PokerStars Hand #250528259659: Tournament #3754315373, $4.80+$5.00+$1.20 USD Hold'em No Limit - Level XXXII (3000/6000) - 2024/05/16 13:12:50 UTC [2024/05/16 9:12:50 ET]
Table '3754315373 2' 8-max Seat #6 is the button
Seat 1: ravenamber (115629 in chips, $32.49 bounty) 
Seat 2: Happy_Grubby (136598 in chips, $17.50 bounty) 
Seat 3: Anton280395 (301929 in chips, $21.56 bounty) 
Seat 4: Mandooo97 (291100 in chips, $23.75 bounty) 
Seat 5: robko19 (258740 in chips, $89.11 bounty) 
Seat 6: khurlee.ts (197459 in chips, $61.70 bounty) 
Seat 7: noway0ut_7 (280247 in chips, $47.94 bounty) 
Seat 8: Imavere (190570 in chips, $48.43 bounty) 
ravenamber: posts the ante 900
Happy_Grubby: posts the ante 900
Anton280395: posts the ante 900
Mandooo97: posts the ante 900
robko19: posts the ante 900
khurlee.ts: posts the ante 900
noway0ut_7: posts the ante 900
Imavere: posts the ante 900
noway0ut_7: posts small blind 3000
Imavere: posts big blind 6000
*** HOLE CARDS ***
ravenamber: folds 
Happy_Grubby: folds 
Anton280395: folds 
Mandooo97: raises 7200 to 13200
robko19: folds 
khurlee.ts: raises 13800 to 27000
noway0ut_7: folds 
Imavere: folds 
Mandooo97: raises 39000 to 66000
khurlee.ts: folds 
Uncalled bet (39000) returned to Mandooo97
Mandooo97 collected 70200 from pot
Mandooo97: doesn't show hand 
*** SUMMARY ***
Total pot 70200 | Rake 0 
Seat 1: ravenamber folded before Flop (didn't bet)
Seat 2: Happy_Grubby folded before Flop (didn't bet)
Seat 3: Anton280395 folded before Flop (didn't bet)
Seat 4: Mandooo97 collected (70200)
Seat 5: robko19 folded before Flop (didn't bet)
Seat 6: khurlee.ts (button) folded before Flop
Seat 7: noway0ut_7 (small blind) folded before Flop
Seat 8: Imavere (big blind) folded before Flop

PokerStars Hand #250528268063: Tournament #3754315373, $4.80+$5.00+$1.20 USD Hold'em No Limit - Level XXXII (3000/6000) - 2024/05/16 13:13:38 UTC [2024/05/16 9:13:38 ET]
Table '3754315373 2' 8-max Seat #7 is the button
Seat 1: ravenamber (114729 in chips, $32.49 bounty) 
Seat 2: Happy_Grubby (135698 in chips, $17.50 bounty) 
Seat 3: Anton280395 (301029 in chips, $21.56 bounty) 
Seat 4: Mandooo97 (333400 in chips, $23.75 bounty) 
Seat 5: robko19 (257840 in chips, $89.11 bounty) 
Seat 6: khurlee.ts (169559 in chips, $61.70 bounty) 
Seat 7: noway0ut_7 (276347 in chips, $47.94 bounty) 
Seat 8: Imavere (183670 in chips, $48.43 bounty) 
ravenamber: posts the ante 900
Happy_Grubby: posts the ante 900
Anton280395: posts the ante 900
Mandooo97: posts the ante 900
robko19: posts the ante 900
khurlee.ts: posts the ante 900
noway0ut_7: posts the ante 900
Imavere: posts the ante 900
Imavere: posts small blind 3000
ravenamber: posts big blind 6000
*** HOLE CARDS ***
Happy_Grubby: folds 
Anton280395: folds 
Mandooo97: folds 
robko19: raises 9600 to 15600
khurlee.ts: folds 
noway0ut_7: folds 
Imavere: folds 
ravenamber: calls 9600
*** FLOP *** [8d 7d 9s]
ravenamber: checks 
robko19: bets 41400
ravenamber: raises 56829 to 98229 and is all-in
robko19: calls 56829
*** TURN *** [8d 7d 9s] [Ts]
*** RIVER *** [8d 7d 9s Ts] [2s]
*** SHOW DOWN ***
ravenamber: shows [Th Jh] (a straight, Seven to Jack)
robko19: shows [6h 7h] (a straight, Six to Ten)
ravenamber collected 237858 from pot
*** SUMMARY ***
Total pot 237858 | Rake 0 
Board [8d 7d 9s Ts 2s]
Seat 1: ravenamber (big blind) showed [Th Jh] and won (237858) with a straight, Seven to Jack
Seat 2: Happy_Grubby folded before Flop (didn't bet)
Seat 3: Anton280395 folded before Flop (didn't bet)
Seat 4: Mandooo97 folded before Flop (didn't bet)
Seat 5: robko19 showed [6h 7h] and lost with a straight, Six to Ten
Seat 6: khurlee.ts folded before Flop (didn't bet)
Seat 7: noway0ut_7 (button) folded before Flop (didn't bet)
Seat 8: Imavere (small blind) folded before Flop

PokerStars Hand #250528268063: Tournament #3754315373, $4.80+$5.00+$1.20 USD Hold'em No Limit - Level XXXII (3000/6000) - 2024/05/16 13:13:38 UTC [2024/05/16 9:13:38 ET]
Table '3754315373 2' 8-max Seat #7 is the button
Seat 1: ravenamber (114729 in chips, $32.49 bounty) 
Seat 2: Happy_Grubby (135698 in chips, $17.50 bounty) 
Seat 3: Anton280395 (301029 in chips, $21.56 bounty) 
Seat 4: Mandooo97 (333400 in chips, $23.75 bounty) 
Seat 5: robko19 (257840 in chips, $89.11 bounty) 
Seat 6: khurlee.ts (169559 in chips, $61.70 bounty) 
Seat 7: noway0ut_7 (276347 in chips, $47.94 bounty) 
Seat 8: Imavere (183670 in chips, $48.43 bounty) 
ravenamber: posts the ante 900
Happy_Grubby: posts the ante 900
Anton280395: posts the ante 900
Mandooo97: posts the ante 900
robko19: posts the ante 900
khurlee.ts: posts the ante 900
noway0ut_7: posts the ante 900
Imavere: posts the ante 900
Imavere: posts small blind 3000
ravenamber: posts big blind 6000
*** HOLE CARDS ***
Happy_Grubby: folds 
Anton280395: folds 
Mandooo97: folds 
robko19: raises 9600 to 15600
khurlee.ts: folds 
noway0ut_7: folds 
Imavere: folds 
ravenamber: calls 9600
*** FLOP *** [8d 7d 9s]
ravenamber: checks 
robko19: bets 41400
ravenamber: raises 56829 to 98229 and is all-in
robko19: calls 56829
*** TURN *** [8d 7d 9s] [Ts]
*** RIVER *** [8d 7d 9s Ts] [2s]
*** SHOW DOWN ***
ravenamber: shows [Th Jh] (a straight, Seven to Jack)
robko19: shows [6h 7h] (a straight, Six to Ten)
ravenamber collected 237858 from pot
*** SUMMARY ***
Total pot 237858 | Rake 0 
Board [8d 7d 9s Ts 2s]
Seat 1: ravenamber (big blind) showed [Th Jh] and won (237858) with a straight, Seven to Jack
Seat 2: Happy_Grubby folded before Flop (didn't bet)
Seat 3: Anton280395 folded before Flop (didn't bet)
Seat 4: Mandooo97 folded before Flop (didn't bet)
Seat 5: robko19 showed [6h 7h] and lost with a straight, Six to Ten
Seat 6: khurlee.ts folded before Flop (didn't bet)
Seat 7: noway0ut_7 (button) folded before Flop (didn't bet)
Seat 8: Imavere (small blind) folded before Flop

PokerStars Hand #250528276685: Tournament #3754315373, $4.80+$5.00+$1.20 USD Hold'em No Limit - Level XXXII (3000/6000) - 2024/05/16 13:14:27 UTC [2024/05/16 9:14:27 ET]
Table '3754315373 2' 8-max Seat #8 is the button
Seat 1: ravenamber (237858 in chips, $32.49 bounty) 
Seat 2: Happy_Grubby (134798 in chips, $17.50 bounty) 
Seat 3: Anton280395 (300129 in chips, $21.56 bounty) 
Seat 4: Mandooo97 (332500 in chips, $23.75 bounty) 
Seat 5: robko19 (143111 in chips, $89.11 bounty) 
Seat 6: khurlee.ts (168659 in chips, $61.70 bounty) 
Seat 7: noway0ut_7 (275447 in chips, $47.94 bounty) 
Seat 8: Imavere (179770 in chips, $48.43 bounty) 
ravenamber: posts the ante 900
Happy_Grubby: posts the ante 900
Anton280395: posts the ante 900
Mandooo97: posts the ante 900
robko19: posts the ante 900
khurlee.ts: posts the ante 900
noway0ut_7: posts the ante 900
Imavere: posts the ante 900
ravenamber: posts small blind 3000
Happy_Grubby: posts big blind 6000
*** HOLE CARDS ***
Anton280395: folds 
Mandooo97: folds 
robko19: folds 
khurlee.ts: raises 6000 to 12000
noway0ut_7: folds 
Imavere: folds 
ravenamber: folds 
Happy_Grubby: calls 6000
*** FLOP *** [5h 3h 7d]
Happy_Grubby: checks 
khurlee.ts: bets 6156
Happy_Grubby: calls 6156
*** TURN *** [5h 3h 7d] [9h]
Happy_Grubby: bets 15349
khurlee.ts: calls 15349
*** RIVER *** [5h 3h 7d 9h] [Ks]
Happy_Grubby: checks 
khurlee.ts: checks 
*** SHOW DOWN ***
Happy_Grubby: shows [9s Js] (a pair of Nines)
khurlee.ts: mucks hand 
Happy_Grubby collected 77210 from pot
*** SUMMARY ***
Total pot 77210 | Rake 0 
Board [5h 3h 7d 9h Ks]
Seat 1: ravenamber (small blind) folded before Flop
Seat 2: Happy_Grubby (big blind) showed [9s Js] and won (77210) with a pair of Nines
Seat 3: Anton280395 folded before Flop (didn't bet)
Seat 4: Mandooo97 folded before Flop (didn't bet)
Seat 5: robko19 folded before Flop (didn't bet)
Seat 6: khurlee.ts mucked
Seat 7: noway0ut_7 folded before Flop (didn't bet)
Seat 8: Imavere (button) folded before Flop (didn't bet)

PokerStars Hand #250528276685: Tournament #3754315373, $4.80+$5.00+$1.20 USD Hold'em No Limit - Level XXXII (3000/6000) - 2024/05/16 13:14:27 UTC [2024/05/16 9:14:27 ET]
Table '3754315373 2' 8-max Seat #8 is the button
Seat 1: ravenamber (237858 in chips, $32.49 bounty) 
Seat 2: Happy_Grubby (134798 in chips, $17.50 bounty) 
Seat 3: Anton280395 (300129 in chips, $21.56 bounty) 
Seat 4: Mandooo97 (332500 in chips, $23.75 bounty) 
Seat 5: robko19 (143111 in chips, $89.11 bounty) 
Seat 6: khurlee.ts (168659 in chips, $61.70 bounty) 
Seat 7: noway0ut_7 (275447 in chips, $47.94 bounty) 
Seat 8: Imavere (179770 in chips, $48.43 bounty) 
ravenamber: posts the ante 900
Happy_Grubby: posts the ante 900
Anton280395: posts the ante 900
Mandooo97: posts the ante 900
robko19: posts the ante 900
khurlee.ts: posts the ante 900
noway0ut_7: posts the ante 900
Imavere: posts the ante 900
ravenamber: posts small blind 3000
Happy_Grubby: posts big blind 6000
*** HOLE CARDS ***
Anton280395: folds 
Mandooo97: folds 
robko19: folds 
khurlee.ts: raises 6000 to 12000
noway0ut_7: folds 
Imavere: folds 
ravenamber: folds 
Happy_Grubby: calls 6000
*** FLOP *** [5h 3h 7d]
Happy_Grubby: checks 
khurlee.ts: bets 6156
Happy_Grubby: calls 6156
*** TURN *** [5h 3h 7d] [9h]
Happy_Grubby: bets 15349
khurlee.ts: calls 15349
*** RIVER *** [5h 3h 7d 9h] [Ks]
Happy_Grubby: checks 
khurlee.ts: checks 
*** SHOW DOWN ***
Happy_Grubby: shows [9s Js] (a pair of Nines)
khurlee.ts: mucks hand 
Happy_Grubby collected 77210 from pot
*** SUMMARY ***
Total pot 77210 | Rake 0 
Board [5h 3h 7d 9h Ks]
Seat 1: ravenamber (small blind) folded before Flop
Seat 2: Happy_Grubby (big blind) showed [9s Js] and won (77210) with a pair of Nines
Seat 3: Anton280395 folded before Flop (didn't bet)
Seat 4: Mandooo97 folded before Flop (didn't bet)
Seat 5: robko19 folded before Flop (didn't bet)
Seat 6: khurlee.ts mucked
Seat 7: noway0ut_7 folded before Flop (didn't bet)
Seat 8: Imavere (button) folded before Flop (didn't bet)

PokerStars Hand #250528288833: Tournament #3754315373, $4.80+$5.00+$1.20 USD Hold'em No Limit - Level XXXII (3000/6000) - 2024/05/16 13:15:34 UTC [2024/05/16 9:15:34 ET]
Table '3754315373 2' 8-max Seat #1 is the button
Seat 1: ravenamber (233958 in chips, $32.49 bounty) 
Seat 2: Happy_Grubby (177603 in chips, $17.50 bounty) 
Seat 3: Anton280395 (299229 in chips, $21.56 bounty) 
Seat 4: Mandooo97 (331600 in chips, $23.75 bounty) 
Seat 5: robko19 (142211 in chips, $89.11 bounty) 
Seat 6: khurlee.ts (134254 in chips, $61.70 bounty) 
Seat 7: noway0ut_7 (274547 in chips, $47.94 bounty) 
Seat 8: Imavere (178870 in chips, $48.43 bounty) 
ravenamber: posts the ante 900
Happy_Grubby: posts the ante 900
Anton280395: posts the ante 900
Mandooo97: posts the ante 900
robko19: posts the ante 900
khurlee.ts: posts the ante 900
noway0ut_7: posts the ante 900
Imavere: posts the ante 900
Happy_Grubby: posts small blind 3000
Anton280395: posts big blind 6000
*** HOLE CARDS ***
Mandooo97: folds 
robko19: folds 
khurlee.ts: folds 
noway0ut_7: raises 6000 to 12000
Imavere: folds 
ravenamber: folds 
Happy_Grubby: folds 
Anton280395: calls 6000
*** FLOP *** [Qd Th 2d]
Anton280395: checks 
noway0ut_7: bets 17100
Anton280395: folds 
Uncalled bet (17100) returned to noway0ut_7
noway0ut_7 collected 34200 from pot
*** SUMMARY ***
Total pot 34200 | Rake 0 
Board [Qd Th 2d]
Seat 1: ravenamber (button) folded before Flop (didn't bet)
Seat 2: Happy_Grubby (small blind) folded before Flop
Seat 3: Anton280395 (big blind) folded on the Flop
Seat 4: Mandooo97 folded before Flop (didn't bet)
Seat 5: robko19 folded before Flop (didn't bet)
Seat 6: khurlee.ts folded before Flop (didn't bet)
Seat 7: noway0ut_7 collected (34200)
Seat 8: Imavere folded before Flop (didn't bet)

PokerStars Hand #250528288833: Tournament #3754315373, $4.80+$5.00+$1.20 USD Hold'em No Limit - Level XXXII (3000/6000) - 2024/05/16 13:15:34 UTC [2024/05/16 9:15:34 ET]
Table '3754315373 2' 8-max Seat #1 is the button
Seat 1: ravenamber (233958 in chips, $32.49 bounty) 
Seat 2: Happy_Grubby (177603 in chips, $17.50 bounty) 
Seat 3: Anton280395 (299229 in chips, $21.56 bounty) 
Seat 4: Mandooo97 (331600 in chips, $23.75 bounty) 
Seat 5: robko19 (142211 in chips, $89.11 bounty) 
Seat 6: khurlee.ts (134254 in chips, $61.70 bounty) 
Seat 7: noway0ut_7 (274547 in chips, $47.94 bounty) 
Seat 8: Imavere (178870 in chips, $48.43 bounty) 
ravenamber: posts the ante 900
Happy_Grubby: posts the ante 900
Anton280395: posts the ante 900
Mandooo97: posts the ante 900
robko19: posts the ante 900
khurlee.ts: posts the ante 900
noway0ut_7: posts the ante 900
Imavere: posts the ante 900
Happy_Grubby: posts small blind 3000
Anton280395: posts big blind 6000
*** HOLE CARDS ***
Mandooo97: folds 
robko19: folds 
khurlee.ts: folds 
noway0ut_7: raises 6000 to 12000
Imavere: folds 
ravenamber: folds 
Happy_Grubby: folds 
Anton280395: calls 6000
*** FLOP *** [Qd Th 2d]
Anton280395: checks 
noway0ut_7: bets 17100
Anton280395: folds 
Uncalled bet (17100) returned to noway0ut_7
noway0ut_7 collected 34200 from pot
*** SUMMARY ***
Total pot 34200 | Rake 0 
Board [Qd Th 2d]
Seat 1: ravenamber (button) folded before Flop (didn't bet)
Seat 2: Happy_Grubby (small blind) folded before Flop
Seat 3: Anton280395 (big blind) folded on the Flop
Seat 4: Mandooo97 folded before Flop (didn't bet)
Seat 5: robko19 folded before Flop (didn't bet)
Seat 6: khurlee.ts folded before Flop (didn't bet)
Seat 7: noway0ut_7 collected (34200)
Seat 8: Imavere folded before Flop (didn't bet)

PokerStars Hand #250528295274: Tournament #3754315373, $4.80+$5.00+$1.20 USD Hold'em No Limit - Level XXXII (3000/6000) - 2024/05/16 13:16:10 UTC [2024/05/16 9:16:10 ET]
Table '3754315373 2' 8-max Seat #2 is the button
Seat 1: ravenamber (233058 in chips, $32.49 bounty) 
Seat 2: Happy_Grubby (173703 in chips, $17.50 bounty) 
Seat 3: Anton280395 (286329 in chips, $21.56 bounty) 
Seat 4: Mandooo97 (330700 in chips, $23.75 bounty) 
Seat 5: robko19 (141311 in chips, $89.11 bounty) 
Seat 6: khurlee.ts (133354 in chips, $61.70 bounty) 
Seat 7: noway0ut_7 (295847 in chips, $47.94 bounty) 
Seat 8: Imavere (177970 in chips, $48.43 bounty) 
ravenamber: posts the ante 900
Happy_Grubby: posts the ante 900
Anton280395: posts the ante 900
Mandooo97: posts the ante 900
robko19: posts the ante 900
khurlee.ts: posts the ante 900
noway0ut_7: posts the ante 900
Imavere: posts the ante 900
Anton280395: posts small blind 3000
Mandooo97: posts big blind 6000
*** HOLE CARDS ***
robko19: folds 
khurlee.ts: folds 
noway0ut_7: folds 
Imavere: raises 6000 to 12000
ravenamber: folds 
Happy_Grubby: folds 
Anton280395: folds 
Mandooo97: folds 
Uncalled bet (6000) returned to Imavere
Imavere collected 22200 from pot
*** SUMMARY ***
Total pot 22200 | Rake 0 
Seat 1: ravenamber folded before Flop (didn't bet)
Seat 2: Happy_Grubby (button) folded before Flop (didn't bet)
Seat 3: Anton280395 (small blind) folded before Flop
Seat 4: Mandooo97 (big blind) folded before Flop
Seat 5: robko19 folded before Flop (didn't bet)
Seat 6: khurlee.ts folded before Flop (didn't bet)
Seat 7: noway0ut_7 folded before Flop (didn't bet)
Seat 8: Imavere collected (22200)

PokerStars Hand #250528295274: Tournament #3754315373, $4.80+$5.00+$1.20 USD Hold'em No Limit - Level XXXII (3000/6000) - 2024/05/16 13:16:10 UTC [2024/05/16 9:16:10 ET]
Table '3754315373 2' 8-max Seat #2 is the button
Seat 1: ravenamber (233058 in chips, $32.49 bounty) 
Seat 2: Happy_Grubby (173703 in chips, $17.50 bounty) 
Seat 3: Anton280395 (286329 in chips, $21.56 bounty) 
Seat 4: Mandooo97 (330700 in chips, $23.75 bounty) 
Seat 5: robko19 (141311 in chips, $89.11 bounty) 
Seat 6: khurlee.ts (133354 in chips, $61.70 bounty) 
Seat 7: noway0ut_7 (295847 in chips, $47.94 bounty) 
Seat 8: Imavere (177970 in chips, $48.43 bounty) 
ravenamber: posts the ante 900
Happy_Grubby: posts the ante 900
Anton280395: posts the ante 900
Mandooo97: posts the ante 900
robko19: posts the ante 900
khurlee.ts: posts the ante 900
noway0ut_7: posts the ante 900
Imavere: posts the ante 900
Anton280395: posts small blind 3000
Mandooo97: posts big blind 6000
*** HOLE CARDS ***
robko19: folds 
khurlee.ts: folds 
noway0ut_7: folds 
Imavere: raises 6000 to 12000
ravenamber: folds 
Happy_Grubby: folds 
Anton280395: folds 
Mandooo97: folds 
Uncalled bet (6000) returned to Imavere
Imavere collected 22200 from pot
*** SUMMARY ***
Total pot 22200 | Rake 0 
Seat 1: ravenamber folded before Flop (didn't bet)
Seat 2: Happy_Grubby (button) folded before Flop (didn't bet)
Seat 3: Anton280395 (small blind) folded before Flop
Seat 4: Mandooo97 (big blind) folded before Flop
Seat 5: robko19 folded before Flop (didn't bet)
Seat 6: khurlee.ts folded before Flop (didn't bet)
Seat 7: noway0ut_7 folded before Flop (didn't bet)
Seat 8: Imavere collected (22200)

PokerStars Hand #250528299745: Tournament #3754315373, $4.80+$5.00+$1.20 USD Hold'em No Limit - Level XXXII (3000/6000) - 2024/05/16 13:16:35 UTC [2024/05/16 9:16:35 ET]
Table '3754315373 2' 8-max Seat #3 is the button
Seat 1: ravenamber (232158 in chips, $32.49 bounty) 
Seat 2: Happy_Grubby (172803 in chips, $17.50 bounty) 
Seat 3: Anton280395 (282429 in chips, $21.56 bounty) 
Seat 4: Mandooo97 (323800 in chips, $23.75 bounty) 
Seat 5: robko19 (140411 in chips, $89.11 bounty) 
Seat 6: khurlee.ts (132454 in chips, $61.70 bounty) 
Seat 7: noway0ut_7 (294947 in chips, $47.94 bounty) 
Seat 8: Imavere (193270 in chips, $48.43 bounty) 
ravenamber: posts the ante 900
Happy_Grubby: posts the ante 900
Anton280395: posts the ante 900
Mandooo97: posts the ante 900
robko19: posts the ante 900
khurlee.ts: posts the ante 900
noway0ut_7: posts the ante 900
Imavere: posts the ante 900
Mandooo97: posts small blind 3000
robko19: posts big blind 6000
*** HOLE CARDS ***
khurlee.ts: folds 
noway0ut_7: folds 
Imavere: folds 
ravenamber: folds 
Happy_Grubby: raises 6000 to 12000
Anton280395: folds 
Mandooo97: folds 
robko19: folds 
Uncalled bet (6000) returned to Happy_Grubby
Happy_Grubby collected 22200 from pot
Happy_Grubby: doesn't show hand 
*** SUMMARY ***
Total pot 22200 | Rake 0 
Seat 1: ravenamber folded before Flop (didn't bet)
Seat 2: Happy_Grubby collected (22200)
Seat 3: Anton280395 (button) folded before Flop (didn't bet)
Seat 4: Mandooo97 (small blind) folded before Flop
Seat 5: robko19 (big blind) folded before Flop
Seat 6: khurlee.ts folded before Flop (didn't bet)
Seat 7: noway0ut_7 folded before Flop (didn't bet)
Seat 8: Imavere folded before Flop (didn't bet)

PokerStars Hand #250528299745: Tournament #3754315373, $4.80+$5.00+$1.20 USD Hold'em No Limit - Level XXXII (3000/6000) - 2024/05/16 13:16:35 UTC [2024/05/16 9:16:35 ET]
Table '3754315373 2' 8-max Seat #3 is the button
Seat 1: ravenamber (232158 in chips, $32.49 bounty) 
Seat 2: Happy_Grubby (172803 in chips, $17.50 bounty) 
Seat 3: Anton280395 (282429 in chips, $21.56 bounty) 
Seat 4: Mandooo97 (323800 in chips, $23.75 bounty) 
Seat 5: robko19 (140411 in chips, $89.11 bounty) 
Seat 6: khurlee.ts (132454 in chips, $61.70 bounty) 
Seat 7: noway0ut_7 (294947 in chips, $47.94 bounty) 
Seat 8: Imavere (193270 in chips, $48.43 bounty) 
ravenamber: posts the ante 900
Happy_Grubby: posts the ante 900
Anton280395: posts the ante 900
Mandooo97: posts the ante 900
robko19: posts the ante 900
khurlee.ts: posts the ante 900
noway0ut_7: posts the ante 900
Imavere: posts the ante 900
Mandooo97: posts small blind 3000
robko19: posts big blind 6000
*** HOLE CARDS ***
khurlee.ts: folds 
noway0ut_7: folds 
Imavere: folds 
ravenamber: folds 
Happy_Grubby: raises 6000 to 12000
Anton280395: folds 
Mandooo97: folds 
robko19: folds 
Uncalled bet (6000) returned to Happy_Grubby
Happy_Grubby collected 22200 from pot
Happy_Grubby: doesn't show hand 
*** SUMMARY ***
Total pot 22200 | Rake 0 
Seat 1: ravenamber folded before Flop (didn't bet)
Seat 2: Happy_Grubby collected (22200)
Seat 3: Anton280395 (button) folded before Flop (didn't bet)
Seat 4: Mandooo97 (small blind) folded before Flop
Seat 5: robko19 (big blind) folded before Flop
Seat 6: khurlee.ts folded before Flop (didn't bet)
Seat 7: noway0ut_7 folded before Flop (didn't bet)
Seat 8: Imavere folded before Flop (didn't bet)

PokerStars Hand #250528304916: Tournament #3754315373, $4.80+$5.00+$1.20 USD Hold'em No Limit - Level XXXII (3000/6000) - 2024/05/16 13:17:05 UTC [2024/05/16 9:17:05 ET]
Table '3754315373 2' 8-max Seat #4 is the button
Seat 1: ravenamber (231258 in chips, $32.49 bounty) 
Seat 2: Happy_Grubby (188103 in chips, $17.50 bounty) 
Seat 3: Anton280395 (281529 in chips, $21.56 bounty) 
Seat 4: Mandooo97 (319900 in chips, $23.75 bounty) 
Seat 5: robko19 (133511 in chips, $89.11 bounty) 
Seat 6: khurlee.ts (131554 in chips, $61.70 bounty) 
Seat 7: noway0ut_7 (294047 in chips, $47.94 bounty) 
Seat 8: Imavere (192370 in chips, $48.43 bounty) 
ravenamber: posts the ante 900
Happy_Grubby: posts the ante 900
Anton280395: posts the ante 900
Mandooo97: posts the ante 900
robko19: posts the ante 900
khurlee.ts: posts the ante 900
noway0ut_7: posts the ante 900
Imavere: posts the ante 900
robko19: posts small blind 3000
khurlee.ts: posts big blind 6000
*** HOLE CARDS ***
noway0ut_7: folds 
Imavere: folds 
ravenamber: folds 
Happy_Grubby: folds 
Anton280395: folds 
Mandooo97: folds 
robko19: raises 6000 to 12000
khurlee.ts: calls 6000
*** FLOP *** [6d 4h 5c]
robko19: checks 
khurlee.ts: bets 10296
robko19: folds 
Uncalled bet (10296) returned to khurlee.ts
khurlee.ts collected 31200 from pot
khurlee.ts: doesn't show hand 
*** SUMMARY ***
Total pot 31200 | Rake 0 
Board [6d 4h 5c]
Seat 1: ravenamber folded before Flop (didn't bet)
Seat 2: Happy_Grubby folded before Flop (didn't bet)
Seat 3: Anton280395 folded before Flop (didn't bet)
Seat 4: Mandooo97 (button) folded before Flop (didn't bet)
Seat 5: robko19 (small blind) folded on the Flop
Seat 6: khurlee.ts (big blind) collected (31200)
Seat 7: noway0ut_7 folded before Flop (didn't bet)
Seat 8: Imavere folded before Flop (didn't bet)

PokerStars Hand #250528304916: Tournament #3754315373, $4.80+$5.00+$1.20 USD Hold'em No Limit - Level XXXII (3000/6000) - 2024/05/16 13:17:05 UTC [2024/05/16 9:17:05 ET]
Table '3754315373 2' 8-max Seat #4 is the button
Seat 1: ravenamber (231258 in chips, $32.49 bounty) 
Seat 2: Happy_Grubby (188103 in chips, $17.50 bounty) 
Seat 3: Anton280395 (281529 in chips, $21.56 bounty) 
Seat 4: Mandooo97 (319900 in chips, $23.75 bounty) 
Seat 5: robko19 (133511 in chips, $89.11 bounty) 
Seat 6: khurlee.ts (131554 in chips, $61.70 bounty) 
Seat 7: noway0ut_7 (294047 in chips, $47.94 bounty) 
Seat 8: Imavere (192370 in chips, $48.43 bounty) 
ravenamber: posts the ante 900
Happy_Grubby: posts the ante 900
Anton280395: posts the ante 900
Mandooo97: posts the ante 900
robko19: posts the ante 900
khurlee.ts: posts the ante 900
noway0ut_7: posts the ante 900
Imavere: posts the ante 900
robko19: posts small blind 3000
khurlee.ts: posts big blind 6000
*** HOLE CARDS ***
noway0ut_7: folds 
Imavere: folds 
ravenamber: folds 
Happy_Grubby: folds 
Anton280395: folds 
Mandooo97: folds 
robko19: raises 6000 to 12000
khurlee.ts: calls 6000
*** FLOP *** [6d 4h 5c]
robko19: checks 
khurlee.ts: bets 10296
robko19: folds 
Uncalled bet (10296) returned to khurlee.ts
khurlee.ts collected 31200 from pot
khurlee.ts: doesn't show hand 
*** SUMMARY ***
Total pot 31200 | Rake 0 
Board [6d 4h 5c]
Seat 1: ravenamber folded before Flop (didn't bet)
Seat 2: Happy_Grubby folded before Flop (didn't bet)
Seat 3: Anton280395 folded before Flop (didn't bet)
Seat 4: Mandooo97 (button) folded before Flop (didn't bet)
Seat 5: robko19 (small blind) folded on the Flop
Seat 6: khurlee.ts (big blind) collected (31200)
Seat 7: noway0ut_7 folded before Flop (didn't bet)
Seat 8: Imavere folded before Flop (didn't bet)

PokerStars Hand #250528313291: Tournament #3754315373, $4.80+$5.00+$1.20 USD Hold'em No Limit - Level XXXIII (3500/7000) - 2024/05/16 13:17:52 UTC [2024/05/16 9:17:52 ET]
Table '3754315373 2' 8-max Seat #5 is the button
Seat 1: ravenamber (230358 in chips, $32.49 bounty) 
Seat 2: Happy_Grubby (187203 in chips, $17.50 bounty) 
Seat 3: Anton280395 (280629 in chips, $21.56 bounty) 
Seat 4: Mandooo97 (319000 in chips, $23.75 bounty) 
Seat 5: robko19 (120611 in chips, $89.11 bounty) 
Seat 6: khurlee.ts (149854 in chips, $61.70 bounty) 
Seat 7: noway0ut_7 (293147 in chips, $47.94 bounty) 
Seat 8: Imavere (191470 in chips, $48.43 bounty) 
ravenamber: posts the ante 1100
Happy_Grubby: posts the ante 1100
Anton280395: posts the ante 1100
Mandooo97: posts the ante 1100
robko19: posts the ante 1100
khurlee.ts: posts the ante 1100
noway0ut_7: posts the ante 1100
Imavere: posts the ante 1100
khurlee.ts: posts small blind 3500
noway0ut_7: posts big blind 7000
*** HOLE CARDS ***
Imavere: folds 
ravenamber: folds 
Happy_Grubby: raises 7000 to 14000
Anton280395: folds 
Mandooo97: folds 
robko19: folds 
khurlee.ts: folds 
noway0ut_7: folds 
Uncalled bet (7000) returned to Happy_Grubby
Happy_Grubby collected 26300 from pot
Happy_Grubby: doesn't show hand 
*** SUMMARY ***
Total pot 26300 | Rake 0 
Seat 1: ravenamber folded before Flop (didn't bet)
Seat 2: Happy_Grubby collected (26300)
Seat 3: Anton280395 folded before Flop (didn't bet)
Seat 4: Mandooo97 folded before Flop (didn't bet)
Seat 5: robko19 (button) folded before Flop (didn't bet)
Seat 6: khurlee.ts (small blind) folded before Flop
Seat 7: noway0ut_7 (big blind) folded before Flop
Seat 8: Imavere folded before Flop (didn't bet)

PokerStars Hand #250528313291: Tournament #3754315373, $4.80+$5.00+$1.20 USD Hold'em No Limit - Level XXXIII (3500/7000) - 2024/05/16 13:17:52 UTC [2024/05/16 9:17:52 ET]
Table '3754315373 2' 8-max Seat #5 is the button
Seat 1: ravenamber (230358 in chips, $32.49 bounty) 
Seat 2: Happy_Grubby (187203 in chips, $17.50 bounty) 
Seat 3: Anton280395 (280629 in chips, $21.56 bounty) 
Seat 4: Mandooo97 (319000 in chips, $23.75 bounty) 
Seat 5: robko19 (120611 in chips, $89.11 bounty) 
Seat 6: khurlee.ts (149854 in chips, $61.70 bounty) 
Seat 7: noway0ut_7 (293147 in chips, $47.94 bounty) 
Seat 8: Imavere (191470 in chips, $48.43 bounty) 
ravenamber: posts the ante 1100
Happy_Grubby: posts the ante 1100
Anton280395: posts the ante 1100
Mandooo97: posts the ante 1100
robko19: posts the ante 1100
khurlee.ts: posts the ante 1100
noway0ut_7: posts the ante 1100
Imavere: posts the ante 1100
khurlee.ts: posts small blind 3500
noway0ut_7: posts big blind 7000
*** HOLE CARDS ***
Imavere: folds 
ravenamber: folds 
Happy_Grubby: raises 7000 to 14000
Anton280395: folds 
Mandooo97: folds 
robko19: folds 
khurlee.ts: folds 
noway0ut_7: folds 
Uncalled bet (7000) returned to Happy_Grubby
Happy_Grubby collected 26300 from pot
Happy_Grubby: doesn't show hand 
*** SUMMARY ***
Total pot 26300 | Rake 0 
Seat 1: ravenamber folded before Flop (didn't bet)
Seat 2: Happy_Grubby collected (26300)
Seat 3: Anton280395 folded before Flop (didn't bet)
Seat 4: Mandooo97 folded before Flop (didn't bet)
Seat 5: robko19 (button) folded before Flop (didn't bet)
Seat 6: khurlee.ts (small blind) folded before Flop
Seat 7: noway0ut_7 (big blind) folded before Flop
Seat 8: Imavere folded before Flop (didn't bet)

PokerStars Hand #250528316667: Tournament #3754315373, $4.80+$5.00+$1.20 USD Hold'em No Limit - Level XXXIII (3500/7000) - 2024/05/16 13:18:11 UTC [2024/05/16 9:18:11 ET]
Table '3754315373 2' 8-max Seat #6 is the button
Seat 1: ravenamber (229258 in chips, $32.49 bounty) 
Seat 2: Happy_Grubby (205403 in chips, $17.50 bounty) 
Seat 3: Anton280395 (279529 in chips, $21.56 bounty) 
Seat 4: Mandooo97 (317900 in chips, $23.75 bounty) 
Seat 5: robko19 (119511 in chips, $89.11 bounty) 
Seat 6: khurlee.ts (145254 in chips, $61.70 bounty) 
Seat 7: noway0ut_7 (285047 in chips, $47.94 bounty) 
Seat 8: Imavere (190370 in chips, $48.43 bounty) 
ravenamber: posts the ante 1100
Happy_Grubby: posts the ante 1100
Anton280395: posts the ante 1100
Mandooo97: posts the ante 1100
robko19: posts the ante 1100
khurlee.ts: posts the ante 1100
noway0ut_7: posts the ante 1100
Imavere: posts the ante 1100
noway0ut_7: posts small blind 3500
Imavere: posts big blind 7000
*** HOLE CARDS ***
ravenamber: folds 
Happy_Grubby: folds 
Anton280395: folds 
Mandooo97: folds 
robko19: folds 
khurlee.ts: folds 
noway0ut_7: raises 276947 to 283947 and is all-in
Imavere: folds [9d]
Uncalled bet (276947) returned to noway0ut_7
noway0ut_7 collected 22800 from pot
*** SUMMARY ***
Total pot 22800 | Rake 0 
Seat 1: ravenamber folded before Flop (didn't bet)
Seat 2: Happy_Grubby folded before Flop (didn't bet)
Seat 3: Anton280395 folded before Flop (didn't bet)
Seat 4: Mandooo97 folded before Flop (didn't bet)
Seat 5: robko19 folded before Flop (didn't bet)
Seat 6: khurlee.ts (button) folded before Flop (didn't bet)
Seat 7: noway0ut_7 (small blind) collected (22800)
Seat 8: Imavere (big blind) folded before Flop

PokerStars Hand #250528316667: Tournament #3754315373, $4.80+$5.00+$1.20 USD Hold'em No Limit - Level XXXIII (3500/7000) - 2024/05/16 13:18:11 UTC [2024/05/16 9:18:11 ET]
Table '3754315373 2' 8-max Seat #6 is the button
Seat 1: ravenamber (229258 in chips, $32.49 bounty) 
Seat 2: Happy_Grubby (205403 in chips, $17.50 bounty) 
Seat 3: Anton280395 (279529 in chips, $21.56 bounty) 
Seat 4: Mandooo97 (317900 in chips, $23.75 bounty) 
Seat 5: robko19 (119511 in chips, $89.11 bounty) 
Seat 6: khurlee.ts (145254 in chips, $61.70 bounty) 
Seat 7: noway0ut_7 (285047 in chips, $47.94 bounty) 
Seat 8: Imavere (190370 in chips, $48.43 bounty) 
ravenamber: posts the ante 1100
Happy_Grubby: posts the ante 1100
Anton280395: posts the ante 1100
Mandooo97: posts the ante 1100
robko19: posts the ante 1100
khurlee.ts: posts the ante 1100
noway0ut_7: posts the ante 1100
Imavere: posts the ante 1100
noway0ut_7: posts small blind 3500
Imavere: posts big blind 7000
*** HOLE CARDS ***
ravenamber: folds 
Happy_Grubby: folds 
Anton280395: folds 
Mandooo97: folds 
robko19: folds 
khurlee.ts: folds 
noway0ut_7: raises 276947 to 283947 and is all-in
Imavere: folds [9d]
Uncalled bet (276947) returned to noway0ut_7
noway0ut_7 collected 22800 from pot
*** SUMMARY ***
Total pot 22800 | Rake 0 
Seat 1: ravenamber folded before Flop (didn't bet)
Seat 2: Happy_Grubby folded before Flop (didn't bet)
Seat 3: Anton280395 folded before Flop (didn't bet)
Seat 4: Mandooo97 folded before Flop (didn't bet)
Seat 5: robko19 folded before Flop (didn't bet)
Seat 6: khurlee.ts (button) folded before Flop (didn't bet)
Seat 7: noway0ut_7 (small blind) collected (22800)
Seat 8: Imavere (big blind) folded before Flop

PokerStars Hand #250528321539: Tournament #3754315373, $4.80+$5.00+$1.20 USD Hold'em No Limit - Level XXXIII (3500/7000) - 2024/05/16 13:18:39 UTC [2024/05/16 9:18:39 ET]
Table '3754315373 2' 8-max Seat #7 is the button
Seat 1: ravenamber (228158 in chips, $32.49 bounty) 
Seat 2: Happy_Grubby (204303 in chips, $17.50 bounty) 
Seat 3: Anton280395 (278429 in chips, $21.56 bounty) 
Seat 4: Mandooo97 (316800 in chips, $23.75 bounty) 
Seat 5: robko19 (118411 in chips, $89.11 bounty) 
Seat 6: khurlee.ts (144154 in chips, $61.70 bounty) 
Seat 7: noway0ut_7 (299747 in chips, $47.94 bounty) 
Seat 8: Imavere (182270 in chips, $48.43 bounty) 
ravenamber: posts the ante 1100
Happy_Grubby: posts the ante 1100
Anton280395: posts the ante 1100
Mandooo97: posts the ante 1100
robko19: posts the ante 1100
khurlee.ts: posts the ante 1100
noway0ut_7: posts the ante 1100
Imavere: posts the ante 1100
Imavere: posts small blind 3500
ravenamber: posts big blind 7000
*** HOLE CARDS ***
Happy_Grubby: raises 7000 to 14000
Anton280395: folds 
Mandooo97: folds 
robko19: folds 
khurlee.ts: folds 
noway0ut_7: folds 
Imavere: folds 
ravenamber: folds 
Uncalled bet (7000) returned to Happy_Grubby
Happy_Grubby collected 26300 from pot
Happy_Grubby: doesn't show hand 
*** SUMMARY ***
Total pot 26300 | Rake 0 
Seat 1: ravenamber (big blind) folded before Flop
Seat 2: Happy_Grubby collected (26300)
Seat 3: Anton280395 folded before Flop (didn't bet)
Seat 4: Mandooo97 folded before Flop (didn't bet)
Seat 5: robko19 folded before Flop (didn't bet)
Seat 6: khurlee.ts folded before Flop (didn't bet)
Seat 7: noway0ut_7 (button) folded before Flop (didn't bet)
Seat 8: Imavere (small blind) folded before Flop

PokerStars Hand #250528321539: Tournament #3754315373, $4.80+$5.00+$1.20 USD Hold'em No Limit - Level XXXIII (3500/7000) - 2024/05/16 13:18:39 UTC [2024/05/16 9:18:39 ET]
Table '3754315373 2' 8-max Seat #7 is the button
Seat 1: ravenamber (228158 in chips, $32.49 bounty) 
Seat 2: Happy_Grubby (204303 in chips, $17.50 bounty) 
Seat 3: Anton280395 (278429 in chips, $21.56 bounty) 
Seat 4: Mandooo97 (316800 in chips, $23.75 bounty) 
Seat 5: robko19 (118411 in chips, $89.11 bounty) 
Seat 6: khurlee.ts (144154 in chips, $61.70 bounty) 
Seat 7: noway0ut_7 (299747 in chips, $47.94 bounty) 
Seat 8: Imavere (182270 in chips, $48.43 bounty) 
ravenamber: posts the ante 1100
Happy_Grubby: posts the ante 1100
Anton280395: posts the ante 1100
Mandooo97: posts the ante 1100
robko19: posts the ante 1100
khurlee.ts: posts the ante 1100
noway0ut_7: posts the ante 1100
Imavere: posts the ante 1100
Imavere: posts small blind 3500
ravenamber: posts big blind 7000
*** HOLE CARDS ***
Happy_Grubby: raises 7000 to 14000
Anton280395: folds 
Mandooo97: folds 
robko19: folds 
khurlee.ts: folds 
noway0ut_7: folds 
Imavere: folds 
ravenamber: folds 
Uncalled bet (7000) returned to Happy_Grubby
Happy_Grubby collected 26300 from pot
Happy_Grubby: doesn't show hand 
*** SUMMARY ***
Total pot 26300 | Rake 0 
Seat 1: ravenamber (big blind) folded before Flop
Seat 2: Happy_Grubby collected (26300)
Seat 3: Anton280395 folded before Flop (didn't bet)
Seat 4: Mandooo97 folded before Flop (didn't bet)
Seat 5: robko19 folded before Flop (didn't bet)
Seat 6: khurlee.ts folded before Flop (didn't bet)
Seat 7: noway0ut_7 (button) folded before Flop (didn't bet)
Seat 8: Imavere (small blind) folded before Flop

PokerStars Hand #250528324587: Tournament #3754315373, $4.80+$5.00+$1.20 USD Hold'em No Limit - Level XXXIII (3500/7000) - 2024/05/16 13:18:55 UTC [2024/05/16 9:18:55 ET]
Table '3754315373 2' 8-max Seat #8 is the button
Seat 1: ravenamber (220058 in chips, $32.49 bounty) 
Seat 2: Happy_Grubby (222503 in chips, $17.50 bounty) 
Seat 3: Anton280395 (277329 in chips, $21.56 bounty) 
Seat 4: Mandooo97 (315700 in chips, $23.75 bounty) 
Seat 5: robko19 (117311 in chips, $89.11 bounty) 
Seat 6: khurlee.ts (143054 in chips, $61.70 bounty) 
Seat 7: noway0ut_7 (298647 in chips, $47.94 bounty) 
Seat 8: Imavere (177670 in chips, $48.43 bounty) 
ravenamber: posts the ante 1100
Happy_Grubby: posts the ante 1100
Anton280395: posts the ante 1100
Mandooo97: posts the ante 1100
robko19: posts the ante 1100
khurlee.ts: posts the ante 1100
noway0ut_7: posts the ante 1100
Imavere: posts the ante 1100
ravenamber: posts small blind 3500
Happy_Grubby: posts big blind 7000
*** HOLE CARDS ***
Anton280395: folds 
Mandooo97: folds 
robko19: folds 
khurlee.ts: raises 7000 to 14000
noway0ut_7: folds 
Imavere: calls 14000
ravenamber: folds 
Happy_Grubby: raises 207403 to 221403 and is all-in
khurlee.ts: folds 
Imavere: folds 
Uncalled bet (207403) returned to Happy_Grubby
Happy_Grubby collected 54300 from pot
Happy_Grubby: doesn't show hand 
*** SUMMARY ***
Total pot 54300 | Rake 0 
Seat 1: ravenamber (small blind) folded before Flop
Seat 2: Happy_Grubby (big blind) collected (54300)
Seat 3: Anton280395 folded before Flop (didn't bet)
Seat 4: Mandooo97 folded before Flop (didn't bet)
Seat 5: robko19 folded before Flop (didn't bet)
Seat 6: khurlee.ts folded before Flop
Seat 7: noway0ut_7 folded before Flop (didn't bet)
Seat 8: Imavere (button) folded before Flop

PokerStars Hand #250528324587: Tournament #3754315373, $4.80+$5.00+$1.20 USD Hold'em No Limit - Level XXXIII (3500/7000) - 2024/05/16 13:18:55 UTC [2024/05/16 9:18:55 ET]
Table '3754315373 2' 8-max Seat #8 is the button
Seat 1: ravenamber (220058 in chips, $32.49 bounty) 
Seat 2: Happy_Grubby (222503 in chips, $17.50 bounty) 
Seat 3: Anton280395 (277329 in chips, $21.56 bounty) 
Seat 4: Mandooo97 (315700 in chips, $23.75 bounty) 
Seat 5: robko19 (117311 in chips, $89.11 bounty) 
Seat 6: khurlee.ts (143054 in chips, $61.70 bounty) 
Seat 7: noway0ut_7 (298647 in chips, $47.94 bounty) 
Seat 8: Imavere (177670 in chips, $48.43 bounty) 
ravenamber: posts the ante 1100
Happy_Grubby: posts the ante 1100
Anton280395: posts the ante 1100
Mandooo97: posts the ante 1100
robko19: posts the ante 1100
khurlee.ts: posts the ante 1100
noway0ut_7: posts the ante 1100
Imavere: posts the ante 1100
ravenamber: posts small blind 3500
Happy_Grubby: posts big blind 7000
*** HOLE CARDS ***
Anton280395: folds 
Mandooo97: folds 
robko19: folds 
khurlee.ts: raises 7000 to 14000
noway0ut_7: folds 
Imavere: calls 14000
ravenamber: folds 
Happy_Grubby: raises 207403 to 221403 and is all-in
khurlee.ts: folds 
Imavere: folds 
Uncalled bet (207403) returned to Happy_Grubby
Happy_Grubby collected 54300 from pot
Happy_Grubby: doesn't show hand 
*** SUMMARY ***
Total pot 54300 | Rake 0 
Seat 1: ravenamber (small blind) folded before Flop
Seat 2: Happy_Grubby (big blind) collected (54300)
Seat 3: Anton280395 folded before Flop (didn't bet)
Seat 4: Mandooo97 folded before Flop (didn't bet)
Seat 5: robko19 folded before Flop (didn't bet)
Seat 6: khurlee.ts folded before Flop
Seat 7: noway0ut_7 folded before Flop (didn't bet)
Seat 8: Imavere (button) folded before Flop

PokerStars Hand #250528334163: Tournament #3754315373, $4.80+$5.00+$1.20 USD Hold'em No Limit - Level XXXIII (3500/7000) - 2024/05/16 13:19:49 UTC [2024/05/16 9:19:49 ET]
Table '3754315373 2' 8-max Seat #1 is the button
Seat 1: ravenamber (215458 in chips, $32.49 bounty) 
Seat 2: Happy_Grubby (261703 in chips, $17.50 bounty) 
Seat 3: Anton280395 (276229 in chips, $21.56 bounty) 
Seat 4: Mandooo97 (314600 in chips, $23.75 bounty) 
Seat 5: robko19 (116211 in chips, $89.11 bounty) 
Seat 6: khurlee.ts (127954 in chips, $61.70 bounty) 
Seat 7: noway0ut_7 (297547 in chips, $47.94 bounty) 
Seat 8: Imavere (162570 in chips, $48.43 bounty) 
ravenamber: posts the ante 1100
Happy_Grubby: posts the ante 1100
Anton280395: posts the ante 1100
Mandooo97: posts the ante 1100
robko19: posts the ante 1100
khurlee.ts: posts the ante 1100
noway0ut_7: posts the ante 1100
Imavere: posts the ante 1100
Happy_Grubby: posts small blind 3500
Anton280395: posts big blind 7000
*** HOLE CARDS ***
Mandooo97: folds 
robko19: folds 
khurlee.ts: folds 
noway0ut_7: folds 
Imavere: folds 
ravenamber: folds 
Happy_Grubby: folds 
Uncalled bet (3500) returned to Anton280395
Anton280395 collected 15800 from pot
Anton280395: doesn't show hand 
*** SUMMARY ***
Total pot 15800 | Rake 0 
Seat 1: ravenamber (button) folded before Flop (didn't bet)
Seat 2: Happy_Grubby (small blind) folded before Flop
Seat 3: Anton280395 (big blind) collected (15800)
Seat 4: Mandooo97 folded before Flop (didn't bet)
Seat 5: robko19 folded before Flop (didn't bet)
Seat 6: khurlee.ts folded before Flop (didn't bet)
Seat 7: noway0ut_7 folded before Flop (didn't bet)
Seat 8: Imavere folded before Flop (didn't bet)

PokerStars Hand #250528334163: Tournament #3754315373, $4.80+$5.00+$1.20 USD Hold'em No Limit - Level XXXIII (3500/7000) - 2024/05/16 13:19:49 UTC [2024/05/16 9:19:49 ET]
Table '3754315373 2' 8-max Seat #1 is the button
Seat 1: ravenamber (215458 in chips, $32.49 bounty) 
Seat 2: Happy_Grubby (261703 in chips, $17.50 bounty) 
Seat 3: Anton280395 (276229 in chips, $21.56 bounty) 
Seat 4: Mandooo97 (314600 in chips, $23.75 bounty) 
Seat 5: robko19 (116211 in chips, $89.11 bounty) 
Seat 6: khurlee.ts (127954 in chips, $61.70 bounty) 
Seat 7: noway0ut_7 (297547 in chips, $47.94 bounty) 
Seat 8: Imavere (162570 in chips, $48.43 bounty) 
ravenamber: posts the ante 1100
Happy_Grubby: posts the ante 1100
Anton280395: posts the ante 1100
Mandooo97: posts the ante 1100
robko19: posts the ante 1100
khurlee.ts: posts the ante 1100
noway0ut_7: posts the ante 1100
Imavere: posts the ante 1100
Happy_Grubby: posts small blind 3500
Anton280395: posts big blind 7000
*** HOLE CARDS ***
Mandooo97: folds 
robko19: folds 
khurlee.ts: folds 
noway0ut_7: folds 
Imavere: folds 
ravenamber: folds 
Happy_Grubby: folds 
Uncalled bet (3500) returned to Anton280395
Anton280395 collected 15800 from pot
Anton280395: doesn't show hand 
*** SUMMARY ***
Total pot 15800 | Rake 0 
Seat 1: ravenamber (button) folded before Flop (didn't bet)
Seat 2: Happy_Grubby (small blind) folded before Flop
Seat 3: Anton280395 (big blind) collected (15800)
Seat 4: Mandooo97 folded before Flop (didn't bet)
Seat 5: robko19 folded before Flop (didn't bet)
Seat 6: khurlee.ts folded before Flop (didn't bet)
Seat 7: noway0ut_7 folded before Flop (didn't bet)
Seat 8: Imavere folded before Flop (didn't bet)

PokerStars Hand #250528337356: Tournament #3754315373, $4.80+$5.00+$1.20 USD Hold'em No Limit - Level XXXIII (3500/7000) - 2024/05/16 13:20:07 UTC [2024/05/16 9:20:07 ET]
Table '3754315373 2' 8-max Seat #2 is the button
Seat 1: ravenamber (214358 in chips, $32.49 bounty) 
Seat 2: Happy_Grubby (257103 in chips, $17.50 bounty) 
Seat 3: Anton280395 (287429 in chips, $21.56 bounty) 
Seat 4: Mandooo97 (313500 in chips, $23.75 bounty) 
Seat 5: robko19 (115111 in chips, $89.11 bounty) 
Seat 6: khurlee.ts (126854 in chips, $61.70 bounty) 
Seat 7: noway0ut_7 (296447 in chips, $47.94 bounty) 
Seat 8: Imavere (161470 in chips, $48.43 bounty) 
ravenamber: posts the ante 1100
Happy_Grubby: posts the ante 1100
Anton280395: posts the ante 1100
Mandooo97: posts the ante 1100
robko19: posts the ante 1100
khurlee.ts: posts the ante 1100
noway0ut_7: posts the ante 1100
Imavere: posts the ante 1100
Anton280395: posts small blind 3500
Mandooo97: posts big blind 7000
*** HOLE CARDS ***
robko19: folds 
khurlee.ts: folds 
noway0ut_7: folds 
Imavere: folds 
ravenamber: folds 
Happy_Grubby: folds 
Anton280395: raises 14000 to 21000
Mandooo97: folds 
Uncalled bet (14000) returned to Anton280395
Anton280395 collected 22800 from pot
Anton280395: doesn't show hand 
*** SUMMARY ***
Total pot 22800 | Rake 0 
Seat 1: ravenamber folded before Flop (didn't bet)
Seat 2: Happy_Grubby (button) folded before Flop (didn't bet)
Seat 3: Anton280395 (small blind) collected (22800)
Seat 4: Mandooo97 (big blind) folded before Flop
Seat 5: robko19 folded before Flop (didn't bet)
Seat 6: khurlee.ts folded before Flop (didn't bet)
Seat 7: noway0ut_7 folded before Flop (didn't bet)
Seat 8: Imavere folded before Flop (didn't bet)

PokerStars Hand #250528337356: Tournament #3754315373, $4.80+$5.00+$1.20 USD Hold'em No Limit - Level XXXIII (3500/7000) - 2024/05/16 13:20:07 UTC [2024/05/16 9:20:07 ET]
Table '3754315373 2' 8-max Seat #2 is the button
Seat 1: ravenamber (214358 in chips, $32.49 bounty) 
Seat 2: Happy_Grubby (257103 in chips, $17.50 bounty) 
Seat 3: Anton280395 (287429 in chips, $21.56 bounty) 
Seat 4: Mandooo97 (313500 in chips, $23.75 bounty) 
Seat 5: robko19 (115111 in chips, $89.11 bounty) 
Seat 6: khurlee.ts (126854 in chips, $61.70 bounty) 
Seat 7: noway0ut_7 (296447 in chips, $47.94 bounty) 
Seat 8: Imavere (161470 in chips, $48.43 bounty) 
ravenamber: posts the ante 1100
Happy_Grubby: posts the ante 1100
Anton280395: posts the ante 1100
Mandooo97: posts the ante 1100
robko19: posts the ante 1100
khurlee.ts: posts the ante 1100
noway0ut_7: posts the ante 1100
Imavere: posts the ante 1100
Anton280395: posts small blind 3500
Mandooo97: posts big blind 7000
*** HOLE CARDS ***
robko19: folds 
khurlee.ts: folds 
noway0ut_7: folds 
Imavere: folds 
ravenamber: folds 
Happy_Grubby: folds 
Anton280395: raises 14000 to 21000
Mandooo97: folds 
Uncalled bet (14000) returned to Anton280395
Anton280395 collected 22800 from pot
Anton280395: doesn't show hand 
*** SUMMARY ***
Total pot 22800 | Rake 0 
Seat 1: ravenamber folded before Flop (didn't bet)
Seat 2: Happy_Grubby (button) folded before Flop (didn't bet)
Seat 3: Anton280395 (small blind) collected (22800)
Seat 4: Mandooo97 (big blind) folded before Flop
Seat 5: robko19 folded before Flop (didn't bet)
Seat 6: khurlee.ts folded before Flop (didn't bet)
Seat 7: noway0ut_7 folded before Flop (didn't bet)
Seat 8: Imavere folded before Flop (didn't bet)

PokerStars Hand #250528341354: Tournament #3754315373, $4.80+$5.00+$1.20 USD Hold'em No Limit - Level XXXIII (3500/7000) - 2024/05/16 13:20:30 UTC [2024/05/16 9:20:30 ET]
Table '3754315373 2' 8-max Seat #3 is the button
Seat 1: ravenamber (213258 in chips, $32.49 bounty) 
Seat 2: Happy_Grubby (256003 in chips, $17.50 bounty) 
Seat 3: Anton280395 (302129 in chips, $21.56 bounty) 
Seat 4: Mandooo97 (305400 in chips, $23.75 bounty) 
Seat 5: robko19 (114011 in chips, $89.11 bounty) 
Seat 6: khurlee.ts (125754 in chips, $61.70 bounty) 
Seat 7: noway0ut_7 (295347 in chips, $47.94 bounty) 
Seat 8: Imavere (160370 in chips, $48.43 bounty) 
ravenamber: posts the ante 1100
Happy_Grubby: posts the ante 1100
Anton280395: posts the ante 1100
Mandooo97: posts the ante 1100
robko19: posts the ante 1100
khurlee.ts: posts the ante 1100
noway0ut_7: posts the ante 1100
Imavere: posts the ante 1100
Mandooo97: posts small blind 3500
robko19: posts big blind 7000
*** HOLE CARDS ***
khurlee.ts: folds 
noway0ut_7: folds 
Imavere: folds 
ravenamber: folds 
Happy_Grubby: folds 
Anton280395: raises 7000 to 14000
Mandooo97: folds 
robko19: folds 
Uncalled bet (7000) returned to Anton280395
Anton280395 collected 26300 from pot
Anton280395: doesn't show hand 
*** SUMMARY ***
Total pot 26300 | Rake 0 
Seat 1: ravenamber folded before Flop (didn't bet)
Seat 2: Happy_Grubby folded before Flop (didn't bet)
Seat 3: Anton280395 (button) collected (26300)
Seat 4: Mandooo97 (small blind) folded before Flop
Seat 5: robko19 (big blind) folded before Flop
Seat 6: khurlee.ts folded before Flop (didn't bet)
Seat 7: noway0ut_7 folded before Flop (didn't bet)
Seat 8: Imavere folded before Flop (didn't bet)

PokerStars Hand #250528341354: Tournament #3754315373, $4.80+$5.00+$1.20 USD Hold'em No Limit - Level XXXIII (3500/7000) - 2024/05/16 13:20:30 UTC [2024/05/16 9:20:30 ET]
Table '3754315373 2' 8-max Seat #3 is the button
Seat 1: ravenamber (213258 in chips, $32.49 bounty) 
Seat 2: Happy_Grubby (256003 in chips, $17.50 bounty) 
Seat 3: Anton280395 (302129 in chips, $21.56 bounty) 
Seat 4: Mandooo97 (305400 in chips, $23.75 bounty) 
Seat 5: robko19 (114011 in chips, $89.11 bounty) 
Seat 6: khurlee.ts (125754 in chips, $61.70 bounty) 
Seat 7: noway0ut_7 (295347 in chips, $47.94 bounty) 
Seat 8: Imavere (160370 in chips, $48.43 bounty) 
ravenamber: posts the ante 1100
Happy_Grubby: posts the ante 1100
Anton280395: posts the ante 1100
Mandooo97: posts the ante 1100
robko19: posts the ante 1100
khurlee.ts: posts the ante 1100
noway0ut_7: posts the ante 1100
Imavere: posts the ante 1100
Mandooo97: posts small blind 3500
robko19: posts big blind 7000
*** HOLE CARDS ***
khurlee.ts: folds 
noway0ut_7: folds 
Imavere: folds 
ravenamber: folds 
Happy_Grubby: folds 
Anton280395: raises 7000 to 14000
Mandooo97: folds 
robko19: folds 
Uncalled bet (7000) returned to Anton280395
Anton280395 collected 26300 from pot
Anton280395: doesn't show hand 
*** SUMMARY ***
Total pot 26300 | Rake 0 
Seat 1: ravenamber folded before Flop (didn't bet)
Seat 2: Happy_Grubby folded before Flop (didn't bet)
Seat 3: Anton280395 (button) collected (26300)
Seat 4: Mandooo97 (small blind) folded before Flop
Seat 5: robko19 (big blind) folded before Flop
Seat 6: khurlee.ts folded before Flop (didn't bet)
Seat 7: noway0ut_7 folded before Flop (didn't bet)
Seat 8: Imavere folded before Flop (didn't bet)

PokerStars Hand #250528345265: Tournament #3754315373, $4.80+$5.00+$1.20 USD Hold'em No Limit - Level XXXIII (3500/7000) - 2024/05/16 13:20:51 UTC [2024/05/16 9:20:51 ET]
Table '3754315373 2' 8-max Seat #4 is the button
Seat 1: ravenamber (212158 in chips, $32.49 bounty) 
Seat 2: Happy_Grubby (254903 in chips, $17.50 bounty) 
Seat 3: Anton280395 (320329 in chips, $21.56 bounty) 
Seat 4: Mandooo97 (300800 in chips, $23.75 bounty) 
Seat 5: robko19 (105911 in chips, $89.11 bounty) 
Seat 6: khurlee.ts (124654 in chips, $61.70 bounty) 
Seat 7: noway0ut_7 (294247 in chips, $47.94 bounty) 
Seat 8: Imavere (159270 in chips, $48.43 bounty) 
ravenamber: posts the ante 1100
Happy_Grubby: posts the ante 1100
Anton280395: posts the ante 1100
Mandooo97: posts the ante 1100
robko19: posts the ante 1100
khurlee.ts: posts the ante 1100
noway0ut_7: posts the ante 1100
Imavere: posts the ante 1100
robko19: posts small blind 3500
khurlee.ts: posts big blind 7000
*** HOLE CARDS ***
noway0ut_7: raises 8400 to 15400
Imavere: folds 
ravenamber: calls 15400
Happy_Grubby: folds 
Anton280395: folds 
Mandooo97: folds 
robko19: calls 11900
khurlee.ts: calls 8400
*** FLOP *** [9h 9s 9d]
robko19: bets 89411 and is all-in
khurlee.ts: folds 
noway0ut_7: folds 
ravenamber: calls 89411
*** TURN *** [9h 9s 9d] [8s]
*** RIVER *** [9h 9s 9d 8s] [Th]
*** SHOW DOWN ***
robko19: shows [Jc Jh] (a full house, Nines full of Jacks)
ravenamber: shows [7d 7c] (a full house, Nines full of Sevens)
robko19 collected 249222 from pot
*** SUMMARY ***
Total pot 249222 | Rake 0 
Board [9h 9s 9d 8s Th]
Seat 1: ravenamber showed [7d 7c] and lost with a full house, Nines full of Sevens
Seat 2: Happy_Grubby folded before Flop (didn't bet)
Seat 3: Anton280395 folded before Flop (didn't bet)
Seat 4: Mandooo97 (button) folded before Flop (didn't bet)
Seat 5: robko19 (small blind) showed [Jc Jh] and won (249222) with a full house, Nines full of Jacks
Seat 6: khurlee.ts (big blind) folded on the Flop
Seat 7: noway0ut_7 folded on the Flop
Seat 8: Imavere folded before Flop (didn't bet)

PokerStars Hand #250528345265: Tournament #3754315373, $4.80+$5.00+$1.20 USD Hold'em No Limit - Level XXXIII (3500/7000) - 2024/05/16 13:20:51 UTC [2024/05/16 9:20:51 ET]
Table '3754315373 2' 8-max Seat #4 is the button
Seat 1: ravenamber (212158 in chips, $32.49 bounty) 
Seat 2: Happy_Grubby (254903 in chips, $17.50 bounty) 
Seat 3: Anton280395 (320329 in chips, $21.56 bounty) 
Seat 4: Mandooo97 (300800 in chips, $23.75 bounty) 
Seat 5: robko19 (105911 in chips, $89.11 bounty) 
Seat 6: khurlee.ts (124654 in chips, $61.70 bounty) 
Seat 7: noway0ut_7 (294247 in chips, $47.94 bounty) 
Seat 8: Imavere (159270 in chips, $48.43 bounty) 
ravenamber: posts the ante 1100
Happy_Grubby: posts the ante 1100
Anton280395: posts the ante 1100
Mandooo97: posts the ante 1100
robko19: posts the ante 1100
khurlee.ts: posts the ante 1100
noway0ut_7: posts the ante 1100
Imavere: posts the ante 1100
robko19: posts small blind 3500
khurlee.ts: posts big blind 7000
*** HOLE CARDS ***
noway0ut_7: raises 8400 to 15400
Imavere: folds 
ravenamber: calls 15400
Happy_Grubby: folds 
Anton280395: folds 
Mandooo97: folds 
robko19: calls 11900
khurlee.ts: calls 8400
*** FLOP *** [9h 9s 9d]
robko19: bets 89411 and is all-in
khurlee.ts: folds 
noway0ut_7: folds 
ravenamber: calls 89411
*** TURN *** [9h 9s 9d] [8s]
*** RIVER *** [9h 9s 9d 8s] [Th]
*** SHOW DOWN ***
robko19: shows [Jc Jh] (a full house, Nines full of Jacks)
ravenamber: shows [7d 7c] (a full house, Nines full of Sevens)
robko19 collected 249222 from pot
*** SUMMARY ***
Total pot 249222 | Rake 0 
Board [9h 9s 9d 8s Th]
Seat 1: ravenamber showed [7d 7c] and lost with a full house, Nines full of Sevens
Seat 2: Happy_Grubby folded before Flop (didn't bet)
Seat 3: Anton280395 folded before Flop (didn't bet)
Seat 4: Mandooo97 (button) folded before Flop (didn't bet)
Seat 5: robko19 (small blind) showed [Jc Jh] and won (249222) with a full house, Nines full of Jacks
Seat 6: khurlee.ts (big blind) folded on the Flop
Seat 7: noway0ut_7 folded on the Flop
Seat 8: Imavere folded before Flop (didn't bet)

PokerStars Hand #250528353221: Tournament #3754315373, $4.80+$5.00+$1.20 USD Hold'em No Limit - Level XXXIII (3500/7000) - 2024/05/16 13:21:37 UTC [2024/05/16 9:21:37 ET]
Table '3754315373 2' 8-max Seat #5 is the button
Seat 1: ravenamber (106247 in chips, $32.49 bounty) 
Seat 2: Happy_Grubby (253803 in chips, $17.50 bounty) 
Seat 3: Anton280395 (319229 in chips, $21.56 bounty) 
Seat 4: Mandooo97 (299700 in chips, $23.75 bounty) 
Seat 5: robko19 (249222 in chips, $89.11 bounty) 
Seat 6: khurlee.ts (108154 in chips, $61.70 bounty) 
Seat 7: noway0ut_7 (277747 in chips, $47.94 bounty) 
Seat 8: Imavere (158170 in chips, $48.43 bounty) 
ravenamber: posts the ante 1100
Happy_Grubby: posts the ante 1100
Anton280395: posts the ante 1100
Mandooo97: posts the ante 1100
robko19: posts the ante 1100
khurlee.ts: posts the ante 1100
noway0ut_7: posts the ante 1100
Imavere: posts the ante 1100
khurlee.ts: posts small blind 3500
noway0ut_7: posts big blind 7000
*** HOLE CARDS ***
Imavere: folds 
ravenamber: folds 
Happy_Grubby: raises 7000 to 14000
Anton280395: folds 
Mandooo97: folds 
robko19: folds 
khurlee.ts: raises 93054 to 107054 and is all-in
noway0ut_7: folds 
Happy_Grubby: folds 
Uncalled bet (93054) returned to khurlee.ts
khurlee.ts collected 43800 from pot
khurlee.ts: doesn't show hand 
*** SUMMARY ***
Total pot 43800 | Rake 0 
Seat 1: ravenamber folded before Flop (didn't bet)
Seat 2: Happy_Grubby folded before Flop
Seat 3: Anton280395 folded before Flop (didn't bet)
Seat 4: Mandooo97 folded before Flop (didn't bet)
Seat 5: robko19 (button) folded before Flop (didn't bet)
Seat 6: khurlee.ts (small blind) collected (43800)
Seat 7: noway0ut_7 (big blind) folded before Flop
Seat 8: Imavere folded before Flop (didn't bet)

PokerStars Hand #250528353221: Tournament #3754315373, $4.80+$5.00+$1.20 USD Hold'em No Limit - Level XXXIII (3500/7000) - 2024/05/16 13:21:37 UTC [2024/05/16 9:21:37 ET]
Table '3754315373 2' 8-max Seat #5 is the button
Seat 1: ravenamber (106247 in chips, $32.49 bounty) 
Seat 2: Happy_Grubby (253803 in chips, $17.50 bounty) 
Seat 3: Anton280395 (319229 in chips, $21.56 bounty) 
Seat 4: Mandooo97 (299700 in chips, $23.75 bounty) 
Seat 5: robko19 (249222 in chips, $89.11 bounty) 
Seat 6: khurlee.ts (108154 in chips, $61.70 bounty) 
Seat 7: noway0ut_7 (277747 in chips, $47.94 bounty) 
Seat 8: Imavere (158170 in chips, $48.43 bounty) 
ravenamber: posts the ante 1100
Happy_Grubby: posts the ante 1100
Anton280395: posts the ante 1100
Mandooo97: posts the ante 1100
robko19: posts the ante 1100
khurlee.ts: posts the ante 1100
noway0ut_7: posts the ante 1100
Imavere: posts the ante 1100
khurlee.ts: posts small blind 3500
noway0ut_7: posts big blind 7000
*** HOLE CARDS ***
Imavere: folds 
ravenamber: folds 
Happy_Grubby: raises 7000 to 14000
Anton280395: folds 
Mandooo97: folds 
robko19: folds 
khurlee.ts: raises 93054 to 107054 and is all-in
noway0ut_7: folds 
Happy_Grubby: folds 
Uncalled bet (93054) returned to khurlee.ts
khurlee.ts collected 43800 from pot
khurlee.ts: doesn't show hand 
*** SUMMARY ***
Total pot 43800 | Rake 0 
Seat 1: ravenamber folded before Flop (didn't bet)
Seat 2: Happy_Grubby folded before Flop
Seat 3: Anton280395 folded before Flop (didn't bet)
Seat 4: Mandooo97 folded before Flop (didn't bet)
Seat 5: robko19 (button) folded before Flop (didn't bet)
Seat 6: khurlee.ts (small blind) collected (43800)
Seat 7: noway0ut_7 (big blind) folded before Flop
Seat 8: Imavere folded before Flop (didn't bet)

PokerStars Hand #250528358998: Tournament #3754315373, $4.80+$5.00+$1.20 USD Hold'em No Limit - Level XXXIII (3500/7000) - 2024/05/16 13:22:09 UTC [2024/05/16 9:22:09 ET]
Table '3754315373 2' 8-max Seat #6 is the button
Seat 1: ravenamber (105147 in chips, $32.49 bounty) 
Seat 2: Happy_Grubby (238703 in chips, $17.50 bounty) 
Seat 3: Anton280395 (318129 in chips, $21.56 bounty) 
Seat 4: Mandooo97 (298600 in chips, $23.75 bounty) 
Seat 5: robko19 (248122 in chips, $89.11 bounty) 
Seat 6: khurlee.ts (136854 in chips, $61.70 bounty) 
Seat 7: noway0ut_7 (269647 in chips, $47.94 bounty) 
Seat 8: Imavere (157070 in chips, $48.43 bounty) 
ravenamber: posts the ante 1100
Happy_Grubby: posts the ante 1100
Anton280395: posts the ante 1100
Mandooo97: posts the ante 1100
robko19: posts the ante 1100
khurlee.ts: posts the ante 1100
noway0ut_7: posts the ante 1100
Imavere: posts the ante 1100
noway0ut_7: posts small blind 3500
Imavere: posts big blind 7000
*** HOLE CARDS ***
ravenamber: folds 
Happy_Grubby: folds 
Anton280395: raises 7000 to 14000
Mandooo97: folds 
robko19: folds 
khurlee.ts: raises 121754 to 135754 and is all-in
noway0ut_7: folds 
Imavere: folds 
Anton280395: folds 
Uncalled bet (121754) returned to khurlee.ts
khurlee.ts collected 47300 from pot
khurlee.ts: doesn't show hand 
*** SUMMARY ***
Total pot 47300 | Rake 0 
Seat 1: ravenamber folded before Flop (didn't bet)
Seat 2: Happy_Grubby folded before Flop (didn't bet)
Seat 3: Anton280395 folded before Flop
Seat 4: Mandooo97 folded before Flop (didn't bet)
Seat 5: robko19 folded before Flop (didn't bet)
Seat 6: khurlee.ts (button) collected (47300)
Seat 7: noway0ut_7 (small blind) folded before Flop
Seat 8: Imavere (big blind) folded before Flop

PokerStars Hand #250528358998: Tournament #3754315373, $4.80+$5.00+$1.20 USD Hold'em No Limit - Level XXXIII (3500/7000) - 2024/05/16 13:22:09 UTC [2024/05/16 9:22:09 ET]
Table '3754315373 2' 8-max Seat #6 is the button
Seat 1: ravenamber (105147 in chips, $32.49 bounty) 
Seat 2: Happy_Grubby (238703 in chips, $17.50 bounty) 
Seat 3: Anton280395 (318129 in chips, $21.56 bounty) 
Seat 4: Mandooo97 (298600 in chips, $23.75 bounty) 
Seat 5: robko19 (248122 in chips, $89.11 bounty) 
Seat 6: khurlee.ts (136854 in chips, $61.70 bounty) 
Seat 7: noway0ut_7 (269647 in chips, $47.94 bounty) 
Seat 8: Imavere (157070 in chips, $48.43 bounty) 
ravenamber: posts the ante 1100
Happy_Grubby: posts the ante 1100
Anton280395: posts the ante 1100
Mandooo97: posts the ante 1100
robko19: posts the ante 1100
khurlee.ts: posts the ante 1100
noway0ut_7: posts the ante 1100
Imavere: posts the ante 1100
noway0ut_7: posts small blind 3500
Imavere: posts big blind 7000
*** HOLE CARDS ***
ravenamber: folds 
Happy_Grubby: folds 
Anton280395: raises 7000 to 14000
Mandooo97: folds 
robko19: folds 
khurlee.ts: raises 121754 to 135754 and is all-in
noway0ut_7: folds 
Imavere: folds 
Anton280395: folds 
Uncalled bet (121754) returned to khurlee.ts
khurlee.ts collected 47300 from pot
khurlee.ts: doesn't show hand 
*** SUMMARY ***
Total pot 47300 | Rake 0 
Seat 1: ravenamber folded before Flop (didn't bet)
Seat 2: Happy_Grubby folded before Flop (didn't bet)
Seat 3: Anton280395 folded before Flop
Seat 4: Mandooo97 folded before Flop (didn't bet)
Seat 5: robko19 folded before Flop (didn't bet)
Seat 6: khurlee.ts (button) collected (47300)
Seat 7: noway0ut_7 (small blind) folded before Flop
Seat 8: Imavere (big blind) folded before Flop

PokerStars Hand #250528363201: Tournament #3754315373, $4.80+$5.00+$1.20 USD Hold'em No Limit - Level XXXIII (3500/7000) - 2024/05/16 13:22:33 UTC [2024/05/16 9:22:33 ET]
Table '3754315373 2' 8-max Seat #7 is the button
Seat 1: ravenamber (104047 in chips, $32.49 bounty) 
Seat 2: Happy_Grubby (237603 in chips, $17.50 bounty) 
Seat 3: Anton280395 (303029 in chips, $21.56 bounty) 
Seat 4: Mandooo97 (297500 in chips, $23.75 bounty) 
Seat 5: robko19 (247022 in chips, $89.11 bounty) 
Seat 6: khurlee.ts (169054 in chips, $61.70 bounty) 
Seat 7: noway0ut_7 (265047 in chips, $47.94 bounty) 
Seat 8: Imavere (148970 in chips, $48.43 bounty) 
ravenamber: posts the ante 1100
Happy_Grubby: posts the ante 1100
Anton280395: posts the ante 1100
Mandooo97: posts the ante 1100
robko19: posts the ante 1100
khurlee.ts: posts the ante 1100
noway0ut_7: posts the ante 1100
Imavere: posts the ante 1100
Imavere: posts small blind 3500
ravenamber: posts big blind 7000
*** HOLE CARDS ***
Happy_Grubby: folds 
Anton280395: folds 
Mandooo97: folds 
robko19: folds 
khurlee.ts: raises 7000 to 14000
noway0ut_7: folds 
Imavere: folds 
ravenamber: calls 7000
*** FLOP *** [5c 3d 9c]
ravenamber: bets 88947 and is all-in
khurlee.ts: folds 
Uncalled bet (88947) returned to ravenamber
ravenamber collected 40300 from pot
ravenamber: doesn't show hand 
*** SUMMARY ***
Total pot 40300 | Rake 0 
Board [5c 3d 9c]
Seat 1: ravenamber (big blind) collected (40300)
Seat 2: Happy_Grubby folded before Flop (didn't bet)
Seat 3: Anton280395 folded before Flop (didn't bet)
Seat 4: Mandooo97 folded before Flop (didn't bet)
Seat 5: robko19 folded before Flop (didn't bet)
Seat 6: khurlee.ts folded on the Flop
Seat 7: noway0ut_7 (button) folded before Flop (didn't bet)
Seat 8: Imavere (small blind) folded before Flop

PokerStars Hand #250528363201: Tournament #3754315373, $4.80+$5.00+$1.20 USD Hold'em No Limit - Level XXXIII (3500/7000) - 2024/05/16 13:22:33 UTC [2024/05/16 9:22:33 ET]
Table '3754315373 2' 8-max Seat #7 is the button
Seat 1: ravenamber (104047 in chips, $32.49 bounty) 
Seat 2: Happy_Grubby (237603 in chips, $17.50 bounty) 
Seat 3: Anton280395 (303029 in chips, $21.56 bounty) 
Seat 4: Mandooo97 (297500 in chips, $23.75 bounty) 
Seat 5: robko19 (247022 in chips, $89.11 bounty) 
Seat 6: khurlee.ts (169054 in chips, $61.70 bounty) 
Seat 7: noway0ut_7 (265047 in chips, $47.94 bounty) 
Seat 8: Imavere (148970 in chips, $48.43 bounty) 
ravenamber: posts the ante 1100
Happy_Grubby: posts the ante 1100
Anton280395: posts the ante 1100
Mandooo97: posts the ante 1100
robko19: posts the ante 1100
khurlee.ts: posts the ante 1100
noway0ut_7: posts the ante 1100
Imavere: posts the ante 1100
Imavere: posts small blind 3500
ravenamber: posts big blind 7000
*** HOLE CARDS ***
Happy_Grubby: folds 
Anton280395: folds 
Mandooo97: folds 
robko19: folds 
khurlee.ts: raises 7000 to 14000
noway0ut_7: folds 
Imavere: folds 
ravenamber: calls 7000
*** FLOP *** [5c 3d 9c]
ravenamber: bets 88947 and is all-in
khurlee.ts: folds 
Uncalled bet (88947) returned to ravenamber
ravenamber collected 40300 from pot
ravenamber: doesn't show hand 
*** SUMMARY ***
Total pot 40300 | Rake 0 
Board [5c 3d 9c]
Seat 1: ravenamber (big blind) collected (40300)
Seat 2: Happy_Grubby folded before Flop (didn't bet)
Seat 3: Anton280395 folded before Flop (didn't bet)
Seat 4: Mandooo97 folded before Flop (didn't bet)
Seat 5: robko19 folded before Flop (didn't bet)
Seat 6: khurlee.ts folded on the Flop
Seat 7: noway0ut_7 (button) folded before Flop (didn't bet)
Seat 8: Imavere (small blind) folded before Flop

PokerStars Hand #250528373032: Tournament #3754315373, $4.80+$5.00+$1.20 USD Hold'em No Limit - Level XXXIII (3500/7000) - 2024/05/16 13:23:28 UTC [2024/05/16 9:23:28 ET]
Table '3754315373 2' 8-max Seat #8 is the button
Seat 1: ravenamber (129247 in chips, $32.49 bounty) 
Seat 2: Happy_Grubby (236503 in chips, $17.50 bounty) 
Seat 3: Anton280395 (301929 in chips, $21.56 bounty) 
Seat 4: Mandooo97 (296400 in chips, $23.75 bounty) 
Seat 5: robko19 (245922 in chips, $89.11 bounty) 
Seat 6: khurlee.ts (153954 in chips, $61.70 bounty) 
Seat 7: noway0ut_7 (263947 in chips, $47.94 bounty) 
Seat 8: Imavere (144370 in chips, $48.43 bounty) 
ravenamber: posts the ante 1100
Happy_Grubby: posts the ante 1100
Anton280395: posts the ante 1100
Mandooo97: posts the ante 1100
robko19: posts the ante 1100
khurlee.ts: posts the ante 1100
noway0ut_7: posts the ante 1100
Imavere: posts the ante 1100
ravenamber: posts small blind 3500
Happy_Grubby: posts big blind 7000
*** HOLE CARDS ***
Anton280395: folds 
Mandooo97: raises 7000 to 14000
robko19: folds 
khurlee.ts: raises 138854 to 152854 and is all-in
noway0ut_7: folds 
Imavere: folds 
ravenamber: folds 
Happy_Grubby: folds 
Mandooo97: folds 
Uncalled bet (138854) returned to khurlee.ts
khurlee.ts collected 47300 from pot
khurlee.ts: doesn't show hand 
*** SUMMARY ***
Total pot 47300 | Rake 0 
Seat 1: ravenamber (small blind) folded before Flop
Seat 2: Happy_Grubby (big blind) folded before Flop
Seat 3: Anton280395 folded before Flop (didn't bet)
Seat 4: Mandooo97 folded before Flop
Seat 5: robko19 folded before Flop (didn't bet)
Seat 6: khurlee.ts collected (47300)
Seat 7: noway0ut_7 folded before Flop (didn't bet)
Seat 8: Imavere (button) folded before Flop (didn't bet)

PokerStars Hand #250528373032: Tournament #3754315373, $4.80+$5.00+$1.20 USD Hold'em No Limit - Level XXXIII (3500/7000) - 2024/05/16 13:23:28 UTC [2024/05/16 9:23:28 ET]
Table '3754315373 2' 8-max Seat #8 is the button
Seat 1: ravenamber (129247 in chips, $32.49 bounty) 
Seat 2: Happy_Grubby (236503 in chips, $17.50 bounty) 
Seat 3: Anton280395 (301929 in chips, $21.56 bounty) 
Seat 4: Mandooo97 (296400 in chips, $23.75 bounty) 
Seat 5: robko19 (245922 in chips, $89.11 bounty) 
Seat 6: khurlee.ts (153954 in chips, $61.70 bounty) 
Seat 7: noway0ut_7 (263947 in chips, $47.94 bounty) 
Seat 8: Imavere (144370 in chips, $48.43 bounty) 
ravenamber: posts the ante 1100
Happy_Grubby: posts the ante 1100
Anton280395: posts the ante 1100
Mandooo97: posts the ante 1100
robko19: posts the ante 1100
khurlee.ts: posts the ante 1100
noway0ut_7: posts the ante 1100
Imavere: posts the ante 1100
ravenamber: posts small blind 3500
Happy_Grubby: posts big blind 7000
*** HOLE CARDS ***
Anton280395: folds 
Mandooo97: raises 7000 to 14000
robko19: folds 
khurlee.ts: raises 138854 to 152854 and is all-in
noway0ut_7: folds 
Imavere: folds 
ravenamber: folds 
Happy_Grubby: folds 
Mandooo97: folds 
Uncalled bet (138854) returned to khurlee.ts
khurlee.ts collected 47300 from pot
khurlee.ts: doesn't show hand 
*** SUMMARY ***
Total pot 47300 | Rake 0 
Seat 1: ravenamber (small blind) folded before Flop
Seat 2: Happy_Grubby (big blind) folded before Flop
Seat 3: Anton280395 folded before Flop (didn't bet)
Seat 4: Mandooo97 folded before Flop
Seat 5: robko19 folded before Flop (didn't bet)
Seat 6: khurlee.ts collected (47300)
Seat 7: noway0ut_7 folded before Flop (didn't bet)
Seat 8: Imavere (button) folded before Flop (didn't bet)

PokerStars Hand #250528379000: Tournament #3754315373, $4.80+$5.00+$1.20 USD Hold'em No Limit - Level XXXIII (3500/7000) - 2024/05/16 13:24:01 UTC [2024/05/16 9:24:01 ET]
Table '3754315373 2' 8-max Seat #1 is the button
Seat 1: ravenamber (124647 in chips, $32.49 bounty) 
Seat 2: Happy_Grubby (228403 in chips, $17.50 bounty) 
Seat 3: Anton280395 (300829 in chips, $21.56 bounty) 
Seat 4: Mandooo97 (281300 in chips, $23.75 bounty) 
Seat 5: robko19 (244822 in chips, $89.11 bounty) 
Seat 6: khurlee.ts (186154 in chips, $61.70 bounty) 
Seat 7: noway0ut_7 (262847 in chips, $47.94 bounty) 
Seat 8: Imavere (143270 in chips, $48.43 bounty) 
ravenamber: posts the ante 1100
Happy_Grubby: posts the ante 1100
Anton280395: posts the ante 1100
Mandooo97: posts the ante 1100
robko19: posts the ante 1100
khurlee.ts: posts the ante 1100
noway0ut_7: posts the ante 1100
Imavere: posts the ante 1100
Happy_Grubby: posts small blind 3500
Anton280395: posts big blind 7000
*** HOLE CARDS ***
Mandooo97: folds 
robko19: raises 11200 to 18200
khurlee.ts: folds 
noway0ut_7: folds 
Imavere: folds 
ravenamber: folds 
Happy_Grubby: folds 
Anton280395: raises 37800 to 56000
robko19: calls 37800
*** FLOP *** [Kc 7d Kd]
Anton280395: checks 
robko19: checks 
*** TURN *** [Kc 7d Kd] [8s]
Anton280395: bets 21000
robko19: calls 21000
*** RIVER *** [Kc 7d Kd 8s] [5c]
Anton280395: bets 21000
robko19: calls 21000
*** SHOW DOWN ***
Anton280395: shows [As Ad] (two pair, Aces and Kings)
robko19: mucks hand 
Anton280395 collected 208300 from pot
*** SUMMARY ***
Total pot 208300 | Rake 0 
Board [Kc 7d Kd 8s 5c]
Seat 1: ravenamber (button) folded before Flop (didn't bet)
Seat 2: Happy_Grubby (small blind) folded before Flop
Seat 3: Anton280395 (big blind) showed [As Ad] and won (208300) with two pair, Aces and Kings
Seat 4: Mandooo97 folded before Flop (didn't bet)
Seat 5: robko19 mucked
Seat 6: khurlee.ts folded before Flop (didn't bet)
Seat 7: noway0ut_7 folded before Flop (didn't bet)
Seat 8: Imavere folded before Flop (didn't bet)

PokerStars Hand #250528379000: Tournament #3754315373, $4.80+$5.00+$1.20 USD Hold'em No Limit - Level XXXIII (3500/7000) - 2024/05/16 13:24:01 UTC [2024/05/16 9:24:01 ET]
Table '3754315373 2' 8-max Seat #1 is the button
Seat 1: ravenamber (124647 in chips, $32.49 bounty) 
Seat 2: Happy_Grubby (228403 in chips, $17.50 bounty) 
Seat 3: Anton280395 (300829 in chips, $21.56 bounty) 
Seat 4: Mandooo97 (281300 in chips, $23.75 bounty) 
Seat 5: robko19 (244822 in chips, $89.11 bounty) 
Seat 6: khurlee.ts (186154 in chips, $61.70 bounty) 
Seat 7: noway0ut_7 (262847 in chips, $47.94 bounty) 
Seat 8: Imavere (143270 in chips, $48.43 bounty) 
ravenamber: posts the ante 1100
Happy_Grubby: posts the ante 1100
Anton280395: posts the ante 1100
Mandooo97: posts the ante 1100
robko19: posts the ante 1100
khurlee.ts: posts the ante 1100
noway0ut_7: posts the ante 1100
Imavere: posts the ante 1100
Happy_Grubby: posts small blind 3500
Anton280395: posts big blind 7000
*** HOLE CARDS ***
Mandooo97: folds 
robko19: raises 11200 to 18200
khurlee.ts: folds 
noway0ut_7: folds 
Imavere: folds 
ravenamber: folds 
Happy_Grubby: folds 
Anton280395: raises 37800 to 56000
robko19: calls 37800
*** FLOP *** [Kc 7d Kd]
Anton280395: checks 
robko19: checks 
*** TURN *** [Kc 7d Kd] [8s]
Anton280395: bets 21000
robko19: calls 21000
*** RIVER *** [Kc 7d Kd 8s] [5c]
Anton280395: bets 21000
robko19: calls 21000
*** SHOW DOWN ***
Anton280395: shows [As Ad] (two pair, Aces and Kings)
robko19: mucks hand 
Anton280395 collected 208300 from pot
*** SUMMARY ***
Total pot 208300 | Rake 0 
Board [Kc 7d Kd 8s 5c]
Seat 1: ravenamber (button) folded before Flop (didn't bet)
Seat 2: Happy_Grubby (small blind) folded before Flop
Seat 3: Anton280395 (big blind) showed [As Ad] and won (208300) with two pair, Aces and Kings
Seat 4: Mandooo97 folded before Flop (didn't bet)
Seat 5: robko19 mucked
Seat 6: khurlee.ts folded before Flop (didn't bet)
Seat 7: noway0ut_7 folded before Flop (didn't bet)
Seat 8: Imavere folded before Flop (didn't bet)

PokerStars Hand #250528390887: Tournament #3754315373, $4.80+$5.00+$1.20 USD Hold'em No Limit - Level XXXIII (3500/7000) - 2024/05/16 13:25:08 UTC [2024/05/16 9:25:08 ET]
Table '3754315373 2' 8-max Seat #2 is the button
Seat 1: ravenamber (123547 in chips, $32.49 bounty) 
Seat 2: Happy_Grubby (223803 in chips, $17.50 bounty) 
Seat 3: Anton280395 (410029 in chips, $21.56 bounty) 
Seat 4: Mandooo97 (280200 in chips, $23.75 bounty) 
Seat 5: robko19 (145722 in chips, $89.11 bounty) 
Seat 6: khurlee.ts (185054 in chips, $61.70 bounty) 
Seat 7: noway0ut_7 (261747 in chips, $47.94 bounty) 
Seat 8: Imavere (142170 in chips, $48.43 bounty) 
ravenamber: posts the ante 1100
Happy_Grubby: posts the ante 1100
Anton280395: posts the ante 1100
Mandooo97: posts the ante 1100
robko19: posts the ante 1100
khurlee.ts: posts the ante 1100
noway0ut_7: posts the ante 1100
Imavere: posts the ante 1100
Anton280395: posts small blind 3500
Mandooo97: posts big blind 7000
*** HOLE CARDS ***
robko19: raises 137622 to 144622 and is all-in
khurlee.ts: folds 
noway0ut_7: folds 
Imavere: folds 
ravenamber: folds 
Happy_Grubby: folds 
Anton280395: folds 
Mandooo97: calls 137622
*** FLOP *** [Qd 8c 5c]
*** TURN *** [Qd 8c 5c] [5h]
*** RIVER *** [Qd 8c 5c 5h] [2h]
*** SHOW DOWN ***
Mandooo97: shows [Ad Ah] (two pair, Aces and Fives)
robko19: shows [As Qs] (two pair, Queens and Fives)
Mandooo97 collected 301544 from pot
Mandooo97 wins $44.56 for eliminating robko19 and their own bounty increases by $44.55 to $68.30
robko19 finished the tournament in 15th place and received $29.78.
*** SUMMARY ***
Total pot 301544 | Rake 0 
Board [Qd 8c 5c 5h 2h]
Seat 1: ravenamber folded before Flop (didn't bet)
Seat 2: Happy_Grubby (button) folded before Flop (didn't bet)
Seat 3: Anton280395 (small blind) folded before Flop
Seat 4: Mandooo97 (big blind) showed [Ad Ah] and won (301544) with two pair, Aces and Fives
Seat 5: robko19 showed [As Qs] and lost with two pair, Queens and Fives
Seat 6: khurlee.ts folded before Flop (didn't bet)
Seat 7: noway0ut_7 folded before Flop (didn't bet)
Seat 8: Imavere folded before Flop (didn't bet)

PokerStars Hand #250528390887: Tournament #3754315373, $4.80+$5.00+$1.20 USD Hold'em No Limit - Level XXXIII (3500/7000) - 2024/05/16 13:25:08 UTC [2024/05/16 9:25:08 ET]
Table '3754315373 2' 8-max Seat #2 is the button
Seat 1: ravenamber (123547 in chips, $32.49 bounty) 
Seat 2: Happy_Grubby (223803 in chips, $17.50 bounty) 
Seat 3: Anton280395 (410029 in chips, $21.56 bounty) 
Seat 4: Mandooo97 (280200 in chips, $23.75 bounty) 
Seat 5: robko19 (145722 in chips, $89.11 bounty) 
Seat 6: khurlee.ts (185054 in chips, $61.70 bounty) 
Seat 7: noway0ut_7 (261747 in chips, $47.94 bounty) 
Seat 8: Imavere (142170 in chips, $48.43 bounty) 
ravenamber: posts the ante 1100
Happy_Grubby: posts the ante 1100
Anton280395: posts the ante 1100
Mandooo97: posts the ante 1100
robko19: posts the ante 1100
khurlee.ts: posts the ante 1100
noway0ut_7: posts the ante 1100
Imavere: posts the ante 1100
Anton280395: posts small blind 3500
Mandooo97: posts big blind 7000
*** HOLE CARDS ***
robko19: raises 137622 to 144622 and is all-in
khurlee.ts: folds 
noway0ut_7: folds 
Imavere: folds 
ravenamber: folds 
Happy_Grubby: folds 
Anton280395: folds 
Mandooo97: calls 137622
*** FLOP *** [Qd 8c 5c]
*** TURN *** [Qd 8c 5c] [5h]
*** RIVER *** [Qd 8c 5c 5h] [2h]
*** SHOW DOWN ***
Mandooo97: shows [Ad Ah] (two pair, Aces and Fives)
robko19: shows [As Qs] (two pair, Queens and Fives)
Mandooo97 collected 301544 from pot
Mandooo97 wins $44.56 for eliminating robko19 and their own bounty increases by $44.55 to $68.30
robko19 finished the tournament in 15th place and received $29.78.
*** SUMMARY ***
Total pot 301544 | Rake 0 
Board [Qd 8c 5c 5h 2h]
Seat 1: ravenamber folded before Flop (didn't bet)
Seat 2: Happy_Grubby (button) folded before Flop (didn't bet)
Seat 3: Anton280395 (small blind) folded before Flop
Seat 4: Mandooo97 (big blind) showed [Ad Ah] and won (301544) with two pair, Aces and Fives
Seat 5: robko19 showed [As Qs] and lost with two pair, Queens and Fives
Seat 6: khurlee.ts folded before Flop (didn't bet)
Seat 7: noway0ut_7 folded before Flop (didn't bet)
Seat 8: Imavere folded before Flop (didn't bet)

PokerStars Hand #250528396594: Tournament #3754315373, $4.80+$5.00+$1.20 USD Hold'em No Limit - Level XXXIV (4000/8000) - 2024/05/16 13:25:39 UTC [2024/05/16 9:25:39 ET]
Table '3754315373 2' 8-max Seat #3 is the button
Seat 1: ravenamber (122447 in chips, $32.49 bounty) 
Seat 2: Happy_Grubby (222703 in chips, $17.50 bounty) 
Seat 3: Anton280395 (405429 in chips, $21.56 bounty) 
Seat 4: Mandooo97 (436022 in chips, $68.30 bounty) 
Seat 6: khurlee.ts (183954 in chips, $61.70 bounty) 
Seat 7: noway0ut_7 (260647 in chips, $47.94 bounty) 
Seat 8: Imavere (141070 in chips, $48.43 bounty) 
ravenamber: posts the ante 1200
Happy_Grubby: posts the ante 1200
Anton280395: posts the ante 1200
Mandooo97: posts the ante 1200
khurlee.ts: posts the ante 1200
noway0ut_7: posts the ante 1200
Imavere: posts the ante 1200
Mandooo97: posts small blind 4000
khurlee.ts: posts big blind 8000
*** HOLE CARDS ***
noway0ut_7: folds 
Imavere: folds 
ravenamber: raises 113247 to 121247 and is all-in
Happy_Grubby: folds 
Anton280395: raises 282982 to 404229 and is all-in
Mandooo97: folds 
khurlee.ts: folds 
Uncalled bet (282982) returned to Anton280395
*** FLOP *** [6c 4d Jc]
*** TURN *** [6c 4d Jc] [Th]
*** RIVER *** [6c 4d Jc Th] [2s]
*** SHOW DOWN ***
ravenamber: shows [9s 9c] (a pair of Nines)
Anton280395: shows [Qc Qs] (a pair of Queens)
Anton280395 collected 262894 from pot
Anton280395 wins $16.25 for eliminating ravenamber and their own bounty increases by $16.24 to $37.80
ravenamber finished the tournament in 14th place and received $29.78.
*** SUMMARY ***
Total pot 262894 | Rake 0 
Board [6c 4d Jc Th 2s]
Seat 1: ravenamber showed [9s 9c] and lost with a pair of Nines
Seat 2: Happy_Grubby folded before Flop (didn't bet)
Seat 3: Anton280395 (button) showed [Qc Qs] and won (262894) with a pair of Queens
Seat 4: Mandooo97 (small blind) folded before Flop
Seat 6: khurlee.ts (big blind) folded before Flop
Seat 7: noway0ut_7 folded before Flop (didn't bet)
Seat 8: Imavere folded before Flop (didn't bet)

PokerStars Hand #250528396594: Tournament #3754315373, $4.80+$5.00+$1.20 USD Hold'em No Limit - Level XXXIV (4000/8000) - 2024/05/16 13:25:39 UTC [2024/05/16 9:25:39 ET]
Table '3754315373 2' 8-max Seat #3 is the button
Seat 1: ravenamber (122447 in chips, $32.49 bounty) 
Seat 2: Happy_Grubby (222703 in chips, $17.50 bounty) 
Seat 3: Anton280395 (405429 in chips, $21.56 bounty) 
Seat 4: Mandooo97 (436022 in chips, $68.30 bounty) 
Seat 6: khurlee.ts (183954 in chips, $61.70 bounty) 
Seat 7: noway0ut_7 (260647 in chips, $47.94 bounty) 
Seat 8: Imavere (141070 in chips, $48.43 bounty) 
ravenamber: posts the ante 1200
Happy_Grubby: posts the ante 1200
Anton280395: posts the ante 1200
Mandooo97: posts the ante 1200
khurlee.ts: posts the ante 1200
noway0ut_7: posts the ante 1200
Imavere: posts the ante 1200
Mandooo97: posts small blind 4000
khurlee.ts: posts big blind 8000
*** HOLE CARDS ***
noway0ut_7: folds 
Imavere: folds 
ravenamber: raises 113247 to 121247 and is all-in
Happy_Grubby: folds 
Anton280395: raises 282982 to 404229 and is all-in
Mandooo97: folds 
khurlee.ts: folds 
Uncalled bet (282982) returned to Anton280395
*** FLOP *** [6c 4d Jc]
*** TURN *** [6c 4d Jc] [Th]
*** RIVER *** [6c 4d Jc Th] [2s]
*** SHOW DOWN ***
ravenamber: shows [9s 9c] (a pair of Nines)
Anton280395: shows [Qc Qs] (a pair of Queens)
Anton280395 collected 262894 from pot
Anton280395 wins $16.25 for eliminating ravenamber and their own bounty increases by $16.24 to $37.80
ravenamber finished the tournament in 14th place and received $29.78.
*** SUMMARY ***
Total pot 262894 | Rake 0 
Board [6c 4d Jc Th 2s]
Seat 1: ravenamber showed [9s 9c] and lost with a pair of Nines
Seat 2: Happy_Grubby folded before Flop (didn't bet)
Seat 3: Anton280395 (button) showed [Qc Qs] and won (262894) with a pair of Queens
Seat 4: Mandooo97 (small blind) folded before Flop
Seat 6: khurlee.ts (big blind) folded before Flop
Seat 7: noway0ut_7 folded before Flop (didn't bet)
Seat 8: Imavere folded before Flop (didn't bet)

PokerStars Hand #250528402271: Tournament #3754315373, $4.80+$5.00+$1.20 USD Hold'em No Limit - Level XXXIV (4000/8000) - 2024/05/16 13:26:11 UTC [2024/05/16 9:26:11 ET]
Table '3754315373 2' 8-max Seat #4 is the button
Seat 2: Happy_Grubby (221503 in chips, $17.50 bounty) 
Seat 3: Anton280395 (545876 in chips, $37.80 bounty) 
Seat 4: Mandooo97 (430822 in chips, $68.30 bounty) 
Seat 6: khurlee.ts (174754 in chips, $61.70 bounty) 
Seat 7: noway0ut_7 (259447 in chips, $47.94 bounty) 
Seat 8: Imavere (139870 in chips, $48.43 bounty) 
Happy_Grubby: posts the ante 1200
Anton280395: posts the ante 1200
Mandooo97: posts the ante 1200
khurlee.ts: posts the ante 1200
noway0ut_7: posts the ante 1200
Imavere: posts the ante 1200
khurlee.ts: posts small blind 4000
noway0ut_7: posts big blind 8000
*** HOLE CARDS ***
Imavere: folds 
Happy_Grubby: folds 
Anton280395: folds 
Mandooo97: folds 
khurlee.ts: folds 
Uncalled bet (4000) returned to noway0ut_7
noway0ut_7 collected 15200 from pot
*** SUMMARY ***
Total pot 15200 | Rake 0 
Seat 2: Happy_Grubby folded before Flop (didn't bet)
Seat 3: Anton280395 folded before Flop (didn't bet)
Seat 4: Mandooo97 (button) folded before Flop (didn't bet)
Seat 6: khurlee.ts (small blind) folded before Flop
Seat 7: noway0ut_7 (big blind) collected (15200)
Seat 8: Imavere folded before Flop (didn't bet)

PokerStars Hand #250528402271: Tournament #3754315373, $4.80+$5.00+$1.20 USD Hold'em No Limit - Level XXXIV (4000/8000) - 2024/05/16 13:26:11 UTC [2024/05/16 9:26:11 ET]
Table '3754315373 2' 8-max Seat #4 is the button
Seat 2: Happy_Grubby (221503 in chips, $17.50 bounty) 
Seat 3: Anton280395 (545876 in chips, $37.80 bounty) 
Seat 4: Mandooo97 (430822 in chips, $68.30 bounty) 
Seat 6: khurlee.ts (174754 in chips, $61.70 bounty) 
Seat 7: noway0ut_7 (259447 in chips, $47.94 bounty) 
Seat 8: Imavere (139870 in chips, $48.43 bounty) 
Happy_Grubby: posts the ante 1200
Anton280395: posts the ante 1200
Mandooo97: posts the ante 1200
khurlee.ts: posts the ante 1200
noway0ut_7: posts the ante 1200
Imavere: posts the ante 1200
khurlee.ts: posts small blind 4000
noway0ut_7: posts big blind 8000
*** HOLE CARDS ***
Imavere: folds 
Happy_Grubby: folds 
Anton280395: folds 
Mandooo97: folds 
khurlee.ts: folds 
Uncalled bet (4000) returned to noway0ut_7
noway0ut_7 collected 15200 from pot
*** SUMMARY ***
Total pot 15200 | Rake 0 
Seat 2: Happy_Grubby folded before Flop (didn't bet)
Seat 3: Anton280395 folded before Flop (didn't bet)
Seat 4: Mandooo97 (button) folded before Flop (didn't bet)
Seat 6: khurlee.ts (small blind) folded before Flop
Seat 7: noway0ut_7 (big blind) collected (15200)
Seat 8: Imavere folded before Flop (didn't bet)

PokerStars Hand #250528405013: Tournament #3754315373, $4.80+$5.00+$1.20 USD Hold'em No Limit - Level XXXIV (4000/8000) - 2024/05/16 13:26:26 UTC [2024/05/16 9:26:26 ET]
Table '3754315373 2' 8-max Seat #6 is the button
Seat 2: Happy_Grubby (220303 in chips, $17.50 bounty) 
Seat 3: Anton280395 (544676 in chips, $37.80 bounty) 
Seat 4: Mandooo97 (429622 in chips, $68.30 bounty) 
Seat 6: khurlee.ts (169554 in chips, $61.70 bounty) 
Seat 7: noway0ut_7 (269447 in chips, $47.94 bounty) 
Seat 8: Imavere (138670 in chips, $48.43 bounty) 
Happy_Grubby: posts the ante 1200
Anton280395: posts the ante 1200
Mandooo97: posts the ante 1200
khurlee.ts: posts the ante 1200
noway0ut_7: posts the ante 1200
Imavere: posts the ante 1200
noway0ut_7: posts small blind 4000
Imavere: posts big blind 8000
*** HOLE CARDS ***
Happy_Grubby: folds 
Anton280395: folds 
Mandooo97: folds 
khurlee.ts: folds 
noway0ut_7: folds 
Uncalled bet (4000) returned to Imavere
Imavere collected 15200 from pot
*** SUMMARY ***
Total pot 15200 | Rake 0 
Seat 2: Happy_Grubby folded before Flop (didn't bet)
Seat 3: Anton280395 folded before Flop (didn't bet)
Seat 4: Mandooo97 folded before Flop (didn't bet)
Seat 6: khurlee.ts (button) folded before Flop (didn't bet)
Seat 7: noway0ut_7 (small blind) folded before Flop
Seat 8: Imavere (big blind) collected (15200)

PokerStars Hand #250528405013: Tournament #3754315373, $4.80+$5.00+$1.20 USD Hold'em No Limit - Level XXXIV (4000/8000) - 2024/05/16 13:26:26 UTC [2024/05/16 9:26:26 ET]
Table '3754315373 2' 8-max Seat #6 is the button
Seat 2: Happy_Grubby (220303 in chips, $17.50 bounty) 
Seat 3: Anton280395 (544676 in chips, $37.80 bounty) 
Seat 4: Mandooo97 (429622 in chips, $68.30 bounty) 
Seat 6: khurlee.ts (169554 in chips, $61.70 bounty) 
Seat 7: noway0ut_7 (269447 in chips, $47.94 bounty) 
Seat 8: Imavere (138670 in chips, $48.43 bounty) 
Happy_Grubby: posts the ante 1200
Anton280395: posts the ante 1200
Mandooo97: posts the ante 1200
khurlee.ts: posts the ante 1200
noway0ut_7: posts the ante 1200
Imavere: posts the ante 1200
noway0ut_7: posts small blind 4000
Imavere: posts big blind 8000
*** HOLE CARDS ***
Happy_Grubby: folds 
Anton280395: folds 
Mandooo97: folds 
khurlee.ts: folds 
noway0ut_7: folds 
Uncalled bet (4000) returned to Imavere
Imavere collected 15200 from pot
*** SUMMARY ***
Total pot 15200 | Rake 0 
Seat 2: Happy_Grubby folded before Flop (didn't bet)
Seat 3: Anton280395 folded before Flop (didn't bet)
Seat 4: Mandooo97 folded before Flop (didn't bet)
Seat 6: khurlee.ts (button) folded before Flop (didn't bet)
Seat 7: noway0ut_7 (small blind) folded before Flop
Seat 8: Imavere (big blind) collected (15200)

PokerStars Hand #250528406719: Tournament #3754315373, $4.80+$5.00+$1.20 USD Hold'em No Limit - Level XXXIV (4000/8000) - 2024/05/16 13:26:36 UTC [2024/05/16 9:26:36 ET]
Table '3754315373 2' 8-max Seat #7 is the button
Seat 2: Happy_Grubby (219103 in chips, $17.50 bounty) 
Seat 3: Anton280395 (543476 in chips, $37.80 bounty) 
Seat 4: Mandooo97 (428422 in chips, $68.30 bounty) 
Seat 6: khurlee.ts (168354 in chips, $61.70 bounty) 
Seat 7: noway0ut_7 (264247 in chips, $47.94 bounty) 
Seat 8: Imavere (148670 in chips, $48.43 bounty) 
Happy_Grubby: posts the ante 1200
Anton280395: posts the ante 1200
Mandooo97: posts the ante 1200
khurlee.ts: posts the ante 1200
noway0ut_7: posts the ante 1200
Imavere: posts the ante 1200
Imavere: posts small blind 4000
Happy_Grubby: posts big blind 8000
*** HOLE CARDS ***
Anton280395: raises 8000 to 16000
Mandooo97: calls 16000
khurlee.ts: folds 
noway0ut_7: folds 
Imavere: folds 
Happy_Grubby: folds 
*** FLOP *** [6s Ts 2c]
Anton280395: bets 26112
Mandooo97: calls 26112
*** TURN *** [6s Ts 2c] [2s]
Anton280395: checks 
Mandooo97: bets 34130
Anton280395: calls 34130
*** RIVER *** [6s Ts 2c 2s] [6h]
Anton280395: checks 
Mandooo97: bets 172000
Anton280395: folds 
Uncalled bet (172000) returned to Mandooo97
Mandooo97 collected 171684 from pot
Mandooo97: doesn't show hand 
*** SUMMARY ***
Total pot 171684 | Rake 0 
Board [6s Ts 2c 2s 6h]
Seat 2: Happy_Grubby (big blind) folded before Flop
Seat 3: Anton280395 folded on the River
Seat 4: Mandooo97 collected (171684)
Seat 6: khurlee.ts folded before Flop (didn't bet)
Seat 7: noway0ut_7 (button) folded before Flop (didn't bet)
Seat 8: Imavere (small blind) folded before Flop

PokerStars Hand #250528406719: Tournament #3754315373, $4.80+$5.00+$1.20 USD Hold'em No Limit - Level XXXIV (4000/8000) - 2024/05/16 13:26:36 UTC [2024/05/16 9:26:36 ET]
Table '3754315373 2' 8-max Seat #7 is the button
Seat 2: Happy_Grubby (219103 in chips, $17.50 bounty) 
Seat 3: Anton280395 (543476 in chips, $37.80 bounty) 
Seat 4: Mandooo97 (428422 in chips, $68.30 bounty) 
Seat 6: khurlee.ts (168354 in chips, $61.70 bounty) 
Seat 7: noway0ut_7 (264247 in chips, $47.94 bounty) 
Seat 8: Imavere (148670 in chips, $48.43 bounty) 
Happy_Grubby: posts the ante 1200
Anton280395: posts the ante 1200
Mandooo97: posts the ante 1200
khurlee.ts: posts the ante 1200
noway0ut_7: posts the ante 1200
Imavere: posts the ante 1200
Imavere: posts small blind 4000
Happy_Grubby: posts big blind 8000
*** HOLE CARDS ***
Anton280395: raises 8000 to 16000
Mandooo97: calls 16000
khurlee.ts: folds 
noway0ut_7: folds 
Imavere: folds 
Happy_Grubby: folds 
*** FLOP *** [6s Ts 2c]
Anton280395: bets 26112
Mandooo97: calls 26112
*** TURN *** [6s Ts 2c] [2s]
Anton280395: checks 
Mandooo97: bets 34130
Anton280395: calls 34130
*** RIVER *** [6s Ts 2c 2s] [6h]
Anton280395: checks 
Mandooo97: bets 172000
Anton280395: folds 
Uncalled bet (172000) returned to Mandooo97
Mandooo97 collected 171684 from pot
Mandooo97: doesn't show hand 
*** SUMMARY ***
Total pot 171684 | Rake 0 
Board [6s Ts 2c 2s 6h]
Seat 2: Happy_Grubby (big blind) folded before Flop
Seat 3: Anton280395 folded on the River
Seat 4: Mandooo97 collected (171684)
Seat 6: khurlee.ts folded before Flop (didn't bet)
Seat 7: noway0ut_7 (button) folded before Flop (didn't bet)
Seat 8: Imavere (small blind) folded before Flop

PokerStars Hand #250528423556: Tournament #3754315373, $4.80+$5.00+$1.20 USD Hold'em No Limit - Level XXXIV (4000/8000) - 2024/05/16 13:28:09 UTC [2024/05/16 9:28:09 ET]
Table '3754315373 2' 8-max Seat #8 is the button
Seat 2: Happy_Grubby (209903 in chips, $17.50 bounty) 
Seat 3: Anton280395 (466034 in chips, $37.80 bounty) 
Seat 4: Mandooo97 (522664 in chips, $68.30 bounty) 
Seat 6: khurlee.ts (167154 in chips, $61.70 bounty) 
Seat 7: noway0ut_7 (263047 in chips, $47.94 bounty) 
Seat 8: Imavere (143470 in chips, $48.43 bounty) 
Happy_Grubby: posts the ante 1200
Anton280395: posts the ante 1200
Mandooo97: posts the ante 1200
khurlee.ts: posts the ante 1200
noway0ut_7: posts the ante 1200
Imavere: posts the ante 1200
Happy_Grubby: posts small blind 4000
Anton280395: posts big blind 8000
*** HOLE CARDS ***
Mandooo97: folds 
khurlee.ts: folds 
noway0ut_7: raises 16000 to 24000
Imavere: folds 
Happy_Grubby: folds 
Anton280395: calls 16000
*** FLOP *** [Qs Js 7c]
Anton280395: checks 
noway0ut_7: checks 
*** TURN *** [Qs Js 7c] [3s]
Anton280395: checks 
noway0ut_7: bets 24000
Anton280395: folds 
Uncalled bet (24000) returned to noway0ut_7
noway0ut_7 collected 59200 from pot
*** SUMMARY ***
Total pot 59200 | Rake 0 
Board [Qs Js 7c 3s]
Seat 2: Happy_Grubby (small blind) folded before Flop
Seat 3: Anton280395 (big blind) folded on the Turn
Seat 4: Mandooo97 folded before Flop (didn't bet)
Seat 6: khurlee.ts folded before Flop (didn't bet)
Seat 7: noway0ut_7 collected (59200)
Seat 8: Imavere (button) folded before Flop (didn't bet)

PokerStars Hand #250528423556: Tournament #3754315373, $4.80+$5.00+$1.20 USD Hold'em No Limit - Level XXXIV (4000/8000) - 2024/05/16 13:28:09 UTC [2024/05/16 9:28:09 ET]
Table '3754315373 2' 8-max Seat #8 is the button
Seat 2: Happy_Grubby (209903 in chips, $17.50 bounty) 
Seat 3: Anton280395 (466034 in chips, $37.80 bounty) 
Seat 4: Mandooo97 (522664 in chips, $68.30 bounty) 
Seat 6: khurlee.ts (167154 in chips, $61.70 bounty) 
Seat 7: noway0ut_7 (263047 in chips, $47.94 bounty) 
Seat 8: Imavere (143470 in chips, $48.43 bounty) 
Happy_Grubby: posts the ante 1200
Anton280395: posts the ante 1200
Mandooo97: posts the ante 1200
khurlee.ts: posts the ante 1200
noway0ut_7: posts the ante 1200
Imavere: posts the ante 1200
Happy_Grubby: posts small blind 4000
Anton280395: posts big blind 8000
*** HOLE CARDS ***
Mandooo97: folds 
khurlee.ts: folds 
noway0ut_7: raises 16000 to 24000
Imavere: folds 
Happy_Grubby: folds 
Anton280395: calls 16000
*** FLOP *** [Qs Js 7c]
Anton280395: checks 
noway0ut_7: checks 
*** TURN *** [Qs Js 7c] [3s]
Anton280395: checks 
noway0ut_7: bets 24000
Anton280395: folds 
Uncalled bet (24000) returned to noway0ut_7
noway0ut_7 collected 59200 from pot
*** SUMMARY ***
Total pot 59200 | Rake 0 
Board [Qs Js 7c 3s]
Seat 2: Happy_Grubby (small blind) folded before Flop
Seat 3: Anton280395 (big blind) folded on the Turn
Seat 4: Mandooo97 folded before Flop (didn't bet)
Seat 6: khurlee.ts folded before Flop (didn't bet)
Seat 7: noway0ut_7 collected (59200)
Seat 8: Imavere (button) folded before Flop (didn't bet)

PokerStars Hand #250528428770: Tournament #3754315373, $4.80+$5.00+$1.20 USD Hold'em No Limit - Level XXXIV (4000/8000) - 2024/05/16 13:28:38 UTC [2024/05/16 9:28:38 ET]
Table '3754315373 2' 8-max Seat #2 is the button
Seat 2: Happy_Grubby (204703 in chips, $17.50 bounty) 
Seat 3: Anton280395 (440834 in chips, $37.80 bounty) 
Seat 4: Mandooo97 (521464 in chips, $68.30 bounty) 
Seat 6: khurlee.ts (165954 in chips, $61.70 bounty) 
Seat 7: noway0ut_7 (297047 in chips, $47.94 bounty) 
Seat 8: Imavere (142270 in chips, $48.43 bounty) 
Happy_Grubby: posts the ante 1200
Anton280395: posts the ante 1200
Mandooo97: posts the ante 1200
khurlee.ts: posts the ante 1200
noway0ut_7: posts the ante 1200
Imavere: posts the ante 1200
Anton280395: posts small blind 4000
Mandooo97: posts big blind 8000
*** HOLE CARDS ***
khurlee.ts: raises 8000 to 16000
noway0ut_7: calls 16000
Imavere: folds 
Happy_Grubby: folds 
Anton280395: folds 
Mandooo97: folds 
*** FLOP *** [3s 3h 9s]
khurlee.ts: checks 
noway0ut_7: checks 
*** TURN *** [3s 3h 9s] [Ks]
khurlee.ts: checks 
noway0ut_7: checks 
*** RIVER *** [3s 3h 9s Ks] [8d]
khurlee.ts: bets 36000
noway0ut_7: folds 
Uncalled bet (36000) returned to khurlee.ts
khurlee.ts collected 51200 from pot
khurlee.ts: doesn't show hand 
*** SUMMARY ***
Total pot 51200 | Rake 0 
Board [3s 3h 9s Ks 8d]
Seat 2: Happy_Grubby (button) folded before Flop (didn't bet)
Seat 3: Anton280395 (small blind) folded before Flop
Seat 4: Mandooo97 (big blind) folded before Flop
Seat 6: khurlee.ts collected (51200)
Seat 7: noway0ut_7 folded on the River
Seat 8: Imavere folded before Flop (didn't bet)

PokerStars Hand #250528428770: Tournament #3754315373, $4.80+$5.00+$1.20 USD Hold'em No Limit - Level XXXIV (4000/8000) - 2024/05/16 13:28:38 UTC [2024/05/16 9:28:38 ET]
Table '3754315373 2' 8-max Seat #2 is the button
Seat 2: Happy_Grubby (204703 in chips, $17.50 bounty) 
Seat 3: Anton280395 (440834 in chips, $37.80 bounty) 
Seat 4: Mandooo97 (521464 in chips, $68.30 bounty) 
Seat 6: khurlee.ts (165954 in chips, $61.70 bounty) 
Seat 7: noway0ut_7 (297047 in chips, $47.94 bounty) 
Seat 8: Imavere (142270 in chips, $48.43 bounty) 
Happy_Grubby: posts the ante 1200
Anton280395: posts the ante 1200
Mandooo97: posts the ante 1200
khurlee.ts: posts the ante 1200
noway0ut_7: posts the ante 1200
Imavere: posts the ante 1200
Anton280395: posts small blind 4000
Mandooo97: posts big blind 8000
*** HOLE CARDS ***
khurlee.ts: raises 8000 to 16000
noway0ut_7: calls 16000
Imavere: folds 
Happy_Grubby: folds 
Anton280395: folds 
Mandooo97: folds 
*** FLOP *** [3s 3h 9s]
khurlee.ts: checks 
noway0ut_7: checks 
*** TURN *** [3s 3h 9s] [Ks]
khurlee.ts: checks 
noway0ut_7: checks 
*** RIVER *** [3s 3h 9s Ks] [8d]
khurlee.ts: bets 36000
noway0ut_7: folds 
Uncalled bet (36000) returned to khurlee.ts
khurlee.ts collected 51200 from pot
khurlee.ts: doesn't show hand 
*** SUMMARY ***
Total pot 51200 | Rake 0 
Board [3s 3h 9s Ks 8d]
Seat 2: Happy_Grubby (button) folded before Flop (didn't bet)
Seat 3: Anton280395 (small blind) folded before Flop
Seat 4: Mandooo97 (big blind) folded before Flop
Seat 6: khurlee.ts collected (51200)
Seat 7: noway0ut_7 folded on the River
Seat 8: Imavere folded before Flop (didn't bet)

PokerStars Hand #250528436877: Tournament #3754315373, $4.80+$5.00+$1.20 USD Hold'em No Limit - Level XXXIV (4000/8000) - 2024/05/16 13:29:24 UTC [2024/05/16 9:29:24 ET]
Table '3754315373 2' 8-max Seat #3 is the button
Seat 2: Happy_Grubby (203503 in chips, $17.50 bounty) 
Seat 3: Anton280395 (435634 in chips, $37.80 bounty) 
Seat 4: Mandooo97 (512264 in chips, $68.30 bounty) 
Seat 6: khurlee.ts (199954 in chips, $61.70 bounty) 
Seat 7: noway0ut_7 (279847 in chips, $47.94 bounty) 
Seat 8: Imavere (141070 in chips, $48.43 bounty) 
Happy_Grubby: posts the ante 1200
Anton280395: posts the ante 1200
Mandooo97: posts the ante 1200
khurlee.ts: posts the ante 1200
noway0ut_7: posts the ante 1200
Imavere: posts the ante 1200
Mandooo97: posts small blind 4000
khurlee.ts: posts big blind 8000
*** HOLE CARDS ***
noway0ut_7: folds 
Imavere: folds 
Happy_Grubby: folds 
Anton280395: raises 8000 to 16000
Mandooo97: folds 
khurlee.ts: raises 28000 to 44000
Anton280395: calls 28000
*** FLOP *** [Ts Jd 7s]
khurlee.ts: bets 28736
Anton280395: calls 28736
*** TURN *** [Ts Jd 7s] [6h]
khurlee.ts: bets 47702
Anton280395: folds 
Uncalled bet (47702) returned to khurlee.ts
khurlee.ts collected 156672 from pot
khurlee.ts: doesn't show hand 
*** SUMMARY ***
Total pot 156672 | Rake 0 
Board [Ts Jd 7s 6h]
Seat 2: Happy_Grubby folded before Flop (didn't bet)
Seat 3: Anton280395 (button) folded on the Turn
Seat 4: Mandooo97 (small blind) folded before Flop
Seat 6: khurlee.ts (big blind) collected (156672)
Seat 7: noway0ut_7 folded before Flop (didn't bet)
Seat 8: Imavere folded before Flop (didn't bet)

PokerStars Hand #250528436877: Tournament #3754315373, $4.80+$5.00+$1.20 USD Hold'em No Limit - Level XXXIV (4000/8000) - 2024/05/16 13:29:24 UTC [2024/05/16 9:29:24 ET]
Table '3754315373 2' 8-max Seat #3 is the button
Seat 2: Happy_Grubby (203503 in chips, $17.50 bounty) 
Seat 3: Anton280395 (435634 in chips, $37.80 bounty) 
Seat 4: Mandooo97 (512264 in chips, $68.30 bounty) 
Seat 6: khurlee.ts (199954 in chips, $61.70 bounty) 
Seat 7: noway0ut_7 (279847 in chips, $47.94 bounty) 
Seat 8: Imavere (141070 in chips, $48.43 bounty) 
Happy_Grubby: posts the ante 1200
Anton280395: posts the ante 1200
Mandooo97: posts the ante 1200
khurlee.ts: posts the ante 1200
noway0ut_7: posts the ante 1200
Imavere: posts the ante 1200
Mandooo97: posts small blind 4000
khurlee.ts: posts big blind 8000
*** HOLE CARDS ***
noway0ut_7: folds 
Imavere: folds 
Happy_Grubby: folds 
Anton280395: raises 8000 to 16000
Mandooo97: folds 
khurlee.ts: raises 28000 to 44000
Anton280395: calls 28000
*** FLOP *** [Ts Jd 7s]
khurlee.ts: bets 28736
Anton280395: calls 28736
*** TURN *** [Ts Jd 7s] [6h]
khurlee.ts: bets 47702
Anton280395: folds 
Uncalled bet (47702) returned to khurlee.ts
khurlee.ts collected 156672 from pot
khurlee.ts: doesn't show hand 
*** SUMMARY ***
Total pot 156672 | Rake 0 
Board [Ts Jd 7s 6h]
Seat 2: Happy_Grubby folded before Flop (didn't bet)
Seat 3: Anton280395 (button) folded on the Turn
Seat 4: Mandooo97 (small blind) folded before Flop
Seat 6: khurlee.ts (big blind) collected (156672)
Seat 7: noway0ut_7 folded before Flop (didn't bet)
Seat 8: Imavere folded before Flop (didn't bet)

PokerStars Hand #250528454759: Tournament #3754315373, $4.80+$5.00+$1.20 USD Hold'em No Limit - Level XXXIV (4000/8000) - 2024/05/16 13:31:02 UTC [2024/05/16 9:31:02 ET]
Table '3754315373 2' 8-max Seat #4 is the button
Seat 2: Happy_Grubby (202303 in chips, $17.50 bounty) 
Seat 3: Anton280395 (361698 in chips, $37.80 bounty) 
Seat 4: Mandooo97 (507064 in chips, $68.30 bounty) 
Seat 6: khurlee.ts (282690 in chips, $61.70 bounty) 
Seat 7: noway0ut_7 (278647 in chips, $47.94 bounty) 
Seat 8: Imavere (139870 in chips, $48.43 bounty) 
Happy_Grubby: posts the ante 1200
Anton280395: posts the ante 1200
Mandooo97: posts the ante 1200
khurlee.ts: posts the ante 1200
noway0ut_7: posts the ante 1200
Imavere: posts the ante 1200
khurlee.ts: posts small blind 4000
noway0ut_7: posts big blind 8000
*** HOLE CARDS ***
Imavere: folds 
Happy_Grubby: folds 
Anton280395: folds 
Mandooo97: raises 9600 to 17600
khurlee.ts: folds 
noway0ut_7: raises 49600 to 67200
Mandooo97: folds 
Uncalled bet (49600) returned to noway0ut_7
noway0ut_7 collected 46400 from pot
*** SUMMARY ***
Total pot 46400 | Rake 0 
Seat 2: Happy_Grubby folded before Flop (didn't bet)
Seat 3: Anton280395 folded before Flop (didn't bet)
Seat 4: Mandooo97 (button) folded before Flop
Seat 6: khurlee.ts (small blind) folded before Flop
Seat 7: noway0ut_7 (big blind) collected (46400)
Seat 8: Imavere folded before Flop (didn't bet)

PokerStars Hand #250528454759: Tournament #3754315373, $4.80+$5.00+$1.20 USD Hold'em No Limit - Level XXXIV (4000/8000) - 2024/05/16 13:31:02 UTC [2024/05/16 9:31:02 ET]
Table '3754315373 2' 8-max Seat #4 is the button
Seat 2: Happy_Grubby (202303 in chips, $17.50 bounty) 
Seat 3: Anton280395 (361698 in chips, $37.80 bounty) 
Seat 4: Mandooo97 (507064 in chips, $68.30 bounty) 
Seat 6: khurlee.ts (282690 in chips, $61.70 bounty) 
Seat 7: noway0ut_7 (278647 in chips, $47.94 bounty) 
Seat 8: Imavere (139870 in chips, $48.43 bounty) 
Happy_Grubby: posts the ante 1200
Anton280395: posts the ante 1200
Mandooo97: posts the ante 1200
khurlee.ts: posts the ante 1200
noway0ut_7: posts the ante 1200
Imavere: posts the ante 1200
khurlee.ts: posts small blind 4000
noway0ut_7: posts big blind 8000
*** HOLE CARDS ***
Imavere: folds 
Happy_Grubby: folds 
Anton280395: folds 
Mandooo97: raises 9600 to 17600
khurlee.ts: folds 
noway0ut_7: raises 49600 to 67200
Mandooo97: folds 
Uncalled bet (49600) returned to noway0ut_7
noway0ut_7 collected 46400 from pot
*** SUMMARY ***
Total pot 46400 | Rake 0 
Seat 2: Happy_Grubby folded before Flop (didn't bet)
Seat 3: Anton280395 folded before Flop (didn't bet)
Seat 4: Mandooo97 (button) folded before Flop
Seat 6: khurlee.ts (small blind) folded before Flop
Seat 7: noway0ut_7 (big blind) collected (46400)
Seat 8: Imavere folded before Flop (didn't bet)

PokerStars Hand #250528461363: Tournament #3754315373, $4.80+$5.00+$1.20 USD Hold'em No Limit - Level XXXIV (4000/8000) - 2024/05/16 13:31:39 UTC [2024/05/16 9:31:39 ET]
Table '3754315373 2' 8-max Seat #6 is the button
Seat 2: Happy_Grubby (201103 in chips, $17.50 bounty) 
Seat 3: Anton280395 (360498 in chips, $37.80 bounty) 
Seat 4: Mandooo97 (488264 in chips, $68.30 bounty) 
Seat 6: khurlee.ts (277490 in chips, $61.70 bounty) 
Seat 7: noway0ut_7 (306247 in chips, $47.94 bounty) 
Seat 8: Imavere (138670 in chips, $48.43 bounty) 
Happy_Grubby: posts the ante 1200
Anton280395: posts the ante 1200
Mandooo97: posts the ante 1200
khurlee.ts: posts the ante 1200
noway0ut_7: posts the ante 1200
Imavere: posts the ante 1200
noway0ut_7: posts small blind 4000
Imavere: posts big blind 8000
*** HOLE CARDS ***
Happy_Grubby: folds 
Anton280395: folds 
Mandooo97: raises 9600 to 17600
khurlee.ts: folds 
noway0ut_7: folds 
Imavere: folds [2s 7h]
Uncalled bet (9600) returned to Mandooo97
Mandooo97 collected 27200 from pot
Mandooo97: doesn't show hand 
*** SUMMARY ***
Total pot 27200 | Rake 0 
Seat 2: Happy_Grubby folded before Flop (didn't bet)
Seat 3: Anton280395 folded before Flop (didn't bet)
Seat 4: Mandooo97 collected (27200)
Seat 6: khurlee.ts (button) folded before Flop (didn't bet)
Seat 7: noway0ut_7 (small blind) folded before Flop
Seat 8: Imavere (big blind) folded before Flop

PokerStars Hand #250528461363: Tournament #3754315373, $4.80+$5.00+$1.20 USD Hold'em No Limit - Level XXXIV (4000/8000) - 2024/05/16 13:31:39 UTC [2024/05/16 9:31:39 ET]
Table '3754315373 2' 8-max Seat #6 is the button
Seat 2: Happy_Grubby (201103 in chips, $17.50 bounty) 
Seat 3: Anton280395 (360498 in chips, $37.80 bounty) 
Seat 4: Mandooo97 (488264 in chips, $68.30 bounty) 
Seat 6: khurlee.ts (277490 in chips, $61.70 bounty) 
Seat 7: noway0ut_7 (306247 in chips, $47.94 bounty) 
Seat 8: Imavere (138670 in chips, $48.43 bounty) 
Happy_Grubby: posts the ante 1200
Anton280395: posts the ante 1200
Mandooo97: posts the ante 1200
khurlee.ts: posts the ante 1200
noway0ut_7: posts the ante 1200
Imavere: posts the ante 1200
noway0ut_7: posts small blind 4000
Imavere: posts big blind 8000
*** HOLE CARDS ***
Happy_Grubby: folds 
Anton280395: folds 
Mandooo97: raises 9600 to 17600
khurlee.ts: folds 
noway0ut_7: folds 
Imavere: folds [2s 7h]
Uncalled bet (9600) returned to Mandooo97
Mandooo97 collected 27200 from pot
Mandooo97: doesn't show hand 
*** SUMMARY ***
Total pot 27200 | Rake 0 
Seat 2: Happy_Grubby folded before Flop (didn't bet)
Seat 3: Anton280395 folded before Flop (didn't bet)
Seat 4: Mandooo97 collected (27200)
Seat 6: khurlee.ts (button) folded before Flop (didn't bet)
Seat 7: noway0ut_7 (small blind) folded before Flop
Seat 8: Imavere (big blind) folded before Flop

PokerStars Hand #250528463660: Tournament #3754315373, $4.80+$5.00+$1.20 USD Hold'em No Limit - Level XXXIV (4000/8000) - 2024/05/16 13:31:51 UTC [2024/05/16 9:31:51 ET]
Table '3754315373 2' 8-max Seat #7 is the button
Seat 2: Happy_Grubby (199903 in chips, $17.50 bounty) 
Seat 3: Anton280395 (359298 in chips, $37.80 bounty) 
Seat 4: Mandooo97 (506264 in chips, $68.30 bounty) 
Seat 6: khurlee.ts (276290 in chips, $61.70 bounty) 
Seat 7: noway0ut_7 (301047 in chips, $47.94 bounty) 
Seat 8: Imavere (129470 in chips, $48.43 bounty) 
Happy_Grubby: posts the ante 1200
Anton280395: posts the ante 1200
Mandooo97: posts the ante 1200
khurlee.ts: posts the ante 1200
noway0ut_7: posts the ante 1200
Imavere: posts the ante 1200
Imavere: posts small blind 4000
Happy_Grubby: posts big blind 8000
*** HOLE CARDS ***
Anton280395: folds 
Mandooo97: raises 9600 to 17600
khurlee.ts: folds 
noway0ut_7: folds 
Imavere: folds 
Happy_Grubby: calls 9600
*** FLOP *** [8s 5d Kd]
Happy_Grubby: checks 
Mandooo97: bets 11600
Happy_Grubby: folds 
Uncalled bet (11600) returned to Mandooo97
Mandooo97 collected 46400 from pot
Mandooo97: doesn't show hand 
*** SUMMARY ***
Total pot 46400 | Rake 0 
Board [8s 5d Kd]
Seat 2: Happy_Grubby (big blind) folded on the Flop
Seat 3: Anton280395 folded before Flop (didn't bet)
Seat 4: Mandooo97 collected (46400)
Seat 6: khurlee.ts folded before Flop (didn't bet)
Seat 7: noway0ut_7 (button) folded before Flop (didn't bet)
Seat 8: Imavere (small blind) folded before Flop

PokerStars Hand #250528463660: Tournament #3754315373, $4.80+$5.00+$1.20 USD Hold'em No Limit - Level XXXIV (4000/8000) - 2024/05/16 13:31:51 UTC [2024/05/16 9:31:51 ET]
Table '3754315373 2' 8-max Seat #7 is the button
Seat 2: Happy_Grubby (199903 in chips, $17.50 bounty) 
Seat 3: Anton280395 (359298 in chips, $37.80 bounty) 
Seat 4: Mandooo97 (506264 in chips, $68.30 bounty) 
Seat 6: khurlee.ts (276290 in chips, $61.70 bounty) 
Seat 7: noway0ut_7 (301047 in chips, $47.94 bounty) 
Seat 8: Imavere (129470 in chips, $48.43 bounty) 
Happy_Grubby: posts the ante 1200
Anton280395: posts the ante 1200
Mandooo97: posts the ante 1200
khurlee.ts: posts the ante 1200
noway0ut_7: posts the ante 1200
Imavere: posts the ante 1200
Imavere: posts small blind 4000
Happy_Grubby: posts big blind 8000
*** HOLE CARDS ***
Anton280395: folds 
Mandooo97: raises 9600 to 17600
khurlee.ts: folds 
noway0ut_7: folds 
Imavere: folds 
Happy_Grubby: calls 9600
*** FLOP *** [8s 5d Kd]
Happy_Grubby: checks 
Mandooo97: bets 11600
Happy_Grubby: folds 
Uncalled bet (11600) returned to Mandooo97
Mandooo97 collected 46400 from pot
Mandooo97: doesn't show hand 
*** SUMMARY ***
Total pot 46400 | Rake 0 
Board [8s 5d Kd]
Seat 2: Happy_Grubby (big blind) folded on the Flop
Seat 3: Anton280395 folded before Flop (didn't bet)
Seat 4: Mandooo97 collected (46400)
Seat 6: khurlee.ts folded before Flop (didn't bet)
Seat 7: noway0ut_7 (button) folded before Flop (didn't bet)
Seat 8: Imavere (small blind) folded before Flop

PokerStars Hand #250528469072: Tournament #3754315373, $4.80+$5.00+$1.20 USD Hold'em No Limit - Level XXXIV (4000/8000) - 2024/05/16 13:32:20 UTC [2024/05/16 9:32:20 ET]
Table '3754315373 2' 8-max Seat #8 is the button
Seat 2: Happy_Grubby (181103 in chips, $17.50 bounty) 
Seat 3: Anton280395 (358098 in chips, $37.80 bounty) 
Seat 4: Mandooo97 (533864 in chips, $68.30 bounty) 
Seat 6: khurlee.ts (275090 in chips, $61.70 bounty) 
Seat 7: noway0ut_7 (299847 in chips, $47.94 bounty) 
Seat 8: Imavere (124270 in chips, $48.43 bounty) 
Happy_Grubby: posts the ante 1200
Anton280395: posts the ante 1200
Mandooo97: posts the ante 1200
khurlee.ts: posts the ante 1200
noway0ut_7: posts the ante 1200
Imavere: posts the ante 1200
Happy_Grubby: posts small blind 4000
Anton280395: posts big blind 8000
*** HOLE CARDS ***
Mandooo97: folds 
khurlee.ts: folds 
noway0ut_7: folds 
Imavere: folds 
Happy_Grubby: folds 
Uncalled bet (4000) returned to Anton280395
Anton280395 collected 15200 from pot
Anton280395: doesn't show hand 
*** SUMMARY ***
Total pot 15200 | Rake 0 
Seat 2: Happy_Grubby (small blind) folded before Flop
Seat 3: Anton280395 (big blind) collected (15200)
Seat 4: Mandooo97 folded before Flop (didn't bet)
Seat 6: khurlee.ts folded before Flop (didn't bet)
Seat 7: noway0ut_7 folded before Flop (didn't bet)
Seat 8: Imavere (button) folded before Flop (didn't bet)

PokerStars Hand #250528469072: Tournament #3754315373, $4.80+$5.00+$1.20 USD Hold'em No Limit - Level XXXIV (4000/8000) - 2024/05/16 13:32:20 UTC [2024/05/16 9:32:20 ET]
Table '3754315373 2' 8-max Seat #8 is the button
Seat 2: Happy_Grubby (181103 in chips, $17.50 bounty) 
Seat 3: Anton280395 (358098 in chips, $37.80 bounty) 
Seat 4: Mandooo97 (533864 in chips, $68.30 bounty) 
Seat 6: khurlee.ts (275090 in chips, $61.70 bounty) 
Seat 7: noway0ut_7 (299847 in chips, $47.94 bounty) 
Seat 8: Imavere (124270 in chips, $48.43 bounty) 
Happy_Grubby: posts the ante 1200
Anton280395: posts the ante 1200
Mandooo97: posts the ante 1200
khurlee.ts: posts the ante 1200
noway0ut_7: posts the ante 1200
Imavere: posts the ante 1200
Happy_Grubby: posts small blind 4000
Anton280395: posts big blind 8000
*** HOLE CARDS ***
Mandooo97: folds 
khurlee.ts: folds 
noway0ut_7: folds 
Imavere: folds 
Happy_Grubby: folds 
Uncalled bet (4000) returned to Anton280395
Anton280395 collected 15200 from pot
Anton280395: doesn't show hand 
*** SUMMARY ***
Total pot 15200 | Rake 0 
Seat 2: Happy_Grubby (small blind) folded before Flop
Seat 3: Anton280395 (big blind) collected (15200)
Seat 4: Mandooo97 folded before Flop (didn't bet)
Seat 6: khurlee.ts folded before Flop (didn't bet)
Seat 7: noway0ut_7 folded before Flop (didn't bet)
Seat 8: Imavere (button) folded before Flop (didn't bet)

PokerStars Hand #250528471205: Tournament #3754315373, $4.80+$5.00+$1.20 USD Hold'em No Limit - Level XXXIV (4000/8000) - 2024/05/16 13:32:32 UTC [2024/05/16 9:32:32 ET]
Table '3754315373 2' 8-max Seat #2 is the button
Seat 2: Happy_Grubby (175903 in chips, $17.50 bounty) 
Seat 3: Anton280395 (368098 in chips, $37.80 bounty) 
Seat 4: Mandooo97 (532664 in chips, $68.30 bounty) 
Seat 6: khurlee.ts (273890 in chips, $61.70 bounty) 
Seat 7: noway0ut_7 (298647 in chips, $47.94 bounty) 
Seat 8: Imavere (123070 in chips, $48.43 bounty) 
Happy_Grubby: posts the ante 1200
Anton280395: posts the ante 1200
Mandooo97: posts the ante 1200
khurlee.ts: posts the ante 1200
noway0ut_7: posts the ante 1200
Imavere: posts the ante 1200
Anton280395: posts small blind 4000
Mandooo97: posts big blind 8000
*** HOLE CARDS ***
khurlee.ts: folds 
noway0ut_7: folds 
Imavere: folds 
Happy_Grubby: raises 8000 to 16000
Anton280395: folds 
Mandooo97: folds 
Uncalled bet (8000) returned to Happy_Grubby
Happy_Grubby collected 27200 from pot
Happy_Grubby: doesn't show hand 
*** SUMMARY ***
Total pot 27200 | Rake 0 
Seat 2: Happy_Grubby (button) collected (27200)
Seat 3: Anton280395 (small blind) folded before Flop
Seat 4: Mandooo97 (big blind) folded before Flop
Seat 6: khurlee.ts folded before Flop (didn't bet)
Seat 7: noway0ut_7 folded before Flop (didn't bet)
Seat 8: Imavere folded before Flop (didn't bet)

PokerStars Hand #250528471205: Tournament #3754315373, $4.80+$5.00+$1.20 USD Hold'em No Limit - Level XXXIV (4000/8000) - 2024/05/16 13:32:32 UTC [2024/05/16 9:32:32 ET]
Table '3754315373 2' 8-max Seat #2 is the button
Seat 2: Happy_Grubby (175903 in chips, $17.50 bounty) 
Seat 3: Anton280395 (368098 in chips, $37.80 bounty) 
Seat 4: Mandooo97 (532664 in chips, $68.30 bounty) 
Seat 6: khurlee.ts (273890 in chips, $61.70 bounty) 
Seat 7: noway0ut_7 (298647 in chips, $47.94 bounty) 
Seat 8: Imavere (123070 in chips, $48.43 bounty) 
Happy_Grubby: posts the ante 1200
Anton280395: posts the ante 1200
Mandooo97: posts the ante 1200
khurlee.ts: posts the ante 1200
noway0ut_7: posts the ante 1200
Imavere: posts the ante 1200
Anton280395: posts small blind 4000
Mandooo97: posts big blind 8000
*** HOLE CARDS ***
khurlee.ts: folds 
noway0ut_7: folds 
Imavere: folds 
Happy_Grubby: raises 8000 to 16000
Anton280395: folds 
Mandooo97: folds 
Uncalled bet (8000) returned to Happy_Grubby
Happy_Grubby collected 27200 from pot
Happy_Grubby: doesn't show hand 
*** SUMMARY ***
Total pot 27200 | Rake 0 
Seat 2: Happy_Grubby (button) collected (27200)
Seat 3: Anton280395 (small blind) folded before Flop
Seat 4: Mandooo97 (big blind) folded before Flop
Seat 6: khurlee.ts folded before Flop (didn't bet)
Seat 7: noway0ut_7 folded before Flop (didn't bet)
Seat 8: Imavere folded before Flop (didn't bet)

PokerStars Hand #250528474198: Tournament #3754315373, $4.80+$5.00+$1.20 USD Hold'em No Limit - Level XXXIV (4000/8000) - 2024/05/16 13:32:48 UTC [2024/05/16 9:32:48 ET]
Table '3754315373 2' 8-max Seat #3 is the button
Seat 2: Happy_Grubby (193903 in chips, $17.50 bounty) 
Seat 3: Anton280395 (362898 in chips, $37.80 bounty) 
Seat 4: Mandooo97 (523464 in chips, $68.30 bounty) 
Seat 6: khurlee.ts (272690 in chips, $61.70 bounty) 
Seat 7: noway0ut_7 (297447 in chips, $47.94 bounty) 
Seat 8: Imavere (121870 in chips, $48.43 bounty) 
Happy_Grubby: posts the ante 1200
Anton280395: posts the ante 1200
Mandooo97: posts the ante 1200
khurlee.ts: posts the ante 1200
noway0ut_7: posts the ante 1200
Imavere: posts the ante 1200
Mandooo97: posts small blind 4000
khurlee.ts: posts big blind 8000
*** HOLE CARDS ***
noway0ut_7: raises 8000 to 16000
Imavere: folds 
Happy_Grubby: folds 
Anton280395: calls 16000
Mandooo97: folds 
khurlee.ts: calls 8000
*** FLOP *** [6c 9c 9h]
khurlee.ts: checks 
noway0ut_7: checks 
Anton280395: bets 20000
khurlee.ts: calls 20000
noway0ut_7: folds 
*** TURN *** [6c 9c 9h] [Js]
khurlee.ts: checks 
Anton280395: checks 
*** RIVER *** [6c 9c 9h Js] [3s]
khurlee.ts: bets 20000
Anton280395: calls 20000
*** SHOW DOWN ***
khurlee.ts: shows [7c Kc] (a pair of Nines)
Anton280395: shows [5h 5s] (two pair, Nines and Fives)
Anton280395 collected 139200 from pot
*** SUMMARY ***
Total pot 139200 | Rake 0 
Board [6c 9c 9h Js 3s]
Seat 2: Happy_Grubby folded before Flop (didn't bet)
Seat 3: Anton280395 (button) showed [5h 5s] and won (139200) with two pair, Nines and Fives
Seat 4: Mandooo97 (small blind) folded before Flop
Seat 6: khurlee.ts (big blind) showed [7c Kc] and lost with a pair of Nines
Seat 7: noway0ut_7 folded on the Flop
Seat 8: Imavere folded before Flop (didn't bet)

PokerStars Hand #250528474198: Tournament #3754315373, $4.80+$5.00+$1.20 USD Hold'em No Limit - Level XXXIV (4000/8000) - 2024/05/16 13:32:48 UTC [2024/05/16 9:32:48 ET]
Table '3754315373 2' 8-max Seat #3 is the button
Seat 2: Happy_Grubby (193903 in chips, $17.50 bounty) 
Seat 3: Anton280395 (362898 in chips, $37.80 bounty) 
Seat 4: Mandooo97 (523464 in chips, $68.30 bounty) 
Seat 6: khurlee.ts (272690 in chips, $61.70 bounty) 
Seat 7: noway0ut_7 (297447 in chips, $47.94 bounty) 
Seat 8: Imavere (121870 in chips, $48.43 bounty) 
Happy_Grubby: posts the ante 1200
Anton280395: posts the ante 1200
Mandooo97: posts the ante 1200
khurlee.ts: posts the ante 1200
noway0ut_7: posts the ante 1200
Imavere: posts the ante 1200
Mandooo97: posts small blind 4000
khurlee.ts: posts big blind 8000
*** HOLE CARDS ***
noway0ut_7: raises 8000 to 16000
Imavere: folds 
Happy_Grubby: folds 
Anton280395: calls 16000
Mandooo97: folds 
khurlee.ts: calls 8000
*** FLOP *** [6c 9c 9h]
khurlee.ts: checks 
noway0ut_7: checks 
Anton280395: bets 20000
khurlee.ts: calls 20000
noway0ut_7: folds 
*** TURN *** [6c 9c 9h] [Js]
khurlee.ts: checks 
Anton280395: checks 
*** RIVER *** [6c 9c 9h Js] [3s]
khurlee.ts: bets 20000
Anton280395: calls 20000
*** SHOW DOWN ***
khurlee.ts: shows [7c Kc] (a pair of Nines)
Anton280395: shows [5h 5s] (two pair, Nines and Fives)
Anton280395 collected 139200 from pot
*** SUMMARY ***
Total pot 139200 | Rake 0 
Board [6c 9c 9h Js 3s]
Seat 2: Happy_Grubby folded before Flop (didn't bet)
Seat 3: Anton280395 (button) showed [5h 5s] and won (139200) with two pair, Nines and Fives
Seat 4: Mandooo97 (small blind) folded before Flop
Seat 6: khurlee.ts (big blind) showed [7c Kc] and lost with a pair of Nines
Seat 7: noway0ut_7 folded on the Flop
Seat 8: Imavere folded before Flop (didn't bet)

PokerStars Hand #250528485407: Tournament #3754315373, $4.80+$5.00+$1.20 USD Hold'em No Limit - Level XXXV (4500/9000) - 2024/05/16 13:33:50 UTC [2024/05/16 9:33:50 ET]
Table '3754315373 2' 8-max Seat #4 is the button
Seat 2: Happy_Grubby (192703 in chips, $17.50 bounty) 
Seat 3: Anton280395 (444898 in chips, $37.80 bounty) 
Seat 4: Mandooo97 (518264 in chips, $68.30 bounty) 
Seat 6: khurlee.ts (215490 in chips, $61.70 bounty) 
Seat 7: noway0ut_7 (280247 in chips, $47.94 bounty) 
Seat 8: Imavere (120670 in chips, $48.43 bounty) 
Happy_Grubby: posts the ante 1400
Anton280395: posts the ante 1400
Mandooo97: posts the ante 1400
khurlee.ts: posts the ante 1400
noway0ut_7: posts the ante 1400
Imavere: posts the ante 1400
khurlee.ts: posts small blind 4500
noway0ut_7: posts big blind 9000
*** HOLE CARDS ***
Imavere: folds 
Happy_Grubby: raises 9000 to 18000
Anton280395: folds 
Mandooo97: folds 
khurlee.ts: folds 
noway0ut_7: folds 
Uncalled bet (9000) returned to Happy_Grubby
Happy_Grubby collected 30900 from pot
Happy_Grubby: doesn't show hand 
*** SUMMARY ***
Total pot 30900 | Rake 0 
Seat 2: Happy_Grubby collected (30900)
Seat 3: Anton280395 folded before Flop (didn't bet)
Seat 4: Mandooo97 (button) folded before Flop (didn't bet)
Seat 6: khurlee.ts (small blind) folded before Flop
Seat 7: noway0ut_7 (big blind) folded before Flop
Seat 8: Imavere folded before Flop (didn't bet)

PokerStars Hand #250528485407: Tournament #3754315373, $4.80+$5.00+$1.20 USD Hold'em No Limit - Level XXXV (4500/9000) - 2024/05/16 13:33:50 UTC [2024/05/16 9:33:50 ET]
Table '3754315373 2' 8-max Seat #4 is the button
Seat 2: Happy_Grubby (192703 in chips, $17.50 bounty) 
Seat 3: Anton280395 (444898 in chips, $37.80 bounty) 
Seat 4: Mandooo97 (518264 in chips, $68.30 bounty) 
Seat 6: khurlee.ts (215490 in chips, $61.70 bounty) 
Seat 7: noway0ut_7 (280247 in chips, $47.94 bounty) 
Seat 8: Imavere (120670 in chips, $48.43 bounty) 
Happy_Grubby: posts the ante 1400
Anton280395: posts the ante 1400
Mandooo97: posts the ante 1400
khurlee.ts: posts the ante 1400
noway0ut_7: posts the ante 1400
Imavere: posts the ante 1400
khurlee.ts: posts small blind 4500
noway0ut_7: posts big blind 9000
*** HOLE CARDS ***
Imavere: folds 
Happy_Grubby: raises 9000 to 18000
Anton280395: folds 
Mandooo97: folds 
khurlee.ts: folds 
noway0ut_7: folds 
Uncalled bet (9000) returned to Happy_Grubby
Happy_Grubby collected 30900 from pot
Happy_Grubby: doesn't show hand 
*** SUMMARY ***
Total pot 30900 | Rake 0 
Seat 2: Happy_Grubby collected (30900)
Seat 3: Anton280395 folded before Flop (didn't bet)
Seat 4: Mandooo97 (button) folded before Flop (didn't bet)
Seat 6: khurlee.ts (small blind) folded before Flop
Seat 7: noway0ut_7 (big blind) folded before Flop
Seat 8: Imavere folded before Flop (didn't bet)

PokerStars Hand #250528488451: Tournament #3754315373, $4.80+$5.00+$1.20 USD Hold'em No Limit - Level XXXV (4500/9000) - 2024/05/16 13:34:06 UTC [2024/05/16 9:34:06 ET]
Table '3754315373 2' 8-max Seat #6 is the button
Seat 2: Happy_Grubby (213203 in chips, $17.50 bounty) 
Seat 3: Anton280395 (443498 in chips, $37.80 bounty) 
Seat 4: Mandooo97 (516864 in chips, $68.30 bounty) 
Seat 6: khurlee.ts (209590 in chips, $61.70 bounty) 
Seat 7: noway0ut_7 (269847 in chips, $47.94 bounty) 
Seat 8: Imavere (119270 in chips, $48.43 bounty) 
Happy_Grubby: posts the ante 1400
Anton280395: posts the ante 1400
Mandooo97: posts the ante 1400
khurlee.ts: posts the ante 1400
noway0ut_7: posts the ante 1400
Imavere: posts the ante 1400
noway0ut_7: posts small blind 4500
Imavere: posts big blind 9000
*** HOLE CARDS ***
Happy_Grubby: folds 
Anton280395: folds 
Mandooo97: raises 10800 to 19800
khurlee.ts: folds 
noway0ut_7: calls 15300
Imavere: folds 
*** FLOP *** [Jc Ad Qc]
noway0ut_7: checks 
Mandooo97: bets 14250
noway0ut_7: folds 
Uncalled bet (14250) returned to Mandooo97
Mandooo97 collected 57000 from pot
Mandooo97: doesn't show hand 
*** SUMMARY ***
Total pot 57000 | Rake 0 
Board [Jc Ad Qc]
Seat 2: Happy_Grubby folded before Flop (didn't bet)
Seat 3: Anton280395 folded before Flop (didn't bet)
Seat 4: Mandooo97 collected (57000)
Seat 6: khurlee.ts (button) folded before Flop (didn't bet)
Seat 7: noway0ut_7 (small blind) folded on the Flop
Seat 8: Imavere (big blind) folded before Flop

PokerStars Hand #250528488451: Tournament #3754315373, $4.80+$5.00+$1.20 USD Hold'em No Limit - Level XXXV (4500/9000) - 2024/05/16 13:34:06 UTC [2024/05/16 9:34:06 ET]
Table '3754315373 2' 8-max Seat #6 is the button
Seat 2: Happy_Grubby (213203 in chips, $17.50 bounty) 
Seat 3: Anton280395 (443498 in chips, $37.80 bounty) 
Seat 4: Mandooo97 (516864 in chips, $68.30 bounty) 
Seat 6: khurlee.ts (209590 in chips, $61.70 bounty) 
Seat 7: noway0ut_7 (269847 in chips, $47.94 bounty) 
Seat 8: Imavere (119270 in chips, $48.43 bounty) 
Happy_Grubby: posts the ante 1400
Anton280395: posts the ante 1400
Mandooo97: posts the ante 1400
khurlee.ts: posts the ante 1400
noway0ut_7: posts the ante 1400
Imavere: posts the ante 1400
noway0ut_7: posts small blind 4500
Imavere: posts big blind 9000
*** HOLE CARDS ***
Happy_Grubby: folds 
Anton280395: folds 
Mandooo97: raises 10800 to 19800
khurlee.ts: folds 
noway0ut_7: calls 15300
Imavere: folds 
*** FLOP *** [Jc Ad Qc]
noway0ut_7: checks 
Mandooo97: bets 14250
noway0ut_7: folds 
Uncalled bet (14250) returned to Mandooo97
Mandooo97 collected 57000 from pot
Mandooo97: doesn't show hand 
*** SUMMARY ***
Total pot 57000 | Rake 0 
Board [Jc Ad Qc]
Seat 2: Happy_Grubby folded before Flop (didn't bet)
Seat 3: Anton280395 folded before Flop (didn't bet)
Seat 4: Mandooo97 collected (57000)
Seat 6: khurlee.ts (button) folded before Flop (didn't bet)
Seat 7: noway0ut_7 (small blind) folded on the Flop
Seat 8: Imavere (big blind) folded before Flop

PokerStars Hand #250528492508: Tournament #3754315373, $4.80+$5.00+$1.20 USD Hold'em No Limit - Level XXXV (4500/9000) - 2024/05/16 13:34:29 UTC [2024/05/16 9:34:29 ET]
Table '3754315373 2' 8-max Seat #7 is the button
Seat 2: Happy_Grubby (211803 in chips, $17.50 bounty) 
Seat 3: Anton280395 (442098 in chips, $37.80 bounty) 
Seat 4: Mandooo97 (552664 in chips, $68.30 bounty) 
Seat 6: khurlee.ts (208190 in chips, $61.70 bounty) 
Seat 7: noway0ut_7 (248647 in chips, $47.94 bounty) 
Seat 8: Imavere (108870 in chips, $48.43 bounty) 
Happy_Grubby: posts the ante 1400
Anton280395: posts the ante 1400
Mandooo97: posts the ante 1400
khurlee.ts: posts the ante 1400
noway0ut_7: posts the ante 1400
Imavere: posts the ante 1400
Imavere: posts small blind 4500
Happy_Grubby: posts big blind 9000
*** HOLE CARDS ***
Anton280395: folds 
Mandooo97: folds 
khurlee.ts: folds 
noway0ut_7: raises 18000 to 27000
Imavere: folds 
Happy_Grubby: folds 
Uncalled bet (18000) returned to noway0ut_7
noway0ut_7 collected 30900 from pot
*** SUMMARY ***
Total pot 30900 | Rake 0 
Seat 2: Happy_Grubby (big blind) folded before Flop
Seat 3: Anton280395 folded before Flop (didn't bet)
Seat 4: Mandooo97 folded before Flop (didn't bet)
Seat 6: khurlee.ts folded before Flop (didn't bet)
Seat 7: noway0ut_7 (button) collected (30900)
Seat 8: Imavere (small blind) folded before Flop

PokerStars Hand #250528492508: Tournament #3754315373, $4.80+$5.00+$1.20 USD Hold'em No Limit - Level XXXV (4500/9000) - 2024/05/16 13:34:29 UTC [2024/05/16 9:34:29 ET]
Table '3754315373 2' 8-max Seat #7 is the button
Seat 2: Happy_Grubby (211803 in chips, $17.50 bounty) 
Seat 3: Anton280395 (442098 in chips, $37.80 bounty) 
Seat 4: Mandooo97 (552664 in chips, $68.30 bounty) 
Seat 6: khurlee.ts (208190 in chips, $61.70 bounty) 
Seat 7: noway0ut_7 (248647 in chips, $47.94 bounty) 
Seat 8: Imavere (108870 in chips, $48.43 bounty) 
Happy_Grubby: posts the ante 1400
Anton280395: posts the ante 1400
Mandooo97: posts the ante 1400
khurlee.ts: posts the ante 1400
noway0ut_7: posts the ante 1400
Imavere: posts the ante 1400
Imavere: posts small blind 4500
Happy_Grubby: posts big blind 9000
*** HOLE CARDS ***
Anton280395: folds 
Mandooo97: folds 
khurlee.ts: folds 
noway0ut_7: raises 18000 to 27000
Imavere: folds 
Happy_Grubby: folds 
Uncalled bet (18000) returned to noway0ut_7
noway0ut_7 collected 30900 from pot
*** SUMMARY ***
Total pot 30900 | Rake 0 
Seat 2: Happy_Grubby (big blind) folded before Flop
Seat 3: Anton280395 folded before Flop (didn't bet)
Seat 4: Mandooo97 folded before Flop (didn't bet)
Seat 6: khurlee.ts folded before Flop (didn't bet)
Seat 7: noway0ut_7 (button) collected (30900)
Seat 8: Imavere (small blind) folded before Flop

PokerStars Hand #250528497593: Tournament #3754315373, $4.80+$5.00+$1.20 USD Hold'em No Limit - Level XXXV (4500/9000) - 2024/05/16 13:34:57 UTC [2024/05/16 9:34:57 ET]
Table '3754315373 2' 8-max Seat #8 is the button
Seat 2: Happy_Grubby (201403 in chips, $17.50 bounty) 
Seat 3: Anton280395 (440698 in chips, $37.80 bounty) 
Seat 4: Mandooo97 (551264 in chips, $68.30 bounty) 
Seat 6: khurlee.ts (206790 in chips, $61.70 bounty) 
Seat 7: noway0ut_7 (269147 in chips, $47.94 bounty) 
Seat 8: Imavere (102970 in chips, $48.43 bounty) 
Happy_Grubby: posts the ante 1400
Anton280395: posts the ante 1400
Mandooo97: posts the ante 1400
khurlee.ts: posts the ante 1400
noway0ut_7: posts the ante 1400
Imavere: posts the ante 1400
Happy_Grubby: posts small blind 4500
Anton280395: posts big blind 9000
*** HOLE CARDS ***
Mandooo97: folds 
khurlee.ts: folds 
noway0ut_7: folds 
Imavere: folds 
Happy_Grubby: calls 4500
Anton280395: raises 18000 to 27000
Happy_Grubby: raises 173003 to 200003 and is all-in
Anton280395: folds 
Uncalled bet (173003) returned to Happy_Grubby
Happy_Grubby collected 62400 from pot
Happy_Grubby: doesn't show hand 
*** SUMMARY ***
Total pot 62400 | Rake 0 
Seat 2: Happy_Grubby (small blind) collected (62400)
Seat 3: Anton280395 (big blind) folded before Flop
Seat 4: Mandooo97 folded before Flop (didn't bet)
Seat 6: khurlee.ts folded before Flop (didn't bet)
Seat 7: noway0ut_7 folded before Flop (didn't bet)
Seat 8: Imavere (button) folded before Flop (didn't bet)

PokerStars Hand #250528497593: Tournament #3754315373, $4.80+$5.00+$1.20 USD Hold'em No Limit - Level XXXV (4500/9000) - 2024/05/16 13:34:57 UTC [2024/05/16 9:34:57 ET]
Table '3754315373 2' 8-max Seat #8 is the button
Seat 2: Happy_Grubby (201403 in chips, $17.50 bounty) 
Seat 3: Anton280395 (440698 in chips, $37.80 bounty) 
Seat 4: Mandooo97 (551264 in chips, $68.30 bounty) 
Seat 6: khurlee.ts (206790 in chips, $61.70 bounty) 
Seat 7: noway0ut_7 (269147 in chips, $47.94 bounty) 
Seat 8: Imavere (102970 in chips, $48.43 bounty) 
Happy_Grubby: posts the ante 1400
Anton280395: posts the ante 1400
Mandooo97: posts the ante 1400
khurlee.ts: posts the ante 1400
noway0ut_7: posts the ante 1400
Imavere: posts the ante 1400
Happy_Grubby: posts small blind 4500
Anton280395: posts big blind 9000
*** HOLE CARDS ***
Mandooo97: folds 
khurlee.ts: folds 
noway0ut_7: folds 
Imavere: folds 
Happy_Grubby: calls 4500
Anton280395: raises 18000 to 27000
Happy_Grubby: raises 173003 to 200003 and is all-in
Anton280395: folds 
Uncalled bet (173003) returned to Happy_Grubby
Happy_Grubby collected 62400 from pot
Happy_Grubby: doesn't show hand 
*** SUMMARY ***
Total pot 62400 | Rake 0 
Seat 2: Happy_Grubby (small blind) collected (62400)
Seat 3: Anton280395 (big blind) folded before Flop
Seat 4: Mandooo97 folded before Flop (didn't bet)
Seat 6: khurlee.ts folded before Flop (didn't bet)
Seat 7: noway0ut_7 folded before Flop (didn't bet)
Seat 8: Imavere (button) folded before Flop (didn't bet)

PokerStars Hand #250528502831: Tournament #3754315373, $4.80+$5.00+$1.20 USD Hold'em No Limit - Level XXXV (4500/9000) - 2024/05/16 13:35:26 UTC [2024/05/16 9:35:26 ET]
Table '3754315373 2' 8-max Seat #2 is the button
Seat 2: Happy_Grubby (235403 in chips, $17.50 bounty) 
Seat 3: Anton280395 (412298 in chips, $37.80 bounty) 
Seat 4: Mandooo97 (549864 in chips, $68.30 bounty) 
Seat 6: khurlee.ts (205390 in chips, $61.70 bounty) 
Seat 7: noway0ut_7 (267747 in chips, $47.94 bounty) 
Seat 8: Imavere (101570 in chips, $48.43 bounty) 
Happy_Grubby: posts the ante 1400
Anton280395: posts the ante 1400
Mandooo97: posts the ante 1400
khurlee.ts: posts the ante 1400
noway0ut_7: posts the ante 1400
Imavere: posts the ante 1400
Anton280395: posts small blind 4500
Mandooo97: posts big blind 9000
*** HOLE CARDS ***
khurlee.ts: folds 
noway0ut_7: folds 
Imavere: raises 9000 to 18000
Happy_Grubby is disconnected 
Happy_Grubby has timed out while disconnected
Happy_Grubby: folds 
Happy_Grubby is sitting out
Anton280395: folds 
Mandooo97: folds 
Uncalled bet (9000) returned to Imavere
Happy_Grubby has returned
Imavere collected 30900 from pot
*** SUMMARY ***
Total pot 30900 | Rake 0 
Seat 2: Happy_Grubby (button) folded before Flop (didn't bet)
Seat 3: Anton280395 (small blind) folded before Flop
Seat 4: Mandooo97 (big blind) folded before Flop
Seat 6: khurlee.ts folded before Flop (didn't bet)
Seat 7: noway0ut_7 folded before Flop (didn't bet)
Seat 8: Imavere collected (30900)

PokerStars Hand #250528502831: Tournament #3754315373, $4.80+$5.00+$1.20 USD Hold'em No Limit - Level XXXV (4500/9000) - 2024/05/16 13:35:26 UTC [2024/05/16 9:35:26 ET]
Table '3754315373 2' 8-max Seat #2 is the button
Seat 2: Happy_Grubby (235403 in chips, $17.50 bounty) 
Seat 3: Anton280395 (412298 in chips, $37.80 bounty) 
Seat 4: Mandooo97 (549864 in chips, $68.30 bounty) 
Seat 6: khurlee.ts (205390 in chips, $61.70 bounty) 
Seat 7: noway0ut_7 (267747 in chips, $47.94 bounty) 
Seat 8: Imavere (101570 in chips, $48.43 bounty) 
Happy_Grubby: posts the ante 1400
Anton280395: posts the ante 1400
Mandooo97: posts the ante 1400
khurlee.ts: posts the ante 1400
noway0ut_7: posts the ante 1400
Imavere: posts the ante 1400
Anton280395: posts small blind 4500
Mandooo97: posts big blind 9000
*** HOLE CARDS ***
khurlee.ts: folds 
noway0ut_7: folds 
Imavere: raises 9000 to 18000
Happy_Grubby is disconnected 
Happy_Grubby has timed out while disconnected
Happy_Grubby: folds 
Happy_Grubby is sitting out
Anton280395: folds 
Mandooo97: folds 
Uncalled bet (9000) returned to Imavere
Happy_Grubby has returned
Imavere collected 30900 from pot
*** SUMMARY ***
Total pot 30900 | Rake 0 
Seat 2: Happy_Grubby (button) folded before Flop (didn't bet)
Seat 3: Anton280395 (small blind) folded before Flop
Seat 4: Mandooo97 (big blind) folded before Flop
Seat 6: khurlee.ts folded before Flop (didn't bet)
Seat 7: noway0ut_7 folded before Flop (didn't bet)
Seat 8: Imavere collected (30900)

PokerStars Hand #250528509285: Tournament #3754315373, $4.80+$5.00+$1.20 USD Hold'em No Limit - Level XXXV (4500/9000) - 2024/05/16 13:36:01 UTC [2024/05/16 9:36:01 ET]
Table '3754315373 2' 8-max Seat #3 is the button
Seat 2: Happy_Grubby (234003 in chips, $17.50 bounty) 
Seat 3: Anton280395 (406398 in chips, $37.80 bounty) 
Seat 4: Mandooo97 (539464 in chips, $68.30 bounty) 
Seat 6: khurlee.ts (203990 in chips, $61.70 bounty) 
Seat 7: noway0ut_7 (266347 in chips, $47.94 bounty) 
Seat 8: Imavere (122070 in chips, $48.43 bounty) 
Happy_Grubby: posts the ante 1400
Anton280395: posts the ante 1400
Mandooo97: posts the ante 1400
khurlee.ts: posts the ante 1400
noway0ut_7: posts the ante 1400
Imavere: posts the ante 1400
Mandooo97: posts small blind 4500
khurlee.ts: posts big blind 9000
*** HOLE CARDS ***
noway0ut_7: folds 
Imavere: folds 
Happy_Grubby: folds 
Anton280395: raises 13500 to 22500
Mandooo97: folds 
khurlee.ts: folds 
Uncalled bet (13500) returned to Anton280395
Anton280395 collected 30900 from pot
Anton280395: doesn't show hand 
*** SUMMARY ***
Total pot 30900 | Rake 0 
Seat 2: Happy_Grubby folded before Flop (didn't bet)
Seat 3: Anton280395 (button) collected (30900)
Seat 4: Mandooo97 (small blind) folded before Flop
Seat 6: khurlee.ts (big blind) folded before Flop
Seat 7: noway0ut_7 folded before Flop (didn't bet)
Seat 8: Imavere folded before Flop (didn't bet)

PokerStars Hand #250528509285: Tournament #3754315373, $4.80+$5.00+$1.20 USD Hold'em No Limit - Level XXXV (4500/9000) - 2024/05/16 13:36:01 UTC [2024/05/16 9:36:01 ET]
Table '3754315373 2' 8-max Seat #3 is the button
Seat 2: Happy_Grubby (234003 in chips, $17.50 bounty) 
Seat 3: Anton280395 (406398 in chips, $37.80 bounty) 
Seat 4: Mandooo97 (539464 in chips, $68.30 bounty) 
Seat 6: khurlee.ts (203990 in chips, $61.70 bounty) 
Seat 7: noway0ut_7 (266347 in chips, $47.94 bounty) 
Seat 8: Imavere (122070 in chips, $48.43 bounty) 
Happy_Grubby: posts the ante 1400
Anton280395: posts the ante 1400
Mandooo97: posts the ante 1400
khurlee.ts: posts the ante 1400
noway0ut_7: posts the ante 1400
Imavere: posts the ante 1400
Mandooo97: posts small blind 4500
khurlee.ts: posts big blind 9000
*** HOLE CARDS ***
noway0ut_7: folds 
Imavere: folds 
Happy_Grubby: folds 
Anton280395: raises 13500 to 22500
Mandooo97: folds 
khurlee.ts: folds 
Uncalled bet (13500) returned to Anton280395
Anton280395 collected 30900 from pot
Anton280395: doesn't show hand 
*** SUMMARY ***
Total pot 30900 | Rake 0 
Seat 2: Happy_Grubby folded before Flop (didn't bet)
Seat 3: Anton280395 (button) collected (30900)
Seat 4: Mandooo97 (small blind) folded before Flop
Seat 6: khurlee.ts (big blind) folded before Flop
Seat 7: noway0ut_7 folded before Flop (didn't bet)
Seat 8: Imavere folded before Flop (didn't bet)

PokerStars Hand #250528515532: Tournament #3754315373, $4.80+$5.00+$1.20 USD Hold'em No Limit - Level XXXV (4500/9000) - 2024/05/16 13:36:34 UTC [2024/05/16 9:36:34 ET]
Table '3754315373 2' 8-max Seat #4 is the button
Seat 2: Happy_Grubby (232603 in chips, $17.50 bounty) 
Seat 3: Anton280395 (426898 in chips, $37.80 bounty) 
Seat 4: Mandooo97 (533564 in chips, $68.30 bounty) 
Seat 6: khurlee.ts (193590 in chips, $61.70 bounty) 
Seat 7: noway0ut_7 (264947 in chips, $47.94 bounty) 
Seat 8: Imavere (120670 in chips, $48.43 bounty) 
Happy_Grubby: posts the ante 1400
Anton280395: posts the ante 1400
Mandooo97: posts the ante 1400
khurlee.ts: posts the ante 1400
noway0ut_7: posts the ante 1400
Imavere: posts the ante 1400
khurlee.ts: posts small blind 4500
noway0ut_7: posts big blind 9000
*** HOLE CARDS ***
Imavere: folds 
Happy_Grubby: raises 11700 to 20700
Anton280395: folds 
Mandooo97: folds 
khurlee.ts: folds 
noway0ut_7: folds 
Uncalled bet (11700) returned to Happy_Grubby
Happy_Grubby collected 30900 from pot
Happy_Grubby: doesn't show hand 
*** SUMMARY ***
Total pot 30900 | Rake 0 
Seat 2: Happy_Grubby collected (30900)
Seat 3: Anton280395 folded before Flop (didn't bet)
Seat 4: Mandooo97 (button) folded before Flop (didn't bet)
Seat 6: khurlee.ts (small blind) folded before Flop
Seat 7: noway0ut_7 (big blind) folded before Flop
Seat 8: Imavere folded before Flop (didn't bet)

PokerStars Hand #250528515532: Tournament #3754315373, $4.80+$5.00+$1.20 USD Hold'em No Limit - Level XXXV (4500/9000) - 2024/05/16 13:36:34 UTC [2024/05/16 9:36:34 ET]
Table '3754315373 2' 8-max Seat #4 is the button
Seat 2: Happy_Grubby (232603 in chips, $17.50 bounty) 
Seat 3: Anton280395 (426898 in chips, $37.80 bounty) 
Seat 4: Mandooo97 (533564 in chips, $68.30 bounty) 
Seat 6: khurlee.ts (193590 in chips, $61.70 bounty) 
Seat 7: noway0ut_7 (264947 in chips, $47.94 bounty) 
Seat 8: Imavere (120670 in chips, $48.43 bounty) 
Happy_Grubby: posts the ante 1400
Anton280395: posts the ante 1400
Mandooo97: posts the ante 1400
khurlee.ts: posts the ante 1400
noway0ut_7: posts the ante 1400
Imavere: posts the ante 1400
khurlee.ts: posts small blind 4500
noway0ut_7: posts big blind 9000
*** HOLE CARDS ***
Imavere: folds 
Happy_Grubby: raises 11700 to 20700
Anton280395: folds 
Mandooo97: folds 
khurlee.ts: folds 
noway0ut_7: folds 
Uncalled bet (11700) returned to Happy_Grubby
Happy_Grubby collected 30900 from pot
Happy_Grubby: doesn't show hand 
*** SUMMARY ***
Total pot 30900 | Rake 0 
Seat 2: Happy_Grubby collected (30900)
Seat 3: Anton280395 folded before Flop (didn't bet)
Seat 4: Mandooo97 (button) folded before Flop (didn't bet)
Seat 6: khurlee.ts (small blind) folded before Flop
Seat 7: noway0ut_7 (big blind) folded before Flop
Seat 8: Imavere folded before Flop (didn't bet)

PokerStars Hand #250528518172: Tournament #3754315373, $4.80+$5.00+$1.20 USD Hold'em No Limit - Level XXXV (4500/9000) - 2024/05/16 13:36:48 UTC [2024/05/16 9:36:48 ET]
Table '3754315373 2' 8-max Seat #6 is the button
Seat 2: Happy_Grubby (253103 in chips, $17.50 bounty) 
Seat 3: Anton280395 (425498 in chips, $37.80 bounty) 
Seat 4: Mandooo97 (532164 in chips, $68.30 bounty) 
Seat 6: khurlee.ts (187690 in chips, $61.70 bounty) 
Seat 7: noway0ut_7 (254547 in chips, $47.94 bounty) 
Seat 8: Imavere (119270 in chips, $48.43 bounty) 
Happy_Grubby: posts the ante 1400
Anton280395: posts the ante 1400
Mandooo97: posts the ante 1400
khurlee.ts: posts the ante 1400
noway0ut_7: posts the ante 1400
Imavere: posts the ante 1400
noway0ut_7: posts small blind 4500
Imavere: posts big blind 9000
*** HOLE CARDS ***
Happy_Grubby: folds 
Anton280395: folds 
Mandooo97: raises 9000 to 18000
khurlee.ts: folds 
noway0ut_7: calls 13500
Imavere: folds 
*** FLOP *** [5s 4c 2h]
noway0ut_7: checks 
Mandooo97: bets 27000
noway0ut_7: folds 
Uncalled bet (27000) returned to Mandooo97
Mandooo97 collected 53400 from pot
Mandooo97: doesn't show hand 
*** SUMMARY ***
Total pot 53400 | Rake 0 
Board [5s 4c 2h]
Seat 2: Happy_Grubby folded before Flop (didn't bet)
Seat 3: Anton280395 folded before Flop (didn't bet)
Seat 4: Mandooo97 collected (53400)
Seat 6: khurlee.ts (button) folded before Flop (didn't bet)
Seat 7: noway0ut_7 (small blind) folded on the Flop
Seat 8: Imavere (big blind) folded before Flop

PokerStars Hand #250528518172: Tournament #3754315373, $4.80+$5.00+$1.20 USD Hold'em No Limit - Level XXXV (4500/9000) - 2024/05/16 13:36:48 UTC [2024/05/16 9:36:48 ET]
Table '3754315373 2' 8-max Seat #6 is the button
Seat 2: Happy_Grubby (253103 in chips, $17.50 bounty) 
Seat 3: Anton280395 (425498 in chips, $37.80 bounty) 
Seat 4: Mandooo97 (532164 in chips, $68.30 bounty) 
Seat 6: khurlee.ts (187690 in chips, $61.70 bounty) 
Seat 7: noway0ut_7 (254547 in chips, $47.94 bounty) 
Seat 8: Imavere (119270 in chips, $48.43 bounty) 
Happy_Grubby: posts the ante 1400
Anton280395: posts the ante 1400
Mandooo97: posts the ante 1400
khurlee.ts: posts the ante 1400
noway0ut_7: posts the ante 1400
Imavere: posts the ante 1400
noway0ut_7: posts small blind 4500
Imavere: posts big blind 9000
*** HOLE CARDS ***
Happy_Grubby: folds 
Anton280395: folds 
Mandooo97: raises 9000 to 18000
khurlee.ts: folds 
noway0ut_7: calls 13500
Imavere: folds 
*** FLOP *** [5s 4c 2h]
noway0ut_7: checks 
Mandooo97: bets 27000
noway0ut_7: folds 
Uncalled bet (27000) returned to Mandooo97
Mandooo97 collected 53400 from pot
Mandooo97: doesn't show hand 
*** SUMMARY ***
Total pot 53400 | Rake 0 
Board [5s 4c 2h]
Seat 2: Happy_Grubby folded before Flop (didn't bet)
Seat 3: Anton280395 folded before Flop (didn't bet)
Seat 4: Mandooo97 collected (53400)
Seat 6: khurlee.ts (button) folded before Flop (didn't bet)
Seat 7: noway0ut_7 (small blind) folded on the Flop
Seat 8: Imavere (big blind) folded before Flop

PokerStars Hand #250528524810: Tournament #3754315373, $4.80+$5.00+$1.20 USD Hold'em No Limit - Level XXXV (4500/9000) - 2024/05/16 13:37:24 UTC [2024/05/16 9:37:24 ET]
Table '3754315373 2' 8-max Seat #7 is the button
Seat 2: Happy_Grubby (251703 in chips, $17.50 bounty) 
Seat 3: Anton280395 (424098 in chips, $37.80 bounty) 
Seat 4: Mandooo97 (566164 in chips, $68.30 bounty) 
Seat 6: khurlee.ts (186290 in chips, $61.70 bounty) 
Seat 7: noway0ut_7 (235147 in chips, $47.94 bounty) 
Seat 8: Imavere (108870 in chips, $48.43 bounty) 
Happy_Grubby: posts the ante 1400
Anton280395: posts the ante 1400
Mandooo97: posts the ante 1400
khurlee.ts: posts the ante 1400
noway0ut_7: posts the ante 1400
Imavere: posts the ante 1400
Imavere: posts small blind 4500
Happy_Grubby: posts big blind 9000
*** HOLE CARDS ***
Anton280395: folds 
Mandooo97: raises 9000 to 18000
khurlee.ts: folds 
noway0ut_7: folds 
Imavere: folds 
Happy_Grubby: folds 
Uncalled bet (9000) returned to Mandooo97
Mandooo97 collected 30900 from pot
Mandooo97: doesn't show hand 
*** SUMMARY ***
Total pot 30900 | Rake 0 
Seat 2: Happy_Grubby (big blind) folded before Flop
Seat 3: Anton280395 folded before Flop (didn't bet)
Seat 4: Mandooo97 collected (30900)
Seat 6: khurlee.ts folded before Flop (didn't bet)
Seat 7: noway0ut_7 (button) folded before Flop (didn't bet)
Seat 8: Imavere (small blind) folded before Flop

PokerStars Hand #250528524810: Tournament #3754315373, $4.80+$5.00+$1.20 USD Hold'em No Limit - Level XXXV (4500/9000) - 2024/05/16 13:37:24 UTC [2024/05/16 9:37:24 ET]
Table '3754315373 2' 8-max Seat #7 is the button
Seat 2: Happy_Grubby (251703 in chips, $17.50 bounty) 
Seat 3: Anton280395 (424098 in chips, $37.80 bounty) 
Seat 4: Mandooo97 (566164 in chips, $68.30 bounty) 
Seat 6: khurlee.ts (186290 in chips, $61.70 bounty) 
Seat 7: noway0ut_7 (235147 in chips, $47.94 bounty) 
Seat 8: Imavere (108870 in chips, $48.43 bounty) 
Happy_Grubby: posts the ante 1400
Anton280395: posts the ante 1400
Mandooo97: posts the ante 1400
khurlee.ts: posts the ante 1400
noway0ut_7: posts the ante 1400
Imavere: posts the ante 1400
Imavere: posts small blind 4500
Happy_Grubby: posts big blind 9000
*** HOLE CARDS ***
Anton280395: folds 
Mandooo97: raises 9000 to 18000
khurlee.ts: folds 
noway0ut_7: folds 
Imavere: folds 
Happy_Grubby: folds 
Uncalled bet (9000) returned to Mandooo97
Mandooo97 collected 30900 from pot
Mandooo97: doesn't show hand 
*** SUMMARY ***
Total pot 30900 | Rake 0 
Seat 2: Happy_Grubby (big blind) folded before Flop
Seat 3: Anton280395 folded before Flop (didn't bet)
Seat 4: Mandooo97 collected (30900)
Seat 6: khurlee.ts folded before Flop (didn't bet)
Seat 7: noway0ut_7 (button) folded before Flop (didn't bet)
Seat 8: Imavere (small blind) folded before Flop

PokerStars Hand #250528529850: Tournament #3754315373, $4.80+$5.00+$1.20 USD Hold'em No Limit - Level XXXV (4500/9000) - 2024/05/16 13:37:51 UTC [2024/05/16 9:37:51 ET]
Table '3754315373 2' 8-max Seat #8 is the button
Seat 2: Happy_Grubby (241303 in chips, $17.50 bounty) 
Seat 3: Anton280395 (422698 in chips, $37.80 bounty) 
Seat 4: Mandooo97 (586664 in chips, $68.30 bounty) 
Seat 6: khurlee.ts (184890 in chips, $61.70 bounty) 
Seat 7: noway0ut_7 (233747 in chips, $47.94 bounty) 
Seat 8: Imavere (102970 in chips, $48.43 bounty) 
Happy_Grubby: posts the ante 1400
Anton280395: posts the ante 1400
Mandooo97: posts the ante 1400
khurlee.ts: posts the ante 1400
noway0ut_7: posts the ante 1400
Imavere: posts the ante 1400
Happy_Grubby: posts small blind 4500
Anton280395: posts big blind 9000
*** HOLE CARDS ***
Mandooo97: folds 
khurlee.ts: raises 9000 to 18000
noway0ut_7: folds 
Imavere: folds 
Happy_Grubby: folds 
Anton280395: calls 9000
*** FLOP *** [4s Td 7s]
Anton280395: checks 
khurlee.ts: bets 16137
Anton280395: raises 28863 to 45000
khurlee.ts: calls 28863
*** TURN *** [4s Td 7s] [8s]
Anton280395: bets 31500
khurlee.ts: raises 88990 to 120490 and is all-in
Anton280395: folds 
Uncalled bet (88990) returned to khurlee.ts
khurlee.ts collected 201900 from pot
khurlee.ts: doesn't show hand 
*** SUMMARY ***
Total pot 201900 | Rake 0 
Board [4s Td 7s 8s]
Seat 2: Happy_Grubby (small blind) folded before Flop
Seat 3: Anton280395 (big blind) folded on the Turn
Seat 4: Mandooo97 folded before Flop (didn't bet)
Seat 6: khurlee.ts collected (201900)
Seat 7: noway0ut_7 folded before Flop (didn't bet)
Seat 8: Imavere (button) folded before Flop (didn't bet)

PokerStars Hand #250528529850: Tournament #3754315373, $4.80+$5.00+$1.20 USD Hold'em No Limit - Level XXXV (4500/9000) - 2024/05/16 13:37:51 UTC [2024/05/16 9:37:51 ET]
Table '3754315373 2' 8-max Seat #8 is the button
Seat 2: Happy_Grubby (241303 in chips, $17.50 bounty) 
Seat 3: Anton280395 (422698 in chips, $37.80 bounty) 
Seat 4: Mandooo97 (586664 in chips, $68.30 bounty) 
Seat 6: khurlee.ts (184890 in chips, $61.70 bounty) 
Seat 7: noway0ut_7 (233747 in chips, $47.94 bounty) 
Seat 8: Imavere (102970 in chips, $48.43 bounty) 
Happy_Grubby: posts the ante 1400
Anton280395: posts the ante 1400
Mandooo97: posts the ante 1400
khurlee.ts: posts the ante 1400
noway0ut_7: posts the ante 1400
Imavere: posts the ante 1400
Happy_Grubby: posts small blind 4500
Anton280395: posts big blind 9000
*** HOLE CARDS ***
Mandooo97: folds 
khurlee.ts: raises 9000 to 18000
noway0ut_7: folds 
Imavere: folds 
Happy_Grubby: folds 
Anton280395: calls 9000
*** FLOP *** [4s Td 7s]
Anton280395: checks 
khurlee.ts: bets 16137
Anton280395: raises 28863 to 45000
khurlee.ts: calls 28863
*** TURN *** [4s Td 7s] [8s]
Anton280395: bets 31500
khurlee.ts: raises 88990 to 120490 and is all-in
Anton280395: folds 
Uncalled bet (88990) returned to khurlee.ts
khurlee.ts collected 201900 from pot
khurlee.ts: doesn't show hand 
*** SUMMARY ***
Total pot 201900 | Rake 0 
Board [4s Td 7s 8s]
Seat 2: Happy_Grubby (small blind) folded before Flop
Seat 3: Anton280395 (big blind) folded on the Turn
Seat 4: Mandooo97 folded before Flop (didn't bet)
Seat 6: khurlee.ts collected (201900)
Seat 7: noway0ut_7 folded before Flop (didn't bet)
Seat 8: Imavere (button) folded before Flop (didn't bet)

PokerStars Hand #250528544531: Tournament #3754315373, $4.80+$5.00+$1.20 USD Hold'em No Limit - Level XXXV (4500/9000) - 2024/05/16 13:39:10 UTC [2024/05/16 9:39:10 ET]
Table '3754315373 2' 8-max Seat #2 is the button
Seat 2: Happy_Grubby (235403 in chips, $17.50 bounty) 
Seat 3: Anton280395 (326798 in chips, $37.80 bounty) 
Seat 4: Mandooo97 (585264 in chips, $68.30 bounty) 
Seat 6: khurlee.ts (290890 in chips, $61.70 bounty) 
Seat 7: noway0ut_7 (232347 in chips, $47.94 bounty) 
Seat 8: Imavere (101570 in chips, $48.43 bounty) 
Happy_Grubby: posts the ante 1400
Anton280395: posts the ante 1400
Mandooo97: posts the ante 1400
khurlee.ts: posts the ante 1400
noway0ut_7: posts the ante 1400
Imavere: posts the ante 1400
Anton280395: posts small blind 4500
Mandooo97: posts big blind 9000
*** HOLE CARDS ***
khurlee.ts: folds 
noway0ut_7: folds 
Imavere: folds 
Happy_Grubby: folds 
Anton280395: folds 
Uncalled bet (4500) returned to Mandooo97
Mandooo97 collected 17400 from pot
Mandooo97: doesn't show hand 
*** SUMMARY ***
Total pot 17400 | Rake 0 
Seat 2: Happy_Grubby (button) folded before Flop (didn't bet)
Seat 3: Anton280395 (small blind) folded before Flop
Seat 4: Mandooo97 (big blind) collected (17400)
Seat 6: khurlee.ts folded before Flop (didn't bet)
Seat 7: noway0ut_7 folded before Flop (didn't bet)
Seat 8: Imavere folded before Flop (didn't bet)

PokerStars Hand #250528544531: Tournament #3754315373, $4.80+$5.00+$1.20 USD Hold'em No Limit - Level XXXV (4500/9000) - 2024/05/16 13:39:10 UTC [2024/05/16 9:39:10 ET]
Table '3754315373 2' 8-max Seat #2 is the button
Seat 2: Happy_Grubby (235403 in chips, $17.50 bounty) 
Seat 3: Anton280395 (326798 in chips, $37.80 bounty) 
Seat 4: Mandooo97 (585264 in chips, $68.30 bounty) 
Seat 6: khurlee.ts (290890 in chips, $61.70 bounty) 
Seat 7: noway0ut_7 (232347 in chips, $47.94 bounty) 
Seat 8: Imavere (101570 in chips, $48.43 bounty) 
Happy_Grubby: posts the ante 1400
Anton280395: posts the ante 1400
Mandooo97: posts the ante 1400
khurlee.ts: posts the ante 1400
noway0ut_7: posts the ante 1400
Imavere: posts the ante 1400
Anton280395: posts small blind 4500
Mandooo97: posts big blind 9000
*** HOLE CARDS ***
khurlee.ts: folds 
noway0ut_7: folds 
Imavere: folds 
Happy_Grubby: folds 
Anton280395: folds 
Uncalled bet (4500) returned to Mandooo97
Mandooo97 collected 17400 from pot
Mandooo97: doesn't show hand 
*** SUMMARY ***
Total pot 17400 | Rake 0 
Seat 2: Happy_Grubby (button) folded before Flop (didn't bet)
Seat 3: Anton280395 (small blind) folded before Flop
Seat 4: Mandooo97 (big blind) collected (17400)
Seat 6: khurlee.ts folded before Flop (didn't bet)
Seat 7: noway0ut_7 folded before Flop (didn't bet)
Seat 8: Imavere folded before Flop (didn't bet)

PokerStars Hand #250528546577: Tournament #3754315373, $4.80+$5.00+$1.20 USD Hold'em No Limit - Level XXXV (4500/9000) - 2024/05/16 13:39:21 UTC [2024/05/16 9:39:21 ET]
Table '3754315373 2' 8-max Seat #3 is the button
Seat 2: Happy_Grubby (234003 in chips, $17.50 bounty) 
Seat 3: Anton280395 (320898 in chips, $37.80 bounty) 
Seat 4: Mandooo97 (596764 in chips, $68.30 bounty) 
Seat 6: khurlee.ts (289490 in chips, $61.70 bounty) 
Seat 7: noway0ut_7 (230947 in chips, $47.94 bounty) 
Seat 8: Imavere (100170 in chips, $48.43 bounty) 
Happy_Grubby: posts the ante 1400
Anton280395: posts the ante 1400
Mandooo97: posts the ante 1400
khurlee.ts: posts the ante 1400
noway0ut_7: posts the ante 1400
Imavere: posts the ante 1400
Mandooo97: posts small blind 4500
khurlee.ts: posts big blind 9000
*** HOLE CARDS ***
noway0ut_7: folds 
Imavere: folds 
Happy_Grubby: raises 9000 to 18000
Anton280395: folds 
Mandooo97: raises 72000 to 90000
khurlee.ts: folds 
Happy_Grubby: raises 142603 to 232603 and is all-in
Mandooo97: calls 142603
*** FLOP *** [As 8h 5d]
*** TURN *** [As 8h 5d] [4s]
*** RIVER *** [As 8h 5d 4s] [3d]
*** SHOW DOWN ***
Mandooo97: shows [Ac Qd] (a pair of Aces)
Happy_Grubby: shows [Qs Qh] (a pair of Queens)
Mandooo97 collected 482606 from pot
Mandooo97 wins $8.75 for eliminating Happy_Grubby and their own bounty increases by $8.75 to $77.05
Happy_Grubby finished the tournament in 13th place and received $36.35.
*** SUMMARY ***
Total pot 482606 | Rake 0 
Board [As 8h 5d 4s 3d]
Seat 2: Happy_Grubby showed [Qs Qh] and lost with a pair of Queens
Seat 3: Anton280395 (button) folded before Flop (didn't bet)
Seat 4: Mandooo97 (small blind) showed [Ac Qd] and won (482606) with a pair of Aces
Seat 6: khurlee.ts (big blind) folded before Flop
Seat 7: noway0ut_7 folded before Flop (didn't bet)
Seat 8: Imavere folded before Flop (didn't bet)

PokerStars Hand #250528546577: Tournament #3754315373, $4.80+$5.00+$1.20 USD Hold'em No Limit - Level XXXV (4500/9000) - 2024/05/16 13:39:21 UTC [2024/05/16 9:39:21 ET]
Table '3754315373 2' 8-max Seat #3 is the button
Seat 2: Happy_Grubby (234003 in chips, $17.50 bounty) 
Seat 3: Anton280395 (320898 in chips, $37.80 bounty) 
Seat 4: Mandooo97 (596764 in chips, $68.30 bounty) 
Seat 6: khurlee.ts (289490 in chips, $61.70 bounty) 
Seat 7: noway0ut_7 (230947 in chips, $47.94 bounty) 
Seat 8: Imavere (100170 in chips, $48.43 bounty) 
Happy_Grubby: posts the ante 1400
Anton280395: posts the ante 1400
Mandooo97: posts the ante 1400
khurlee.ts: posts the ante 1400
noway0ut_7: posts the ante 1400
Imavere: posts the ante 1400
Mandooo97: posts small blind 4500
khurlee.ts: posts big blind 9000
*** HOLE CARDS ***
noway0ut_7: folds 
Imavere: folds 
Happy_Grubby: raises 9000 to 18000
Anton280395: folds 
Mandooo97: raises 72000 to 90000
khurlee.ts: folds 
Happy_Grubby: raises 142603 to 232603 and is all-in
Mandooo97: calls 142603
*** FLOP *** [As 8h 5d]
*** TURN *** [As 8h 5d] [4s]
*** RIVER *** [As 8h 5d 4s] [3d]
*** SHOW DOWN ***
Mandooo97: shows [Ac Qd] (a pair of Aces)
Happy_Grubby: shows [Qs Qh] (a pair of Queens)
Mandooo97 collected 482606 from pot
Mandooo97 wins $8.75 for eliminating Happy_Grubby and their own bounty increases by $8.75 to $77.05
Happy_Grubby finished the tournament in 13th place and received $36.35.
*** SUMMARY ***
Total pot 482606 | Rake 0 
Board [As 8h 5d 4s 3d]
Seat 2: Happy_Grubby showed [Qs Qh] and lost with a pair of Queens
Seat 3: Anton280395 (button) folded before Flop (didn't bet)
Seat 4: Mandooo97 (small blind) showed [Ac Qd] and won (482606) with a pair of Aces
Seat 6: khurlee.ts (big blind) folded before Flop
Seat 7: noway0ut_7 folded before Flop (didn't bet)
Seat 8: Imavere folded before Flop (didn't bet)

PokerStars Hand #250528551264: Tournament #3754315373, $4.80+$5.00+$1.20 USD Hold'em No Limit - Level XXXV (4500/9000) - 2024/05/16 13:39:46 UTC [2024/05/16 9:39:46 ET]
Table '3754315373 2' 8-max Seat #4 is the button
Seat 3: Anton280395 (319498 in chips, $37.80 bounty) 
Seat 4: Mandooo97 (845367 in chips, $77.05 bounty) 
Seat 6: khurlee.ts (279090 in chips, $61.70 bounty) 
Seat 7: noway0ut_7 (229547 in chips, $47.94 bounty) 
Seat 8: Imavere (98770 in chips, $48.43 bounty) 
Anton280395: posts the ante 1400
Mandooo97: posts the ante 1400
khurlee.ts: posts the ante 1400
noway0ut_7: posts the ante 1400
Imavere: posts the ante 1400
khurlee.ts: posts small blind 4500
noway0ut_7: posts big blind 9000
*** HOLE CARDS ***
Imavere: folds 
Anton280395: folds 
Mandooo97: folds 
khurlee.ts: raises 9000 to 18000
noway0ut_7: folds 
Uncalled bet (9000) returned to khurlee.ts
khurlee.ts collected 25000 from pot
khurlee.ts: doesn't show hand 
*** SUMMARY ***
Total pot 25000 | Rake 0 
Seat 3: Anton280395 folded before Flop (didn't bet)
Seat 4: Mandooo97 (button) folded before Flop (didn't bet)
Seat 6: khurlee.ts (small blind) collected (25000)
Seat 7: noway0ut_7 (big blind) folded before Flop
Seat 8: Imavere folded before Flop (didn't bet)

PokerStars Hand #250528551264: Tournament #3754315373, $4.80+$5.00+$1.20 USD Hold'em No Limit - Level XXXV (4500/9000) - 2024/05/16 13:39:46 UTC [2024/05/16 9:39:46 ET]
Table '3754315373 2' 8-max Seat #4 is the button
Seat 3: Anton280395 (319498 in chips, $37.80 bounty) 
Seat 4: Mandooo97 (845367 in chips, $77.05 bounty) 
Seat 6: khurlee.ts (279090 in chips, $61.70 bounty) 
Seat 7: noway0ut_7 (229547 in chips, $47.94 bounty) 
Seat 8: Imavere (98770 in chips, $48.43 bounty) 
Anton280395: posts the ante 1400
Mandooo97: posts the ante 1400
khurlee.ts: posts the ante 1400
noway0ut_7: posts the ante 1400
Imavere: posts the ante 1400
khurlee.ts: posts small blind 4500
noway0ut_7: posts big blind 9000
*** HOLE CARDS ***
Imavere: folds 
Anton280395: folds 
Mandooo97: folds 
khurlee.ts: raises 9000 to 18000
noway0ut_7: folds 
Uncalled bet (9000) returned to khurlee.ts
khurlee.ts collected 25000 from pot
khurlee.ts: doesn't show hand 
*** SUMMARY ***
Total pot 25000 | Rake 0 
Seat 3: Anton280395 folded before Flop (didn't bet)
Seat 4: Mandooo97 (button) folded before Flop (didn't bet)
Seat 6: khurlee.ts (small blind) collected (25000)
Seat 7: noway0ut_7 (big blind) folded before Flop
Seat 8: Imavere folded before Flop (didn't bet)

PokerStars Hand #250528555287: Tournament #3754315373, $4.80+$5.00+$1.20 USD Hold'em No Limit - Level XXXV (4500/9000) - 2024/05/16 13:40:08 UTC [2024/05/16 9:40:08 ET]
Table '3754315373 2' 8-max Seat #6 is the button
Seat 3: Anton280395 (318098 in chips, $37.80 bounty) 
Seat 4: Mandooo97 (843967 in chips, $77.05 bounty) 
Seat 6: khurlee.ts (293690 in chips, $61.70 bounty) 
Seat 7: noway0ut_7 (219147 in chips, $47.94 bounty) 
Seat 8: Imavere (97370 in chips, $48.43 bounty) 
Anton280395: posts the ante 1400
Mandooo97: posts the ante 1400
khurlee.ts: posts the ante 1400
noway0ut_7: posts the ante 1400
Imavere: posts the ante 1400
noway0ut_7: posts small blind 4500
Imavere: posts big blind 9000
*** HOLE CARDS ***
SSS1965 is disconnected 
Anton280395: folds 
Mandooo97: folds 
khurlee.ts: raises 9000 to 18000
noway0ut_7: folds 
Imavere: folds [2s 8d]
Uncalled bet (9000) returned to khurlee.ts
khurlee.ts collected 29500 from pot
khurlee.ts: doesn't show hand 
*** SUMMARY ***
Total pot 29500 | Rake 0 
Seat 3: Anton280395 folded before Flop (didn't bet)
Seat 4: Mandooo97 folded before Flop (didn't bet)
Seat 6: khurlee.ts (button) collected (29500)
Seat 7: noway0ut_7 (small blind) folded before Flop
Seat 8: Imavere (big blind) folded before Flop

PokerStars Hand #250528555287: Tournament #3754315373, $4.80+$5.00+$1.20 USD Hold'em No Limit - Level XXXV (4500/9000) - 2024/05/16 13:40:08 UTC [2024/05/16 9:40:08 ET]
Table '3754315373 2' 8-max Seat #6 is the button
Seat 3: Anton280395 (318098 in chips, $37.80 bounty) 
Seat 4: Mandooo97 (843967 in chips, $77.05 bounty) 
Seat 6: khurlee.ts (293690 in chips, $61.70 bounty) 
Seat 7: noway0ut_7 (219147 in chips, $47.94 bounty) 
Seat 8: Imavere (97370 in chips, $48.43 bounty) 
Anton280395: posts the ante 1400
Mandooo97: posts the ante 1400
khurlee.ts: posts the ante 1400
noway0ut_7: posts the ante 1400
Imavere: posts the ante 1400
noway0ut_7: posts small blind 4500
Imavere: posts big blind 9000
*** HOLE CARDS ***
SSS1965 is disconnected 
Anton280395: folds 
Mandooo97: folds 
khurlee.ts: raises 9000 to 18000
noway0ut_7: folds 
Imavere: folds [2s 8d]
Uncalled bet (9000) returned to khurlee.ts
khurlee.ts collected 29500 from pot
khurlee.ts: doesn't show hand 
*** SUMMARY ***
Total pot 29500 | Rake 0 
Seat 3: Anton280395 folded before Flop (didn't bet)
Seat 4: Mandooo97 folded before Flop (didn't bet)
Seat 6: khurlee.ts (button) collected (29500)
Seat 7: noway0ut_7 (small blind) folded before Flop
Seat 8: Imavere (big blind) folded before Flop

PokerStars Hand #250528557652: Tournament #3754315373, $4.80+$5.00+$1.20 USD Hold'em No Limit - Level XXXV (4500/9000) - 2024/05/16 13:40:21 UTC [2024/05/16 9:40:21 ET]
Table '3754315373 2' 8-max Seat #7 is the button
Seat 1: SSS1965 (135543 in chips, $66.87 bounty) 
Seat 3: Anton280395 (316698 in chips, $37.80 bounty) 
Seat 4: Mandooo97 (842567 in chips, $77.05 bounty) 
Seat 6: khurlee.ts (312790 in chips, $61.70 bounty) 
Seat 7: noway0ut_7 (213247 in chips, $47.94 bounty) 
Seat 8: Imavere (86970 in chips, $48.43 bounty) 
SSS1965: posts the ante 1400
Anton280395: posts the ante 1400
Mandooo97: posts the ante 1400
khurlee.ts: posts the ante 1400
noway0ut_7: posts the ante 1400
Imavere: posts the ante 1400
Imavere: posts small blind 4500
SSS1965: posts big blind 9000
*** HOLE CARDS ***
Anton280395: folds 
Mandooo97: folds 
khurlee.ts: raises 9000 to 18000
noway0ut_7: folds 
Imavere: folds 
SSS1965: raises 48900 to 66900
khurlee.ts: raises 244490 to 311390 and is all-in
SSS1965: calls 67243 and is all-in
Uncalled bet (177247) returned to khurlee.ts
*** FLOP *** [Jh Ac 7d]
*** TURN *** [Jh Ac 7d] [Kh]
*** RIVER *** [Jh Ac 7d Kh] [4s]
*** SHOW DOWN ***
SSS1965: shows [Qs Qd] (a pair of Queens)
khurlee.ts: shows [Qc Kc] (a pair of Kings)
khurlee.ts collected 281186 from pot
khurlee.ts wins $33.44 for eliminating SSS1965 and their own bounty increases by $33.43 to $95.13
SSS1965 finished the tournament in 12th place and received $36.35.
*** SUMMARY ***
Total pot 281186 | Rake 0 
Board [Jh Ac 7d Kh 4s]
Seat 1: SSS1965 (big blind) showed [Qs Qd] and lost with a pair of Queens
Seat 3: Anton280395 folded before Flop (didn't bet)
Seat 4: Mandooo97 folded before Flop (didn't bet)
Seat 6: khurlee.ts showed [Qc Kc] and won (281186) with a pair of Kings
Seat 7: noway0ut_7 (button) folded before Flop (didn't bet)
Seat 8: Imavere (small blind) folded before Flop

PokerStars Hand #250528557652: Tournament #3754315373, $4.80+$5.00+$1.20 USD Hold'em No Limit - Level XXXV (4500/9000) - 2024/05/16 13:40:21 UTC [2024/05/16 9:40:21 ET]
Table '3754315373 2' 8-max Seat #7 is the button
Seat 1: SSS1965 (135543 in chips, $66.87 bounty) 
Seat 3: Anton280395 (316698 in chips, $37.80 bounty) 
Seat 4: Mandooo97 (842567 in chips, $77.05 bounty) 
Seat 6: khurlee.ts (312790 in chips, $61.70 bounty) 
Seat 7: noway0ut_7 (213247 in chips, $47.94 bounty) 
Seat 8: Imavere (86970 in chips, $48.43 bounty) 
SSS1965: posts the ante 1400
Anton280395: posts the ante 1400
Mandooo97: posts the ante 1400
khurlee.ts: posts the ante 1400
noway0ut_7: posts the ante 1400
Imavere: posts the ante 1400
Imavere: posts small blind 4500
SSS1965: posts big blind 9000
*** HOLE CARDS ***
Anton280395: folds 
Mandooo97: folds 
khurlee.ts: raises 9000 to 18000
noway0ut_7: folds 
Imavere: folds 
SSS1965: raises 48900 to 66900
khurlee.ts: raises 244490 to 311390 and is all-in
SSS1965: calls 67243 and is all-in
Uncalled bet (177247) returned to khurlee.ts
*** FLOP *** [Jh Ac 7d]
*** TURN *** [Jh Ac 7d] [Kh]
*** RIVER *** [Jh Ac 7d Kh] [4s]
*** SHOW DOWN ***
SSS1965: shows [Qs Qd] (a pair of Queens)
khurlee.ts: shows [Qc Kc] (a pair of Kings)
khurlee.ts collected 281186 from pot
khurlee.ts wins $33.44 for eliminating SSS1965 and their own bounty increases by $33.43 to $95.13
SSS1965 finished the tournament in 12th place and received $36.35.
*** SUMMARY ***
Total pot 281186 | Rake 0 
Board [Jh Ac 7d Kh 4s]
Seat 1: SSS1965 (big blind) showed [Qs Qd] and lost with a pair of Queens
Seat 3: Anton280395 folded before Flop (didn't bet)
Seat 4: Mandooo97 folded before Flop (didn't bet)
Seat 6: khurlee.ts showed [Qc Kc] and won (281186) with a pair of Kings
Seat 7: noway0ut_7 (button) folded before Flop (didn't bet)
Seat 8: Imavere (small blind) folded before Flop

PokerStars Hand #250528563167: Tournament #3754315373, $4.80+$5.00+$1.20 USD Hold'em No Limit - Level XXXV (4500/9000) - 2024/05/16 13:40:51 UTC [2024/05/16 9:40:51 ET]
Table '3754315373 2' 8-max Seat #8 is the button
Seat 3: Anton280395 (315298 in chips, $37.80 bounty) 
Seat 4: Mandooo97 (841167 in chips, $77.05 bounty) 
Seat 6: khurlee.ts (458433 in chips, $95.13 bounty) 
Seat 7: noway0ut_7 (211847 in chips, $47.94 bounty) 
Seat 8: Imavere (81070 in chips, $48.43 bounty) 
Anton280395: posts the ante 1400
Mandooo97: posts the ante 1400
khurlee.ts: posts the ante 1400
noway0ut_7: posts the ante 1400
Imavere: posts the ante 1400
Anton280395: posts small blind 4500
Mandooo97: posts big blind 9000
*** HOLE CARDS ***
khurlee.ts: folds 
noway0ut_7: folds 
Imavere: raises 70670 to 79670 and is all-in
Anton280395: folds 
Mandooo97: calls 70670
*** FLOP *** [2c Jd 7d]
*** TURN *** [2c Jd 7d] [Qs]
*** RIVER *** [2c Jd 7d Qs] [8c]
*** SHOW DOWN ***
Mandooo97: shows [4h 6h] (high card Queen)
Imavere: shows [Ad 6c] (high card Ace)
Imavere collected 170840 from pot
*** SUMMARY ***
Total pot 170840 | Rake 0 
Board [2c Jd 7d Qs 8c]
Seat 3: Anton280395 (small blind) folded before Flop
Seat 4: Mandooo97 (big blind) showed [4h 6h] and lost with high card Queen
Seat 6: khurlee.ts folded before Flop (didn't bet)
Seat 7: noway0ut_7 folded before Flop (didn't bet)
Seat 8: Imavere (button) showed [Ad 6c] and won (170840) with high card Ace

PokerStars Hand #250528563167: Tournament #3754315373, $4.80+$5.00+$1.20 USD Hold'em No Limit - Level XXXV (4500/9000) - 2024/05/16 13:40:51 UTC [2024/05/16 9:40:51 ET]
Table '3754315373 2' 8-max Seat #8 is the button
Seat 3: Anton280395 (315298 in chips, $37.80 bounty) 
Seat 4: Mandooo97 (841167 in chips, $77.05 bounty) 
Seat 6: khurlee.ts (458433 in chips, $95.13 bounty) 
Seat 7: noway0ut_7 (211847 in chips, $47.94 bounty) 
Seat 8: Imavere (81070 in chips, $48.43 bounty) 
Anton280395: posts the ante 1400
Mandooo97: posts the ante 1400
khurlee.ts: posts the ante 1400
noway0ut_7: posts the ante 1400
Imavere: posts the ante 1400
Anton280395: posts small blind 4500
Mandooo97: posts big blind 9000
*** HOLE CARDS ***
khurlee.ts: folds 
noway0ut_7: folds 
Imavere: raises 70670 to 79670 and is all-in
Anton280395: folds 
Mandooo97: calls 70670
*** FLOP *** [2c Jd 7d]
*** TURN *** [2c Jd 7d] [Qs]
*** RIVER *** [2c Jd 7d Qs] [8c]
*** SHOW DOWN ***
Mandooo97: shows [4h 6h] (high card Queen)
Imavere: shows [Ad 6c] (high card Ace)
Imavere collected 170840 from pot
*** SUMMARY ***
Total pot 170840 | Rake 0 
Board [2c Jd 7d Qs 8c]
Seat 3: Anton280395 (small blind) folded before Flop
Seat 4: Mandooo97 (big blind) showed [4h 6h] and lost with high card Queen
Seat 6: khurlee.ts folded before Flop (didn't bet)
Seat 7: noway0ut_7 folded before Flop (didn't bet)
Seat 8: Imavere (button) showed [Ad 6c] and won (170840) with high card Ace

PokerStars Hand #250528571476: Tournament #3754315373, $4.80+$5.00+$1.20 USD Hold'em No Limit - Level XXXVI (5000/10000) - 2024/05/16 13:41:36 UTC [2024/05/16 9:41:36 ET]
Table '3754315373 2' 8-max Seat #3 is the button
Seat 3: Anton280395 (309398 in chips, $37.80 bounty) 
Seat 4: Mandooo97 (760097 in chips, $77.05 bounty) 
Seat 6: khurlee.ts (457033 in chips, $95.13 bounty) 
Seat 7: noway0ut_7 (210447 in chips, $47.94 bounty) 
Seat 8: Imavere (170840 in chips, $48.43 bounty) 
Anton280395: posts the ante 1500
Mandooo97: posts the ante 1500
khurlee.ts: posts the ante 1500
noway0ut_7: posts the ante 1500
Imavere: posts the ante 1500
Mandooo97: posts small blind 5000
khurlee.ts: posts big blind 10000
*** HOLE CARDS ***
noway0ut_7: folds 
Imavere: folds 
Anton280395: folds 
Mandooo97: folds 
Uncalled bet (5000) returned to khurlee.ts
khurlee.ts collected 17500 from pot
khurlee.ts: doesn't show hand 
*** SUMMARY ***
Total pot 17500 | Rake 0 
Seat 3: Anton280395 (button) folded before Flop (didn't bet)
Seat 4: Mandooo97 (small blind) folded before Flop
Seat 6: khurlee.ts (big blind) collected (17500)
Seat 7: noway0ut_7 folded before Flop (didn't bet)
Seat 8: Imavere folded before Flop (didn't bet)

PokerStars Hand #250528571476: Tournament #3754315373, $4.80+$5.00+$1.20 USD Hold'em No Limit - Level XXXVI (5000/10000) - 2024/05/16 13:41:36 UTC [2024/05/16 9:41:36 ET]
Table '3754315373 2' 8-max Seat #3 is the button
Seat 3: Anton280395 (309398 in chips, $37.80 bounty) 
Seat 4: Mandooo97 (760097 in chips, $77.05 bounty) 
Seat 6: khurlee.ts (457033 in chips, $95.13 bounty) 
Seat 7: noway0ut_7 (210447 in chips, $47.94 bounty) 
Seat 8: Imavere (170840 in chips, $48.43 bounty) 
Anton280395: posts the ante 1500
Mandooo97: posts the ante 1500
khurlee.ts: posts the ante 1500
noway0ut_7: posts the ante 1500
Imavere: posts the ante 1500
Mandooo97: posts small blind 5000
khurlee.ts: posts big blind 10000
*** HOLE CARDS ***
noway0ut_7: folds 
Imavere: folds 
Anton280395: folds 
Mandooo97: folds 
Uncalled bet (5000) returned to khurlee.ts
khurlee.ts collected 17500 from pot
khurlee.ts: doesn't show hand 
*** SUMMARY ***
Total pot 17500 | Rake 0 
Seat 3: Anton280395 (button) folded before Flop (didn't bet)
Seat 4: Mandooo97 (small blind) folded before Flop
Seat 6: khurlee.ts (big blind) collected (17500)
Seat 7: noway0ut_7 folded before Flop (didn't bet)
Seat 8: Imavere folded before Flop (didn't bet)

PokerStars Hand #250528573625: Tournament #3754315373, $4.80+$5.00+$1.20 USD Hold'em No Limit - Level XXXVI (5000/10000) - 2024/05/16 13:41:48 UTC [2024/05/16 9:41:48 ET]
Table '3754315373 2' 8-max Seat #4 is the button
Seat 3: Anton280395 (307898 in chips, $37.80 bounty) 
Seat 4: Mandooo97 (753597 in chips, $77.05 bounty) 
Seat 6: khurlee.ts (468033 in chips, $95.13 bounty) 
Seat 7: noway0ut_7 (208947 in chips, $47.94 bounty) 
Seat 8: Imavere (169340 in chips, $48.43 bounty) 
Anton280395: posts the ante 1500
Mandooo97: posts the ante 1500
khurlee.ts: posts the ante 1500
noway0ut_7: posts the ante 1500
Imavere: posts the ante 1500
khurlee.ts: posts small blind 5000
noway0ut_7: posts big blind 10000
*** HOLE CARDS ***
Imavere: folds 
Anton280395: folds 
Mandooo97: raises 15000 to 25000
khurlee.ts: calls 20000
noway0ut_7: folds 
*** FLOP *** [Js 2s 7c]
khurlee.ts: checks 
Mandooo97: bets 16875
khurlee.ts: calls 16875
*** TURN *** [Js 2s 7c] [9s]
khurlee.ts: checks 
Mandooo97: bets 80000
khurlee.ts: calls 80000
*** RIVER *** [Js 2s 7c 9s] [As]
khurlee.ts: checks 
Mandooo97: checks 
*** SHOW DOWN ***
khurlee.ts: shows [9c Ts] (a flush, Ace high)
Mandooo97: mucks hand 
khurlee.ts collected 261250 from pot
*** SUMMARY ***
Total pot 261250 | Rake 0 
Board [Js 2s 7c 9s As]
Seat 3: Anton280395 folded before Flop (didn't bet)
Seat 4: Mandooo97 (button) mucked
Seat 6: khurlee.ts (small blind) showed [9c Ts] and won (261250) with a flush, Ace high
Seat 7: noway0ut_7 (big blind) folded before Flop
Seat 8: Imavere folded before Flop (didn't bet)

PokerStars Hand #250528573625: Tournament #3754315373, $4.80+$5.00+$1.20 USD Hold'em No Limit - Level XXXVI (5000/10000) - 2024/05/16 13:41:48 UTC [2024/05/16 9:41:48 ET]
Table '3754315373 2' 8-max Seat #4 is the button
Seat 3: Anton280395 (307898 in chips, $37.80 bounty) 
Seat 4: Mandooo97 (753597 in chips, $77.05 bounty) 
Seat 6: khurlee.ts (468033 in chips, $95.13 bounty) 
Seat 7: noway0ut_7 (208947 in chips, $47.94 bounty) 
Seat 8: Imavere (169340 in chips, $48.43 bounty) 
Anton280395: posts the ante 1500
Mandooo97: posts the ante 1500
khurlee.ts: posts the ante 1500
noway0ut_7: posts the ante 1500
Imavere: posts the ante 1500
khurlee.ts: posts small blind 5000
noway0ut_7: posts big blind 10000
*** HOLE CARDS ***
Imavere: folds 
Anton280395: folds 
Mandooo97: raises 15000 to 25000
khurlee.ts: calls 20000
noway0ut_7: folds 
*** FLOP *** [Js 2s 7c]
khurlee.ts: checks 
Mandooo97: bets 16875
khurlee.ts: calls 16875
*** TURN *** [Js 2s 7c] [9s]
khurlee.ts: checks 
Mandooo97: bets 80000
khurlee.ts: calls 80000
*** RIVER *** [Js 2s 7c 9s] [As]
khurlee.ts: checks 
Mandooo97: checks 
*** SHOW DOWN ***
khurlee.ts: shows [9c Ts] (a flush, Ace high)
Mandooo97: mucks hand 
khurlee.ts collected 261250 from pot
*** SUMMARY ***
Total pot 261250 | Rake 0 
Board [Js 2s 7c 9s As]
Seat 3: Anton280395 folded before Flop (didn't bet)
Seat 4: Mandooo97 (button) mucked
Seat 6: khurlee.ts (small blind) showed [9c Ts] and won (261250) with a flush, Ace high
Seat 7: noway0ut_7 (big blind) folded before Flop
Seat 8: Imavere folded before Flop (didn't bet)

PokerStars Hand #250528580600: Tournament #3754315373, $4.80+$5.00+$1.20 USD Hold'em No Limit - Level XXXVI (5000/10000) - 2024/05/16 13:42:25 UTC [2024/05/16 9:42:25 ET]
Table '3754315373 2' 8-max Seat #6 is the button
Seat 3: Anton280395 (306398 in chips, $37.80 bounty) 
Seat 4: Mandooo97 (630222 in chips, $77.05 bounty) 
Seat 6: khurlee.ts (605908 in chips, $95.13 bounty) 
Seat 7: noway0ut_7 (197447 in chips, $47.94 bounty) 
Seat 8: Imavere (167840 in chips, $48.43 bounty) 
Anton280395: posts the ante 1500
Mandooo97: posts the ante 1500
khurlee.ts: posts the ante 1500
noway0ut_7: posts the ante 1500
Imavere: posts the ante 1500
noway0ut_7: posts small blind 5000
Imavere: posts big blind 10000
*** HOLE CARDS ***
Anton280395: raises 10000 to 20000
Mandooo97: folds 
khurlee.ts: folds 
noway0ut_7: calls 15000
Imavere: folds 
*** FLOP *** [Ks Qs 4c]
noway0ut_7: checks 
Anton280395: bets 25000
noway0ut_7: calls 25000
*** TURN *** [Ks Qs 4c] [9s]
noway0ut_7: checks 
Anton280395: checks 
*** RIVER *** [Ks Qs 4c 9s] [2s]
noway0ut_7: bets 53750
Anton280395: folds 
Uncalled bet (53750) returned to noway0ut_7
noway0ut_7 collected 107500 from pot
*** SUMMARY ***
Total pot 107500 | Rake 0 
Board [Ks Qs 4c 9s 2s]
Seat 3: Anton280395 folded on the River
Seat 4: Mandooo97 folded before Flop (didn't bet)
Seat 6: khurlee.ts (button) folded before Flop (didn't bet)
Seat 7: noway0ut_7 (small blind) collected (107500)
Seat 8: Imavere (big blind) folded before Flop

PokerStars Hand #250528580600: Tournament #3754315373, $4.80+$5.00+$1.20 USD Hold'em No Limit - Level XXXVI (5000/10000) - 2024/05/16 13:42:25 UTC [2024/05/16 9:42:25 ET]
Table '3754315373 2' 8-max Seat #6 is the button
Seat 3: Anton280395 (306398 in chips, $37.80 bounty) 
Seat 4: Mandooo97 (630222 in chips, $77.05 bounty) 
Seat 6: khurlee.ts (605908 in chips, $95.13 bounty) 
Seat 7: noway0ut_7 (197447 in chips, $47.94 bounty) 
Seat 8: Imavere (167840 in chips, $48.43 bounty) 
Anton280395: posts the ante 1500
Mandooo97: posts the ante 1500
khurlee.ts: posts the ante 1500
noway0ut_7: posts the ante 1500
Imavere: posts the ante 1500
noway0ut_7: posts small blind 5000
Imavere: posts big blind 10000
*** HOLE CARDS ***
Anton280395: raises 10000 to 20000
Mandooo97: folds 
khurlee.ts: folds 
noway0ut_7: calls 15000
Imavere: folds 
*** FLOP *** [Ks Qs 4c]
noway0ut_7: checks 
Anton280395: bets 25000
noway0ut_7: calls 25000
*** TURN *** [Ks Qs 4c] [9s]
noway0ut_7: checks 
Anton280395: checks 
*** RIVER *** [Ks Qs 4c 9s] [2s]
noway0ut_7: bets 53750
Anton280395: folds 
Uncalled bet (53750) returned to noway0ut_7
noway0ut_7 collected 107500 from pot
*** SUMMARY ***
Total pot 107500 | Rake 0 
Board [Ks Qs 4c 9s 2s]
Seat 3: Anton280395 folded on the River
Seat 4: Mandooo97 folded before Flop (didn't bet)
Seat 6: khurlee.ts (button) folded before Flop (didn't bet)
Seat 7: noway0ut_7 (small blind) collected (107500)
Seat 8: Imavere (big blind) folded before Flop

PokerStars Hand #250528590179: Tournament #3754315373, $4.80+$5.00+$1.20 USD Hold'em No Limit - Level XXXVI (5000/10000) - 2024/05/16 13:43:15 UTC [2024/05/16 9:43:15 ET]
Table '3754315373 2' 8-max Seat #7 is the button
Seat 3: Anton280395 (259898 in chips, $37.80 bounty) 
Seat 4: Mandooo97 (628722 in chips, $77.05 bounty) 
Seat 6: khurlee.ts (604408 in chips, $95.13 bounty) 
Seat 7: noway0ut_7 (258447 in chips, $47.94 bounty) 
Seat 8: Imavere (156340 in chips, $48.43 bounty) 
Anton280395: posts the ante 1500
Mandooo97: posts the ante 1500
khurlee.ts: posts the ante 1500
noway0ut_7: posts the ante 1500
Imavere: posts the ante 1500
Imavere: posts small blind 5000
Anton280395: posts big blind 10000
*** HOLE CARDS ***
Mandooo97: raises 10000 to 20000
khurlee.ts: folds 
noway0ut_7: folds 
Imavere: folds 
Anton280395: calls 10000
*** FLOP *** [2c 4d Ks]
Anton280395: checks 
Mandooo97: bets 17325
Anton280395: folds 
Uncalled bet (17325) returned to Mandooo97
Mandooo97 collected 52500 from pot
Mandooo97: doesn't show hand 
*** SUMMARY ***
Total pot 52500 | Rake 0 
Board [2c 4d Ks]
Seat 3: Anton280395 (big blind) folded on the Flop
Seat 4: Mandooo97 collected (52500)
Seat 6: khurlee.ts folded before Flop (didn't bet)
Seat 7: noway0ut_7 (button) folded before Flop (didn't bet)
Seat 8: Imavere (small blind) folded before Flop

PokerStars Hand #250528590179: Tournament #3754315373, $4.80+$5.00+$1.20 USD Hold'em No Limit - Level XXXVI (5000/10000) - 2024/05/16 13:43:15 UTC [2024/05/16 9:43:15 ET]
Table '3754315373 2' 8-max Seat #7 is the button
Seat 3: Anton280395 (259898 in chips, $37.80 bounty) 
Seat 4: Mandooo97 (628722 in chips, $77.05 bounty) 
Seat 6: khurlee.ts (604408 in chips, $95.13 bounty) 
Seat 7: noway0ut_7 (258447 in chips, $47.94 bounty) 
Seat 8: Imavere (156340 in chips, $48.43 bounty) 
Anton280395: posts the ante 1500
Mandooo97: posts the ante 1500
khurlee.ts: posts the ante 1500
noway0ut_7: posts the ante 1500
Imavere: posts the ante 1500
Imavere: posts small blind 5000
Anton280395: posts big blind 10000
*** HOLE CARDS ***
Mandooo97: raises 10000 to 20000
khurlee.ts: folds 
noway0ut_7: folds 
Imavere: folds 
Anton280395: calls 10000
*** FLOP *** [2c 4d Ks]
Anton280395: checks 
Mandooo97: bets 17325
Anton280395: folds 
Uncalled bet (17325) returned to Mandooo97
Mandooo97 collected 52500 from pot
Mandooo97: doesn't show hand 
*** SUMMARY ***
Total pot 52500 | Rake 0 
Board [2c 4d Ks]
Seat 3: Anton280395 (big blind) folded on the Flop
Seat 4: Mandooo97 collected (52500)
Seat 6: khurlee.ts folded before Flop (didn't bet)
Seat 7: noway0ut_7 (button) folded before Flop (didn't bet)
Seat 8: Imavere (small blind) folded before Flop

PokerStars Hand #250528593171: Tournament #3754315373, $4.80+$5.00+$1.20 USD Hold'em No Limit - Level XXXVI (5000/10000) - 2024/05/16 13:43:31 UTC [2024/05/16 9:43:31 ET]
Table '3754315373 2' 8-max Seat #8 is the button
Seat 3: Anton280395 (238398 in chips, $37.80 bounty) 
Seat 4: Mandooo97 (659722 in chips, $77.05 bounty) 
Seat 6: khurlee.ts (602908 in chips, $95.13 bounty) 
Seat 7: noway0ut_7 (256947 in chips, $47.94 bounty) 
Seat 8: Imavere (149840 in chips, $48.43 bounty) 
Anton280395: posts the ante 1500
Mandooo97: posts the ante 1500
khurlee.ts: posts the ante 1500
noway0ut_7: posts the ante 1500
Imavere: posts the ante 1500
Anton280395: posts small blind 5000
Mandooo97: posts big blind 10000
*** HOLE CARDS ***
khurlee.ts: raises 10000 to 20000
noway0ut_7: folds 
Imavere: folds 
Anton280395: folds 
Mandooo97: calls 10000
*** FLOP *** [8d Ac Ks]
Mandooo97: checks 
khurlee.ts: bets 17325
Mandooo97: calls 17325
*** TURN *** [8d Ac Ks] [Qs]
Mandooo97: checks 
khurlee.ts: bets 50000
Mandooo97: folds 
Uncalled bet (50000) returned to khurlee.ts
khurlee.ts collected 87150 from pot
khurlee.ts: doesn't show hand 
*** SUMMARY ***
Total pot 87150 | Rake 0 
Board [8d Ac Ks Qs]
Seat 3: Anton280395 (small blind) folded before Flop
Seat 4: Mandooo97 (big blind) folded on the Turn
Seat 6: khurlee.ts collected (87150)
Seat 7: noway0ut_7 folded before Flop (didn't bet)
Seat 8: Imavere (button) folded before Flop (didn't bet)

PokerStars Hand #250528593171: Tournament #3754315373, $4.80+$5.00+$1.20 USD Hold'em No Limit - Level XXXVI (5000/10000) - 2024/05/16 13:43:31 UTC [2024/05/16 9:43:31 ET]
Table '3754315373 2' 8-max Seat #8 is the button
Seat 3: Anton280395 (238398 in chips, $37.80 bounty) 
Seat 4: Mandooo97 (659722 in chips, $77.05 bounty) 
Seat 6: khurlee.ts (602908 in chips, $95.13 bounty) 
Seat 7: noway0ut_7 (256947 in chips, $47.94 bounty) 
Seat 8: Imavere (149840 in chips, $48.43 bounty) 
Anton280395: posts the ante 1500
Mandooo97: posts the ante 1500
khurlee.ts: posts the ante 1500
noway0ut_7: posts the ante 1500
Imavere: posts the ante 1500
Anton280395: posts small blind 5000
Mandooo97: posts big blind 10000
*** HOLE CARDS ***
khurlee.ts: raises 10000 to 20000
noway0ut_7: folds 
Imavere: folds 
Anton280395: folds 
Mandooo97: calls 10000
*** FLOP *** [8d Ac Ks]
Mandooo97: checks 
khurlee.ts: bets 17325
Mandooo97: calls 17325
*** TURN *** [8d Ac Ks] [Qs]
Mandooo97: checks 
khurlee.ts: bets 50000
Mandooo97: folds 
Uncalled bet (50000) returned to khurlee.ts
khurlee.ts collected 87150 from pot
khurlee.ts: doesn't show hand 
*** SUMMARY ***
Total pot 87150 | Rake 0 
Board [8d Ac Ks Qs]
Seat 3: Anton280395 (small blind) folded before Flop
Seat 4: Mandooo97 (big blind) folded on the Turn
Seat 6: khurlee.ts collected (87150)
Seat 7: noway0ut_7 folded before Flop (didn't bet)
Seat 8: Imavere (button) folded before Flop (didn't bet)

PokerStars Hand #250528600207: Tournament #3754315373, $4.80+$5.00+$1.20 USD Hold'em No Limit - Level XXXVI (5000/10000) - 2024/05/16 13:44:09 UTC [2024/05/16 9:44:09 ET]
Table '3754315373 2' 8-max Seat #3 is the button
Seat 3: Anton280395 (231898 in chips, $37.80 bounty) 
Seat 4: Mandooo97 (620897 in chips, $77.05 bounty) 
Seat 6: khurlee.ts (651233 in chips, $95.13 bounty) 
Seat 7: noway0ut_7 (255447 in chips, $47.94 bounty) 
Seat 8: Imavere (148340 in chips, $48.43 bounty) 
Anton280395: posts the ante 1500
Mandooo97: posts the ante 1500
khurlee.ts: posts the ante 1500
noway0ut_7: posts the ante 1500
Imavere: posts the ante 1500
Mandooo97: posts small blind 5000
khurlee.ts: posts big blind 10000
*** HOLE CARDS ***
noway0ut_7: folds 
Imavere: raises 10000 to 20000
Anton280395: folds 
Mandooo97: folds 
khurlee.ts: folds 
Uncalled bet (10000) returned to Imavere
Imavere collected 32500 from pot
*** SUMMARY ***
Total pot 32500 | Rake 0 
Seat 3: Anton280395 (button) folded before Flop (didn't bet)
Seat 4: Mandooo97 (small blind) folded before Flop
Seat 6: khurlee.ts (big blind) folded before Flop
Seat 7: noway0ut_7 folded before Flop (didn't bet)
Seat 8: Imavere collected (32500)

PokerStars Hand #250528600207: Tournament #3754315373, $4.80+$5.00+$1.20 USD Hold'em No Limit - Level XXXVI (5000/10000) - 2024/05/16 13:44:09 UTC [2024/05/16 9:44:09 ET]
Table '3754315373 2' 8-max Seat #3 is the button
Seat 3: Anton280395 (231898 in chips, $37.80 bounty) 
Seat 4: Mandooo97 (620897 in chips, $77.05 bounty) 
Seat 6: khurlee.ts (651233 in chips, $95.13 bounty) 
Seat 7: noway0ut_7 (255447 in chips, $47.94 bounty) 
Seat 8: Imavere (148340 in chips, $48.43 bounty) 
Anton280395: posts the ante 1500
Mandooo97: posts the ante 1500
khurlee.ts: posts the ante 1500
noway0ut_7: posts the ante 1500
Imavere: posts the ante 1500
Mandooo97: posts small blind 5000
khurlee.ts: posts big blind 10000
*** HOLE CARDS ***
noway0ut_7: folds 
Imavere: raises 10000 to 20000
Anton280395: folds 
Mandooo97: folds 
khurlee.ts: folds 
Uncalled bet (10000) returned to Imavere
Imavere collected 32500 from pot
*** SUMMARY ***
Total pot 32500 | Rake 0 
Seat 3: Anton280395 (button) folded before Flop (didn't bet)
Seat 4: Mandooo97 (small blind) folded before Flop
Seat 6: khurlee.ts (big blind) folded before Flop
Seat 7: noway0ut_7 folded before Flop (didn't bet)
Seat 8: Imavere collected (32500)

PokerStars Hand #250528603199: Tournament #3754315373, $4.80+$5.00+$1.20 USD Hold'em No Limit - Level XXXVI (5000/10000) - 2024/05/16 13:44:26 UTC [2024/05/16 9:44:26 ET]
Table '3754315373 2' 8-max Seat #4 is the button
Seat 3: Anton280395 (230398 in chips, $37.80 bounty) 
Seat 4: Mandooo97 (614397 in chips, $77.05 bounty) 
Seat 6: khurlee.ts (639733 in chips, $95.13 bounty) 
Seat 7: noway0ut_7 (253947 in chips, $47.94 bounty) 
Seat 8: Imavere (169340 in chips, $48.43 bounty) 
Anton280395: posts the ante 1500
Mandooo97: posts the ante 1500
khurlee.ts: posts the ante 1500
noway0ut_7: posts the ante 1500
Imavere: posts the ante 1500
khurlee.ts: posts small blind 5000
noway0ut_7: posts big blind 10000
*** HOLE CARDS ***
Imavere: folds 
Anton280395: raises 10000 to 20000
Mandooo97: folds 
khurlee.ts: folds 
noway0ut_7: calls 10000
*** FLOP *** [2s 2c 6h]
noway0ut_7: checks 
Anton280395: bets 15750
noway0ut_7: folds 
Uncalled bet (15750) returned to Anton280395
Anton280395 collected 52500 from pot
Anton280395: doesn't show hand 
*** SUMMARY ***
Total pot 52500 | Rake 0 
Board [2s 2c 6h]
Seat 3: Anton280395 collected (52500)
Seat 4: Mandooo97 (button) folded before Flop (didn't bet)
Seat 6: khurlee.ts (small blind) folded before Flop
Seat 7: noway0ut_7 (big blind) folded on the Flop
Seat 8: Imavere folded before Flop (didn't bet)

PokerStars Hand #250528603199: Tournament #3754315373, $4.80+$5.00+$1.20 USD Hold'em No Limit - Level XXXVI (5000/10000) - 2024/05/16 13:44:26 UTC [2024/05/16 9:44:26 ET]
Table '3754315373 2' 8-max Seat #4 is the button
Seat 3: Anton280395 (230398 in chips, $37.80 bounty) 
Seat 4: Mandooo97 (614397 in chips, $77.05 bounty) 
Seat 6: khurlee.ts (639733 in chips, $95.13 bounty) 
Seat 7: noway0ut_7 (253947 in chips, $47.94 bounty) 
Seat 8: Imavere (169340 in chips, $48.43 bounty) 
Anton280395: posts the ante 1500
Mandooo97: posts the ante 1500
khurlee.ts: posts the ante 1500
noway0ut_7: posts the ante 1500
Imavere: posts the ante 1500
khurlee.ts: posts small blind 5000
noway0ut_7: posts big blind 10000
*** HOLE CARDS ***
Imavere: folds 
Anton280395: raises 10000 to 20000
Mandooo97: folds 
khurlee.ts: folds 
noway0ut_7: calls 10000
*** FLOP *** [2s 2c 6h]
noway0ut_7: checks 
Anton280395: bets 15750
noway0ut_7: folds 
Uncalled bet (15750) returned to Anton280395
Anton280395 collected 52500 from pot
Anton280395: doesn't show hand 
*** SUMMARY ***
Total pot 52500 | Rake 0 
Board [2s 2c 6h]
Seat 3: Anton280395 collected (52500)
Seat 4: Mandooo97 (button) folded before Flop (didn't bet)
Seat 6: khurlee.ts (small blind) folded before Flop
Seat 7: noway0ut_7 (big blind) folded on the Flop
Seat 8: Imavere folded before Flop (didn't bet)

PokerStars Hand #250528608086: Tournament #3754315373, $4.80+$5.00+$1.20 USD Hold'em No Limit - Level XXXVI (5000/10000) - 2024/05/16 13:44:52 UTC [2024/05/16 9:44:52 ET]
Table '3754315373 2' 8-max Seat #6 is the button
Seat 3: Anton280395 (261398 in chips, $37.80 bounty) 
Seat 4: Mandooo97 (612897 in chips, $77.05 bounty) 
Seat 6: khurlee.ts (633233 in chips, $95.13 bounty) 
Seat 7: noway0ut_7 (232447 in chips, $47.94 bounty) 
Seat 8: Imavere (167840 in chips, $48.43 bounty) 
Anton280395: posts the ante 1500
Mandooo97: posts the ante 1500
khurlee.ts: posts the ante 1500
noway0ut_7: posts the ante 1500
Imavere: posts the ante 1500
noway0ut_7: posts small blind 5000
Imavere: posts big blind 10000
*** HOLE CARDS ***
Anton280395: folds 
Mandooo97: raises 12000 to 22000
khurlee.ts: folds 
noway0ut_7: folds 
Imavere: calls 12000
*** FLOP *** [6h 7h Th]
Imavere: checks 
Mandooo97: bets 10000
Imavere: calls 10000
*** TURN *** [6h 7h Th] [3d]
noway0ut_7 is disconnected 
Imavere: checks 
Mandooo97: checks 
*** RIVER *** [6h 7h Th 3d] [2c]
Imavere: checks 
Mandooo97: checks 
*** SHOW DOWN ***
Imavere: shows [As 5h] (high card Ace)
Mandooo97: mucks hand 
Imavere collected 76500 from pot
*** SUMMARY ***
Total pot 76500 | Rake 0 
Board [6h 7h Th 3d 2c]
Seat 3: Anton280395 folded before Flop (didn't bet)
Seat 4: Mandooo97 mucked
Seat 6: khurlee.ts (button) folded before Flop (didn't bet)
Seat 7: noway0ut_7 (small blind) folded before Flop
Seat 8: Imavere (big blind) showed [As 5h] and won (76500) with high card Ace

PokerStars Hand #250528608086: Tournament #3754315373, $4.80+$5.00+$1.20 USD Hold'em No Limit - Level XXXVI (5000/10000) - 2024/05/16 13:44:52 UTC [2024/05/16 9:44:52 ET]
Table '3754315373 2' 8-max Seat #6 is the button
Seat 3: Anton280395 (261398 in chips, $37.80 bounty) 
Seat 4: Mandooo97 (612897 in chips, $77.05 bounty) 
Seat 6: khurlee.ts (633233 in chips, $95.13 bounty) 
Seat 7: noway0ut_7 (232447 in chips, $47.94 bounty) 
Seat 8: Imavere (167840 in chips, $48.43 bounty) 
Anton280395: posts the ante 1500
Mandooo97: posts the ante 1500
khurlee.ts: posts the ante 1500
noway0ut_7: posts the ante 1500
Imavere: posts the ante 1500
noway0ut_7: posts small blind 5000
Imavere: posts big blind 10000
*** HOLE CARDS ***
Anton280395: folds 
Mandooo97: raises 12000 to 22000
khurlee.ts: folds 
noway0ut_7: folds 
Imavere: calls 12000
*** FLOP *** [6h 7h Th]
Imavere: checks 
Mandooo97: bets 10000
Imavere: calls 10000
*** TURN *** [6h 7h Th] [3d]
noway0ut_7 is disconnected 
Imavere: checks 
Mandooo97: checks 
*** RIVER *** [6h 7h Th 3d] [2c]
Imavere: checks 
Mandooo97: checks 
*** SHOW DOWN ***
Imavere: shows [As 5h] (high card Ace)
Mandooo97: mucks hand 
Imavere collected 76500 from pot
*** SUMMARY ***
Total pot 76500 | Rake 0 
Board [6h 7h Th 3d 2c]
Seat 3: Anton280395 folded before Flop (didn't bet)
Seat 4: Mandooo97 mucked
Seat 6: khurlee.ts (button) folded before Flop (didn't bet)
Seat 7: noway0ut_7 (small blind) folded before Flop
Seat 8: Imavere (big blind) showed [As 5h] and won (76500) with high card Ace

PokerStars Hand #250528617874: Tournament #3754315373, $4.80+$5.00+$1.20 USD Hold'em No Limit - Level XXXVI (5000/10000) - 2024/05/16 13:45:44 UTC [2024/05/16 9:45:44 ET]
Table '3754315373 2' 8-max Seat #7 is the button
Seat 3: Anton280395 (259898 in chips, $37.80 bounty) 
Seat 4: Mandooo97 (579397 in chips, $77.05 bounty) 
Seat 6: khurlee.ts (631733 in chips, $95.13 bounty) 
Seat 7: noway0ut_7 (225947 in chips, $47.94 bounty) 
Seat 8: Imavere (210840 in chips, $48.43 bounty) 
Anton280395: posts the ante 1500
Mandooo97: posts the ante 1500
khurlee.ts: posts the ante 1500
noway0ut_7: posts the ante 1500
Imavere: posts the ante 1500
Imavere: posts small blind 5000
Anton280395: posts big blind 10000
*** HOLE CARDS ***
Mandooo97: raises 10000 to 20000
khurlee.ts: raises 25000 to 45000
noway0ut_7: folds 
Imavere: folds 
Anton280395: folds 
Mandooo97: calls 25000
*** FLOP *** [3h 8h 5d]
Mandooo97: checks 
khurlee.ts: bets 40000
Mandooo97: raises 50000 to 90000
khurlee.ts: folds 
Uncalled bet (50000) returned to Mandooo97
Mandooo97 collected 192500 from pot
Mandooo97: doesn't show hand 
*** SUMMARY ***
Total pot 192500 | Rake 0 
Board [3h 8h 5d]
Seat 3: Anton280395 (big blind) folded before Flop
Seat 4: Mandooo97 collected (192500)
Seat 6: khurlee.ts folded on the Flop
Seat 7: noway0ut_7 (button) folded before Flop (didn't bet)
Seat 8: Imavere (small blind) folded before Flop

PokerStars Hand #250528617874: Tournament #3754315373, $4.80+$5.00+$1.20 USD Hold'em No Limit - Level XXXVI (5000/10000) - 2024/05/16 13:45:44 UTC [2024/05/16 9:45:44 ET]
Table '3754315373 2' 8-max Seat #7 is the button
Seat 3: Anton280395 (259898 in chips, $37.80 bounty) 
Seat 4: Mandooo97 (579397 in chips, $77.05 bounty) 
Seat 6: khurlee.ts (631733 in chips, $95.13 bounty) 
Seat 7: noway0ut_7 (225947 in chips, $47.94 bounty) 
Seat 8: Imavere (210840 in chips, $48.43 bounty) 
Anton280395: posts the ante 1500
Mandooo97: posts the ante 1500
khurlee.ts: posts the ante 1500
noway0ut_7: posts the ante 1500
Imavere: posts the ante 1500
Imavere: posts small blind 5000
Anton280395: posts big blind 10000
*** HOLE CARDS ***
Mandooo97: raises 10000 to 20000
khurlee.ts: raises 25000 to 45000
noway0ut_7: folds 
Imavere: folds 
Anton280395: folds 
Mandooo97: calls 25000
*** FLOP *** [3h 8h 5d]
Mandooo97: checks 
khurlee.ts: bets 40000
Mandooo97: raises 50000 to 90000
khurlee.ts: folds 
Uncalled bet (50000) returned to Mandooo97
Mandooo97 collected 192500 from pot
Mandooo97: doesn't show hand 
*** SUMMARY ***
Total pot 192500 | Rake 0 
Board [3h 8h 5d]
Seat 3: Anton280395 (big blind) folded before Flop
Seat 4: Mandooo97 collected (192500)
Seat 6: khurlee.ts folded on the Flop
Seat 7: noway0ut_7 (button) folded before Flop (didn't bet)
Seat 8: Imavere (small blind) folded before Flop

PokerStars Hand #250528627639: Tournament #3754315373, $4.80+$5.00+$1.20 USD Hold'em No Limit - Level XXXVI (5000/10000) - 2024/05/16 13:46:36 UTC [2024/05/16 9:46:36 ET]
Table '3754315373 2' 8-max Seat #8 is the button
Seat 3: Anton280395 (248398 in chips, $37.80 bounty) 
Seat 4: Mandooo97 (685397 in chips, $77.05 bounty) 
Seat 6: khurlee.ts (545233 in chips, $95.13 bounty) 
Seat 7: noway0ut_7 (224447 in chips, $47.94 bounty) 
Seat 8: Imavere (204340 in chips, $48.43 bounty) 
Anton280395: posts the ante 1500
Mandooo97: posts the ante 1500
khurlee.ts: posts the ante 1500
noway0ut_7: posts the ante 1500
Imavere: posts the ante 1500
Anton280395: posts small blind 5000
Mandooo97: posts big blind 10000
*** HOLE CARDS ***
khurlee.ts: folds 
noway0ut_7: folds 
Imavere: folds 
Anton280395: calls 5000
Mandooo97: checks 
*** FLOP *** [7c 9c 6c]
Anton280395: bets 10000
Mandooo97: folds 
Uncalled bet (10000) returned to Anton280395
Anton280395 collected 27500 from pot
Anton280395: doesn't show hand 
*** SUMMARY ***
Total pot 27500 | Rake 0 
Board [7c 9c 6c]
Seat 3: Anton280395 (small blind) collected (27500)
Seat 4: Mandooo97 (big blind) folded on the Flop
Seat 6: khurlee.ts folded before Flop (didn't bet)
Seat 7: noway0ut_7 folded before Flop (didn't bet)
Seat 8: Imavere (button) folded before Flop (didn't bet)

PokerStars Hand #250528627639: Tournament #3754315373, $4.80+$5.00+$1.20 USD Hold'em No Limit - Level XXXVI (5000/10000) - 2024/05/16 13:46:36 UTC [2024/05/16 9:46:36 ET]
Table '3754315373 2' 8-max Seat #8 is the button
Seat 3: Anton280395 (248398 in chips, $37.80 bounty) 
Seat 4: Mandooo97 (685397 in chips, $77.05 bounty) 
Seat 6: khurlee.ts (545233 in chips, $95.13 bounty) 
Seat 7: noway0ut_7 (224447 in chips, $47.94 bounty) 
Seat 8: Imavere (204340 in chips, $48.43 bounty) 
Anton280395: posts the ante 1500
Mandooo97: posts the ante 1500
khurlee.ts: posts the ante 1500
noway0ut_7: posts the ante 1500
Imavere: posts the ante 1500
Anton280395: posts small blind 5000
Mandooo97: posts big blind 10000
*** HOLE CARDS ***
khurlee.ts: folds 
noway0ut_7: folds 
Imavere: folds 
Anton280395: calls 5000
Mandooo97: checks 
*** FLOP *** [7c 9c 6c]
Anton280395: bets 10000
Mandooo97: folds 
Uncalled bet (10000) returned to Anton280395
Anton280395 collected 27500 from pot
Anton280395: doesn't show hand 
*** SUMMARY ***
Total pot 27500 | Rake 0 
Board [7c 9c 6c]
Seat 3: Anton280395 (small blind) collected (27500)
Seat 4: Mandooo97 (big blind) folded on the Flop
Seat 6: khurlee.ts folded before Flop (didn't bet)
Seat 7: noway0ut_7 folded before Flop (didn't bet)
Seat 8: Imavere (button) folded before Flop (didn't bet)

PokerStars Hand #250528633833: Tournament #3754315373, $4.80+$5.00+$1.20 USD Hold'em No Limit - Level XXXVI (5000/10000) - 2024/05/16 13:47:08 UTC [2024/05/16 9:47:08 ET]
Table '3754315373 2' 8-max Seat #3 is the button
Seat 3: Anton280395 (264398 in chips, $37.80 bounty) 
Seat 4: Mandooo97 (673897 in chips, $77.05 bounty) 
Seat 6: khurlee.ts (543733 in chips, $95.13 bounty) 
Seat 7: noway0ut_7 (222947 in chips, $47.94 bounty) 
Seat 8: Imavere (202840 in chips, $48.43 bounty) 
Anton280395: posts the ante 1500
Mandooo97: posts the ante 1500
khurlee.ts: posts the ante 1500
noway0ut_7: posts the ante 1500
Imavere: posts the ante 1500
Mandooo97: posts small blind 5000
khurlee.ts: posts big blind 10000
*** HOLE CARDS ***
noway0ut_7: folds 
Imavere: folds 
Anton280395: raises 10000 to 20000
Mandooo97: folds 
khurlee.ts: calls 10000
*** FLOP *** [9d 5s 4c]
khurlee.ts: checks 
Anton280395: bets 13100
khurlee.ts: raises 16900 to 30000
Anton280395: folds 
Uncalled bet (16900) returned to khurlee.ts
khurlee.ts collected 78700 from pot
khurlee.ts: doesn't show hand 
*** SUMMARY ***
Total pot 78700 | Rake 0 
Board [9d 5s 4c]
Seat 3: Anton280395 (button) folded on the Flop
Seat 4: Mandooo97 (small blind) folded before Flop
Seat 6: khurlee.ts (big blind) collected (78700)
Seat 7: noway0ut_7 folded before Flop (didn't bet)
Seat 8: Imavere folded before Flop (didn't bet)

PokerStars Hand #250528633833: Tournament #3754315373, $4.80+$5.00+$1.20 USD Hold'em No Limit - Level XXXVI (5000/10000) - 2024/05/16 13:47:08 UTC [2024/05/16 9:47:08 ET]
Table '3754315373 2' 8-max Seat #3 is the button
Seat 3: Anton280395 (264398 in chips, $37.80 bounty) 
Seat 4: Mandooo97 (673897 in chips, $77.05 bounty) 
Seat 6: khurlee.ts (543733 in chips, $95.13 bounty) 
Seat 7: noway0ut_7 (222947 in chips, $47.94 bounty) 
Seat 8: Imavere (202840 in chips, $48.43 bounty) 
Anton280395: posts the ante 1500
Mandooo97: posts the ante 1500
khurlee.ts: posts the ante 1500
noway0ut_7: posts the ante 1500
Imavere: posts the ante 1500
Mandooo97: posts small blind 5000
khurlee.ts: posts big blind 10000
*** HOLE CARDS ***
noway0ut_7: folds 
Imavere: folds 
Anton280395: raises 10000 to 20000
Mandooo97: folds 
khurlee.ts: calls 10000
*** FLOP *** [9d 5s 4c]
khurlee.ts: checks 
Anton280395: bets 13100
khurlee.ts: raises 16900 to 30000
Anton280395: folds 
Uncalled bet (16900) returned to khurlee.ts
khurlee.ts collected 78700 from pot
khurlee.ts: doesn't show hand 
*** SUMMARY ***
Total pot 78700 | Rake 0 
Board [9d 5s 4c]
Seat 3: Anton280395 (button) folded on the Flop
Seat 4: Mandooo97 (small blind) folded before Flop
Seat 6: khurlee.ts (big blind) collected (78700)
Seat 7: noway0ut_7 folded before Flop (didn't bet)
Seat 8: Imavere folded before Flop (didn't bet)

PokerStars Hand #250528640004: Tournament #3754315373, $4.80+$5.00+$1.20 USD Hold'em No Limit - Level XXXVI (5000/10000) - 2024/05/16 13:47:41 UTC [2024/05/16 9:47:41 ET]
Table '3754315373 2' 8-max Seat #4 is the button
Seat 3: Anton280395 (229798 in chips, $37.80 bounty) 
Seat 4: Mandooo97 (667397 in chips, $77.05 bounty) 
Seat 6: khurlee.ts (587833 in chips, $95.13 bounty) 
Seat 7: noway0ut_7 (221447 in chips, $47.94 bounty) 
Seat 8: Imavere (201340 in chips, $48.43 bounty) 
Anton280395: posts the ante 1500
Mandooo97: posts the ante 1500
khurlee.ts: posts the ante 1500
noway0ut_7: posts the ante 1500
Imavere: posts the ante 1500
khurlee.ts: posts small blind 5000
noway0ut_7: posts big blind 10000
*** HOLE CARDS ***
Imavere: raises 10000 to 20000
Anton280395: folds 
Mandooo97: calls 20000
khurlee.ts: folds 
noway0ut_7: calls 10000
*** FLOP *** [Ac 7c Kh]
noway0ut_7: checks 
Imavere: checks 
Mandooo97: checks 
*** TURN *** [Ac 7c Kh] [3d]
noway0ut_7: checks 
Imavere: checks 
Mandooo97: checks 
*** RIVER *** [Ac 7c Kh 3d] [2d]
noway0ut_7: checks 
Imavere: checks 
Mandooo97: bets 54375
noway0ut_7: folds 
Imavere: folds 
Uncalled bet (54375) returned to Mandooo97
Mandooo97 collected 72500 from pot
Mandooo97: doesn't show hand 
*** SUMMARY ***
Total pot 72500 | Rake 0 
Board [Ac 7c Kh 3d 2d]
Seat 3: Anton280395 folded before Flop (didn't bet)
Seat 4: Mandooo97 (button) collected (72500)
Seat 6: khurlee.ts (small blind) folded before Flop
Seat 7: noway0ut_7 (big blind) folded on the River
Seat 8: Imavere folded on the River

PokerStars Hand #250528640004: Tournament #3754315373, $4.80+$5.00+$1.20 USD Hold'em No Limit - Level XXXVI (5000/10000) - 2024/05/16 13:47:41 UTC [2024/05/16 9:47:41 ET]
Table '3754315373 2' 8-max Seat #4 is the button
Seat 3: Anton280395 (229798 in chips, $37.80 bounty) 
Seat 4: Mandooo97 (667397 in chips, $77.05 bounty) 
Seat 6: khurlee.ts (587833 in chips, $95.13 bounty) 
Seat 7: noway0ut_7 (221447 in chips, $47.94 bounty) 
Seat 8: Imavere (201340 in chips, $48.43 bounty) 
Anton280395: posts the ante 1500
Mandooo97: posts the ante 1500
khurlee.ts: posts the ante 1500
noway0ut_7: posts the ante 1500
Imavere: posts the ante 1500
khurlee.ts: posts small blind 5000
noway0ut_7: posts big blind 10000
*** HOLE CARDS ***
Imavere: raises 10000 to 20000
Anton280395: folds 
Mandooo97: calls 20000
khurlee.ts: folds 
noway0ut_7: calls 10000
*** FLOP *** [Ac 7c Kh]
noway0ut_7: checks 
Imavere: checks 
Mandooo97: checks 
*** TURN *** [Ac 7c Kh] [3d]
noway0ut_7: checks 
Imavere: checks 
Mandooo97: checks 
*** RIVER *** [Ac 7c Kh 3d] [2d]
noway0ut_7: checks 
Imavere: checks 
Mandooo97: bets 54375
noway0ut_7: folds 
Imavere: folds 
Uncalled bet (54375) returned to Mandooo97
Mandooo97 collected 72500 from pot
Mandooo97: doesn't show hand 
*** SUMMARY ***
Total pot 72500 | Rake 0 
Board [Ac 7c Kh 3d 2d]
Seat 3: Anton280395 folded before Flop (didn't bet)
Seat 4: Mandooo97 (button) collected (72500)
Seat 6: khurlee.ts (small blind) folded before Flop
Seat 7: noway0ut_7 (big blind) folded on the River
Seat 8: Imavere folded on the River

PokerStars Hand #250528656602: Tournament #3754315373, $4.80+$5.00+$1.20 USD Hold'em No Limit - Level XXXVI (5000/10000) - 2024/05/16 13:49:08 UTC [2024/05/16 9:49:08 ET]
Table '3754315373 2' 8-max Seat #6 is the button
Seat 3: Anton280395 (228298 in chips, $37.80 bounty) 
Seat 4: Mandooo97 (718397 in chips, $77.05 bounty) 
Seat 6: khurlee.ts (581333 in chips, $95.13 bounty) 
Seat 7: noway0ut_7 (199947 in chips, $47.94 bounty) 
Seat 8: Imavere (179840 in chips, $48.43 bounty) 
Anton280395: posts the ante 1500
Mandooo97: posts the ante 1500
khurlee.ts: posts the ante 1500
noway0ut_7: posts the ante 1500
Imavere: posts the ante 1500
noway0ut_7: posts small blind 5000
Imavere: posts big blind 10000
*** HOLE CARDS ***
Anton280395: folds 
Mandooo97: raises 10000 to 20000
khurlee.ts: folds 
noway0ut_7: folds 
Imavere: calls 10000
*** FLOP *** [Kh Ts 3c]
Imavere: checks 
Mandooo97: bets 13125
Imavere: calls 13125
*** TURN *** [Kh Ts 3c] [Qd]
Imavere: checks 
Mandooo97: bets 40000
Imavere: folds 
Uncalled bet (40000) returned to Mandooo97
Mandooo97 collected 78750 from pot
Mandooo97: doesn't show hand 
*** SUMMARY ***
Total pot 78750 | Rake 0 
Board [Kh Ts 3c Qd]
Seat 3: Anton280395 folded before Flop (didn't bet)
Seat 4: Mandooo97 collected (78750)
Seat 6: khurlee.ts (button) folded before Flop (didn't bet)
Seat 7: noway0ut_7 (small blind) folded before Flop
Seat 8: Imavere (big blind) folded on the Turn

PokerStars Hand #250528656602: Tournament #3754315373, $4.80+$5.00+$1.20 USD Hold'em No Limit - Level XXXVI (5000/10000) - 2024/05/16 13:49:08 UTC [2024/05/16 9:49:08 ET]
Table '3754315373 2' 8-max Seat #6 is the button
Seat 3: Anton280395 (228298 in chips, $37.80 bounty) 
Seat 4: Mandooo97 (718397 in chips, $77.05 bounty) 
Seat 6: khurlee.ts (581333 in chips, $95.13 bounty) 
Seat 7: noway0ut_7 (199947 in chips, $47.94 bounty) 
Seat 8: Imavere (179840 in chips, $48.43 bounty) 
Anton280395: posts the ante 1500
Mandooo97: posts the ante 1500
khurlee.ts: posts the ante 1500
noway0ut_7: posts the ante 1500
Imavere: posts the ante 1500
noway0ut_7: posts small blind 5000
Imavere: posts big blind 10000
*** HOLE CARDS ***
Anton280395: folds 
Mandooo97: raises 10000 to 20000
khurlee.ts: folds 
noway0ut_7: folds 
Imavere: calls 10000
*** FLOP *** [Kh Ts 3c]
Imavere: checks 
Mandooo97: bets 13125
Imavere: calls 13125
*** TURN *** [Kh Ts 3c] [Qd]
Imavere: checks 
Mandooo97: bets 40000
Imavere: folds 
Uncalled bet (40000) returned to Mandooo97
Mandooo97 collected 78750 from pot
Mandooo97: doesn't show hand 
*** SUMMARY ***
Total pot 78750 | Rake 0 
Board [Kh Ts 3c Qd]
Seat 3: Anton280395 folded before Flop (didn't bet)
Seat 4: Mandooo97 collected (78750)
Seat 6: khurlee.ts (button) folded before Flop (didn't bet)
Seat 7: noway0ut_7 (small blind) folded before Flop
Seat 8: Imavere (big blind) folded on the Turn

PokerStars Hand #250528665427: Tournament #3754315373, $4.80+$5.00+$1.20 USD Hold'em No Limit - Level XXXVII (6000/12000) - 2024/05/16 13:49:55 UTC [2024/05/16 9:49:55 ET]
Table '3754315373 2' 8-max Seat #7 is the button
Seat 3: Anton280395 (226798 in chips, $37.80 bounty) 
Seat 4: Mandooo97 (762522 in chips, $77.05 bounty) 
Seat 6: khurlee.ts (579833 in chips, $95.13 bounty) 
Seat 7: noway0ut_7 (193447 in chips, $47.94 bounty) 
Seat 8: Imavere (145215 in chips, $48.43 bounty) 
Anton280395: posts the ante 1800
Mandooo97: posts the ante 1800
khurlee.ts: posts the ante 1800
noway0ut_7: posts the ante 1800
Imavere: posts the ante 1800
Imavere: posts small blind 6000
Anton280395: posts big blind 12000
*** HOLE CARDS ***
Mandooo97: folds 
khurlee.ts: raises 12000 to 24000
noway0ut_7: folds 
Imavere: folds 
Anton280395: folds 
Uncalled bet (12000) returned to khurlee.ts
khurlee.ts collected 39000 from pot
khurlee.ts: doesn't show hand 
*** SUMMARY ***
Total pot 39000 | Rake 0 
Seat 3: Anton280395 (big blind) folded before Flop
Seat 4: Mandooo97 folded before Flop (didn't bet)
Seat 6: khurlee.ts collected (39000)
Seat 7: noway0ut_7 (button) folded before Flop (didn't bet)
Seat 8: Imavere (small blind) folded before Flop

PokerStars Hand #250528665427: Tournament #3754315373, $4.80+$5.00+$1.20 USD Hold'em No Limit - Level XXXVII (6000/12000) - 2024/05/16 13:49:55 UTC [2024/05/16 9:49:55 ET]
Table '3754315373 2' 8-max Seat #7 is the button
Seat 3: Anton280395 (226798 in chips, $37.80 bounty) 
Seat 4: Mandooo97 (762522 in chips, $77.05 bounty) 
Seat 6: khurlee.ts (579833 in chips, $95.13 bounty) 
Seat 7: noway0ut_7 (193447 in chips, $47.94 bounty) 
Seat 8: Imavere (145215 in chips, $48.43 bounty) 
Anton280395: posts the ante 1800
Mandooo97: posts the ante 1800
khurlee.ts: posts the ante 1800
noway0ut_7: posts the ante 1800
Imavere: posts the ante 1800
Imavere: posts small blind 6000
Anton280395: posts big blind 12000
*** HOLE CARDS ***
Mandooo97: folds 
khurlee.ts: raises 12000 to 24000
noway0ut_7: folds 
Imavere: folds 
Anton280395: folds 
Uncalled bet (12000) returned to khurlee.ts
khurlee.ts collected 39000 from pot
khurlee.ts: doesn't show hand 
*** SUMMARY ***
Total pot 39000 | Rake 0 
Seat 3: Anton280395 (big blind) folded before Flop
Seat 4: Mandooo97 folded before Flop (didn't bet)
Seat 6: khurlee.ts collected (39000)
Seat 7: noway0ut_7 (button) folded before Flop (didn't bet)
Seat 8: Imavere (small blind) folded before Flop

PokerStars Hand #250528669477: Tournament #3754315373, $4.80+$5.00+$1.20 USD Hold'em No Limit - Level XXXVII (6000/12000) - 2024/05/16 13:50:17 UTC [2024/05/16 9:50:17 ET]
Table '3754315373 2' 8-max Seat #8 is the button
Seat 3: Anton280395 (212998 in chips, $37.80 bounty) 
Seat 4: Mandooo97 (760722 in chips, $77.05 bounty) 
Seat 6: khurlee.ts (605033 in chips, $95.13 bounty) 
Seat 7: noway0ut_7 (191647 in chips, $47.94 bounty) 
Seat 8: Imavere (137415 in chips, $48.43 bounty) 
Anton280395: posts the ante 1800
Mandooo97: posts the ante 1800
khurlee.ts: posts the ante 1800
noway0ut_7: posts the ante 1800
Imavere: posts the ante 1800
Anton280395: posts small blind 6000
Mandooo97: posts big blind 12000
*** HOLE CARDS ***
khurlee.ts: raises 12000 to 24000
noway0ut_7: folds 
Imavere: raises 111615 to 135615 and is all-in
noway0ut_7 is disconnected 
Anton280395: raises 75583 to 211198 and is all-in
Mandooo97: folds 
khurlee.ts: calls 187198
*** FLOP *** [Js Ac Tc]
*** TURN *** [Js Ac Tc] [Th]
*** RIVER *** [Js Ac Tc Th] [5s]
*** SHOW DOWN ***
Anton280395: shows [Jh As] (two pair, Aces and Jacks)
khurlee.ts: shows [Qc Ah] (two pair, Aces and Tens)
Anton280395 collected 151166 from side pot
Imavere: shows [Ad 9h] (two pair, Aces and Tens)
Anton280395 collected 427845 from main pot
Anton280395 wins $24.22 for eliminating Imavere and their own bounty increases by $24.21 to $62.01
Imavere finished the tournament in 11th place and received $44.36.
*** SUMMARY ***
Total pot 579011 Main pot 427845. Side pot 151166. | Rake 0 
Board [Js Ac Tc Th 5s]
Seat 3: Anton280395 (small blind) showed [Jh As] and won (579011) with two pair, Aces and Jacks
Seat 4: Mandooo97 (big blind) folded before Flop
Seat 6: khurlee.ts showed [Qc Ah] and lost with two pair, Aces and Tens
Seat 7: noway0ut_7 folded before Flop (didn't bet)
Seat 8: Imavere (button) showed [Ad 9h] and lost with two pair, Aces and Tens

PokerStars Hand #250528669477: Tournament #3754315373, $4.80+$5.00+$1.20 USD Hold'em No Limit - Level XXXVII (6000/12000) - 2024/05/16 13:50:17 UTC [2024/05/16 9:50:17 ET]
Table '3754315373 2' 8-max Seat #8 is the button
Seat 3: Anton280395 (212998 in chips, $37.80 bounty) 
Seat 4: Mandooo97 (760722 in chips, $77.05 bounty) 
Seat 6: khurlee.ts (605033 in chips, $95.13 bounty) 
Seat 7: noway0ut_7 (191647 in chips, $47.94 bounty) 
Seat 8: Imavere (137415 in chips, $48.43 bounty) 
Anton280395: posts the ante 1800
Mandooo97: posts the ante 1800
khurlee.ts: posts the ante 1800
noway0ut_7: posts the ante 1800
Imavere: posts the ante 1800
Anton280395: posts small blind 6000
Mandooo97: posts big blind 12000
*** HOLE CARDS ***
khurlee.ts: raises 12000 to 24000
noway0ut_7: folds 
Imavere: raises 111615 to 135615 and is all-in
noway0ut_7 is disconnected 
Anton280395: raises 75583 to 211198 and is all-in
Mandooo97: folds 
khurlee.ts: calls 187198
*** FLOP *** [Js Ac Tc]
*** TURN *** [Js Ac Tc] [Th]
*** RIVER *** [Js Ac Tc Th] [5s]
*** SHOW DOWN ***
Anton280395: shows [Jh As] (two pair, Aces and Jacks)
khurlee.ts: shows [Qc Ah] (two pair, Aces and Tens)
Anton280395 collected 151166 from side pot
Imavere: shows [Ad 9h] (two pair, Aces and Tens)
Anton280395 collected 427845 from main pot
Anton280395 wins $24.22 for eliminating Imavere and their own bounty increases by $24.21 to $62.01
Imavere finished the tournament in 11th place and received $44.36.
*** SUMMARY ***
Total pot 579011 Main pot 427845. Side pot 151166. | Rake 0 
Board [Js Ac Tc Th 5s]
Seat 3: Anton280395 (small blind) showed [Jh As] and won (579011) with two pair, Aces and Jacks
Seat 4: Mandooo97 (big blind) folded before Flop
Seat 6: khurlee.ts showed [Qc Ah] and lost with two pair, Aces and Tens
Seat 7: noway0ut_7 folded before Flop (didn't bet)
Seat 8: Imavere (button) showed [Ad 9h] and lost with two pair, Aces and Tens

PokerStars Hand #250528676419: Tournament #3754315373, $4.80+$5.00+$1.20 USD Hold'em No Limit - Level XXXVII (6000/12000) - 2024/05/16 13:50:55 UTC [2024/05/16 9:50:55 ET]
Table '3754315373 2' 8-max Seat #3 is the button
Seat 3: Anton280395 (579011 in chips, $62.01 bounty) 
Seat 4: Mandooo97 (746922 in chips, $77.05 bounty) 
Seat 6: khurlee.ts (392035 in chips, $95.13 bounty) 
Seat 7: noway0ut_7 (189847 in chips, $47.94 bounty) 
Anton280395: posts the ante 1800
Mandooo97: posts the ante 1800
khurlee.ts: posts the ante 1800
noway0ut_7: posts the ante 1800
Mandooo97: posts small blind 6000
khurlee.ts: posts big blind 12000
*** HOLE CARDS ***
noway0ut_7: folds 
Anton280395: folds 
Mandooo97: folds 
Uncalled bet (6000) returned to khurlee.ts
khurlee.ts collected 19200 from pot
khurlee.ts: doesn't show hand 
*** SUMMARY ***
Total pot 19200 | Rake 0 
Seat 3: Anton280395 (button) folded before Flop (didn't bet)
Seat 4: Mandooo97 (small blind) folded before Flop
Seat 6: khurlee.ts (big blind) collected (19200)
Seat 7: noway0ut_7 folded before Flop (didn't bet)

PokerStars Hand #250528676419: Tournament #3754315373, $4.80+$5.00+$1.20 USD Hold'em No Limit - Level XXXVII (6000/12000) - 2024/05/16 13:50:55 UTC [2024/05/16 9:50:55 ET]
Table '3754315373 2' 8-max Seat #3 is the button
Seat 3: Anton280395 (579011 in chips, $62.01 bounty) 
Seat 4: Mandooo97 (746922 in chips, $77.05 bounty) 
Seat 6: khurlee.ts (392035 in chips, $95.13 bounty) 
Seat 7: noway0ut_7 (189847 in chips, $47.94 bounty) 
Anton280395: posts the ante 1800
Mandooo97: posts the ante 1800
khurlee.ts: posts the ante 1800
noway0ut_7: posts the ante 1800
Mandooo97: posts small blind 6000
khurlee.ts: posts big blind 12000
*** HOLE CARDS ***
noway0ut_7: folds 
Anton280395: folds 
Mandooo97: folds 
Uncalled bet (6000) returned to khurlee.ts
khurlee.ts collected 19200 from pot
khurlee.ts: doesn't show hand 
*** SUMMARY ***
Total pot 19200 | Rake 0 
Seat 3: Anton280395 (button) folded before Flop (didn't bet)
Seat 4: Mandooo97 (small blind) folded before Flop
Seat 6: khurlee.ts (big blind) collected (19200)
Seat 7: noway0ut_7 folded before Flop (didn't bet)

PokerStars Hand #250528676419: Tournament #3754315373, $4.80+$5.00+$1.20 USD Hold'em No Limit - Level XXXVII (6000/12000) - 2024/05/16 13:50:55 UTC [2024/05/16 9:50:55 ET]
Table '3754315373 2' 8-max Seat #3 is the button
Seat 3: Anton280395 (579011 in chips, $62.01 bounty) 
Seat 4: Mandooo97 (746922 in chips, $77.05 bounty) 
Seat 6: khurlee.ts (392035 in chips, $95.13 bounty) 
Seat 7: noway0ut_7 (189847 in chips, $47.94 bounty) 
Anton280395: posts the ante 1800
Mandooo97: posts the ante 1800
khurlee.ts: posts the ante 1800
noway0ut_7: posts the ante 1800
Mandooo97: posts small blind 6000
khurlee.ts: posts big blind 12000
*** HOLE CARDS ***
noway0ut_7: folds 
Anton280395: folds 
Mandooo97: folds 
Uncalled bet (6000) returned to khurlee.ts
khurlee.ts collected 19200 from pot
khurlee.ts: doesn't show hand 
*** SUMMARY ***
Total pot 19200 | Rake 0 
Seat 3: Anton280395 (button) folded before Flop (didn't bet)
Seat 4: Mandooo97 (small blind) folded before Flop
Seat 6: khurlee.ts (big blind) collected (19200)
Seat 7: noway0ut_7 folded before Flop (didn't bet)
