PokerStars Hand #250527952993: Tournament #3754315429, $20+$20+$4 USD Hold'em No Limit - Level XXII (600/1200) - 2024/05/16 12:42:37 UTC [2024/05/16 8:42:37 ET]
Table '3754315429 3' 8-max Seat #6 is the button
Seat 1: Toxa_Karol’ (80685 in chips, $165 bounty) 
Seat 2: holdemlouis1 (27463 in chips, $57.50 bounty) 
Seat 3: santiga (9555 in chips, $60 bounty) 
Seat 4: Bxutu_ (65968 in chips, $92.50 bounty) 
Seat 5: k8ldykbala (18402 in chips, $80 bounty) 
Seat 6: Chufffa (20290 in chips, $70 bounty) 
Seat 7: Priitk (31626 in chips, $55 bounty) 
Seat 8: zKiPiSHz (33100 in chips, $85 bounty) 
Toxa_Karol’: posts the ante 180
holdemlouis1: posts the ante 180
santiga: posts the ante 180
Bxutu_: posts the ante 180
k8ldykbala: posts the ante 180
Chufffa: posts the ante 180
Priitk: posts the ante 180
zKiPiSHz: posts the ante 180
Priitk: posts small blind 600
zKiPiSHz: posts big blind 1200
*** HOLE CARDS ***
Toxa_Karol’: raises 1200 to 2400
holdemlouis1: folds 
santiga: folds 
Bxutu_: folds 
k8ldykbala: folds 
Chufffa: folds 
Priitk: folds 
zKiPiSHz: folds 
Uncalled bet (1200) returned to Toxa_Karol’
Toxa_Karol’ collected 4440 from pot
*** SUMMARY ***
Total pot 4440 | Rake 0 
Seat 1: Toxa_Karol’ collected (4440)
Seat 2: holdemlouis1 folded before Flop (didn't bet)
Seat 3: santiga folded before Flop (didn't bet)
Seat 4: Bxutu_ folded before Flop (didn't bet)
Seat 5: k8ldykbala folded before Flop (didn't bet)
Seat 6: Chufffa (button) folded before Flop (didn't bet)
Seat 7: Priitk (small blind) folded before Flop
Seat 8: zKiPiSHz (big blind) folded before Flop

PokerStars Hand #250527957809: Tournament #3754315429, $20+$20+$4 USD Hold'em No Limit - Level XXII (600/1200) - 2024/05/16 12:43:06 UTC [2024/05/16 8:43:06 ET]
Table '3754315429 3' 8-max Seat #7 is the button
Seat 1: Toxa_Karol’ (83745 in chips, $165 bounty) 
Seat 2: holdemlouis1 (27283 in chips, $57.50 bounty) 
Seat 3: santiga (9375 in chips, $60 bounty) 
Seat 4: Bxutu_ (65788 in chips, $92.50 bounty) 
Seat 5: k8ldykbala (18222 in chips, $80 bounty) 
Seat 6: Chufffa (20110 in chips, $70 bounty) 
Seat 7: Priitk (30846 in chips, $55 bounty) 
Seat 8: zKiPiSHz (31720 in chips, $85 bounty) 
Toxa_Karol’: posts the ante 180
holdemlouis1: posts the ante 180
santiga: posts the ante 180
Bxutu_: posts the ante 180
k8ldykbala: posts the ante 180
Chufffa: posts the ante 180
Priitk: posts the ante 180
zKiPiSHz: posts the ante 180
zKiPiSHz: posts small blind 600
Toxa_Karol’: posts big blind 1200
*** HOLE CARDS ***
holdemlouis1: folds 
santiga: folds 
Bxutu_: folds 
k8ldykbala: folds 
Chufffa: folds 
Priitk: folds 
zKiPiSHz: calls 600
Toxa_Karol’: raises 2400 to 3600
zKiPiSHz: raises 27940 to 31540 and is all-in
Toxa_Karol’: folds [2d 5c]
Uncalled bet (27940) returned to zKiPiSHz
zKiPiSHz collected 8640 from pot
zKiPiSHz: doesn't show hand 
*** SUMMARY ***
Total pot 8640 | Rake 0 
Seat 1: Toxa_Karol’ (big blind) folded before Flop
Seat 2: holdemlouis1 folded before Flop (didn't bet)
Seat 3: santiga folded before Flop (didn't bet)
Seat 4: Bxutu_ folded before Flop (didn't bet)
Seat 5: k8ldykbala folded before Flop (didn't bet)
Seat 6: Chufffa folded before Flop (didn't bet)
Seat 7: Priitk (button) folded before Flop (didn't bet)
Seat 8: zKiPiSHz (small blind) collected (8640)

PokerStars Hand #250527957809: Tournament #3754315429, $20+$20+$4 USD Hold'em No Limit - Level XXII (600/1200) - 2024/05/16 12:43:06 UTC [2024/05/16 8:43:06 ET]
Table '3754315429 3' 8-max Seat #7 is the button
Seat 1: Toxa_Karol’ (83745 in chips, $165 bounty) 
Seat 2: holdemlouis1 (27283 in chips, $57.50 bounty) 
Seat 3: santiga (9375 in chips, $60 bounty) 
Seat 4: Bxutu_ (65788 in chips, $92.50 bounty) 
Seat 5: k8ldykbala (18222 in chips, $80 bounty) 
Seat 6: Chufffa (20110 in chips, $70 bounty) 
Seat 7: Priitk (30846 in chips, $55 bounty) 
Seat 8: zKiPiSHz (31720 in chips, $85 bounty) 
Toxa_Karol’: posts the ante 180
holdemlouis1: posts the ante 180
santiga: posts the ante 180
Bxutu_: posts the ante 180
k8ldykbala: posts the ante 180
Chufffa: posts the ante 180
Priitk: posts the ante 180
zKiPiSHz: posts the ante 180
zKiPiSHz: posts small blind 600
Toxa_Karol’: posts big blind 1200
*** HOLE CARDS ***
holdemlouis1: folds 
santiga: folds 
Bxutu_: folds 
k8ldykbala: folds 
Chufffa: folds 
Priitk: folds 
zKiPiSHz: calls 600
Toxa_Karol’: raises 2400 to 3600
zKiPiSHz: raises 27940 to 31540 and is all-in
Toxa_Karol’: folds [2d 5c]
Uncalled bet (27940) returned to zKiPiSHz
zKiPiSHz collected 8640 from pot
zKiPiSHz: doesn't show hand 
*** SUMMARY ***
Total pot 8640 | Rake 0 
Seat 1: Toxa_Karol’ (big blind) folded before Flop
Seat 2: holdemlouis1 folded before Flop (didn't bet)
Seat 3: santiga folded before Flop (didn't bet)
Seat 4: Bxutu_ folded before Flop (didn't bet)
Seat 5: k8ldykbala folded before Flop (didn't bet)
Seat 6: Chufffa folded before Flop (didn't bet)
Seat 7: Priitk (button) folded before Flop (didn't bet)
Seat 8: zKiPiSHz (small blind) collected (8640)

PokerStars Hand #250527964403: Tournament #3754315429, $20+$20+$4 USD Hold'em No Limit - Level XXII (600/1200) - 2024/05/16 12:43:44 UTC [2024/05/16 8:43:44 ET]
Table '3754315429 3' 8-max Seat #8 is the button
Seat 1: Toxa_Karol’ (79965 in chips, $165 bounty) 
Seat 2: holdemlouis1 (27103 in chips, $57.50 bounty) 
Seat 3: santiga (9195 in chips, $60 bounty) 
Seat 4: Bxutu_ (65608 in chips, $92.50 bounty) 
Seat 5: k8ldykbala (18042 in chips, $80 bounty) 
Seat 6: Chufffa (19930 in chips, $70 bounty) 
Seat 7: Priitk (30666 in chips, $55 bounty) 
Seat 8: zKiPiSHz (36580 in chips, $85 bounty) 
Toxa_Karol’: posts the ante 180
holdemlouis1: posts the ante 180
santiga: posts the ante 180
Bxutu_: posts the ante 180
k8ldykbala: posts the ante 180
Chufffa: posts the ante 180
Priitk: posts the ante 180
zKiPiSHz: posts the ante 180
Toxa_Karol’: posts small blind 600
holdemlouis1: posts big blind 1200
*** HOLE CARDS ***
santiga: folds 
Bxutu_: folds 
k8ldykbala: folds 
Chufffa: raises 1200 to 2400
Priitk: folds 
zKiPiSHz: folds 
Toxa_Karol’: folds 
holdemlouis1: calls 1200
*** FLOP *** [Js Ad 7c]
holdemlouis1: checks 
Chufffa: bets 1778
holdemlouis1: folds 
Uncalled bet (1778) returned to Chufffa
Chufffa collected 6840 from pot
*** SUMMARY ***
Total pot 6840 | Rake 0 
Board [Js Ad 7c]
Seat 1: Toxa_Karol’ (small blind) folded before Flop
Seat 2: holdemlouis1 (big blind) folded on the Flop
Seat 3: santiga folded before Flop (didn't bet)
Seat 4: Bxutu_ folded before Flop (didn't bet)
Seat 5: k8ldykbala folded before Flop (didn't bet)
Seat 6: Chufffa collected (6840)
Seat 7: Priitk folded before Flop (didn't bet)
Seat 8: zKiPiSHz (button) folded before Flop (didn't bet)

PokerStars Hand #250527964403: Tournament #3754315429, $20+$20+$4 USD Hold'em No Limit - Level XXII (600/1200) - 2024/05/16 12:43:44 UTC [2024/05/16 8:43:44 ET]
Table '3754315429 3' 8-max Seat #8 is the button
Seat 1: Toxa_Karol’ (79965 in chips, $165 bounty) 
Seat 2: holdemlouis1 (27103 in chips, $57.50 bounty) 
Seat 3: santiga (9195 in chips, $60 bounty) 
Seat 4: Bxutu_ (65608 in chips, $92.50 bounty) 
Seat 5: k8ldykbala (18042 in chips, $80 bounty) 
Seat 6: Chufffa (19930 in chips, $70 bounty) 
Seat 7: Priitk (30666 in chips, $55 bounty) 
Seat 8: zKiPiSHz (36580 in chips, $85 bounty) 
Toxa_Karol’: posts the ante 180
holdemlouis1: posts the ante 180
santiga: posts the ante 180
Bxutu_: posts the ante 180
k8ldykbala: posts the ante 180
Chufffa: posts the ante 180
Priitk: posts the ante 180
zKiPiSHz: posts the ante 180
Toxa_Karol’: posts small blind 600
holdemlouis1: posts big blind 1200
*** HOLE CARDS ***
santiga: folds 
Bxutu_: folds 
k8ldykbala: folds 
Chufffa: raises 1200 to 2400
Priitk: folds 
zKiPiSHz: folds 
Toxa_Karol’: folds 
holdemlouis1: calls 1200
*** FLOP *** [Js Ad 7c]
holdemlouis1: checks 
Chufffa: bets 1778
holdemlouis1: folds 
Uncalled bet (1778) returned to Chufffa
Chufffa collected 6840 from pot
*** SUMMARY ***
Total pot 6840 | Rake 0 
Board [Js Ad 7c]
Seat 1: Toxa_Karol’ (small blind) folded before Flop
Seat 2: holdemlouis1 (big blind) folded on the Flop
Seat 3: santiga folded before Flop (didn't bet)
Seat 4: Bxutu_ folded before Flop (didn't bet)
Seat 5: k8ldykbala folded before Flop (didn't bet)
Seat 6: Chufffa collected (6840)
Seat 7: Priitk folded before Flop (didn't bet)
Seat 8: zKiPiSHz (button) folded before Flop (didn't bet)

PokerStars Hand #250527972196: Tournament #3754315429, $20+$20+$4 USD Hold'em No Limit - Level XXII (600/1200) - 2024/05/16 12:44:29 UTC [2024/05/16 8:44:29 ET]
Table '3754315429 3' 8-max Seat #1 is the button
Seat 1: Toxa_Karol’ (79185 in chips, $165 bounty) 
Seat 2: holdemlouis1 (24523 in chips, $57.50 bounty) 
Seat 3: santiga (9015 in chips, $60 bounty) 
Seat 4: Bxutu_ (65428 in chips, $92.50 bounty) 
Seat 5: k8ldykbala (17862 in chips, $80 bounty) 
Seat 6: Chufffa (24190 in chips, $70 bounty) 
Seat 7: Priitk (30486 in chips, $55 bounty) 
Seat 8: zKiPiSHz (36400 in chips, $85 bounty) 
Toxa_Karol’: posts the ante 180
holdemlouis1: posts the ante 180
santiga: posts the ante 180
Bxutu_: posts the ante 180
k8ldykbala: posts the ante 180
Chufffa: posts the ante 180
Priitk: posts the ante 180
zKiPiSHz: posts the ante 180
holdemlouis1: posts small blind 600
santiga: posts big blind 1200
*** HOLE CARDS ***
Bxutu_: raises 1380 to 2580
k8ldykbala: folds 
Chufffa: folds 
Priitk: folds 
zKiPiSHz: folds 
Toxa_Karol’: calls 2580
holdemlouis1: folds 
santiga: calls 1380
*** FLOP *** [3d 9d 4d]
santiga: bets 6255 and is all-in
Bxutu_: calls 6255
Toxa_Karol’: calls 6255
*** TURN *** [3d 9d 4d] [8h]
Bxutu_: checks 
Toxa_Karol’: checks 
*** RIVER *** [3d 9d 4d 8h] [3h]
Bxutu_: checks 
Toxa_Karol’: checks 
*** SHOW DOWN ***
santiga: shows [Jh 9h] (two pair, Nines and Threes)
Bxutu_: mucks hand 
Toxa_Karol’: mucks hand 
santiga collected 28545 from pot
*** SUMMARY ***
Total pot 28545 | Rake 0 
Board [3d 9d 4d 8h 3h]
Seat 1: Toxa_Karol’ (button) mucked
Seat 2: holdemlouis1 (small blind) folded before Flop
Seat 3: santiga (big blind) showed [Jh 9h] and won (28545) with two pair, Nines and Threes
Seat 4: Bxutu_ mucked
Seat 5: k8ldykbala folded before Flop (didn't bet)
Seat 6: Chufffa folded before Flop (didn't bet)
Seat 7: Priitk folded before Flop (didn't bet)
Seat 8: zKiPiSHz folded before Flop (didn't bet)

PokerStars Hand #250527972196: Tournament #3754315429, $20+$20+$4 USD Hold'em No Limit - Level XXII (600/1200) - 2024/05/16 12:44:29 UTC [2024/05/16 8:44:29 ET]
Table '3754315429 3' 8-max Seat #1 is the button
Seat 1: Toxa_Karol’ (79185 in chips, $165 bounty) 
Seat 2: holdemlouis1 (24523 in chips, $57.50 bounty) 
Seat 3: santiga (9015 in chips, $60 bounty) 
Seat 4: Bxutu_ (65428 in chips, $92.50 bounty) 
Seat 5: k8ldykbala (17862 in chips, $80 bounty) 
Seat 6: Chufffa (24190 in chips, $70 bounty) 
Seat 7: Priitk (30486 in chips, $55 bounty) 
Seat 8: zKiPiSHz (36400 in chips, $85 bounty) 
Toxa_Karol’: posts the ante 180
holdemlouis1: posts the ante 180
santiga: posts the ante 180
Bxutu_: posts the ante 180
k8ldykbala: posts the ante 180
Chufffa: posts the ante 180
Priitk: posts the ante 180
zKiPiSHz: posts the ante 180
holdemlouis1: posts small blind 600
santiga: posts big blind 1200
*** HOLE CARDS ***
Bxutu_: raises 1380 to 2580
k8ldykbala: folds 
Chufffa: folds 
Priitk: folds 
zKiPiSHz: folds 
Toxa_Karol’: calls 2580
holdemlouis1: folds 
santiga: calls 1380
*** FLOP *** [3d 9d 4d]
santiga: bets 6255 and is all-in
Bxutu_: calls 6255
Toxa_Karol’: calls 6255
*** TURN *** [3d 9d 4d] [8h]
Bxutu_: checks 
Toxa_Karol’: checks 
*** RIVER *** [3d 9d 4d 8h] [3h]
Bxutu_: checks 
Toxa_Karol’: checks 
*** SHOW DOWN ***
santiga: shows [Jh 9h] (two pair, Nines and Threes)
Bxutu_: mucks hand 
Toxa_Karol’: mucks hand 
santiga collected 28545 from pot
*** SUMMARY ***
Total pot 28545 | Rake 0 
Board [3d 9d 4d 8h 3h]
Seat 1: Toxa_Karol’ (button) mucked
Seat 2: holdemlouis1 (small blind) folded before Flop
Seat 3: santiga (big blind) showed [Jh 9h] and won (28545) with two pair, Nines and Threes
Seat 4: Bxutu_ mucked
Seat 5: k8ldykbala folded before Flop (didn't bet)
Seat 6: Chufffa folded before Flop (didn't bet)
Seat 7: Priitk folded before Flop (didn't bet)
Seat 8: zKiPiSHz folded before Flop (didn't bet)

PokerStars Hand #250527983420: Tournament #3754315429, $20+$20+$4 USD Hold'em No Limit - Level XXII (600/1200) - 2024/05/16 12:45:33 UTC [2024/05/16 8:45:33 ET]
Table '3754315429 3' 8-max Seat #2 is the button
Seat 1: Toxa_Karol’ (70170 in chips, $165 bounty) 
Seat 2: holdemlouis1 (23743 in chips, $57.50 bounty) 
Seat 3: santiga (28545 in chips, $60 bounty) 
Seat 4: Bxutu_ (56413 in chips, $92.50 bounty) 
Seat 5: k8ldykbala (17682 in chips, $80 bounty) 
Seat 6: Chufffa (24010 in chips, $70 bounty) 
Seat 7: Priitk (30306 in chips, $55 bounty) 
Seat 8: zKiPiSHz (36220 in chips, $85 bounty) 
Toxa_Karol’: posts the ante 180
holdemlouis1: posts the ante 180
santiga: posts the ante 180
Bxutu_: posts the ante 180
k8ldykbala: posts the ante 180
Chufffa: posts the ante 180
Priitk: posts the ante 180
zKiPiSHz: posts the ante 180
santiga: posts small blind 600
Bxutu_: posts big blind 1200
*** HOLE CARDS ***
k8ldykbala: folds 
Chufffa: raises 1200 to 2400
Priitk: folds 
zKiPiSHz: folds 
Toxa_Karol’: folds 
holdemlouis1: raises 21163 to 23563 and is all-in
santiga: folds 
Bxutu_: folds 
Chufffa: folds 
Uncalled bet (21163) returned to holdemlouis1
holdemlouis1 collected 8040 from pot
*** SUMMARY ***
Total pot 8040 | Rake 0 
Seat 1: Toxa_Karol’ folded before Flop (didn't bet)
Seat 2: holdemlouis1 (button) collected (8040)
Seat 3: santiga (small blind) folded before Flop
Seat 4: Bxutu_ (big blind) folded before Flop
Seat 5: k8ldykbala folded before Flop (didn't bet)
Seat 6: Chufffa folded before Flop
Seat 7: Priitk folded before Flop (didn't bet)
Seat 8: zKiPiSHz folded before Flop (didn't bet)

PokerStars Hand #250527983420: Tournament #3754315429, $20+$20+$4 USD Hold'em No Limit - Level XXII (600/1200) - 2024/05/16 12:45:33 UTC [2024/05/16 8:45:33 ET]
Table '3754315429 3' 8-max Seat #2 is the button
Seat 1: Toxa_Karol’ (70170 in chips, $165 bounty) 
Seat 2: holdemlouis1 (23743 in chips, $57.50 bounty) 
Seat 3: santiga (28545 in chips, $60 bounty) 
Seat 4: Bxutu_ (56413 in chips, $92.50 bounty) 
Seat 5: k8ldykbala (17682 in chips, $80 bounty) 
Seat 6: Chufffa (24010 in chips, $70 bounty) 
Seat 7: Priitk (30306 in chips, $55 bounty) 
Seat 8: zKiPiSHz (36220 in chips, $85 bounty) 
Toxa_Karol’: posts the ante 180
holdemlouis1: posts the ante 180
santiga: posts the ante 180
Bxutu_: posts the ante 180
k8ldykbala: posts the ante 180
Chufffa: posts the ante 180
Priitk: posts the ante 180
zKiPiSHz: posts the ante 180
santiga: posts small blind 600
Bxutu_: posts big blind 1200
*** HOLE CARDS ***
k8ldykbala: folds 
Chufffa: raises 1200 to 2400
Priitk: folds 
zKiPiSHz: folds 
Toxa_Karol’: folds 
holdemlouis1: raises 21163 to 23563 and is all-in
santiga: folds 
Bxutu_: folds 
Chufffa: folds 
Uncalled bet (21163) returned to holdemlouis1
holdemlouis1 collected 8040 from pot
*** SUMMARY ***
Total pot 8040 | Rake 0 
Seat 1: Toxa_Karol’ folded before Flop (didn't bet)
Seat 2: holdemlouis1 (button) collected (8040)
Seat 3: santiga (small blind) folded before Flop
Seat 4: Bxutu_ (big blind) folded before Flop
Seat 5: k8ldykbala folded before Flop (didn't bet)
Seat 6: Chufffa folded before Flop
Seat 7: Priitk folded before Flop (didn't bet)
Seat 8: zKiPiSHz folded before Flop (didn't bet)

PokerStars Hand #250527994010: Tournament #3754315429, $20+$20+$4 USD Hold'em No Limit - Level XXIII (700/1400) - 2024/05/16 12:46:32 UTC [2024/05/16 8:46:32 ET]
Table '3754315429 3' 8-max Seat #3 is the button
Seat 1: Toxa_Karol’ (69990 in chips, $165 bounty) 
Seat 2: holdemlouis1 (29203 in chips, $57.50 bounty) 
Seat 3: santiga (27765 in chips, $60 bounty) 
Seat 4: Bxutu_ (55033 in chips, $92.50 bounty) 
Seat 5: k8ldykbala (17502 in chips, $80 bounty) 
Seat 7: Priitk (30126 in chips, $55 bounty) 
Seat 8: zKiPiSHz (36040 in chips, $85 bounty) 
Toxa_Karol’: posts the ante 210
holdemlouis1: posts the ante 210
santiga: posts the ante 210
Bxutu_: posts the ante 210
k8ldykbala: posts the ante 210
Priitk: posts the ante 210
zKiPiSHz: posts the ante 210
Bxutu_: posts small blind 700
k8ldykbala: posts big blind 1400
*** HOLE CARDS ***
Priitk: folds 
zKiPiSHz: folds 
Toxa_Karol’: folds 
holdemlouis1: raises 1400 to 2800
santiga: raises 24755 to 27555 and is all-in
Bxutu_: folds 
k8ldykbala: folds 
holdemlouis1: folds 
Uncalled bet (24755) returned to santiga
santiga collected 9170 from pot
santiga: doesn't show hand 
*** SUMMARY ***
Total pot 9170 | Rake 0 
Seat 1: Toxa_Karol’ folded before Flop (didn't bet)
Seat 2: holdemlouis1 folded before Flop
Seat 3: santiga (button) collected (9170)
Seat 4: Bxutu_ (small blind) folded before Flop
Seat 5: k8ldykbala (big blind) folded before Flop
Seat 7: Priitk folded before Flop (didn't bet)
Seat 8: zKiPiSHz folded before Flop (didn't bet)

PokerStars Hand #250527994010: Tournament #3754315429, $20+$20+$4 USD Hold'em No Limit - Level XXIII (700/1400) - 2024/05/16 12:46:32 UTC [2024/05/16 8:46:32 ET]
Table '3754315429 3' 8-max Seat #3 is the button
Seat 1: Toxa_Karol’ (69990 in chips, $165 bounty) 
Seat 2: holdemlouis1 (29203 in chips, $57.50 bounty) 
Seat 3: santiga (27765 in chips, $60 bounty) 
Seat 4: Bxutu_ (55033 in chips, $92.50 bounty) 
Seat 5: k8ldykbala (17502 in chips, $80 bounty) 
Seat 7: Priitk (30126 in chips, $55 bounty) 
Seat 8: zKiPiSHz (36040 in chips, $85 bounty) 
Toxa_Karol’: posts the ante 210
holdemlouis1: posts the ante 210
santiga: posts the ante 210
Bxutu_: posts the ante 210
k8ldykbala: posts the ante 210
Priitk: posts the ante 210
zKiPiSHz: posts the ante 210
Bxutu_: posts small blind 700
k8ldykbala: posts big blind 1400
*** HOLE CARDS ***
Priitk: folds 
zKiPiSHz: folds 
Toxa_Karol’: folds 
holdemlouis1: raises 1400 to 2800
santiga: raises 24755 to 27555 and is all-in
Bxutu_: folds 
k8ldykbala: folds 
holdemlouis1: folds 
Uncalled bet (24755) returned to santiga
santiga collected 9170 from pot
santiga: doesn't show hand 
*** SUMMARY ***
Total pot 9170 | Rake 0 
Seat 1: Toxa_Karol’ folded before Flop (didn't bet)
Seat 2: holdemlouis1 folded before Flop
Seat 3: santiga (button) collected (9170)
Seat 4: Bxutu_ (small blind) folded before Flop
Seat 5: k8ldykbala (big blind) folded before Flop
Seat 7: Priitk folded before Flop (didn't bet)
Seat 8: zKiPiSHz folded before Flop (didn't bet)

PokerStars Hand #250527999898: Tournament #3754315429, $20+$20+$4 USD Hold'em No Limit - Level XXIII (700/1400) - 2024/05/16 12:47:06 UTC [2024/05/16 8:47:06 ET]
Table '3754315429 3' 8-max Seat #4 is the button
Seat 1: Toxa_Karol’ (69780 in chips, $165 bounty) 
Seat 2: holdemlouis1 (26193 in chips, $57.50 bounty) 
Seat 3: santiga (33925 in chips, $60 bounty) 
Seat 4: Bxutu_ (54123 in chips, $92.50 bounty) 
Seat 5: k8ldykbala (15892 in chips, $80 bounty) 
Seat 7: Priitk (29916 in chips, $55 bounty) 
Seat 8: zKiPiSHz (35830 in chips, $85 bounty) 
Toxa_Karol’: posts the ante 210
holdemlouis1: posts the ante 210
santiga: posts the ante 210
Bxutu_: posts the ante 210
k8ldykbala: posts the ante 210
Priitk: posts the ante 210
zKiPiSHz: posts the ante 210
k8ldykbala: posts small blind 700
Priitk: posts big blind 1400
*** HOLE CARDS ***
zKiPiSHz: folds 
Toxa_Karol’: raises 1400 to 2800
holdemlouis1: folds 
santiga: folds 
Bxutu_: folds 
k8ldykbala: folds 
Priitk: calls 1400
*** FLOP *** [Ks 3s As]
Priitk: checks 
Toxa_Karol’: bets 2562
Priitk: calls 2562
*** TURN *** [Ks 3s As] [Qc]
Priitk: checks 
Toxa_Karol’: bets 7350
Priitk: folds 
Uncalled bet (7350) returned to Toxa_Karol’
Toxa_Karol’ collected 12894 from pot
*** SUMMARY ***
Total pot 12894 | Rake 0 
Board [Ks 3s As Qc]
Seat 1: Toxa_Karol’ collected (12894)
Seat 2: holdemlouis1 folded before Flop (didn't bet)
Seat 3: santiga folded before Flop (didn't bet)
Seat 4: Bxutu_ (button) folded before Flop (didn't bet)
Seat 5: k8ldykbala (small blind) folded before Flop
Seat 7: Priitk (big blind) folded on the Turn
Seat 8: zKiPiSHz folded before Flop (didn't bet)

PokerStars Hand #250527999898: Tournament #3754315429, $20+$20+$4 USD Hold'em No Limit - Level XXIII (700/1400) - 2024/05/16 12:47:06 UTC [2024/05/16 8:47:06 ET]
Table '3754315429 3' 8-max Seat #4 is the button
Seat 1: Toxa_Karol’ (69780 in chips, $165 bounty) 
Seat 2: holdemlouis1 (26193 in chips, $57.50 bounty) 
Seat 3: santiga (33925 in chips, $60 bounty) 
Seat 4: Bxutu_ (54123 in chips, $92.50 bounty) 
Seat 5: k8ldykbala (15892 in chips, $80 bounty) 
Seat 7: Priitk (29916 in chips, $55 bounty) 
Seat 8: zKiPiSHz (35830 in chips, $85 bounty) 
Toxa_Karol’: posts the ante 210
holdemlouis1: posts the ante 210
santiga: posts the ante 210
Bxutu_: posts the ante 210
k8ldykbala: posts the ante 210
Priitk: posts the ante 210
zKiPiSHz: posts the ante 210
k8ldykbala: posts small blind 700
Priitk: posts big blind 1400
*** HOLE CARDS ***
zKiPiSHz: folds 
Toxa_Karol’: raises 1400 to 2800
holdemlouis1: folds 
santiga: folds 
Bxutu_: folds 
k8ldykbala: folds 
Priitk: calls 1400
*** FLOP *** [Ks 3s As]
Priitk: checks 
Toxa_Karol’: bets 2562
Priitk: calls 2562
*** TURN *** [Ks 3s As] [Qc]
Priitk: checks 
Toxa_Karol’: bets 7350
Priitk: folds 
Uncalled bet (7350) returned to Toxa_Karol’
Toxa_Karol’ collected 12894 from pot
*** SUMMARY ***
Total pot 12894 | Rake 0 
Board [Ks 3s As Qc]
Seat 1: Toxa_Karol’ collected (12894)
Seat 2: holdemlouis1 folded before Flop (didn't bet)
Seat 3: santiga folded before Flop (didn't bet)
Seat 4: Bxutu_ (button) folded before Flop (didn't bet)
Seat 5: k8ldykbala (small blind) folded before Flop
Seat 7: Priitk (big blind) folded on the Turn
Seat 8: zKiPiSHz folded before Flop (didn't bet)

PokerStars Hand #250528006368: Tournament #3754315429, $20+$20+$4 USD Hold'em No Limit - Level XXIII (700/1400) - 2024/05/16 12:47:43 UTC [2024/05/16 8:47:43 ET]
Table '3754315429 3' 8-max Seat #5 is the button
Seat 1: Toxa_Karol’ (77102 in chips, $165 bounty) 
Seat 2: holdemlouis1 (25983 in chips, $57.50 bounty) 
Seat 3: santiga (33715 in chips, $60 bounty) 
Seat 4: Bxutu_ (53913 in chips, $92.50 bounty) 
Seat 5: k8ldykbala (14982 in chips, $80 bounty) 
Seat 7: Priitk (24344 in chips, $55 bounty) 
Seat 8: zKiPiSHz (35620 in chips, $85 bounty) 
Toxa_Karol’: posts the ante 210
holdemlouis1: posts the ante 210
santiga: posts the ante 210
Bxutu_: posts the ante 210
k8ldykbala: posts the ante 210
Priitk: posts the ante 210
zKiPiSHz: posts the ante 210
Priitk: posts small blind 700
zKiPiSHz: posts big blind 1400
*** HOLE CARDS ***
Toxa_Karol’: folds 
holdemlouis1: folds 
santiga: folds 
Bxutu_: raises 1610 to 3010
k8ldykbala: folds 
Priitk: folds 
zKiPiSHz: folds 
Uncalled bet (1610) returned to Bxutu_
Bxutu_ collected 4970 from pot
Bxutu_: doesn't show hand 
*** SUMMARY ***
Total pot 4970 | Rake 0 
Seat 1: Toxa_Karol’ folded before Flop (didn't bet)
Seat 2: holdemlouis1 folded before Flop (didn't bet)
Seat 3: santiga folded before Flop (didn't bet)
Seat 4: Bxutu_ collected (4970)
Seat 5: k8ldykbala (button) folded before Flop (didn't bet)
Seat 7: Priitk (small blind) folded before Flop
Seat 8: zKiPiSHz (big blind) folded before Flop

PokerStars Hand #250528006368: Tournament #3754315429, $20+$20+$4 USD Hold'em No Limit - Level XXIII (700/1400) - 2024/05/16 12:47:43 UTC [2024/05/16 8:47:43 ET]
Table '3754315429 3' 8-max Seat #5 is the button
Seat 1: Toxa_Karol’ (77102 in chips, $165 bounty) 
Seat 2: holdemlouis1 (25983 in chips, $57.50 bounty) 
Seat 3: santiga (33715 in chips, $60 bounty) 
Seat 4: Bxutu_ (53913 in chips, $92.50 bounty) 
Seat 5: k8ldykbala (14982 in chips, $80 bounty) 
Seat 7: Priitk (24344 in chips, $55 bounty) 
Seat 8: zKiPiSHz (35620 in chips, $85 bounty) 
Toxa_Karol’: posts the ante 210
holdemlouis1: posts the ante 210
santiga: posts the ante 210
Bxutu_: posts the ante 210
k8ldykbala: posts the ante 210
Priitk: posts the ante 210
zKiPiSHz: posts the ante 210
Priitk: posts small blind 700
zKiPiSHz: posts big blind 1400
*** HOLE CARDS ***
Toxa_Karol’: folds 
holdemlouis1: folds 
santiga: folds 
Bxutu_: raises 1610 to 3010
k8ldykbala: folds 
Priitk: folds 
zKiPiSHz: folds 
Uncalled bet (1610) returned to Bxutu_
Bxutu_ collected 4970 from pot
Bxutu_: doesn't show hand 
*** SUMMARY ***
Total pot 4970 | Rake 0 
Seat 1: Toxa_Karol’ folded before Flop (didn't bet)
Seat 2: holdemlouis1 folded before Flop (didn't bet)
Seat 3: santiga folded before Flop (didn't bet)
Seat 4: Bxutu_ collected (4970)
Seat 5: k8ldykbala (button) folded before Flop (didn't bet)
Seat 7: Priitk (small blind) folded before Flop
Seat 8: zKiPiSHz (big blind) folded before Flop

PokerStars Hand #250528010990: Tournament #3754315429, $20+$20+$4 USD Hold'em No Limit - Level XXIII (700/1400) - 2024/05/16 12:48:10 UTC [2024/05/16 8:48:10 ET]
Table '3754315429 3' 8-max Seat #7 is the button
Seat 1: Toxa_Karol’ (76892 in chips, $165 bounty) 
Seat 2: holdemlouis1 (25773 in chips, $57.50 bounty) 
Seat 3: santiga (33505 in chips, $60 bounty) 
Seat 4: Bxutu_ (57273 in chips, $92.50 bounty) 
Seat 5: k8ldykbala (14772 in chips, $80 bounty) 
Seat 7: Priitk (23434 in chips, $55 bounty) 
Seat 8: zKiPiSHz (34010 in chips, $85 bounty) 
Toxa_Karol’: posts the ante 210
holdemlouis1: posts the ante 210
santiga: posts the ante 210
Bxutu_: posts the ante 210
k8ldykbala: posts the ante 210
Priitk: posts the ante 210
zKiPiSHz: posts the ante 210
zKiPiSHz: posts small blind 700
Toxa_Karol’: posts big blind 1400
*** HOLE CARDS ***
holdemlouis1: folds 
santiga: raises 1960 to 3360
Bxutu_: folds 
k8ldykbala: folds 
Priitk: folds 
zKiPiSHz: folds 
Toxa_Karol’: folds 
Uncalled bet (1960) returned to santiga
santiga collected 4970 from pot
santiga: doesn't show hand 
*** SUMMARY ***
Total pot 4970 | Rake 0 
Seat 1: Toxa_Karol’ (big blind) folded before Flop
Seat 2: holdemlouis1 folded before Flop (didn't bet)
Seat 3: santiga collected (4970)
Seat 4: Bxutu_ folded before Flop (didn't bet)
Seat 5: k8ldykbala folded before Flop (didn't bet)
Seat 7: Priitk (button) folded before Flop (didn't bet)
Seat 8: zKiPiSHz (small blind) folded before Flop

PokerStars Hand #250528010990: Tournament #3754315429, $20+$20+$4 USD Hold'em No Limit - Level XXIII (700/1400) - 2024/05/16 12:48:10 UTC [2024/05/16 8:48:10 ET]
Table '3754315429 3' 8-max Seat #7 is the button
Seat 1: Toxa_Karol’ (76892 in chips, $165 bounty) 
Seat 2: holdemlouis1 (25773 in chips, $57.50 bounty) 
Seat 3: santiga (33505 in chips, $60 bounty) 
Seat 4: Bxutu_ (57273 in chips, $92.50 bounty) 
Seat 5: k8ldykbala (14772 in chips, $80 bounty) 
Seat 7: Priitk (23434 in chips, $55 bounty) 
Seat 8: zKiPiSHz (34010 in chips, $85 bounty) 
Toxa_Karol’: posts the ante 210
holdemlouis1: posts the ante 210
santiga: posts the ante 210
Bxutu_: posts the ante 210
k8ldykbala: posts the ante 210
Priitk: posts the ante 210
zKiPiSHz: posts the ante 210
zKiPiSHz: posts small blind 700
Toxa_Karol’: posts big blind 1400
*** HOLE CARDS ***
holdemlouis1: folds 
santiga: raises 1960 to 3360
Bxutu_: folds 
k8ldykbala: folds 
Priitk: folds 
zKiPiSHz: folds 
Toxa_Karol’: folds 
Uncalled bet (1960) returned to santiga
santiga collected 4970 from pot
santiga: doesn't show hand 
*** SUMMARY ***
Total pot 4970 | Rake 0 
Seat 1: Toxa_Karol’ (big blind) folded before Flop
Seat 2: holdemlouis1 folded before Flop (didn't bet)
Seat 3: santiga collected (4970)
Seat 4: Bxutu_ folded before Flop (didn't bet)
Seat 5: k8ldykbala folded before Flop (didn't bet)
Seat 7: Priitk (button) folded before Flop (didn't bet)
Seat 8: zKiPiSHz (small blind) folded before Flop

PokerStars Hand #250528016286: Tournament #3754315429, $20+$20+$4 USD Hold'em No Limit - Level XXIII (700/1400) - 2024/05/16 12:48:41 UTC [2024/05/16 8:48:41 ET]
Table '3754315429 3' 8-max Seat #8 is the button
Seat 1: Toxa_Karol’ (75282 in chips, $165 bounty) 
Seat 2: holdemlouis1 (25563 in chips, $57.50 bounty) 
Seat 3: santiga (36865 in chips, $60 bounty) 
Seat 4: Bxutu_ (57063 in chips, $92.50 bounty) 
Seat 5: k8ldykbala (14562 in chips, $80 bounty) 
Seat 7: Priitk (23224 in chips, $55 bounty) 
Seat 8: zKiPiSHz (33100 in chips, $85 bounty) 
Toxa_Karol’: posts the ante 210
holdemlouis1: posts the ante 210
santiga: posts the ante 210
Bxutu_: posts the ante 210
k8ldykbala: posts the ante 210
Priitk: posts the ante 210
zKiPiSHz: posts the ante 210
Toxa_Karol’: posts small blind 700
holdemlouis1: posts big blind 1400
*** HOLE CARDS ***
santiga: folds 
Bxutu_: raises 1610 to 3010
k8ldykbala: raises 11342 to 14352 and is all-in
Priitk: folds 
zKiPiSHz: folds 
Toxa_Karol’: folds 
holdemlouis1: folds 
Bxutu_: calls 11342
*** FLOP *** [Td Kc 8h]
*** TURN *** [Td Kc 8h] [Ac]
*** RIVER *** [Td Kc 8h Ac] [2d]
*** SHOW DOWN ***
Bxutu_: shows [5c 5s] (a pair of Fives)
k8ldykbala: shows [Js As] (a pair of Aces)
k8ldykbala collected 32274 from pot
*** SUMMARY ***
Total pot 32274 | Rake 0 
Board [Td Kc 8h Ac 2d]
Seat 1: Toxa_Karol’ (small blind) folded before Flop
Seat 2: holdemlouis1 (big blind) folded before Flop
Seat 3: santiga folded before Flop (didn't bet)
Seat 4: Bxutu_ showed [5c 5s] and lost with a pair of Fives
Seat 5: k8ldykbala showed [Js As] and won (32274) with a pair of Aces
Seat 7: Priitk folded before Flop (didn't bet)
Seat 8: zKiPiSHz (button) folded before Flop (didn't bet)

PokerStars Hand #250528016286: Tournament #3754315429, $20+$20+$4 USD Hold'em No Limit - Level XXIII (700/1400) - 2024/05/16 12:48:41 UTC [2024/05/16 8:48:41 ET]
Table '3754315429 3' 8-max Seat #8 is the button
Seat 1: Toxa_Karol’ (75282 in chips, $165 bounty) 
Seat 2: holdemlouis1 (25563 in chips, $57.50 bounty) 
Seat 3: santiga (36865 in chips, $60 bounty) 
Seat 4: Bxutu_ (57063 in chips, $92.50 bounty) 
Seat 5: k8ldykbala (14562 in chips, $80 bounty) 
Seat 7: Priitk (23224 in chips, $55 bounty) 
Seat 8: zKiPiSHz (33100 in chips, $85 bounty) 
Toxa_Karol’: posts the ante 210
holdemlouis1: posts the ante 210
santiga: posts the ante 210
Bxutu_: posts the ante 210
k8ldykbala: posts the ante 210
Priitk: posts the ante 210
zKiPiSHz: posts the ante 210
Toxa_Karol’: posts small blind 700
holdemlouis1: posts big blind 1400
*** HOLE CARDS ***
santiga: folds 
Bxutu_: raises 1610 to 3010
k8ldykbala: raises 11342 to 14352 and is all-in
Priitk: folds 
zKiPiSHz: folds 
Toxa_Karol’: folds 
holdemlouis1: folds 
Bxutu_: calls 11342
*** FLOP *** [Td Kc 8h]
*** TURN *** [Td Kc 8h] [Ac]
*** RIVER *** [Td Kc 8h Ac] [2d]
*** SHOW DOWN ***
Bxutu_: shows [5c 5s] (a pair of Fives)
k8ldykbala: shows [Js As] (a pair of Aces)
k8ldykbala collected 32274 from pot
*** SUMMARY ***
Total pot 32274 | Rake 0 
Board [Td Kc 8h Ac 2d]
Seat 1: Toxa_Karol’ (small blind) folded before Flop
Seat 2: holdemlouis1 (big blind) folded before Flop
Seat 3: santiga folded before Flop (didn't bet)
Seat 4: Bxutu_ showed [5c 5s] and lost with a pair of Fives
Seat 5: k8ldykbala showed [Js As] and won (32274) with a pair of Aces
Seat 7: Priitk folded before Flop (didn't bet)
Seat 8: zKiPiSHz (button) folded before Flop (didn't bet)

PokerStars Hand #250528021504: Tournament #3754315429, $20+$20+$4 USD Hold'em No Limit - Level XXIII (700/1400) - 2024/05/16 12:49:10 UTC [2024/05/16 8:49:10 ET]
Table '3754315429 3' 8-max Seat #1 is the button
Seat 1: Toxa_Karol’ (74372 in chips, $165 bounty) 
Seat 2: holdemlouis1 (23953 in chips, $57.50 bounty) 
Seat 3: santiga (36655 in chips, $60 bounty) 
Seat 4: Bxutu_ (42501 in chips, $92.50 bounty) 
Seat 5: k8ldykbala (32274 in chips, $80 bounty) 
Seat 7: Priitk (23014 in chips, $55 bounty) 
Seat 8: zKiPiSHz (32890 in chips, $85 bounty) 
Toxa_Karol’: posts the ante 210
holdemlouis1: posts the ante 210
santiga: posts the ante 210
Bxutu_: posts the ante 210
k8ldykbala: posts the ante 210
Priitk: posts the ante 210
zKiPiSHz: posts the ante 210
holdemlouis1: posts small blind 700
santiga: posts big blind 1400
*** HOLE CARDS ***
Bxutu_: folds 
k8ldykbala: folds 
Priitk: folds 
zKiPiSHz: folds 
Toxa_Karol’: raises 1400 to 2800
holdemlouis1: raises 20943 to 23743 and is all-in
santiga: folds 
Toxa_Karol’: folds 
Uncalled bet (20943) returned to holdemlouis1
holdemlouis1 collected 8470 from pot
*** SUMMARY ***
Total pot 8470 | Rake 0 
Seat 1: Toxa_Karol’ (button) folded before Flop
Seat 2: holdemlouis1 (small blind) collected (8470)
Seat 3: santiga (big blind) folded before Flop
Seat 4: Bxutu_ folded before Flop (didn't bet)
Seat 5: k8ldykbala folded before Flop (didn't bet)
Seat 7: Priitk folded before Flop (didn't bet)
Seat 8: zKiPiSHz folded before Flop (didn't bet)

PokerStars Hand #250528021504: Tournament #3754315429, $20+$20+$4 USD Hold'em No Limit - Level XXIII (700/1400) - 2024/05/16 12:49:10 UTC [2024/05/16 8:49:10 ET]
Table '3754315429 3' 8-max Seat #1 is the button
Seat 1: Toxa_Karol’ (74372 in chips, $165 bounty) 
Seat 2: holdemlouis1 (23953 in chips, $57.50 bounty) 
Seat 3: santiga (36655 in chips, $60 bounty) 
Seat 4: Bxutu_ (42501 in chips, $92.50 bounty) 
Seat 5: k8ldykbala (32274 in chips, $80 bounty) 
Seat 7: Priitk (23014 in chips, $55 bounty) 
Seat 8: zKiPiSHz (32890 in chips, $85 bounty) 
Toxa_Karol’: posts the ante 210
holdemlouis1: posts the ante 210
santiga: posts the ante 210
Bxutu_: posts the ante 210
k8ldykbala: posts the ante 210
Priitk: posts the ante 210
zKiPiSHz: posts the ante 210
holdemlouis1: posts small blind 700
santiga: posts big blind 1400
*** HOLE CARDS ***
Bxutu_: folds 
k8ldykbala: folds 
Priitk: folds 
zKiPiSHz: folds 
Toxa_Karol’: raises 1400 to 2800
holdemlouis1: raises 20943 to 23743 and is all-in
santiga: folds 
Toxa_Karol’: folds 
Uncalled bet (20943) returned to holdemlouis1
holdemlouis1 collected 8470 from pot
*** SUMMARY ***
Total pot 8470 | Rake 0 
Seat 1: Toxa_Karol’ (button) folded before Flop
Seat 2: holdemlouis1 (small blind) collected (8470)
Seat 3: santiga (big blind) folded before Flop
Seat 4: Bxutu_ folded before Flop (didn't bet)
Seat 5: k8ldykbala folded before Flop (didn't bet)
Seat 7: Priitk folded before Flop (didn't bet)
Seat 8: zKiPiSHz folded before Flop (didn't bet)

PokerStars Hand #250528026261: Tournament #3754315429, $20+$20+$4 USD Hold'em No Limit - Level XXIII (700/1400) - 2024/05/16 12:49:38 UTC [2024/05/16 8:49:38 ET]
Table '3754315429 3' 8-max Seat #2 is the button
Seat 1: Toxa_Karol’ (71362 in chips, $165 bounty) 
Seat 2: holdemlouis1 (29413 in chips, $57.50 bounty) 
Seat 3: santiga (35045 in chips, $60 bounty) 
Seat 4: Bxutu_ (42291 in chips, $92.50 bounty) 
Seat 5: k8ldykbala (32064 in chips, $80 bounty) 
Seat 7: Priitk (22804 in chips, $55 bounty) 
Seat 8: zKiPiSHz (32680 in chips, $85 bounty) 
Toxa_Karol’: posts the ante 210
holdemlouis1: posts the ante 210
santiga: posts the ante 210
Bxutu_: posts the ante 210
k8ldykbala: posts the ante 210
Priitk: posts the ante 210
zKiPiSHz: posts the ante 210
santiga: posts small blind 700
Bxutu_: posts big blind 1400
*** HOLE CARDS ***
k8ldykbala: folds 
Priitk: folds 
zKiPiSHz: raises 1400 to 2800
Toxa_Karol’: raises 4900 to 7700
holdemlouis1: folds 
santiga: folds 
Bxutu_: folds 
zKiPiSHz: folds 
Uncalled bet (4900) returned to Toxa_Karol’
Toxa_Karol’ collected 9170 from pot
*** SUMMARY ***
Total pot 9170 | Rake 0 
Seat 1: Toxa_Karol’ collected (9170)
Seat 2: holdemlouis1 (button) folded before Flop (didn't bet)
Seat 3: santiga (small blind) folded before Flop
Seat 4: Bxutu_ (big blind) folded before Flop
Seat 5: k8ldykbala folded before Flop (didn't bet)
Seat 7: Priitk folded before Flop (didn't bet)
Seat 8: zKiPiSHz folded before Flop

PokerStars Hand #250528026261: Tournament #3754315429, $20+$20+$4 USD Hold'em No Limit - Level XXIII (700/1400) - 2024/05/16 12:49:38 UTC [2024/05/16 8:49:38 ET]
Table '3754315429 3' 8-max Seat #2 is the button
Seat 1: Toxa_Karol’ (71362 in chips, $165 bounty) 
Seat 2: holdemlouis1 (29413 in chips, $57.50 bounty) 
Seat 3: santiga (35045 in chips, $60 bounty) 
Seat 4: Bxutu_ (42291 in chips, $92.50 bounty) 
Seat 5: k8ldykbala (32064 in chips, $80 bounty) 
Seat 7: Priitk (22804 in chips, $55 bounty) 
Seat 8: zKiPiSHz (32680 in chips, $85 bounty) 
Toxa_Karol’: posts the ante 210
holdemlouis1: posts the ante 210
santiga: posts the ante 210
Bxutu_: posts the ante 210
k8ldykbala: posts the ante 210
Priitk: posts the ante 210
zKiPiSHz: posts the ante 210
santiga: posts small blind 700
Bxutu_: posts big blind 1400
*** HOLE CARDS ***
k8ldykbala: folds 
Priitk: folds 
zKiPiSHz: raises 1400 to 2800
Toxa_Karol’: raises 4900 to 7700
holdemlouis1: folds 
santiga: folds 
Bxutu_: folds 
zKiPiSHz: folds 
Uncalled bet (4900) returned to Toxa_Karol’
Toxa_Karol’ collected 9170 from pot
*** SUMMARY ***
Total pot 9170 | Rake 0 
Seat 1: Toxa_Karol’ collected (9170)
Seat 2: holdemlouis1 (button) folded before Flop (didn't bet)
Seat 3: santiga (small blind) folded before Flop
Seat 4: Bxutu_ (big blind) folded before Flop
Seat 5: k8ldykbala folded before Flop (didn't bet)
Seat 7: Priitk folded before Flop (didn't bet)
Seat 8: zKiPiSHz folded before Flop

PokerStars Hand #250528036435: Tournament #3754315429, $20+$20+$4 USD Hold'em No Limit - Level XXIII (700/1400) - 2024/05/16 12:50:37 UTC [2024/05/16 8:50:37 ET]
Table '3754315429 3' 8-max Seat #3 is the button
Seat 1: Toxa_Karol’ (77522 in chips, $165 bounty) 
Seat 2: holdemlouis1 (29203 in chips, $57.50 bounty) 
Seat 3: santiga (34135 in chips, $60 bounty) 
Seat 4: Bxutu_ (40681 in chips, $92.50 bounty) 
Seat 5: k8ldykbala (31854 in chips, $80 bounty) 
Seat 7: Priitk (22594 in chips, $55 bounty) 
Seat 8: zKiPiSHz (29670 in chips, $85 bounty) 
Toxa_Karol’: posts the ante 210
holdemlouis1: posts the ante 210
santiga: posts the ante 210
Bxutu_: posts the ante 210
k8ldykbala: posts the ante 210
Priitk: posts the ante 210
zKiPiSHz: posts the ante 210
Bxutu_: posts small blind 700
k8ldykbala: posts big blind 1400
*** HOLE CARDS ***
Priitk: folds 
zKiPiSHz: raises 1400 to 2800
Toxa_Karol’: folds 
holdemlouis1: folds 
santiga: folds 
Bxutu_: folds 
k8ldykbala: calls 1400
*** FLOP *** [3h Js 4d]
k8ldykbala: checks 
zKiPiSHz: bets 2100
k8ldykbala: raises 3588 to 5688
zKiPiSHz: calls 3588
*** TURN *** [3h Js 4d] [Ah]
k8ldykbala: checks 
zKiPiSHz: bets 20972 and is all-in
k8ldykbala: folds 
Uncalled bet (20972) returned to zKiPiSHz
zKiPiSHz collected 19146 from pot
zKiPiSHz: doesn't show hand 
*** SUMMARY ***
Total pot 19146 | Rake 0 
Board [3h Js 4d Ah]
Seat 1: Toxa_Karol’ folded before Flop (didn't bet)
Seat 2: holdemlouis1 folded before Flop (didn't bet)
Seat 3: santiga (button) folded before Flop (didn't bet)
Seat 4: Bxutu_ (small blind) folded before Flop
Seat 5: k8ldykbala (big blind) folded on the Turn
Seat 7: Priitk folded before Flop (didn't bet)
Seat 8: zKiPiSHz collected (19146)

PokerStars Hand #250528036435: Tournament #3754315429, $20+$20+$4 USD Hold'em No Limit - Level XXIII (700/1400) - 2024/05/16 12:50:37 UTC [2024/05/16 8:50:37 ET]
Table '3754315429 3' 8-max Seat #3 is the button
Seat 1: Toxa_Karol’ (77522 in chips, $165 bounty) 
Seat 2: holdemlouis1 (29203 in chips, $57.50 bounty) 
Seat 3: santiga (34135 in chips, $60 bounty) 
Seat 4: Bxutu_ (40681 in chips, $92.50 bounty) 
Seat 5: k8ldykbala (31854 in chips, $80 bounty) 
Seat 7: Priitk (22594 in chips, $55 bounty) 
Seat 8: zKiPiSHz (29670 in chips, $85 bounty) 
Toxa_Karol’: posts the ante 210
holdemlouis1: posts the ante 210
santiga: posts the ante 210
Bxutu_: posts the ante 210
k8ldykbala: posts the ante 210
Priitk: posts the ante 210
zKiPiSHz: posts the ante 210
Bxutu_: posts small blind 700
k8ldykbala: posts big blind 1400
*** HOLE CARDS ***
Priitk: folds 
zKiPiSHz: raises 1400 to 2800
Toxa_Karol’: folds 
holdemlouis1: folds 
santiga: folds 
Bxutu_: folds 
k8ldykbala: calls 1400
*** FLOP *** [3h Js 4d]
k8ldykbala: checks 
zKiPiSHz: bets 2100
k8ldykbala: raises 3588 to 5688
zKiPiSHz: calls 3588
*** TURN *** [3h Js 4d] [Ah]
k8ldykbala: checks 
zKiPiSHz: bets 20972 and is all-in
k8ldykbala: folds 
Uncalled bet (20972) returned to zKiPiSHz
zKiPiSHz collected 19146 from pot
zKiPiSHz: doesn't show hand 
*** SUMMARY ***
Total pot 19146 | Rake 0 
Board [3h Js 4d Ah]
Seat 1: Toxa_Karol’ folded before Flop (didn't bet)
Seat 2: holdemlouis1 folded before Flop (didn't bet)
Seat 3: santiga (button) folded before Flop (didn't bet)
Seat 4: Bxutu_ (small blind) folded before Flop
Seat 5: k8ldykbala (big blind) folded on the Turn
Seat 7: Priitk folded before Flop (didn't bet)
Seat 8: zKiPiSHz collected (19146)

PokerStars Hand #250528049938: Tournament #3754315429, $20+$20+$4 USD Hold'em No Limit - Level XXIII (700/1400) - 2024/05/16 12:51:55 UTC [2024/05/16 8:51:55 ET]
Table '3754315429 3' 8-max Seat #4 is the button
Seat 1: Toxa_Karol’ (77312 in chips, $165 bounty) 
Seat 2: holdemlouis1 (28993 in chips, $57.50 bounty) 
Seat 3: santiga (33925 in chips, $60 bounty) 
Seat 4: Bxutu_ (39771 in chips, $92.50 bounty) 
Seat 5: k8ldykbala (23156 in chips, $80 bounty) 
Seat 7: Priitk (22384 in chips, $55 bounty) 
Seat 8: zKiPiSHz (40118 in chips, $85 bounty) 
Toxa_Karol’: posts the ante 210
holdemlouis1: posts the ante 210
santiga: posts the ante 210
Bxutu_: posts the ante 210
k8ldykbala: posts the ante 210
Priitk: posts the ante 210
zKiPiSHz: posts the ante 210
k8ldykbala: posts small blind 700
Priitk: posts big blind 1400
*** HOLE CARDS ***
zKiPiSHz: folds 
Toxa_Karol’: folds 
holdemlouis1: folds 
santiga: folds 
Bxutu_: raises 38161 to 39561 and is all-in
k8ldykbala: folds 
Priitk: folds 
Uncalled bet (38161) returned to Bxutu_
Bxutu_ collected 4970 from pot
Bxutu_: doesn't show hand 
*** SUMMARY ***
Total pot 4970 | Rake 0 
Seat 1: Toxa_Karol’ folded before Flop (didn't bet)
Seat 2: holdemlouis1 folded before Flop (didn't bet)
Seat 3: santiga folded before Flop (didn't bet)
Seat 4: Bxutu_ (button) collected (4970)
Seat 5: k8ldykbala (small blind) folded before Flop
Seat 7: Priitk (big blind) folded before Flop
Seat 8: zKiPiSHz folded before Flop (didn't bet)

PokerStars Hand #250528049938: Tournament #3754315429, $20+$20+$4 USD Hold'em No Limit - Level XXIII (700/1400) - 2024/05/16 12:51:55 UTC [2024/05/16 8:51:55 ET]
Table '3754315429 3' 8-max Seat #4 is the button
Seat 1: Toxa_Karol’ (77312 in chips, $165 bounty) 
Seat 2: holdemlouis1 (28993 in chips, $57.50 bounty) 
Seat 3: santiga (33925 in chips, $60 bounty) 
Seat 4: Bxutu_ (39771 in chips, $92.50 bounty) 
Seat 5: k8ldykbala (23156 in chips, $80 bounty) 
Seat 7: Priitk (22384 in chips, $55 bounty) 
Seat 8: zKiPiSHz (40118 in chips, $85 bounty) 
Toxa_Karol’: posts the ante 210
holdemlouis1: posts the ante 210
santiga: posts the ante 210
Bxutu_: posts the ante 210
k8ldykbala: posts the ante 210
Priitk: posts the ante 210
zKiPiSHz: posts the ante 210
k8ldykbala: posts small blind 700
Priitk: posts big blind 1400
*** HOLE CARDS ***
zKiPiSHz: folds 
Toxa_Karol’: folds 
holdemlouis1: folds 
santiga: folds 
Bxutu_: raises 38161 to 39561 and is all-in
k8ldykbala: folds 
Priitk: folds 
Uncalled bet (38161) returned to Bxutu_
Bxutu_ collected 4970 from pot
Bxutu_: doesn't show hand 
*** SUMMARY ***
Total pot 4970 | Rake 0 
Seat 1: Toxa_Karol’ folded before Flop (didn't bet)
Seat 2: holdemlouis1 folded before Flop (didn't bet)
Seat 3: santiga folded before Flop (didn't bet)
Seat 4: Bxutu_ (button) collected (4970)
Seat 5: k8ldykbala (small blind) folded before Flop
Seat 7: Priitk (big blind) folded before Flop
Seat 8: zKiPiSHz folded before Flop (didn't bet)

PokerStars Hand #250528055224: Tournament #3754315429, $20+$20+$4 USD Hold'em No Limit - Level XXIII (700/1400) - 2024/05/16 12:52:25 UTC [2024/05/16 8:52:25 ET]
Table '3754315429 3' 8-max Seat #5 is the button
Seat 1: Toxa_Karol’ (77102 in chips, $165 bounty) 
Seat 2: holdemlouis1 (28783 in chips, $57.50 bounty) 
Seat 3: santiga (33715 in chips, $60 bounty) 
Seat 4: Bxutu_ (43131 in chips, $92.50 bounty) 
Seat 5: k8ldykbala (22246 in chips, $80 bounty) 
Seat 7: Priitk (20774 in chips, $55 bounty) 
Seat 8: zKiPiSHz (39908 in chips, $85 bounty) 
Toxa_Karol’: posts the ante 210
holdemlouis1: posts the ante 210
santiga: posts the ante 210
Bxutu_: posts the ante 210
k8ldykbala: posts the ante 210
Priitk: posts the ante 210
zKiPiSHz: posts the ante 210
Priitk: posts small blind 700
zKiPiSHz: posts big blind 1400
*** HOLE CARDS ***
Toxa_Karol’: raises 1400 to 2800
holdemlouis1: folds 
santiga: folds 
Bxutu_: folds 
k8ldykbala: folds 
Priitk: folds 
zKiPiSHz: folds 
Uncalled bet (1400) returned to Toxa_Karol’
Toxa_Karol’ collected 4970 from pot
*** SUMMARY ***
Total pot 4970 | Rake 0 
Seat 1: Toxa_Karol’ collected (4970)
Seat 2: holdemlouis1 folded before Flop (didn't bet)
Seat 3: santiga folded before Flop (didn't bet)
Seat 4: Bxutu_ folded before Flop (didn't bet)
Seat 5: k8ldykbala (button) folded before Flop (didn't bet)
Seat 7: Priitk (small blind) folded before Flop
Seat 8: zKiPiSHz (big blind) folded before Flop

PokerStars Hand #250528055224: Tournament #3754315429, $20+$20+$4 USD Hold'em No Limit - Level XXIII (700/1400) - 2024/05/16 12:52:25 UTC [2024/05/16 8:52:25 ET]
Table '3754315429 3' 8-max Seat #5 is the button
Seat 1: Toxa_Karol’ (77102 in chips, $165 bounty) 
Seat 2: holdemlouis1 (28783 in chips, $57.50 bounty) 
Seat 3: santiga (33715 in chips, $60 bounty) 
Seat 4: Bxutu_ (43131 in chips, $92.50 bounty) 
Seat 5: k8ldykbala (22246 in chips, $80 bounty) 
Seat 7: Priitk (20774 in chips, $55 bounty) 
Seat 8: zKiPiSHz (39908 in chips, $85 bounty) 
Toxa_Karol’: posts the ante 210
holdemlouis1: posts the ante 210
santiga: posts the ante 210
Bxutu_: posts the ante 210
k8ldykbala: posts the ante 210
Priitk: posts the ante 210
zKiPiSHz: posts the ante 210
Priitk: posts small blind 700
zKiPiSHz: posts big blind 1400
*** HOLE CARDS ***
Toxa_Karol’: raises 1400 to 2800
holdemlouis1: folds 
santiga: folds 
Bxutu_: folds 
k8ldykbala: folds 
Priitk: folds 
zKiPiSHz: folds 
Uncalled bet (1400) returned to Toxa_Karol’
Toxa_Karol’ collected 4970 from pot
*** SUMMARY ***
Total pot 4970 | Rake 0 
Seat 1: Toxa_Karol’ collected (4970)
Seat 2: holdemlouis1 folded before Flop (didn't bet)
Seat 3: santiga folded before Flop (didn't bet)
Seat 4: Bxutu_ folded before Flop (didn't bet)
Seat 5: k8ldykbala (button) folded before Flop (didn't bet)
Seat 7: Priitk (small blind) folded before Flop
Seat 8: zKiPiSHz (big blind) folded before Flop

PokerStars Hand #250528058211: Tournament #3754315429, $20+$20+$4 USD Hold'em No Limit - Level XXIII (700/1400) - 2024/05/16 12:52:43 UTC [2024/05/16 8:52:43 ET]
Table '3754315429 3' 8-max Seat #7 is the button
Seat 1: Toxa_Karol’ (80462 in chips, $165 bounty) 
Seat 2: holdemlouis1 (28573 in chips, $57.50 bounty) 
Seat 3: santiga (33505 in chips, $60 bounty) 
Seat 4: Bxutu_ (42921 in chips, $92.50 bounty) 
Seat 5: k8ldykbala (22036 in chips, $80 bounty) 
Seat 7: Priitk (19864 in chips, $55 bounty) 
Seat 8: zKiPiSHz (38298 in chips, $85 bounty) 
Toxa_Karol’: posts the ante 210
holdemlouis1: posts the ante 210
santiga: posts the ante 210
Bxutu_: posts the ante 210
k8ldykbala: posts the ante 210
Priitk: posts the ante 210
zKiPiSHz: posts the ante 210
zKiPiSHz: posts small blind 700
Toxa_Karol’: posts big blind 1400
*** HOLE CARDS ***
holdemlouis1: folds 
santiga: folds 
Bxutu_: raises 1610 to 3010
k8ldykbala: folds 
Priitk: folds 
zKiPiSHz: folds 
Toxa_Karol’: calls 1610
*** FLOP *** [Th As Qs]
Toxa_Karol’: checks 
Bxutu_: bets 2048
Toxa_Karol’: folds 
Uncalled bet (2048) returned to Bxutu_
Bxutu_ collected 8190 from pot
Bxutu_: doesn't show hand 
*** SUMMARY ***
Total pot 8190 | Rake 0 
Board [Th As Qs]
Seat 1: Toxa_Karol’ (big blind) folded on the Flop
Seat 2: holdemlouis1 folded before Flop (didn't bet)
Seat 3: santiga folded before Flop (didn't bet)
Seat 4: Bxutu_ collected (8190)
Seat 5: k8ldykbala folded before Flop (didn't bet)
Seat 7: Priitk (button) folded before Flop (didn't bet)
Seat 8: zKiPiSHz (small blind) folded before Flop

PokerStars Hand #250528058211: Tournament #3754315429, $20+$20+$4 USD Hold'em No Limit - Level XXIII (700/1400) - 2024/05/16 12:52:43 UTC [2024/05/16 8:52:43 ET]
Table '3754315429 3' 8-max Seat #7 is the button
Seat 1: Toxa_Karol’ (80462 in chips, $165 bounty) 
Seat 2: holdemlouis1 (28573 in chips, $57.50 bounty) 
Seat 3: santiga (33505 in chips, $60 bounty) 
Seat 4: Bxutu_ (42921 in chips, $92.50 bounty) 
Seat 5: k8ldykbala (22036 in chips, $80 bounty) 
Seat 7: Priitk (19864 in chips, $55 bounty) 
Seat 8: zKiPiSHz (38298 in chips, $85 bounty) 
Toxa_Karol’: posts the ante 210
holdemlouis1: posts the ante 210
santiga: posts the ante 210
Bxutu_: posts the ante 210
k8ldykbala: posts the ante 210
Priitk: posts the ante 210
zKiPiSHz: posts the ante 210
zKiPiSHz: posts small blind 700
Toxa_Karol’: posts big blind 1400
*** HOLE CARDS ***
holdemlouis1: folds 
santiga: folds 
Bxutu_: raises 1610 to 3010
k8ldykbala: folds 
Priitk: folds 
zKiPiSHz: folds 
Toxa_Karol’: calls 1610
*** FLOP *** [Th As Qs]
Toxa_Karol’: checks 
Bxutu_: bets 2048
Toxa_Karol’: folds 
Uncalled bet (2048) returned to Bxutu_
Bxutu_ collected 8190 from pot
Bxutu_: doesn't show hand 
*** SUMMARY ***
Total pot 8190 | Rake 0 
Board [Th As Qs]
Seat 1: Toxa_Karol’ (big blind) folded on the Flop
Seat 2: holdemlouis1 folded before Flop (didn't bet)
Seat 3: santiga folded before Flop (didn't bet)
Seat 4: Bxutu_ collected (8190)
Seat 5: k8ldykbala folded before Flop (didn't bet)
Seat 7: Priitk (button) folded before Flop (didn't bet)
Seat 8: zKiPiSHz (small blind) folded before Flop

PokerStars Hand #250528065626: Tournament #3754315429, $20+$20+$4 USD Hold'em No Limit - Level XXIII (700/1400) - 2024/05/16 12:53:25 UTC [2024/05/16 8:53:25 ET]
Table '3754315429 3' 8-max Seat #8 is the button
Seat 1: Toxa_Karol’ (77242 in chips, $165 bounty) 
Seat 2: holdemlouis1 (28363 in chips, $57.50 bounty) 
Seat 3: santiga (33295 in chips, $60 bounty) 
Seat 4: Bxutu_ (47891 in chips, $92.50 bounty) 
Seat 5: k8ldykbala (21826 in chips, $80 bounty) 
Seat 7: Priitk (19654 in chips, $55 bounty) 
Seat 8: zKiPiSHz (37388 in chips, $85 bounty) 
Toxa_Karol’: posts the ante 210
holdemlouis1: posts the ante 210
santiga: posts the ante 210
Bxutu_: posts the ante 210
k8ldykbala: posts the ante 210
Priitk: posts the ante 210
zKiPiSHz: posts the ante 210
Toxa_Karol’: posts small blind 700
holdemlouis1: posts big blind 1400
*** HOLE CARDS ***
santiga: folds 
Bxutu_: raises 1610 to 3010
k8ldykbala: folds 
Priitk: folds 
zKiPiSHz: folds 
Toxa_Karol’: folds 
holdemlouis1: folds 
Uncalled bet (1610) returned to Bxutu_
Bxutu_ collected 4970 from pot
Bxutu_: doesn't show hand 
*** SUMMARY ***
Total pot 4970 | Rake 0 
Seat 1: Toxa_Karol’ (small blind) folded before Flop
Seat 2: holdemlouis1 (big blind) folded before Flop
Seat 3: santiga folded before Flop (didn't bet)
Seat 4: Bxutu_ collected (4970)
Seat 5: k8ldykbala folded before Flop (didn't bet)
Seat 7: Priitk folded before Flop (didn't bet)
Seat 8: zKiPiSHz (button) folded before Flop (didn't bet)

PokerStars Hand #250528065626: Tournament #3754315429, $20+$20+$4 USD Hold'em No Limit - Level XXIII (700/1400) - 2024/05/16 12:53:25 UTC [2024/05/16 8:53:25 ET]
Table '3754315429 3' 8-max Seat #8 is the button
Seat 1: Toxa_Karol’ (77242 in chips, $165 bounty) 
Seat 2: holdemlouis1 (28363 in chips, $57.50 bounty) 
Seat 3: santiga (33295 in chips, $60 bounty) 
Seat 4: Bxutu_ (47891 in chips, $92.50 bounty) 
Seat 5: k8ldykbala (21826 in chips, $80 bounty) 
Seat 7: Priitk (19654 in chips, $55 bounty) 
Seat 8: zKiPiSHz (37388 in chips, $85 bounty) 
Toxa_Karol’: posts the ante 210
holdemlouis1: posts the ante 210
santiga: posts the ante 210
Bxutu_: posts the ante 210
k8ldykbala: posts the ante 210
Priitk: posts the ante 210
zKiPiSHz: posts the ante 210
Toxa_Karol’: posts small blind 700
holdemlouis1: posts big blind 1400
*** HOLE CARDS ***
santiga: folds 
Bxutu_: raises 1610 to 3010
k8ldykbala: folds 
Priitk: folds 
zKiPiSHz: folds 
Toxa_Karol’: folds 
holdemlouis1: folds 
Uncalled bet (1610) returned to Bxutu_
Bxutu_ collected 4970 from pot
Bxutu_: doesn't show hand 
*** SUMMARY ***
Total pot 4970 | Rake 0 
Seat 1: Toxa_Karol’ (small blind) folded before Flop
Seat 2: holdemlouis1 (big blind) folded before Flop
Seat 3: santiga folded before Flop (didn't bet)
Seat 4: Bxutu_ collected (4970)
Seat 5: k8ldykbala folded before Flop (didn't bet)
Seat 7: Priitk folded before Flop (didn't bet)
Seat 8: zKiPiSHz (button) folded before Flop (didn't bet)

PokerStars Hand #250528068182: Tournament #3754315429, $20+$20+$4 USD Hold'em No Limit - Level XXIII (700/1400) - 2024/05/16 12:53:40 UTC [2024/05/16 8:53:40 ET]
Table '3754315429 3' 8-max Seat #1 is the button
Seat 1: Toxa_Karol’ (76332 in chips, $165 bounty) 
Seat 2: holdemlouis1 (26753 in chips, $57.50 bounty) 
Seat 3: santiga (33085 in chips, $60 bounty) 
Seat 4: Bxutu_ (51251 in chips, $92.50 bounty) 
Seat 5: k8ldykbala (21616 in chips, $80 bounty) 
Seat 7: Priitk (19444 in chips, $55 bounty) 
Seat 8: zKiPiSHz (37178 in chips, $85 bounty) 
Toxa_Karol’: posts the ante 210
holdemlouis1: posts the ante 210
santiga: posts the ante 210
Bxutu_: posts the ante 210
k8ldykbala: posts the ante 210
Priitk: posts the ante 210
zKiPiSHz: posts the ante 210
holdemlouis1: posts small blind 700
santiga: posts big blind 1400
*** HOLE CARDS ***
Bxutu_: folds 
k8ldykbala: folds 
Priitk: folds 
zKiPiSHz: folds 
Toxa_Karol’: raises 1400 to 2800
holdemlouis1: folds 
santiga: raises 7000 to 9800
Toxa_Karol’: folds 
Uncalled bet (7000) returned to santiga
santiga collected 7770 from pot
santiga: doesn't show hand 
*** SUMMARY ***
Total pot 7770 | Rake 0 
Seat 1: Toxa_Karol’ (button) folded before Flop
Seat 2: holdemlouis1 (small blind) folded before Flop
Seat 3: santiga (big blind) collected (7770)
Seat 4: Bxutu_ folded before Flop (didn't bet)
Seat 5: k8ldykbala folded before Flop (didn't bet)
Seat 7: Priitk folded before Flop (didn't bet)
Seat 8: zKiPiSHz folded before Flop (didn't bet)

PokerStars Hand #250528068182: Tournament #3754315429, $20+$20+$4 USD Hold'em No Limit - Level XXIII (700/1400) - 2024/05/16 12:53:40 UTC [2024/05/16 8:53:40 ET]
Table '3754315429 3' 8-max Seat #1 is the button
Seat 1: Toxa_Karol’ (76332 in chips, $165 bounty) 
Seat 2: holdemlouis1 (26753 in chips, $57.50 bounty) 
Seat 3: santiga (33085 in chips, $60 bounty) 
Seat 4: Bxutu_ (51251 in chips, $92.50 bounty) 
Seat 5: k8ldykbala (21616 in chips, $80 bounty) 
Seat 7: Priitk (19444 in chips, $55 bounty) 
Seat 8: zKiPiSHz (37178 in chips, $85 bounty) 
Toxa_Karol’: posts the ante 210
holdemlouis1: posts the ante 210
santiga: posts the ante 210
Bxutu_: posts the ante 210
k8ldykbala: posts the ante 210
Priitk: posts the ante 210
zKiPiSHz: posts the ante 210
holdemlouis1: posts small blind 700
santiga: posts big blind 1400
*** HOLE CARDS ***
Bxutu_: folds 
k8ldykbala: folds 
Priitk: folds 
zKiPiSHz: folds 
Toxa_Karol’: raises 1400 to 2800
holdemlouis1: folds 
santiga: raises 7000 to 9800
Toxa_Karol’: folds 
Uncalled bet (7000) returned to santiga
santiga collected 7770 from pot
santiga: doesn't show hand 
*** SUMMARY ***
Total pot 7770 | Rake 0 
Seat 1: Toxa_Karol’ (button) folded before Flop
Seat 2: holdemlouis1 (small blind) folded before Flop
Seat 3: santiga (big blind) collected (7770)
Seat 4: Bxutu_ folded before Flop (didn't bet)
Seat 5: k8ldykbala folded before Flop (didn't bet)
Seat 7: Priitk folded before Flop (didn't bet)
Seat 8: zKiPiSHz folded before Flop (didn't bet)

PokerStars Hand #250528076528: Tournament #3754315429, $20+$20+$4 USD Hold'em No Limit - Level XXIV (800/1600) - 2024/05/16 12:54:28 UTC [2024/05/16 8:54:28 ET]
Table '3754315429 3' 8-max Seat #2 is the button
Seat 1: Toxa_Karol’ (73322 in chips, $165 bounty) 
Seat 2: holdemlouis1 (25843 in chips, $57.50 bounty) 
Seat 3: santiga (37845 in chips, $60 bounty) 
Seat 4: Bxutu_ (51041 in chips, $92.50 bounty) 
Seat 5: k8ldykbala (21406 in chips, $80 bounty) 
Seat 7: Priitk (19234 in chips, $55 bounty) 
Seat 8: zKiPiSHz (36968 in chips, $85 bounty) 
Toxa_Karol’: posts the ante 240
holdemlouis1: posts the ante 240
santiga: posts the ante 240
Bxutu_: posts the ante 240
k8ldykbala: posts the ante 240
Priitk: posts the ante 240
zKiPiSHz: posts the ante 240
santiga: posts small blind 800
Bxutu_: posts big blind 1600
*** HOLE CARDS ***
k8ldykbala: folds 
Priitk: folds 
zKiPiSHz: folds 
Toxa_Karol’: folds 
holdemlouis1: raises 22400 to 24000
santiga: folds 
Bxutu_: folds 
Uncalled bet (22400) returned to holdemlouis1
holdemlouis1 collected 5680 from pot
*** SUMMARY ***
Total pot 5680 | Rake 0 
Seat 1: Toxa_Karol’ folded before Flop (didn't bet)
Seat 2: holdemlouis1 (button) collected (5680)
Seat 3: santiga (small blind) folded before Flop
Seat 4: Bxutu_ (big blind) folded before Flop
Seat 5: k8ldykbala folded before Flop (didn't bet)
Seat 7: Priitk folded before Flop (didn't bet)
Seat 8: zKiPiSHz folded before Flop (didn't bet)

PokerStars Hand #250528076528: Tournament #3754315429, $20+$20+$4 USD Hold'em No Limit - Level XXIV (800/1600) - 2024/05/16 12:54:28 UTC [2024/05/16 8:54:28 ET]
Table '3754315429 3' 8-max Seat #2 is the button
Seat 1: Toxa_Karol’ (73322 in chips, $165 bounty) 
Seat 2: holdemlouis1 (25843 in chips, $57.50 bounty) 
Seat 3: santiga (37845 in chips, $60 bounty) 
Seat 4: Bxutu_ (51041 in chips, $92.50 bounty) 
Seat 5: k8ldykbala (21406 in chips, $80 bounty) 
Seat 7: Priitk (19234 in chips, $55 bounty) 
Seat 8: zKiPiSHz (36968 in chips, $85 bounty) 
Toxa_Karol’: posts the ante 240
holdemlouis1: posts the ante 240
santiga: posts the ante 240
Bxutu_: posts the ante 240
k8ldykbala: posts the ante 240
Priitk: posts the ante 240
zKiPiSHz: posts the ante 240
santiga: posts small blind 800
Bxutu_: posts big blind 1600
*** HOLE CARDS ***
k8ldykbala: folds 
Priitk: folds 
zKiPiSHz: folds 
Toxa_Karol’: folds 
holdemlouis1: raises 22400 to 24000
santiga: folds 
Bxutu_: folds 
Uncalled bet (22400) returned to holdemlouis1
holdemlouis1 collected 5680 from pot
*** SUMMARY ***
Total pot 5680 | Rake 0 
Seat 1: Toxa_Karol’ folded before Flop (didn't bet)
Seat 2: holdemlouis1 (button) collected (5680)
Seat 3: santiga (small blind) folded before Flop
Seat 4: Bxutu_ (big blind) folded before Flop
Seat 5: k8ldykbala folded before Flop (didn't bet)
Seat 7: Priitk folded before Flop (didn't bet)
Seat 8: zKiPiSHz folded before Flop (didn't bet)

PokerStars Hand #250528081136: Tournament #3754315429, $20+$20+$4 USD Hold'em No Limit - Level XXIV (800/1600) - 2024/05/16 12:54:54 UTC [2024/05/16 8:54:54 ET]
Table '3754315429 3' 8-max Seat #3 is the button
Seat 2: holdemlouis1 (29683 in chips, $57.50 bounty) 
Seat 3: santiga (36805 in chips, $60 bounty) 
Seat 4: Bxutu_ (49201 in chips, $92.50 bounty) 
Seat 5: k8ldykbala (21166 in chips, $80 bounty) 
Seat 7: Priitk (18994 in chips, $55 bounty) 
Seat 8: zKiPiSHz (36728 in chips, $85 bounty) 
holdemlouis1: posts the ante 240
santiga: posts the ante 240
Bxutu_: posts the ante 240
k8ldykbala: posts the ante 240
Priitk: posts the ante 240
zKiPiSHz: posts the ante 240
Bxutu_: posts small blind 800
k8ldykbala: posts big blind 1600
*** HOLE CARDS ***
Priitk: folds 
zKiPiSHz: folds 
holdemlouis1: raises 1600 to 3200
santiga: folds 
Bxutu_: folds 
k8ldykbala: calls 1600
*** FLOP *** [Qs 7h 8c]
k8ldykbala: checks 
holdemlouis1: bets 2160
k8ldykbala: raises 2960 to 5120
holdemlouis1: folds 
Uncalled bet (2960) returned to k8ldykbala
k8ldykbala collected 12960 from pot
k8ldykbala: doesn't show hand 
*** SUMMARY ***
Total pot 12960 | Rake 0 
Board [Qs 7h 8c]
Seat 2: holdemlouis1 folded on the Flop
Seat 3: santiga (button) folded before Flop (didn't bet)
Seat 4: Bxutu_ (small blind) folded before Flop
Seat 5: k8ldykbala (big blind) collected (12960)
Seat 7: Priitk folded before Flop (didn't bet)
Seat 8: zKiPiSHz folded before Flop (didn't bet)

PokerStars Hand #250528081136: Tournament #3754315429, $20+$20+$4 USD Hold'em No Limit - Level XXIV (800/1600) - 2024/05/16 12:54:54 UTC [2024/05/16 8:54:54 ET]
Table '3754315429 3' 8-max Seat #3 is the button
Seat 2: holdemlouis1 (29683 in chips, $57.50 bounty) 
Seat 3: santiga (36805 in chips, $60 bounty) 
Seat 4: Bxutu_ (49201 in chips, $92.50 bounty) 
Seat 5: k8ldykbala (21166 in chips, $80 bounty) 
Seat 7: Priitk (18994 in chips, $55 bounty) 
Seat 8: zKiPiSHz (36728 in chips, $85 bounty) 
holdemlouis1: posts the ante 240
santiga: posts the ante 240
Bxutu_: posts the ante 240
k8ldykbala: posts the ante 240
Priitk: posts the ante 240
zKiPiSHz: posts the ante 240
Bxutu_: posts small blind 800
k8ldykbala: posts big blind 1600
*** HOLE CARDS ***
Priitk: folds 
zKiPiSHz: folds 
holdemlouis1: raises 1600 to 3200
santiga: folds 
Bxutu_: folds 
k8ldykbala: calls 1600
*** FLOP *** [Qs 7h 8c]
k8ldykbala: checks 
holdemlouis1: bets 2160
k8ldykbala: raises 2960 to 5120
holdemlouis1: folds 
Uncalled bet (2960) returned to k8ldykbala
k8ldykbala collected 12960 from pot
k8ldykbala: doesn't show hand 
*** SUMMARY ***
Total pot 12960 | Rake 0 
Board [Qs 7h 8c]
Seat 2: holdemlouis1 folded on the Flop
Seat 3: santiga (button) folded before Flop (didn't bet)
Seat 4: Bxutu_ (small blind) folded before Flop
Seat 5: k8ldykbala (big blind) collected (12960)
Seat 7: Priitk folded before Flop (didn't bet)
Seat 8: zKiPiSHz folded before Flop (didn't bet)

PokerStars Hand #250528137117: Tournament #3754315429, $20+$20+$4 USD Hold'em No Limit - Level XXIV (800/1600) - 2024/05/16 13:01:13 UTC [2024/05/16 9:01:13 ET]
Table '3754315429 3' 8-max Seat #4 is the button
Seat 2: holdemlouis1 (24083 in chips, $57.50 bounty) 
Seat 3: santiga (36565 in chips, $60 bounty) 
Seat 4: Bxutu_ (48161 in chips, $92.50 bounty) 
Seat 5: k8ldykbala (28526 in chips, $80 bounty) 
Seat 7: Priitk (18754 in chips, $55 bounty) 
Seat 8: zKiPiSHz (36488 in chips, $85 bounty) 
holdemlouis1: posts the ante 240
santiga: posts the ante 240
Bxutu_: posts the ante 240
k8ldykbala: posts the ante 240
Priitk: posts the ante 240
zKiPiSHz: posts the ante 240
k8ldykbala: posts small blind 800
Priitk: posts big blind 1600
*** HOLE CARDS ***
zKiPiSHz: folds 
holdemlouis1: folds 
santiga: folds 
Bxutu_: raises 1840 to 3440
k8ldykbala: folds 
Priitk: folds 
Uncalled bet (1840) returned to Bxutu_
Bxutu_ collected 5440 from pot
Bxutu_: doesn't show hand 
*** SUMMARY ***
Total pot 5440 | Rake 0 
Seat 2: holdemlouis1 folded before Flop (didn't bet)
Seat 3: santiga folded before Flop (didn't bet)
Seat 4: Bxutu_ (button) collected (5440)
Seat 5: k8ldykbala (small blind) folded before Flop
Seat 7: Priitk (big blind) folded before Flop
Seat 8: zKiPiSHz folded before Flop (didn't bet)

PokerStars Hand #250528137117: Tournament #3754315429, $20+$20+$4 USD Hold'em No Limit - Level XXIV (800/1600) - 2024/05/16 13:01:13 UTC [2024/05/16 9:01:13 ET]
Table '3754315429 3' 8-max Seat #4 is the button
Seat 2: holdemlouis1 (24083 in chips, $57.50 bounty) 
Seat 3: santiga (36565 in chips, $60 bounty) 
Seat 4: Bxutu_ (48161 in chips, $92.50 bounty) 
Seat 5: k8ldykbala (28526 in chips, $80 bounty) 
Seat 7: Priitk (18754 in chips, $55 bounty) 
Seat 8: zKiPiSHz (36488 in chips, $85 bounty) 
holdemlouis1: posts the ante 240
santiga: posts the ante 240
Bxutu_: posts the ante 240
k8ldykbala: posts the ante 240
Priitk: posts the ante 240
zKiPiSHz: posts the ante 240
k8ldykbala: posts small blind 800
Priitk: posts big blind 1600
*** HOLE CARDS ***
zKiPiSHz: folds 
holdemlouis1: folds 
santiga: folds 
Bxutu_: raises 1840 to 3440
k8ldykbala: folds 
Priitk: folds 
Uncalled bet (1840) returned to Bxutu_
Bxutu_ collected 5440 from pot
Bxutu_: doesn't show hand 
*** SUMMARY ***
Total pot 5440 | Rake 0 
Seat 2: holdemlouis1 folded before Flop (didn't bet)
Seat 3: santiga folded before Flop (didn't bet)
Seat 4: Bxutu_ (button) collected (5440)
Seat 5: k8ldykbala (small blind) folded before Flop
Seat 7: Priitk (big blind) folded before Flop
Seat 8: zKiPiSHz folded before Flop (didn't bet)

PokerStars Hand #250528145712: Tournament #3754315429, $20+$20+$4 USD Hold'em No Limit - Level XXIV (800/1600) - 2024/05/16 13:02:04 UTC [2024/05/16 9:02:04 ET]
Table '3754315429 3' 8-max Seat #5 is the button
Seat 2: holdemlouis1 (23843 in chips, $57.50 bounty) 
Seat 3: santiga (36325 in chips, $60 bounty) 
Seat 4: Bxutu_ (51761 in chips, $92.50 bounty) 
Seat 5: k8ldykbala (27486 in chips, $80 bounty) 
Seat 7: Priitk (16914 in chips, $55 bounty) 
Seat 8: zKiPiSHz (36248 in chips, $85 bounty) 
holdemlouis1: posts the ante 240
santiga: posts the ante 240
Bxutu_: posts the ante 240
k8ldykbala: posts the ante 240
Priitk: posts the ante 240
zKiPiSHz: posts the ante 240
Priitk: posts small blind 800
zKiPiSHz: posts big blind 1600
*** HOLE CARDS ***
holdemlouis1: folds 
santiga: folds 
Bxutu_: folds 
k8ldykbala: folds 
Priitk: folds 
Uncalled bet (800) returned to zKiPiSHz
zKiPiSHz collected 3040 from pot
zKiPiSHz: doesn't show hand 
*** SUMMARY ***
Total pot 3040 | Rake 0 
Seat 2: holdemlouis1 folded before Flop (didn't bet)
Seat 3: santiga folded before Flop (didn't bet)
Seat 4: Bxutu_ folded before Flop (didn't bet)
Seat 5: k8ldykbala (button) folded before Flop (didn't bet)
Seat 7: Priitk (small blind) folded before Flop
Seat 8: zKiPiSHz (big blind) collected (3040)

PokerStars Hand #250528145712: Tournament #3754315429, $20+$20+$4 USD Hold'em No Limit - Level XXIV (800/1600) - 2024/05/16 13:02:04 UTC [2024/05/16 9:02:04 ET]
Table '3754315429 3' 8-max Seat #5 is the button
Seat 2: holdemlouis1 (23843 in chips, $57.50 bounty) 
Seat 3: santiga (36325 in chips, $60 bounty) 
Seat 4: Bxutu_ (51761 in chips, $92.50 bounty) 
Seat 5: k8ldykbala (27486 in chips, $80 bounty) 
Seat 7: Priitk (16914 in chips, $55 bounty) 
Seat 8: zKiPiSHz (36248 in chips, $85 bounty) 
holdemlouis1: posts the ante 240
santiga: posts the ante 240
Bxutu_: posts the ante 240
k8ldykbala: posts the ante 240
Priitk: posts the ante 240
zKiPiSHz: posts the ante 240
Priitk: posts small blind 800
zKiPiSHz: posts big blind 1600
*** HOLE CARDS ***
holdemlouis1: folds 
santiga: folds 
Bxutu_: folds 
k8ldykbala: folds 
Priitk: folds 
Uncalled bet (800) returned to zKiPiSHz
zKiPiSHz collected 3040 from pot
zKiPiSHz: doesn't show hand 
*** SUMMARY ***
Total pot 3040 | Rake 0 
Seat 2: holdemlouis1 folded before Flop (didn't bet)
Seat 3: santiga folded before Flop (didn't bet)
Seat 4: Bxutu_ folded before Flop (didn't bet)
Seat 5: k8ldykbala (button) folded before Flop (didn't bet)
Seat 7: Priitk (small blind) folded before Flop
Seat 8: zKiPiSHz (big blind) collected (3040)

PokerStars Hand #250528148565: Tournament #3754315429, $20+$20+$4 USD Hold'em No Limit - Level XXIV (800/1600) - 2024/05/16 13:02:20 UTC [2024/05/16 9:02:20 ET]
Table '3754315429 3' 8-max Seat #7 is the button
Seat 2: holdemlouis1 (23603 in chips, $57.50 bounty) 
Seat 3: santiga (36085 in chips, $60 bounty) 
Seat 4: Bxutu_ (51521 in chips, $92.50 bounty) 
Seat 5: k8ldykbala (27246 in chips, $80 bounty) 
Seat 7: Priitk (15874 in chips, $55 bounty) 
Seat 8: zKiPiSHz (38248 in chips, $85 bounty) 
holdemlouis1: posts the ante 240
santiga: posts the ante 240
Bxutu_: posts the ante 240
k8ldykbala: posts the ante 240
Priitk: posts the ante 240
zKiPiSHz: posts the ante 240
zKiPiSHz: posts small blind 800
holdemlouis1: posts big blind 1600
*** HOLE CARDS ***
santiga: folds 
Bxutu_: raises 1840 to 3440
k8ldykbala: folds 
Priitk: folds 
zKiPiSHz: folds 
holdemlouis1: folds 
Uncalled bet (1840) returned to Bxutu_
Bxutu_ collected 5440 from pot
Bxutu_: doesn't show hand 
*** SUMMARY ***
Total pot 5440 | Rake 0 
Seat 2: holdemlouis1 (big blind) folded before Flop
Seat 3: santiga folded before Flop (didn't bet)
Seat 4: Bxutu_ collected (5440)
Seat 5: k8ldykbala folded before Flop (didn't bet)
Seat 7: Priitk (button) folded before Flop (didn't bet)
Seat 8: zKiPiSHz (small blind) folded before Flop

PokerStars Hand #250528148565: Tournament #3754315429, $20+$20+$4 USD Hold'em No Limit - Level XXIV (800/1600) - 2024/05/16 13:02:20 UTC [2024/05/16 9:02:20 ET]
Table '3754315429 3' 8-max Seat #7 is the button
Seat 2: holdemlouis1 (23603 in chips, $57.50 bounty) 
Seat 3: santiga (36085 in chips, $60 bounty) 
Seat 4: Bxutu_ (51521 in chips, $92.50 bounty) 
Seat 5: k8ldykbala (27246 in chips, $80 bounty) 
Seat 7: Priitk (15874 in chips, $55 bounty) 
Seat 8: zKiPiSHz (38248 in chips, $85 bounty) 
holdemlouis1: posts the ante 240
santiga: posts the ante 240
Bxutu_: posts the ante 240
k8ldykbala: posts the ante 240
Priitk: posts the ante 240
zKiPiSHz: posts the ante 240
zKiPiSHz: posts small blind 800
holdemlouis1: posts big blind 1600
*** HOLE CARDS ***
santiga: folds 
Bxutu_: raises 1840 to 3440
k8ldykbala: folds 
Priitk: folds 
zKiPiSHz: folds 
holdemlouis1: folds 
Uncalled bet (1840) returned to Bxutu_
Bxutu_ collected 5440 from pot
Bxutu_: doesn't show hand 
*** SUMMARY ***
Total pot 5440 | Rake 0 
Seat 2: holdemlouis1 (big blind) folded before Flop
Seat 3: santiga folded before Flop (didn't bet)
Seat 4: Bxutu_ collected (5440)
Seat 5: k8ldykbala folded before Flop (didn't bet)
Seat 7: Priitk (button) folded before Flop (didn't bet)
Seat 8: zKiPiSHz (small blind) folded before Flop

PokerStars Hand #250528152203: Tournament #3754315429, $20+$20+$4 USD Hold'em No Limit - Level XXIV (800/1600) - 2024/05/16 13:02:41 UTC [2024/05/16 9:02:41 ET]
Table '3754315429 3' 8-max Seat #8 is the button
Seat 2: holdemlouis1 (21763 in chips, $57.50 bounty) 
Seat 3: santiga (35845 in chips, $60 bounty) 
Seat 4: Bxutu_ (55121 in chips, $92.50 bounty) 
Seat 5: k8ldykbala (27006 in chips, $80 bounty) 
Seat 7: Priitk (15634 in chips, $55 bounty) 
Seat 8: zKiPiSHz (37208 in chips, $85 bounty) 
holdemlouis1: posts the ante 240
santiga: posts the ante 240
Bxutu_: posts the ante 240
k8ldykbala: posts the ante 240
Priitk: posts the ante 240
zKiPiSHz: posts the ante 240
holdemlouis1: posts small blind 800
santiga: posts big blind 1600
*** HOLE CARDS ***
Bxutu_: raises 1840 to 3440
k8ldykbala: folds 
Priitk: folds 
zKiPiSHz: folds 
holdemlouis1: folds 
santiga: folds 
Uncalled bet (1840) returned to Bxutu_
Bxutu_ collected 5440 from pot
Bxutu_: doesn't show hand 
*** SUMMARY ***
Total pot 5440 | Rake 0 
Seat 2: holdemlouis1 (small blind) folded before Flop
Seat 3: santiga (big blind) folded before Flop
Seat 4: Bxutu_ collected (5440)
Seat 5: k8ldykbala folded before Flop (didn't bet)
Seat 7: Priitk folded before Flop (didn't bet)
Seat 8: zKiPiSHz (button) folded before Flop (didn't bet)

PokerStars Hand #250528152203: Tournament #3754315429, $20+$20+$4 USD Hold'em No Limit - Level XXIV (800/1600) - 2024/05/16 13:02:41 UTC [2024/05/16 9:02:41 ET]
Table '3754315429 3' 8-max Seat #8 is the button
Seat 2: holdemlouis1 (21763 in chips, $57.50 bounty) 
Seat 3: santiga (35845 in chips, $60 bounty) 
Seat 4: Bxutu_ (55121 in chips, $92.50 bounty) 
Seat 5: k8ldykbala (27006 in chips, $80 bounty) 
Seat 7: Priitk (15634 in chips, $55 bounty) 
Seat 8: zKiPiSHz (37208 in chips, $85 bounty) 
holdemlouis1: posts the ante 240
santiga: posts the ante 240
Bxutu_: posts the ante 240
k8ldykbala: posts the ante 240
Priitk: posts the ante 240
zKiPiSHz: posts the ante 240
holdemlouis1: posts small blind 800
santiga: posts big blind 1600
*** HOLE CARDS ***
Bxutu_: raises 1840 to 3440
k8ldykbala: folds 
Priitk: folds 
zKiPiSHz: folds 
holdemlouis1: folds 
santiga: folds 
Uncalled bet (1840) returned to Bxutu_
Bxutu_ collected 5440 from pot
Bxutu_: doesn't show hand 
*** SUMMARY ***
Total pot 5440 | Rake 0 
Seat 2: holdemlouis1 (small blind) folded before Flop
Seat 3: santiga (big blind) folded before Flop
Seat 4: Bxutu_ collected (5440)
Seat 5: k8ldykbala folded before Flop (didn't bet)
Seat 7: Priitk folded before Flop (didn't bet)
Seat 8: zKiPiSHz (button) folded before Flop (didn't bet)

PokerStars Hand #250528157248: Tournament #3754315429, $20+$20+$4 USD Hold'em No Limit - Level XXIV (800/1600) - 2024/05/16 13:03:09 UTC [2024/05/16 9:03:09 ET]
Table '3754315429 3' 8-max Seat #2 is the button
Seat 2: holdemlouis1 (20723 in chips, $57.50 bounty) 
Seat 3: santiga (34005 in chips, $60 bounty) 
Seat 4: Bxutu_ (58721 in chips, $92.50 bounty) 
Seat 5: k8ldykbala (26766 in chips, $80 bounty) 
Seat 7: Priitk (15394 in chips, $55 bounty) 
Seat 8: zKiPiSHz (36968 in chips, $85 bounty) 
holdemlouis1: posts the ante 240
santiga: posts the ante 240
Bxutu_: posts the ante 240
k8ldykbala: posts the ante 240
Priitk: posts the ante 240
zKiPiSHz: posts the ante 240
santiga: posts small blind 800
Bxutu_: posts big blind 1600
*** HOLE CARDS ***
k8ldykbala: folds 
Priitk: folds 
zKiPiSHz: folds 
holdemlouis1: folds 
santiga: calls 800
Bxutu_: checks 
*** FLOP *** [2s 9s As]
santiga: bets 1600
Bxutu_: calls 1600
*** TURN *** [2s 9s As] [8d]
santiga: checks 
Bxutu_: bets 3200
santiga: folds 
Uncalled bet (3200) returned to Bxutu_
Bxutu_ collected 7840 from pot
Bxutu_: doesn't show hand 
*** SUMMARY ***
Total pot 7840 | Rake 0 
Board [2s 9s As 8d]
Seat 2: holdemlouis1 (button) folded before Flop (didn't bet)
Seat 3: santiga (small blind) folded on the Turn
Seat 4: Bxutu_ (big blind) collected (7840)
Seat 5: k8ldykbala folded before Flop (didn't bet)
Seat 7: Priitk folded before Flop (didn't bet)
Seat 8: zKiPiSHz folded before Flop (didn't bet)

PokerStars Hand #250528157248: Tournament #3754315429, $20+$20+$4 USD Hold'em No Limit - Level XXIV (800/1600) - 2024/05/16 13:03:09 UTC [2024/05/16 9:03:09 ET]
Table '3754315429 3' 8-max Seat #2 is the button
Seat 2: holdemlouis1 (20723 in chips, $57.50 bounty) 
Seat 3: santiga (34005 in chips, $60 bounty) 
Seat 4: Bxutu_ (58721 in chips, $92.50 bounty) 
Seat 5: k8ldykbala (26766 in chips, $80 bounty) 
Seat 7: Priitk (15394 in chips, $55 bounty) 
Seat 8: zKiPiSHz (36968 in chips, $85 bounty) 
holdemlouis1: posts the ante 240
santiga: posts the ante 240
Bxutu_: posts the ante 240
k8ldykbala: posts the ante 240
Priitk: posts the ante 240
zKiPiSHz: posts the ante 240
santiga: posts small blind 800
Bxutu_: posts big blind 1600
*** HOLE CARDS ***
k8ldykbala: folds 
Priitk: folds 
zKiPiSHz: folds 
holdemlouis1: folds 
santiga: calls 800
Bxutu_: checks 
*** FLOP *** [2s 9s As]
santiga: bets 1600
Bxutu_: calls 1600
*** TURN *** [2s 9s As] [8d]
santiga: checks 
Bxutu_: bets 3200
santiga: folds 
Uncalled bet (3200) returned to Bxutu_
Bxutu_ collected 7840 from pot
Bxutu_: doesn't show hand 
*** SUMMARY ***
Total pot 7840 | Rake 0 
Board [2s 9s As 8d]
Seat 2: holdemlouis1 (button) folded before Flop (didn't bet)
Seat 3: santiga (small blind) folded on the Turn
Seat 4: Bxutu_ (big blind) collected (7840)
Seat 5: k8ldykbala folded before Flop (didn't bet)
Seat 7: Priitk folded before Flop (didn't bet)
Seat 8: zKiPiSHz folded before Flop (didn't bet)

PokerStars Hand #250528163928: Tournament #3754315429, $20+$20+$4 USD Hold'em No Limit - Level XXIV (800/1600) - 2024/05/16 13:03:47 UTC [2024/05/16 9:03:47 ET]
Table '3754315429 3' 8-max Seat #3 is the button
Seat 2: holdemlouis1 (20483 in chips, $57.50 bounty) 
Seat 3: santiga (30565 in chips, $60 bounty) 
Seat 4: Bxutu_ (63121 in chips, $92.50 bounty) 
Seat 5: k8ldykbala (26526 in chips, $80 bounty) 
Seat 7: Priitk (15154 in chips, $55 bounty) 
Seat 8: zKiPiSHz (36728 in chips, $85 bounty) 
holdemlouis1: posts the ante 240
santiga: posts the ante 240
Bxutu_: posts the ante 240
k8ldykbala: posts the ante 240
Priitk: posts the ante 240
zKiPiSHz: posts the ante 240
Bxutu_: posts small blind 800
k8ldykbala: posts big blind 1600
*** HOLE CARDS ***
Priitk: raises 13314 to 14914 and is all-in
zKiPiSHz: raises 21574 to 36488 and is all-in
holdemlouis1: folds 
santiga: folds 
Bxutu_: folds 
k8ldykbala: folds 
Uncalled bet (21574) returned to zKiPiSHz
*** FLOP *** [3d Jd 7c]
*** TURN *** [3d Jd 7c] [As]
*** RIVER *** [3d Jd 7c As] [4h]
*** SHOW DOWN ***
Priitk: shows [Kd Jh] (a pair of Jacks)
zKiPiSHz: shows [Js Ac] (two pair, Aces and Jacks)
zKiPiSHz collected 33668 from pot
zKiPiSHz wins $27.50 for eliminating Priitk and their own bounty increases by $27.50 to $112.50
Priitk finished the tournament in 19th place and received $43.42.
koluvan333 is disconnected 
*** SUMMARY ***
Total pot 33668 | Rake 0 
Board [3d Jd 7c As 4h]
Seat 2: holdemlouis1 folded before Flop (didn't bet)
Seat 3: santiga (button) folded before Flop (didn't bet)
Seat 4: Bxutu_ (small blind) folded before Flop
Seat 5: k8ldykbala (big blind) folded before Flop
Seat 7: Priitk showed [Kd Jh] and lost with a pair of Jacks
Seat 8: zKiPiSHz showed [Js Ac] and won (33668) with two pair, Aces and Jacks

PokerStars Hand #250528163928: Tournament #3754315429, $20+$20+$4 USD Hold'em No Limit - Level XXIV (800/1600) - 2024/05/16 13:03:47 UTC [2024/05/16 9:03:47 ET]
Table '3754315429 3' 8-max Seat #3 is the button
Seat 2: holdemlouis1 (20483 in chips, $57.50 bounty) 
Seat 3: santiga (30565 in chips, $60 bounty) 
Seat 4: Bxutu_ (63121 in chips, $92.50 bounty) 
Seat 5: k8ldykbala (26526 in chips, $80 bounty) 
Seat 7: Priitk (15154 in chips, $55 bounty) 
Seat 8: zKiPiSHz (36728 in chips, $85 bounty) 
holdemlouis1: posts the ante 240
santiga: posts the ante 240
Bxutu_: posts the ante 240
k8ldykbala: posts the ante 240
Priitk: posts the ante 240
zKiPiSHz: posts the ante 240
Bxutu_: posts small blind 800
k8ldykbala: posts big blind 1600
*** HOLE CARDS ***
Priitk: raises 13314 to 14914 and is all-in
zKiPiSHz: raises 21574 to 36488 and is all-in
holdemlouis1: folds 
santiga: folds 
Bxutu_: folds 
k8ldykbala: folds 
Uncalled bet (21574) returned to zKiPiSHz
*** FLOP *** [3d Jd 7c]
*** TURN *** [3d Jd 7c] [As]
*** RIVER *** [3d Jd 7c As] [4h]
*** SHOW DOWN ***
Priitk: shows [Kd Jh] (a pair of Jacks)
zKiPiSHz: shows [Js Ac] (two pair, Aces and Jacks)
zKiPiSHz collected 33668 from pot
zKiPiSHz wins $27.50 for eliminating Priitk and their own bounty increases by $27.50 to $112.50
Priitk finished the tournament in 19th place and received $43.42.
koluvan333 is disconnected 
*** SUMMARY ***
Total pot 33668 | Rake 0 
Board [3d Jd 7c As 4h]
Seat 2: holdemlouis1 folded before Flop (didn't bet)
Seat 3: santiga (button) folded before Flop (didn't bet)
Seat 4: Bxutu_ (small blind) folded before Flop
Seat 5: k8ldykbala (big blind) folded before Flop
Seat 7: Priitk showed [Kd Jh] and lost with a pair of Jacks
Seat 8: zKiPiSHz showed [Js Ac] and won (33668) with two pair, Aces and Jacks

PokerStars Hand #250528169549: Tournament #3754315429, $20+$20+$4 USD Hold'em No Limit - Level XXIV (800/1600) - 2024/05/16 13:04:19 UTC [2024/05/16 9:04:19 ET]
Table '3754315429 3' 8-max Seat #4 is the button
Seat 1: koluvan333 (10207 in chips, $85 bounty) 
Seat 2: holdemlouis1 (20243 in chips, $57.50 bounty) 
Seat 3: santiga (30325 in chips, $60 bounty) 
Seat 4: Bxutu_ (62081 in chips, $92.50 bounty) 
Seat 5: k8ldykbala (24686 in chips, $80 bounty) 
Seat 8: zKiPiSHz (55242 in chips, $112.50 bounty) 
koluvan333: posts the ante 240
holdemlouis1: posts the ante 240
santiga: posts the ante 240
Bxutu_: posts the ante 240
k8ldykbala: posts the ante 240
zKiPiSHz: posts the ante 240
k8ldykbala: posts small blind 800
zKiPiSHz: posts big blind 1600
*** HOLE CARDS ***
koluvan333: folds 
holdemlouis1: folds 
santiga: raises 2240 to 3840
Bxutu_: folds 
k8ldykbala: raises 20606 to 24446 and is all-in
zKiPiSHz: folds 
santiga: folds 
Uncalled bet (20606) returned to k8ldykbala
k8ldykbala collected 10720 from pot
k8ldykbala: doesn't show hand 
*** SUMMARY ***
Total pot 10720 | Rake 0 
Seat 1: koluvan333 folded before Flop (didn't bet)
Seat 2: holdemlouis1 folded before Flop (didn't bet)
Seat 3: santiga folded before Flop
Seat 4: Bxutu_ (button) folded before Flop (didn't bet)
Seat 5: k8ldykbala (small blind) collected (10720)
Seat 8: zKiPiSHz (big blind) folded before Flop

PokerStars Hand #250528169549: Tournament #3754315429, $20+$20+$4 USD Hold'em No Limit - Level XXIV (800/1600) - 2024/05/16 13:04:19 UTC [2024/05/16 9:04:19 ET]
Table '3754315429 3' 8-max Seat #4 is the button
Seat 1: koluvan333 (10207 in chips, $85 bounty) 
Seat 2: holdemlouis1 (20243 in chips, $57.50 bounty) 
Seat 3: santiga (30325 in chips, $60 bounty) 
Seat 4: Bxutu_ (62081 in chips, $92.50 bounty) 
Seat 5: k8ldykbala (24686 in chips, $80 bounty) 
Seat 8: zKiPiSHz (55242 in chips, $112.50 bounty) 
koluvan333: posts the ante 240
holdemlouis1: posts the ante 240
santiga: posts the ante 240
Bxutu_: posts the ante 240
k8ldykbala: posts the ante 240
zKiPiSHz: posts the ante 240
k8ldykbala: posts small blind 800
zKiPiSHz: posts big blind 1600
*** HOLE CARDS ***
koluvan333: folds 
holdemlouis1: folds 
santiga: raises 2240 to 3840
Bxutu_: folds 
k8ldykbala: raises 20606 to 24446 and is all-in
zKiPiSHz: folds 
santiga: folds 
Uncalled bet (20606) returned to k8ldykbala
k8ldykbala collected 10720 from pot
k8ldykbala: doesn't show hand 
*** SUMMARY ***
Total pot 10720 | Rake 0 
Seat 1: koluvan333 folded before Flop (didn't bet)
Seat 2: holdemlouis1 folded before Flop (didn't bet)
Seat 3: santiga folded before Flop
Seat 4: Bxutu_ (button) folded before Flop (didn't bet)
Seat 5: k8ldykbala (small blind) collected (10720)
Seat 8: zKiPiSHz (big blind) folded before Flop

PokerStars Hand #250528175847: Tournament #3754315429, $20+$20+$4 USD Hold'em No Limit - Level XXIV (800/1600) - 2024/05/16 13:04:56 UTC [2024/05/16 9:04:56 ET]
Table '3754315429 3' 8-max Seat #5 is the button
Seat 1: koluvan333 (9967 in chips, $85 bounty) 
Seat 2: holdemlouis1 (20003 in chips, $57.50 bounty) 
Seat 3: santiga (26245 in chips, $60 bounty) 
Seat 4: Bxutu_ (61841 in chips, $92.50 bounty) 
Seat 5: k8ldykbala (31326 in chips, $80 bounty) 
Seat 8: zKiPiSHz (53402 in chips, $112.50 bounty) 
koluvan333: posts the ante 240
holdemlouis1: posts the ante 240
santiga: posts the ante 240
Bxutu_: posts the ante 240
k8ldykbala: posts the ante 240
zKiPiSHz: posts the ante 240
zKiPiSHz: posts small blind 800
koluvan333: posts big blind 1600
*** HOLE CARDS ***
holdemlouis1: folds 
santiga: raises 2240 to 3840
Bxutu_: folds 
k8ldykbala: folds 
zKiPiSHz: folds 
koluvan333: calls 2240
*** FLOP *** [5h Ts 7c]
koluvan333: checks 
santiga: bets 1600
koluvan333: calls 1600
*** TURN *** [5h Ts 7c] [Kc]
koluvan333: bets 4287 and is all-in
santiga: calls 4287
*** RIVER *** [5h Ts 7c Kc] [8h]
*** SHOW DOWN ***
koluvan333: shows [6d Kd] (a pair of Kings)
santiga: shows [Th Ks] (two pair, Kings and Tens)
santiga collected 21694 from pot
santiga wins $42.50 for eliminating koluvan333 and their own bounty increases by $42.50 to $102.50
koluvan333 finished the tournament in 18th place and received $43.42.
*** SUMMARY ***
Total pot 21694 | Rake 0 
Board [5h Ts 7c Kc 8h]
Seat 1: koluvan333 (big blind) showed [6d Kd] and lost with a pair of Kings
Seat 2: holdemlouis1 folded before Flop (didn't bet)
Seat 3: santiga showed [Th Ks] and won (21694) with two pair, Kings and Tens
Seat 4: Bxutu_ folded before Flop (didn't bet)
Seat 5: k8ldykbala (button) folded before Flop (didn't bet)
Seat 8: zKiPiSHz (small blind) folded before Flop

PokerStars Hand #250528175847: Tournament #3754315429, $20+$20+$4 USD Hold'em No Limit - Level XXIV (800/1600) - 2024/05/16 13:04:56 UTC [2024/05/16 9:04:56 ET]
Table '3754315429 3' 8-max Seat #5 is the button
Seat 1: koluvan333 (9967 in chips, $85 bounty) 
Seat 2: holdemlouis1 (20003 in chips, $57.50 bounty) 
Seat 3: santiga (26245 in chips, $60 bounty) 
Seat 4: Bxutu_ (61841 in chips, $92.50 bounty) 
Seat 5: k8ldykbala (31326 in chips, $80 bounty) 
Seat 8: zKiPiSHz (53402 in chips, $112.50 bounty) 
koluvan333: posts the ante 240
holdemlouis1: posts the ante 240
santiga: posts the ante 240
Bxutu_: posts the ante 240
k8ldykbala: posts the ante 240
zKiPiSHz: posts the ante 240
zKiPiSHz: posts small blind 800
koluvan333: posts big blind 1600
*** HOLE CARDS ***
holdemlouis1: folds 
santiga: raises 2240 to 3840
Bxutu_: folds 
k8ldykbala: folds 
zKiPiSHz: folds 
koluvan333: calls 2240
*** FLOP *** [5h Ts 7c]
koluvan333: checks 
santiga: bets 1600
koluvan333: calls 1600
*** TURN *** [5h Ts 7c] [Kc]
koluvan333: bets 4287 and is all-in
santiga: calls 4287
*** RIVER *** [5h Ts 7c Kc] [8h]
*** SHOW DOWN ***
koluvan333: shows [6d Kd] (a pair of Kings)
santiga: shows [Th Ks] (two pair, Kings and Tens)
santiga collected 21694 from pot
santiga wins $42.50 for eliminating koluvan333 and their own bounty increases by $42.50 to $102.50
koluvan333 finished the tournament in 18th place and received $43.42.
*** SUMMARY ***
Total pot 21694 | Rake 0 
Board [5h Ts 7c Kc 8h]
Seat 1: koluvan333 (big blind) showed [6d Kd] and lost with a pair of Kings
Seat 2: holdemlouis1 folded before Flop (didn't bet)
Seat 3: santiga showed [Th Ks] and won (21694) with two pair, Kings and Tens
Seat 4: Bxutu_ folded before Flop (didn't bet)
Seat 5: k8ldykbala (button) folded before Flop (didn't bet)
Seat 8: zKiPiSHz (small blind) folded before Flop

PokerStars Hand #250528183011: Tournament #3754315429, $20+$20+$4 USD Hold'em No Limit - Level XXIV (800/1600) - 2024/05/16 13:05:37 UTC [2024/05/16 9:05:37 ET]
Table '3754315429 3' 8-max Seat #8 is the button
Seat 2: holdemlouis1 (19763 in chips, $57.50 bounty) 
Seat 3: santiga (37972 in chips, $102.50 bounty) 
Seat 4: Bxutu_ (61601 in chips, $92.50 bounty) 
Seat 5: k8ldykbala (31086 in chips, $80 bounty) 
Seat 8: zKiPiSHz (52362 in chips, $112.50 bounty) 
holdemlouis1: posts the ante 240
santiga: posts the ante 240
Bxutu_: posts the ante 240
k8ldykbala: posts the ante 240
zKiPiSHz: posts the ante 240
holdemlouis1: posts small blind 800
santiga: posts big blind 1600
*** HOLE CARDS ***
Bxutu_: raises 1840 to 3440
k8ldykbala: folds 
zKiPiSHz: folds 
holdemlouis1: folds 
santiga: folds 
Uncalled bet (1840) returned to Bxutu_
Bxutu_ collected 5200 from pot
Bxutu_: doesn't show hand 
*** SUMMARY ***
Total pot 5200 | Rake 0 
Seat 2: holdemlouis1 (small blind) folded before Flop
Seat 3: santiga (big blind) folded before Flop
Seat 4: Bxutu_ collected (5200)
Seat 5: k8ldykbala folded before Flop (didn't bet)
Seat 8: zKiPiSHz (button) folded before Flop (didn't bet)

PokerStars Hand #250528183011: Tournament #3754315429, $20+$20+$4 USD Hold'em No Limit - Level XXIV (800/1600) - 2024/05/16 13:05:37 UTC [2024/05/16 9:05:37 ET]
Table '3754315429 3' 8-max Seat #8 is the button
Seat 2: holdemlouis1 (19763 in chips, $57.50 bounty) 
Seat 3: santiga (37972 in chips, $102.50 bounty) 
Seat 4: Bxutu_ (61601 in chips, $92.50 bounty) 
Seat 5: k8ldykbala (31086 in chips, $80 bounty) 
Seat 8: zKiPiSHz (52362 in chips, $112.50 bounty) 
holdemlouis1: posts the ante 240
santiga: posts the ante 240
Bxutu_: posts the ante 240
k8ldykbala: posts the ante 240
zKiPiSHz: posts the ante 240
holdemlouis1: posts small blind 800
santiga: posts big blind 1600
*** HOLE CARDS ***
Bxutu_: raises 1840 to 3440
k8ldykbala: folds 
zKiPiSHz: folds 
holdemlouis1: folds 
santiga: folds 
Uncalled bet (1840) returned to Bxutu_
Bxutu_ collected 5200 from pot
Bxutu_: doesn't show hand 
*** SUMMARY ***
Total pot 5200 | Rake 0 
Seat 2: holdemlouis1 (small blind) folded before Flop
Seat 3: santiga (big blind) folded before Flop
Seat 4: Bxutu_ collected (5200)
Seat 5: k8ldykbala folded before Flop (didn't bet)
Seat 8: zKiPiSHz (button) folded before Flop (didn't bet)

PokerStars Hand #250528188242: Tournament #3754315429, $20+$20+$4 USD Hold'em No Limit - Level XXIV (800/1600) - 2024/05/16 13:06:06 UTC [2024/05/16 9:06:06 ET]
Table '3754315429 3' 8-max Seat #2 is the button
Seat 2: holdemlouis1 (18723 in chips, $57.50 bounty) 
Seat 3: santiga (36132 in chips, $102.50 bounty) 
Seat 4: Bxutu_ (64961 in chips, $92.50 bounty) 
Seat 5: k8ldykbala (30846 in chips, $80 bounty) 
Seat 8: zKiPiSHz (52122 in chips, $112.50 bounty) 
holdemlouis1: posts the ante 240
santiga: posts the ante 240
Bxutu_: posts the ante 240
k8ldykbala: posts the ante 240
zKiPiSHz: posts the ante 240
santiga: posts small blind 800
Bxutu_: posts big blind 1600
*** HOLE CARDS ***
k8ldykbala: folds 
zKiPiSHz: folds 
holdemlouis1: folds 
santiga: calls 800
Bxutu_: raises 3900 to 5500
santiga: calls 3900
*** FLOP *** [6c 7s 6d]
santiga: checks 
Bxutu_: bets 8000
santiga: folds 
Uncalled bet (8000) returned to Bxutu_
Bxutu_ collected 12200 from pot
Bxutu_: doesn't show hand 
*** SUMMARY ***
Total pot 12200 | Rake 0 
Board [6c 7s 6d]
Seat 2: holdemlouis1 (button) folded before Flop (didn't bet)
Seat 3: santiga (small blind) folded on the Flop
Seat 4: Bxutu_ (big blind) collected (12200)
Seat 5: k8ldykbala folded before Flop (didn't bet)
Seat 8: zKiPiSHz folded before Flop (didn't bet)

PokerStars Hand #250528188242: Tournament #3754315429, $20+$20+$4 USD Hold'em No Limit - Level XXIV (800/1600) - 2024/05/16 13:06:06 UTC [2024/05/16 9:06:06 ET]
Table '3754315429 3' 8-max Seat #2 is the button
Seat 2: holdemlouis1 (18723 in chips, $57.50 bounty) 
Seat 3: santiga (36132 in chips, $102.50 bounty) 
Seat 4: Bxutu_ (64961 in chips, $92.50 bounty) 
Seat 5: k8ldykbala (30846 in chips, $80 bounty) 
Seat 8: zKiPiSHz (52122 in chips, $112.50 bounty) 
holdemlouis1: posts the ante 240
santiga: posts the ante 240
Bxutu_: posts the ante 240
k8ldykbala: posts the ante 240
zKiPiSHz: posts the ante 240
santiga: posts small blind 800
Bxutu_: posts big blind 1600
*** HOLE CARDS ***
k8ldykbala: folds 
zKiPiSHz: folds 
holdemlouis1: folds 
santiga: calls 800
Bxutu_: raises 3900 to 5500
santiga: calls 3900
*** FLOP *** [6c 7s 6d]
santiga: checks 
Bxutu_: bets 8000
santiga: folds 
Uncalled bet (8000) returned to Bxutu_
Bxutu_ collected 12200 from pot
Bxutu_: doesn't show hand 
*** SUMMARY ***
Total pot 12200 | Rake 0 
Board [6c 7s 6d]
Seat 2: holdemlouis1 (button) folded before Flop (didn't bet)
Seat 3: santiga (small blind) folded on the Flop
Seat 4: Bxutu_ (big blind) collected (12200)
Seat 5: k8ldykbala folded before Flop (didn't bet)
Seat 8: zKiPiSHz folded before Flop (didn't bet)

PokerStars Hand #250528197588: Tournament #3754315429, $20+$20+$4 USD Hold'em No Limit - Level XXIV (800/1600) - 2024/05/16 13:07:00 UTC [2024/05/16 9:07:00 ET]
Table '3754315429 3' 8-max Seat #3 is the button
Seat 2: holdemlouis1 (18483 in chips, $57.50 bounty) 
Seat 3: santiga (30392 in chips, $102.50 bounty) 
Seat 4: Bxutu_ (71421 in chips, $92.50 bounty) 
Seat 5: k8ldykbala (30606 in chips, $80 bounty) 
Seat 8: zKiPiSHz (51882 in chips, $112.50 bounty) 
holdemlouis1: posts the ante 240
santiga: posts the ante 240
Bxutu_: posts the ante 240
k8ldykbala: posts the ante 240
zKiPiSHz: posts the ante 240
Bxutu_: posts small blind 800
k8ldykbala: posts big blind 1600
*** HOLE CARDS ***
zKiPiSHz: folds 
holdemlouis1: folds 
santiga: calls 1600
Bxutu_: calls 800
k8ldykbala: checks 
*** FLOP *** [Ks 8s 4s]
Bxutu_: checks 
k8ldykbala: checks 
santiga: bets 2400
Bxutu_: folds 
k8ldykbala: folds 
Uncalled bet (2400) returned to santiga
santiga collected 6000 from pot
santiga: doesn't show hand 
*** SUMMARY ***
Total pot 6000 | Rake 0 
Board [Ks 8s 4s]
Seat 2: holdemlouis1 folded before Flop (didn't bet)
Seat 3: santiga (button) collected (6000)
Seat 4: Bxutu_ (small blind) folded on the Flop
Seat 5: k8ldykbala (big blind) folded on the Flop
Seat 8: zKiPiSHz folded before Flop (didn't bet)

PokerStars Hand #250528197588: Tournament #3754315429, $20+$20+$4 USD Hold'em No Limit - Level XXIV (800/1600) - 2024/05/16 13:07:00 UTC [2024/05/16 9:07:00 ET]
Table '3754315429 3' 8-max Seat #3 is the button
Seat 2: holdemlouis1 (18483 in chips, $57.50 bounty) 
Seat 3: santiga (30392 in chips, $102.50 bounty) 
Seat 4: Bxutu_ (71421 in chips, $92.50 bounty) 
Seat 5: k8ldykbala (30606 in chips, $80 bounty) 
Seat 8: zKiPiSHz (51882 in chips, $112.50 bounty) 
holdemlouis1: posts the ante 240
santiga: posts the ante 240
Bxutu_: posts the ante 240
k8ldykbala: posts the ante 240
zKiPiSHz: posts the ante 240
Bxutu_: posts small blind 800
k8ldykbala: posts big blind 1600
*** HOLE CARDS ***
zKiPiSHz: folds 
holdemlouis1: folds 
santiga: calls 1600
Bxutu_: calls 800
k8ldykbala: checks 
*** FLOP *** [Ks 8s 4s]
Bxutu_: checks 
k8ldykbala: checks 
santiga: bets 2400
Bxutu_: folds 
k8ldykbala: folds 
Uncalled bet (2400) returned to santiga
santiga collected 6000 from pot
santiga: doesn't show hand 
*** SUMMARY ***
Total pot 6000 | Rake 0 
Board [Ks 8s 4s]
Seat 2: holdemlouis1 folded before Flop (didn't bet)
Seat 3: santiga (button) collected (6000)
Seat 4: Bxutu_ (small blind) folded on the Flop
Seat 5: k8ldykbala (big blind) folded on the Flop
Seat 8: zKiPiSHz folded before Flop (didn't bet)

PokerStars Hand #250528209959: Tournament #3754315429, $20+$20+$4 USD Hold'em No Limit - Level XXV (900/1800) - 2024/05/16 13:08:09 UTC [2024/05/16 9:08:09 ET]
Table '3754315429 3' 8-max Seat #4 is the button
Seat 2: holdemlouis1 (18243 in chips, $57.50 bounty) 
Seat 3: santiga (34552 in chips, $102.50 bounty) 
Seat 4: Bxutu_ (69581 in chips, $92.50 bounty) 
Seat 5: k8ldykbala (28766 in chips, $80 bounty) 
Seat 8: zKiPiSHz (51642 in chips, $112.50 bounty) 
holdemlouis1: posts the ante 270
santiga: posts the ante 270
Bxutu_: posts the ante 270
k8ldykbala: posts the ante 270
zKiPiSHz: posts the ante 270
k8ldykbala: posts small blind 900
zKiPiSHz: posts big blind 1800
*** HOLE CARDS ***
holdemlouis1: folds 
santiga: folds 
Bxutu_: folds 
k8ldykbala: folds 
Uncalled bet (900) returned to zKiPiSHz
born1407 is disconnected 
jaworlegia is disconnected 
zKiPiSHz collected 3150 from pot
zKiPiSHz: doesn't show hand 
*** SUMMARY ***
Total pot 3150 | Rake 0 
Seat 2: holdemlouis1 folded before Flop (didn't bet)
Seat 3: santiga folded before Flop (didn't bet)
Seat 4: Bxutu_ (button) folded before Flop (didn't bet)
Seat 5: k8ldykbala (small blind) folded before Flop
Seat 8: zKiPiSHz (big blind) collected (3150)

PokerStars Hand #250528209959: Tournament #3754315429, $20+$20+$4 USD Hold'em No Limit - Level XXV (900/1800) - 2024/05/16 13:08:09 UTC [2024/05/16 9:08:09 ET]
Table '3754315429 3' 8-max Seat #4 is the button
Seat 2: holdemlouis1 (18243 in chips, $57.50 bounty) 
Seat 3: santiga (34552 in chips, $102.50 bounty) 
Seat 4: Bxutu_ (69581 in chips, $92.50 bounty) 
Seat 5: k8ldykbala (28766 in chips, $80 bounty) 
Seat 8: zKiPiSHz (51642 in chips, $112.50 bounty) 
holdemlouis1: posts the ante 270
santiga: posts the ante 270
Bxutu_: posts the ante 270
k8ldykbala: posts the ante 270
zKiPiSHz: posts the ante 270
k8ldykbala: posts small blind 900
zKiPiSHz: posts big blind 1800
*** HOLE CARDS ***
holdemlouis1: folds 
santiga: folds 
Bxutu_: folds 
k8ldykbala: folds 
Uncalled bet (900) returned to zKiPiSHz
born1407 is disconnected 
jaworlegia is disconnected 
zKiPiSHz collected 3150 from pot
zKiPiSHz: doesn't show hand 
*** SUMMARY ***
Total pot 3150 | Rake 0 
Seat 2: holdemlouis1 folded before Flop (didn't bet)
Seat 3: santiga folded before Flop (didn't bet)
Seat 4: Bxutu_ (button) folded before Flop (didn't bet)
Seat 5: k8ldykbala (small blind) folded before Flop
Seat 8: zKiPiSHz (big blind) collected (3150)

PokerStars Hand #250528212488: Tournament #3754315429, $20+$20+$4 USD Hold'em No Limit - Level XXV (900/1800) - 2024/05/16 13:08:24 UTC [2024/05/16 9:08:24 ET]
Table '3754315429 3' 8-max Seat #5 is the button
Seat 1: NGNFuture (25497 in chips, $45 bounty) is sitting out
Seat 2: holdemlouis1 (17973 in chips, $57.50 bounty) 
Seat 3: santiga (34282 in chips, $102.50 bounty) 
Seat 4: Bxutu_ (69311 in chips, $92.50 bounty) 
Seat 5: k8ldykbala (27596 in chips, $80 bounty) 
Seat 6: born1407 (82096 in chips) out of hand (moved from another table into small blind)
Seat 7: jaworlegia (83342 in chips) out of hand (moved from another table into small blind)
Seat 8: zKiPiSHz (53622 in chips, $112.50 bounty) 
born1407 will be allowed to play after the button
jaworlegia will be allowed to play after the button
NGNFuture: posts the ante 270
holdemlouis1: posts the ante 270
santiga: posts the ante 270
Bxutu_: posts the ante 270
k8ldykbala: posts the ante 270
zKiPiSHz: posts the ante 270
zKiPiSHz: posts small blind 900
NGNFuture: posts big blind 1800
*** HOLE CARDS ***
holdemlouis1: folds 
santiga: folds 
Bxutu_: folds 
k8ldykbala: folds 
zKiPiSHz: raises 1800 to 3600
NGNFuture: folds 
Uncalled bet (1800) returned to zKiPiSHz
zKiPiSHz collected 5220 from pot
zKiPiSHz: doesn't show hand 
*** SUMMARY ***
Total pot 5220 | Rake 0 
Seat 1: NGNFuture (big blind) folded before Flop
Seat 2: holdemlouis1 folded before Flop (didn't bet)
Seat 3: santiga folded before Flop (didn't bet)
Seat 4: Bxutu_ folded before Flop (didn't bet)
Seat 5: k8ldykbala (button) folded before Flop (didn't bet)
Seat 8: zKiPiSHz (small blind) collected (5220)

PokerStars Hand #250528212488: Tournament #3754315429, $20+$20+$4 USD Hold'em No Limit - Level XXV (900/1800) - 2024/05/16 13:08:24 UTC [2024/05/16 9:08:24 ET]
Table '3754315429 3' 8-max Seat #5 is the button
Seat 1: NGNFuture (25497 in chips, $45 bounty) is sitting out
Seat 2: holdemlouis1 (17973 in chips, $57.50 bounty) 
Seat 3: santiga (34282 in chips, $102.50 bounty) 
Seat 4: Bxutu_ (69311 in chips, $92.50 bounty) 
Seat 5: k8ldykbala (27596 in chips, $80 bounty) 
Seat 6: born1407 (82096 in chips) out of hand (moved from another table into small blind)
Seat 7: jaworlegia (83342 in chips) out of hand (moved from another table into small blind)
Seat 8: zKiPiSHz (53622 in chips, $112.50 bounty) 
born1407 will be allowed to play after the button
jaworlegia will be allowed to play after the button
NGNFuture: posts the ante 270
holdemlouis1: posts the ante 270
santiga: posts the ante 270
Bxutu_: posts the ante 270
k8ldykbala: posts the ante 270
zKiPiSHz: posts the ante 270
zKiPiSHz: posts small blind 900
NGNFuture: posts big blind 1800
*** HOLE CARDS ***
holdemlouis1: folds 
santiga: folds 
Bxutu_: folds 
k8ldykbala: folds 
zKiPiSHz: raises 1800 to 3600
NGNFuture: folds 
Uncalled bet (1800) returned to zKiPiSHz
zKiPiSHz collected 5220 from pot
zKiPiSHz: doesn't show hand 
*** SUMMARY ***
Total pot 5220 | Rake 0 
Seat 1: NGNFuture (big blind) folded before Flop
Seat 2: holdemlouis1 folded before Flop (didn't bet)
Seat 3: santiga folded before Flop (didn't bet)
Seat 4: Bxutu_ folded before Flop (didn't bet)
Seat 5: k8ldykbala (button) folded before Flop (didn't bet)
Seat 8: zKiPiSHz (small blind) collected (5220)

PokerStars Hand #250528216941: Tournament #3754315429, $20+$20+$4 USD Hold'em No Limit - Level XXV (900/1800) - 2024/05/16 13:08:49 UTC [2024/05/16 9:08:49 ET]
Table '3754315429 3' 8-max Seat #8 is the button
Seat 1: NGNFuture (23427 in chips, $45 bounty) is sitting out
Seat 2: holdemlouis1 (17703 in chips, $57.50 bounty) 
Seat 3: santiga (34012 in chips, $102.50 bounty) 
Seat 4: Bxutu_ (69041 in chips, $92.50 bounty) 
Seat 5: k8ldykbala (27326 in chips, $80 bounty) 
Seat 6: born1407 (82096 in chips, $142.50 bounty) 
Seat 7: jaworlegia (83342 in chips, $20 bounty) 
Seat 8: zKiPiSHz (56772 in chips, $112.50 bounty) 
NGNFuture: posts the ante 270
holdemlouis1: posts the ante 270
santiga: posts the ante 270
Bxutu_: posts the ante 270
k8ldykbala: posts the ante 270
born1407: posts the ante 270
jaworlegia: posts the ante 270
zKiPiSHz: posts the ante 270
NGNFuture: posts small blind 900
holdemlouis1: posts big blind 1800
*** HOLE CARDS ***
santiga: raises 2520 to 4320
Bxutu_: folds 
k8ldykbala: folds 
born1407: folds 
jaworlegia: folds 
zKiPiSHz: folds 
NGNFuture: folds 
holdemlouis1: calls 2520
*** FLOP *** [4h 8d 4c]
holdemlouis1: checks 
santiga: bets 1800
holdemlouis1: raises 11313 to 13113 and is all-in
santiga: calls 11313
*** TURN *** [4h 8d 4c] [9d]
*** RIVER *** [4h 8d 4c 9d] [6c]
*** SHOW DOWN ***
holdemlouis1: shows [8h Ah] (two pair, Eights and Fours)
santiga: shows [Tc Th] (two pair, Tens and Fours)
santiga collected 37926 from pot
santiga wins $28.75 for eliminating holdemlouis1 and their own bounty increases by $28.75 to $131.25
holdemlouis1 finished the tournament in 16th place and received $49.82.
*** SUMMARY ***
Total pot 37926 | Rake 0 
Board [4h 8d 4c 9d 6c]
Seat 1: NGNFuture (small blind) folded before Flop
Seat 2: holdemlouis1 (big blind) showed [8h Ah] and lost with two pair, Eights and Fours
Seat 3: santiga showed [Tc Th] and won (37926) with two pair, Tens and Fours
Seat 4: Bxutu_ folded before Flop (didn't bet)
Seat 5: k8ldykbala folded before Flop (didn't bet)
Seat 6: born1407 folded before Flop (didn't bet)
Seat 7: jaworlegia folded before Flop (didn't bet)
Seat 8: zKiPiSHz (button) folded before Flop (didn't bet)

PokerStars Hand #250528216941: Tournament #3754315429, $20+$20+$4 USD Hold'em No Limit - Level XXV (900/1800) - 2024/05/16 13:08:49 UTC [2024/05/16 9:08:49 ET]
Table '3754315429 3' 8-max Seat #8 is the button
Seat 1: NGNFuture (23427 in chips, $45 bounty) is sitting out
Seat 2: holdemlouis1 (17703 in chips, $57.50 bounty) 
Seat 3: santiga (34012 in chips, $102.50 bounty) 
Seat 4: Bxutu_ (69041 in chips, $92.50 bounty) 
Seat 5: k8ldykbala (27326 in chips, $80 bounty) 
Seat 6: born1407 (82096 in chips, $142.50 bounty) 
Seat 7: jaworlegia (83342 in chips, $20 bounty) 
Seat 8: zKiPiSHz (56772 in chips, $112.50 bounty) 
NGNFuture: posts the ante 270
holdemlouis1: posts the ante 270
santiga: posts the ante 270
Bxutu_: posts the ante 270
k8ldykbala: posts the ante 270
born1407: posts the ante 270
jaworlegia: posts the ante 270
zKiPiSHz: posts the ante 270
NGNFuture: posts small blind 900
holdemlouis1: posts big blind 1800
*** HOLE CARDS ***
santiga: raises 2520 to 4320
Bxutu_: folds 
k8ldykbala: folds 
born1407: folds 
jaworlegia: folds 
zKiPiSHz: folds 
NGNFuture: folds 
holdemlouis1: calls 2520
*** FLOP *** [4h 8d 4c]
holdemlouis1: checks 
santiga: bets 1800
holdemlouis1: raises 11313 to 13113 and is all-in
santiga: calls 11313
*** TURN *** [4h 8d 4c] [9d]
*** RIVER *** [4h 8d 4c 9d] [6c]
*** SHOW DOWN ***
holdemlouis1: shows [8h Ah] (two pair, Eights and Fours)
santiga: shows [Tc Th] (two pair, Tens and Fours)
santiga collected 37926 from pot
santiga wins $28.75 for eliminating holdemlouis1 and their own bounty increases by $28.75 to $131.25
holdemlouis1 finished the tournament in 16th place and received $49.82.
*** SUMMARY ***
Total pot 37926 | Rake 0 
Board [4h 8d 4c 9d 6c]
Seat 1: NGNFuture (small blind) folded before Flop
Seat 2: holdemlouis1 (big blind) showed [8h Ah] and lost with two pair, Eights and Fours
Seat 3: santiga showed [Tc Th] and won (37926) with two pair, Tens and Fours
Seat 4: Bxutu_ folded before Flop (didn't bet)
Seat 5: k8ldykbala folded before Flop (didn't bet)
Seat 6: born1407 folded before Flop (didn't bet)
Seat 7: jaworlegia folded before Flop (didn't bet)
Seat 8: zKiPiSHz (button) folded before Flop (didn't bet)

PokerStars Hand #250528223686: Tournament #3754315429, $20+$20+$4 USD Hold'em No Limit - Level XXV (900/1800) - 2024/05/16 13:09:27 UTC [2024/05/16 9:09:27 ET]
Table '3754315429 3' 8-max Seat #1 is the button
Seat 1: NGNFuture (22257 in chips, $45 bounty) is sitting out
Seat 3: santiga (54235 in chips, $131.25 bounty) 
Seat 4: Bxutu_ (68771 in chips, $92.50 bounty) 
Seat 5: k8ldykbala (27056 in chips, $80 bounty) 
Seat 6: born1407 (81826 in chips, $142.50 bounty) 
Seat 7: jaworlegia (83072 in chips, $20 bounty) 
Seat 8: zKiPiSHz (56502 in chips, $112.50 bounty) 
NGNFuture: posts the ante 270
santiga: posts the ante 270
Bxutu_: posts the ante 270
k8ldykbala: posts the ante 270
born1407: posts the ante 270
jaworlegia: posts the ante 270
zKiPiSHz: posts the ante 270
santiga: posts small blind 900
Bxutu_: posts big blind 1800
*** HOLE CARDS ***
k8ldykbala: folds 
born1407: raises 1800 to 3600
jaworlegia: folds 
zKiPiSHz: folds 
NGNFuture: folds 
santiga: folds 
Bxutu_: calls 1800
*** FLOP *** [3c Qc 6s]
Bxutu_: checks 
born1407: bets 3297
Bxutu_: calls 3297
*** TURN *** [3c Qc 6s] [Ks]
Bxutu_: checks 
born1407: bets 13500
Bxutu_: calls 13500
*** RIVER *** [3c Qc 6s Ks] [4c]
Bxutu_: bets 3600
born1407: calls 3600
*** SHOW DOWN ***
Bxutu_: shows [9c Tc] (a flush, Queen high)
born1407: mucks hand 
Bxutu_ collected 50784 from pot
*** SUMMARY ***
Total pot 50784 | Rake 0 
Board [3c Qc 6s Ks 4c]
Seat 1: NGNFuture (button) folded before Flop (didn't bet)
Seat 3: santiga (small blind) folded before Flop
Seat 4: Bxutu_ (big blind) showed [9c Tc] and won (50784) with a flush, Queen high
Seat 5: k8ldykbala folded before Flop (didn't bet)
Seat 6: born1407 mucked
Seat 7: jaworlegia folded before Flop (didn't bet)
Seat 8: zKiPiSHz folded before Flop (didn't bet)

PokerStars Hand #250528223686: Tournament #3754315429, $20+$20+$4 USD Hold'em No Limit - Level XXV (900/1800) - 2024/05/16 13:09:27 UTC [2024/05/16 9:09:27 ET]
Table '3754315429 3' 8-max Seat #1 is the button
Seat 1: NGNFuture (22257 in chips, $45 bounty) is sitting out
Seat 3: santiga (54235 in chips, $131.25 bounty) 
Seat 4: Bxutu_ (68771 in chips, $92.50 bounty) 
Seat 5: k8ldykbala (27056 in chips, $80 bounty) 
Seat 6: born1407 (81826 in chips, $142.50 bounty) 
Seat 7: jaworlegia (83072 in chips, $20 bounty) 
Seat 8: zKiPiSHz (56502 in chips, $112.50 bounty) 
NGNFuture: posts the ante 270
santiga: posts the ante 270
Bxutu_: posts the ante 270
k8ldykbala: posts the ante 270
born1407: posts the ante 270
jaworlegia: posts the ante 270
zKiPiSHz: posts the ante 270
santiga: posts small blind 900
Bxutu_: posts big blind 1800
*** HOLE CARDS ***
k8ldykbala: folds 
born1407: raises 1800 to 3600
jaworlegia: folds 
zKiPiSHz: folds 
NGNFuture: folds 
santiga: folds 
Bxutu_: calls 1800
*** FLOP *** [3c Qc 6s]
Bxutu_: checks 
born1407: bets 3297
Bxutu_: calls 3297
*** TURN *** [3c Qc 6s] [Ks]
Bxutu_: checks 
born1407: bets 13500
Bxutu_: calls 13500
*** RIVER *** [3c Qc 6s Ks] [4c]
Bxutu_: bets 3600
born1407: calls 3600
*** SHOW DOWN ***
Bxutu_: shows [9c Tc] (a flush, Queen high)
born1407: mucks hand 
Bxutu_ collected 50784 from pot
*** SUMMARY ***
Total pot 50784 | Rake 0 
Board [3c Qc 6s Ks 4c]
Seat 1: NGNFuture (button) folded before Flop (didn't bet)
Seat 3: santiga (small blind) folded before Flop
Seat 4: Bxutu_ (big blind) showed [9c Tc] and won (50784) with a flush, Queen high
Seat 5: k8ldykbala folded before Flop (didn't bet)
Seat 6: born1407 mucked
Seat 7: jaworlegia folded before Flop (didn't bet)
Seat 8: zKiPiSHz folded before Flop (didn't bet)

PokerStars Hand #250528237843: Tournament #3754315429, $20+$20+$4 USD Hold'em No Limit - Level XXV (900/1800) - 2024/05/16 13:10:47 UTC [2024/05/16 9:10:47 ET]
Table '3754315429 3' 8-max Seat #3 is the button
Seat 1: NGNFuture (21987 in chips, $45 bounty) is sitting out
Seat 3: santiga (53065 in chips, $131.25 bounty) 
Seat 4: Bxutu_ (95288 in chips, $92.50 bounty) 
Seat 5: k8ldykbala (26786 in chips, $80 bounty) 
Seat 6: born1407 (57559 in chips, $142.50 bounty) 
Seat 7: jaworlegia (82802 in chips, $20 bounty) 
Seat 8: zKiPiSHz (56232 in chips, $112.50 bounty) 
NGNFuture: posts the ante 270
santiga: posts the ante 270
Bxutu_: posts the ante 270
k8ldykbala: posts the ante 270
born1407: posts the ante 270
jaworlegia: posts the ante 270
zKiPiSHz: posts the ante 270
Bxutu_: posts small blind 900
k8ldykbala: posts big blind 1800
*** HOLE CARDS ***
born1407: folds 
jaworlegia: folds 
zKiPiSHz: raises 1800 to 3600
NGNFuture: folds 
santiga: folds 
Bxutu_: folds 
k8ldykbala: folds 
Uncalled bet (1800) returned to zKiPiSHz
zKiPiSHz collected 6390 from pot
zKiPiSHz: doesn't show hand 
*** SUMMARY ***
Total pot 6390 | Rake 0 
Seat 1: NGNFuture folded before Flop (didn't bet)
Seat 3: santiga (button) folded before Flop (didn't bet)
Seat 4: Bxutu_ (small blind) folded before Flop
Seat 5: k8ldykbala (big blind) folded before Flop
Seat 6: born1407 folded before Flop (didn't bet)
Seat 7: jaworlegia folded before Flop (didn't bet)
Seat 8: zKiPiSHz collected (6390)

PokerStars Hand #250528237843: Tournament #3754315429, $20+$20+$4 USD Hold'em No Limit - Level XXV (900/1800) - 2024/05/16 13:10:47 UTC [2024/05/16 9:10:47 ET]
Table '3754315429 3' 8-max Seat #3 is the button
Seat 1: NGNFuture (21987 in chips, $45 bounty) is sitting out
Seat 3: santiga (53065 in chips, $131.25 bounty) 
Seat 4: Bxutu_ (95288 in chips, $92.50 bounty) 
Seat 5: k8ldykbala (26786 in chips, $80 bounty) 
Seat 6: born1407 (57559 in chips, $142.50 bounty) 
Seat 7: jaworlegia (82802 in chips, $20 bounty) 
Seat 8: zKiPiSHz (56232 in chips, $112.50 bounty) 
NGNFuture: posts the ante 270
santiga: posts the ante 270
Bxutu_: posts the ante 270
k8ldykbala: posts the ante 270
born1407: posts the ante 270
jaworlegia: posts the ante 270
zKiPiSHz: posts the ante 270
Bxutu_: posts small blind 900
k8ldykbala: posts big blind 1800
*** HOLE CARDS ***
born1407: folds 
jaworlegia: folds 
zKiPiSHz: raises 1800 to 3600
NGNFuture: folds 
santiga: folds 
Bxutu_: folds 
k8ldykbala: folds 
Uncalled bet (1800) returned to zKiPiSHz
zKiPiSHz collected 6390 from pot
zKiPiSHz: doesn't show hand 
*** SUMMARY ***
Total pot 6390 | Rake 0 
Seat 1: NGNFuture folded before Flop (didn't bet)
Seat 3: santiga (button) folded before Flop (didn't bet)
Seat 4: Bxutu_ (small blind) folded before Flop
Seat 5: k8ldykbala (big blind) folded before Flop
Seat 6: born1407 folded before Flop (didn't bet)
Seat 7: jaworlegia folded before Flop (didn't bet)
Seat 8: zKiPiSHz collected (6390)

PokerStars Hand #250528242318: Tournament #3754315429, $20+$20+$4 USD Hold'em No Limit - Level XXV (900/1800) - 2024/05/16 13:11:13 UTC [2024/05/16 9:11:13 ET]
Table '3754315429 3' 8-max Seat #4 is the button
Seat 1: NGNFuture (21717 in chips, $45 bounty) is sitting out
Seat 3: santiga (52795 in chips, $131.25 bounty) 
Seat 4: Bxutu_ (94118 in chips, $92.50 bounty) 
Seat 5: k8ldykbala (24716 in chips, $80 bounty) 
Seat 6: born1407 (57289 in chips, $142.50 bounty) 
Seat 7: jaworlegia (82532 in chips, $20 bounty) 
Seat 8: zKiPiSHz (60552 in chips, $112.50 bounty) 
NGNFuture: posts the ante 270
santiga: posts the ante 270
Bxutu_: posts the ante 270
k8ldykbala: posts the ante 270
born1407: posts the ante 270
jaworlegia: posts the ante 270
zKiPiSHz: posts the ante 270
k8ldykbala: posts small blind 900
born1407: posts big blind 1800
*** HOLE CARDS ***
jaworlegia: folds 
zKiPiSHz: raises 1800 to 3600
NGNFuture: folds 
santiga: folds 
Bxutu_: raises 7200 to 10800
k8ldykbala: folds 
born1407: folds 
zKiPiSHz: folds 
Uncalled bet (7200) returned to Bxutu_
Bxutu_ collected 11790 from pot
Bxutu_: doesn't show hand 
*** SUMMARY ***
Total pot 11790 | Rake 0 
Seat 1: NGNFuture folded before Flop (didn't bet)
Seat 3: santiga folded before Flop (didn't bet)
Seat 4: Bxutu_ (button) collected (11790)
Seat 5: k8ldykbala (small blind) folded before Flop
Seat 6: born1407 (big blind) folded before Flop
Seat 7: jaworlegia folded before Flop (didn't bet)
Seat 8: zKiPiSHz folded before Flop

PokerStars Hand #250528242318: Tournament #3754315429, $20+$20+$4 USD Hold'em No Limit - Level XXV (900/1800) - 2024/05/16 13:11:13 UTC [2024/05/16 9:11:13 ET]
Table '3754315429 3' 8-max Seat #4 is the button
Seat 1: NGNFuture (21717 in chips, $45 bounty) is sitting out
Seat 3: santiga (52795 in chips, $131.25 bounty) 
Seat 4: Bxutu_ (94118 in chips, $92.50 bounty) 
Seat 5: k8ldykbala (24716 in chips, $80 bounty) 
Seat 6: born1407 (57289 in chips, $142.50 bounty) 
Seat 7: jaworlegia (82532 in chips, $20 bounty) 
Seat 8: zKiPiSHz (60552 in chips, $112.50 bounty) 
NGNFuture: posts the ante 270
santiga: posts the ante 270
Bxutu_: posts the ante 270
k8ldykbala: posts the ante 270
born1407: posts the ante 270
jaworlegia: posts the ante 270
zKiPiSHz: posts the ante 270
k8ldykbala: posts small blind 900
born1407: posts big blind 1800
*** HOLE CARDS ***
jaworlegia: folds 
zKiPiSHz: raises 1800 to 3600
NGNFuture: folds 
santiga: folds 
Bxutu_: raises 7200 to 10800
k8ldykbala: folds 
born1407: folds 
zKiPiSHz: folds 
Uncalled bet (7200) returned to Bxutu_
Bxutu_ collected 11790 from pot
Bxutu_: doesn't show hand 
*** SUMMARY ***
Total pot 11790 | Rake 0 
Seat 1: NGNFuture folded before Flop (didn't bet)
Seat 3: santiga folded before Flop (didn't bet)
Seat 4: Bxutu_ (button) collected (11790)
Seat 5: k8ldykbala (small blind) folded before Flop
Seat 6: born1407 (big blind) folded before Flop
Seat 7: jaworlegia folded before Flop (didn't bet)
Seat 8: zKiPiSHz folded before Flop

PokerStars Hand #250528247776: Tournament #3754315429, $20+$20+$4 USD Hold'em No Limit - Level XXV (900/1800) - 2024/05/16 13:11:43 UTC [2024/05/16 9:11:43 ET]
Table '3754315429 3' 8-max Seat #5 is the button
Seat 1: NGNFuture (21447 in chips, $45 bounty) is sitting out
Seat 3: santiga (52525 in chips, $131.25 bounty) 
Seat 4: Bxutu_ (102038 in chips, $92.50 bounty) 
Seat 5: k8ldykbala (23546 in chips, $80 bounty) 
Seat 6: born1407 (55219 in chips, $142.50 bounty) 
Seat 7: jaworlegia (82262 in chips, $20 bounty) 
Seat 8: zKiPiSHz (56682 in chips, $112.50 bounty) 
NGNFuture: posts the ante 270
santiga: posts the ante 270
Bxutu_: posts the ante 270
k8ldykbala: posts the ante 270
born1407: posts the ante 270
jaworlegia: posts the ante 270
zKiPiSHz: posts the ante 270
born1407: posts small blind 900
jaworlegia: posts big blind 1800
*** HOLE CARDS ***
zKiPiSHz: folds 
NGNFuture: folds 
santiga: folds 
Bxutu_: raises 2070 to 3870
k8ldykbala: raises 19406 to 23276 and is all-in
born1407: folds 
jaworlegia: folds 
Bxutu_: calls 19406
*** FLOP *** [2d Th 9s]
*** TURN *** [2d Th 9s] [5c]
*** RIVER *** [2d Th 9s 5c] [3h]
*** SHOW DOWN ***
Bxutu_: shows [Ks Qc] (high card King)
k8ldykbala: shows [8h Ad] (high card Ace)
k8ldykbala collected 51142 from pot
*** SUMMARY ***
Total pot 51142 | Rake 0 
Board [2d Th 9s 5c 3h]
Seat 1: NGNFuture folded before Flop (didn't bet)
Seat 3: santiga folded before Flop (didn't bet)
Seat 4: Bxutu_ showed [Ks Qc] and lost with high card King
Seat 5: k8ldykbala (button) showed [8h Ad] and won (51142) with high card Ace
Seat 6: born1407 (small blind) folded before Flop
Seat 7: jaworlegia (big blind) folded before Flop
Seat 8: zKiPiSHz folded before Flop (didn't bet)

PokerStars Hand #250528247776: Tournament #3754315429, $20+$20+$4 USD Hold'em No Limit - Level XXV (900/1800) - 2024/05/16 13:11:43 UTC [2024/05/16 9:11:43 ET]
Table '3754315429 3' 8-max Seat #5 is the button
Seat 1: NGNFuture (21447 in chips, $45 bounty) is sitting out
Seat 3: santiga (52525 in chips, $131.25 bounty) 
Seat 4: Bxutu_ (102038 in chips, $92.50 bounty) 
Seat 5: k8ldykbala (23546 in chips, $80 bounty) 
Seat 6: born1407 (55219 in chips, $142.50 bounty) 
Seat 7: jaworlegia (82262 in chips, $20 bounty) 
Seat 8: zKiPiSHz (56682 in chips, $112.50 bounty) 
NGNFuture: posts the ante 270
santiga: posts the ante 270
Bxutu_: posts the ante 270
k8ldykbala: posts the ante 270
born1407: posts the ante 270
jaworlegia: posts the ante 270
zKiPiSHz: posts the ante 270
born1407: posts small blind 900
jaworlegia: posts big blind 1800
*** HOLE CARDS ***
zKiPiSHz: folds 
NGNFuture: folds 
santiga: folds 
Bxutu_: raises 2070 to 3870
k8ldykbala: raises 19406 to 23276 and is all-in
born1407: folds 
jaworlegia: folds 
Bxutu_: calls 19406
*** FLOP *** [2d Th 9s]
*** TURN *** [2d Th 9s] [5c]
*** RIVER *** [2d Th 9s 5c] [3h]
*** SHOW DOWN ***
Bxutu_: shows [Ks Qc] (high card King)
k8ldykbala: shows [8h Ad] (high card Ace)
k8ldykbala collected 51142 from pot
*** SUMMARY ***
Total pot 51142 | Rake 0 
Board [2d Th 9s 5c 3h]
Seat 1: NGNFuture folded before Flop (didn't bet)
Seat 3: santiga folded before Flop (didn't bet)
Seat 4: Bxutu_ showed [Ks Qc] and lost with high card King
Seat 5: k8ldykbala (button) showed [8h Ad] and won (51142) with high card Ace
Seat 6: born1407 (small blind) folded before Flop
Seat 7: jaworlegia (big blind) folded before Flop
Seat 8: zKiPiSHz folded before Flop (didn't bet)

PokerStars Hand #250528254003: Tournament #3754315429, $20+$20+$4 USD Hold'em No Limit - Level XXV (900/1800) - 2024/05/16 13:12:19 UTC [2024/05/16 9:12:19 ET]
Table '3754315429 3' 8-max Seat #6 is the button
Seat 1: NGNFuture (21177 in chips, $45 bounty) is sitting out
Seat 3: santiga (52255 in chips, $131.25 bounty) 
Seat 4: Bxutu_ (78492 in chips, $92.50 bounty) 
Seat 5: k8ldykbala (51142 in chips, $80 bounty) 
Seat 6: born1407 (54049 in chips, $142.50 bounty) 
Seat 7: jaworlegia (80192 in chips, $20 bounty) 
Seat 8: zKiPiSHz (56412 in chips, $112.50 bounty) 
NGNFuture: posts the ante 270
santiga: posts the ante 270
Bxutu_: posts the ante 270
k8ldykbala: posts the ante 270
born1407: posts the ante 270
jaworlegia: posts the ante 270
zKiPiSHz: posts the ante 270
jaworlegia: posts small blind 900
zKiPiSHz: posts big blind 1800
*** HOLE CARDS ***
NGNFuture: folds 
santiga: folds 
Bxutu_: folds 
k8ldykbala: folds 
born1407: folds 
jaworlegia: calls 900
zKiPiSHz: raises 4500 to 6300
jaworlegia: folds 
Uncalled bet (4500) returned to zKiPiSHz
zKiPiSHz collected 5490 from pot
zKiPiSHz: doesn't show hand 
*** SUMMARY ***
Total pot 5490 | Rake 0 
Seat 1: NGNFuture folded before Flop (didn't bet)
Seat 3: santiga folded before Flop (didn't bet)
Seat 4: Bxutu_ folded before Flop (didn't bet)
Seat 5: k8ldykbala folded before Flop (didn't bet)
Seat 6: born1407 (button) folded before Flop (didn't bet)
Seat 7: jaworlegia (small blind) folded before Flop
Seat 8: zKiPiSHz (big blind) collected (5490)

PokerStars Hand #250528254003: Tournament #3754315429, $20+$20+$4 USD Hold'em No Limit - Level XXV (900/1800) - 2024/05/16 13:12:19 UTC [2024/05/16 9:12:19 ET]
Table '3754315429 3' 8-max Seat #6 is the button
Seat 1: NGNFuture (21177 in chips, $45 bounty) is sitting out
Seat 3: santiga (52255 in chips, $131.25 bounty) 
Seat 4: Bxutu_ (78492 in chips, $92.50 bounty) 
Seat 5: k8ldykbala (51142 in chips, $80 bounty) 
Seat 6: born1407 (54049 in chips, $142.50 bounty) 
Seat 7: jaworlegia (80192 in chips, $20 bounty) 
Seat 8: zKiPiSHz (56412 in chips, $112.50 bounty) 
NGNFuture: posts the ante 270
santiga: posts the ante 270
Bxutu_: posts the ante 270
k8ldykbala: posts the ante 270
born1407: posts the ante 270
jaworlegia: posts the ante 270
zKiPiSHz: posts the ante 270
jaworlegia: posts small blind 900
zKiPiSHz: posts big blind 1800
*** HOLE CARDS ***
NGNFuture: folds 
santiga: folds 
Bxutu_: folds 
k8ldykbala: folds 
born1407: folds 
jaworlegia: calls 900
zKiPiSHz: raises 4500 to 6300
jaworlegia: folds 
Uncalled bet (4500) returned to zKiPiSHz
zKiPiSHz collected 5490 from pot
zKiPiSHz: doesn't show hand 
*** SUMMARY ***
Total pot 5490 | Rake 0 
Seat 1: NGNFuture folded before Flop (didn't bet)
Seat 3: santiga folded before Flop (didn't bet)
Seat 4: Bxutu_ folded before Flop (didn't bet)
Seat 5: k8ldykbala folded before Flop (didn't bet)
Seat 6: born1407 (button) folded before Flop (didn't bet)
Seat 7: jaworlegia (small blind) folded before Flop
Seat 8: zKiPiSHz (big blind) collected (5490)

PokerStars Hand #250528257585: Tournament #3754315429, $20+$20+$4 USD Hold'em No Limit - Level XXV (900/1800) - 2024/05/16 13:12:39 UTC [2024/05/16 9:12:39 ET]
Table '3754315429 3' 8-max Seat #7 is the button
Seat 1: NGNFuture (20907 in chips, $45 bounty) is sitting out
Seat 3: santiga (51985 in chips, $131.25 bounty) 
Seat 4: Bxutu_ (78222 in chips, $92.50 bounty) 
Seat 5: k8ldykbala (50872 in chips, $80 bounty) 
Seat 6: born1407 (53779 in chips, $142.50 bounty) 
Seat 7: jaworlegia (78122 in chips, $20 bounty) 
Seat 8: zKiPiSHz (59832 in chips, $112.50 bounty) 
NGNFuture: posts the ante 270
santiga: posts the ante 270
Bxutu_: posts the ante 270
k8ldykbala: posts the ante 270
born1407: posts the ante 270
jaworlegia: posts the ante 270
zKiPiSHz: posts the ante 270
zKiPiSHz: posts small blind 900
NGNFuture: posts big blind 1800
*** HOLE CARDS ***
santiga: raises 2520 to 4320
Bxutu_: folds 
k8ldykbala: folds 
born1407: folds 
jaworlegia: folds 
zKiPiSHz: folds 
NGNFuture: folds 
Uncalled bet (2520) returned to santiga
santiga collected 6390 from pot
santiga: doesn't show hand 
*** SUMMARY ***
Total pot 6390 | Rake 0 
Seat 1: NGNFuture (big blind) folded before Flop
Seat 3: santiga collected (6390)
Seat 4: Bxutu_ folded before Flop (didn't bet)
Seat 5: k8ldykbala folded before Flop (didn't bet)
Seat 6: born1407 folded before Flop (didn't bet)
Seat 7: jaworlegia (button) folded before Flop (didn't bet)
Seat 8: zKiPiSHz (small blind) folded before Flop

PokerStars Hand #250528257585: Tournament #3754315429, $20+$20+$4 USD Hold'em No Limit - Level XXV (900/1800) - 2024/05/16 13:12:39 UTC [2024/05/16 9:12:39 ET]
Table '3754315429 3' 8-max Seat #7 is the button
Seat 1: NGNFuture (20907 in chips, $45 bounty) is sitting out
Seat 3: santiga (51985 in chips, $131.25 bounty) 
Seat 4: Bxutu_ (78222 in chips, $92.50 bounty) 
Seat 5: k8ldykbala (50872 in chips, $80 bounty) 
Seat 6: born1407 (53779 in chips, $142.50 bounty) 
Seat 7: jaworlegia (78122 in chips, $20 bounty) 
Seat 8: zKiPiSHz (59832 in chips, $112.50 bounty) 
NGNFuture: posts the ante 270
santiga: posts the ante 270
Bxutu_: posts the ante 270
k8ldykbala: posts the ante 270
born1407: posts the ante 270
jaworlegia: posts the ante 270
zKiPiSHz: posts the ante 270
zKiPiSHz: posts small blind 900
NGNFuture: posts big blind 1800
*** HOLE CARDS ***
santiga: raises 2520 to 4320
Bxutu_: folds 
k8ldykbala: folds 
born1407: folds 
jaworlegia: folds 
zKiPiSHz: folds 
NGNFuture: folds 
Uncalled bet (2520) returned to santiga
santiga collected 6390 from pot
santiga: doesn't show hand 
*** SUMMARY ***
Total pot 6390 | Rake 0 
Seat 1: NGNFuture (big blind) folded before Flop
Seat 3: santiga collected (6390)
Seat 4: Bxutu_ folded before Flop (didn't bet)
Seat 5: k8ldykbala folded before Flop (didn't bet)
Seat 6: born1407 folded before Flop (didn't bet)
Seat 7: jaworlegia (button) folded before Flop (didn't bet)
Seat 8: zKiPiSHz (small blind) folded before Flop

PokerStars Hand #250528259575: Tournament #3754315429, $20+$20+$4 USD Hold'em No Limit - Level XXV (900/1800) - 2024/05/16 13:12:50 UTC [2024/05/16 9:12:50 ET]
Table '3754315429 3' 8-max Seat #8 is the button
Seat 1: NGNFuture (18837 in chips, $45 bounty) is sitting out
Seat 3: santiga (56305 in chips, $131.25 bounty) 
Seat 4: Bxutu_ (77952 in chips, $92.50 bounty) 
Seat 5: k8ldykbala (50602 in chips, $80 bounty) 
Seat 6: born1407 (53509 in chips, $142.50 bounty) 
Seat 7: jaworlegia (77852 in chips, $20 bounty) 
Seat 8: zKiPiSHz (58662 in chips, $112.50 bounty) 
NGNFuture: posts the ante 270
santiga: posts the ante 270
Bxutu_: posts the ante 270
k8ldykbala: posts the ante 270
born1407: posts the ante 270
jaworlegia: posts the ante 270
zKiPiSHz: posts the ante 270
NGNFuture: posts small blind 900
santiga: posts big blind 1800
*** HOLE CARDS ***
Bxutu_: folds 
k8ldykbala: folds 
born1407: folds 
jaworlegia: folds 
zKiPiSHz: raises 1800 to 3600
NGNFuture: folds 
santiga: calls 1800
*** FLOP *** [Qh 6s 9h]
santiga: checks 
zKiPiSHz: bets 6480
santiga: folds 
Uncalled bet (6480) returned to zKiPiSHz
zKiPiSHz collected 9990 from pot
zKiPiSHz: doesn't show hand 
*** SUMMARY ***
Total pot 9990 | Rake 0 
Board [Qh 6s 9h]
Seat 1: NGNFuture (small blind) folded before Flop
Seat 3: santiga (big blind) folded on the Flop
Seat 4: Bxutu_ folded before Flop (didn't bet)
Seat 5: k8ldykbala folded before Flop (didn't bet)
Seat 6: born1407 folded before Flop (didn't bet)
Seat 7: jaworlegia folded before Flop (didn't bet)
Seat 8: zKiPiSHz (button) collected (9990)

PokerStars Hand #250528259575: Tournament #3754315429, $20+$20+$4 USD Hold'em No Limit - Level XXV (900/1800) - 2024/05/16 13:12:50 UTC [2024/05/16 9:12:50 ET]
Table '3754315429 3' 8-max Seat #8 is the button
Seat 1: NGNFuture (18837 in chips, $45 bounty) is sitting out
Seat 3: santiga (56305 in chips, $131.25 bounty) 
Seat 4: Bxutu_ (77952 in chips, $92.50 bounty) 
Seat 5: k8ldykbala (50602 in chips, $80 bounty) 
Seat 6: born1407 (53509 in chips, $142.50 bounty) 
Seat 7: jaworlegia (77852 in chips, $20 bounty) 
Seat 8: zKiPiSHz (58662 in chips, $112.50 bounty) 
NGNFuture: posts the ante 270
santiga: posts the ante 270
Bxutu_: posts the ante 270
k8ldykbala: posts the ante 270
born1407: posts the ante 270
jaworlegia: posts the ante 270
zKiPiSHz: posts the ante 270
NGNFuture: posts small blind 900
santiga: posts big blind 1800
*** HOLE CARDS ***
Bxutu_: folds 
k8ldykbala: folds 
born1407: folds 
jaworlegia: folds 
zKiPiSHz: raises 1800 to 3600
NGNFuture: folds 
santiga: calls 1800
*** FLOP *** [Qh 6s 9h]
santiga: checks 
zKiPiSHz: bets 6480
santiga: folds 
Uncalled bet (6480) returned to zKiPiSHz
zKiPiSHz collected 9990 from pot
zKiPiSHz: doesn't show hand 
*** SUMMARY ***
Total pot 9990 | Rake 0 
Board [Qh 6s 9h]
Seat 1: NGNFuture (small blind) folded before Flop
Seat 3: santiga (big blind) folded on the Flop
Seat 4: Bxutu_ folded before Flop (didn't bet)
Seat 5: k8ldykbala folded before Flop (didn't bet)
Seat 6: born1407 folded before Flop (didn't bet)
Seat 7: jaworlegia folded before Flop (didn't bet)
Seat 8: zKiPiSHz (button) collected (9990)

PokerStars Hand #250528266466: Tournament #3754315429, $20+$20+$4 USD Hold'em No Limit - Level XXV (900/1800) - 2024/05/16 13:13:29 UTC [2024/05/16 9:13:29 ET]
Table '3754315429 3' 8-max Seat #1 is the button
Seat 1: NGNFuture (17667 in chips, $45 bounty) is sitting out
Seat 3: santiga (52435 in chips, $131.25 bounty) 
Seat 4: Bxutu_ (77682 in chips, $92.50 bounty) 
Seat 5: k8ldykbala (50332 in chips, $80 bounty) 
Seat 6: born1407 (53239 in chips, $142.50 bounty) 
Seat 7: jaworlegia (77582 in chips, $20 bounty) 
Seat 8: zKiPiSHz (64782 in chips, $112.50 bounty) 
NGNFuture: posts the ante 270
santiga: posts the ante 270
Bxutu_: posts the ante 270
k8ldykbala: posts the ante 270
born1407: posts the ante 270
jaworlegia: posts the ante 270
zKiPiSHz: posts the ante 270
santiga: posts small blind 900
Bxutu_: posts big blind 1800
*** HOLE CARDS ***
k8ldykbala: raises 1800 to 3600
born1407: folds 
jaworlegia: folds 
zKiPiSHz: folds 
NGNFuture: folds 
santiga: folds 
Bxutu_: folds 
Uncalled bet (1800) returned to k8ldykbala
k8ldykbala collected 6390 from pot
k8ldykbala: doesn't show hand 
*** SUMMARY ***
Total pot 6390 | Rake 0 
Seat 1: NGNFuture (button) folded before Flop (didn't bet)
Seat 3: santiga (small blind) folded before Flop
Seat 4: Bxutu_ (big blind) folded before Flop
Seat 5: k8ldykbala collected (6390)
Seat 6: born1407 folded before Flop (didn't bet)
Seat 7: jaworlegia folded before Flop (didn't bet)
Seat 8: zKiPiSHz folded before Flop (didn't bet)

PokerStars Hand #250528266466: Tournament #3754315429, $20+$20+$4 USD Hold'em No Limit - Level XXV (900/1800) - 2024/05/16 13:13:29 UTC [2024/05/16 9:13:29 ET]
Table '3754315429 3' 8-max Seat #1 is the button
Seat 1: NGNFuture (17667 in chips, $45 bounty) is sitting out
Seat 3: santiga (52435 in chips, $131.25 bounty) 
Seat 4: Bxutu_ (77682 in chips, $92.50 bounty) 
Seat 5: k8ldykbala (50332 in chips, $80 bounty) 
Seat 6: born1407 (53239 in chips, $142.50 bounty) 
Seat 7: jaworlegia (77582 in chips, $20 bounty) 
Seat 8: zKiPiSHz (64782 in chips, $112.50 bounty) 
NGNFuture: posts the ante 270
santiga: posts the ante 270
Bxutu_: posts the ante 270
k8ldykbala: posts the ante 270
born1407: posts the ante 270
jaworlegia: posts the ante 270
zKiPiSHz: posts the ante 270
santiga: posts small blind 900
Bxutu_: posts big blind 1800
*** HOLE CARDS ***
k8ldykbala: raises 1800 to 3600
born1407: folds 
jaworlegia: folds 
zKiPiSHz: folds 
NGNFuture: folds 
santiga: folds 
Bxutu_: folds 
Uncalled bet (1800) returned to k8ldykbala
k8ldykbala collected 6390 from pot
k8ldykbala: doesn't show hand 
*** SUMMARY ***
Total pot 6390 | Rake 0 
Seat 1: NGNFuture (button) folded before Flop (didn't bet)
Seat 3: santiga (small blind) folded before Flop
Seat 4: Bxutu_ (big blind) folded before Flop
Seat 5: k8ldykbala collected (6390)
Seat 6: born1407 folded before Flop (didn't bet)
Seat 7: jaworlegia folded before Flop (didn't bet)
Seat 8: zKiPiSHz folded before Flop (didn't bet)

PokerStars Hand #250528269274: Tournament #3754315429, $20+$20+$4 USD Hold'em No Limit - Level XXV (900/1800) - 2024/05/16 13:13:45 UTC [2024/05/16 9:13:45 ET]
Table '3754315429 3' 8-max Seat #3 is the button
Seat 1: NGNFuture (17397 in chips, $45 bounty) is sitting out
Seat 3: santiga (51265 in chips, $131.25 bounty) 
Seat 4: Bxutu_ (75612 in chips, $92.50 bounty) 
Seat 5: k8ldykbala (54652 in chips, $80 bounty) 
Seat 6: born1407 (52969 in chips, $142.50 bounty) 
Seat 7: jaworlegia (77312 in chips, $20 bounty) 
Seat 8: zKiPiSHz (64512 in chips, $112.50 bounty) 
NGNFuture: posts the ante 270
santiga: posts the ante 270
Bxutu_: posts the ante 270
k8ldykbala: posts the ante 270
born1407: posts the ante 270
jaworlegia: posts the ante 270
zKiPiSHz: posts the ante 270
Bxutu_: posts small blind 900
k8ldykbala: posts big blind 1800
*** HOLE CARDS ***
born1407: folds 
jaworlegia: raises 1800 to 3600
zKiPiSHz: calls 3600
NGNFuture: folds 
santiga: folds 
Bxutu_: folds 
k8ldykbala: folds 
*** FLOP *** [Ts 4s 2h]
jaworlegia: checks 
zKiPiSHz: bets 4716
jaworlegia: calls 4716
*** TURN *** [Ts 4s 2h] [5c]
jaworlegia: checks 
zKiPiSHz: bets 16978
jaworlegia: folds 
Uncalled bet (16978) returned to zKiPiSHz
zKiPiSHz collected 21222 from pot
zKiPiSHz: doesn't show hand 
*** SUMMARY ***
Total pot 21222 | Rake 0 
Board [Ts 4s 2h 5c]
Seat 1: NGNFuture folded before Flop (didn't bet)
Seat 3: santiga (button) folded before Flop (didn't bet)
Seat 4: Bxutu_ (small blind) folded before Flop
Seat 5: k8ldykbala (big blind) folded before Flop
Seat 6: born1407 folded before Flop (didn't bet)
Seat 7: jaworlegia folded on the Turn
Seat 8: zKiPiSHz collected (21222)

PokerStars Hand #250528269274: Tournament #3754315429, $20+$20+$4 USD Hold'em No Limit - Level XXV (900/1800) - 2024/05/16 13:13:45 UTC [2024/05/16 9:13:45 ET]
Table '3754315429 3' 8-max Seat #3 is the button
Seat 1: NGNFuture (17397 in chips, $45 bounty) is sitting out
Seat 3: santiga (51265 in chips, $131.25 bounty) 
Seat 4: Bxutu_ (75612 in chips, $92.50 bounty) 
Seat 5: k8ldykbala (54652 in chips, $80 bounty) 
Seat 6: born1407 (52969 in chips, $142.50 bounty) 
Seat 7: jaworlegia (77312 in chips, $20 bounty) 
Seat 8: zKiPiSHz (64512 in chips, $112.50 bounty) 
NGNFuture: posts the ante 270
santiga: posts the ante 270
Bxutu_: posts the ante 270
k8ldykbala: posts the ante 270
born1407: posts the ante 270
jaworlegia: posts the ante 270
zKiPiSHz: posts the ante 270
Bxutu_: posts small blind 900
k8ldykbala: posts big blind 1800
*** HOLE CARDS ***
born1407: folds 
jaworlegia: raises 1800 to 3600
zKiPiSHz: calls 3600
NGNFuture: folds 
santiga: folds 
Bxutu_: folds 
k8ldykbala: folds 
*** FLOP *** [Ts 4s 2h]
jaworlegia: checks 
zKiPiSHz: bets 4716
jaworlegia: calls 4716
*** TURN *** [Ts 4s 2h] [5c]
jaworlegia: checks 
zKiPiSHz: bets 16978
jaworlegia: folds 
Uncalled bet (16978) returned to zKiPiSHz
zKiPiSHz collected 21222 from pot
zKiPiSHz: doesn't show hand 
*** SUMMARY ***
Total pot 21222 | Rake 0 
Board [Ts 4s 2h 5c]
Seat 1: NGNFuture folded before Flop (didn't bet)
Seat 3: santiga (button) folded before Flop (didn't bet)
Seat 4: Bxutu_ (small blind) folded before Flop
Seat 5: k8ldykbala (big blind) folded before Flop
Seat 6: born1407 folded before Flop (didn't bet)
Seat 7: jaworlegia folded on the Turn
Seat 8: zKiPiSHz collected (21222)

PokerStars Hand #250528278203: Tournament #3754315429, $20+$20+$4 USD Hold'em No Limit - Level XXV (900/1800) - 2024/05/16 13:14:35 UTC [2024/05/16 9:14:35 ET]
Table '3754315429 3' 8-max Seat #4 is the button
Seat 1: NGNFuture (17127 in chips, $45 bounty) is sitting out
Seat 3: santiga (50995 in chips, $131.25 bounty) 
Seat 4: Bxutu_ (74442 in chips, $92.50 bounty) 
Seat 5: k8ldykbala (52582 in chips, $80 bounty) 
Seat 6: born1407 (52699 in chips, $142.50 bounty) 
Seat 7: jaworlegia (68726 in chips, $20 bounty) 
Seat 8: zKiPiSHz (77148 in chips, $112.50 bounty) 
NGNFuture: posts the ante 270
santiga: posts the ante 270
Bxutu_: posts the ante 270
k8ldykbala: posts the ante 270
born1407: posts the ante 270
jaworlegia: posts the ante 270
zKiPiSHz: posts the ante 270
k8ldykbala: posts small blind 900
born1407: posts big blind 1800
*** HOLE CARDS ***
jaworlegia: folds 
zKiPiSHz: folds 
NGNFuture: folds 
santiga: raises 2880 to 4680
Bxutu_: calls 4680
k8ldykbala: folds 
born1407: raises 11520 to 16200
santiga: folds 
Bxutu_: folds 
Uncalled bet (11520) returned to born1407
born1407 collected 16830 from pot
born1407: doesn't show hand 
*** SUMMARY ***
Total pot 16830 | Rake 0 
Seat 1: NGNFuture folded before Flop (didn't bet)
Seat 3: santiga folded before Flop
Seat 4: Bxutu_ (button) folded before Flop
Seat 5: k8ldykbala (small blind) folded before Flop
Seat 6: born1407 (big blind) collected (16830)
Seat 7: jaworlegia folded before Flop (didn't bet)
Seat 8: zKiPiSHz folded before Flop (didn't bet)

PokerStars Hand #250528278203: Tournament #3754315429, $20+$20+$4 USD Hold'em No Limit - Level XXV (900/1800) - 2024/05/16 13:14:35 UTC [2024/05/16 9:14:35 ET]
Table '3754315429 3' 8-max Seat #4 is the button
Seat 1: NGNFuture (17127 in chips, $45 bounty) is sitting out
Seat 3: santiga (50995 in chips, $131.25 bounty) 
Seat 4: Bxutu_ (74442 in chips, $92.50 bounty) 
Seat 5: k8ldykbala (52582 in chips, $80 bounty) 
Seat 6: born1407 (52699 in chips, $142.50 bounty) 
Seat 7: jaworlegia (68726 in chips, $20 bounty) 
Seat 8: zKiPiSHz (77148 in chips, $112.50 bounty) 
NGNFuture: posts the ante 270
santiga: posts the ante 270
Bxutu_: posts the ante 270
k8ldykbala: posts the ante 270
born1407: posts the ante 270
jaworlegia: posts the ante 270
zKiPiSHz: posts the ante 270
k8ldykbala: posts small blind 900
born1407: posts big blind 1800
*** HOLE CARDS ***
jaworlegia: folds 
zKiPiSHz: folds 
NGNFuture: folds 
santiga: raises 2880 to 4680
Bxutu_: calls 4680
k8ldykbala: folds 
born1407: raises 11520 to 16200
santiga: folds 
Bxutu_: folds 
Uncalled bet (11520) returned to born1407
born1407 collected 16830 from pot
born1407: doesn't show hand 
*** SUMMARY ***
Total pot 16830 | Rake 0 
Seat 1: NGNFuture folded before Flop (didn't bet)
Seat 3: santiga folded before Flop
Seat 4: Bxutu_ (button) folded before Flop
Seat 5: k8ldykbala (small blind) folded before Flop
Seat 6: born1407 (big blind) collected (16830)
Seat 7: jaworlegia folded before Flop (didn't bet)
Seat 8: zKiPiSHz folded before Flop (didn't bet)

PokerStars Hand #250528284829: Tournament #3754315429, $20+$20+$4 USD Hold'em No Limit - Level XXV (900/1800) - 2024/05/16 13:15:12 UTC [2024/05/16 9:15:12 ET]
Table '3754315429 3' 8-max Seat #5 is the button
Seat 1: NGNFuture (16857 in chips, $45 bounty) is sitting out
Seat 3: santiga (46045 in chips, $131.25 bounty) 
Seat 4: Bxutu_ (69492 in chips, $92.50 bounty) 
Seat 5: k8ldykbala (51412 in chips, $80 bounty) 
Seat 6: born1407 (64579 in chips, $142.50 bounty) 
Seat 7: jaworlegia (68456 in chips, $20 bounty) 
Seat 8: zKiPiSHz (76878 in chips, $112.50 bounty) 
NGNFuture: posts the ante 270
santiga: posts the ante 270
Bxutu_: posts the ante 270
k8ldykbala: posts the ante 270
born1407: posts the ante 270
jaworlegia: posts the ante 270
zKiPiSHz: posts the ante 270
born1407: posts small blind 900
jaworlegia: posts big blind 1800
*** HOLE CARDS ***
zKiPiSHz: raises 1800 to 3600
NGNFuture: folds 
santiga: folds 
Bxutu_: folds 
k8ldykbala: folds 
born1407: folds 
jaworlegia: calls 1800
*** FLOP *** [Qc Ts Ah]
jaworlegia: checks 
zKiPiSHz: bets 2997
jaworlegia: calls 2997
*** TURN *** [Qc Ts Ah] [Ad]
jaworlegia: checks 
zKiPiSHz: bets 6390
jaworlegia: folds 
Uncalled bet (6390) returned to zKiPiSHz
zKiPiSHz collected 15984 from pot
zKiPiSHz: doesn't show hand 
*** SUMMARY ***
Total pot 15984 | Rake 0 
Board [Qc Ts Ah Ad]
Seat 1: NGNFuture folded before Flop (didn't bet)
Seat 3: santiga folded before Flop (didn't bet)
Seat 4: Bxutu_ folded before Flop (didn't bet)
Seat 5: k8ldykbala (button) folded before Flop (didn't bet)
Seat 6: born1407 (small blind) folded before Flop
Seat 7: jaworlegia (big blind) folded on the Turn
Seat 8: zKiPiSHz collected (15984)

PokerStars Hand #250528284829: Tournament #3754315429, $20+$20+$4 USD Hold'em No Limit - Level XXV (900/1800) - 2024/05/16 13:15:12 UTC [2024/05/16 9:15:12 ET]
Table '3754315429 3' 8-max Seat #5 is the button
Seat 1: NGNFuture (16857 in chips, $45 bounty) is sitting out
Seat 3: santiga (46045 in chips, $131.25 bounty) 
Seat 4: Bxutu_ (69492 in chips, $92.50 bounty) 
Seat 5: k8ldykbala (51412 in chips, $80 bounty) 
Seat 6: born1407 (64579 in chips, $142.50 bounty) 
Seat 7: jaworlegia (68456 in chips, $20 bounty) 
Seat 8: zKiPiSHz (76878 in chips, $112.50 bounty) 
NGNFuture: posts the ante 270
santiga: posts the ante 270
Bxutu_: posts the ante 270
k8ldykbala: posts the ante 270
born1407: posts the ante 270
jaworlegia: posts the ante 270
zKiPiSHz: posts the ante 270
born1407: posts small blind 900
jaworlegia: posts big blind 1800
*** HOLE CARDS ***
zKiPiSHz: raises 1800 to 3600
NGNFuture: folds 
santiga: folds 
Bxutu_: folds 
k8ldykbala: folds 
born1407: folds 
jaworlegia: calls 1800
*** FLOP *** [Qc Ts Ah]
jaworlegia: checks 
zKiPiSHz: bets 2997
jaworlegia: calls 2997
*** TURN *** [Qc Ts Ah] [Ad]
jaworlegia: checks 
zKiPiSHz: bets 6390
jaworlegia: folds 
Uncalled bet (6390) returned to zKiPiSHz
zKiPiSHz collected 15984 from pot
zKiPiSHz: doesn't show hand 
*** SUMMARY ***
Total pot 15984 | Rake 0 
Board [Qc Ts Ah Ad]
Seat 1: NGNFuture folded before Flop (didn't bet)
Seat 3: santiga folded before Flop (didn't bet)
Seat 4: Bxutu_ folded before Flop (didn't bet)
Seat 5: k8ldykbala (button) folded before Flop (didn't bet)
Seat 6: born1407 (small blind) folded before Flop
Seat 7: jaworlegia (big blind) folded on the Turn
Seat 8: zKiPiSHz collected (15984)

PokerStars Hand #250528295263: Tournament #3754315429, $20+$20+$4 USD Hold'em No Limit - Level XXVI (1000/2000) - 2024/05/16 13:16:10 UTC [2024/05/16 9:16:10 ET]
Table '3754315429 3' 8-max Seat #6 is the button
Seat 1: NGNFuture (16587 in chips, $45 bounty) is sitting out
Seat 3: santiga (45775 in chips, $131.25 bounty) 
Seat 4: Bxutu_ (69222 in chips, $92.50 bounty) 
Seat 5: k8ldykbala (51142 in chips, $80 bounty) 
Seat 6: born1407 (63409 in chips, $142.50 bounty) 
Seat 7: jaworlegia (61589 in chips, $20 bounty) 
Seat 8: zKiPiSHz (85995 in chips, $112.50 bounty) 
NGNFuture: posts the ante 300
santiga: posts the ante 300
Bxutu_: posts the ante 300
k8ldykbala: posts the ante 300
born1407: posts the ante 300
jaworlegia: posts the ante 300
zKiPiSHz: posts the ante 300
jaworlegia: posts small blind 1000
zKiPiSHz: posts big blind 2000
*** HOLE CARDS ***
NGNFuture: folds 
santiga: folds 
Bxutu_: folds 
k8ldykbala: raises 2000 to 4000
born1407: folds 
jaworlegia: folds 
zKiPiSHz: raises 81695 to 85695 and is all-in
k8ldykbala: folds 
Uncalled bet (81695) returned to zKiPiSHz
zKiPiSHz collected 11100 from pot
zKiPiSHz: doesn't show hand 
*** SUMMARY ***
Total pot 11100 | Rake 0 
Seat 1: NGNFuture folded before Flop (didn't bet)
Seat 3: santiga folded before Flop (didn't bet)
Seat 4: Bxutu_ folded before Flop (didn't bet)
Seat 5: k8ldykbala folded before Flop
Seat 6: born1407 (button) folded before Flop (didn't bet)
Seat 7: jaworlegia (small blind) folded before Flop
Seat 8: zKiPiSHz (big blind) collected (11100)

PokerStars Hand #250528295263: Tournament #3754315429, $20+$20+$4 USD Hold'em No Limit - Level XXVI (1000/2000) - 2024/05/16 13:16:10 UTC [2024/05/16 9:16:10 ET]
Table '3754315429 3' 8-max Seat #6 is the button
Seat 1: NGNFuture (16587 in chips, $45 bounty) is sitting out
Seat 3: santiga (45775 in chips, $131.25 bounty) 
Seat 4: Bxutu_ (69222 in chips, $92.50 bounty) 
Seat 5: k8ldykbala (51142 in chips, $80 bounty) 
Seat 6: born1407 (63409 in chips, $142.50 bounty) 
Seat 7: jaworlegia (61589 in chips, $20 bounty) 
Seat 8: zKiPiSHz (85995 in chips, $112.50 bounty) 
NGNFuture: posts the ante 300
santiga: posts the ante 300
Bxutu_: posts the ante 300
k8ldykbala: posts the ante 300
born1407: posts the ante 300
jaworlegia: posts the ante 300
zKiPiSHz: posts the ante 300
jaworlegia: posts small blind 1000
zKiPiSHz: posts big blind 2000
*** HOLE CARDS ***
NGNFuture: folds 
santiga: folds 
Bxutu_: folds 
k8ldykbala: raises 2000 to 4000
born1407: folds 
jaworlegia: folds 
zKiPiSHz: raises 81695 to 85695 and is all-in
k8ldykbala: folds 
Uncalled bet (81695) returned to zKiPiSHz
zKiPiSHz collected 11100 from pot
zKiPiSHz: doesn't show hand 
*** SUMMARY ***
Total pot 11100 | Rake 0 
Seat 1: NGNFuture folded before Flop (didn't bet)
Seat 3: santiga folded before Flop (didn't bet)
Seat 4: Bxutu_ folded before Flop (didn't bet)
Seat 5: k8ldykbala folded before Flop
Seat 6: born1407 (button) folded before Flop (didn't bet)
Seat 7: jaworlegia (small blind) folded before Flop
Seat 8: zKiPiSHz (big blind) collected (11100)

PokerStars Hand #250528300623: Tournament #3754315429, $20+$20+$4 USD Hold'em No Limit - Level XXVI (1000/2000) - 2024/05/16 13:16:41 UTC [2024/05/16 9:16:41 ET]
Table '3754315429 3' 8-max Seat #7 is the button
Seat 1: NGNFuture (16287 in chips, $45 bounty) is sitting out
Seat 3: santiga (45475 in chips, $131.25 bounty) 
Seat 4: Bxutu_ (68922 in chips, $92.50 bounty) 
Seat 5: k8ldykbala (46842 in chips, $80 bounty) 
Seat 6: born1407 (63109 in chips, $142.50 bounty) 
Seat 7: jaworlegia (60289 in chips, $20 bounty) 
Seat 8: zKiPiSHz (92795 in chips, $112.50 bounty) 
NGNFuture: posts the ante 300
santiga: posts the ante 300
Bxutu_: posts the ante 300
k8ldykbala: posts the ante 300
born1407: posts the ante 300
jaworlegia: posts the ante 300
zKiPiSHz: posts the ante 300
zKiPiSHz: posts small blind 1000
NGNFuture: posts big blind 2000
*** HOLE CARDS ***
santiga: raises 2800 to 4800
Bxutu_: folds 
k8ldykbala: folds 
born1407: folds 
jaworlegia: folds 
zKiPiSHz: calls 3800
NGNFuture: folds 
*** FLOP *** [3s 4d Js]
zKiPiSHz: checks 
santiga: bets 5000
zKiPiSHz: folds 
Uncalled bet (5000) returned to santiga
santiga collected 13700 from pot
santiga: doesn't show hand 
*** SUMMARY ***
Total pot 13700 | Rake 0 
Board [3s 4d Js]
Seat 1: NGNFuture (big blind) folded before Flop
Seat 3: santiga collected (13700)
Seat 4: Bxutu_ folded before Flop (didn't bet)
Seat 5: k8ldykbala folded before Flop (didn't bet)
Seat 6: born1407 folded before Flop (didn't bet)
Seat 7: jaworlegia (button) folded before Flop (didn't bet)
Seat 8: zKiPiSHz (small blind) folded on the Flop

PokerStars Hand #250528300623: Tournament #3754315429, $20+$20+$4 USD Hold'em No Limit - Level XXVI (1000/2000) - 2024/05/16 13:16:41 UTC [2024/05/16 9:16:41 ET]
Table '3754315429 3' 8-max Seat #7 is the button
Seat 1: NGNFuture (16287 in chips, $45 bounty) is sitting out
Seat 3: santiga (45475 in chips, $131.25 bounty) 
Seat 4: Bxutu_ (68922 in chips, $92.50 bounty) 
Seat 5: k8ldykbala (46842 in chips, $80 bounty) 
Seat 6: born1407 (63109 in chips, $142.50 bounty) 
Seat 7: jaworlegia (60289 in chips, $20 bounty) 
Seat 8: zKiPiSHz (92795 in chips, $112.50 bounty) 
NGNFuture: posts the ante 300
santiga: posts the ante 300
Bxutu_: posts the ante 300
k8ldykbala: posts the ante 300
born1407: posts the ante 300
jaworlegia: posts the ante 300
zKiPiSHz: posts the ante 300
zKiPiSHz: posts small blind 1000
NGNFuture: posts big blind 2000
*** HOLE CARDS ***
santiga: raises 2800 to 4800
Bxutu_: folds 
k8ldykbala: folds 
born1407: folds 
jaworlegia: folds 
zKiPiSHz: calls 3800
NGNFuture: folds 
*** FLOP *** [3s 4d Js]
zKiPiSHz: checks 
santiga: bets 5000
zKiPiSHz: folds 
Uncalled bet (5000) returned to santiga
santiga collected 13700 from pot
santiga: doesn't show hand 
*** SUMMARY ***
Total pot 13700 | Rake 0 
Board [3s 4d Js]
Seat 1: NGNFuture (big blind) folded before Flop
Seat 3: santiga collected (13700)
Seat 4: Bxutu_ folded before Flop (didn't bet)
Seat 5: k8ldykbala folded before Flop (didn't bet)
Seat 6: born1407 folded before Flop (didn't bet)
Seat 7: jaworlegia (button) folded before Flop (didn't bet)
Seat 8: zKiPiSHz (small blind) folded on the Flop

PokerStars Hand #250528305827: Tournament #3754315429, $20+$20+$4 USD Hold'em No Limit - Level XXVI (1000/2000) - 2024/05/16 13:17:10 UTC [2024/05/16 9:17:10 ET]
Table '3754315429 3' 8-max Seat #8 is the button
Seat 1: NGNFuture (13987 in chips, $45 bounty) is sitting out
Seat 3: santiga (54075 in chips, $131.25 bounty) 
Seat 4: Bxutu_ (68622 in chips, $92.50 bounty) 
Seat 5: k8ldykbala (46542 in chips, $80 bounty) 
Seat 6: born1407 (62809 in chips, $142.50 bounty) 
Seat 7: jaworlegia (59989 in chips, $20 bounty) 
Seat 8: zKiPiSHz (87695 in chips, $112.50 bounty) 
NGNFuture: posts the ante 300
santiga: posts the ante 300
Bxutu_: posts the ante 300
k8ldykbala: posts the ante 300
born1407: posts the ante 300
jaworlegia: posts the ante 300
zKiPiSHz: posts the ante 300
NGNFuture: posts small blind 1000
santiga: posts big blind 2000
*** HOLE CARDS ***
Bxutu_: folds 
k8ldykbala: folds 
born1407: folds 
jaworlegia: folds 
zKiPiSHz: raises 2000 to 4000
NGNFuture: folds 
santiga: calls 2000
*** FLOP *** [9c 7s Qs]
santiga: checks 
zKiPiSHz: bets 7200
santiga: calls 7200
*** TURN *** [9c 7s Qs] [Ac]
santiga: checks 
zKiPiSHz: bets 10200
santiga: folds 
Uncalled bet (10200) returned to zKiPiSHz
zKiPiSHz collected 25500 from pot
zKiPiSHz: doesn't show hand 
*** SUMMARY ***
Total pot 25500 | Rake 0 
Board [9c 7s Qs Ac]
Seat 1: NGNFuture (small blind) folded before Flop
Seat 3: santiga (big blind) folded on the Turn
Seat 4: Bxutu_ folded before Flop (didn't bet)
Seat 5: k8ldykbala folded before Flop (didn't bet)
Seat 6: born1407 folded before Flop (didn't bet)
Seat 7: jaworlegia folded before Flop (didn't bet)
Seat 8: zKiPiSHz (button) collected (25500)

PokerStars Hand #250528305827: Tournament #3754315429, $20+$20+$4 USD Hold'em No Limit - Level XXVI (1000/2000) - 2024/05/16 13:17:10 UTC [2024/05/16 9:17:10 ET]
Table '3754315429 3' 8-max Seat #8 is the button
Seat 1: NGNFuture (13987 in chips, $45 bounty) is sitting out
Seat 3: santiga (54075 in chips, $131.25 bounty) 
Seat 4: Bxutu_ (68622 in chips, $92.50 bounty) 
Seat 5: k8ldykbala (46542 in chips, $80 bounty) 
Seat 6: born1407 (62809 in chips, $142.50 bounty) 
Seat 7: jaworlegia (59989 in chips, $20 bounty) 
Seat 8: zKiPiSHz (87695 in chips, $112.50 bounty) 
NGNFuture: posts the ante 300
santiga: posts the ante 300
Bxutu_: posts the ante 300
k8ldykbala: posts the ante 300
born1407: posts the ante 300
jaworlegia: posts the ante 300
zKiPiSHz: posts the ante 300
NGNFuture: posts small blind 1000
santiga: posts big blind 2000
*** HOLE CARDS ***
Bxutu_: folds 
k8ldykbala: folds 
born1407: folds 
jaworlegia: folds 
zKiPiSHz: raises 2000 to 4000
NGNFuture: folds 
santiga: calls 2000
*** FLOP *** [9c 7s Qs]
santiga: checks 
zKiPiSHz: bets 7200
santiga: calls 7200
*** TURN *** [9c 7s Qs] [Ac]
santiga: checks 
zKiPiSHz: bets 10200
santiga: folds 
Uncalled bet (10200) returned to zKiPiSHz
zKiPiSHz collected 25500 from pot
zKiPiSHz: doesn't show hand 
*** SUMMARY ***
Total pot 25500 | Rake 0 
Board [9c 7s Qs Ac]
Seat 1: NGNFuture (small blind) folded before Flop
Seat 3: santiga (big blind) folded on the Turn
Seat 4: Bxutu_ folded before Flop (didn't bet)
Seat 5: k8ldykbala folded before Flop (didn't bet)
Seat 6: born1407 folded before Flop (didn't bet)
Seat 7: jaworlegia folded before Flop (didn't bet)
Seat 8: zKiPiSHz (button) collected (25500)

PokerStars Hand #250528314869: Tournament #3754315429, $20+$20+$4 USD Hold'em No Limit - Level XXVI (1000/2000) - 2024/05/16 13:18:01 UTC [2024/05/16 9:18:01 ET]
Table '3754315429 3' 8-max Seat #1 is the button
Seat 1: NGNFuture (12687 in chips, $45 bounty) is sitting out
Seat 3: santiga (42575 in chips, $131.25 bounty) 
Seat 4: Bxutu_ (68322 in chips, $92.50 bounty) 
Seat 5: k8ldykbala (46242 in chips, $80 bounty) 
Seat 6: born1407 (62509 in chips, $142.50 bounty) 
Seat 7: jaworlegia (59689 in chips, $20 bounty) 
Seat 8: zKiPiSHz (101695 in chips, $112.50 bounty) 
NGNFuture: posts the ante 300
santiga: posts the ante 300
Bxutu_: posts the ante 300
k8ldykbala: posts the ante 300
born1407: posts the ante 300
jaworlegia: posts the ante 300
zKiPiSHz: posts the ante 300
santiga: posts small blind 1000
Bxutu_: posts big blind 2000
*** HOLE CARDS ***
k8ldykbala: folds 
born1407: folds 
jaworlegia: raises 2000 to 4000
zKiPiSHz: folds 
NGNFuture: folds 
santiga: folds 
Bxutu_: calls 2000
*** FLOP *** [5s 2h 7s]
Bxutu_: checks 
jaworlegia: checks 
*** TURN *** [5s 2h 7s] [6c]
Bxutu_: bets 8325
jaworlegia: folds 
Uncalled bet (8325) returned to Bxutu_
Bxutu_ collected 11100 from pot
Bxutu_: doesn't show hand 
*** SUMMARY ***
Total pot 11100 | Rake 0 
Board [5s 2h 7s 6c]
Seat 1: NGNFuture (button) folded before Flop (didn't bet)
Seat 3: santiga (small blind) folded before Flop
Seat 4: Bxutu_ (big blind) collected (11100)
Seat 5: k8ldykbala folded before Flop (didn't bet)
Seat 6: born1407 folded before Flop (didn't bet)
Seat 7: jaworlegia folded on the Turn
Seat 8: zKiPiSHz folded before Flop (didn't bet)

PokerStars Hand #250528314869: Tournament #3754315429, $20+$20+$4 USD Hold'em No Limit - Level XXVI (1000/2000) - 2024/05/16 13:18:01 UTC [2024/05/16 9:18:01 ET]
Table '3754315429 3' 8-max Seat #1 is the button
Seat 1: NGNFuture (12687 in chips, $45 bounty) is sitting out
Seat 3: santiga (42575 in chips, $131.25 bounty) 
Seat 4: Bxutu_ (68322 in chips, $92.50 bounty) 
Seat 5: k8ldykbala (46242 in chips, $80 bounty) 
Seat 6: born1407 (62509 in chips, $142.50 bounty) 
Seat 7: jaworlegia (59689 in chips, $20 bounty) 
Seat 8: zKiPiSHz (101695 in chips, $112.50 bounty) 
NGNFuture: posts the ante 300
santiga: posts the ante 300
Bxutu_: posts the ante 300
k8ldykbala: posts the ante 300
born1407: posts the ante 300
jaworlegia: posts the ante 300
zKiPiSHz: posts the ante 300
santiga: posts small blind 1000
Bxutu_: posts big blind 2000
*** HOLE CARDS ***
k8ldykbala: folds 
born1407: folds 
jaworlegia: raises 2000 to 4000
zKiPiSHz: folds 
NGNFuture: folds 
santiga: folds 
Bxutu_: calls 2000
*** FLOP *** [5s 2h 7s]
Bxutu_: checks 
jaworlegia: checks 
*** TURN *** [5s 2h 7s] [6c]
Bxutu_: bets 8325
jaworlegia: folds 
Uncalled bet (8325) returned to Bxutu_
Bxutu_ collected 11100 from pot
Bxutu_: doesn't show hand 
*** SUMMARY ***
Total pot 11100 | Rake 0 
Board [5s 2h 7s 6c]
Seat 1: NGNFuture (button) folded before Flop (didn't bet)
Seat 3: santiga (small blind) folded before Flop
Seat 4: Bxutu_ (big blind) collected (11100)
Seat 5: k8ldykbala folded before Flop (didn't bet)
Seat 6: born1407 folded before Flop (didn't bet)
Seat 7: jaworlegia folded on the Turn
Seat 8: zKiPiSHz folded before Flop (didn't bet)

PokerStars Hand #250528323687: Tournament #3754315429, $20+$20+$4 USD Hold'em No Limit - Level XXVI (1000/2000) - 2024/05/16 13:18:51 UTC [2024/05/16 9:18:51 ET]
Table '3754315429 3' 8-max Seat #3 is the button
Seat 1: NGNFuture (12387 in chips, $45 bounty) is sitting out
Seat 3: santiga (41275 in chips, $131.25 bounty) 
Seat 4: Bxutu_ (75122 in chips, $92.50 bounty) 
Seat 5: k8ldykbala (45942 in chips, $80 bounty) 
Seat 6: born1407 (62209 in chips, $142.50 bounty) 
Seat 7: jaworlegia (55389 in chips, $20 bounty) 
Seat 8: zKiPiSHz (101395 in chips, $112.50 bounty) 
NGNFuture: posts the ante 300
santiga: posts the ante 300
Bxutu_: posts the ante 300
k8ldykbala: posts the ante 300
born1407: posts the ante 300
jaworlegia: posts the ante 300
zKiPiSHz: posts the ante 300
Bxutu_: posts small blind 1000
k8ldykbala: posts big blind 2000
*** HOLE CARDS ***
born1407: folds 
jaworlegia: folds 
zKiPiSHz: raises 2000 to 4000
NGNFuture: folds 
santiga: folds 
Bxutu_: folds 
k8ldykbala: folds 
Uncalled bet (2000) returned to zKiPiSHz
zKiPiSHz collected 7100 from pot
zKiPiSHz: doesn't show hand 
*** SUMMARY ***
Total pot 7100 | Rake 0 
Seat 1: NGNFuture folded before Flop (didn't bet)
Seat 3: santiga (button) folded before Flop (didn't bet)
Seat 4: Bxutu_ (small blind) folded before Flop
Seat 5: k8ldykbala (big blind) folded before Flop
Seat 6: born1407 folded before Flop (didn't bet)
Seat 7: jaworlegia folded before Flop (didn't bet)
Seat 8: zKiPiSHz collected (7100)

PokerStars Hand #250528323687: Tournament #3754315429, $20+$20+$4 USD Hold'em No Limit - Level XXVI (1000/2000) - 2024/05/16 13:18:51 UTC [2024/05/16 9:18:51 ET]
Table '3754315429 3' 8-max Seat #3 is the button
Seat 1: NGNFuture (12387 in chips, $45 bounty) is sitting out
Seat 3: santiga (41275 in chips, $131.25 bounty) 
Seat 4: Bxutu_ (75122 in chips, $92.50 bounty) 
Seat 5: k8ldykbala (45942 in chips, $80 bounty) 
Seat 6: born1407 (62209 in chips, $142.50 bounty) 
Seat 7: jaworlegia (55389 in chips, $20 bounty) 
Seat 8: zKiPiSHz (101395 in chips, $112.50 bounty) 
NGNFuture: posts the ante 300
santiga: posts the ante 300
Bxutu_: posts the ante 300
k8ldykbala: posts the ante 300
born1407: posts the ante 300
jaworlegia: posts the ante 300
zKiPiSHz: posts the ante 300
Bxutu_: posts small blind 1000
k8ldykbala: posts big blind 2000
*** HOLE CARDS ***
born1407: folds 
jaworlegia: folds 
zKiPiSHz: raises 2000 to 4000
NGNFuture: folds 
santiga: folds 
Bxutu_: folds 
k8ldykbala: folds 
Uncalled bet (2000) returned to zKiPiSHz
zKiPiSHz collected 7100 from pot
zKiPiSHz: doesn't show hand 
*** SUMMARY ***
Total pot 7100 | Rake 0 
Seat 1: NGNFuture folded before Flop (didn't bet)
Seat 3: santiga (button) folded before Flop (didn't bet)
Seat 4: Bxutu_ (small blind) folded before Flop
Seat 5: k8ldykbala (big blind) folded before Flop
Seat 6: born1407 folded before Flop (didn't bet)
Seat 7: jaworlegia folded before Flop (didn't bet)
Seat 8: zKiPiSHz collected (7100)

PokerStars Hand #250528329353: Tournament #3754315429, $20+$20+$4 USD Hold'em No Limit - Level XXVI (1000/2000) - 2024/05/16 13:19:22 UTC [2024/05/16 9:19:22 ET]
Table '3754315429 3' 8-max Seat #4 is the button
Seat 1: NGNFuture (12087 in chips, $45 bounty) is sitting out
Seat 3: santiga (40975 in chips, $131.25 bounty) 
Seat 4: Bxutu_ (73822 in chips, $92.50 bounty) 
Seat 5: k8ldykbala (43642 in chips, $80 bounty) 
Seat 6: born1407 (61909 in chips, $142.50 bounty) 
Seat 7: jaworlegia (55089 in chips, $20 bounty) 
Seat 8: zKiPiSHz (106195 in chips, $112.50 bounty) 
NGNFuture: posts the ante 300
santiga: posts the ante 300
Bxutu_: posts the ante 300
k8ldykbala: posts the ante 300
born1407: posts the ante 300
jaworlegia: posts the ante 300
zKiPiSHz: posts the ante 300
k8ldykbala: posts small blind 1000
born1407: posts big blind 2000
*** HOLE CARDS ***
jaworlegia: folds 
zKiPiSHz: raises 2000 to 4000
NGNFuture: folds 
santiga: folds 
Bxutu_: calls 4000
k8ldykbala: folds 
born1407: folds 
*** FLOP *** [2h 3d Ad]
zKiPiSHz: checks 
Bxutu_: bets 3275
zKiPiSHz: calls 3275
*** TURN *** [2h 3d Ad] [5s]
zKiPiSHz: checks 
Bxutu_: bets 14738
zKiPiSHz: calls 14738
*** RIVER *** [2h 3d Ad 5s] [Th]
zKiPiSHz: checks 
Bxutu_: bets 51509 and is all-in
zKiPiSHz: calls 51509
*** SHOW DOWN ***
Bxutu_: shows [5h 5d] (three of a kind, Fives)
zKiPiSHz: shows [7d As] (a pair of Aces)
Bxutu_ collected 152144 from pot
*** SUMMARY ***
Total pot 152144 | Rake 0 
Board [2h 3d Ad 5s Th]
Seat 1: NGNFuture folded before Flop (didn't bet)
Seat 3: santiga folded before Flop (didn't bet)
Seat 4: Bxutu_ (button) showed [5h 5d] and won (152144) with three of a kind, Fives
Seat 5: k8ldykbala (small blind) folded before Flop
Seat 6: born1407 (big blind) folded before Flop
Seat 7: jaworlegia folded before Flop (didn't bet)
Seat 8: zKiPiSHz showed [7d As] and lost with a pair of Aces

PokerStars Hand #250528329353: Tournament #3754315429, $20+$20+$4 USD Hold'em No Limit - Level XXVI (1000/2000) - 2024/05/16 13:19:22 UTC [2024/05/16 9:19:22 ET]
Table '3754315429 3' 8-max Seat #4 is the button
Seat 1: NGNFuture (12087 in chips, $45 bounty) is sitting out
Seat 3: santiga (40975 in chips, $131.25 bounty) 
Seat 4: Bxutu_ (73822 in chips, $92.50 bounty) 
Seat 5: k8ldykbala (43642 in chips, $80 bounty) 
Seat 6: born1407 (61909 in chips, $142.50 bounty) 
Seat 7: jaworlegia (55089 in chips, $20 bounty) 
Seat 8: zKiPiSHz (106195 in chips, $112.50 bounty) 
NGNFuture: posts the ante 300
santiga: posts the ante 300
Bxutu_: posts the ante 300
k8ldykbala: posts the ante 300
born1407: posts the ante 300
jaworlegia: posts the ante 300
zKiPiSHz: posts the ante 300
k8ldykbala: posts small blind 1000
born1407: posts big blind 2000
*** HOLE CARDS ***
jaworlegia: folds 
zKiPiSHz: raises 2000 to 4000
NGNFuture: folds 
santiga: folds 
Bxutu_: calls 4000
k8ldykbala: folds 
born1407: folds 
*** FLOP *** [2h 3d Ad]
zKiPiSHz: checks 
Bxutu_: bets 3275
zKiPiSHz: calls 3275
*** TURN *** [2h 3d Ad] [5s]
zKiPiSHz: checks 
Bxutu_: bets 14738
zKiPiSHz: calls 14738
*** RIVER *** [2h 3d Ad 5s] [Th]
zKiPiSHz: checks 
Bxutu_: bets 51509 and is all-in
zKiPiSHz: calls 51509
*** SHOW DOWN ***
Bxutu_: shows [5h 5d] (three of a kind, Fives)
zKiPiSHz: shows [7d As] (a pair of Aces)
Bxutu_ collected 152144 from pot
*** SUMMARY ***
Total pot 152144 | Rake 0 
Board [2h 3d Ad 5s Th]
Seat 1: NGNFuture folded before Flop (didn't bet)
Seat 3: santiga folded before Flop (didn't bet)
Seat 4: Bxutu_ (button) showed [5h 5d] and won (152144) with three of a kind, Fives
Seat 5: k8ldykbala (small blind) folded before Flop
Seat 6: born1407 (big blind) folded before Flop
Seat 7: jaworlegia folded before Flop (didn't bet)
Seat 8: zKiPiSHz showed [7d As] and lost with a pair of Aces

PokerStars Hand #250528340400: Tournament #3754315429, $20+$20+$4 USD Hold'em No Limit - Level XXVI (1000/2000) - 2024/05/16 13:20:24 UTC [2024/05/16 9:20:24 ET]
Table '3754315429 3' 8-max Seat #5 is the button
Seat 1: NGNFuture (11787 in chips, $45 bounty) is sitting out
Seat 3: santiga (40675 in chips, $131.25 bounty) 
Seat 4: Bxutu_ (152144 in chips, $92.50 bounty) 
Seat 5: k8ldykbala (42342 in chips, $80 bounty) 
Seat 6: born1407 (59609 in chips, $142.50 bounty) 
Seat 7: jaworlegia (54789 in chips, $20 bounty) 
Seat 8: zKiPiSHz (32373 in chips, $112.50 bounty) 
NGNFuture: posts the ante 300
santiga: posts the ante 300
Bxutu_: posts the ante 300
k8ldykbala: posts the ante 300
born1407: posts the ante 300
jaworlegia: posts the ante 300
zKiPiSHz: posts the ante 300
born1407: posts small blind 1000
jaworlegia: posts big blind 2000
*** HOLE CARDS ***
zKiPiSHz: folds 
NGNFuture: folds 
santiga: folds 
Bxutu_: folds 
k8ldykbala: raises 2000 to 4000
born1407: raises 8000 to 12000
jaworlegia: folds 
k8ldykbala: folds 
Uncalled bet (8000) returned to born1407
born1407 collected 12100 from pot
born1407: doesn't show hand 
*** SUMMARY ***
Total pot 12100 | Rake 0 
Seat 1: NGNFuture folded before Flop (didn't bet)
Seat 3: santiga folded before Flop (didn't bet)
Seat 4: Bxutu_ folded before Flop (didn't bet)
Seat 5: k8ldykbala (button) folded before Flop
Seat 6: born1407 (small blind) collected (12100)
Seat 7: jaworlegia (big blind) folded before Flop
Seat 8: zKiPiSHz folded before Flop (didn't bet)

PokerStars Hand #250528340400: Tournament #3754315429, $20+$20+$4 USD Hold'em No Limit - Level XXVI (1000/2000) - 2024/05/16 13:20:24 UTC [2024/05/16 9:20:24 ET]
Table '3754315429 3' 8-max Seat #5 is the button
Seat 1: NGNFuture (11787 in chips, $45 bounty) is sitting out
Seat 3: santiga (40675 in chips, $131.25 bounty) 
Seat 4: Bxutu_ (152144 in chips, $92.50 bounty) 
Seat 5: k8ldykbala (42342 in chips, $80 bounty) 
Seat 6: born1407 (59609 in chips, $142.50 bounty) 
Seat 7: jaworlegia (54789 in chips, $20 bounty) 
Seat 8: zKiPiSHz (32373 in chips, $112.50 bounty) 
NGNFuture: posts the ante 300
santiga: posts the ante 300
Bxutu_: posts the ante 300
k8ldykbala: posts the ante 300
born1407: posts the ante 300
jaworlegia: posts the ante 300
zKiPiSHz: posts the ante 300
born1407: posts small blind 1000
jaworlegia: posts big blind 2000
*** HOLE CARDS ***
zKiPiSHz: folds 
NGNFuture: folds 
santiga: folds 
Bxutu_: folds 
k8ldykbala: raises 2000 to 4000
born1407: raises 8000 to 12000
jaworlegia: folds 
k8ldykbala: folds 
Uncalled bet (8000) returned to born1407
born1407 collected 12100 from pot
born1407: doesn't show hand 
*** SUMMARY ***
Total pot 12100 | Rake 0 
Seat 1: NGNFuture folded before Flop (didn't bet)
Seat 3: santiga folded before Flop (didn't bet)
Seat 4: Bxutu_ folded before Flop (didn't bet)
Seat 5: k8ldykbala (button) folded before Flop
Seat 6: born1407 (small blind) collected (12100)
Seat 7: jaworlegia (big blind) folded before Flop
Seat 8: zKiPiSHz folded before Flop (didn't bet)

PokerStars Hand #250528349534: Tournament #3754315429, $20+$20+$4 USD Hold'em No Limit - Level XXVI (1000/2000) - 2024/05/16 13:21:16 UTC [2024/05/16 9:21:16 ET]
Table '3754315429 3' 8-max Seat #6 is the button
Seat 1: NGNFuture (11487 in chips, $45 bounty) is sitting out
Seat 3: santiga (40375 in chips, $131.25 bounty) 
Seat 4: Bxutu_ (151844 in chips, $92.50 bounty) 
Seat 5: k8ldykbala (38042 in chips, $80 bounty) 
Seat 6: born1407 (67409 in chips, $142.50 bounty) 
Seat 7: jaworlegia (52489 in chips, $20 bounty) 
Seat 8: zKiPiSHz (32073 in chips, $112.50 bounty) 
NGNFuture: posts the ante 300
santiga: posts the ante 300
Bxutu_: posts the ante 300
k8ldykbala: posts the ante 300
born1407: posts the ante 300
jaworlegia: posts the ante 300
zKiPiSHz: posts the ante 300
jaworlegia: posts small blind 1000
zKiPiSHz: posts big blind 2000
*** HOLE CARDS ***
NGNFuture: folds 
santiga: folds 
Bxutu_: raises 2300 to 4300
k8ldykbala: folds 
born1407: folds 
jaworlegia: folds 
zKiPiSHz: calls 2300
*** FLOP *** [Ks Qc Kd]
zKiPiSHz: checks 
Bxutu_: bets 2000
zKiPiSHz: calls 2000
*** TURN *** [Ks Qc Kd] [5h]
zKiPiSHz: checks 
Bxutu_: checks 
*** RIVER *** [Ks Qc Kd 5h] [9s]
zKiPiSHz: checks 
Bxutu_: checks 
*** SHOW DOWN ***
zKiPiSHz: shows [Qd Js] (two pair, Kings and Queens)
Bxutu_: mucks hand 
zKiPiSHz collected 15700 from pot
*** SUMMARY ***
Total pot 15700 | Rake 0 
Board [Ks Qc Kd 5h 9s]
Seat 1: NGNFuture folded before Flop (didn't bet)
Seat 3: santiga folded before Flop (didn't bet)
Seat 4: Bxutu_ mucked
Seat 5: k8ldykbala folded before Flop (didn't bet)
Seat 6: born1407 (button) folded before Flop (didn't bet)
Seat 7: jaworlegia (small blind) folded before Flop
Seat 8: zKiPiSHz (big blind) showed [Qd Js] and won (15700) with two pair, Kings and Queens

PokerStars Hand #250528349534: Tournament #3754315429, $20+$20+$4 USD Hold'em No Limit - Level XXVI (1000/2000) - 2024/05/16 13:21:16 UTC [2024/05/16 9:21:16 ET]
Table '3754315429 3' 8-max Seat #6 is the button
Seat 1: NGNFuture (11487 in chips, $45 bounty) is sitting out
Seat 3: santiga (40375 in chips, $131.25 bounty) 
Seat 4: Bxutu_ (151844 in chips, $92.50 bounty) 
Seat 5: k8ldykbala (38042 in chips, $80 bounty) 
Seat 6: born1407 (67409 in chips, $142.50 bounty) 
Seat 7: jaworlegia (52489 in chips, $20 bounty) 
Seat 8: zKiPiSHz (32073 in chips, $112.50 bounty) 
NGNFuture: posts the ante 300
santiga: posts the ante 300
Bxutu_: posts the ante 300
k8ldykbala: posts the ante 300
born1407: posts the ante 300
jaworlegia: posts the ante 300
zKiPiSHz: posts the ante 300
jaworlegia: posts small blind 1000
zKiPiSHz: posts big blind 2000
*** HOLE CARDS ***
NGNFuture: folds 
santiga: folds 
Bxutu_: raises 2300 to 4300
k8ldykbala: folds 
born1407: folds 
jaworlegia: folds 
zKiPiSHz: calls 2300
*** FLOP *** [Ks Qc Kd]
zKiPiSHz: checks 
Bxutu_: bets 2000
zKiPiSHz: calls 2000
*** TURN *** [Ks Qc Kd] [5h]
zKiPiSHz: checks 
Bxutu_: checks 
*** RIVER *** [Ks Qc Kd 5h] [9s]
zKiPiSHz: checks 
Bxutu_: checks 
*** SHOW DOWN ***
zKiPiSHz: shows [Qd Js] (two pair, Kings and Queens)
Bxutu_: mucks hand 
zKiPiSHz collected 15700 from pot
*** SUMMARY ***
Total pot 15700 | Rake 0 
Board [Ks Qc Kd 5h 9s]
Seat 1: NGNFuture folded before Flop (didn't bet)
Seat 3: santiga folded before Flop (didn't bet)
Seat 4: Bxutu_ mucked
Seat 5: k8ldykbala folded before Flop (didn't bet)
Seat 6: born1407 (button) folded before Flop (didn't bet)
Seat 7: jaworlegia (small blind) folded before Flop
Seat 8: zKiPiSHz (big blind) showed [Qd Js] and won (15700) with two pair, Kings and Queens

PokerStars Hand #250528357734: Tournament #3754315429, $20+$20+$4 USD Hold'em No Limit - Level XXVI (1000/2000) - 2024/05/16 13:22:02 UTC [2024/05/16 9:22:02 ET]
Table '3754315429 3' 8-max Seat #7 is the button
Seat 1: NGNFuture (11187 in chips, $45 bounty) is sitting out
Seat 3: santiga (40075 in chips, $131.25 bounty) 
Seat 4: Bxutu_ (145244 in chips, $92.50 bounty) 
Seat 5: k8ldykbala (37742 in chips, $80 bounty) 
Seat 6: born1407 (67109 in chips, $142.50 bounty) 
Seat 7: jaworlegia (51189 in chips, $20 bounty) 
Seat 8: zKiPiSHz (41173 in chips, $112.50 bounty) 
NGNFuture: posts the ante 300
santiga: posts the ante 300
Bxutu_: posts the ante 300
k8ldykbala: posts the ante 300
born1407: posts the ante 300
jaworlegia: posts the ante 300
zKiPiSHz: posts the ante 300
zKiPiSHz: posts small blind 1000
NGNFuture: posts big blind 2000
*** HOLE CARDS ***
santiga: folds 
Bxutu_: raises 2300 to 4300
k8ldykbala: folds 
born1407: folds 
jaworlegia: folds 
zKiPiSHz: raises 36573 to 40873 and is all-in
NGNFuture: folds 
Bxutu_: calls 36573
*** FLOP *** [8h 7s Qs]
*** TURN *** [8h 7s Qs] [6h]
*** RIVER *** [8h 7s Qs 6h] [5h]
*** SHOW DOWN ***
zKiPiSHz: shows [As 2h] (high card Ace)
Bxutu_: shows [Ts Td] (a pair of Tens)
Bxutu_ collected 85846 from pot
Bxutu_ wins $56.25 for eliminating zKiPiSHz and their own bounty increases by $56.25 to $148.75
zKiPiSHz finished the tournament in 13th place and received $57.16.
*** SUMMARY ***
Total pot 85846 | Rake 0 
Board [8h 7s Qs 6h 5h]
Seat 1: NGNFuture (big blind) folded before Flop
Seat 3: santiga folded before Flop (didn't bet)
Seat 4: Bxutu_ showed [Ts Td] and won (85846) with a pair of Tens
Seat 5: k8ldykbala folded before Flop (didn't bet)
Seat 6: born1407 folded before Flop (didn't bet)
Seat 7: jaworlegia (button) folded before Flop (didn't bet)
Seat 8: zKiPiSHz (small blind) showed [As 2h] and lost with high card Ace

PokerStars Hand #250528357734: Tournament #3754315429, $20+$20+$4 USD Hold'em No Limit - Level XXVI (1000/2000) - 2024/05/16 13:22:02 UTC [2024/05/16 9:22:02 ET]
Table '3754315429 3' 8-max Seat #7 is the button
Seat 1: NGNFuture (11187 in chips, $45 bounty) is sitting out
Seat 3: santiga (40075 in chips, $131.25 bounty) 
Seat 4: Bxutu_ (145244 in chips, $92.50 bounty) 
Seat 5: k8ldykbala (37742 in chips, $80 bounty) 
Seat 6: born1407 (67109 in chips, $142.50 bounty) 
Seat 7: jaworlegia (51189 in chips, $20 bounty) 
Seat 8: zKiPiSHz (41173 in chips, $112.50 bounty) 
NGNFuture: posts the ante 300
santiga: posts the ante 300
Bxutu_: posts the ante 300
k8ldykbala: posts the ante 300
born1407: posts the ante 300
jaworlegia: posts the ante 300
zKiPiSHz: posts the ante 300
zKiPiSHz: posts small blind 1000
NGNFuture: posts big blind 2000
*** HOLE CARDS ***
santiga: folds 
Bxutu_: raises 2300 to 4300
k8ldykbala: folds 
born1407: folds 
jaworlegia: folds 
zKiPiSHz: raises 36573 to 40873 and is all-in
NGNFuture: folds 
Bxutu_: calls 36573
*** FLOP *** [8h 7s Qs]
*** TURN *** [8h 7s Qs] [6h]
*** RIVER *** [8h 7s Qs 6h] [5h]
*** SHOW DOWN ***
zKiPiSHz: shows [As 2h] (high card Ace)
Bxutu_: shows [Ts Td] (a pair of Tens)
Bxutu_ collected 85846 from pot
Bxutu_ wins $56.25 for eliminating zKiPiSHz and their own bounty increases by $56.25 to $148.75
zKiPiSHz finished the tournament in 13th place and received $57.16.
*** SUMMARY ***
Total pot 85846 | Rake 0 
Board [8h 7s Qs 6h 5h]
Seat 1: NGNFuture (big blind) folded before Flop
Seat 3: santiga folded before Flop (didn't bet)
Seat 4: Bxutu_ showed [Ts Td] and won (85846) with a pair of Tens
Seat 5: k8ldykbala folded before Flop (didn't bet)
Seat 6: born1407 folded before Flop (didn't bet)
Seat 7: jaworlegia (button) folded before Flop (didn't bet)
Seat 8: zKiPiSHz (small blind) showed [As 2h] and lost with high card Ace

PokerStars Hand #250528362890: Tournament #3754315429, $20+$20+$4 USD Hold'em No Limit - Level XXVI (1000/2000) - 2024/05/16 13:22:31 UTC [2024/05/16 9:22:31 ET]
Table '3754315429 3' 8-max Seat #1 is the button
Seat 1: NGNFuture (8887 in chips, $45 bounty) is sitting out
Seat 3: santiga (39775 in chips, $131.25 bounty) 
Seat 4: Bxutu_ (189917 in chips, $148.75 bounty) 
Seat 5: k8ldykbala (37442 in chips, $80 bounty) 
Seat 6: born1407 (66809 in chips, $142.50 bounty) 
Seat 7: jaworlegia (50889 in chips, $20 bounty) 
NGNFuture: posts the ante 300
santiga: posts the ante 300
Bxutu_: posts the ante 300
k8ldykbala: posts the ante 300
born1407: posts the ante 300
jaworlegia: posts the ante 300
santiga: posts small blind 1000
Bxutu_: posts big blind 2000
*** HOLE CARDS ***
k8ldykbala: folds 
born1407: folds 
jaworlegia: folds 
NGNFuture: folds 
santiga: folds 
Uncalled bet (1000) returned to Bxutu_
Bxutu_ collected 3800 from pot
Bxutu_: doesn't show hand 
*** SUMMARY ***
Total pot 3800 | Rake 0 
Seat 1: NGNFuture (button) folded before Flop (didn't bet)
Seat 3: santiga (small blind) folded before Flop
Seat 4: Bxutu_ (big blind) collected (3800)
Seat 5: k8ldykbala folded before Flop (didn't bet)
Seat 6: born1407 folded before Flop (didn't bet)
Seat 7: jaworlegia folded before Flop (didn't bet)

PokerStars Hand #250528362890: Tournament #3754315429, $20+$20+$4 USD Hold'em No Limit - Level XXVI (1000/2000) - 2024/05/16 13:22:31 UTC [2024/05/16 9:22:31 ET]
Table '3754315429 3' 8-max Seat #1 is the button
Seat 1: NGNFuture (8887 in chips, $45 bounty) is sitting out
Seat 3: santiga (39775 in chips, $131.25 bounty) 
Seat 4: Bxutu_ (189917 in chips, $148.75 bounty) 
Seat 5: k8ldykbala (37442 in chips, $80 bounty) 
Seat 6: born1407 (66809 in chips, $142.50 bounty) 
Seat 7: jaworlegia (50889 in chips, $20 bounty) 
NGNFuture: posts the ante 300
santiga: posts the ante 300
Bxutu_: posts the ante 300
k8ldykbala: posts the ante 300
born1407: posts the ante 300
jaworlegia: posts the ante 300
santiga: posts small blind 1000
Bxutu_: posts big blind 2000
*** HOLE CARDS ***
k8ldykbala: folds 
born1407: folds 
jaworlegia: folds 
NGNFuture: folds 
santiga: folds 
Uncalled bet (1000) returned to Bxutu_
Bxutu_ collected 3800 from pot
Bxutu_: doesn't show hand 
*** SUMMARY ***
Total pot 3800 | Rake 0 
Seat 1: NGNFuture (button) folded before Flop (didn't bet)
Seat 3: santiga (small blind) folded before Flop
Seat 4: Bxutu_ (big blind) collected (3800)
Seat 5: k8ldykbala folded before Flop (didn't bet)
Seat 6: born1407 folded before Flop (didn't bet)
Seat 7: jaworlegia folded before Flop (didn't bet)

PokerStars Hand #250528366112: Tournament #3754315429, $20+$20+$4 USD Hold'em No Limit - Level XXVI (1000/2000) - 2024/05/16 13:22:49 UTC [2024/05/16 9:22:49 ET]
Table '3754315429 3' 8-max Seat #3 is the button
Seat 1: NGNFuture (8587 in chips, $45 bounty) is sitting out
Seat 3: santiga (38475 in chips, $131.25 bounty) 
Seat 4: Bxutu_ (192417 in chips, $148.75 bounty) 
Seat 5: k8ldykbala (37142 in chips, $80 bounty) 
Seat 6: born1407 (66509 in chips, $142.50 bounty) 
Seat 7: jaworlegia (50589 in chips, $20 bounty) 
NGNFuture: posts the ante 300
santiga: posts the ante 300
Bxutu_: posts the ante 300
k8ldykbala: posts the ante 300
born1407: posts the ante 300
jaworlegia: posts the ante 300
Bxutu_: posts small blind 1000
k8ldykbala: posts big blind 2000
*** HOLE CARDS ***
born1407: folds 
jaworlegia: folds 
NGNFuture: folds 
santiga: folds 
Bxutu_: calls 1000
k8ldykbala: raises 34842 to 36842 and is all-in
Bxutu_: folds 
Uncalled bet (34842) returned to k8ldykbala
k8ldykbala collected 5800 from pot
k8ldykbala: doesn't show hand 
*** SUMMARY ***
Total pot 5800 | Rake 0 
Seat 1: NGNFuture folded before Flop (didn't bet)
Seat 3: santiga (button) folded before Flop (didn't bet)
Seat 4: Bxutu_ (small blind) folded before Flop
Seat 5: k8ldykbala (big blind) collected (5800)
Seat 6: born1407 folded before Flop (didn't bet)
Seat 7: jaworlegia folded before Flop (didn't bet)

PokerStars Hand #250528366112: Tournament #3754315429, $20+$20+$4 USD Hold'em No Limit - Level XXVI (1000/2000) - 2024/05/16 13:22:49 UTC [2024/05/16 9:22:49 ET]
Table '3754315429 3' 8-max Seat #3 is the button
Seat 1: NGNFuture (8587 in chips, $45 bounty) is sitting out
Seat 3: santiga (38475 in chips, $131.25 bounty) 
Seat 4: Bxutu_ (192417 in chips, $148.75 bounty) 
Seat 5: k8ldykbala (37142 in chips, $80 bounty) 
Seat 6: born1407 (66509 in chips, $142.50 bounty) 
Seat 7: jaworlegia (50589 in chips, $20 bounty) 
NGNFuture: posts the ante 300
santiga: posts the ante 300
Bxutu_: posts the ante 300
k8ldykbala: posts the ante 300
born1407: posts the ante 300
jaworlegia: posts the ante 300
Bxutu_: posts small blind 1000
k8ldykbala: posts big blind 2000
*** HOLE CARDS ***
born1407: folds 
jaworlegia: folds 
NGNFuture: folds 
santiga: folds 
Bxutu_: calls 1000
k8ldykbala: raises 34842 to 36842 and is all-in
Bxutu_: folds 
Uncalled bet (34842) returned to k8ldykbala
k8ldykbala collected 5800 from pot
k8ldykbala: doesn't show hand 
*** SUMMARY ***
Total pot 5800 | Rake 0 
Seat 1: NGNFuture folded before Flop (didn't bet)
Seat 3: santiga (button) folded before Flop (didn't bet)
Seat 4: Bxutu_ (small blind) folded before Flop
Seat 5: k8ldykbala (big blind) collected (5800)
Seat 6: born1407 folded before Flop (didn't bet)
Seat 7: jaworlegia folded before Flop (didn't bet)

PokerStars Hand #250528370465: Tournament #3754315429, $20+$20+$4 USD Hold'em No Limit - Level XXVI (1000/2000) - 2024/05/16 13:23:14 UTC [2024/05/16 9:23:14 ET]
Table '3754315429 3' 8-max Seat #4 is the button
Seat 1: NGNFuture (8287 in chips, $45 bounty) is sitting out
Seat 3: santiga (38175 in chips, $131.25 bounty) 
Seat 4: Bxutu_ (190117 in chips, $148.75 bounty) 
Seat 5: k8ldykbala (40642 in chips, $80 bounty) 
Seat 6: born1407 (66209 in chips, $142.50 bounty) 
Seat 7: jaworlegia (50289 in chips, $20 bounty) 
NGNFuture: posts the ante 300
santiga: posts the ante 300
Bxutu_: posts the ante 300
k8ldykbala: posts the ante 300
born1407: posts the ante 300
jaworlegia: posts the ante 300
k8ldykbala: posts small blind 1000
born1407: posts big blind 2000
*** HOLE CARDS ***
jaworlegia: folds 
NGNFuture: folds 
santiga: folds 
Bxutu_: raises 2300 to 4300
k8ldykbala: raises 36042 to 40342 and is all-in
born1407: folds 
Bxutu_: folds 
Uncalled bet (36042) returned to k8ldykbala
k8ldykbala collected 12400 from pot
k8ldykbala: doesn't show hand 
*** SUMMARY ***
Total pot 12400 | Rake 0 
Seat 1: NGNFuture folded before Flop (didn't bet)
Seat 3: santiga folded before Flop (didn't bet)
Seat 4: Bxutu_ (button) folded before Flop
Seat 5: k8ldykbala (small blind) collected (12400)
Seat 6: born1407 (big blind) folded before Flop
Seat 7: jaworlegia folded before Flop (didn't bet)

PokerStars Hand #250528370465: Tournament #3754315429, $20+$20+$4 USD Hold'em No Limit - Level XXVI (1000/2000) - 2024/05/16 13:23:14 UTC [2024/05/16 9:23:14 ET]
Table '3754315429 3' 8-max Seat #4 is the button
Seat 1: NGNFuture (8287 in chips, $45 bounty) is sitting out
Seat 3: santiga (38175 in chips, $131.25 bounty) 
Seat 4: Bxutu_ (190117 in chips, $148.75 bounty) 
Seat 5: k8ldykbala (40642 in chips, $80 bounty) 
Seat 6: born1407 (66209 in chips, $142.50 bounty) 
Seat 7: jaworlegia (50289 in chips, $20 bounty) 
NGNFuture: posts the ante 300
santiga: posts the ante 300
Bxutu_: posts the ante 300
k8ldykbala: posts the ante 300
born1407: posts the ante 300
jaworlegia: posts the ante 300
k8ldykbala: posts small blind 1000
born1407: posts big blind 2000
*** HOLE CARDS ***
jaworlegia: folds 
NGNFuture: folds 
santiga: folds 
Bxutu_: raises 2300 to 4300
k8ldykbala: raises 36042 to 40342 and is all-in
born1407: folds 
Bxutu_: folds 
Uncalled bet (36042) returned to k8ldykbala
k8ldykbala collected 12400 from pot
k8ldykbala: doesn't show hand 
*** SUMMARY ***
Total pot 12400 | Rake 0 
Seat 1: NGNFuture folded before Flop (didn't bet)
Seat 3: santiga folded before Flop (didn't bet)
Seat 4: Bxutu_ (button) folded before Flop
Seat 5: k8ldykbala (small blind) collected (12400)
Seat 6: born1407 (big blind) folded before Flop
Seat 7: jaworlegia folded before Flop (didn't bet)

PokerStars Hand #250528375160: Tournament #3754315429, $20+$20+$4 USD Hold'em No Limit - Level XXVI (1000/2000) - 2024/05/16 13:23:40 UTC [2024/05/16 9:23:40 ET]
Table '3754315429 3' 8-max Seat #5 is the button
Seat 1: NGNFuture (7987 in chips, $45 bounty) is sitting out
Seat 3: santiga (37875 in chips, $131.25 bounty) 
Seat 4: Bxutu_ (185517 in chips, $148.75 bounty) 
Seat 5: k8ldykbala (48442 in chips, $80 bounty) 
Seat 6: born1407 (63909 in chips, $142.50 bounty) 
Seat 7: jaworlegia (49989 in chips, $20 bounty) 
NGNFuture: posts the ante 300
santiga: posts the ante 300
Bxutu_: posts the ante 300
k8ldykbala: posts the ante 300
born1407: posts the ante 300
jaworlegia: posts the ante 300
born1407: posts small blind 1000
jaworlegia: posts big blind 2000
*** HOLE CARDS ***
NGNFuture: folds 
santiga: raises 2800 to 4800
Bxutu_: folds 
k8ldykbala: folds 
born1407: folds 
jaworlegia: calls 2800
*** FLOP *** [Ah As 5c]
jaworlegia: checks 
santiga: bets 2200
jaworlegia: folds 
Uncalled bet (2200) returned to santiga
santiga collected 12400 from pot
santiga: doesn't show hand 
*** SUMMARY ***
Total pot 12400 | Rake 0 
Board [Ah As 5c]
Seat 1: NGNFuture folded before Flop (didn't bet)
Seat 3: santiga collected (12400)
Seat 4: Bxutu_ folded before Flop (didn't bet)
Seat 5: k8ldykbala (button) folded before Flop (didn't bet)
Seat 6: born1407 (small blind) folded before Flop
Seat 7: jaworlegia (big blind) folded on the Flop

PokerStars Hand #250528375160: Tournament #3754315429, $20+$20+$4 USD Hold'em No Limit - Level XXVI (1000/2000) - 2024/05/16 13:23:40 UTC [2024/05/16 9:23:40 ET]
Table '3754315429 3' 8-max Seat #5 is the button
Seat 1: NGNFuture (7987 in chips, $45 bounty) is sitting out
Seat 3: santiga (37875 in chips, $131.25 bounty) 
Seat 4: Bxutu_ (185517 in chips, $148.75 bounty) 
Seat 5: k8ldykbala (48442 in chips, $80 bounty) 
Seat 6: born1407 (63909 in chips, $142.50 bounty) 
Seat 7: jaworlegia (49989 in chips, $20 bounty) 
NGNFuture: posts the ante 300
santiga: posts the ante 300
Bxutu_: posts the ante 300
k8ldykbala: posts the ante 300
born1407: posts the ante 300
jaworlegia: posts the ante 300
born1407: posts small blind 1000
jaworlegia: posts big blind 2000
*** HOLE CARDS ***
NGNFuture: folds 
santiga: raises 2800 to 4800
Bxutu_: folds 
k8ldykbala: folds 
born1407: folds 
jaworlegia: calls 2800
*** FLOP *** [Ah As 5c]
jaworlegia: checks 
santiga: bets 2200
jaworlegia: folds 
Uncalled bet (2200) returned to santiga
santiga collected 12400 from pot
santiga: doesn't show hand 
*** SUMMARY ***
Total pot 12400 | Rake 0 
Board [Ah As 5c]
Seat 1: NGNFuture folded before Flop (didn't bet)
Seat 3: santiga collected (12400)
Seat 4: Bxutu_ folded before Flop (didn't bet)
Seat 5: k8ldykbala (button) folded before Flop (didn't bet)
Seat 6: born1407 (small blind) folded before Flop
Seat 7: jaworlegia (big blind) folded on the Flop

PokerStars Hand #250528380894: Tournament #3754315429, $20+$20+$4 USD Hold'em No Limit - Level XXVII (1250/2500) - 2024/05/16 13:24:12 UTC [2024/05/16 9:24:12 ET]
Table '3754315429 3' 8-max Seat #6 is the button
Seat 1: NGNFuture (7687 in chips, $45 bounty) is sitting out
Seat 3: santiga (45175 in chips, $131.25 bounty) 
Seat 4: Bxutu_ (185217 in chips, $148.75 bounty) 
Seat 5: k8ldykbala (48142 in chips, $80 bounty) 
Seat 6: born1407 (62609 in chips, $142.50 bounty) 
Seat 7: jaworlegia (44889 in chips, $20 bounty) 
NGNFuture: posts the ante 380
santiga: posts the ante 380
Bxutu_: posts the ante 380
k8ldykbala: posts the ante 380
born1407: posts the ante 380
jaworlegia: posts the ante 380
jaworlegia: posts small blind 1250
NGNFuture: posts big blind 2500
*** HOLE CARDS ***
santiga: folds 
Bxutu_: raises 2875 to 5375
k8ldykbala: folds 
born1407: folds 
jaworlegia: folds 
NGNFuture: folds 
Uncalled bet (2875) returned to Bxutu_
Bxutu_ collected 8530 from pot
Bxutu_: doesn't show hand 
*** SUMMARY ***
Total pot 8530 | Rake 0 
Seat 1: NGNFuture (big blind) folded before Flop
Seat 3: santiga folded before Flop (didn't bet)
Seat 4: Bxutu_ collected (8530)
Seat 5: k8ldykbala folded before Flop (didn't bet)
Seat 6: born1407 (button) folded before Flop (didn't bet)
Seat 7: jaworlegia (small blind) folded before Flop

PokerStars Hand #250528380894: Tournament #3754315429, $20+$20+$4 USD Hold'em No Limit - Level XXVII (1250/2500) - 2024/05/16 13:24:12 UTC [2024/05/16 9:24:12 ET]
Table '3754315429 3' 8-max Seat #6 is the button
Seat 1: NGNFuture (7687 in chips, $45 bounty) is sitting out
Seat 3: santiga (45175 in chips, $131.25 bounty) 
Seat 4: Bxutu_ (185217 in chips, $148.75 bounty) 
Seat 5: k8ldykbala (48142 in chips, $80 bounty) 
Seat 6: born1407 (62609 in chips, $142.50 bounty) 
Seat 7: jaworlegia (44889 in chips, $20 bounty) 
NGNFuture: posts the ante 380
santiga: posts the ante 380
Bxutu_: posts the ante 380
k8ldykbala: posts the ante 380
born1407: posts the ante 380
jaworlegia: posts the ante 380
jaworlegia: posts small blind 1250
NGNFuture: posts big blind 2500
*** HOLE CARDS ***
santiga: folds 
Bxutu_: raises 2875 to 5375
k8ldykbala: folds 
born1407: folds 
jaworlegia: folds 
NGNFuture: folds 
Uncalled bet (2875) returned to Bxutu_
Bxutu_ collected 8530 from pot
Bxutu_: doesn't show hand 
*** SUMMARY ***
Total pot 8530 | Rake 0 
Seat 1: NGNFuture (big blind) folded before Flop
Seat 3: santiga folded before Flop (didn't bet)
Seat 4: Bxutu_ collected (8530)
Seat 5: k8ldykbala folded before Flop (didn't bet)
Seat 6: born1407 (button) folded before Flop (didn't bet)
Seat 7: jaworlegia (small blind) folded before Flop

PokerStars Hand #250528384575: Tournament #3754315429, $20+$20+$4 USD Hold'em No Limit - Level XXVII (1250/2500) - 2024/05/16 13:24:33 UTC [2024/05/16 9:24:33 ET]
Table '3754315429 3' 8-max Seat #7 is the button
Seat 1: NGNFuture (4807 in chips, $45 bounty) is sitting out
Seat 3: santiga (44795 in chips, $131.25 bounty) 
Seat 4: Bxutu_ (190867 in chips, $148.75 bounty) 
Seat 5: k8ldykbala (47762 in chips, $80 bounty) 
Seat 6: born1407 (62229 in chips, $142.50 bounty) 
Seat 7: jaworlegia (43259 in chips, $20 bounty) 
NGNFuture: posts the ante 380
santiga: posts the ante 380
Bxutu_: posts the ante 380
k8ldykbala: posts the ante 380
born1407: posts the ante 380
jaworlegia: posts the ante 380
NGNFuture: posts small blind 1250
santiga: posts big blind 2500
*** HOLE CARDS ***
Bxutu_: folds 
k8ldykbala: folds 
born1407: folds 
jaworlegia: raises 40379 to 42879 and is all-in
NGNFuture: folds 
santiga: calls 40379
*** FLOP *** [Qs 6s Jc]
*** TURN *** [Qs 6s Jc] [Qd]
*** RIVER *** [Qs 6s Jc Qd] [Jh]
*** SHOW DOWN ***
santiga: shows [6d Ah] (two pair, Queens and Jacks)
jaworlegia: shows [Qh Kd] (a full house, Queens full of Jacks)
jaworlegia collected 89288 from pot
*** SUMMARY ***
Total pot 89288 | Rake 0 
Board [Qs 6s Jc Qd Jh]
Seat 1: NGNFuture (small blind) folded before Flop
Seat 3: santiga (big blind) showed [6d Ah] and lost with two pair, Queens and Jacks
Seat 4: Bxutu_ folded before Flop (didn't bet)
Seat 5: k8ldykbala folded before Flop (didn't bet)
Seat 6: born1407 folded before Flop (didn't bet)
Seat 7: jaworlegia (button) showed [Qh Kd] and won (89288) with a full house, Queens full of Jacks

PokerStars Hand #250528384575: Tournament #3754315429, $20+$20+$4 USD Hold'em No Limit - Level XXVII (1250/2500) - 2024/05/16 13:24:33 UTC [2024/05/16 9:24:33 ET]
Table '3754315429 3' 8-max Seat #7 is the button
Seat 1: NGNFuture (4807 in chips, $45 bounty) is sitting out
Seat 3: santiga (44795 in chips, $131.25 bounty) 
Seat 4: Bxutu_ (190867 in chips, $148.75 bounty) 
Seat 5: k8ldykbala (47762 in chips, $80 bounty) 
Seat 6: born1407 (62229 in chips, $142.50 bounty) 
Seat 7: jaworlegia (43259 in chips, $20 bounty) 
NGNFuture: posts the ante 380
santiga: posts the ante 380
Bxutu_: posts the ante 380
k8ldykbala: posts the ante 380
born1407: posts the ante 380
jaworlegia: posts the ante 380
NGNFuture: posts small blind 1250
santiga: posts big blind 2500
*** HOLE CARDS ***
Bxutu_: folds 
k8ldykbala: folds 
born1407: folds 
jaworlegia: raises 40379 to 42879 and is all-in
NGNFuture: folds 
santiga: calls 40379
*** FLOP *** [Qs 6s Jc]
*** TURN *** [Qs 6s Jc] [Qd]
*** RIVER *** [Qs 6s Jc Qd] [Jh]
*** SHOW DOWN ***
santiga: shows [6d Ah] (two pair, Queens and Jacks)
jaworlegia: shows [Qh Kd] (a full house, Queens full of Jacks)
jaworlegia collected 89288 from pot
*** SUMMARY ***
Total pot 89288 | Rake 0 
Board [Qs 6s Jc Qd Jh]
Seat 1: NGNFuture (small blind) folded before Flop
Seat 3: santiga (big blind) showed [6d Ah] and lost with two pair, Queens and Jacks
Seat 4: Bxutu_ folded before Flop (didn't bet)
Seat 5: k8ldykbala folded before Flop (didn't bet)
Seat 6: born1407 folded before Flop (didn't bet)
Seat 7: jaworlegia (button) showed [Qh Kd] and won (89288) with a full house, Queens full of Jacks

PokerStars Hand #250528391182: Tournament #3754315429, $20+$20+$4 USD Hold'em No Limit - Level XXVII (1250/2500) - 2024/05/16 13:25:10 UTC [2024/05/16 9:25:10 ET]
Table '3754315429 3' 8-max Seat #1 is the button
Seat 1: NGNFuture (3177 in chips, $45 bounty) is sitting out
Seat 3: santiga (1536 in chips, $131.25 bounty) 
Seat 4: Bxutu_ (190487 in chips, $148.75 bounty) 
Seat 5: k8ldykbala (47382 in chips, $80 bounty) 
Seat 6: born1407 (61849 in chips, $142.50 bounty) 
Seat 7: jaworlegia (89288 in chips, $20 bounty) 
NGNFuture: posts the ante 380
santiga: posts the ante 380
Bxutu_: posts the ante 380
k8ldykbala: posts the ante 380
born1407: posts the ante 380
jaworlegia: posts the ante 380
santiga: posts small blind 1156 and is all-in
Bxutu_: posts big blind 2500
*** HOLE CARDS ***
k8ldykbala: raises 44502 to 47002 and is all-in
born1407: raises 14467 to 61469 and is all-in
jaworlegia: folds 
NGNFuture: folds 
Bxutu_: folds 
Uncalled bet (14467) returned to born1407
*** FLOP *** [Tc 2d Ah]
*** TURN *** [Tc 2d Ah] [6s]
*** RIVER *** [Tc 2d Ah 6s] [8h]
*** SHOW DOWN ***
k8ldykbala: shows [Ac 4s] (a pair of Aces)
born1407: shows [Jh Jd] (a pair of Jacks)
k8ldykbala collected 93036 from side pot
santiga: shows [7s Kh] (high card Ace)
k8ldykbala collected 6904 from main pot
k8ldykbala wins $65.63 for eliminating santiga and their own bounty increases by $65.62 to $145.62
santiga finished the tournament in 12th place and received $57.16.
*** SUMMARY ***
Total pot 99940 Main pot 6904. Side pot 93036. | Rake 0 
Board [Tc 2d Ah 6s 8h]
Seat 1: NGNFuture (button) folded before Flop (didn't bet)
Seat 3: santiga (small blind) showed [7s Kh] and lost with high card Ace
Seat 4: Bxutu_ (big blind) folded before Flop
Seat 5: k8ldykbala showed [Ac 4s] and won (99940) with a pair of Aces
Seat 6: born1407 showed [Jh Jd] and lost with a pair of Jacks
Seat 7: jaworlegia folded before Flop (didn't bet)

PokerStars Hand #250528391182: Tournament #3754315429, $20+$20+$4 USD Hold'em No Limit - Level XXVII (1250/2500) - 2024/05/16 13:25:10 UTC [2024/05/16 9:25:10 ET]
Table '3754315429 3' 8-max Seat #1 is the button
Seat 1: NGNFuture (3177 in chips, $45 bounty) is sitting out
Seat 3: santiga (1536 in chips, $131.25 bounty) 
Seat 4: Bxutu_ (190487 in chips, $148.75 bounty) 
Seat 5: k8ldykbala (47382 in chips, $80 bounty) 
Seat 6: born1407 (61849 in chips, $142.50 bounty) 
Seat 7: jaworlegia (89288 in chips, $20 bounty) 
NGNFuture: posts the ante 380
santiga: posts the ante 380
Bxutu_: posts the ante 380
k8ldykbala: posts the ante 380
born1407: posts the ante 380
jaworlegia: posts the ante 380
santiga: posts small blind 1156 and is all-in
Bxutu_: posts big blind 2500
*** HOLE CARDS ***
k8ldykbala: raises 44502 to 47002 and is all-in
born1407: raises 14467 to 61469 and is all-in
jaworlegia: folds 
NGNFuture: folds 
Bxutu_: folds 
Uncalled bet (14467) returned to born1407
*** FLOP *** [Tc 2d Ah]
*** TURN *** [Tc 2d Ah] [6s]
*** RIVER *** [Tc 2d Ah 6s] [8h]
*** SHOW DOWN ***
k8ldykbala: shows [Ac 4s] (a pair of Aces)
born1407: shows [Jh Jd] (a pair of Jacks)
k8ldykbala collected 93036 from side pot
santiga: shows [7s Kh] (high card Ace)
k8ldykbala collected 6904 from main pot
k8ldykbala wins $65.63 for eliminating santiga and their own bounty increases by $65.62 to $145.62
santiga finished the tournament in 12th place and received $57.16.
*** SUMMARY ***
Total pot 99940 Main pot 6904. Side pot 93036. | Rake 0 
Board [Tc 2d Ah 6s 8h]
Seat 1: NGNFuture (button) folded before Flop (didn't bet)
Seat 3: santiga (small blind) showed [7s Kh] and lost with high card Ace
Seat 4: Bxutu_ (big blind) folded before Flop
Seat 5: k8ldykbala showed [Ac 4s] and won (99940) with a pair of Aces
Seat 6: born1407 showed [Jh Jd] and lost with a pair of Jacks
Seat 7: jaworlegia folded before Flop (didn't bet)

PokerStars Hand #250528395732: Tournament #3754315429, $20+$20+$4 USD Hold'em No Limit - Level XXVII (1250/2500) - 2024/05/16 13:25:35 UTC [2024/05/16 9:25:35 ET]
Table '3754315429 3' 8-max Seat #4 is the button
Seat 1: NGNFuture (2797 in chips, $45 bounty) is sitting out
Seat 4: Bxutu_ (187607 in chips, $148.75 bounty) 
Seat 5: k8ldykbala (99940 in chips, $145.62 bounty) 
Seat 6: born1407 (14467 in chips, $142.50 bounty) 
Seat 7: jaworlegia (88908 in chips, $20 bounty) 
NGNFuture: posts the ante 380
Bxutu_: posts the ante 380
k8ldykbala: posts the ante 380
born1407: posts the ante 380
jaworlegia: posts the ante 380
k8ldykbala: posts small blind 1250
born1407: posts big blind 2500
*** HOLE CARDS ***
jaworlegia: raises 2500 to 5000
NGNFuture: folds 
Bxutu_: folds 
k8ldykbala: folds 
born1407: folds 
Uncalled bet (2500) returned to jaworlegia
jaworlegia collected 8150 from pot
jaworlegia: doesn't show hand 
*** SUMMARY ***
Total pot 8150 | Rake 0 
Seat 1: NGNFuture folded before Flop (didn't bet)
Seat 4: Bxutu_ (button) folded before Flop (didn't bet)
Seat 5: k8ldykbala (small blind) folded before Flop
Seat 6: born1407 (big blind) folded before Flop
Seat 7: jaworlegia collected (8150)

PokerStars Hand #250528395732: Tournament #3754315429, $20+$20+$4 USD Hold'em No Limit - Level XXVII (1250/2500) - 2024/05/16 13:25:35 UTC [2024/05/16 9:25:35 ET]
Table '3754315429 3' 8-max Seat #4 is the button
Seat 1: NGNFuture (2797 in chips, $45 bounty) is sitting out
Seat 4: Bxutu_ (187607 in chips, $148.75 bounty) 
Seat 5: k8ldykbala (99940 in chips, $145.62 bounty) 
Seat 6: born1407 (14467 in chips, $142.50 bounty) 
Seat 7: jaworlegia (88908 in chips, $20 bounty) 
NGNFuture: posts the ante 380
Bxutu_: posts the ante 380
k8ldykbala: posts the ante 380
born1407: posts the ante 380
jaworlegia: posts the ante 380
k8ldykbala: posts small blind 1250
born1407: posts big blind 2500
*** HOLE CARDS ***
jaworlegia: raises 2500 to 5000
NGNFuture: folds 
Bxutu_: folds 
k8ldykbala: folds 
born1407: folds 
Uncalled bet (2500) returned to jaworlegia
jaworlegia collected 8150 from pot
jaworlegia: doesn't show hand 
*** SUMMARY ***
Total pot 8150 | Rake 0 
Seat 1: NGNFuture folded before Flop (didn't bet)
Seat 4: Bxutu_ (button) folded before Flop (didn't bet)
Seat 5: k8ldykbala (small blind) folded before Flop
Seat 6: born1407 (big blind) folded before Flop
Seat 7: jaworlegia collected (8150)

PokerStars Hand #250528398792: Tournament #3754315429, $20+$20+$4 USD Hold'em No Limit - Level XXVII (1250/2500) - 2024/05/16 13:25:52 UTC [2024/05/16 9:25:52 ET]
Table '3754315429 3' 8-max Seat #5 is the button
Seat 1: NGNFuture (2417 in chips, $45 bounty) is sitting out
Seat 4: Bxutu_ (187227 in chips, $148.75 bounty) 
Seat 5: k8ldykbala (98310 in chips, $145.62 bounty) 
Seat 6: born1407 (11587 in chips, $142.50 bounty) 
Seat 7: jaworlegia (94178 in chips, $20 bounty) 
NGNFuture: posts the ante 380
Bxutu_: posts the ante 380
k8ldykbala: posts the ante 380
born1407: posts the ante 380
jaworlegia: posts the ante 380
born1407: posts small blind 1250
jaworlegia: posts big blind 2500
*** HOLE CARDS ***
NGNFuture: folds 
Bxutu_: folds 
k8ldykbala: raises 2500 to 5000
born1407: folds 
jaworlegia: calls 2500
*** FLOP *** [Jh Kh Qs]
jaworlegia: checks 
k8ldykbala: checks 
*** TURN *** [Jh Kh Qs] [Qh]
jaworlegia: checks 
k8ldykbala: bets 4289
jaworlegia: calls 4289
*** RIVER *** [Jh Kh Qs Qh] [2s]
jaworlegia: checks 
k8ldykbala: checks 
*** SHOW DOWN ***
jaworlegia: shows [8s Ks] (two pair, Kings and Queens)
k8ldykbala: mucks hand 
jaworlegia collected 21728 from pot
*** SUMMARY ***
Total pot 21728 | Rake 0 
Board [Jh Kh Qs Qh 2s]
Seat 1: NGNFuture folded before Flop (didn't bet)
Seat 4: Bxutu_ folded before Flop (didn't bet)
Seat 5: k8ldykbala (button) mucked
Seat 6: born1407 (small blind) folded before Flop
Seat 7: jaworlegia (big blind) showed [8s Ks] and won (21728) with two pair, Kings and Queens

PokerStars Hand #250528398792: Tournament #3754315429, $20+$20+$4 USD Hold'em No Limit - Level XXVII (1250/2500) - 2024/05/16 13:25:52 UTC [2024/05/16 9:25:52 ET]
Table '3754315429 3' 8-max Seat #5 is the button
Seat 1: NGNFuture (2417 in chips, $45 bounty) is sitting out
Seat 4: Bxutu_ (187227 in chips, $148.75 bounty) 
Seat 5: k8ldykbala (98310 in chips, $145.62 bounty) 
Seat 6: born1407 (11587 in chips, $142.50 bounty) 
Seat 7: jaworlegia (94178 in chips, $20 bounty) 
NGNFuture: posts the ante 380
Bxutu_: posts the ante 380
k8ldykbala: posts the ante 380
born1407: posts the ante 380
jaworlegia: posts the ante 380
born1407: posts small blind 1250
jaworlegia: posts big blind 2500
*** HOLE CARDS ***
NGNFuture: folds 
Bxutu_: folds 
k8ldykbala: raises 2500 to 5000
born1407: folds 
jaworlegia: calls 2500
*** FLOP *** [Jh Kh Qs]
jaworlegia: checks 
k8ldykbala: checks 
*** TURN *** [Jh Kh Qs] [Qh]
jaworlegia: checks 
k8ldykbala: bets 4289
jaworlegia: calls 4289
*** RIVER *** [Jh Kh Qs Qh] [2s]
jaworlegia: checks 
k8ldykbala: checks 
*** SHOW DOWN ***
jaworlegia: shows [8s Ks] (two pair, Kings and Queens)
k8ldykbala: mucks hand 
jaworlegia collected 21728 from pot
*** SUMMARY ***
Total pot 21728 | Rake 0 
Board [Jh Kh Qs Qh 2s]
Seat 1: NGNFuture folded before Flop (didn't bet)
Seat 4: Bxutu_ folded before Flop (didn't bet)
Seat 5: k8ldykbala (button) mucked
Seat 6: born1407 (small blind) folded before Flop
Seat 7: jaworlegia (big blind) showed [8s Ks] and won (21728) with two pair, Kings and Queens

PokerStars Hand #250528416488: Tournament #3754315429, $20+$20+$4 USD Hold'em No Limit - Level XXVII (1250/2500) - 2024/05/16 13:27:30 UTC [2024/05/16 9:27:30 ET]
Table '3754315429 3' 8-max Seat #6 is the button
Seat 1: NGNFuture (2037 in chips, $45 bounty) is sitting out
Seat 4: Bxutu_ (186847 in chips, $148.75 bounty) 
Seat 5: k8ldykbala (88641 in chips, $145.62 bounty) 
Seat 6: born1407 (9957 in chips, $142.50 bounty) 
Seat 7: jaworlegia (106237 in chips, $20 bounty) 
NGNFuture: posts the ante 380
Bxutu_: posts the ante 380
k8ldykbala: posts the ante 380
born1407: posts the ante 380
jaworlegia: posts the ante 380
jaworlegia: posts small blind 1250
NGNFuture: posts big blind 1657 and is all-in
*** HOLE CARDS ***
Bxutu_: raises 3718 to 5375
k8ldykbala: calls 5375
born1407: raises 4202 to 9577 and is all-in
jaworlegia: folds 
Bxutu_: raises 176890 to 186467 and is all-in
k8ldykbala: calls 82886 and is all-in
NGNFuture: folds 
Uncalled bet (98206) returned to Bxutu_
*** FLOP *** [5h 7d Qh]
*** TURN *** [5h 7d Qh] [2h]
*** RIVER *** [5h 7d Qh 2h] [7h]
*** SHOW DOWN ***
Bxutu_: shows [4c 8s] (a pair of Sevens)
k8ldykbala: shows [6d 6s] (two pair, Sevens and Sixes)
k8ldykbala collected 157368 from side pot
born1407: shows [Kc Js] (a pair of Sevens)
k8ldykbala collected 33538 from main pot
k8ldykbala wins $22.50 for eliminating NGNFuture and their own bounty increases by $22.50 to $168.12
k8ldykbala wins $71.25 for eliminating born1407 and their own bounty increases by $71.25 to $239.37
born1407 finished the tournament in 9th place and received $75.25.
NGNFuture finished the tournament in 10th place and received $65.58.
*** SUMMARY ***
Total pot 190906 Main pot 33538. Side pot 157368. | Rake 0 
Board [5h 7d Qh 2h 7h]
Seat 1: NGNFuture (big blind) folded before Flop
Seat 4: Bxutu_ showed [4c 8s] and lost with a pair of Sevens
Seat 5: k8ldykbala showed [6d 6s] and won (190906) with two pair, Sevens and Sixes
Seat 6: born1407 (button) showed [Kc Js] and lost with a pair of Sevens
Seat 7: jaworlegia (small blind) folded before Flop

PokerStars Hand #250528416488: Tournament #3754315429, $20+$20+$4 USD Hold'em No Limit - Level XXVII (1250/2500) - 2024/05/16 13:27:30 UTC [2024/05/16 9:27:30 ET]
Table '3754315429 3' 8-max Seat #6 is the button
Seat 1: NGNFuture (2037 in chips, $45 bounty) is sitting out
Seat 4: Bxutu_ (186847 in chips, $148.75 bounty) 
Seat 5: k8ldykbala (88641 in chips, $145.62 bounty) 
Seat 6: born1407 (9957 in chips, $142.50 bounty) 
Seat 7: jaworlegia (106237 in chips, $20 bounty) 
NGNFuture: posts the ante 380
Bxutu_: posts the ante 380
k8ldykbala: posts the ante 380
born1407: posts the ante 380
jaworlegia: posts the ante 380
jaworlegia: posts small blind 1250
NGNFuture: posts big blind 1657 and is all-in
*** HOLE CARDS ***
Bxutu_: raises 3718 to 5375
k8ldykbala: calls 5375
born1407: raises 4202 to 9577 and is all-in
jaworlegia: folds 
Bxutu_: raises 176890 to 186467 and is all-in
k8ldykbala: calls 82886 and is all-in
NGNFuture: folds 
Uncalled bet (98206) returned to Bxutu_
*** FLOP *** [5h 7d Qh]
*** TURN *** [5h 7d Qh] [2h]
*** RIVER *** [5h 7d Qh 2h] [7h]
*** SHOW DOWN ***
Bxutu_: shows [4c 8s] (a pair of Sevens)
k8ldykbala: shows [6d 6s] (two pair, Sevens and Sixes)
k8ldykbala collected 157368 from side pot
born1407: shows [Kc Js] (a pair of Sevens)
k8ldykbala collected 33538 from main pot
k8ldykbala wins $22.50 for eliminating NGNFuture and their own bounty increases by $22.50 to $168.12
k8ldykbala wins $71.25 for eliminating born1407 and their own bounty increases by $71.25 to $239.37
born1407 finished the tournament in 9th place and received $75.25.
NGNFuture finished the tournament in 10th place and received $65.58.
*** SUMMARY ***
Total pot 190906 Main pot 33538. Side pot 157368. | Rake 0 
Board [5h 7d Qh 2h 7h]
Seat 1: NGNFuture (big blind) folded before Flop
Seat 4: Bxutu_ showed [4c 8s] and lost with a pair of Sevens
Seat 5: k8ldykbala showed [6d 6s] and won (190906) with two pair, Sevens and Sixes
Seat 6: born1407 (button) showed [Kc Js] and lost with a pair of Sevens
Seat 7: jaworlegia (small blind) folded before Flop

PokerStars Hand #250528416488: Tournament #3754315429, $20+$20+$4 USD Hold'em No Limit - Level XXVII (1250/2500) - 2024/05/16 13:27:30 UTC [2024/05/16 9:27:30 ET]
Table '3754315429 3' 8-max Seat #6 is the button
Seat 1: NGNFuture (2037 in chips, $45 bounty) is sitting out
Seat 4: Bxutu_ (186847 in chips, $148.75 bounty) 
Seat 5: k8ldykbala (88641 in chips, $145.62 bounty) 
Seat 6: born1407 (9957 in chips, $142.50 bounty) 
Seat 7: jaworlegia (106237 in chips, $20 bounty) 
NGNFuture: posts the ante 380
Bxutu_: posts the ante 380
k8ldykbala: posts the ante 380
born1407: posts the ante 380
jaworlegia: posts the ante 380
jaworlegia: posts small blind 1250
NGNFuture: posts big blind 1657 and is all-in
*** HOLE CARDS ***
Bxutu_: raises 3718 to 5375
k8ldykbala: calls 5375
born1407: raises 4202 to 9577 and is all-in
jaworlegia: folds 
Bxutu_: raises 176890 to 186467 and is all-in
k8ldykbala: calls 82886 and is all-in
NGNFuture: folds 
Uncalled bet (98206) returned to Bxutu_
*** FLOP *** [5h 7d Qh]
*** TURN *** [5h 7d Qh] [2h]
*** RIVER *** [5h 7d Qh 2h] [7h]
*** SHOW DOWN ***
Bxutu_: shows [4c 8s] (a pair of Sevens)
k8ldykbala: shows [6d 6s] (two pair, Sevens and Sixes)
k8ldykbala collected 157368 from side pot
born1407: shows [Kc Js] (a pair of Sevens)
k8ldykbala collected 33538 from main pot
k8ldykbala wins $22.50 for eliminating NGNFuture and their own bounty increases by $22.50 to $168.12
k8ldykbala wins $71.25 for eliminating born1407 and their own bounty increases by $71.25 to $239.37
born1407 finished the tournament in 9th place and received $75.25.
NGNFuture finished the tournament in 10th place and received $65.58.
*** SUMMARY ***
Total pot 190906 Main pot 33538. Side pot 157368. | Rake 0 
Board [5h 7d Qh 2h 7h]
Seat 1: NGNFuture (big blind) folded before Flop
Seat 4: Bxutu_ showed [4c 8s] and lost with a pair of Sevens
Seat 5: k8ldykbala showed [6d 6s] and won (190906) with two pair, Sevens and Sixes
Seat 6: born1407 (button) showed [Kc Js] and lost with a pair of Sevens
Seat 7: jaworlegia (small blind) folded before Flop
