PokerStars Hand #251207032000: Tournament #3767885527, $40+$10+$5 USD Hold'em No Limit - Level XIX (2500/5000) - 2024/06/26 20:34:17 UTC [2024/06/26 16:34:17 ET]
Table '3767885527 97' 8-max Seat #8 is the button
Seat 1: Dowgh-Santos (271336 in chips) 
Seat 2: Siltex_by (175638 in chips) 
Seat 3: TheVanity (51694 in chips) 
Seat 4: dictba (308576 in chips) 
Seat 5: Medeiros B. (119838 in chips) 
Seat 6: SEATON1998 (36459 in chips) 
Seat 7: DrTeleborian (270572 in chips) 
Seat 8: Vnezapnostb (130837 in chips) 
Dowgh-Santos: posts the ante 625
Siltex_by: posts the ante 625
TheVanity: posts the ante 625
dictba: posts the ante 625
Medeiros B.: posts the ante 625
SEATON1998: posts the ante 625
DrTeleborian: posts the ante 625
Vnezapnostb: posts the ante 625
Dowgh-Santos: posts small blind 2500
Siltex_by: posts big blind 5000
*** HOLE CARDS ***
TheVanity: folds 
dictba: folds 
Medeiros B.: folds 
SEATON1998: raises 30834 to 35834 and is all-in
DrTeleborian: folds 
Vnezapnostb: calls 35834
Dowgh-Santos: folds 
Siltex_by: folds 
*** FLOP *** [3s 4d 7h]
*** TURN *** [3s 4d 7h] [9h]
*** RIVER *** [3s 4d 7h 9h] [6h]
*** SHOW DOWN ***
SEATON1998: shows [Th Ts] (a pair of Tens)
Vnezapnostb: shows [Ad Ah] (a pair of Aces)
Vnezapnostb collected 84168 from pot
SEATON1998 finished the tournament in 301st place and received $104.64.
*** SUMMARY ***
Total pot 84168 | Rake 0 
Board [3s 4d 7h 9h 6h]
Seat 1: Dowgh-Santos (small blind) folded before Flop
Seat 2: Siltex_by (big blind) folded before Flop
Seat 3: TheVanity folded before Flop (didn't bet)
Seat 4: dictba folded before Flop (didn't bet)
Seat 5: Medeiros B. folded before Flop (didn't bet)
Seat 6: SEATON1998 showed [Th Ts] and lost with a pair of Tens
Seat 7: DrTeleborian folded before Flop (didn't bet)
Seat 8: Vnezapnostb (button) showed [Ad Ah] and won (84168) with a pair of Aces

PokerStars Hand #251207044192: Tournament #3767885527, $40+$10+$5 USD Hold'em No Limit - Level XIX (2500/5000) - 2024/06/26 20:35:00 UTC [2024/06/26 16:35:00 ET]
Table '3767885527 97' 8-max Seat #1 is the button
Seat 1: Dowgh-Santos (268211 in chips) 
Seat 2: Siltex_by (170013 in chips) 
Seat 3: TheVanity (51069 in chips) 
Seat 4: dictba (307951 in chips) 
Seat 5: Medeiros B. (119213 in chips) 
Seat 7: DrTeleborian (269947 in chips) 
Seat 8: Vnezapnostb (178546 in chips) 
Dowgh-Santos: posts the ante 625
Siltex_by: posts the ante 625
TheVanity: posts the ante 625
dictba: posts the ante 625
Medeiros B.: posts the ante 625
DrTeleborian: posts the ante 625
Vnezapnostb: posts the ante 625
Siltex_by: posts small blind 2500
TheVanity: posts big blind 5000
*** HOLE CARDS ***
dictba: folds 
Medeiros B.: raises 5000 to 10000
DrTeleborian: raises 20000 to 30000
Vnezapnostb: folds 
Dowgh-Santos: folds 
Siltex_by: folds 
TheVanity: folds 
Medeiros B.: folds 
Uncalled bet (20000) returned to DrTeleborian
DrTeleborian collected 31875 from pot
*** SUMMARY ***
Total pot 31875 | Rake 0 
Seat 1: Dowgh-Santos (button) folded before Flop (didn't bet)
Seat 2: Siltex_by (small blind) folded before Flop
Seat 3: TheVanity (big blind) folded before Flop
Seat 4: dictba folded before Flop (didn't bet)
Seat 5: Medeiros B. folded before Flop
Seat 7: DrTeleborian collected (31875)
Seat 8: Vnezapnostb folded before Flop (didn't bet)

PokerStars Hand #251207055748: Tournament #3767885527, $40+$10+$5 USD Hold'em No Limit - Level XIX (2500/5000) - 2024/06/26 20:35:41 UTC [2024/06/26 16:35:41 ET]
Table '3767885527 97' 8-max Seat #2 is the button
Seat 1: Dowgh-Santos (267586 in chips) 
Seat 2: Siltex_by (166888 in chips) 
Seat 3: TheVanity (45444 in chips) 
Seat 4: dictba (307326 in chips) 
Seat 5: Medeiros B. (108588 in chips) 
Seat 6: Biazutti (86598 in chips) 
Seat 7: DrTeleborian (291197 in chips) 
Seat 8: Vnezapnostb (177921 in chips) 
Dowgh-Santos: posts the ante 625
Siltex_by: posts the ante 625
TheVanity: posts the ante 625
dictba: posts the ante 625
Medeiros B.: posts the ante 625
Biazutti: posts the ante 625
DrTeleborian: posts the ante 625
Vnezapnostb: posts the ante 625
TheVanity: posts small blind 2500
dictba: posts big blind 5000
*** HOLE CARDS ***
Medeiros B.: folds 
Biazutti: raises 5000 to 10000
DrTeleborian: folds 
Vnezapnostb: folds 
Dowgh-Santos: folds 
Siltex_by: raises 25000 to 35000
TheVanity: folds 
dictba: folds 
Biazutti: raises 50973 to 85973 and is all-in
Siltex_by: calls 50973
*** FLOP *** [3d Ad 4d]
*** TURN *** [3d Ad 4d] [4h]
*** RIVER *** [3d Ad 4d 4h] [8s]
*** SHOW DOWN ***
Biazutti: shows [Qs Ah] (two pair, Aces and Fours)
Siltex_by: shows [Kd Kh] (two pair, Kings and Fours)
Biazutti collected 184446 from pot
*** SUMMARY ***
Total pot 184446 | Rake 0 
Board [3d Ad 4d 4h 8s]
Seat 1: Dowgh-Santos folded before Flop (didn't bet)
Seat 2: Siltex_by (button) showed [Kd Kh] and lost with two pair, Kings and Fours
Seat 3: TheVanity (small blind) folded before Flop
Seat 4: dictba (big blind) folded before Flop
Seat 5: Medeiros B. folded before Flop (didn't bet)
Seat 6: Biazutti showed [Qs Ah] and won (184446) with two pair, Aces and Fours
Seat 7: DrTeleborian folded before Flop (didn't bet)
Seat 8: Vnezapnostb folded before Flop (didn't bet)

PokerStars Hand #251207075917: Tournament #3767885527, $40+$10+$5 USD Hold'em No Limit - Level XX (3000/6000) - 2024/06/26 20:36:52 UTC [2024/06/26 16:36:52 ET]
Table '3767885527 97' 8-max Seat #3 is the button
Seat 1: Dowgh-Santos (266961 in chips) 
Seat 2: Siltex_by (80290 in chips) 
Seat 3: TheVanity (42319 in chips) 
Seat 4: dictba (301701 in chips) 
Seat 5: Medeiros B. (107963 in chips) 
Seat 6: Biazutti (184446 in chips) 
Seat 7: DrTeleborian (290572 in chips) 
Seat 8: Vnezapnostb (177296 in chips) 
Dowgh-Santos: posts the ante 750
Siltex_by: posts the ante 750
TheVanity: posts the ante 750
dictba: posts the ante 750
Medeiros B.: posts the ante 750
Biazutti: posts the ante 750
DrTeleborian: posts the ante 750
Vnezapnostb: posts the ante 750
dictba: posts small blind 3000
Medeiros B.: posts big blind 6000
*** HOLE CARDS ***
Biazutti: folds 
DrTeleborian: folds 
Vnezapnostb: folds 
Dowgh-Santos: folds 
Siltex_by: folds 
TheVanity: raises 35569 to 41569 and is all-in
dictba: folds 
Medeiros B.: calls 35569
*** FLOP *** [8h 6s 9c]
*** TURN *** [8h 6s 9c] [Ts]
*** RIVER *** [8h 6s 9c Ts] [Qd]
*** SHOW DOWN ***
Medeiros B.: shows [3h 3d] (a pair of Threes)
TheVanity: shows [Ac 9d] (a pair of Nines)
TheVanity collected 92138 from pot
*** SUMMARY ***
Total pot 92138 | Rake 0 
Board [8h 6s 9c Ts Qd]
Seat 1: Dowgh-Santos folded before Flop (didn't bet)
Seat 2: Siltex_by folded before Flop (didn't bet)
Seat 3: TheVanity (button) showed [Ac 9d] and won (92138) with a pair of Nines
Seat 4: dictba (small blind) folded before Flop
Seat 5: Medeiros B. (big blind) showed [3h 3d] and lost with a pair of Threes
Seat 6: Biazutti folded before Flop (didn't bet)
Seat 7: DrTeleborian folded before Flop (didn't bet)
Seat 8: Vnezapnostb folded before Flop (didn't bet)

PokerStars Hand #251207086147: Tournament #3767885527, $40+$10+$5 USD Hold'em No Limit - Level XX (3000/6000) - 2024/06/26 20:37:28 UTC [2024/06/26 16:37:28 ET]
Table '3767885527 97' 8-max Seat #4 is the button
Seat 1: Dowgh-Santos (266211 in chips) 
Seat 2: Siltex_by (79540 in chips) 
Seat 3: TheVanity (92138 in chips) 
Seat 4: dictba (297951 in chips) 
Seat 5: Medeiros B. (65644 in chips) 
Seat 6: Biazutti (183696 in chips) 
Seat 7: DrTeleborian (289822 in chips) 
Seat 8: Vnezapnostb (176546 in chips) 
Dowgh-Santos: posts the ante 750
Siltex_by: posts the ante 750
TheVanity: posts the ante 750
dictba: posts the ante 750
Medeiros B.: posts the ante 750
Biazutti: posts the ante 750
DrTeleborian: posts the ante 750
Vnezapnostb: posts the ante 750
Medeiros B.: posts small blind 3000
Biazutti: posts big blind 6000
*** HOLE CARDS ***
DrTeleborian: folds 
Vnezapnostb: folds 
Dowgh-Santos: folds 
Siltex_by: folds 
TheVanity: folds 
dictba: raises 6000 to 12000
Medeiros B.: raises 52894 to 64894 and is all-in
Biazutti: folds 
dictba: calls 52894
*** FLOP *** [Th Kd Td]
*** TURN *** [Th Kd Td] [2h]
*** RIVER *** [Th Kd Td 2h] [Jh]
*** SHOW DOWN ***
Medeiros B.: shows [3s Ad] (a pair of Tens)
dictba: shows [9h As] (a pair of Tens)
Medeiros B. collected 70894 from pot
dictba collected 70894 from pot
*** SUMMARY ***
Total pot 141788 | Rake 0 
Board [Th Kd Td 2h Jh]
Seat 1: Dowgh-Santos folded before Flop (didn't bet)
Seat 2: Siltex_by folded before Flop (didn't bet)
Seat 3: TheVanity folded before Flop (didn't bet)
Seat 4: dictba (button) showed [9h As] and won (70894) with a pair of Tens
Seat 5: Medeiros B. (small blind) showed [3s Ad] and won (70894) with a pair of Tens
Seat 6: Biazutti (big blind) folded before Flop
Seat 7: DrTeleborian folded before Flop (didn't bet)
Seat 8: Vnezapnostb folded before Flop (didn't bet)

PokerStars Hand #251207095692: Tournament #3767885527, $40+$10+$5 USD Hold'em No Limit - Level XX (3000/6000) - 2024/06/26 20:38:01 UTC [2024/06/26 16:38:01 ET]
Table '3767885527 97' 8-max Seat #5 is the button
Seat 1: Dowgh-Santos (265461 in chips) 
Seat 2: Siltex_by (78790 in chips) 
Seat 3: TheVanity (91388 in chips) 
Seat 4: dictba (303201 in chips) 
Seat 5: Medeiros B. (70894 in chips) 
Seat 6: Biazutti (176946 in chips) 
Seat 7: DrTeleborian (289072 in chips) 
Seat 8: Vnezapnostb (175796 in chips) 
Dowgh-Santos: posts the ante 750
Siltex_by: posts the ante 750
TheVanity: posts the ante 750
dictba: posts the ante 750
Medeiros B.: posts the ante 750
Biazutti: posts the ante 750
DrTeleborian: posts the ante 750
Vnezapnostb: posts the ante 750
Biazutti: posts small blind 3000
DrTeleborian: posts big blind 6000
*** HOLE CARDS ***
Vnezapnostb: folds 
Dowgh-Santos: folds 
Siltex_by: folds 
TheVanity: folds 
dictba: folds 
Medeiros B.: folds 
Biazutti: calls 3000
DrTeleborian: checks 
*** FLOP *** [8d 6s 8c]
Biazutti: checks 
DrTeleborian: checks 
*** TURN *** [8d 6s 8c] [7d]
Biazutti: bets 6000
DrTeleborian: folds 
Uncalled bet (6000) returned to Biazutti
Biazutti collected 18000 from pot
Biazutti: doesn't show hand 
*** SUMMARY ***
Total pot 18000 | Rake 0 
Board [8d 6s 8c 7d]
Seat 1: Dowgh-Santos folded before Flop (didn't bet)
Seat 2: Siltex_by folded before Flop (didn't bet)
Seat 3: TheVanity folded before Flop (didn't bet)
Seat 4: dictba folded before Flop (didn't bet)
Seat 5: Medeiros B. (button) folded before Flop (didn't bet)
Seat 6: Biazutti (small blind) collected (18000)
Seat 7: DrTeleborian (big blind) folded on the Turn
Seat 8: Vnezapnostb folded before Flop (didn't bet)

PokerStars Hand #251207114198: Tournament #3767885527, $40+$10+$5 USD Hold'em No Limit - Level XX (3000/6000) - 2024/06/26 20:39:07 UTC [2024/06/26 16:39:07 ET]
Table '3767885527 97' 8-max Seat #6 is the button
Seat 1: Dowgh-Santos (264711 in chips) 
Seat 2: Siltex_by (78040 in chips) 
Seat 3: TheVanity (90638 in chips) 
Seat 4: dictba (302451 in chips) 
Seat 5: Medeiros B. (70144 in chips) 
Seat 6: Biazutti (188196 in chips) 
Seat 7: DrTeleborian (282322 in chips) 
Seat 8: Vnezapnostb (175046 in chips) 
Dowgh-Santos: posts the ante 750
Siltex_by: posts the ante 750
TheVanity: posts the ante 750
dictba: posts the ante 750
Medeiros B.: posts the ante 750
Biazutti: posts the ante 750
DrTeleborian: posts the ante 750
Vnezapnostb: posts the ante 750
DrTeleborian: posts small blind 3000
Vnezapnostb: posts big blind 6000
*** HOLE CARDS ***
Dowgh-Santos: folds 
Siltex_by: folds 
TheVanity: folds 
dictba: folds 
Medeiros B.: folds 
Biazutti: folds 
DrTeleborian: raises 15000 to 21000
Vnezapnostb: calls 15000
*** FLOP *** [5c Ac Qh]
DrTeleborian: bets 12000
Vnezapnostb: calls 12000
*** TURN *** [5c Ac Qh] [8c]
DrTeleborian: checks 
Vnezapnostb: bets 38160
DrTeleborian: folds 
Uncalled bet (38160) returned to Vnezapnostb
Vnezapnostb collected 72000 from pot
Vnezapnostb: doesn't show hand 
*** SUMMARY ***
Total pot 72000 | Rake 0 
Board [5c Ac Qh 8c]
Seat 1: Dowgh-Santos folded before Flop (didn't bet)
Seat 2: Siltex_by folded before Flop (didn't bet)
Seat 3: TheVanity folded before Flop (didn't bet)
Seat 4: dictba folded before Flop (didn't bet)
Seat 5: Medeiros B. folded before Flop (didn't bet)
Seat 6: Biazutti (button) folded before Flop (didn't bet)
Seat 7: DrTeleborian (small blind) folded on the Turn
Seat 8: Vnezapnostb (big blind) collected (72000)

PokerStars Hand #251207141724: Tournament #3767885527, $40+$10+$5 USD Hold'em No Limit - Level XX (3000/6000) - 2024/06/26 20:40:45 UTC [2024/06/26 16:40:45 ET]
Table '3767885527 97' 8-max Seat #7 is the button
Seat 1: Dowgh-Santos (263961 in chips) 
Seat 2: Siltex_by (77290 in chips) 
Seat 3: TheVanity (89888 in chips) 
Seat 4: dictba (301701 in chips) 
Seat 5: Medeiros B. (69394 in chips) 
Seat 6: Biazutti (187446 in chips) 
Seat 7: DrTeleborian (248572 in chips) 
Seat 8: Vnezapnostb (213296 in chips) 
Dowgh-Santos: posts the ante 750
Siltex_by: posts the ante 750
TheVanity: posts the ante 750
dictba: posts the ante 750
Medeiros B.: posts the ante 750
Biazutti: posts the ante 750
DrTeleborian: posts the ante 750
Vnezapnostb: posts the ante 750
Vnezapnostb: posts small blind 3000
Dowgh-Santos: posts big blind 6000
*** HOLE CARDS ***
Siltex_by: folds 
TheVanity: raises 6000 to 12000
dictba: folds 
Medeiros B.: folds 
Biazutti: folds 
DrTeleborian: raises 24000 to 36000
Vnezapnostb: folds 
Dowgh-Santos: folds 
TheVanity: folds 
Uncalled bet (24000) returned to DrTeleborian
DrTeleborian collected 39000 from pot
*** SUMMARY ***
Total pot 39000 | Rake 0 
Seat 1: Dowgh-Santos (big blind) folded before Flop
Seat 2: Siltex_by folded before Flop (didn't bet)
Seat 3: TheVanity folded before Flop
Seat 4: dictba folded before Flop (didn't bet)
Seat 5: Medeiros B. folded before Flop (didn't bet)
Seat 6: Biazutti folded before Flop (didn't bet)
Seat 7: DrTeleborian (button) collected (39000)
Seat 8: Vnezapnostb (small blind) folded before Flop

PokerStars Hand #251207152717: Tournament #3767885527, $40+$10+$5 USD Hold'em No Limit - Level XX (3000/6000) - 2024/06/26 20:41:25 UTC [2024/06/26 16:41:25 ET]
Table '3767885527 97' 8-max Seat #8 is the button
Seat 1: Dowgh-Santos (257211 in chips) 
Seat 2: Siltex_by (76540 in chips) 
Seat 3: TheVanity (77138 in chips) 
Seat 4: dictba (300951 in chips) 
Seat 5: Medeiros B. (68644 in chips) 
Seat 6: Biazutti (186696 in chips) 
Seat 7: DrTeleborian (274822 in chips) 
Seat 8: Vnezapnostb (209546 in chips) 
Dowgh-Santos: posts the ante 750
Siltex_by: posts the ante 750
TheVanity: posts the ante 750
dictba: posts the ante 750
Medeiros B.: posts the ante 750
Biazutti: posts the ante 750
DrTeleborian: posts the ante 750
Vnezapnostb: posts the ante 750
Dowgh-Santos: posts small blind 3000
Siltex_by: posts big blind 6000
*** HOLE CARDS ***
TheVanity: folds 
dictba: folds 
Medeiros B.: folds 
Biazutti: folds 
DrTeleborian: raises 6600 to 12600
Vnezapnostb: folds 
Dowgh-Santos: folds 
Siltex_by: folds 
Uncalled bet (6600) returned to DrTeleborian
DrTeleborian collected 21000 from pot
*** SUMMARY ***
Total pot 21000 | Rake 0 
Seat 1: Dowgh-Santos (small blind) folded before Flop
Seat 2: Siltex_by (big blind) folded before Flop
Seat 3: TheVanity folded before Flop (didn't bet)
Seat 4: dictba folded before Flop (didn't bet)
Seat 5: Medeiros B. folded before Flop (didn't bet)
Seat 6: Biazutti folded before Flop (didn't bet)
Seat 7: DrTeleborian collected (21000)
Seat 8: Vnezapnostb (button) folded before Flop (didn't bet)

PokerStars Hand #251207158329: Tournament #3767885527, $40+$10+$5 USD Hold'em No Limit - Level XX (3000/6000) - 2024/06/26 20:41:45 UTC [2024/06/26 16:41:45 ET]
Table '3767885527 97' 8-max Seat #1 is the button
Seat 1: Dowgh-Santos (253461 in chips) 
Seat 2: Siltex_by (69790 in chips) 
Seat 3: TheVanity (76388 in chips) 
Seat 4: dictba (300201 in chips) 
Seat 5: Medeiros B. (67894 in chips) 
Seat 6: Biazutti (185946 in chips) 
Seat 7: DrTeleborian (289072 in chips) 
Seat 8: Vnezapnostb (208796 in chips) 
Dowgh-Santos: posts the ante 750
Siltex_by: posts the ante 750
TheVanity: posts the ante 750
dictba: posts the ante 750
Medeiros B.: posts the ante 750
Biazutti: posts the ante 750
DrTeleborian: posts the ante 750
Vnezapnostb: posts the ante 750
Siltex_by: posts small blind 3000
TheVanity: posts big blind 6000
*** HOLE CARDS ***
dictba: raises 6000 to 12000
Medeiros B.: folds 
Biazutti: folds 
DrTeleborian: folds 
Vnezapnostb: folds 
Dowgh-Santos: calls 12000
Siltex_by: folds 
TheVanity: calls 6000
*** FLOP *** [5h Qc 3c]
TheVanity: checks 
dictba: checks 
Dowgh-Santos: checks 
*** TURN *** [5h Qc 3c] [8c]
TheVanity: checks 
dictba: bets 26400
Dowgh-Santos: folds 
TheVanity: folds 
Uncalled bet (26400) returned to dictba
dictba collected 45000 from pot
dictba: doesn't show hand 
*** SUMMARY ***
Total pot 45000 | Rake 0 
Board [5h Qc 3c 8c]
Seat 1: Dowgh-Santos (button) folded on the Turn
Seat 2: Siltex_by (small blind) folded before Flop
Seat 3: TheVanity (big blind) folded on the Turn
Seat 4: dictba collected (45000)
Seat 5: Medeiros B. folded before Flop (didn't bet)
Seat 6: Biazutti folded before Flop (didn't bet)
Seat 7: DrTeleborian folded before Flop (didn't bet)
Seat 8: Vnezapnostb folded before Flop (didn't bet)

PokerStars Hand #251207173087: Tournament #3767885527, $40+$10+$5 USD Hold'em No Limit - Level XX (3000/6000) - 2024/06/26 20:42:38 UTC [2024/06/26 16:42:38 ET]
Table '3767885527 97' 8-max Seat #2 is the button
Seat 1: Dowgh-Santos (240711 in chips) 
Seat 2: Siltex_by (66040 in chips) 
Seat 3: TheVanity (63638 in chips) 
Seat 4: dictba (332451 in chips) 
Seat 5: Medeiros B. (67144 in chips) 
Seat 6: Biazutti (185196 in chips) 
Seat 7: DrTeleborian (288322 in chips) 
Seat 8: Vnezapnostb (208046 in chips) 
Dowgh-Santos: posts the ante 750
Siltex_by: posts the ante 750
TheVanity: posts the ante 750
dictba: posts the ante 750
Medeiros B.: posts the ante 750
Biazutti: posts the ante 750
DrTeleborian: posts the ante 750
Vnezapnostb: posts the ante 750
TheVanity: posts small blind 3000
dictba: posts big blind 6000
*** HOLE CARDS ***
Medeiros B.: folds 
Biazutti: folds 
DrTeleborian: folds 
Vnezapnostb: folds 
Dowgh-Santos: folds 
Siltex_by: folds 
TheVanity: raises 56888 to 62888 and is all-in
dictba: folds 
Uncalled bet (56888) returned to TheVanity
TheVanity collected 18000 from pot
TheVanity: doesn't show hand 
*** SUMMARY ***
Total pot 18000 | Rake 0 
Seat 1: Dowgh-Santos folded before Flop (didn't bet)
Seat 2: Siltex_by (button) folded before Flop (didn't bet)
Seat 3: TheVanity (small blind) collected (18000)
Seat 4: dictba (big blind) folded before Flop
Seat 5: Medeiros B. folded before Flop (didn't bet)
Seat 6: Biazutti folded before Flop (didn't bet)
Seat 7: DrTeleborian folded before Flop (didn't bet)
Seat 8: Vnezapnostb folded before Flop (didn't bet)

PokerStars Hand #251207180827: Tournament #3767885527, $40+$10+$5 USD Hold'em No Limit - Level XX (3000/6000) - 2024/06/26 20:43:06 UTC [2024/06/26 16:43:06 ET]
Table '3767885527 97' 8-max Seat #3 is the button
Seat 1: Dowgh-Santos (239961 in chips) 
Seat 2: Siltex_by (65290 in chips) 
Seat 3: TheVanity (74888 in chips) 
Seat 4: dictba (325701 in chips) 
Seat 5: Medeiros B. (66394 in chips) 
Seat 6: Biazutti (184446 in chips) 
Seat 7: DrTeleborian (287572 in chips) 
Seat 8: Vnezapnostb (207296 in chips) 
Dowgh-Santos: posts the ante 750
Siltex_by: posts the ante 750
TheVanity: posts the ante 750
dictba: posts the ante 750
Medeiros B.: posts the ante 750
Biazutti: posts the ante 750
DrTeleborian: posts the ante 750
Vnezapnostb: posts the ante 750
dictba: posts small blind 3000
Medeiros B.: posts big blind 6000
*** HOLE CARDS ***
Biazutti: folds 
DrTeleborian: folds 
Vnezapnostb: folds 
Dowgh-Santos: folds 
Siltex_by: folds 
TheVanity: folds 
dictba: raises 282000 to 288000
Medeiros B.: folds 
Uncalled bet (282000) returned to dictba
dictba collected 18000 from pot
dictba: doesn't show hand 
*** SUMMARY ***
Total pot 18000 | Rake 0 
Seat 1: Dowgh-Santos folded before Flop (didn't bet)
Seat 2: Siltex_by folded before Flop (didn't bet)
Seat 3: TheVanity (button) folded before Flop (didn't bet)
Seat 4: dictba (small blind) collected (18000)
Seat 5: Medeiros B. (big blind) folded before Flop
Seat 6: Biazutti folded before Flop (didn't bet)
Seat 7: DrTeleborian folded before Flop (didn't bet)
Seat 8: Vnezapnostb folded before Flop (didn't bet)

PokerStars Hand #251207185857: Tournament #3767885527, $40+$10+$5 USD Hold'em No Limit - Level XX (3000/6000) - 2024/06/26 20:43:24 UTC [2024/06/26 16:43:24 ET]
Table '3767885527 97' 8-max Seat #4 is the button
Seat 1: Dowgh-Santos (239211 in chips) 
Seat 2: Siltex_by (64540 in chips) 
Seat 3: TheVanity (74138 in chips) 
Seat 4: dictba (336951 in chips) 
Seat 5: Medeiros B. (59644 in chips) 
Seat 6: Biazutti (183696 in chips) 
Seat 7: DrTeleborian (286822 in chips) 
Seat 8: Vnezapnostb (206546 in chips) 
Dowgh-Santos: posts the ante 750
Siltex_by: posts the ante 750
TheVanity: posts the ante 750
dictba: posts the ante 750
Medeiros B.: posts the ante 750
Biazutti: posts the ante 750
DrTeleborian: posts the ante 750
Vnezapnostb: posts the ante 750
Medeiros B.: posts small blind 3000
Biazutti: posts big blind 6000
*** HOLE CARDS ***
DrTeleborian: raises 6600 to 12600
Vnezapnostb: folds 
Dowgh-Santos: folds 
Siltex_by: folds 
TheVanity: folds 
dictba: folds 
Medeiros B.: folds 
Biazutti: calls 6600
*** FLOP *** [Tc 8c 9h]
Biazutti: checks 
DrTeleborian: bets 14364
Biazutti: raises 30336 to 44700
DrTeleborian: folds 
Uncalled bet (30336) returned to Biazutti
Biazutti collected 62928 from pot
Biazutti: doesn't show hand 
*** SUMMARY ***
Total pot 62928 | Rake 0 
Board [Tc 8c 9h]
Seat 1: Dowgh-Santos folded before Flop (didn't bet)
Seat 2: Siltex_by folded before Flop (didn't bet)
Seat 3: TheVanity folded before Flop (didn't bet)
Seat 4: dictba (button) folded before Flop (didn't bet)
Seat 5: Medeiros B. (small blind) folded before Flop
Seat 6: Biazutti (big blind) collected (62928)
Seat 7: DrTeleborian folded on the Flop
Seat 8: Vnezapnostb folded before Flop (didn't bet)

PokerStars Hand #251207203453: Tournament #3767885527, $40+$10+$5 USD Hold'em No Limit - Level XX (3000/6000) - 2024/06/26 20:44:30 UTC [2024/06/26 16:44:30 ET]
Table '3767885527 97' 8-max Seat #5 is the button
Seat 1: Dowgh-Santos (238461 in chips) 
Seat 2: Siltex_by (63790 in chips) 
Seat 3: TheVanity (73388 in chips) 
Seat 4: dictba (336201 in chips) 
Seat 5: Medeiros B. (55894 in chips) 
Seat 6: Biazutti (218910 in chips) 
Seat 7: DrTeleborian (259108 in chips) 
Seat 8: Vnezapnostb (205796 in chips) 
Dowgh-Santos: posts the ante 750
Siltex_by: posts the ante 750
TheVanity: posts the ante 750
dictba: posts the ante 750
Medeiros B.: posts the ante 750
Biazutti: posts the ante 750
DrTeleborian: posts the ante 750
Vnezapnostb: posts the ante 750
Biazutti: posts small blind 3000
DrTeleborian: posts big blind 6000
*** HOLE CARDS ***
Vnezapnostb: folds 
Dowgh-Santos: folds 
Siltex_by: folds 
TheVanity: raises 66638 to 72638 and is all-in
dictba: folds 
Medeiros B.: folds 
Biazutti: raises 145522 to 218160 and is all-in
DrTeleborian: folds 
Uncalled bet (145522) returned to Biazutti
*** FLOP *** [6c Kc 2d]
*** TURN *** [6c Kc 2d] [Js]
*** RIVER *** [6c Kc 2d Js] [8d]
*** SHOW DOWN ***
Biazutti: shows [Qs Ad] (high card Ace)
TheVanity: shows [9h 8h] (a pair of Eights)
TheVanity collected 157276 from pot
*** SUMMARY ***
Total pot 157276 | Rake 0 
Board [6c Kc 2d Js 8d]
Seat 1: Dowgh-Santos folded before Flop (didn't bet)
Seat 2: Siltex_by folded before Flop (didn't bet)
Seat 3: TheVanity showed [9h 8h] and won (157276) with a pair of Eights
Seat 4: dictba folded before Flop (didn't bet)
Seat 5: Medeiros B. (button) folded before Flop (didn't bet)
Seat 6: Biazutti (small blind) showed [Qs Ad] and lost with high card Ace
Seat 7: DrTeleborian (big blind) folded before Flop
Seat 8: Vnezapnostb folded before Flop (didn't bet)

PokerStars Hand #251207214684: Tournament #3767885527, $40+$10+$5 USD Hold'em No Limit - Level XX (3000/6000) - 2024/06/26 20:45:10 UTC [2024/06/26 16:45:10 ET]
Table '3767885527 97' 8-max Seat #6 is the button
Seat 1: Dowgh-Santos (237711 in chips) 
Seat 2: Siltex_by (63040 in chips) 
Seat 3: TheVanity (157276 in chips) 
Seat 4: dictba (335451 in chips) 
Seat 5: Medeiros B. (55144 in chips) 
Seat 6: Biazutti (145522 in chips) 
Seat 7: DrTeleborian (252358 in chips) 
Seat 8: Vnezapnostb (205046 in chips) 
Dowgh-Santos: posts the ante 750
Siltex_by: posts the ante 750
TheVanity: posts the ante 750
dictba: posts the ante 750
Medeiros B.: posts the ante 750
Biazutti: posts the ante 750
DrTeleborian: posts the ante 750
Vnezapnostb: posts the ante 750
DrTeleborian: posts small blind 3000
Vnezapnostb: posts big blind 6000
*** HOLE CARDS ***
Dowgh-Santos: folds 
Siltex_by: folds 
TheVanity: raises 6000 to 12000
dictba: folds 
Medeiros B.: folds 
Biazutti: folds 
DrTeleborian: folds 
Vnezapnostb: calls 6000
*** FLOP *** [Qc 5d 4c]
Vnezapnostb: checks 
TheVanity: checks 
*** TURN *** [Qc 5d 4c] [8s]
Vnezapnostb: bets 17490
TheVanity: folds 
Uncalled bet (17490) returned to Vnezapnostb
Vnezapnostb collected 33000 from pot
Vnezapnostb: doesn't show hand 
*** SUMMARY ***
Total pot 33000 | Rake 0 
Board [Qc 5d 4c 8s]
Seat 1: Dowgh-Santos folded before Flop (didn't bet)
Seat 2: Siltex_by folded before Flop (didn't bet)
Seat 3: TheVanity folded on the Turn
Seat 4: dictba folded before Flop (didn't bet)
Seat 5: Medeiros B. folded before Flop (didn't bet)
Seat 6: Biazutti (button) folded before Flop (didn't bet)
Seat 7: DrTeleborian (small blind) folded before Flop
Seat 8: Vnezapnostb (big blind) collected (33000)

PokerStars Hand #251207225284: Tournament #3767885527, $40+$10+$5 USD Hold'em No Limit - Level XX (3000/6000) - 2024/06/26 20:45:49 UTC [2024/06/26 16:45:49 ET]
Table '3767885527 97' 8-max Seat #7 is the button
Seat 1: Dowgh-Santos (236961 in chips) 
Seat 2: Siltex_by (62290 in chips) 
Seat 3: TheVanity (144526 in chips) 
Seat 4: dictba (334701 in chips) 
Seat 5: Medeiros B. (54394 in chips) 
Seat 6: Biazutti (144772 in chips) 
Seat 7: DrTeleborian (248608 in chips) 
Seat 8: Vnezapnostb (225296 in chips) 
Dowgh-Santos: posts the ante 750
Siltex_by: posts the ante 750
TheVanity: posts the ante 750
dictba: posts the ante 750
Medeiros B.: posts the ante 750
Biazutti: posts the ante 750
DrTeleborian: posts the ante 750
Vnezapnostb: posts the ante 750
Vnezapnostb: posts small blind 3000
Dowgh-Santos: posts big blind 6000
*** HOLE CARDS ***
Siltex_by: folds 
TheVanity: folds 
dictba: folds 
Medeiros B.: folds 
Biazutti: folds 
DrTeleborian: raises 6600 to 12600
Vnezapnostb: folds 
Dowgh-Santos: calls 6600
*** FLOP *** [Jd 5d 3c]
Dowgh-Santos: checks 
DrTeleborian: checks 
*** TURN *** [Jd 5d 3c] [Jc]
Dowgh-Santos: checks 
DrTeleborian: bets 14364
Dowgh-Santos: calls 14364
*** RIVER *** [Jd 5d 3c Jc] [Qs]
Dowgh-Santos: checks 
DrTeleborian: bets 47972
Dowgh-Santos: folds 
Uncalled bet (47972) returned to DrTeleborian
DrTeleborian collected 62928 from pot
*** SUMMARY ***
Total pot 62928 | Rake 0 
Board [Jd 5d 3c Jc Qs]
Seat 1: Dowgh-Santos (big blind) folded on the River
Seat 2: Siltex_by folded before Flop (didn't bet)
Seat 3: TheVanity folded before Flop (didn't bet)
Seat 4: dictba folded before Flop (didn't bet)
Seat 5: Medeiros B. folded before Flop (didn't bet)
Seat 6: Biazutti folded before Flop (didn't bet)
Seat 7: DrTeleborian (button) collected (62928)
Seat 8: Vnezapnostb (small blind) folded before Flop

PokerStars Hand #251207248210: Tournament #3767885527, $40+$10+$5 USD Hold'em No Limit - Level XXI (3500/7000) - 2024/06/26 20:47:12 UTC [2024/06/26 16:47:12 ET]
Table '3767885527 97' 8-max Seat #8 is the button
Seat 1: Dowgh-Santos (209247 in chips) 
Seat 2: Siltex_by (61540 in chips) 
Seat 3: TheVanity (143776 in chips) 
Seat 4: dictba (333951 in chips) 
Seat 5: Medeiros B. (53644 in chips) 
Seat 6: Biazutti (144022 in chips) 
Seat 7: DrTeleborian (283822 in chips) 
Seat 8: Vnezapnostb (221546 in chips) 
Dowgh-Santos: posts the ante 875
Siltex_by: posts the ante 875
TheVanity: posts the ante 875
dictba: posts the ante 875
Medeiros B.: posts the ante 875
Biazutti: posts the ante 875
DrTeleborian: posts the ante 875
Vnezapnostb: posts the ante 875
Dowgh-Santos: posts small blind 3500
Siltex_by: posts big blind 7000
*** HOLE CARDS ***
TheVanity: folds 
dictba: folds 
Medeiros B.: folds 
Biazutti: raises 7000 to 14000
DrTeleborian: folds 
Vnezapnostb: folds 
Dowgh-Santos: folds 
Siltex_by: folds 
Uncalled bet (7000) returned to Biazutti
Biazutti collected 24500 from pot
Biazutti: doesn't show hand 
*** SUMMARY ***
Total pot 24500 | Rake 0 
Seat 1: Dowgh-Santos (small blind) folded before Flop
Seat 2: Siltex_by (big blind) folded before Flop
Seat 3: TheVanity folded before Flop (didn't bet)
Seat 4: dictba folded before Flop (didn't bet)
Seat 5: Medeiros B. folded before Flop (didn't bet)
Seat 6: Biazutti collected (24500)
Seat 7: DrTeleborian folded before Flop (didn't bet)
Seat 8: Vnezapnostb (button) folded before Flop (didn't bet)

PokerStars Hand #251207256522: Tournament #3767885527, $40+$10+$5 USD Hold'em No Limit - Level XXI (3500/7000) - 2024/06/26 20:47:42 UTC [2024/06/26 16:47:42 ET]
Table '3767885527 97' 8-max Seat #1 is the button
Seat 1: Dowgh-Santos (204872 in chips) 
Seat 2: Siltex_by (53665 in chips) 
Seat 3: TheVanity (142901 in chips) 
Seat 4: dictba (333076 in chips) 
Seat 5: Medeiros B. (52769 in chips) 
Seat 6: Biazutti (160647 in chips) 
Seat 7: DrTeleborian (282947 in chips) 
Seat 8: Vnezapnostb (220671 in chips) 
Dowgh-Santos: posts the ante 875
Siltex_by: posts the ante 875
TheVanity: posts the ante 875
dictba: posts the ante 875
Medeiros B.: posts the ante 875
Biazutti: posts the ante 875
DrTeleborian: posts the ante 875
Vnezapnostb: posts the ante 875
Siltex_by: posts small blind 3500
TheVanity: posts big blind 7000
*** HOLE CARDS ***
dictba: folds 
Medeiros B.: raises 44894 to 51894 and is all-in
Biazutti: folds 
DrTeleborian: folds 
Vnezapnostb: folds 
Dowgh-Santos: folds 
Siltex_by: folds 
TheVanity: folds 
Uncalled bet (44894) returned to Medeiros B.
Medeiros B. collected 24500 from pot
Medeiros B.: doesn't show hand 
*** SUMMARY ***
Total pot 24500 | Rake 0 
Seat 1: Dowgh-Santos (button) folded before Flop (didn't bet)
Seat 2: Siltex_by (small blind) folded before Flop
Seat 3: TheVanity (big blind) folded before Flop
Seat 4: dictba folded before Flop (didn't bet)
Seat 5: Medeiros B. collected (24500)
Seat 6: Biazutti folded before Flop (didn't bet)
Seat 7: DrTeleborian folded before Flop (didn't bet)
Seat 8: Vnezapnostb folded before Flop (didn't bet)

PokerStars Hand #251207264805: Tournament #3767885527, $40+$10+$5 USD Hold'em No Limit - Level XXI (3500/7000) - 2024/06/26 20:48:12 UTC [2024/06/26 16:48:12 ET]
Table '3767885527 97' 8-max Seat #2 is the button
Seat 1: Dowgh-Santos (203997 in chips) 
Seat 2: Siltex_by (49290 in chips) 
Seat 3: TheVanity (135026 in chips) 
Seat 4: dictba (332201 in chips) 
Seat 5: Medeiros B. (69394 in chips) 
Seat 6: Biazutti (159772 in chips) 
Seat 7: DrTeleborian (282072 in chips) 
Seat 8: Vnezapnostb (219796 in chips) 
Dowgh-Santos: posts the ante 875
Siltex_by: posts the ante 875
TheVanity: posts the ante 875
dictba: posts the ante 875
Medeiros B.: posts the ante 875
Biazutti: posts the ante 875
DrTeleborian: posts the ante 875
Vnezapnostb: posts the ante 875
TheVanity: posts small blind 3500
dictba: posts big blind 7000
*** HOLE CARDS ***
Medeiros B.: folds 
Biazutti: folds 
DrTeleborian: folds 
Vnezapnostb: folds 
Dowgh-Santos: raises 7000 to 14000
Siltex_by: folds 
TheVanity: folds 
dictba: calls 7000
*** FLOP *** [As Kc 8s]
dictba: checks 
Dowgh-Santos: bets 11550
dictba: folds 
Uncalled bet (11550) returned to Dowgh-Santos
Dowgh-Santos collected 38500 from pot
Dowgh-Santos: doesn't show hand 
*** SUMMARY ***
Total pot 38500 | Rake 0 
Board [As Kc 8s]
Seat 1: Dowgh-Santos collected (38500)
Seat 2: Siltex_by (button) folded before Flop (didn't bet)
Seat 3: TheVanity (small blind) folded before Flop
Seat 4: dictba (big blind) folded on the Flop
Seat 5: Medeiros B. folded before Flop (didn't bet)
Seat 6: Biazutti folded before Flop (didn't bet)
Seat 7: DrTeleborian folded before Flop (didn't bet)
Seat 8: Vnezapnostb folded before Flop (didn't bet)

PokerStars Hand #251207273426: Tournament #3767885527, $40+$10+$5 USD Hold'em No Limit - Level XXI (3500/7000) - 2024/06/26 20:48:43 UTC [2024/06/26 16:48:43 ET]
Table '3767885527 97' 8-max Seat #3 is the button
Seat 1: Dowgh-Santos (227622 in chips) 
Seat 2: Siltex_by (48415 in chips) 
Seat 3: TheVanity (130651 in chips) 
Seat 4: dictba (317326 in chips) 
Seat 5: Medeiros B. (68519 in chips) 
Seat 6: Biazutti (158897 in chips) 
Seat 7: DrTeleborian (281197 in chips) 
Seat 8: Vnezapnostb (218921 in chips) 
Dowgh-Santos: posts the ante 875
Siltex_by: posts the ante 875
TheVanity: posts the ante 875
dictba: posts the ante 875
Medeiros B.: posts the ante 875
Biazutti: posts the ante 875
DrTeleborian: posts the ante 875
Vnezapnostb: posts the ante 875
dictba: posts small blind 3500
Medeiros B.: posts big blind 7000
*** HOLE CARDS ***
Biazutti: raises 7000 to 14000
DrTeleborian: folds 
Vnezapnostb: folds 
Dowgh-Santos: folds 
Siltex_by: folds 
TheVanity: folds 
dictba: folds 
Medeiros B.: calls 7000
*** FLOP *** [Ah Ks Kc]
Medeiros B.: checks 
Biazutti: bets 7000
Medeiros B.: raises 7000 to 14000
Biazutti: calls 7000
*** TURN *** [Ah Ks Kc] [8s]
Medeiros B.: checks 
Biazutti: checks 
*** RIVER *** [Ah Ks Kc 8s] [6h]
Medeiros B.: bets 39644 and is all-in
Biazutti: calls 39644
*** SHOW DOWN ***
Medeiros B.: shows [4s Kd] (three of a kind, Kings)
Biazutti: shows [3s As] (two pair, Aces and Kings)
Medeiros B. collected 145788 from pot
*** SUMMARY ***
Total pot 145788 | Rake 0 
Board [Ah Ks Kc 8s 6h]
Seat 1: Dowgh-Santos folded before Flop (didn't bet)
Seat 2: Siltex_by folded before Flop (didn't bet)
Seat 3: TheVanity (button) folded before Flop (didn't bet)
Seat 4: dictba (small blind) folded before Flop
Seat 5: Medeiros B. (big blind) showed [4s Kd] and won (145788) with three of a kind, Kings
Seat 6: Biazutti showed [3s As] and lost with two pair, Aces and Kings
Seat 7: DrTeleborian folded before Flop (didn't bet)
Seat 8: Vnezapnostb folded before Flop (didn't bet)

PokerStars Hand #251207287659: Tournament #3767885527, $40+$10+$5 USD Hold'em No Limit - Level XXI (3500/7000) - 2024/06/26 20:49:35 UTC [2024/06/26 16:49:35 ET]
Table '3767885527 97' 8-max Seat #4 is the button
Seat 1: Dowgh-Santos (226747 in chips) 
Seat 2: Siltex_by (47540 in chips) 
Seat 3: TheVanity (129776 in chips) 
Seat 4: dictba (312951 in chips) 
Seat 5: Medeiros B. (145788 in chips) 
Seat 6: Biazutti (90378 in chips) 
Seat 7: DrTeleborian (280322 in chips) 
Seat 8: Vnezapnostb (218046 in chips) 
Dowgh-Santos: posts the ante 875
Siltex_by: posts the ante 875
TheVanity: posts the ante 875
dictba: posts the ante 875
Medeiros B.: posts the ante 875
Biazutti: posts the ante 875
DrTeleborian: posts the ante 875
Vnezapnostb: posts the ante 875
Medeiros B.: posts small blind 3500
Biazutti: posts big blind 7000
*** HOLE CARDS ***
DrTeleborian: folds 
Vnezapnostb: folds 
Dowgh-Santos: folds 
Siltex_by: raises 39665 to 46665 and is all-in
TheVanity: folds 
dictba: folds 
Medeiros B.: folds 
Biazutti: folds 
Uncalled bet (39665) returned to Siltex_by
Siltex_by collected 24500 from pot
Siltex_by: doesn't show hand 
*** SUMMARY ***
Total pot 24500 | Rake 0 
Seat 1: Dowgh-Santos folded before Flop (didn't bet)
Seat 2: Siltex_by collected (24500)
Seat 3: TheVanity folded before Flop (didn't bet)
Seat 4: dictba (button) folded before Flop (didn't bet)
Seat 5: Medeiros B. (small blind) folded before Flop
Seat 6: Biazutti (big blind) folded before Flop
Seat 7: DrTeleborian folded before Flop (didn't bet)
Seat 8: Vnezapnostb folded before Flop (didn't bet)

PokerStars Hand #251207295019: Tournament #3767885527, $40+$10+$5 USD Hold'em No Limit - Level XXI (3500/7000) - 2024/06/26 20:50:03 UTC [2024/06/26 16:50:03 ET]
Table '3767885527 97' 8-max Seat #5 is the button
Seat 1: Dowgh-Santos (225872 in chips) 
Seat 2: Siltex_by (64165 in chips) 
Seat 3: TheVanity (128901 in chips) 
Seat 4: dictba (312076 in chips) 
Seat 5: Medeiros B. (141413 in chips) 
Seat 6: Biazutti (82503 in chips) 
Seat 7: DrTeleborian (279447 in chips) 
Seat 8: Vnezapnostb (217171 in chips) 
Dowgh-Santos: posts the ante 875
Siltex_by: posts the ante 875
TheVanity: posts the ante 875
dictba: posts the ante 875
Medeiros B.: posts the ante 875
Biazutti: posts the ante 875
DrTeleborian: posts the ante 875
Vnezapnostb: posts the ante 875
Biazutti: posts small blind 3500
DrTeleborian: posts big blind 7000
*** HOLE CARDS ***
Vnezapnostb: folds 
Dowgh-Santos: raises 7000 to 14000
Siltex_by: folds 
TheVanity: folds 
dictba: folds 
Medeiros B.: folds 
Biazutti: folds 
DrTeleborian: calls 7000
*** FLOP *** [4d Js 4h]
DrTeleborian: checks 
Dowgh-Santos: bets 7700
DrTeleborian: raises 26138 to 33838
Dowgh-Santos: folds 
Uncalled bet (26138) returned to DrTeleborian
DrTeleborian collected 53900 from pot
*** SUMMARY ***
Total pot 53900 | Rake 0 
Board [4d Js 4h]
Seat 1: Dowgh-Santos folded on the Flop
Seat 2: Siltex_by folded before Flop (didn't bet)
Seat 3: TheVanity folded before Flop (didn't bet)
Seat 4: dictba folded before Flop (didn't bet)
Seat 5: Medeiros B. (button) folded before Flop (didn't bet)
Seat 6: Biazutti (small blind) folded before Flop
Seat 7: DrTeleborian (big blind) collected (53900)
Seat 8: Vnezapnostb folded before Flop (didn't bet)

PokerStars Hand #251207309728: Tournament #3767885527, $40+$10+$5 USD Hold'em No Limit - Level XXI (3500/7000) - 2024/06/26 20:50:57 UTC [2024/06/26 16:50:57 ET]
Table '3767885527 97' 8-max Seat #6 is the button
Seat 1: Dowgh-Santos (203297 in chips) 
Seat 2: Siltex_by (63290 in chips) 
Seat 3: TheVanity (128026 in chips) 
Seat 4: dictba (311201 in chips) 
Seat 5: Medeiros B. (140538 in chips) 
Seat 6: Biazutti (78128 in chips) 
Seat 7: DrTeleborian (310772 in chips) 
Seat 8: Vnezapnostb (216296 in chips) 
Dowgh-Santos: posts the ante 875
Siltex_by: posts the ante 875
TheVanity: posts the ante 875
dictba: posts the ante 875
Medeiros B.: posts the ante 875
Biazutti: posts the ante 875
DrTeleborian: posts the ante 875
Vnezapnostb: posts the ante 875
DrTeleborian: posts small blind 3500
Vnezapnostb: posts big blind 7000
*** HOLE CARDS ***
Dowgh-Santos: folds 
Siltex_by: folds 
TheVanity: folds 
dictba: folds 
Medeiros B.: raises 7000 to 14000
Biazutti: raises 63253 to 77253 and is all-in
DrTeleborian: folds 
Vnezapnostb: folds 
Medeiros B.: calls 63253
*** FLOP *** [4c Ac 2h]
*** TURN *** [4c Ac 2h] [2d]
*** RIVER *** [4c Ac 2h 2d] [8h]
*** SHOW DOWN ***
Medeiros B.: shows [Ad 6d] (two pair, Aces and Deuces)
Biazutti: shows [Ah Js] (two pair, Aces and Deuces - Jack kicker)
Biazutti collected 172006 from pot
*** SUMMARY ***
Total pot 172006 | Rake 0 
Board [4c Ac 2h 2d 8h]
Seat 1: Dowgh-Santos folded before Flop (didn't bet)
Seat 2: Siltex_by folded before Flop (didn't bet)
Seat 3: TheVanity folded before Flop (didn't bet)
Seat 4: dictba folded before Flop (didn't bet)
Seat 5: Medeiros B. showed [Ad 6d] and lost with two pair, Aces and Deuces
Seat 6: Biazutti (button) showed [Ah Js] and won (172006) with two pair, Aces and Deuces
Seat 7: DrTeleborian (small blind) folded before Flop
Seat 8: Vnezapnostb (big blind) folded before Flop

PokerStars Hand #251207317440: Tournament #3767885527, $40+$10+$5 USD Hold'em No Limit - Level XXI (3500/7000) - 2024/06/26 20:51:26 UTC [2024/06/26 16:51:26 ET]
Table '3767885527 97' 8-max Seat #7 is the button
Seat 1: Dowgh-Santos (202422 in chips) 
Seat 2: Siltex_by (62415 in chips) 
Seat 3: TheVanity (127151 in chips) 
Seat 4: dictba (310326 in chips) 
Seat 5: Medeiros B. (62410 in chips) 
Seat 6: Biazutti (172006 in chips) 
Seat 7: DrTeleborian (306397 in chips) 
Seat 8: Vnezapnostb (208421 in chips) 
Dowgh-Santos: posts the ante 875
Siltex_by: posts the ante 875
TheVanity: posts the ante 875
dictba: posts the ante 875
Medeiros B.: posts the ante 875
Biazutti: posts the ante 875
DrTeleborian: posts the ante 875
Vnezapnostb: posts the ante 875
Vnezapnostb: posts small blind 3500
Dowgh-Santos: posts big blind 7000
*** HOLE CARDS ***
Siltex_by: folds 
TheVanity: folds 
dictba: raises 7000 to 14000
Medeiros B.: folds 
Biazutti: folds 
DrTeleborian: folds 
Vnezapnostb: calls 10500
Dowgh-Santos: raises 187547 to 201547 and is all-in
dictba: folds 
Vnezapnostb: folds 
Uncalled bet (187547) returned to Dowgh-Santos
Dowgh-Santos collected 49000 from pot
Dowgh-Santos: doesn't show hand 
*** SUMMARY ***
Total pot 49000 | Rake 0 
Seat 1: Dowgh-Santos (big blind) collected (49000)
Seat 2: Siltex_by folded before Flop (didn't bet)
Seat 3: TheVanity folded before Flop (didn't bet)
Seat 4: dictba folded before Flop
Seat 5: Medeiros B. folded before Flop (didn't bet)
Seat 6: Biazutti folded before Flop (didn't bet)
Seat 7: DrTeleborian (button) folded before Flop (didn't bet)
Seat 8: Vnezapnostb (small blind) folded before Flop

PokerStars Hand #251207327769: Tournament #3767885527, $40+$10+$5 USD Hold'em No Limit - Level XXI (3500/7000) - 2024/06/26 20:52:04 UTC [2024/06/26 16:52:04 ET]
Table '3767885527 97' 8-max Seat #8 is the button
Seat 1: Dowgh-Santos (236547 in chips) 
Seat 2: Siltex_by (61540 in chips) 
Seat 3: TheVanity (126276 in chips) 
Seat 4: dictba (295451 in chips) 
Seat 5: Medeiros B. (61535 in chips) 
Seat 6: Biazutti (171131 in chips) 
Seat 7: DrTeleborian (305522 in chips) 
Seat 8: Vnezapnostb (193546 in chips) 
Dowgh-Santos: posts the ante 875
Siltex_by: posts the ante 875
TheVanity: posts the ante 875
dictba: posts the ante 875
Medeiros B.: posts the ante 875
Biazutti: posts the ante 875
DrTeleborian: posts the ante 875
Vnezapnostb: posts the ante 875
Dowgh-Santos: posts small blind 3500
Siltex_by: posts big blind 7000
*** HOLE CARDS ***
TheVanity: folds 
dictba: folds 
Medeiros B.: raises 49000 to 56000
Biazutti: folds 
DrTeleborian: folds 
Vnezapnostb: folds 
Dowgh-Santos: folds 
Siltex_by: folds 
Uncalled bet (49000) returned to Medeiros B.
Medeiros B. collected 24500 from pot
Medeiros B.: doesn't show hand 
*** SUMMARY ***
Total pot 24500 | Rake 0 
Seat 1: Dowgh-Santos (small blind) folded before Flop
Seat 2: Siltex_by (big blind) folded before Flop
Seat 3: TheVanity folded before Flop (didn't bet)
Seat 4: dictba folded before Flop (didn't bet)
Seat 5: Medeiros B. collected (24500)
Seat 6: Biazutti folded before Flop (didn't bet)
Seat 7: DrTeleborian folded before Flop (didn't bet)
Seat 8: Vnezapnostb (button) folded before Flop (didn't bet)

PokerStars Hand #251207336680: Tournament #3767885527, $40+$10+$5 USD Hold'em No Limit - Level XXI (3500/7000) - 2024/06/26 20:52:37 UTC [2024/06/26 16:52:37 ET]
Table '3767885527 97' 8-max Seat #1 is the button
Seat 1: Dowgh-Santos (232172 in chips) 
Seat 2: Siltex_by (53665 in chips) 
Seat 3: TheVanity (125401 in chips) 
Seat 4: dictba (294576 in chips) 
Seat 5: Medeiros B. (78160 in chips) 
Seat 6: Biazutti (170256 in chips) 
Seat 7: DrTeleborian (304647 in chips) 
Seat 8: Vnezapnostb (192671 in chips) 
Dowgh-Santos: posts the ante 875
Siltex_by: posts the ante 875
TheVanity: posts the ante 875
dictba: posts the ante 875
Medeiros B.: posts the ante 875
Biazutti: posts the ante 875
DrTeleborian: posts the ante 875
Vnezapnostb: posts the ante 875
Siltex_by: posts small blind 3500
TheVanity: posts big blind 7000
*** HOLE CARDS ***
dictba: raises 7000 to 14000
Medeiros B.: folds 
Biazutti: folds 
DrTeleborian: folds 
Vnezapnostb: folds 
Dowgh-Santos: folds 
Siltex_by: folds 
TheVanity: folds 
Uncalled bet (7000) returned to dictba
dictba collected 24500 from pot
dictba: doesn't show hand 
*** SUMMARY ***
Total pot 24500 | Rake 0 
Seat 1: Dowgh-Santos (button) folded before Flop (didn't bet)
Seat 2: Siltex_by (small blind) folded before Flop
Seat 3: TheVanity (big blind) folded before Flop
Seat 4: dictba collected (24500)
Seat 5: Medeiros B. folded before Flop (didn't bet)
Seat 6: Biazutti folded before Flop (didn't bet)
Seat 7: DrTeleborian folded before Flop (didn't bet)
Seat 8: Vnezapnostb folded before Flop (didn't bet)

PokerStars Hand #251207346359: Tournament #3767885527, $40+$10+$5 USD Hold'em No Limit - Level XXI (3500/7000) - 2024/06/26 20:53:13 UTC [2024/06/26 16:53:13 ET]
Table '3767885527 97' 8-max Seat #2 is the button
Seat 1: Dowgh-Santos (231297 in chips) 
Seat 2: Siltex_by (49290 in chips) 
Seat 3: TheVanity (117526 in chips) 
Seat 4: dictba (311201 in chips) 
Seat 5: Medeiros B. (77285 in chips) 
Seat 6: Biazutti (169381 in chips) 
Seat 7: DrTeleborian (303772 in chips) 
Seat 8: Vnezapnostb (191796 in chips) 
Dowgh-Santos: posts the ante 875
Siltex_by: posts the ante 875
TheVanity: posts the ante 875
dictba: posts the ante 875
Medeiros B.: posts the ante 875
Biazutti: posts the ante 875
DrTeleborian: posts the ante 875
Vnezapnostb: posts the ante 875
TheVanity: posts small blind 3500
dictba: posts big blind 7000
*** HOLE CARDS ***
Medeiros B.: folds 
Biazutti: folds 
DrTeleborian: folds 
Vnezapnostb: folds 
Dowgh-Santos: raises 7000 to 14000
Siltex_by: folds 
TheVanity: folds 
dictba: folds 
Uncalled bet (7000) returned to Dowgh-Santos
Dowgh-Santos collected 24500 from pot
Dowgh-Santos: doesn't show hand 
*** SUMMARY ***
Total pot 24500 | Rake 0 
Seat 1: Dowgh-Santos collected (24500)
Seat 2: Siltex_by (button) folded before Flop (didn't bet)
Seat 3: TheVanity (small blind) folded before Flop
Seat 4: dictba (big blind) folded before Flop
Seat 5: Medeiros B. folded before Flop (didn't bet)
Seat 6: Biazutti folded before Flop (didn't bet)
Seat 7: DrTeleborian folded before Flop (didn't bet)
Seat 8: Vnezapnostb folded before Flop (didn't bet)

PokerStars Hand #251207352781: Tournament #3767885527, $40+$10+$5 USD Hold'em No Limit - Level XXI (3500/7000) - 2024/06/26 20:53:37 UTC [2024/06/26 16:53:37 ET]
Table '3767885527 97' 8-max Seat #3 is the button
Seat 1: Dowgh-Santos (247922 in chips) 
Seat 2: Siltex_by (48415 in chips) 
Seat 3: TheVanity (113151 in chips) 
Seat 4: dictba (303326 in chips) 
Seat 5: Medeiros B. (76410 in chips) 
Seat 6: Biazutti (168506 in chips) 
Seat 7: DrTeleborian (302897 in chips) 
Seat 8: Vnezapnostb (190921 in chips) 
Dowgh-Santos: posts the ante 875
Siltex_by: posts the ante 875
TheVanity: posts the ante 875
dictba: posts the ante 875
Medeiros B.: posts the ante 875
Biazutti: posts the ante 875
DrTeleborian: posts the ante 875
Vnezapnostb: posts the ante 875
dictba: posts small blind 3500
Medeiros B.: posts big blind 7000
*** HOLE CARDS ***
Biazutti: folds 
DrTeleborian: folds 
Vnezapnostb: folds 
Dowgh-Santos: raises 7000 to 14000
Siltex_by: folds 
TheVanity: folds 
dictba: folds 
Medeiros B.: raises 61535 to 75535 and is all-in
Dowgh-Santos: calls 61535
*** FLOP *** [Ks 7c 2d]
*** TURN *** [Ks 7c 2d] [8s]
*** RIVER *** [Ks 7c 2d 8s] [7h]
*** SHOW DOWN ***
Medeiros B.: shows [Ad 6c] (a pair of Sevens)
Dowgh-Santos: shows [Jd Kd] (two pair, Kings and Sevens)
Dowgh-Santos collected 161570 from pot
Medeiros B. finished the tournament in 186th place and received $126.61.
*** SUMMARY ***
Total pot 161570 | Rake 0 
Board [Ks 7c 2d 8s 7h]
Seat 1: Dowgh-Santos showed [Jd Kd] and won (161570) with two pair, Kings and Sevens
Seat 2: Siltex_by folded before Flop (didn't bet)
Seat 3: TheVanity (button) folded before Flop (didn't bet)
Seat 4: dictba (small blind) folded before Flop
Seat 5: Medeiros B. (big blind) showed [Ad 6c] and lost with a pair of Sevens
Seat 6: Biazutti folded before Flop (didn't bet)
Seat 7: DrTeleborian folded before Flop (didn't bet)
Seat 8: Vnezapnostb folded before Flop (didn't bet)

PokerStars Hand #251207363138: Tournament #3767885527, $40+$10+$5 USD Hold'em No Limit - Level XXI (3500/7000) - 2024/06/26 20:54:16 UTC [2024/06/26 16:54:16 ET]
Table '3767885527 97' 8-max Seat #4 is the button
Seat 1: Dowgh-Santos (333082 in chips) 
Seat 2: Siltex_by (47540 in chips) 
Seat 3: TheVanity (112276 in chips) 
Seat 4: dictba (298951 in chips) 
Seat 6: Biazutti (167631 in chips) 
Seat 7: DrTeleborian (302022 in chips) 
Seat 8: Vnezapnostb (190046 in chips) 
Dowgh-Santos: posts the ante 875
Siltex_by: posts the ante 875
TheVanity: posts the ante 875
dictba: posts the ante 875
Biazutti: posts the ante 875
DrTeleborian: posts the ante 875
Vnezapnostb: posts the ante 875
Biazutti: posts small blind 3500
DrTeleborian: posts big blind 7000
*** HOLE CARDS ***
Vnezapnostb: folds 
Dowgh-Santos: folds 
Siltex_by: raises 39665 to 46665 and is all-in
TheVanity: folds 
dictba: folds 
jaaum00 is disconnected 
Biazutti: folds 
DrTeleborian: calls 39665
*** FLOP *** [4h 2c Ad]
*** TURN *** [4h 2c Ad] [Jh]
*** RIVER *** [4h 2c Ad Jh] [3s]
*** SHOW DOWN ***
DrTeleborian: shows [7h Js] (a pair of Jacks)
Siltex_by: shows [As Tc] (a pair of Aces)
Siltex_by collected 102955 from pot
*** SUMMARY ***
Total pot 102955 | Rake 0 
Board [4h 2c Ad Jh 3s]
Seat 1: Dowgh-Santos folded before Flop (didn't bet)
Seat 2: Siltex_by showed [As Tc] and won (102955) with a pair of Aces
Seat 3: TheVanity folded before Flop (didn't bet)
Seat 4: dictba (button) folded before Flop (didn't bet)
Seat 6: Biazutti (small blind) folded before Flop
Seat 7: DrTeleborian (big blind) showed [7h Js] and lost with a pair of Jacks
Seat 8: Vnezapnostb folded before Flop (didn't bet)

PokerStars Hand #251207374720: Tournament #3767885527, $40+$10+$5 USD Hold'em No Limit - Level XXI (3500/7000) - 2024/06/26 20:55:00 UTC [2024/06/26 16:55:00 ET]
Table '3767885527 97' 8-max Seat #6 is the button
Seat 1: Dowgh-Santos (332207 in chips) 
Seat 2: Siltex_by (102955 in chips) 
Seat 3: TheVanity (111401 in chips) 
Seat 4: dictba (298076 in chips) 
Seat 5: jaaum00 (233646 in chips) 
Seat 6: Biazutti (163256 in chips) 
Seat 7: DrTeleborian (254482 in chips) 
Seat 8: Vnezapnostb (189171 in chips) 
Dowgh-Santos: posts the ante 875
Siltex_by: posts the ante 875
TheVanity: posts the ante 875
dictba: posts the ante 875
jaaum00: posts the ante 875
Biazutti: posts the ante 875
DrTeleborian: posts the ante 875
Vnezapnostb: posts the ante 875
DrTeleborian: posts small blind 3500
Vnezapnostb: posts big blind 7000
*** HOLE CARDS ***
Dowgh-Santos: raises 7000 to 14000
Siltex_by: folds 
TheVanity: folds 
dictba: folds 
jaaum00: calls 14000
Biazutti: folds 
DrTeleborian: calls 10500
Vnezapnostb: raises 174296 to 188296 and is all-in
Dowgh-Santos: raises 143036 to 331332 and is all-in
jaaum00: folds 
DrTeleborian: folds 
Uncalled bet (143036) returned to Dowgh-Santos
*** FLOP *** [8s Jd Js]
*** TURN *** [8s Jd Js] [2h]
*** RIVER *** [8s Jd Js 2h] [5d]
*** SHOW DOWN ***
Vnezapnostb: shows [9s 9d] (two pair, Jacks and Nines)
Dowgh-Santos: shows [Td Th] (two pair, Jacks and Tens)
Dowgh-Santos collected 411592 from pot
Vnezapnostb finished the tournament in 180th place and received $126.61.
*** SUMMARY ***
Total pot 411592 | Rake 0 
Board [8s Jd Js 2h 5d]
Seat 1: Dowgh-Santos showed [Td Th] and won (411592) with two pair, Jacks and Tens
Seat 2: Siltex_by folded before Flop (didn't bet)
Seat 3: TheVanity folded before Flop (didn't bet)
Seat 4: dictba folded before Flop (didn't bet)
Seat 5: jaaum00 folded before Flop
Seat 6: Biazutti (button) folded before Flop (didn't bet)
Seat 7: DrTeleborian (small blind) folded before Flop
Seat 8: Vnezapnostb (big blind) showed [9s 9d] and lost with two pair, Jacks and Nines

PokerStars Hand #251207474932: Tournament #3767885527, $40+$10+$5 USD Hold'em No Limit - Level XXI (3500/7000) - 2024/06/26 21:02:48 UTC [2024/06/26 17:02:48 ET]
Table '3767885527 97' 8-max Seat #7 is the button
Seat 1: Dowgh-Santos (554628 in chips) 
Seat 2: Siltex_by (102080 in chips) 
Seat 3: TheVanity (110526 in chips) 
Seat 4: dictba (297201 in chips) 
Seat 5: jaaum00 (218771 in chips) 
Seat 6: Biazutti (162381 in chips) 
Seat 7: DrTeleborian (239607 in chips) 
Dowgh-Santos: posts the ante 875
Siltex_by: posts the ante 875
TheVanity: posts the ante 875
dictba: posts the ante 875
jaaum00: posts the ante 875
Biazutti: posts the ante 875
DrTeleborian: posts the ante 875
Dowgh-Santos: posts small blind 3500
Siltex_by: posts big blind 7000
*** HOLE CARDS ***
Siltex_by is disconnected 
TheVanity: folds 
dictba: folds 
jaaum00: folds 
Biazutti: folds 
DrTeleborian: folds 
Dowgh-Santos: raises 546753 to 553753 and is all-in
Siltex_by: folds 
Uncalled bet (546753) returned to Dowgh-Santos
Dowgh-Santos collected 20125 from pot
Dowgh-Santos: doesn't show hand 
*** SUMMARY ***
Total pot 20125 | Rake 0 
Seat 1: Dowgh-Santos (small blind) collected (20125)
Seat 2: Siltex_by (big blind) folded before Flop
Seat 3: TheVanity folded before Flop (didn't bet)
Seat 4: dictba folded before Flop (didn't bet)
Seat 5: jaaum00 folded before Flop (didn't bet)
Seat 6: Biazutti folded before Flop (didn't bet)
Seat 7: DrTeleborian (button) folded before Flop (didn't bet)

PokerStars Hand #251207485433: Tournament #3767885527, $40+$10+$5 USD Hold'em No Limit - Level XXI (3500/7000) - 2024/06/26 21:03:27 UTC [2024/06/26 17:03:27 ET]
Table '3767885527 97' 8-max Seat #1 is the button
Seat 1: Dowgh-Santos (566878 in chips) 
Seat 2: Siltex_by (94205 in chips) 
Seat 3: TheVanity (109651 in chips) 
Seat 4: dictba (296326 in chips) 
Seat 5: jaaum00 (217896 in chips) 
Seat 6: Biazutti (161506 in chips) 
Seat 7: DrTeleborian (238732 in chips) 
Dowgh-Santos: posts the ante 875
Siltex_by: posts the ante 875
TheVanity: posts the ante 875
dictba: posts the ante 875
jaaum00: posts the ante 875
Biazutti: posts the ante 875
DrTeleborian: posts the ante 875
Siltex_by: posts small blind 3500
TheVanity: posts big blind 7000
*** HOLE CARDS ***
dictba: raises 7000 to 14000
jaaum00: raises 21000 to 35000
Biazutti: folds 
DrTeleborian: folds 
Dowgh-Santos: folds 
Siltex_by: folds 
TheVanity: folds 
dictba: folds 
Uncalled bet (21000) returned to jaaum00
jaaum00 collected 44625 from pot
jaaum00: doesn't show hand 
*** SUMMARY ***
Total pot 44625 | Rake 0 
Seat 1: Dowgh-Santos (button) folded before Flop (didn't bet)
Seat 2: Siltex_by (small blind) folded before Flop
Seat 3: TheVanity (big blind) folded before Flop
Seat 4: dictba folded before Flop
Seat 5: jaaum00 collected (44625)
Seat 6: Biazutti folded before Flop (didn't bet)
Seat 7: DrTeleborian folded before Flop (didn't bet)

PokerStars Hand #251207496480: Tournament #3767885527, $40+$10+$5 USD Hold'em No Limit - Level XXII (4000/8000) - 2024/06/26 21:04:08 UTC [2024/06/26 17:04:08 ET]
Table '3767885527 97' 8-max Seat #2 is the button
Seat 1: Dowgh-Santos (566003 in chips) 
Seat 2: Siltex_by (89830 in chips) 
Seat 3: TheVanity (101776 in chips) 
Seat 4: dictba (281451 in chips) 
Seat 5: jaaum00 (247646 in chips) 
Seat 6: Biazutti (160631 in chips) 
Seat 7: DrTeleborian (237857 in chips) 
Dowgh-Santos: posts the ante 1000
Siltex_by: posts the ante 1000
TheVanity: posts the ante 1000
dictba: posts the ante 1000
jaaum00: posts the ante 1000
Biazutti: posts the ante 1000
DrTeleborian: posts the ante 1000
TheVanity: posts small blind 4000
dictba: posts big blind 8000
*** HOLE CARDS ***
jaaum00: folds 
Biazutti: folds 
DrTeleborian: raises 8800 to 16800
Dowgh-Santos: folds 
Siltex_by: folds 
Tagomaga is disconnected 
TheVanity: folds 
dictba: raises 35200 to 52000
DrTeleborian: calls 35200
*** FLOP *** [2h 7s 8d]
dictba: bets 35100
DrTeleborian: raises 46300 to 81400
dictba: folds 
Uncalled bet (46300) returned to DrTeleborian
DrTeleborian collected 185200 from pot
*** SUMMARY ***
Total pot 185200 | Rake 0 
Board [2h 7s 8d]
Seat 1: Dowgh-Santos folded before Flop (didn't bet)
Seat 2: Siltex_by (button) folded before Flop (didn't bet)
Seat 3: TheVanity (small blind) folded before Flop
Seat 4: dictba (big blind) folded on the Flop
Seat 5: jaaum00 folded before Flop (didn't bet)
Seat 6: Biazutti folded before Flop (didn't bet)
Seat 7: DrTeleborian collected (185200)

PokerStars Hand #251207520557: Tournament #3767885527, $40+$10+$5 USD Hold'em No Limit - Level XXII (4000/8000) - 2024/06/26 21:05:33 UTC [2024/06/26 17:05:33 ET]
Table '3767885527 97' 8-max Seat #3 is the button
Seat 1: Dowgh-Santos (565003 in chips) 
Seat 2: Siltex_by (88830 in chips) 
Seat 3: TheVanity (96776 in chips) 
Seat 4: dictba (193351 in chips) 
Seat 5: jaaum00 (246646 in chips) 
Seat 6: Biazutti (159631 in chips) 
Seat 7: DrTeleborian (334957 in chips) 
Seat 8: Tagomaga (185366 in chips) 
Dowgh-Santos: posts the ante 1000
Siltex_by: posts the ante 1000
TheVanity: posts the ante 1000
dictba: posts the ante 1000
jaaum00: posts the ante 1000
Biazutti: posts the ante 1000
DrTeleborian: posts the ante 1000
Tagomaga: posts the ante 1000
dictba: posts small blind 4000
jaaum00: posts big blind 8000
*** HOLE CARDS ***
Biazutti: folds 
DrTeleborian: folds 
Tagomaga: folds 
Dowgh-Santos: folds 
Siltex_by: raises 79830 to 87830 and is all-in
TheVanity: folds 
dictba: folds 
jaaum00: folds 
Uncalled bet (79830) returned to Siltex_by
Siltex_by collected 28000 from pot
Siltex_by: doesn't show hand 
*** SUMMARY ***
Total pot 28000 | Rake 0 
Seat 1: Dowgh-Santos folded before Flop (didn't bet)
Seat 2: Siltex_by collected (28000)
Seat 3: TheVanity (button) folded before Flop (didn't bet)
Seat 4: dictba (small blind) folded before Flop
Seat 5: jaaum00 (big blind) folded before Flop
Seat 6: Biazutti folded before Flop (didn't bet)
Seat 7: DrTeleborian folded before Flop (didn't bet)
Seat 8: Tagomaga folded before Flop (didn't bet)

PokerStars Hand #251207529914: Tournament #3767885527, $40+$10+$5 USD Hold'em No Limit - Level XXII (4000/8000) - 2024/06/26 21:06:05 UTC [2024/06/26 17:06:05 ET]
Table '3767885527 97' 8-max Seat #4 is the button
Seat 1: Dowgh-Santos (564003 in chips) 
Seat 2: Siltex_by (107830 in chips) 
Seat 3: TheVanity (95776 in chips) 
Seat 4: dictba (188351 in chips) 
Seat 5: jaaum00 (237646 in chips) 
Seat 6: Biazutti (158631 in chips) 
Seat 7: DrTeleborian (333957 in chips) 
Seat 8: Tagomaga (184366 in chips) 
Dowgh-Santos: posts the ante 1000
Siltex_by: posts the ante 1000
TheVanity: posts the ante 1000
dictba: posts the ante 1000
jaaum00: posts the ante 1000
Biazutti: posts the ante 1000
DrTeleborian: posts the ante 1000
Tagomaga: posts the ante 1000
jaaum00: posts small blind 4000
Biazutti: posts big blind 8000
*** HOLE CARDS ***
DrTeleborian: raises 8800 to 16800
Tagomaga: folds 
Dowgh-Santos: folds 
Siltex_by: folds 
TheVanity: folds 
dictba: folds 
jaaum00: folds 
Biazutti: calls 8800
*** FLOP *** [5c Ac Js]
Biazutti: checks 
DrTeleborian: bets 15152
Biazutti: calls 15152
*** TURN *** [5c Ac Js] [3s]
Biazutti: checks 
DrTeleborian: bets 98880
Biazutti: folds 
Uncalled bet (98880) returned to DrTeleborian
DrTeleborian collected 75904 from pot
*** SUMMARY ***
Total pot 75904 | Rake 0 
Board [5c Ac Js 3s]
Seat 1: Dowgh-Santos folded before Flop (didn't bet)
Seat 2: Siltex_by folded before Flop (didn't bet)
Seat 3: TheVanity folded before Flop (didn't bet)
Seat 4: dictba (button) folded before Flop (didn't bet)
Seat 5: jaaum00 (small blind) folded before Flop
Seat 6: Biazutti (big blind) folded on the Turn
Seat 7: DrTeleborian collected (75904)
Seat 8: Tagomaga folded before Flop (didn't bet)

PokerStars Hand #251207548002: Tournament #3767885527, $40+$10+$5 USD Hold'em No Limit - Level XXII (4000/8000) - 2024/06/26 21:07:05 UTC [2024/06/26 17:07:05 ET]
Table '3767885527 97' 8-max Seat #5 is the button
Seat 1: Dowgh-Santos (563003 in chips) 
Seat 2: Siltex_by (106830 in chips) 
Seat 3: TheVanity (94776 in chips) 
Seat 4: dictba (187351 in chips) 
Seat 5: jaaum00 (232646 in chips) 
Seat 6: Biazutti (125679 in chips) 
Seat 7: DrTeleborian (376909 in chips) 
Seat 8: Tagomaga (183366 in chips) 
Dowgh-Santos: posts the ante 1000
Siltex_by: posts the ante 1000
TheVanity: posts the ante 1000
dictba: posts the ante 1000
jaaum00: posts the ante 1000
Biazutti: posts the ante 1000
DrTeleborian: posts the ante 1000
Tagomaga: posts the ante 1000
Biazutti: posts small blind 4000
DrTeleborian: posts big blind 8000
*** HOLE CARDS ***
Tagomaga: folds 
Dowgh-Santos: folds 
Siltex_by: folds 
TheVanity: folds 
dictba: folds 
jaaum00: raises 8000 to 16000
Biazutti: raises 108679 to 124679 and is all-in
DrTeleborian: folds 
jaaum00: folds 
Uncalled bet (108679) returned to Biazutti
Biazutti collected 48000 from pot
Biazutti: doesn't show hand 
*** SUMMARY ***
Total pot 48000 | Rake 0 
Seat 1: Dowgh-Santos folded before Flop (didn't bet)
Seat 2: Siltex_by folded before Flop (didn't bet)
Seat 3: TheVanity folded before Flop (didn't bet)
Seat 4: dictba folded before Flop (didn't bet)
Seat 5: jaaum00 (button) folded before Flop
Seat 6: Biazutti (small blind) collected (48000)
Seat 7: DrTeleborian (big blind) folded before Flop
Seat 8: Tagomaga folded before Flop (didn't bet)

PokerStars Hand #251207559117: Tournament #3767885527, $40+$10+$5 USD Hold'em No Limit - Level XXII (4000/8000) - 2024/06/26 21:07:41 UTC [2024/06/26 17:07:41 ET]
Table '3767885527 97' 8-max Seat #6 is the button
Seat 1: Dowgh-Santos (562003 in chips) 
Seat 2: Siltex_by (105830 in chips) 
Seat 3: TheVanity (93776 in chips) 
Seat 4: dictba (186351 in chips) 
Seat 5: jaaum00 (215646 in chips) 
Seat 6: Biazutti (156679 in chips) 
Seat 7: DrTeleborian (367909 in chips) 
Seat 8: Tagomaga (182366 in chips) 
Dowgh-Santos: posts the ante 1000
Siltex_by: posts the ante 1000
TheVanity: posts the ante 1000
dictba: posts the ante 1000
jaaum00: posts the ante 1000
Biazutti: posts the ante 1000
DrTeleborian: posts the ante 1000
Tagomaga: posts the ante 1000
DrTeleborian: posts small blind 4000
Tagomaga: posts big blind 8000
*** HOLE CARDS ***
Dowgh-Santos: folds 
Siltex_by: folds 
TheVanity: folds 
dictba: raises 8000 to 16000
jaaum00: folds 
Biazutti: folds 
DrTeleborian: folds 
Tagomaga: folds 
Uncalled bet (8000) returned to dictba
dictba collected 28000 from pot
dictba: doesn't show hand 
*** SUMMARY ***
Total pot 28000 | Rake 0 
Seat 1: Dowgh-Santos folded before Flop (didn't bet)
Seat 2: Siltex_by folded before Flop (didn't bet)
Seat 3: TheVanity folded before Flop (didn't bet)
Seat 4: dictba collected (28000)
Seat 5: jaaum00 folded before Flop (didn't bet)
Seat 6: Biazutti (button) folded before Flop (didn't bet)
Seat 7: DrTeleborian (small blind) folded before Flop
Seat 8: Tagomaga (big blind) folded before Flop

PokerStars Hand #251207566815: Tournament #3767885527, $40+$10+$5 USD Hold'em No Limit - Level XXII (4000/8000) - 2024/06/26 21:08:07 UTC [2024/06/26 17:08:07 ET]
Table '3767885527 97' 8-max Seat #7 is the button
Seat 1: Dowgh-Santos (561003 in chips) 
Seat 2: Siltex_by (104830 in chips) 
Seat 3: TheVanity (92776 in chips) 
Seat 4: dictba (205351 in chips) 
Seat 5: jaaum00 (214646 in chips) 
Seat 6: Biazutti (155679 in chips) 
Seat 7: DrTeleborian (362909 in chips) 
Seat 8: Tagomaga (173366 in chips) 
Dowgh-Santos: posts the ante 1000
Siltex_by: posts the ante 1000
TheVanity: posts the ante 1000
dictba: posts the ante 1000
jaaum00: posts the ante 1000
Biazutti: posts the ante 1000
DrTeleborian: posts the ante 1000
Tagomaga: posts the ante 1000
Tagomaga: posts small blind 4000
Dowgh-Santos: posts big blind 8000
*** HOLE CARDS ***
Siltex_by: folds 
TheVanity: raises 83776 to 91776 and is all-in
dictba: folds 
jaaum00: folds 
Biazutti: folds 
DrTeleborian: folds 
Tagomaga: folds 
Dowgh-Santos: folds 
Uncalled bet (83776) returned to TheVanity
TheVanity collected 28000 from pot
TheVanity: doesn't show hand 
*** SUMMARY ***
Total pot 28000 | Rake 0 
Seat 1: Dowgh-Santos (big blind) folded before Flop
Seat 2: Siltex_by folded before Flop (didn't bet)
Seat 3: TheVanity collected (28000)
Seat 4: dictba folded before Flop (didn't bet)
Seat 5: jaaum00 folded before Flop (didn't bet)
Seat 6: Biazutti folded before Flop (didn't bet)
Seat 7: DrTeleborian (button) folded before Flop (didn't bet)
Seat 8: Tagomaga (small blind) folded before Flop

PokerStars Hand #251207576750: Tournament #3767885527, $40+$10+$5 USD Hold'em No Limit - Level XXII (4000/8000) - 2024/06/26 21:08:40 UTC [2024/06/26 17:08:40 ET]
Table '3767885527 97' 8-max Seat #8 is the button
Seat 1: Dowgh-Santos (552003 in chips) 
Seat 2: Siltex_by (103830 in chips) 
Seat 3: TheVanity (111776 in chips) 
Seat 4: dictba (204351 in chips) 
Seat 5: jaaum00 (213646 in chips) 
Seat 6: Biazutti (154679 in chips) 
Seat 7: DrTeleborian (361909 in chips) 
Seat 8: Tagomaga (168366 in chips) 
Dowgh-Santos: posts the ante 1000
Siltex_by: posts the ante 1000
TheVanity: posts the ante 1000
dictba: posts the ante 1000
jaaum00: posts the ante 1000
Biazutti: posts the ante 1000
DrTeleborian: posts the ante 1000
Tagomaga: posts the ante 1000
Dowgh-Santos: posts small blind 4000
Siltex_by: posts big blind 8000
*** HOLE CARDS ***
TheVanity: folds 
dictba: folds 
jaaum00: folds 
Biazutti: raises 8000 to 16000
DrTeleborian: folds 
Tagomaga: folds 
Dowgh-Santos: folds 
Siltex_by: raises 86830 to 102830 and is all-in
Biazutti: calls 86830
*** FLOP *** [6d 4s Ts]
*** TURN *** [6d 4s Ts] [Tc]
*** RIVER *** [6d 4s Ts Tc] [3c]
*** SHOW DOWN ***
Siltex_by: shows [Kd As] (a pair of Tens)
Biazutti: shows [Ac Qd] (a pair of Tens - lower kicker)
Siltex_by collected 217660 from pot
*** SUMMARY ***
Total pot 217660 | Rake 0 
Board [6d 4s Ts Tc 3c]
Seat 1: Dowgh-Santos (small blind) folded before Flop
Seat 2: Siltex_by (big blind) showed [Kd As] and won (217660) with a pair of Tens
Seat 3: TheVanity folded before Flop (didn't bet)
Seat 4: dictba folded before Flop (didn't bet)
Seat 5: jaaum00 folded before Flop (didn't bet)
Seat 6: Biazutti showed [Ac Qd] and lost with a pair of Tens
Seat 7: DrTeleborian folded before Flop (didn't bet)
Seat 8: Tagomaga (button) folded before Flop (didn't bet)

PokerStars Hand #251207594874: Tournament #3767885527, $40+$10+$5 USD Hold'em No Limit - Level XXII (4000/8000) - 2024/06/26 21:09:39 UTC [2024/06/26 17:09:39 ET]
Table '3767885527 97' 8-max Seat #1 is the button
Seat 1: Dowgh-Santos (547003 in chips) 
Seat 2: Siltex_by (217660 in chips) 
Seat 3: TheVanity (110776 in chips) 
Seat 4: dictba (203351 in chips) 
Seat 5: jaaum00 (212646 in chips) 
Seat 6: Biazutti (50849 in chips) 
Seat 7: DrTeleborian (360909 in chips) 
Seat 8: Tagomaga (167366 in chips) 
Dowgh-Santos: posts the ante 1000
Siltex_by: posts the ante 1000
TheVanity: posts the ante 1000
dictba: posts the ante 1000
jaaum00: posts the ante 1000
Biazutti: posts the ante 1000
DrTeleborian: posts the ante 1000
Tagomaga: posts the ante 1000
Siltex_by: posts small blind 4000
TheVanity: posts big blind 8000
*** HOLE CARDS ***
dictba: folds 
jaaum00: raises 9040 to 17040
Biazutti: folds 
DrTeleborian: calls 17040
Tagomaga: folds 
Dowgh-Santos: calls 17040
Siltex_by: folds 
TheVanity: calls 9040
*** FLOP *** [6c 2h 8d]
TheVanity: checks 
jaaum00: checks 
DrTeleborian: bets 33667
Dowgh-Santos: folds 
TheVanity: folds 
jaaum00: folds 
Uncalled bet (33667) returned to DrTeleborian
DrTeleborian collected 80160 from pot
*** SUMMARY ***
Total pot 80160 | Rake 0 
Board [6c 2h 8d]
Seat 1: Dowgh-Santos (button) folded on the Flop
Seat 2: Siltex_by (small blind) folded before Flop
Seat 3: TheVanity (big blind) folded on the Flop
Seat 4: dictba folded before Flop (didn't bet)
Seat 5: jaaum00 folded on the Flop
Seat 6: Biazutti folded before Flop (didn't bet)
Seat 7: DrTeleborian collected (80160)
Seat 8: Tagomaga folded before Flop (didn't bet)

PokerStars Hand #251207618919: Tournament #3767885527, $40+$10+$5 USD Hold'em No Limit - Level XXII (4000/8000) - 2024/06/26 21:10:58 UTC [2024/06/26 17:10:58 ET]
Table '3767885527 97' 8-max Seat #2 is the button
Seat 1: Dowgh-Santos (528963 in chips) 
Seat 2: Siltex_by (212660 in chips) 
Seat 3: TheVanity (92736 in chips) 
Seat 4: dictba (202351 in chips) 
Seat 5: jaaum00 (194606 in chips) 
Seat 6: Biazutti (49849 in chips) 
Seat 7: DrTeleborian (423029 in chips) 
Seat 8: Tagomaga (166366 in chips) 
Dowgh-Santos: posts the ante 1000
Siltex_by: posts the ante 1000
TheVanity: posts the ante 1000
dictba: posts the ante 1000
jaaum00: posts the ante 1000
Biazutti: posts the ante 1000
DrTeleborian: posts the ante 1000
Tagomaga: posts the ante 1000
TheVanity: posts small blind 4000
dictba: posts big blind 8000
*** HOLE CARDS ***
jaaum00: folds 
Biazutti: raises 40849 to 48849 and is all-in
DrTeleborian: folds 
Tagomaga: folds 
Dowgh-Santos: folds 
Siltex_by: folds 
TheVanity: folds 
dictba: calls 40849
*** FLOP *** [6c Jd 5s]
*** TURN *** [6c Jd 5s] [7h]
*** RIVER *** [6c Jd 5s 7h] [4c]
*** SHOW DOWN ***
dictba: shows [7s 6s] (two pair, Sevens and Sixes)
Biazutti: shows [3s 3h] (a straight, Three to Seven)
Biazutti collected 109698 from pot
*** SUMMARY ***
Total pot 109698 | Rake 0 
Board [6c Jd 5s 7h 4c]
Seat 1: Dowgh-Santos folded before Flop (didn't bet)
Seat 2: Siltex_by (button) folded before Flop (didn't bet)
Seat 3: TheVanity (small blind) folded before Flop
Seat 4: dictba (big blind) showed [7s 6s] and lost with two pair, Sevens and Sixes
Seat 5: jaaum00 folded before Flop (didn't bet)
Seat 6: Biazutti showed [3s 3h] and won (109698) with a straight, Three to Seven
Seat 7: DrTeleborian folded before Flop (didn't bet)
Seat 8: Tagomaga folded before Flop (didn't bet)

PokerStars Hand #251207629968: Tournament #3767885527, $40+$10+$5 USD Hold'em No Limit - Level XXII (4000/8000) - 2024/06/26 21:11:34 UTC [2024/06/26 17:11:34 ET]
Table '3767885527 97' 8-max Seat #3 is the button
Seat 1: Dowgh-Santos (527963 in chips) 
Seat 2: Siltex_by (211660 in chips) 
Seat 3: TheVanity (87736 in chips) 
Seat 4: dictba (152502 in chips) 
Seat 5: jaaum00 (193606 in chips) 
Seat 6: Biazutti (109698 in chips) 
Seat 7: DrTeleborian (422029 in chips) 
Seat 8: Tagomaga (165366 in chips) 
Dowgh-Santos: posts the ante 1000
Siltex_by: posts the ante 1000
TheVanity: posts the ante 1000
dictba: posts the ante 1000
jaaum00: posts the ante 1000
Biazutti: posts the ante 1000
DrTeleborian: posts the ante 1000
Tagomaga: posts the ante 1000
dictba: posts small blind 4000
jaaum00: posts big blind 8000
*** HOLE CARDS ***
Biazutti: folds 
DrTeleborian: folds 
Tagomaga: folds 
Dowgh-Santos: raises 8000 to 16000
Siltex_by: calls 16000
TheVanity: folds 
dictba: raises 135502 to 151502 and is all-in
jaaum00: folds 
Dowgh-Santos: folds 
Siltex_by: calls 135502
*** FLOP *** [4c 6c 6h]
*** TURN *** [4c 6c 6h] [Ks]
*** RIVER *** [4c 6c 6h Ks] [Js]
*** SHOW DOWN ***
dictba: shows [Jc Ah] (two pair, Jacks and Sixes)
Siltex_by: shows [As Ad] (two pair, Aces and Sixes)
Siltex_by collected 335004 from pot
dictba finished the tournament in 150th place and received $126.61.
*** SUMMARY ***
Total pot 335004 | Rake 0 
Board [4c 6c 6h Ks Js]
Seat 1: Dowgh-Santos folded before Flop
Seat 2: Siltex_by showed [As Ad] and won (335004) with two pair, Aces and Sixes
Seat 3: TheVanity (button) folded before Flop (didn't bet)
Seat 4: dictba (small blind) showed [Jc Ah] and lost with two pair, Jacks and Sixes
Seat 5: jaaum00 (big blind) folded before Flop
Seat 6: Biazutti folded before Flop (didn't bet)
Seat 7: DrTeleborian folded before Flop (didn't bet)
Seat 8: Tagomaga folded before Flop (didn't bet)

PokerStars Hand #251207646938: Tournament #3767885527, $40+$10+$5 USD Hold'em No Limit - Level XXII (4000/8000) - 2024/06/26 21:12:30 UTC [2024/06/26 17:12:30 ET]
Table '3767885527 97' 8-max Seat #5 is the button
Seat 1: Dowgh-Santos (510963 in chips) 
Seat 2: Siltex_by (394162 in chips) 
Seat 3: TheVanity (86736 in chips) 
Seat 5: jaaum00 (184606 in chips) 
Seat 6: Biazutti (108698 in chips) 
Seat 7: DrTeleborian (421029 in chips) 
Seat 8: Tagomaga (164366 in chips) 
Dowgh-Santos: posts the ante 1000
Siltex_by: posts the ante 1000
TheVanity: posts the ante 1000
jaaum00: posts the ante 1000
Biazutti: posts the ante 1000
DrTeleborian: posts the ante 1000
Tagomaga: posts the ante 1000
Biazutti: posts small blind 4000
DrTeleborian: posts big blind 8000
*** HOLE CARDS ***
Tagomaga: folds 
Dowgh-Santos: raises 8000 to 16000
Siltex_by: folds 
TheVanity: folds 
jaaum00: folds 
Biazutti: folds 
DrTeleborian: raises 40000 to 56000
Dowgh-Santos: folds 
Uncalled bet (40000) returned to DrTeleborian
DrTeleborian collected 43000 from pot
*** SUMMARY ***
Total pot 43000 | Rake 0 
Seat 1: Dowgh-Santos folded before Flop
Seat 2: Siltex_by folded before Flop (didn't bet)
Seat 3: TheVanity folded before Flop (didn't bet)
Seat 5: jaaum00 (button) folded before Flop (didn't bet)
Seat 6: Biazutti (small blind) folded before Flop
Seat 7: DrTeleborian (big blind) collected (43000)
Seat 8: Tagomaga folded before Flop (didn't bet)

PokerStars Hand #251207656992: Tournament #3767885527, $40+$10+$5 USD Hold'em No Limit - Level XXII (4000/8000) - 2024/06/26 21:13:02 UTC [2024/06/26 17:13:02 ET]
Table '3767885527 97' 8-max Seat #6 is the button
Seat 1: Dowgh-Santos (493963 in chips) 
Seat 2: Siltex_by (393162 in chips) 
Seat 3: TheVanity (85736 in chips) 
Seat 5: jaaum00 (183606 in chips) 
Seat 6: Biazutti (103698 in chips) 
Seat 7: DrTeleborian (447029 in chips) 
Seat 8: Tagomaga (163366 in chips) 
Dowgh-Santos: posts the ante 1000
Siltex_by: posts the ante 1000
TheVanity: posts the ante 1000
jaaum00: posts the ante 1000
Biazutti: posts the ante 1000
DrTeleborian: posts the ante 1000
Tagomaga: posts the ante 1000
DrTeleborian: posts small blind 4000
Tagomaga: posts big blind 8000
*** HOLE CARDS ***
Dowgh-Santos: folds 
Siltex_by: folds 
TheVanity: folds 
jaaum00: folds 
Biazutti: folds 
DrTeleborian: raises 12000 to 20000
Tagomaga: calls 12000
*** FLOP *** [3s 3d Ks]
DrTeleborian: checks 
Tagomaga: checks 
*** TURN *** [3s 3d Ks] [2s]
DrTeleborian: bets 34070
Tagomaga: folds 
Uncalled bet (34070) returned to DrTeleborian
DrTeleborian collected 47000 from pot
*** SUMMARY ***
Total pot 47000 | Rake 0 
Board [3s 3d Ks 2s]
Seat 1: Dowgh-Santos folded before Flop (didn't bet)
Seat 2: Siltex_by folded before Flop (didn't bet)
Seat 3: TheVanity folded before Flop (didn't bet)
Seat 5: jaaum00 folded before Flop (didn't bet)
Seat 6: Biazutti (button) folded before Flop (didn't bet)
Seat 7: DrTeleborian (small blind) collected (47000)
Seat 8: Tagomaga (big blind) folded on the Turn

PokerStars Hand #251207679187: Tournament #3767885527, $40+$10+$5 USD Hold'em No Limit - Level XXIII (5000/10000) - 2024/06/26 21:14:14 UTC [2024/06/26 17:14:14 ET]
Table '3767885527 97' 8-max Seat #7 is the button
Seat 1: Dowgh-Santos (492963 in chips) 
Seat 2: Siltex_by (392162 in chips) 
Seat 3: TheVanity (84736 in chips) 
Seat 5: jaaum00 (182606 in chips) 
Seat 6: Biazutti (102698 in chips) 
Seat 7: DrTeleborian (473029 in chips) 
Seat 8: Tagomaga (142366 in chips) 
Dowgh-Santos: posts the ante 1250
Siltex_by: posts the ante 1250
TheVanity: posts the ante 1250
jaaum00: posts the ante 1250
Biazutti: posts the ante 1250
DrTeleborian: posts the ante 1250
Tagomaga: posts the ante 1250
Tagomaga: posts small blind 5000
Dowgh-Santos: posts big blind 10000
*** HOLE CARDS ***
Siltex_by: folds 
TheVanity: folds 
jaaum00: folds 
Biazutti: folds 
DrTeleborian: folds 
Tagomaga: calls 5000
Dowgh-Santos: raises 20000 to 30000
Tagomaga: folds 
Uncalled bet (20000) returned to Dowgh-Santos
Dowgh-Santos collected 28750 from pot
Dowgh-Santos: doesn't show hand 
*** SUMMARY ***
Total pot 28750 | Rake 0 
Seat 1: Dowgh-Santos (big blind) collected (28750)
Seat 2: Siltex_by folded before Flop (didn't bet)
Seat 3: TheVanity folded before Flop (didn't bet)
Seat 5: jaaum00 folded before Flop (didn't bet)
Seat 6: Biazutti folded before Flop (didn't bet)
Seat 7: DrTeleborian (button) folded before Flop (didn't bet)
Seat 8: Tagomaga (small blind) folded before Flop

PokerStars Hand #251207692467: Tournament #3767885527, $40+$10+$5 USD Hold'em No Limit - Level XXIII (5000/10000) - 2024/06/26 21:14:57 UTC [2024/06/26 17:14:57 ET]
Table '3767885527 97' 8-max Seat #8 is the button
Seat 1: Dowgh-Santos (510463 in chips) 
Seat 2: Siltex_by (390912 in chips) 
Seat 3: TheVanity (83486 in chips) 
Seat 5: jaaum00 (181356 in chips) 
Seat 6: Biazutti (101448 in chips) 
Seat 7: DrTeleborian (471779 in chips) 
Seat 8: Tagomaga (131116 in chips) 
Dowgh-Santos: posts the ante 1250
Siltex_by: posts the ante 1250
TheVanity: posts the ante 1250
jaaum00: posts the ante 1250
Biazutti: posts the ante 1250
DrTeleborian: posts the ante 1250
Tagomaga: posts the ante 1250
Dowgh-Santos: posts small blind 5000
Siltex_by: posts big blind 10000
*** HOLE CARDS ***
TheVanity: folds 
jaaum00: folds 
Biazutti: folds 
DrTeleborian: folds 
Tagomaga: raises 10000 to 20000
Dowgh-Santos: folds 
Siltex_by: folds 
Uncalled bet (10000) returned to Tagomaga
Tagomaga collected 33750 from pot
Tagomaga: doesn't show hand 
*** SUMMARY ***
Total pot 33750 | Rake 0 
Seat 1: Dowgh-Santos (small blind) folded before Flop
Seat 2: Siltex_by (big blind) folded before Flop
Seat 3: TheVanity folded before Flop (didn't bet)
Seat 5: jaaum00 folded before Flop (didn't bet)
Seat 6: Biazutti folded before Flop (didn't bet)
Seat 7: DrTeleborian folded before Flop (didn't bet)
Seat 8: Tagomaga (button) collected (33750)

PokerStars Hand #251207700023: Tournament #3767885527, $40+$10+$5 USD Hold'em No Limit - Level XXIII (5000/10000) - 2024/06/26 21:15:22 UTC [2024/06/26 17:15:22 ET]
Table '3767885527 97' 8-max Seat #1 is the button
Seat 1: Dowgh-Santos (504213 in chips) 
Seat 2: Siltex_by (379662 in chips) 
Seat 3: TheVanity (82236 in chips) 
Seat 4: jammy1875 (692571 in chips) 
Seat 5: jaaum00 (180106 in chips) 
Seat 6: Biazutti (100198 in chips) 
Seat 7: DrTeleborian (470529 in chips) 
Seat 8: Tagomaga (153616 in chips) 
Dowgh-Santos: posts the ante 1250
Siltex_by: posts the ante 1250
TheVanity: posts the ante 1250
jammy1875: posts the ante 1250
jaaum00: posts the ante 1250
Biazutti: posts the ante 1250
DrTeleborian: posts the ante 1250
Tagomaga: posts the ante 1250
Siltex_by: posts small blind 5000
TheVanity: posts big blind 10000
*** HOLE CARDS ***
jammy1875: raises 10000 to 20000
jaaum00: folds 
Biazutti: folds 
DrTeleborian: folds 
Tagomaga: folds 
Dowgh-Santos: folds 
Siltex_by: folds 
TheVanity: folds 
Uncalled bet (10000) returned to jammy1875
jammy1875 collected 35000 from pot
*** SUMMARY ***
Total pot 35000 | Rake 0 
Seat 1: Dowgh-Santos (button) folded before Flop (didn't bet)
Seat 2: Siltex_by (small blind) folded before Flop
Seat 3: TheVanity (big blind) folded before Flop
Seat 4: jammy1875 collected (35000)
Seat 5: jaaum00 folded before Flop (didn't bet)
Seat 6: Biazutti folded before Flop (didn't bet)
Seat 7: DrTeleborian folded before Flop (didn't bet)
Seat 8: Tagomaga folded before Flop (didn't bet)

PokerStars Hand #251207711183: Tournament #3767885527, $40+$10+$5 USD Hold'em No Limit - Level XXIII (5000/10000) - 2024/06/26 21:15:57 UTC [2024/06/26 17:15:57 ET]
Table '3767885527 97' 8-max Seat #2 is the button
Seat 1: Dowgh-Santos (502963 in chips) 
Seat 2: Siltex_by (373412 in chips) 
Seat 3: TheVanity (70986 in chips) 
Seat 4: jammy1875 (716321 in chips) 
Seat 5: jaaum00 (178856 in chips) 
Seat 6: Biazutti (98948 in chips) 
Seat 7: DrTeleborian (469279 in chips) 
Seat 8: Tagomaga (152366 in chips) 
Dowgh-Santos: posts the ante 1250
Siltex_by: posts the ante 1250
TheVanity: posts the ante 1250
jammy1875: posts the ante 1250
jaaum00: posts the ante 1250
Biazutti: posts the ante 1250
DrTeleborian: posts the ante 1250
Tagomaga: posts the ante 1250
TheVanity: posts small blind 5000
jammy1875: posts big blind 10000
*** HOLE CARDS ***
jaaum00: folds 
Biazutti: folds 
DrTeleborian: folds 
Tagomaga: raises 10000 to 20000
Dowgh-Santos: folds 
Siltex_by: folds 
TheVanity: folds 
jammy1875: calls 10000
*** FLOP *** [7d Jc 4s]
jammy1875: checks 
Tagomaga: bets 18700
jammy1875: calls 18700
*** TURN *** [7d Jc 4s] [Td]
jammy1875: checks 
Tagomaga: checks 
*** RIVER *** [7d Jc 4s Td] [5d]
jammy1875: bets 46200
Tagomaga: folds 
Uncalled bet (46200) returned to jammy1875
jammy1875 collected 92400 from pot
*** SUMMARY ***
Total pot 92400 | Rake 0 
Board [7d Jc 4s Td 5d]
Seat 1: Dowgh-Santos folded before Flop (didn't bet)
Seat 2: Siltex_by (button) folded before Flop (didn't bet)
Seat 3: TheVanity (small blind) folded before Flop
Seat 4: jammy1875 (big blind) collected (92400)
Seat 5: jaaum00 folded before Flop (didn't bet)
Seat 6: Biazutti folded before Flop (didn't bet)
Seat 7: DrTeleborian folded before Flop (didn't bet)
Seat 8: Tagomaga folded on the River

PokerStars Hand #251207744188: Tournament #3767885527, $40+$10+$5 USD Hold'em No Limit - Level XXIII (5000/10000) - 2024/06/26 21:17:44 UTC [2024/06/26 17:17:44 ET]
Table '3767885527 97' 8-max Seat #3 is the button
Seat 1: Dowgh-Santos (501713 in chips) 
Seat 2: Siltex_by (372162 in chips) 
Seat 3: TheVanity (64736 in chips) 
Seat 4: jammy1875 (768771 in chips) 
Seat 5: jaaum00 (177606 in chips) 
Seat 6: Biazutti (97698 in chips) 
Seat 7: DrTeleborian (468029 in chips) 
Seat 8: Tagomaga (112416 in chips) 
Dowgh-Santos: posts the ante 1250
Siltex_by: posts the ante 1250
TheVanity: posts the ante 1250
jammy1875: posts the ante 1250
jaaum00: posts the ante 1250
Biazutti: posts the ante 1250
DrTeleborian: posts the ante 1250
Tagomaga: posts the ante 1250
jammy1875: posts small blind 5000
jaaum00: posts big blind 10000
*** HOLE CARDS ***
Biazutti: folds 
DrTeleborian is disconnected 
DrTeleborian has timed out while disconnected
DrTeleborian: folds 
DrTeleborian is sitting out
Tagomaga: folds 
Dowgh-Santos: folds 
Siltex_by: folds 
DrTeleborian has returned
TheVanity: raises 53486 to 63486 and is all-in
jammy1875: folds 
jaaum00: folds 
Uncalled bet (53486) returned to TheVanity
TheVanity collected 35000 from pot
TheVanity: doesn't show hand 
*** SUMMARY ***
Total pot 35000 | Rake 0 
Seat 1: Dowgh-Santos folded before Flop (didn't bet)
Seat 2: Siltex_by folded before Flop (didn't bet)
Seat 3: TheVanity (button) collected (35000)
Seat 4: jammy1875 (small blind) folded before Flop
Seat 5: jaaum00 (big blind) folded before Flop
Seat 6: Biazutti folded before Flop (didn't bet)
Seat 7: DrTeleborian folded before Flop (didn't bet)
Seat 8: Tagomaga folded before Flop (didn't bet)

PokerStars Hand #251207761383: Tournament #3767885527, $40+$10+$5 USD Hold'em No Limit - Level XXIII (5000/10000) - 2024/06/26 21:18:40 UTC [2024/06/26 17:18:40 ET]
Table '3767885527 97' 8-max Seat #4 is the button
Seat 1: Dowgh-Santos (500463 in chips) 
Seat 2: Siltex_by (370912 in chips) 
Seat 3: TheVanity (88486 in chips) 
Seat 4: jammy1875 (762521 in chips) 
Seat 5: jaaum00 (166356 in chips) 
Seat 6: Biazutti (96448 in chips) 
Seat 7: DrTeleborian (466779 in chips) 
Seat 8: Tagomaga (111166 in chips) 
Dowgh-Santos: posts the ante 1250
Siltex_by: posts the ante 1250
TheVanity: posts the ante 1250
jammy1875: posts the ante 1250
jaaum00: posts the ante 1250
Biazutti: posts the ante 1250
DrTeleborian: posts the ante 1250
Tagomaga: posts the ante 1250
jaaum00: posts small blind 5000
Biazutti: posts big blind 10000
*** HOLE CARDS ***
DrTeleborian: folds 
Tagomaga: folds 
Dowgh-Santos: folds 
Siltex_by: folds 
TheVanity: folds 
jammy1875: raises 12147 to 22147
jaaum00: folds 
Biazutti: calls 12147
*** FLOP *** [Js 7c Qh]
Biazutti: checks 
jammy1875: bets 20000
Biazutti: raises 53051 to 73051 and is all-in
jammy1875: calls 53051
*** TURN *** [Js 7c Qh] [2d]
*** RIVER *** [Js 7c Qh 2d] [9h]
*** SHOW DOWN ***
Biazutti: shows [Kd Tc] (a straight, Nine to King)
jammy1875: shows [7s 4s] (a pair of Sevens)
Biazutti collected 205396 from pot
*** SUMMARY ***
Total pot 205396 | Rake 0 
Board [Js 7c Qh 2d 9h]
Seat 1: Dowgh-Santos folded before Flop (didn't bet)
Seat 2: Siltex_by folded before Flop (didn't bet)
Seat 3: TheVanity folded before Flop (didn't bet)
Seat 4: jammy1875 (button) showed [7s 4s] and lost with a pair of Sevens
Seat 5: jaaum00 (small blind) folded before Flop
Seat 6: Biazutti (big blind) showed [Kd Tc] and won (205396) with a straight, Nine to King
Seat 7: DrTeleborian folded before Flop (didn't bet)
Seat 8: Tagomaga folded before Flop (didn't bet)

PokerStars Hand #251207785054: Tournament #3767885527, $40+$10+$5 USD Hold'em No Limit - Level XXIII (5000/10000) - 2024/06/26 21:19:56 UTC [2024/06/26 17:19:56 ET]
Table '3767885527 97' 8-max Seat #5 is the button
Seat 1: Dowgh-Santos (499213 in chips) 
Seat 2: Siltex_by (369662 in chips) 
Seat 3: TheVanity (87236 in chips) 
Seat 4: jammy1875 (666073 in chips) 
Seat 5: jaaum00 (160106 in chips) 
Seat 6: Biazutti (205396 in chips) 
Seat 7: DrTeleborian (465529 in chips) 
Seat 8: Tagomaga (109916 in chips) 
Dowgh-Santos: posts the ante 1250
Siltex_by: posts the ante 1250
TheVanity: posts the ante 1250
jammy1875: posts the ante 1250
jaaum00: posts the ante 1250
Biazutti: posts the ante 1250
DrTeleborian: posts the ante 1250
Tagomaga: posts the ante 1250
Biazutti: posts small blind 5000
DrTeleborian: posts big blind 10000
*** HOLE CARDS ***
Tagomaga: folds 
Dowgh-Santos: raises 10000 to 20000
Siltex_by: folds 
TheVanity: folds 
jammy1875: folds 
jaaum00: calls 20000
Biazutti: folds 
DrTeleborian: folds 
*** FLOP *** [6s 9c 7c]
Dowgh-Santos: checks 
jaaum00: bets 34450
Dowgh-Santos: raises 120550 to 155000
jaaum00: calls 104406 and is all-in
Uncalled bet (16144) returned to Dowgh-Santos
*** TURN *** [6s 9c 7c] [Jd]
*** RIVER *** [6s 9c 7c Jd] [4c]
*** SHOW DOWN ***
Dowgh-Santos: shows [Kh Ks] (a pair of Kings)
jaaum00: shows [Ad Ah] (a pair of Aces)
jaaum00 collected 342712 from pot
*** SUMMARY ***
Total pot 342712 | Rake 0 
Board [6s 9c 7c Jd 4c]
Seat 1: Dowgh-Santos showed [Kh Ks] and lost with a pair of Kings
Seat 2: Siltex_by folded before Flop (didn't bet)
Seat 3: TheVanity folded before Flop (didn't bet)
Seat 4: jammy1875 folded before Flop (didn't bet)
Seat 5: jaaum00 (button) showed [Ad Ah] and won (342712) with a pair of Aces
Seat 6: Biazutti (small blind) folded before Flop
Seat 7: DrTeleborian (big blind) folded before Flop
Seat 8: Tagomaga folded before Flop (didn't bet)

PokerStars Hand #251207802044: Tournament #3767885527, $40+$10+$5 USD Hold'em No Limit - Level XXIII (5000/10000) - 2024/06/26 21:20:50 UTC [2024/06/26 17:20:50 ET]
Table '3767885527 97' 8-max Seat #6 is the button
Seat 1: Dowgh-Santos (339107 in chips) 
Seat 2: Siltex_by (368412 in chips) 
Seat 3: TheVanity (85986 in chips) 
Seat 4: jammy1875 (664823 in chips) 
Seat 5: jaaum00 (342712 in chips) 
Seat 6: Biazutti (199146 in chips) 
Seat 7: DrTeleborian (454279 in chips) 
Seat 8: Tagomaga (108666 in chips) 
Dowgh-Santos: posts the ante 1250
Siltex_by: posts the ante 1250
TheVanity: posts the ante 1250
jammy1875: posts the ante 1250
jaaum00: posts the ante 1250
Biazutti: posts the ante 1250
DrTeleborian: posts the ante 1250
Tagomaga: posts the ante 1250
DrTeleborian: posts small blind 5000
Tagomaga: posts big blind 10000
*** HOLE CARDS ***
Dowgh-Santos: folds 
Siltex_by: folds 
TheVanity: raises 74736 to 84736 and is all-in
jammy1875: folds 
jaaum00: folds 
Biazutti: folds 
DrTeleborian: folds 
Tagomaga: folds 
Uncalled bet (74736) returned to TheVanity
TheVanity collected 35000 from pot
TheVanity: doesn't show hand 
*** SUMMARY ***
Total pot 35000 | Rake 0 
Seat 1: Dowgh-Santos folded before Flop (didn't bet)
Seat 2: Siltex_by folded before Flop (didn't bet)
Seat 3: TheVanity collected (35000)
Seat 4: jammy1875 folded before Flop (didn't bet)
Seat 5: jaaum00 folded before Flop (didn't bet)
Seat 6: Biazutti (button) folded before Flop (didn't bet)
Seat 7: DrTeleborian (small blind) folded before Flop
Seat 8: Tagomaga (big blind) folded before Flop

PokerStars Hand #251207809982: Tournament #3767885527, $40+$10+$5 USD Hold'em No Limit - Level XXIII (5000/10000) - 2024/06/26 21:21:16 UTC [2024/06/26 17:21:16 ET]
Table '3767885527 97' 8-max Seat #7 is the button
Seat 1: Dowgh-Santos (337857 in chips) 
Seat 2: Siltex_by (367162 in chips) 
Seat 3: TheVanity (109736 in chips) 
Seat 4: jammy1875 (663573 in chips) 
Seat 5: jaaum00 (341462 in chips) 
Seat 6: Biazutti (197896 in chips) 
Seat 7: DrTeleborian (448029 in chips) 
Seat 8: Tagomaga (97416 in chips) 
Dowgh-Santos: posts the ante 1250
Siltex_by: posts the ante 1250
TheVanity: posts the ante 1250
jammy1875: posts the ante 1250
jaaum00: posts the ante 1250
Biazutti: posts the ante 1250
DrTeleborian: posts the ante 1250
Tagomaga: posts the ante 1250
Tagomaga: posts small blind 5000
Dowgh-Santos: posts big blind 10000
*** HOLE CARDS ***
Siltex_by: folds 
TheVanity: folds 
jammy1875: folds 
jaaum00: folds 
Biazutti: folds 
DrTeleborian: folds 
Tagomaga: raises 86166 to 96166 and is all-in
Dowgh-Santos: calls 86166
*** FLOP *** [Th Ks 3c]
*** TURN *** [Th Ks 3c] [4s]
*** RIVER *** [Th Ks 3c 4s] [As]
*** SHOW DOWN ***
Tagomaga: shows [7d Kh] (a pair of Kings)
Dowgh-Santos: shows [Kd 4h] (two pair, Kings and Fours)
Dowgh-Santos collected 202332 from pot
Tagomaga finished the tournament in 129th place and received $139.27.
*** SUMMARY ***
Total pot 202332 | Rake 0 
Board [Th Ks 3c 4s As]
Seat 1: Dowgh-Santos (big blind) showed [Kd 4h] and won (202332) with two pair, Kings and Fours
Seat 2: Siltex_by folded before Flop (didn't bet)
Seat 3: TheVanity folded before Flop (didn't bet)
Seat 4: jammy1875 folded before Flop (didn't bet)
Seat 5: jaaum00 folded before Flop (didn't bet)
Seat 6: Biazutti folded before Flop (didn't bet)
Seat 7: DrTeleborian (button) folded before Flop (didn't bet)
Seat 8: Tagomaga (small blind) showed [7d Kh] and lost with a pair of Kings

PokerStars Hand #251205614352: Tournament #3767885527, $40+$10+$5 USD Hold'em No Limit - Level XI (600/1200) - 2024/06/26 19:07:37 UTC [2024/06/26 15:07:37 ET]
Table '3767885527 96' 8-max Seat #1 is the button
Seat 1: MKL1010 (37531 in chips) 
Seat 2: DontCryClumsy88 (24246 in chips) 
Seat 3: Eux1986 (89833 in chips) 
Seat 4: moratto1992 (28490 in chips) 
Seat 5: 4fast2u (33091 in chips) 
Seat 6: Dizzydarts (24186 in chips) 
Seat 7: ivan limeira (52552 in chips) 
Seat 8: Mike.fontova (10582 in chips) 
MKL1010: posts the ante 150
DontCryClumsy88: posts the ante 150
Eux1986: posts the ante 150
moratto1992: posts the ante 150
4fast2u: posts the ante 150
Dizzydarts: posts the ante 150
ivan limeira: posts the ante 150
Mike.fontova: posts the ante 150
DontCryClumsy88: posts small blind 600
Eux1986: posts big blind 1200
*** HOLE CARDS ***
moratto1992: raises 1200 to 2400
4fast2u: folds 
Dizzydarts: folds 
ivan limeira: folds 
Mike.fontova: calls 2400
MKL1010: folds 
DontCryClumsy88: calls 1800
Eux1986: calls 1200
*** FLOP *** [2h Kh 8s]
DontCryClumsy88: checks 
Eux1986: checks 
moratto1992: checks 
Mike.fontova: bets 8032 and is all-in
DontCryClumsy88: raises 13664 to 21696 and is all-in
Eux1986: folds 
moratto1992: folds 
Uncalled bet (13664) returned to DontCryClumsy88
*** TURN *** [2h Kh 8s] [Td]
*** RIVER *** [2h Kh 8s Td] [8d]
*** SHOW DOWN ***
DontCryClumsy88: shows [Kd Jc] (two pair, Kings and Eights)
Mike.fontova: shows [Js Jd] (two pair, Jacks and Eights)
DontCryClumsy88 collected 26864 from pot
Mike.fontova finished the tournament
*** SUMMARY ***
Total pot 26864 | Rake 0 
Board [2h Kh 8s Td 8d]
Seat 1: MKL1010 (button) folded before Flop (didn't bet)
Seat 2: DontCryClumsy88 (small blind) showed [Kd Jc] and won (26864) with two pair, Kings and Eights
Seat 3: Eux1986 (big blind) folded on the Flop
Seat 4: moratto1992 folded on the Flop
Seat 5: 4fast2u folded before Flop (didn't bet)
Seat 6: Dizzydarts folded before Flop (didn't bet)
Seat 7: ivan limeira folded before Flop (didn't bet)
Seat 8: Mike.fontova showed [Js Jd] and lost with two pair, Jacks and Eights

PokerStars Hand #251205627968: Tournament #3767885527, $40+$10+$5 USD Hold'em No Limit - Level XI (600/1200) - 2024/06/26 19:08:29 UTC [2024/06/26 15:08:29 ET]
Table '3767885527 96' 8-max Seat #2 is the button
Seat 1: MKL1010 (37381 in chips) 
Seat 2: DontCryClumsy88 (40528 in chips) 
Seat 3: Eux1986 (87283 in chips) 
Seat 4: moratto1992 (25940 in chips) 
Seat 5: 4fast2u (32941 in chips) 
Seat 6: Dizzydarts (24036 in chips) 
Seat 7: ivan limeira (52402 in chips) 
MKL1010: posts the ante 150
DontCryClumsy88: posts the ante 150
Eux1986: posts the ante 150
moratto1992: posts the ante 150
4fast2u: posts the ante 150
Dizzydarts: posts the ante 150
ivan limeira: posts the ante 150
Eux1986: posts small blind 600
moratto1992: posts big blind 1200
*** HOLE CARDS ***
4fast2u: folds 
Dizzydarts: folds 
ivan limeira: folds 
MKL1010: raises 1200 to 2400
DontCryClumsy88: calls 2400
Eux1986: folds 
moratto1992: raises 23390 to 25790 and is all-in
MKL1010: folds 
DontCryClumsy88: folds 
Uncalled bet (23390) returned to moratto1992
moratto1992 collected 8850 from pot
moratto1992: doesn't show hand 
*** SUMMARY ***
Total pot 8850 | Rake 0 
Seat 1: MKL1010 folded before Flop
Seat 2: DontCryClumsy88 (button) folded before Flop
Seat 3: Eux1986 (small blind) folded before Flop
Seat 4: moratto1992 (big blind) collected (8850)
Seat 5: 4fast2u folded before Flop (didn't bet)
Seat 6: Dizzydarts folded before Flop (didn't bet)
Seat 7: ivan limeira folded before Flop (didn't bet)

PokerStars Hand #251205637815: Tournament #3767885527, $40+$10+$5 USD Hold'em No Limit - Level XI (600/1200) - 2024/06/26 19:09:06 UTC [2024/06/26 15:09:06 ET]
Table '3767885527 96' 8-max Seat #3 is the button
Seat 1: MKL1010 (34831 in chips) 
Seat 2: DontCryClumsy88 (37978 in chips) 
Seat 3: Eux1986 (86533 in chips) 
Seat 4: moratto1992 (32240 in chips) 
Seat 5: 4fast2u (32791 in chips) 
Seat 6: Dizzydarts (23886 in chips) 
Seat 7: ivan limeira (52252 in chips) 
MKL1010: posts the ante 150
DontCryClumsy88: posts the ante 150
Eux1986: posts the ante 150
moratto1992: posts the ante 150
4fast2u: posts the ante 150
Dizzydarts: posts the ante 150
ivan limeira: posts the ante 150
moratto1992: posts small blind 600
4fast2u: posts big blind 1200
*** HOLE CARDS ***
Dizzydarts: folds 
ivan limeira: folds 
MKL1010: folds 
DontCryClumsy88: folds 
Eux1986: folds 
moratto1992: calls 600
DontCryClumsy88 is disconnected 
4fast2u: checks 
*** FLOP *** [6d 9s Kh]
moratto1992: checks 
DontCryClumsy88 is disconnected 
4fast2u: checks 
*** TURN *** [6d 9s Kh] [6c]
moratto1992: bets 1200
4fast2u: calls 1200
*** RIVER *** [6d 9s Kh 6c] [6h]
moratto1992: bets 1200
4fast2u: calls 1200
*** SHOW DOWN ***
moratto1992: shows [2s 2c] (a full house, Sixes full of Deuces)
4fast2u: mucks hand 
moratto1992 collected 8250 from pot
*** SUMMARY ***
Total pot 8250 | Rake 0 
Board [6d 9s Kh 6c 6h]
Seat 1: MKL1010 folded before Flop (didn't bet)
Seat 2: DontCryClumsy88 folded before Flop (didn't bet)
Seat 3: Eux1986 (button) folded before Flop (didn't bet)
Seat 4: moratto1992 (small blind) showed [2s 2c] and won (8250) with a full house, Sixes full of Deuces
Seat 5: 4fast2u (big blind) mucked
Seat 6: Dizzydarts folded before Flop (didn't bet)
Seat 7: ivan limeira folded before Flop (didn't bet)

PokerStars Hand #251205649992: Tournament #3767885527, $40+$10+$5 USD Hold'em No Limit - Level XII (700/1400) - 2024/06/26 19:09:51 UTC [2024/06/26 15:09:51 ET]
Table '3767885527 96' 8-max Seat #4 is the button
Seat 1: MKL1010 (34681 in chips) 
Seat 2: DontCryClumsy88 (37828 in chips) 
Seat 3: Eux1986 (86383 in chips) 
Seat 4: moratto1992 (36740 in chips) 
Seat 5: 4fast2u (29041 in chips) 
Seat 6: Dizzydarts (23736 in chips) 
Seat 7: ivan limeira (52102 in chips) 
MKL1010: posts the ante 175
DontCryClumsy88: posts the ante 175
Eux1986: posts the ante 175
moratto1992: posts the ante 175
4fast2u: posts the ante 175
Dizzydarts: posts the ante 175
ivan limeira: posts the ante 175
4fast2u: posts small blind 700
Dizzydarts: posts big blind 1400
*** HOLE CARDS ***
ivan limeira: folds 
MKL1010: folds 
DontCryClumsy88: folds 
Eux1986: raises 2800 to 4200
moratto1992: folds 
4fast2u: raises 8225 to 12425
Dizzydarts: folds 
Eux1986: raises 73783 to 86208 and is all-in
4fast2u: calls 16441 and is all-in
Uncalled bet (57342) returned to Eux1986
*** FLOP *** [Ts 6h Qs]
*** TURN *** [Ts 6h Qs] [4d]
*** RIVER *** [Ts 6h Qs 4d] [6s]
*** SHOW DOWN ***
4fast2u: shows [As Ah] (two pair, Aces and Sixes)
Eux1986: shows [4c 4h] (a full house, Fours full of Sixes)
Eux1986 collected 60357 from pot
4fast2u finished the tournament
*** SUMMARY ***
Total pot 60357 | Rake 0 
Board [Ts 6h Qs 4d 6s]
Seat 1: MKL1010 folded before Flop (didn't bet)
Seat 2: DontCryClumsy88 folded before Flop (didn't bet)
Seat 3: Eux1986 showed [4c 4h] and won (60357) with a full house, Fours full of Sixes
Seat 4: moratto1992 (button) folded before Flop (didn't bet)
Seat 5: 4fast2u (small blind) showed [As Ah] and lost with two pair, Aces and Sixes
Seat 6: Dizzydarts (big blind) folded before Flop
Seat 7: ivan limeira folded before Flop (didn't bet)

PokerStars Hand #251205661495: Tournament #3767885527, $40+$10+$5 USD Hold'em No Limit - Level XII (700/1400) - 2024/06/26 19:10:34 UTC [2024/06/26 15:10:34 ET]
Table '3767885527 96' 8-max Seat #6 is the button
Seat 1: MKL1010 (34506 in chips) 
Seat 2: DontCryClumsy88 (37653 in chips) 
Seat 3: Eux1986 (117699 in chips) 
Seat 4: moratto1992 (36565 in chips) 
Seat 6: Dizzydarts (22161 in chips) 
Seat 7: ivan limeira (51927 in chips) 
Seat 8: diabo656 (78175 in chips) 
MKL1010: posts the ante 175
DontCryClumsy88: posts the ante 175
Eux1986: posts the ante 175
moratto1992: posts the ante 175
Dizzydarts: posts the ante 175
ivan limeira: posts the ante 175
diabo656: posts the ante 175
ivan limeira: posts small blind 700
diabo656: posts big blind 1400
*** HOLE CARDS ***
MKL1010: folds 
DontCryClumsy88: folds 
Eux1986: folds 
moratto1992: folds 
Dizzydarts: raises 1400 to 2800
ivan limeira: folds 
diabo656 has timed out
diabo656: folds 
diabo656 is sitting out
Uncalled bet (1400) returned to Dizzydarts
Dizzydarts collected 4725 from pot
Dizzydarts: doesn't show hand 
*** SUMMARY ***
Total pot 4725 | Rake 0 
Seat 1: MKL1010 folded before Flop (didn't bet)
Seat 2: DontCryClumsy88 folded before Flop (didn't bet)
Seat 3: Eux1986 folded before Flop (didn't bet)
Seat 4: moratto1992 folded before Flop (didn't bet)
Seat 6: Dizzydarts (button) collected (4725)
Seat 7: ivan limeira (small blind) folded before Flop
Seat 8: diabo656 (big blind) folded before Flop

PokerStars Hand #251205669658: Tournament #3767885527, $40+$10+$5 USD Hold'em No Limit - Level XII (700/1400) - 2024/06/26 19:11:04 UTC [2024/06/26 15:11:04 ET]
Table '3767885527 96' 8-max Seat #7 is the button
Seat 1: MKL1010 (34331 in chips) 
Seat 2: DontCryClumsy88 (37478 in chips) 
Seat 3: Eux1986 (117524 in chips) 
Seat 4: moratto1992 (36390 in chips) 
Seat 6: Dizzydarts (25311 in chips) 
Seat 7: ivan limeira (51052 in chips) 
Seat 8: diabo656 (76600 in chips) is sitting out
MKL1010: posts the ante 175
DontCryClumsy88: posts the ante 175
Eux1986: posts the ante 175
moratto1992: posts the ante 175
Dizzydarts: posts the ante 175
ivan limeira: posts the ante 175
diabo656: posts the ante 175
diabo656: posts small blind 700
MKL1010: posts big blind 1400
*** HOLE CARDS ***
DontCryClumsy88: folds 
Eux1986: folds 
moratto1992: folds 
Dizzydarts: calls 1400
ivan limeira: folds 
diabo656: folds 
MKL1010: checks 
*** FLOP *** [Ah 8s 9h]
diabo656 has returned
MKL1010: checks 
Dizzydarts: bets 2363
MKL1010: folds 
Uncalled bet (2363) returned to Dizzydarts
Dizzydarts collected 4725 from pot
Dizzydarts: doesn't show hand 
*** SUMMARY ***
Total pot 4725 | Rake 0 
Board [Ah 8s 9h]
Seat 1: MKL1010 (big blind) folded on the Flop
Seat 2: DontCryClumsy88 folded before Flop (didn't bet)
Seat 3: Eux1986 folded before Flop (didn't bet)
Seat 4: moratto1992 folded before Flop (didn't bet)
Seat 6: Dizzydarts collected (4725)
Seat 7: ivan limeira (button) folded before Flop (didn't bet)
Seat 8: diabo656 (small blind) folded before Flop

PokerStars Hand #251205677346: Tournament #3767885527, $40+$10+$5 USD Hold'em No Limit - Level XII (700/1400) - 2024/06/26 19:11:33 UTC [2024/06/26 15:11:33 ET]
Table '3767885527 96' 8-max Seat #8 is the button
Seat 1: MKL1010 (32756 in chips) 
Seat 2: DontCryClumsy88 (37303 in chips) 
Seat 3: Eux1986 (117349 in chips) 
Seat 4: moratto1992 (36215 in chips) 
Seat 6: Dizzydarts (28461 in chips) 
Seat 7: ivan limeira (50877 in chips) 
Seat 8: diabo656 (75725 in chips) 
MKL1010: posts the ante 175
DontCryClumsy88: posts the ante 175
Eux1986: posts the ante 175
moratto1992: posts the ante 175
Dizzydarts: posts the ante 175
ivan limeira: posts the ante 175
diabo656: posts the ante 175
MKL1010: posts small blind 700
DontCryClumsy88: posts big blind 1400
*** HOLE CARDS ***
Eux1986: folds 
moratto1992: raises 1400 to 2800
Dizzydarts: folds 
ivan limeira: raises 4900 to 7700
diabo656 has timed out
diabo656: folds 
diabo656 is sitting out
diabo656 has returned
MKL1010: folds 
DontCryClumsy88: folds 
moratto1992: calls 4900
*** FLOP *** [As 5d 6c]
moratto1992: checks 
ivan limeira: bets 4200
UnterMauern is disconnected 
moratto1992: folds 
Uncalled bet (4200) returned to ivan limeira
ivan limeira collected 18725 from pot
ivan limeira: doesn't show hand 
*** SUMMARY ***
Total pot 18725 | Rake 0 
Board [As 5d 6c]
Seat 1: MKL1010 (small blind) folded before Flop
Seat 2: DontCryClumsy88 (big blind) folded before Flop
Seat 3: Eux1986 folded before Flop (didn't bet)
Seat 4: moratto1992 folded on the Flop
Seat 6: Dizzydarts folded before Flop (didn't bet)
Seat 7: ivan limeira collected (18725)
Seat 8: diabo656 (button) folded before Flop (didn't bet)

PokerStars Hand #251205698735: Tournament #3767885527, $40+$10+$5 USD Hold'em No Limit - Level XII (700/1400) - 2024/06/26 19:12:52 UTC [2024/06/26 15:12:52 ET]
Table '3767885527 96' 8-max Seat #1 is the button
Seat 1: MKL1010 (31881 in chips) 
Seat 2: DontCryClumsy88 (35728 in chips) 
Seat 3: Eux1986 (117174 in chips) 
Seat 4: moratto1992 (28340 in chips) 
Seat 5: UnterMauern (25000 in chips) 
Seat 6: Dizzydarts (28286 in chips) 
Seat 7: ivan limeira (61727 in chips) 
Seat 8: diabo656 (75550 in chips) 
MKL1010: posts the ante 175
DontCryClumsy88: posts the ante 175
Eux1986: posts the ante 175
moratto1992: posts the ante 175
UnterMauern: posts the ante 175
Dizzydarts: posts the ante 175
ivan limeira: posts the ante 175
diabo656: posts the ante 175
DontCryClumsy88: posts small blind 700
Eux1986: posts big blind 1400
*** HOLE CARDS ***
moratto1992: folds 
UnterMauern: folds 
Dizzydarts: raises 1400 to 2800
ivan limeira: folds 
diabo656: folds 
MKL1010: folds 
DontCryClumsy88: calls 2100
Eux1986: calls 1400
*** FLOP *** [Ks As 9d]
DontCryClumsy88: checks 
Eux1986: bets 1400
Dizzydarts: calls 1400
DontCryClumsy88: calls 1400
*** TURN *** [Ks As 9d] [4d]
DontCryClumsy88: checks 
Eux1986: checks 
Dizzydarts: bets 2100
DontCryClumsy88: calls 2100
Eux1986: folds 
*** RIVER *** [Ks As 9d 4d] [Tc]
DontCryClumsy88: checks 
Dizzydarts: checks 
*** SHOW DOWN ***
DontCryClumsy88: shows [8d Ad] (a pair of Aces)
Dizzydarts: mucks hand 
DontCryClumsy88 collected 18200 from pot
*** SUMMARY ***
Total pot 18200 | Rake 0 
Board [Ks As 9d 4d Tc]
Seat 1: MKL1010 (button) folded before Flop (didn't bet)
Seat 2: DontCryClumsy88 (small blind) showed [8d Ad] and won (18200) with a pair of Aces
Seat 3: Eux1986 (big blind) folded on the Turn
Seat 4: moratto1992 folded before Flop (didn't bet)
Seat 5: UnterMauern folded before Flop (didn't bet)
Seat 6: Dizzydarts mucked
Seat 7: ivan limeira folded before Flop (didn't bet)
Seat 8: diabo656 folded before Flop (didn't bet)

PokerStars Hand #251205717395: Tournament #3767885527, $40+$10+$5 USD Hold'em No Limit - Level XII (700/1400) - 2024/06/26 19:14:01 UTC [2024/06/26 15:14:01 ET]
Table '3767885527 96' 8-max Seat #2 is the button
Seat 1: MKL1010 (31706 in chips) 
Seat 2: DontCryClumsy88 (47453 in chips) 
Seat 3: Eux1986 (112799 in chips) 
Seat 4: moratto1992 (28165 in chips) 
Seat 5: UnterMauern (24825 in chips) 
Seat 6: Dizzydarts (21811 in chips) 
Seat 7: ivan limeira (61552 in chips) 
Seat 8: diabo656 (75375 in chips) 
MKL1010: posts the ante 175
DontCryClumsy88: posts the ante 175
Eux1986: posts the ante 175
moratto1992: posts the ante 175
UnterMauern: posts the ante 175
Dizzydarts: posts the ante 175
ivan limeira: posts the ante 175
diabo656: posts the ante 175
Eux1986: posts small blind 700
moratto1992: posts big blind 1400
*** HOLE CARDS ***
UnterMauern: folds 
Dizzydarts: raises 1400 to 2800
ivan limeira: folds 
diabo656: folds 
MKL1010: folds 
DontCryClumsy88: calls 2800
Eux1986: folds 
moratto1992: folds 
*** FLOP *** [3d 6c 8d]
Dizzydarts: checks 
DontCryClumsy88: checks 
*** TURN *** [3d 6c 8d] [5c]
Dizzydarts: checks 
DontCryClumsy88: checks 
*** RIVER *** [3d 6c 8d 5c] [Td]
Dizzydarts: checks 
DontCryClumsy88: checks 
*** SHOW DOWN ***
Dizzydarts: shows [Qs Ah] (high card Ace)
DontCryClumsy88: shows [Qc Ad] (high card Ace)
Dizzydarts collected 4550 from pot
DontCryClumsy88 collected 4550 from pot
*** SUMMARY ***
Total pot 9100 | Rake 0 
Board [3d 6c 8d 5c Td]
Seat 1: MKL1010 folded before Flop (didn't bet)
Seat 2: DontCryClumsy88 (button) showed [Qc Ad] and won (4550) with high card Ace
Seat 3: Eux1986 (small blind) folded before Flop
Seat 4: moratto1992 (big blind) folded before Flop
Seat 5: UnterMauern folded before Flop (didn't bet)
Seat 6: Dizzydarts showed [Qs Ah] and won (4550) with high card Ace
Seat 7: ivan limeira folded before Flop (didn't bet)
Seat 8: diabo656 folded before Flop (didn't bet)

PokerStars Hand #251205729421: Tournament #3767885527, $40+$10+$5 USD Hold'em No Limit - Level XII (700/1400) - 2024/06/26 19:14:45 UTC [2024/06/26 15:14:45 ET]
Table '3767885527 96' 8-max Seat #3 is the button
Seat 1: MKL1010 (31531 in chips) 
Seat 2: DontCryClumsy88 (49028 in chips) 
Seat 3: Eux1986 (111924 in chips) 
Seat 4: moratto1992 (26590 in chips) 
Seat 5: UnterMauern (24650 in chips) 
Seat 6: Dizzydarts (23386 in chips) 
Seat 7: ivan limeira (61377 in chips) 
Seat 8: diabo656 (75200 in chips) 
MKL1010: posts the ante 175
DontCryClumsy88: posts the ante 175
Eux1986: posts the ante 175
moratto1992: posts the ante 175
UnterMauern: posts the ante 175
Dizzydarts: posts the ante 175
ivan limeira: posts the ante 175
diabo656: posts the ante 175
moratto1992: posts small blind 700
UnterMauern: posts big blind 1400
*** HOLE CARDS ***
Dizzydarts: folds 
ivan limeira: folds 
diabo656 has timed out
diabo656: folds 
diabo656 is sitting out
MKL1010: folds 
DontCryClumsy88: folds 
Eux1986: calls 1400
moratto1992: calls 700
diabo656 has returned
UnterMauern: checks 
*** FLOP *** [Th 4d 3h]
moratto1992: checks 
UnterMauern: checks 
Eux1986: bets 2800
moratto1992: calls 2800
UnterMauern: folds 
*** TURN *** [Th 4d 3h] [8s]
moratto1992: bets 22215 and is all-in
Eux1986: folds 
Uncalled bet (22215) returned to moratto1992
moratto1992 collected 11200 from pot
moratto1992: doesn't show hand 
*** SUMMARY ***
Total pot 11200 | Rake 0 
Board [Th 4d 3h 8s]
Seat 1: MKL1010 folded before Flop (didn't bet)
Seat 2: DontCryClumsy88 folded before Flop (didn't bet)
Seat 3: Eux1986 (button) folded on the Turn
Seat 4: moratto1992 (small blind) collected (11200)
Seat 5: UnterMauern (big blind) folded on the Flop
Seat 6: Dizzydarts folded before Flop (didn't bet)
Seat 7: ivan limeira folded before Flop (didn't bet)
Seat 8: diabo656 folded before Flop (didn't bet)

PokerStars Hand #251205757480: Tournament #3767885527, $40+$10+$5 USD Hold'em No Limit - Level XII (700/1400) - 2024/06/26 19:16:28 UTC [2024/06/26 15:16:28 ET]
Table '3767885527 96' 8-max Seat #4 is the button
Seat 1: MKL1010 (31356 in chips) 
Seat 2: DontCryClumsy88 (48853 in chips) 
Seat 3: Eux1986 (107549 in chips) 
Seat 4: moratto1992 (33415 in chips) 
Seat 5: UnterMauern (23075 in chips) 
Seat 6: Dizzydarts (23211 in chips) 
Seat 7: ivan limeira (61202 in chips) 
Seat 8: diabo656 (75025 in chips) 
MKL1010: posts the ante 175
DontCryClumsy88: posts the ante 175
Eux1986: posts the ante 175
moratto1992: posts the ante 175
UnterMauern: posts the ante 175
Dizzydarts: posts the ante 175
ivan limeira: posts the ante 175
diabo656: posts the ante 175
UnterMauern: posts small blind 700
Dizzydarts: posts big blind 1400
*** HOLE CARDS ***
MKL1010 is disconnected 
ivan limeira: folds 
diabo656: folds 
MKL1010 is connected 
MKL1010 is connected 
MKL1010: folds 
DontCryClumsy88: folds 
Eux1986: calls 1400
moratto1992: folds 
UnterMauern: folds 
Dizzydarts: checks 
*** FLOP *** [Tc 5d 5s]
Dizzydarts: checks 
Eux1986: checks 
*** TURN *** [Tc 5d 5s] [6h]
Dizzydarts: checks 
Eux1986: bets 2800
Dizzydarts: folds 
Uncalled bet (2800) returned to Eux1986
Eux1986 collected 4900 from pot
Eux1986: doesn't show hand 
*** SUMMARY ***
Total pot 4900 | Rake 0 
Board [Tc 5d 5s 6h]
Seat 1: MKL1010 folded before Flop (didn't bet)
Seat 2: DontCryClumsy88 folded before Flop (didn't bet)
Seat 3: Eux1986 collected (4900)
Seat 4: moratto1992 (button) folded before Flop (didn't bet)
Seat 5: UnterMauern (small blind) folded before Flop
Seat 6: Dizzydarts (big blind) folded on the Turn
Seat 7: ivan limeira folded before Flop (didn't bet)
Seat 8: diabo656 folded before Flop (didn't bet)

PokerStars Hand #251205771625: Tournament #3767885527, $40+$10+$5 USD Hold'em No Limit - Level XII (700/1400) - 2024/06/26 19:17:20 UTC [2024/06/26 15:17:20 ET]
Table '3767885527 96' 8-max Seat #5 is the button
Seat 1: MKL1010 (31181 in chips) 
Seat 2: DontCryClumsy88 (48678 in chips) 
Seat 3: Eux1986 (110874 in chips) 
Seat 4: moratto1992 (33240 in chips) 
Seat 5: UnterMauern (22200 in chips) 
Seat 6: Dizzydarts (21636 in chips) 
Seat 7: ivan limeira (61027 in chips) 
Seat 8: diabo656 (74850 in chips) 
MKL1010: posts the ante 175
DontCryClumsy88: posts the ante 175
Eux1986: posts the ante 175
moratto1992: posts the ante 175
UnterMauern: posts the ante 175
Dizzydarts: posts the ante 175
ivan limeira: posts the ante 175
diabo656: posts the ante 175
Dizzydarts: posts small blind 700
ivan limeira: posts big blind 1400
*** HOLE CARDS ***
diabo656 has timed out
diabo656: folds 
diabo656 is sitting out
MKL1010: folds 
diabo656 has returned
DontCryClumsy88: folds 
Eux1986: folds 
moratto1992: folds 
UnterMauern: folds 
Dizzydarts: calls 700
ivan limeira: raises 59452 to 60852 and is all-in
Dizzydarts: folds 
Uncalled bet (59452) returned to ivan limeira
ivan limeira collected 4200 from pot
ivan limeira: doesn't show hand 
*** SUMMARY ***
Total pot 4200 | Rake 0 
Seat 1: MKL1010 folded before Flop (didn't bet)
Seat 2: DontCryClumsy88 folded before Flop (didn't bet)
Seat 3: Eux1986 folded before Flop (didn't bet)
Seat 4: moratto1992 folded before Flop (didn't bet)
Seat 5: UnterMauern (button) folded before Flop (didn't bet)
Seat 6: Dizzydarts (small blind) folded before Flop
Seat 7: ivan limeira (big blind) collected (4200)
Seat 8: diabo656 folded before Flop (didn't bet)

PokerStars Hand #251205783980: Tournament #3767885527, $40+$10+$5 USD Hold'em No Limit - Level XII (700/1400) - 2024/06/26 19:18:05 UTC [2024/06/26 15:18:05 ET]
Table '3767885527 96' 8-max Seat #6 is the button
Seat 1: MKL1010 (31006 in chips) 
Seat 2: DontCryClumsy88 (48503 in chips) 
Seat 3: Eux1986 (110699 in chips) 
Seat 4: moratto1992 (33065 in chips) 
Seat 5: UnterMauern (22025 in chips) 
Seat 6: Dizzydarts (20061 in chips) 
Seat 7: ivan limeira (63652 in chips) 
Seat 8: diabo656 (74675 in chips) 
MKL1010: posts the ante 175
DontCryClumsy88: posts the ante 175
Eux1986: posts the ante 175
moratto1992: posts the ante 175
UnterMauern: posts the ante 175
Dizzydarts: posts the ante 175
ivan limeira: posts the ante 175
diabo656: posts the ante 175
ivan limeira: posts small blind 700
diabo656: posts big blind 1400
*** HOLE CARDS ***
MKL1010: folds 
DontCryClumsy88: folds 
Eux1986: folds 
moratto1992: folds 
UnterMauern: folds 
Dizzydarts: raises 1400 to 2800
ivan limeira: folds 
diabo656: calls 1400
*** FLOP *** [9d Ah Ks]
diabo656: checks 
Dizzydarts: checks 
*** TURN *** [9d Ah Ks] [Qc]
diabo656: bets 3850
Dizzydarts: folds 
Uncalled bet (3850) returned to diabo656
diabo656 collected 7700 from pot
*** SUMMARY ***
Total pot 7700 | Rake 0 
Board [9d Ah Ks Qc]
Seat 1: MKL1010 folded before Flop (didn't bet)
Seat 2: DontCryClumsy88 folded before Flop (didn't bet)
Seat 3: Eux1986 folded before Flop (didn't bet)
Seat 4: moratto1992 folded before Flop (didn't bet)
Seat 5: UnterMauern folded before Flop (didn't bet)
Seat 6: Dizzydarts (button) folded on the Turn
Seat 7: ivan limeira (small blind) folded before Flop
Seat 8: diabo656 (big blind) collected (7700)

PokerStars Hand #251205796194: Tournament #3767885527, $40+$10+$5 USD Hold'em No Limit - Level XII (700/1400) - 2024/06/26 19:18:50 UTC [2024/06/26 15:18:50 ET]
Table '3767885527 96' 8-max Seat #7 is the button
Seat 1: MKL1010 (30831 in chips) 
Seat 2: DontCryClumsy88 (48328 in chips) 
Seat 3: Eux1986 (110524 in chips) 
Seat 4: moratto1992 (32890 in chips) 
Seat 5: UnterMauern (21850 in chips) 
Seat 6: Dizzydarts (17086 in chips) 
Seat 7: ivan limeira (62777 in chips) 
Seat 8: diabo656 (79400 in chips) 
MKL1010: posts the ante 175
DontCryClumsy88: posts the ante 175
Eux1986: posts the ante 175
moratto1992: posts the ante 175
UnterMauern: posts the ante 175
Dizzydarts: posts the ante 175
ivan limeira: posts the ante 175
diabo656: posts the ante 175
diabo656: posts small blind 700
MKL1010: posts big blind 1400
*** HOLE CARDS ***
DontCryClumsy88: calls 1400
Eux1986: folds 
moratto1992: folds 
UnterMauern: folds 
Dizzydarts: calls 1400
ivan limeira: folds 
diabo656: folds 
MKL1010: checks 
*** FLOP *** [3d Qd Kh]
MKL1010: checks 
DontCryClumsy88: checks 
Dizzydarts: checks 
*** TURN *** [3d Qd Kh] [5c]
MKL1010: bets 2800
DontCryClumsy88: calls 2800
Dizzydarts: folds 
*** RIVER *** [3d Qd Kh 5c] [Ac]
MKL1010: checks 
DontCryClumsy88: bets 3927
MKL1010: calls 3927
*** SHOW DOWN ***
DontCryClumsy88: shows [Jc Td] (a straight, Ten to Ace)
MKL1010: mucks hand 
DontCryClumsy88 collected 19754 from pot
*** SUMMARY ***
Total pot 19754 | Rake 0 
Board [3d Qd Kh 5c Ac]
Seat 1: MKL1010 (big blind) mucked
Seat 2: DontCryClumsy88 showed [Jc Td] and won (19754) with a straight, Ten to Ace
Seat 3: Eux1986 folded before Flop (didn't bet)
Seat 4: moratto1992 folded before Flop (didn't bet)
Seat 5: UnterMauern folded before Flop (didn't bet)
Seat 6: Dizzydarts folded on the Turn
Seat 7: ivan limeira (button) folded before Flop (didn't bet)
Seat 8: diabo656 (small blind) folded before Flop

PokerStars Hand #251205810694: Tournament #3767885527, $40+$10+$5 USD Hold'em No Limit - Level XIII (800/1600) - 2024/06/26 19:19:43 UTC [2024/06/26 15:19:43 ET]
Table '3767885527 96' 8-max Seat #8 is the button
Seat 1: MKL1010 (22529 in chips) 
Seat 2: DontCryClumsy88 (59780 in chips) 
Seat 3: Eux1986 (110349 in chips) 
Seat 4: moratto1992 (32715 in chips) 
Seat 5: UnterMauern (21675 in chips) 
Seat 6: Dizzydarts (15511 in chips) 
Seat 7: ivan limeira (62602 in chips) 
Seat 8: diabo656 (78525 in chips) 
MKL1010: posts the ante 200
DontCryClumsy88: posts the ante 200
Eux1986: posts the ante 200
moratto1992: posts the ante 200
UnterMauern: posts the ante 200
Dizzydarts: posts the ante 200
ivan limeira: posts the ante 200
diabo656: posts the ante 200
MKL1010: posts small blind 800
DontCryClumsy88: posts big blind 1600
*** HOLE CARDS ***
Eux1986: folds 
moratto1992: folds 
UnterMauern: folds 
Dizzydarts: folds 
ivan limeira: folds 
diabo656: folds 
MKL1010: calls 800
DontCryClumsy88: checks 
*** FLOP *** [5h 9s Jc]
MKL1010: checks 
DontCryClumsy88: checks 
*** TURN *** [5h 9s Jc] [Ad]
MKL1010: checks 
DontCryClumsy88: bets 2640
MKL1010: folds 
Uncalled bet (2640) returned to DontCryClumsy88
DontCryClumsy88 collected 4800 from pot
*** SUMMARY ***
Total pot 4800 | Rake 0 
Board [5h 9s Jc Ad]
Seat 1: MKL1010 (small blind) folded on the Turn
Seat 2: DontCryClumsy88 (big blind) collected (4800)
Seat 3: Eux1986 folded before Flop (didn't bet)
Seat 4: moratto1992 folded before Flop (didn't bet)
Seat 5: UnterMauern folded before Flop (didn't bet)
Seat 6: Dizzydarts folded before Flop (didn't bet)
Seat 7: ivan limeira folded before Flop (didn't bet)
Seat 8: diabo656 (button) folded before Flop (didn't bet)

PokerStars Hand #251205820329: Tournament #3767885527, $40+$10+$5 USD Hold'em No Limit - Level XIII (800/1600) - 2024/06/26 19:20:18 UTC [2024/06/26 15:20:18 ET]
Table '3767885527 96' 8-max Seat #1 is the button
Seat 1: MKL1010 (20729 in chips) 
Seat 2: DontCryClumsy88 (62780 in chips) 
Seat 3: Eux1986 (110149 in chips) 
Seat 4: moratto1992 (32515 in chips) 
Seat 5: UnterMauern (21475 in chips) 
Seat 6: Dizzydarts (15311 in chips) 
Seat 7: ivan limeira (62402 in chips) 
Seat 8: diabo656 (78325 in chips) 
MKL1010: posts the ante 200
DontCryClumsy88: posts the ante 200
Eux1986: posts the ante 200
moratto1992: posts the ante 200
UnterMauern: posts the ante 200
Dizzydarts: posts the ante 200
ivan limeira: posts the ante 200
diabo656: posts the ante 200
DontCryClumsy88: posts small blind 800
Eux1986: posts big blind 1600
*** HOLE CARDS ***
moratto1992: folds 
UnterMauern: folds 
Dizzydarts: raises 1600 to 3200
ivan limeira: folds 
diabo656: folds 
MKL1010: folds 
DontCryClumsy88: folds 
Eux1986: calls 1600
*** FLOP *** [6d Jd 2c]
Eux1986: checks 
Dizzydarts: bets 11911 and is all-in
Eux1986: folds 
Uncalled bet (11911) returned to Dizzydarts
Dizzydarts collected 8800 from pot
Dizzydarts: doesn't show hand 
*** SUMMARY ***
Total pot 8800 | Rake 0 
Board [6d Jd 2c]
Seat 1: MKL1010 (button) folded before Flop (didn't bet)
Seat 2: DontCryClumsy88 (small blind) folded before Flop
Seat 3: Eux1986 (big blind) folded on the Flop
Seat 4: moratto1992 folded before Flop (didn't bet)
Seat 5: UnterMauern folded before Flop (didn't bet)
Seat 6: Dizzydarts collected (8800)
Seat 7: ivan limeira folded before Flop (didn't bet)
Seat 8: diabo656 folded before Flop (didn't bet)

PokerStars Hand #251205830398: Tournament #3767885527, $40+$10+$5 USD Hold'em No Limit - Level XIII (800/1600) - 2024/06/26 19:20:56 UTC [2024/06/26 15:20:56 ET]
Table '3767885527 96' 8-max Seat #2 is the button
Seat 1: MKL1010 (20529 in chips) 
Seat 2: DontCryClumsy88 (61780 in chips) 
Seat 3: Eux1986 (106749 in chips) 
Seat 4: moratto1992 (32315 in chips) 
Seat 5: UnterMauern (21275 in chips) 
Seat 6: Dizzydarts (20711 in chips) 
Seat 7: ivan limeira (62202 in chips) 
Seat 8: diabo656 (78125 in chips) 
MKL1010: posts the ante 200
DontCryClumsy88: posts the ante 200
Eux1986: posts the ante 200
moratto1992: posts the ante 200
UnterMauern: posts the ante 200
Dizzydarts: posts the ante 200
ivan limeira: posts the ante 200
diabo656: posts the ante 200
Eux1986: posts small blind 800
moratto1992: posts big blind 1600
*** HOLE CARDS ***
UnterMauern: raises 19200 to 20800
Dizzydarts: folds 
ivan limeira: folds 
diabo656: folds 
MKL1010: folds 
DontCryClumsy88: folds 
Eux1986: folds 
moratto1992: folds 
Uncalled bet (19200) returned to UnterMauern
UnterMauern collected 5600 from pot
UnterMauern: doesn't show hand 
*** SUMMARY ***
Total pot 5600 | Rake 0 
Seat 1: MKL1010 folded before Flop (didn't bet)
Seat 2: DontCryClumsy88 (button) folded before Flop (didn't bet)
Seat 3: Eux1986 (small blind) folded before Flop
Seat 4: moratto1992 (big blind) folded before Flop
Seat 5: UnterMauern collected (5600)
Seat 6: Dizzydarts folded before Flop (didn't bet)
Seat 7: ivan limeira folded before Flop (didn't bet)
Seat 8: diabo656 folded before Flop (didn't bet)

PokerStars Hand #251205840255: Tournament #3767885527, $40+$10+$5 USD Hold'em No Limit - Level XIII (800/1600) - 2024/06/26 19:21:32 UTC [2024/06/26 15:21:32 ET]
Table '3767885527 96' 8-max Seat #3 is the button
Seat 1: MKL1010 (20329 in chips) 
Seat 2: DontCryClumsy88 (61580 in chips) 
Seat 3: Eux1986 (105749 in chips) 
Seat 4: moratto1992 (30515 in chips) 
Seat 5: UnterMauern (25075 in chips) 
Seat 6: Dizzydarts (20511 in chips) 
Seat 7: ivan limeira (62002 in chips) 
Seat 8: diabo656 (77925 in chips) 
MKL1010: posts the ante 200
DontCryClumsy88: posts the ante 200
Eux1986: posts the ante 200
moratto1992: posts the ante 200
UnterMauern: posts the ante 200
Dizzydarts: posts the ante 200
ivan limeira: posts the ante 200
diabo656: posts the ante 200
moratto1992: posts small blind 800
UnterMauern: posts big blind 1600
*** HOLE CARDS ***
Dizzydarts: folds 
ivan limeira: folds 
diabo656: folds 
MKL1010: folds 
DontCryClumsy88: folds 
Eux1986: folds 
moratto1992: raises 28715 to 30315 and is all-in
UnterMauern: folds 
Uncalled bet (28715) returned to moratto1992
moratto1992 collected 4800 from pot
moratto1992: doesn't show hand 
*** SUMMARY ***
Total pot 4800 | Rake 0 
Seat 1: MKL1010 folded before Flop (didn't bet)
Seat 2: DontCryClumsy88 folded before Flop (didn't bet)
Seat 3: Eux1986 (button) folded before Flop (didn't bet)
Seat 4: moratto1992 (small blind) collected (4800)
Seat 5: UnterMauern (big blind) folded before Flop
Seat 6: Dizzydarts folded before Flop (didn't bet)
Seat 7: ivan limeira folded before Flop (didn't bet)
Seat 8: diabo656 folded before Flop (didn't bet)

PokerStars Hand #251205848401: Tournament #3767885527, $40+$10+$5 USD Hold'em No Limit - Level XIII (800/1600) - 2024/06/26 19:22:02 UTC [2024/06/26 15:22:02 ET]
Table '3767885527 96' 8-max Seat #4 is the button
Seat 1: MKL1010 (20129 in chips) 
Seat 2: DontCryClumsy88 (61380 in chips) 
Seat 3: Eux1986 (105549 in chips) 
Seat 4: moratto1992 (33515 in chips) 
Seat 5: UnterMauern (23275 in chips) 
Seat 6: Dizzydarts (20311 in chips) 
Seat 7: ivan limeira (61802 in chips) 
Seat 8: diabo656 (77725 in chips) 
MKL1010: posts the ante 200
DontCryClumsy88: posts the ante 200
Eux1986: posts the ante 200
moratto1992: posts the ante 200
UnterMauern: posts the ante 200
Dizzydarts: posts the ante 200
ivan limeira: posts the ante 200
diabo656: posts the ante 200
UnterMauern: posts small blind 800
Dizzydarts: posts big blind 1600
*** HOLE CARDS ***
ivan limeira: folds 
diabo656: calls 1600
MKL1010: folds 
DontCryClumsy88: folds 
Eux1986: folds 
moratto1992: folds 
UnterMauern: folds 
Dizzydarts: checks 
*** FLOP *** [3h 5s 9c]
Dizzydarts: checks 
diabo656: bets 5600
Dizzydarts: folds 
Uncalled bet (5600) returned to diabo656
diabo656 collected 5600 from pot
*** SUMMARY ***
Total pot 5600 | Rake 0 
Board [3h 5s 9c]
Seat 1: MKL1010 folded before Flop (didn't bet)
Seat 2: DontCryClumsy88 folded before Flop (didn't bet)
Seat 3: Eux1986 folded before Flop (didn't bet)
Seat 4: moratto1992 (button) folded before Flop (didn't bet)
Seat 5: UnterMauern (small blind) folded before Flop
Seat 6: Dizzydarts (big blind) folded on the Flop
Seat 7: ivan limeira folded before Flop (didn't bet)
Seat 8: diabo656 collected (5600)

PokerStars Hand #251205860002: Tournament #3767885527, $40+$10+$5 USD Hold'em No Limit - Level XIII (800/1600) - 2024/06/26 19:22:44 UTC [2024/06/26 15:22:44 ET]
Table '3767885527 96' 8-max Seat #5 is the button
Seat 1: MKL1010 (19929 in chips) 
Seat 2: DontCryClumsy88 (61180 in chips) 
Seat 3: Eux1986 (105349 in chips) 
Seat 4: moratto1992 (33315 in chips) 
Seat 5: UnterMauern (22275 in chips) 
Seat 6: Dizzydarts (18511 in chips) 
Seat 7: ivan limeira (61602 in chips) 
Seat 8: diabo656 (81525 in chips) 
MKL1010: posts the ante 200
DontCryClumsy88: posts the ante 200
Eux1986: posts the ante 200
moratto1992: posts the ante 200
UnterMauern: posts the ante 200
Dizzydarts: posts the ante 200
ivan limeira: posts the ante 200
diabo656: posts the ante 200
Dizzydarts: posts small blind 800
ivan limeira: posts big blind 1600
*** HOLE CARDS ***
diabo656: folds 
MKL1010: folds 
DontCryClumsy88: folds 
Eux1986: calls 1600
moratto1992: calls 1600
UnterMauern: calls 1600
Dizzydarts: raises 16711 to 18311 and is all-in
ivan limeira: folds 
Eux1986: folds 
moratto1992: folds 
UnterMauern: folds 
Uncalled bet (16711) returned to Dizzydarts
Dizzydarts collected 9600 from pot
Dizzydarts: doesn't show hand 
*** SUMMARY ***
Total pot 9600 | Rake 0 
Seat 1: MKL1010 folded before Flop (didn't bet)
Seat 2: DontCryClumsy88 folded before Flop (didn't bet)
Seat 3: Eux1986 folded before Flop
Seat 4: moratto1992 folded before Flop
Seat 5: UnterMauern (button) folded before Flop
Seat 6: Dizzydarts (small blind) collected (9600)
Seat 7: ivan limeira (big blind) folded before Flop
Seat 8: diabo656 folded before Flop (didn't bet)

PokerStars Hand #251205876143: Tournament #3767885527, $40+$10+$5 USD Hold'em No Limit - Level XIII (800/1600) - 2024/06/26 19:23:43 UTC [2024/06/26 15:23:43 ET]
Table '3767885527 96' 8-max Seat #6 is the button
Seat 1: MKL1010 (19729 in chips) 
Seat 2: DontCryClumsy88 (60980 in chips) 
Seat 3: Eux1986 (103549 in chips) 
Seat 4: moratto1992 (31515 in chips) 
Seat 5: UnterMauern (20475 in chips) 
Seat 6: Dizzydarts (26311 in chips) 
Seat 7: ivan limeira (59802 in chips) 
Seat 8: diabo656 (81325 in chips) 
MKL1010: posts the ante 200
DontCryClumsy88: posts the ante 200
Eux1986: posts the ante 200
moratto1992: posts the ante 200
UnterMauern: posts the ante 200
Dizzydarts: posts the ante 200
ivan limeira: posts the ante 200
diabo656: posts the ante 200
ivan limeira: posts small blind 800
diabo656: posts big blind 1600
*** HOLE CARDS ***
MKL1010: raises 17929 to 19529 and is all-in
DontCryClumsy88: folds 
Eux1986: folds 
moratto1992: folds 
UnterMauern: folds 
Dizzydarts: folds 
ivan limeira: folds 
diabo656 is disconnected 
diabo656 is connected 
diabo656 is connected 
diabo656: folds 
Uncalled bet (17929) returned to MKL1010
MKL1010 collected 5600 from pot
MKL1010: doesn't show hand 
*** SUMMARY ***
Total pot 5600 | Rake 0 
Seat 1: MKL1010 collected (5600)
Seat 2: DontCryClumsy88 folded before Flop (didn't bet)
Seat 3: Eux1986 folded before Flop (didn't bet)
Seat 4: moratto1992 folded before Flop (didn't bet)
Seat 5: UnterMauern folded before Flop (didn't bet)
Seat 6: Dizzydarts (button) folded before Flop (didn't bet)
Seat 7: ivan limeira (small blind) folded before Flop
Seat 8: diabo656 (big blind) folded before Flop

PokerStars Hand #251205887405: Tournament #3767885527, $40+$10+$5 USD Hold'em No Limit - Level XIII (800/1600) - 2024/06/26 19:24:24 UTC [2024/06/26 15:24:24 ET]
Table '3767885527 96' 8-max Seat #7 is the button
Seat 1: MKL1010 (23529 in chips) 
Seat 2: DontCryClumsy88 (60780 in chips) 
Seat 3: Eux1986 (103349 in chips) 
Seat 4: moratto1992 (31315 in chips) 
Seat 5: UnterMauern (20275 in chips) 
Seat 6: Dizzydarts (26111 in chips) 
Seat 7: ivan limeira (58802 in chips) 
Seat 8: diabo656 (79525 in chips) 
MKL1010: posts the ante 200
DontCryClumsy88: posts the ante 200
Eux1986: posts the ante 200
moratto1992: posts the ante 200
UnterMauern: posts the ante 200
Dizzydarts: posts the ante 200
ivan limeira: posts the ante 200
diabo656: posts the ante 200
diabo656: posts small blind 800
MKL1010: posts big blind 1600
*** HOLE CARDS ***
DontCryClumsy88: folds 
Eux1986: raises 1600 to 3200
moratto1992: raises 4160 to 7360
UnterMauern: folds 
Dizzydarts: folds 
ivan limeira: folds 
diabo656 is connected 
diabo656 is connected 
diabo656: folds 
MKL1010: folds 
Eux1986: raises 95789 to 103149 and is all-in
moratto1992: folds 
Uncalled bet (95789) returned to Eux1986
Eux1986 collected 18720 from pot
Eux1986: doesn't show hand 
*** SUMMARY ***
Total pot 18720 | Rake 0 
Seat 1: MKL1010 (big blind) folded before Flop
Seat 2: DontCryClumsy88 folded before Flop (didn't bet)
Seat 3: Eux1986 collected (18720)
Seat 4: moratto1992 folded before Flop
Seat 5: UnterMauern folded before Flop (didn't bet)
Seat 6: Dizzydarts folded before Flop (didn't bet)
Seat 7: ivan limeira (button) folded before Flop (didn't bet)
Seat 8: diabo656 (small blind) folded before Flop

PokerStars Hand #251205907060: Tournament #3767885527, $40+$10+$5 USD Hold'em No Limit - Level XIII (800/1600) - 2024/06/26 19:25:35 UTC [2024/06/26 15:25:35 ET]
Table '3767885527 96' 8-max Seat #8 is the button
Seat 1: MKL1010 (21729 in chips) 
Seat 2: DontCryClumsy88 (60580 in chips) 
Seat 3: Eux1986 (114509 in chips) 
Seat 4: moratto1992 (23755 in chips) 
Seat 5: UnterMauern (20075 in chips) 
Seat 6: Dizzydarts (25911 in chips) 
Seat 7: ivan limeira (58602 in chips) 
Seat 8: diabo656 (78525 in chips) 
MKL1010: posts the ante 200
DontCryClumsy88: posts the ante 200
Eux1986: posts the ante 200
moratto1992: posts the ante 200
UnterMauern: posts the ante 200
Dizzydarts: posts the ante 200
ivan limeira: posts the ante 200
diabo656: posts the ante 200
MKL1010: posts small blind 800
DontCryClumsy88: posts big blind 1600
*** HOLE CARDS ***
Eux1986: folds 
moratto1992: raises 1600 to 3200
UnterMauern: folds 
Dizzydarts: folds 
ivan limeira: folds 
diabo656: folds 
MKL1010: folds 
DontCryClumsy88: folds 
Uncalled bet (1600) returned to moratto1992
moratto1992 collected 5600 from pot
moratto1992: doesn't show hand 
*** SUMMARY ***
Total pot 5600 | Rake 0 
Seat 1: MKL1010 (small blind) folded before Flop
Seat 2: DontCryClumsy88 (big blind) folded before Flop
Seat 3: Eux1986 folded before Flop (didn't bet)
Seat 4: moratto1992 collected (5600)
Seat 5: UnterMauern folded before Flop (didn't bet)
Seat 6: Dizzydarts folded before Flop (didn't bet)
Seat 7: ivan limeira folded before Flop (didn't bet)
Seat 8: diabo656 (button) folded before Flop (didn't bet)

PokerStars Hand #251205914078: Tournament #3767885527, $40+$10+$5 USD Hold'em No Limit - Level XIII (800/1600) - 2024/06/26 19:26:01 UTC [2024/06/26 15:26:01 ET]
Table '3767885527 96' 8-max Seat #1 is the button
Seat 1: MKL1010 (20729 in chips) 
Seat 2: DontCryClumsy88 (58780 in chips) 
Seat 3: Eux1986 (114309 in chips) 
Seat 4: moratto1992 (27555 in chips) 
Seat 5: UnterMauern (19875 in chips) 
Seat 6: Dizzydarts (25711 in chips) 
Seat 7: ivan limeira (58402 in chips) 
Seat 8: diabo656 (78325 in chips) 
MKL1010: posts the ante 200
DontCryClumsy88: posts the ante 200
Eux1986: posts the ante 200
moratto1992: posts the ante 200
UnterMauern: posts the ante 200
Dizzydarts: posts the ante 200
ivan limeira: posts the ante 200
diabo656: posts the ante 200
DontCryClumsy88: posts small blind 800
Eux1986: posts big blind 1600
*** HOLE CARDS ***
moratto1992: folds 
UnterMauern: raises 18075 to 19675 and is all-in
Dizzydarts: folds 
ivan limeira: folds 
diabo656: calls 19675
MKL1010: folds 
DontCryClumsy88: folds 
Eux1986: folds 
*** FLOP *** [6s 5c 3s]
*** TURN *** [6s 5c 3s] [Jh]
*** RIVER *** [6s 5c 3s Jh] [Th]
*** SHOW DOWN ***
UnterMauern: shows [6d Ah] (a pair of Sixes)
diabo656: shows [8s 8c] (a pair of Eights)
diabo656 collected 43350 from pot
UnterMauern finished the tournament
*** SUMMARY ***
Total pot 43350 | Rake 0 
Board [6s 5c 3s Jh Th]
Seat 1: MKL1010 (button) folded before Flop (didn't bet)
Seat 2: DontCryClumsy88 (small blind) folded before Flop
Seat 3: Eux1986 (big blind) folded before Flop
Seat 4: moratto1992 folded before Flop (didn't bet)
Seat 5: UnterMauern showed [6d Ah] and lost with a pair of Sixes
Seat 6: Dizzydarts folded before Flop (didn't bet)
Seat 7: ivan limeira folded before Flop (didn't bet)
Seat 8: diabo656 showed [8s 8c] and won (43350) with a pair of Eights

PokerStars Hand #251205922433: Tournament #3767885527, $40+$10+$5 USD Hold'em No Limit - Level XIII (800/1600) - 2024/06/26 19:26:31 UTC [2024/06/26 15:26:31 ET]
Table '3767885527 96' 8-max Seat #2 is the button
Seat 1: MKL1010 (20529 in chips) 
Seat 2: DontCryClumsy88 (57780 in chips) 
Seat 3: Eux1986 (112509 in chips) 
Seat 4: moratto1992 (27355 in chips) 
Seat 6: Dizzydarts (25511 in chips) 
Seat 7: ivan limeira (58202 in chips) 
Seat 8: diabo656 (101800 in chips) 
MKL1010: posts the ante 200
DontCryClumsy88: posts the ante 200
Eux1986: posts the ante 200
moratto1992: posts the ante 200
Dizzydarts: posts the ante 200
ivan limeira: posts the ante 200
diabo656: posts the ante 200
Eux1986: posts small blind 800
moratto1992: posts big blind 1600
*** HOLE CARDS ***
Dizzydarts: folds 
ivan limeira: folds 
diabo656: folds 
MKL1010: folds 
DontCryClumsy88: folds 
Eux1986: calls 800
moratto1992: checks 
*** FLOP *** [3c Jh 6c]
Eux1986: checks 
moratto1992: checks 
*** TURN *** [3c Jh 6c] [Qd]
Ace-hai is disconnected 
Eux1986: checks 
moratto1992: bets 1600
Eux1986: folds 
Uncalled bet (1600) returned to moratto1992
moratto1992 collected 4600 from pot
moratto1992: doesn't show hand 
*** SUMMARY ***
Total pot 4600 | Rake 0 
Board [3c Jh 6c Qd]
Seat 1: MKL1010 folded before Flop (didn't bet)
Seat 2: DontCryClumsy88 (button) folded before Flop (didn't bet)
Seat 3: Eux1986 (small blind) folded on the Turn
Seat 4: moratto1992 (big blind) collected (4600)
Seat 6: Dizzydarts folded before Flop (didn't bet)
Seat 7: ivan limeira folded before Flop (didn't bet)
Seat 8: diabo656 folded before Flop (didn't bet)

PokerStars Hand #251205940461: Tournament #3767885527, $40+$10+$5 USD Hold'em No Limit - Level XIII (800/1600) - 2024/06/26 19:27:38 UTC [2024/06/26 15:27:38 ET]
Table '3767885527 96' 8-max Seat #3 is the button
Seat 1: MKL1010 (20329 in chips) 
Seat 2: DontCryClumsy88 (57580 in chips) 
Seat 3: Eux1986 (110709 in chips) 
Seat 4: moratto1992 (30155 in chips) 
Seat 5: Ace-hai (25000 in chips) 
Seat 6: Dizzydarts (25311 in chips) 
Seat 7: ivan limeira (58002 in chips) 
Seat 8: diabo656 (101600 in chips) 
MKL1010: posts the ante 200
DontCryClumsy88: posts the ante 200
Eux1986: posts the ante 200
moratto1992: posts the ante 200
Ace-hai: posts the ante 200
Dizzydarts: posts the ante 200
ivan limeira: posts the ante 200
diabo656: posts the ante 200
moratto1992: posts small blind 800
Ace-hai: posts big blind 1600
*** HOLE CARDS ***
Dizzydarts: folds 
ivan limeira: folds 
diabo656: folds 
MKL1010: raises 18529 to 20129 and is all-in
DontCryClumsy88: folds 
Eux1986: raises 18529 to 38658
moratto1992: folds 
Ace-hai: calls 23200 and is all-in
Uncalled bet (13858) returned to Eux1986
*** FLOP *** [5c 9s 3d]
*** TURN *** [5c 9s 3d] [6s]
*** RIVER *** [5c 9s 3d 6s] [Js]
*** SHOW DOWN ***
Ace-hai: shows [Td Ts] (a pair of Tens)
Eux1986: shows [Kh Jh] (a pair of Jacks)
Eux1986 collected 9342 from side pot
MKL1010: shows [As 3s] (a flush, Ace high)
MKL1010 collected 62787 from main pot
Ace-hai finished the tournament
*** SUMMARY ***
Total pot 72129 Main pot 62787. Side pot 9342. | Rake 0 
Board [5c 9s 3d 6s Js]
Seat 1: MKL1010 showed [As 3s] and won (62787) with a flush, Ace high
Seat 2: DontCryClumsy88 folded before Flop (didn't bet)
Seat 3: Eux1986 (button) showed [Kh Jh] and won (9342) with a pair of Jacks
Seat 4: moratto1992 (small blind) folded before Flop
Seat 5: Ace-hai (big blind) showed [Td Ts] and lost with a pair of Tens
Seat 6: Dizzydarts folded before Flop (didn't bet)
Seat 7: ivan limeira folded before Flop (didn't bet)
Seat 8: diabo656 folded before Flop (didn't bet)

PokerStars Hand #251205952611: Tournament #3767885527, $40+$10+$5 USD Hold'em No Limit - Level XIII (800/1600) - 2024/06/26 19:28:24 UTC [2024/06/26 15:28:24 ET]
Table '3767885527 96' 8-max Seat #4 is the button
Seat 1: MKL1010 (62787 in chips) 
Seat 2: DontCryClumsy88 (57380 in chips) 
Seat 3: Eux1986 (95051 in chips) 
Seat 4: moratto1992 (29155 in chips) 
Seat 6: Dizzydarts (25111 in chips) 
Seat 7: ivan limeira (57802 in chips) 
Seat 8: diabo656 (101400 in chips) 
MKL1010: posts the ante 200
DontCryClumsy88: posts the ante 200
Eux1986: posts the ante 200
moratto1992: posts the ante 200
Dizzydarts: posts the ante 200
ivan limeira: posts the ante 200
diabo656: posts the ante 200
Dizzydarts: posts small blind 800
ivan limeira: posts big blind 1600
*** HOLE CARDS ***
diabo656: calls 1600
MKL1010: folds 
DontCryClumsy88: calls 1600
Eux1986: folds 
moratto1992: folds 
Dizzydarts: calls 800
ivan limeira: raises 56002 to 57602 and is all-in
diabo656: folds 
DontCryClumsy88: folds 
Dizzydarts: folds 
Uncalled bet (56002) returned to ivan limeira
ivan limeira collected 7800 from pot
ivan limeira: doesn't show hand 
*** SUMMARY ***
Total pot 7800 | Rake 0 
Seat 1: MKL1010 folded before Flop (didn't bet)
Seat 2: DontCryClumsy88 folded before Flop
Seat 3: Eux1986 folded before Flop (didn't bet)
Seat 4: moratto1992 (button) folded before Flop (didn't bet)
Seat 6: Dizzydarts (small blind) folded before Flop
Seat 7: ivan limeira (big blind) collected (7800)
Seat 8: diabo656 folded before Flop

PokerStars Hand #251205962072: Tournament #3767885527, $40+$10+$5 USD Hold'em No Limit - Level XIII (800/1600) - 2024/06/26 19:28:59 UTC [2024/06/26 15:28:59 ET]
Table '3767885527 96' 8-max Seat #6 is the button
Seat 1: MKL1010 (62587 in chips) 
Seat 2: DontCryClumsy88 (55580 in chips) 
Seat 3: Eux1986 (94851 in chips) 
Seat 4: moratto1992 (28955 in chips) 
Seat 6: Dizzydarts (23311 in chips) 
Seat 7: ivan limeira (63802 in chips) 
Seat 8: diabo656 (99600 in chips) 
MKL1010: posts the ante 200
DontCryClumsy88: posts the ante 200
Eux1986: posts the ante 200
moratto1992: posts the ante 200
Dizzydarts: posts the ante 200
ivan limeira: posts the ante 200
diabo656: posts the ante 200
ivan limeira: posts small blind 800
diabo656: posts big blind 1600
*** HOLE CARDS ***
MKL1010: folds 
DontCryClumsy88: calls 1600
Eux1986: folds 
moratto1992: folds 
Dizzydarts: folds 
ivan limeira: calls 800
diabo656: checks 
*** FLOP *** [Jh 3d Qd]
ivan limeira: checks 
cardinals970 is disconnected 
diabo656: checks 
DontCryClumsy88: bets 2046
ivan limeira: folds 
diabo656: folds 
Uncalled bet (2046) returned to DontCryClumsy88
DontCryClumsy88 collected 6200 from pot
*** SUMMARY ***
Total pot 6200 | Rake 0 
Board [Jh 3d Qd]
Seat 1: MKL1010 folded before Flop (didn't bet)
Seat 2: DontCryClumsy88 collected (6200)
Seat 3: Eux1986 folded before Flop (didn't bet)
Seat 4: moratto1992 folded before Flop (didn't bet)
Seat 6: Dizzydarts (button) folded before Flop (didn't bet)
Seat 7: ivan limeira (small blind) folded on the Flop
Seat 8: diabo656 (big blind) folded on the Flop

PokerStars Hand #251205977881: Tournament #3767885527, $40+$10+$5 USD Hold'em No Limit - Level XIV (1000/2000) - 2024/06/26 19:29:57 UTC [2024/06/26 15:29:57 ET]
Table '3767885527 96' 8-max Seat #7 is the button
Seat 1: MKL1010 (62387 in chips) 
Seat 2: DontCryClumsy88 (59980 in chips) 
Seat 3: Eux1986 (94651 in chips) 
Seat 4: moratto1992 (28755 in chips) 
Seat 5: cardinals970 (25000 in chips) 
Seat 6: Dizzydarts (23111 in chips) 
Seat 7: ivan limeira (62002 in chips) 
Seat 8: diabo656 (97800 in chips) 
MKL1010: posts the ante 250
DontCryClumsy88: posts the ante 250
Eux1986: posts the ante 250
moratto1992: posts the ante 250
cardinals970: posts the ante 250
Dizzydarts: posts the ante 250
ivan limeira: posts the ante 250
diabo656: posts the ante 250
diabo656: posts small blind 1000
MKL1010: posts big blind 2000
*** HOLE CARDS ***
DontCryClumsy88: folds 
Eux1986: folds 
moratto1992: folds 
cardinals970: folds 
Dizzydarts: folds 
ivan limeira: raises 2000 to 4000
diabo656: folds 
MKL1010: calls 2000
*** FLOP *** [8d Kh 7c]
MKL1010: checks 
ivan limeira: bets 2750
MKL1010: calls 2750
*** TURN *** [8d Kh 7c] [3h]
MKL1010: checks 
ivan limeira: checks 
*** RIVER *** [8d Kh 7c 3h] [8h]
MKL1010: bets 8250
ivan limeira: calls 8250
*** SHOW DOWN ***
MKL1010: shows [Kc Qh] (two pair, Kings and Eights)
ivan limeira: mucks hand 
MKL1010 collected 33000 from pot
*** SUMMARY ***
Total pot 33000 | Rake 0 
Board [8d Kh 7c 3h 8h]
Seat 1: MKL1010 (big blind) showed [Kc Qh] and won (33000) with two pair, Kings and Eights
Seat 2: DontCryClumsy88 folded before Flop (didn't bet)
Seat 3: Eux1986 folded before Flop (didn't bet)
Seat 4: moratto1992 folded before Flop (didn't bet)
Seat 5: cardinals970 folded before Flop (didn't bet)
Seat 6: Dizzydarts folded before Flop (didn't bet)
Seat 7: ivan limeira (button) mucked
Seat 8: diabo656 (small blind) folded before Flop

PokerStars Hand #251205994012: Tournament #3767885527, $40+$10+$5 USD Hold'em No Limit - Level XIV (1000/2000) - 2024/06/26 19:30:56 UTC [2024/06/26 15:30:56 ET]
Table '3767885527 96' 8-max Seat #8 is the button
Seat 1: MKL1010 (80137 in chips) 
Seat 2: DontCryClumsy88 (59730 in chips) 
Seat 3: Eux1986 (94401 in chips) 
Seat 4: moratto1992 (28505 in chips) 
Seat 5: cardinals970 (24750 in chips) 
Seat 6: Dizzydarts (22861 in chips) 
Seat 7: ivan limeira (46752 in chips) 
Seat 8: diabo656 (96550 in chips) 
MKL1010: posts the ante 250
DontCryClumsy88: posts the ante 250
Eux1986: posts the ante 250
moratto1992: posts the ante 250
cardinals970: posts the ante 250
Dizzydarts: posts the ante 250
ivan limeira: posts the ante 250
diabo656: posts the ante 250
MKL1010: posts small blind 1000
DontCryClumsy88: posts big blind 2000
*** HOLE CARDS ***
Eux1986: folds 
moratto1992: folds 
cardinals970: folds 
Dizzydarts: folds 
ivan limeira: raises 2000 to 4000
diabo656: calls 4000
MKL1010: folds 
DontCryClumsy88: calls 2000
*** FLOP *** [4d 3s Ac]
DontCryClumsy88: checks 
ivan limeira: bets 3750
diabo656: raises 3750 to 7500
DontCryClumsy88: folds 
ivan limeira: calls 3750
*** TURN *** [4d 3s Ac] [3h]
ivan limeira: checks 
diabo656: bets 84800 and is all-in
ivan limeira: folds 
Uncalled bet (84800) returned to diabo656
diabo656 collected 30000 from pot
*** SUMMARY ***
Total pot 30000 | Rake 0 
Board [4d 3s Ac 3h]
Seat 1: MKL1010 (small blind) folded before Flop
Seat 2: DontCryClumsy88 (big blind) folded on the Flop
Seat 3: Eux1986 folded before Flop (didn't bet)
Seat 4: moratto1992 folded before Flop (didn't bet)
Seat 5: cardinals970 folded before Flop (didn't bet)
Seat 6: Dizzydarts folded before Flop (didn't bet)
Seat 7: ivan limeira folded on the Turn
Seat 8: diabo656 (button) collected (30000)

PokerStars Hand #251206012118: Tournament #3767885527, $40+$10+$5 USD Hold'em No Limit - Level XIV (1000/2000) - 2024/06/26 19:32:01 UTC [2024/06/26 15:32:01 ET]
Table '3767885527 96' 8-max Seat #1 is the button
Seat 1: MKL1010 (78887 in chips) 
Seat 2: DontCryClumsy88 (55480 in chips) 
Seat 3: Eux1986 (94151 in chips) 
Seat 4: moratto1992 (28255 in chips) 
Seat 5: cardinals970 (24500 in chips) 
Seat 6: Dizzydarts (22611 in chips) 
Seat 7: ivan limeira (35002 in chips) 
Seat 8: diabo656 (114800 in chips) 
MKL1010: posts the ante 250
DontCryClumsy88: posts the ante 250
Eux1986: posts the ante 250
moratto1992: posts the ante 250
cardinals970: posts the ante 250
Dizzydarts: posts the ante 250
ivan limeira: posts the ante 250
diabo656: posts the ante 250
DontCryClumsy88: posts small blind 1000
Eux1986: posts big blind 2000
*** HOLE CARDS ***
moratto1992: folds 
cardinals970: folds 
Dizzydarts: folds 
ivan limeira: raises 2000 to 4000
diabo656: folds 
MKL1010: folds 
DontCryClumsy88: folds 
Eux1986: folds 
Uncalled bet (2000) returned to ivan limeira
ivan limeira collected 7000 from pot
ivan limeira: doesn't show hand 
*** SUMMARY ***
Total pot 7000 | Rake 0 
Seat 1: MKL1010 (button) folded before Flop (didn't bet)
Seat 2: DontCryClumsy88 (small blind) folded before Flop
Seat 3: Eux1986 (big blind) folded before Flop
Seat 4: moratto1992 folded before Flop (didn't bet)
Seat 5: cardinals970 folded before Flop (didn't bet)
Seat 6: Dizzydarts folded before Flop (didn't bet)
Seat 7: ivan limeira collected (7000)
Seat 8: diabo656 folded before Flop (didn't bet)

PokerStars Hand #251206023652: Tournament #3767885527, $40+$10+$5 USD Hold'em No Limit - Level XIV (1000/2000) - 2024/06/26 19:32:43 UTC [2024/06/26 15:32:43 ET]
Table '3767885527 96' 8-max Seat #2 is the button
Seat 1: MKL1010 (78637 in chips) 
Seat 2: DontCryClumsy88 (54230 in chips) 
Seat 3: Eux1986 (91901 in chips) 
Seat 4: moratto1992 (28005 in chips) 
Seat 5: cardinals970 (24250 in chips) 
Seat 6: Dizzydarts (22361 in chips) 
Seat 7: ivan limeira (39752 in chips) 
Seat 8: diabo656 (114550 in chips) 
MKL1010: posts the ante 250
DontCryClumsy88: posts the ante 250
Eux1986: posts the ante 250
moratto1992: posts the ante 250
cardinals970: posts the ante 250
Dizzydarts: posts the ante 250
ivan limeira: posts the ante 250
diabo656: posts the ante 250
Eux1986: posts small blind 1000
moratto1992: posts big blind 2000
*** HOLE CARDS ***
cardinals970: folds 
Dizzydarts: folds 
ivan limeira: raises 2000 to 4000
diabo656: folds 
MKL1010: folds 
DontCryClumsy88: folds 
Eux1986: calls 3000
moratto1992: folds 
*** FLOP *** [7s 4d Qd]
Eux1986: checks 
ivan limeira: bets 3000
Eux1986: calls 3000
*** TURN *** [7s 4d Qd] [3h]
Eux1986: checks 
ivan limeira: bets 9000
Eux1986: folds 
Uncalled bet (9000) returned to ivan limeira
ivan limeira collected 18000 from pot
ivan limeira: doesn't show hand 
*** SUMMARY ***
Total pot 18000 | Rake 0 
Board [7s 4d Qd 3h]
Seat 1: MKL1010 folded before Flop (didn't bet)
Seat 2: DontCryClumsy88 (button) folded before Flop (didn't bet)
Seat 3: Eux1986 (small blind) folded on the Turn
Seat 4: moratto1992 (big blind) folded before Flop
Seat 5: cardinals970 folded before Flop (didn't bet)
Seat 6: Dizzydarts folded before Flop (didn't bet)
Seat 7: ivan limeira collected (18000)
Seat 8: diabo656 folded before Flop (didn't bet)

PokerStars Hand #251206039056: Tournament #3767885527, $40+$10+$5 USD Hold'em No Limit - Level XIV (1000/2000) - 2024/06/26 19:33:40 UTC [2024/06/26 15:33:40 ET]
Table '3767885527 96' 8-max Seat #3 is the button
Seat 1: MKL1010 (78387 in chips) 
Seat 2: DontCryClumsy88 (53980 in chips) 
Seat 3: Eux1986 (84651 in chips) 
Seat 4: moratto1992 (25755 in chips) 
Seat 5: cardinals970 (24000 in chips) 
Seat 6: Dizzydarts (22111 in chips) 
Seat 7: ivan limeira (50502 in chips) 
Seat 8: diabo656 (114300 in chips) 
MKL1010: posts the ante 250
DontCryClumsy88: posts the ante 250
Eux1986: posts the ante 250
moratto1992: posts the ante 250
cardinals970: posts the ante 250
Dizzydarts: posts the ante 250
ivan limeira: posts the ante 250
diabo656: posts the ante 250
moratto1992: posts small blind 1000
cardinals970: posts big blind 2000
*** HOLE CARDS ***
Dizzydarts: folds 
ivan limeira: raises 2000 to 4000
diabo656: calls 4000
MKL1010: folds 
DontCryClumsy88: calls 4000
Eux1986: raises 6000 to 10000
moratto1992: folds 
cardinals970: folds 
ivan limeira: folds 
diabo656: calls 6000
DontCryClumsy88: calls 6000
*** FLOP *** [8s 7c Ks]
diabo656: checks 
DontCryClumsy88: checks 
Eux1986: bets 26000
diabo656: folds 
DontCryClumsy88: raises 17730 to 43730 and is all-in
Eux1986: calls 17730
*** TURN *** [8s 7c Ks] [6d]
*** RIVER *** [8s 7c Ks 6d] [3c]
*** SHOW DOWN ***
DontCryClumsy88: shows [7d 7s] (three of a kind, Sevens)
Eux1986: shows [As Ad] (a pair of Aces)
DontCryClumsy88 collected 126460 from pot
*** SUMMARY ***
Total pot 126460 | Rake 0 
Board [8s 7c Ks 6d 3c]
Seat 1: MKL1010 folded before Flop (didn't bet)
Seat 2: DontCryClumsy88 showed [7d 7s] and won (126460) with three of a kind, Sevens
Seat 3: Eux1986 (button) showed [As Ad] and lost with a pair of Aces
Seat 4: moratto1992 (small blind) folded before Flop
Seat 5: cardinals970 (big blind) folded before Flop
Seat 6: Dizzydarts folded before Flop (didn't bet)
Seat 7: ivan limeira folded before Flop
Seat 8: diabo656 folded on the Flop

PokerStars Hand #251206056776: Tournament #3767885527, $40+$10+$5 USD Hold'em No Limit - Level XIV (1000/2000) - 2024/06/26 19:34:45 UTC [2024/06/26 15:34:45 ET]
Table '3767885527 96' 8-max Seat #4 is the button
Seat 1: MKL1010 (78137 in chips) 
Seat 2: DontCryClumsy88 (126460 in chips) 
Seat 3: Eux1986 (30671 in chips) 
Seat 4: moratto1992 (24505 in chips) 
Seat 5: cardinals970 (21750 in chips) 
Seat 6: Dizzydarts (21861 in chips) 
Seat 7: ivan limeira (46252 in chips) 
Seat 8: diabo656 (104050 in chips) 
MKL1010: posts the ante 250
DontCryClumsy88: posts the ante 250
Eux1986: posts the ante 250
moratto1992: posts the ante 250
cardinals970: posts the ante 250
Dizzydarts: posts the ante 250
ivan limeira: posts the ante 250
diabo656: posts the ante 250
cardinals970: posts small blind 1000
Dizzydarts: posts big blind 2000
*** HOLE CARDS ***
ivan limeira: folds 
diabo656: folds 
MKL1010: folds 
DontCryClumsy88: raises 2000 to 4000
Eux1986: folds 
moratto1992: raises 20255 to 24255 and is all-in
cardinals970: folds 
Dizzydarts: folds 
DontCryClumsy88: calls 20255
*** FLOP *** [Js 4h Kc]
*** TURN *** [Js 4h Kc] [7s]
*** RIVER *** [Js 4h Kc 7s] [Jc]
*** SHOW DOWN ***
DontCryClumsy88: shows [Ks Ac] (two pair, Kings and Jacks)
moratto1992: shows [8h Kh] (two pair, Kings and Jacks - lower kicker)
DontCryClumsy88 collected 53510 from pot
moratto1992 finished the tournament
*** SUMMARY ***
Total pot 53510 | Rake 0 
Board [Js 4h Kc 7s Jc]
Seat 1: MKL1010 folded before Flop (didn't bet)
Seat 2: DontCryClumsy88 showed [Ks Ac] and won (53510) with two pair, Kings and Jacks
Seat 3: Eux1986 folded before Flop (didn't bet)
Seat 4: moratto1992 (button) showed [8h Kh] and lost with two pair, Kings and Jacks
Seat 5: cardinals970 (small blind) folded before Flop
Seat 6: Dizzydarts (big blind) folded before Flop
Seat 7: ivan limeira folded before Flop (didn't bet)
Seat 8: diabo656 folded before Flop (didn't bet)

PokerStars Hand #251206064993: Tournament #3767885527, $40+$10+$5 USD Hold'em No Limit - Level XIV (1000/2000) - 2024/06/26 19:35:15 UTC [2024/06/26 15:35:15 ET]
Table '3767885527 96' 8-max Seat #5 is the button
Seat 1: MKL1010 (77887 in chips) 
Seat 2: DontCryClumsy88 (155465 in chips) 
Seat 3: Eux1986 (30421 in chips) 
Seat 5: cardinals970 (20500 in chips) 
Seat 6: Dizzydarts (19611 in chips) 
Seat 7: ivan limeira (46002 in chips) 
Seat 8: diabo656 (103800 in chips) 
MKL1010: posts the ante 250
DontCryClumsy88: posts the ante 250
Eux1986: posts the ante 250
cardinals970: posts the ante 250
Dizzydarts: posts the ante 250
ivan limeira: posts the ante 250
diabo656: posts the ante 250
Dizzydarts: posts small blind 1000
ivan limeira: posts big blind 2000
*** HOLE CARDS ***
diabo656: folds 
MKL1010: folds 
DontCryClumsy88: folds 
Eux1986: folds 
cardinals970: raises 18250 to 20250 and is all-in
Dizzydarts: calls 18361 and is all-in
ivan limeira: folds 
Uncalled bet (889) returned to cardinals970
*** FLOP *** [5c 2s 5d]
*** TURN *** [5c 2s 5d] [4c]
*** RIVER *** [5c 2s 5d 4c] [4h]
*** SHOW DOWN ***
Dizzydarts: shows [6d 6s] (two pair, Sixes and Fives)
cardinals970: shows [Kc Kh] (two pair, Kings and Fives)
cardinals970 collected 42472 from pot
Dizzydarts finished the tournament
*** SUMMARY ***
Total pot 42472 | Rake 0 
Board [5c 2s 5d 4c 4h]
Seat 1: MKL1010 folded before Flop (didn't bet)
Seat 2: DontCryClumsy88 folded before Flop (didn't bet)
Seat 3: Eux1986 folded before Flop (didn't bet)
Seat 5: cardinals970 (button) showed [Kc Kh] and won (42472) with two pair, Kings and Fives
Seat 6: Dizzydarts (small blind) showed [6d 6s] and lost with two pair, Sixes and Fives
Seat 7: ivan limeira (big blind) folded before Flop
Seat 8: diabo656 folded before Flop (didn't bet)

PokerStars Hand #251206077467: Tournament #3767885527, $40+$10+$5 USD Hold'em No Limit - Level XIV (1000/2000) - 2024/06/26 19:36:00 UTC [2024/06/26 15:36:00 ET]
Table '3767885527 96' 8-max Seat #7 is the button
Seat 1: MKL1010 (77637 in chips) 
Seat 2: DontCryClumsy88 (155215 in chips) 
Seat 3: Eux1986 (30171 in chips) 
Seat 4: Bigprad (89372 in chips) 
Seat 5: cardinals970 (43361 in chips) 
Seat 7: ivan limeira (43752 in chips) 
Seat 8: diabo656 (103550 in chips) 
MKL1010: posts the ante 250
DontCryClumsy88: posts the ante 250
Eux1986: posts the ante 250
Bigprad: posts the ante 250
cardinals970: posts the ante 250
ivan limeira: posts the ante 250
diabo656: posts the ante 250
diabo656: posts small blind 1000
MKL1010: posts big blind 2000
*** HOLE CARDS ***
DontCryClumsy88: raises 2000 to 4000
Eux1986: folds 
Bigprad: folds 
cardinals970: folds 
ivan limeira: raises 6000 to 10000
diabo656: calls 9000
MKL1010: folds 
DontCryClumsy88: folds 
*** FLOP *** [9s 6s 5d]
diabo656: checks 
ivan limeira: bets 9158
diabo656: calls 9158
*** TURN *** [9s 6s 5d] [6c]
Dueces4Days is disconnected 
diabo656: checks 
ivan limeira: checks 
*** RIVER *** [9s 6s 5d 6c] [Ad]
diabo656: checks 
ivan limeira: checks 
*** SHOW DOWN ***
diabo656: shows [Qd As] (two pair, Aces and Sixes)
ivan limeira: mucks hand 
diabo656 collected 46066 from pot
*** SUMMARY ***
Total pot 46066 | Rake 0 
Board [9s 6s 5d 6c Ad]
Seat 1: MKL1010 (big blind) folded before Flop
Seat 2: DontCryClumsy88 folded before Flop
Seat 3: Eux1986 folded before Flop (didn't bet)
Seat 4: Bigprad folded before Flop (didn't bet)
Seat 5: cardinals970 folded before Flop (didn't bet)
Seat 7: ivan limeira (button) mucked
Seat 8: diabo656 (small blind) showed [Qd As] and won (46066) with two pair, Aces and Sixes

PokerStars Hand #251206096899: Tournament #3767885527, $40+$10+$5 USD Hold'em No Limit - Level XIV (1000/2000) - 2024/06/26 19:37:11 UTC [2024/06/26 15:37:11 ET]
Table '3767885527 96' 8-max Seat #8 is the button
Seat 1: MKL1010 (75387 in chips) 
Seat 2: DontCryClumsy88 (150965 in chips) 
Seat 3: Eux1986 (29921 in chips) 
Seat 4: Bigprad (89122 in chips) 
Seat 5: cardinals970 (43111 in chips) 
Seat 6: Dueces4Days (141708 in chips) 
Seat 7: ivan limeira (24344 in chips) 
Seat 8: diabo656 (130208 in chips) 
MKL1010: posts the ante 250
DontCryClumsy88: posts the ante 250
Eux1986: posts the ante 250
Bigprad: posts the ante 250
cardinals970: posts the ante 250
Dueces4Days: posts the ante 250
ivan limeira: posts the ante 250
diabo656: posts the ante 250
MKL1010: posts small blind 1000
DontCryClumsy88: posts big blind 2000
*** HOLE CARDS ***
Eux1986: folds 
Bigprad: folds 
cardinals970: folds 
Dueces4Days: folds 
ivan limeira: folds 
diabo656: raises 7000 to 9000
MKL1010: folds 
DontCryClumsy88: folds 
Uncalled bet (7000) returned to diabo656
diabo656 collected 7000 from pot
*** SUMMARY ***
Total pot 7000 | Rake 0 
Seat 1: MKL1010 (small blind) folded before Flop
Seat 2: DontCryClumsy88 (big blind) folded before Flop
Seat 3: Eux1986 folded before Flop (didn't bet)
Seat 4: Bigprad folded before Flop (didn't bet)
Seat 5: cardinals970 folded before Flop (didn't bet)
Seat 6: Dueces4Days folded before Flop (didn't bet)
Seat 7: ivan limeira folded before Flop (didn't bet)
Seat 8: diabo656 (button) collected (7000)

PokerStars Hand #251206104233: Tournament #3767885527, $40+$10+$5 USD Hold'em No Limit - Level XIV (1000/2000) - 2024/06/26 19:37:37 UTC [2024/06/26 15:37:37 ET]
Table '3767885527 96' 8-max Seat #1 is the button
Seat 1: MKL1010 (74137 in chips) 
Seat 2: DontCryClumsy88 (148715 in chips) 
Seat 3: Eux1986 (29671 in chips) 
Seat 4: Bigprad (88872 in chips) 
Seat 5: cardinals970 (42861 in chips) 
Seat 6: Dueces4Days (141458 in chips) 
Seat 7: ivan limeira (24094 in chips) 
Seat 8: diabo656 (134958 in chips) 
MKL1010: posts the ante 250
DontCryClumsy88: posts the ante 250
Eux1986: posts the ante 250
Bigprad: posts the ante 250
cardinals970: posts the ante 250
Dueces4Days: posts the ante 250
ivan limeira: posts the ante 250
diabo656: posts the ante 250
DontCryClumsy88: posts small blind 1000
Eux1986: posts big blind 2000
*** HOLE CARDS ***
Bigprad: folds 
cardinals970: folds 
Dueces4Days: raises 2000 to 4000
ivan limeira: folds 
diabo656: folds 
MKL1010: folds 
DontCryClumsy88: folds 
Eux1986: calls 2000
*** FLOP *** [5d Ad 7c]
Eux1986: checks 
Dueces4Days: bets 2750
Eux1986: folds 
Uncalled bet (2750) returned to Dueces4Days
Dueces4Days collected 11000 from pot
Dueces4Days: doesn't show hand 
*** SUMMARY ***
Total pot 11000 | Rake 0 
Board [5d Ad 7c]
Seat 1: MKL1010 (button) folded before Flop (didn't bet)
Seat 2: DontCryClumsy88 (small blind) folded before Flop
Seat 3: Eux1986 (big blind) folded on the Flop
Seat 4: Bigprad folded before Flop (didn't bet)
Seat 5: cardinals970 folded before Flop (didn't bet)
Seat 6: Dueces4Days collected (11000)
Seat 7: ivan limeira folded before Flop (didn't bet)
Seat 8: diabo656 folded before Flop (didn't bet)

PokerStars Hand #251206112187: Tournament #3767885527, $40+$10+$5 USD Hold'em No Limit - Level XIV (1000/2000) - 2024/06/26 19:38:07 UTC [2024/06/26 15:38:07 ET]
Table '3767885527 96' 8-max Seat #2 is the button
Seat 1: MKL1010 (73887 in chips) 
Seat 2: DontCryClumsy88 (147465 in chips) 
Seat 3: Eux1986 (25421 in chips) 
Seat 4: Bigprad (88622 in chips) 
Seat 5: cardinals970 (42611 in chips) 
Seat 6: Dueces4Days (148208 in chips) 
Seat 7: ivan limeira (23844 in chips) 
Seat 8: diabo656 (134708 in chips) 
MKL1010: posts the ante 250
DontCryClumsy88: posts the ante 250
Eux1986: posts the ante 250
Bigprad: posts the ante 250
cardinals970: posts the ante 250
Dueces4Days: posts the ante 250
ivan limeira: posts the ante 250
diabo656: posts the ante 250
Eux1986: posts small blind 1000
Bigprad: posts big blind 2000
*** HOLE CARDS ***
cardinals970: folds 
Dueces4Days: raises 2000 to 4000
ivan limeira: folds 
diabo656: folds 
MKL1010: folds 
DontCryClumsy88: folds 
Eux1986: folds 
Bigprad: folds 
Uncalled bet (2000) returned to Dueces4Days
Dueces4Days collected 7000 from pot
Dueces4Days: doesn't show hand 
*** SUMMARY ***
Total pot 7000 | Rake 0 
Seat 1: MKL1010 folded before Flop (didn't bet)
Seat 2: DontCryClumsy88 (button) folded before Flop (didn't bet)
Seat 3: Eux1986 (small blind) folded before Flop
Seat 4: Bigprad (big blind) folded before Flop
Seat 5: cardinals970 folded before Flop (didn't bet)
Seat 6: Dueces4Days collected (7000)
Seat 7: ivan limeira folded before Flop (didn't bet)
Seat 8: diabo656 folded before Flop (didn't bet)

PokerStars Hand #251206118379: Tournament #3767885527, $40+$10+$5 USD Hold'em No Limit - Level XIV (1000/2000) - 2024/06/26 19:38:30 UTC [2024/06/26 15:38:30 ET]
Table '3767885527 96' 8-max Seat #3 is the button
Seat 1: MKL1010 (73637 in chips) 
Seat 2: DontCryClumsy88 (147215 in chips) 
Seat 3: Eux1986 (24171 in chips) 
Seat 4: Bigprad (86372 in chips) 
Seat 5: cardinals970 (42361 in chips) 
Seat 6: Dueces4Days (152958 in chips) 
Seat 7: ivan limeira (23594 in chips) 
Seat 8: diabo656 (134458 in chips) 
MKL1010: posts the ante 250
DontCryClumsy88: posts the ante 250
Eux1986: posts the ante 250
Bigprad: posts the ante 250
cardinals970: posts the ante 250
Dueces4Days: posts the ante 250
ivan limeira: posts the ante 250
diabo656: posts the ante 250
Bigprad: posts small blind 1000
cardinals970: posts big blind 2000
*** HOLE CARDS ***
Dueces4Days: raises 2000 to 4000
ivan limeira: folds 
diabo656: folds 
MKL1010: calls 4000
DontCryClumsy88: calls 4000
Eux1986: folds 
Bigprad: calls 3000
cardinals970: folds 
*** FLOP *** [Th 9s 4h]
Bigprad: checks 
Dueces4Days: checks 
MKL1010: bets 6000
DontCryClumsy88: folds 
Bigprad: calls 6000
Dueces4Days: calls 6000
*** TURN *** [Th 9s 4h] [Jd]
Bigprad: checks 
Dueces4Days: checks 
MKL1010: bets 19000
Bigprad: calls 19000
Dueces4Days: raises 123708 to 142708 and is all-in
MKL1010: calls 44387 and is all-in
Bigprad: folds 
Uncalled bet (79321) returned to Dueces4Days
*** RIVER *** [Th 9s 4h Jd] [6d]
*** SHOW DOWN ***
Dueces4Days: shows [Kc Qs] (a straight, Nine to King)
MKL1010: shows [Td Tc] (three of a kind, Tens)
Dueces4Days collected 183774 from pot
MKL1010 finished the tournament in 610th place
*** SUMMARY ***
Total pot 183774 | Rake 0 
Board [Th 9s 4h Jd 6d]
Seat 1: MKL1010 showed [Td Tc] and lost with three of a kind, Tens
Seat 2: DontCryClumsy88 folded on the Flop
Seat 3: Eux1986 (button) folded before Flop (didn't bet)
Seat 4: Bigprad (small blind) folded on the Turn
Seat 5: cardinals970 (big blind) folded before Flop
Seat 6: Dueces4Days showed [Kc Qs] and won (183774) with a straight, Nine to King
Seat 7: ivan limeira folded before Flop (didn't bet)
Seat 8: diabo656 folded before Flop (didn't bet)

PokerStars Hand #251206139227: Tournament #3767885527, $40+$10+$5 USD Hold'em No Limit - Level XV (1250/2500) - 2024/06/26 19:39:46 UTC [2024/06/26 15:39:46 ET]
Table '3767885527 96' 8-max Seat #4 is the button
Seat 2: DontCryClumsy88 (142965 in chips) 
Seat 3: Eux1986 (23921 in chips) 
Seat 4: Bigprad (57122 in chips) 
Seat 5: cardinals970 (40111 in chips) 
Seat 6: Dueces4Days (263095 in chips) 
Seat 7: ivan limeira (23344 in chips) 
Seat 8: diabo656 (134208 in chips) 
DontCryClumsy88: posts the ante 325
Eux1986: posts the ante 325
Bigprad: posts the ante 325
cardinals970: posts the ante 325
Dueces4Days: posts the ante 325
ivan limeira: posts the ante 325
diabo656: posts the ante 325
cardinals970: posts small blind 1250
Dueces4Days: posts big blind 2500
*** HOLE CARDS ***
ivan limeira: raises 2500 to 5000
diabo656: calls 5000
DontCryClumsy88: folds 
Eux1986: folds 
Bigprad: folds 
cardinals970: folds 
Dueces4Days: calls 2500
*** FLOP *** [9s Js 2h]
Dueces4Days: checks 
ivan limeira: checks 
diabo656: bets 18525
Dueces4Days: raises 31025 to 49550
ivan limeira: folds 
diabo656: calls 31025
*** TURN *** [9s Js 2h] [Qd]
Dueces4Days: bets 176438
diabo656: calls 79333 and is all-in
Uncalled bet (97105) returned to Dueces4Days
*** RIVER *** [9s Js 2h Qd] [4d]
*** SHOW DOWN ***
Dueces4Days: shows [Ts 7s] (high card Queen)
diabo656: shows [Jc Qc] (two pair, Queens and Jacks)
diabo656 collected 276291 from pot
*** SUMMARY ***
Total pot 276291 | Rake 0 
Board [9s Js 2h Qd 4d]
Seat 2: DontCryClumsy88 folded before Flop (didn't bet)
Seat 3: Eux1986 folded before Flop (didn't bet)
Seat 4: Bigprad (button) folded before Flop (didn't bet)
Seat 5: cardinals970 (small blind) folded before Flop
Seat 6: Dueces4Days (big blind) showed [Ts 7s] and lost with high card Queen
Seat 7: ivan limeira folded on the Flop
Seat 8: diabo656 showed [Jc Qc] and won (276291) with two pair, Queens and Jacks

PokerStars Hand #251206164105: Tournament #3767885527, $40+$10+$5 USD Hold'em No Limit - Level XV (1250/2500) - 2024/06/26 19:41:16 UTC [2024/06/26 15:41:16 ET]
Table '3767885527 96' 8-max Seat #5 is the button
Seat 1: Scairone (30771 in chips) 
Seat 2: DontCryClumsy88 (142640 in chips) 
Seat 3: Eux1986 (23596 in chips) 
Seat 4: Bigprad (56797 in chips) 
Seat 5: cardinals970 (38536 in chips) 
Seat 6: Dueces4Days (128887 in chips) 
Seat 7: ivan limeira (18019 in chips) 
Seat 8: diabo656 (276291 in chips) 
Scairone: posts the ante 325
DontCryClumsy88: posts the ante 325
Eux1986: posts the ante 325
Bigprad: posts the ante 325
cardinals970: posts the ante 325
Dueces4Days: posts the ante 325
ivan limeira: posts the ante 325
diabo656: posts the ante 325
Dueces4Days: posts small blind 1250
ivan limeira: posts big blind 2500
*** HOLE CARDS ***
diabo656: folds 
Scairone: folds 
DontCryClumsy88: folds 
Eux1986: folds 
Bigprad: folds 
cardinals970: folds 
Dueces4Days: raises 126062 to 128562 and is all-in
ivan limeira: calls 15194 and is all-in
Uncalled bet (110868) returned to Dueces4Days
*** FLOP *** [7c 8c 4d]
*** TURN *** [7c 8c 4d] [7s]
*** RIVER *** [7c 8c 4d 7s] [7h]
*** SHOW DOWN ***
Dueces4Days: shows [8h 5d] (a full house, Sevens full of Eights)
ivan limeira: shows [As Tc] (three of a kind, Sevens)
Dueces4Days collected 37988 from pot
ivan limeira finished the tournament in 577th place
*** SUMMARY ***
Total pot 37988 | Rake 0 
Board [7c 8c 4d 7s 7h]
Seat 1: Scairone folded before Flop (didn't bet)
Seat 2: DontCryClumsy88 folded before Flop (didn't bet)
Seat 3: Eux1986 folded before Flop (didn't bet)
Seat 4: Bigprad folded before Flop (didn't bet)
Seat 5: cardinals970 (button) folded before Flop (didn't bet)
Seat 6: Dueces4Days (small blind) showed [8h 5d] and won (37988) with a full house, Sevens full of Eights
Seat 7: ivan limeira (big blind) showed [As Tc] and lost with three of a kind, Sevens
Seat 8: diabo656 folded before Flop (didn't bet)


PokerStars Hand #251205799339: Tournament #3767885527, $40+$10+$5 USD Hold'em No Limit - Level XII (700/1400) - 2024/06/26 19:19:02 UTC [2024/06/26 15:19:02 ET]
Table '3767885527 94' 8-max Seat #5 is the button
Seat 1: pazipro (66633 in chips) 
Seat 2: 010101777 (43448 in chips) 
Seat 3: Parrafelipe (15667 in chips) 
Seat 4: PIUlimeira (52085 in chips) 
Seat 5: Ale7anderr77 (71117 in chips) 
Seat 6: Hookz (24007 in chips) 
Seat 7: esdeathonlol (26575 in chips) 
Seat 8: Thrumbo (76020 in chips) 
pazipro: posts the ante 175
010101777: posts the ante 175
Parrafelipe: posts the ante 175
PIUlimeira: posts the ante 175
Ale7anderr77: posts the ante 175
Hookz: posts the ante 175
esdeathonlol: posts the ante 175
Thrumbo: posts the ante 175
Hookz: posts small blind 700
esdeathonlol: posts big blind 1400
*** HOLE CARDS ***
Thrumbo: raises 1540 to 2940
pazipro: folds 
010101777: calls 2940
Parrafelipe: folds 
PIUlimeira: folds 
Ale7anderr77: raises 7840 to 10780
Hookz: folds 
esdeathonlol: folds 
Thrumbo: folds 
010101777: raises 32493 to 43273 and is all-in
Ale7anderr77: calls 32493
*** FLOP *** [6c Ts Tc]
*** TURN *** [6c Ts Tc] [Qs]
*** RIVER *** [6c Ts Tc Qs] [Jc]
*** SHOW DOWN ***
010101777: shows [9h 9s] (two pair, Tens and Nines)
Ale7anderr77: shows [Qd Kh] (two pair, Queens and Tens)
Ale7anderr77 collected 92986 from pot
010101777 finished the tournament
*** SUMMARY ***
Total pot 92986 | Rake 0 
Board [6c Ts Tc Qs Jc]
Seat 1: pazipro folded before Flop (didn't bet)
Seat 2: 010101777 showed [9h 9s] and lost with two pair, Tens and Nines
Seat 3: Parrafelipe folded before Flop (didn't bet)
Seat 4: PIUlimeira folded before Flop (didn't bet)
Seat 5: Ale7anderr77 (button) showed [Qd Kh] and won (92986) with two pair, Queens and Tens
Seat 6: Hookz (small blind) folded before Flop
Seat 7: esdeathonlol (big blind) folded before Flop
Seat 8: Thrumbo folded before Flop

PokerStars Hand #251205823612: Tournament #3767885527, $40+$10+$5 USD Hold'em No Limit - Level XIII (800/1600) - 2024/06/26 19:20:30 UTC [2024/06/26 15:20:30 ET]
Table '3767885527 94' 8-max Seat #6 is the button
Seat 1: pazipro (66458 in chips) 
Seat 3: Parrafelipe (15492 in chips) 
Seat 4: PIUlimeira (51910 in chips) 
Seat 5: Ale7anderr77 (120655 in chips) 
Seat 6: Hookz (23132 in chips) 
Seat 7: esdeathonlol (25000 in chips) 
Seat 8: Thrumbo (72905 in chips) 
pazipro: posts the ante 200
Parrafelipe: posts the ante 200
PIUlimeira: posts the ante 200
Ale7anderr77: posts the ante 200
Hookz: posts the ante 200
esdeathonlol: posts the ante 200
Thrumbo: posts the ante 200
esdeathonlol: posts small blind 800
Thrumbo: posts big blind 1600
*** HOLE CARDS ***
pazipro: folds 
Parrafelipe: folds 
PIUlimeira: folds 
Ale7anderr77: raises 1600 to 3200
Hookz: folds 
esdeathonlol: folds 
saupra506 is disconnected 
Thrumbo: calls 1600
*** FLOP *** [Ts Tc 4s]
Thrumbo: checks 
Ale7anderr77: bets 2924
Thrumbo: raises 4334 to 7258
Ale7anderr77: calls 4334
*** TURN *** [Ts Tc 4s] [Kh]
Thrumbo: bets 10402
Ale7anderr77: calls 10402
*** RIVER *** [Ts Tc 4s Kh] [7s]
Thrumbo: bets 13176
Ale7anderr77: raises 22292 to 35468
Thrumbo: raises 16377 to 51845 and is all-in
Ale7anderr77: calls 16377
*** SHOW DOWN ***
Thrumbo: shows [Kd Td] (a full house, Tens full of Kings)
Ale7anderr77: shows [Ks 5s] (a flush, King high)
Thrumbo collected 147610 from pot
*** SUMMARY ***
Total pot 147610 | Rake 0 
Board [Ts Tc 4s Kh 7s]
Seat 1: pazipro folded before Flop (didn't bet)
Seat 3: Parrafelipe folded before Flop (didn't bet)
Seat 4: PIUlimeira folded before Flop (didn't bet)
Seat 5: Ale7anderr77 showed [Ks 5s] and lost with a flush, King high
Seat 6: Hookz (button) folded before Flop (didn't bet)
Seat 7: esdeathonlol (small blind) folded before Flop
Seat 8: Thrumbo (big blind) showed [Kd Td] and won (147610) with a full house, Tens full of Kings

PokerStars Hand #251205857723: Tournament #3767885527, $40+$10+$5 USD Hold'em No Limit - Level XIII (800/1600) - 2024/06/26 19:22:36 UTC [2024/06/26 15:22:36 ET]
Table '3767885527 94' 8-max Seat #7 is the button
Seat 1: pazipro (66258 in chips) 
Seat 2: saupra506 (25000 in chips) 
Seat 3: Parrafelipe (15292 in chips) 
Seat 4: PIUlimeira (51710 in chips) 
Seat 5: Ale7anderr77 (47750 in chips) 
Seat 6: Hookz (22932 in chips) 
Seat 7: esdeathonlol (24000 in chips) 
Seat 8: Thrumbo (147610 in chips) 
pazipro: posts the ante 200
saupra506: posts the ante 200
Parrafelipe: posts the ante 200
PIUlimeira: posts the ante 200
Ale7anderr77: posts the ante 200
Hookz: posts the ante 200
esdeathonlol: posts the ante 200
Thrumbo: posts the ante 200
Thrumbo: posts small blind 800
pazipro: posts big blind 1600
*** HOLE CARDS ***
saupra506: folds 
Parrafelipe: folds 
PIUlimeira: raises 1600 to 3200
Ale7anderr77: calls 3200
Hookz: folds 
esdeathonlol: folds 
Thrumbo: folds 
pazipro: folds 
*** FLOP *** [8c 7d Th]
PIUlimeira: checks 
Ale7anderr77: checks 
*** TURN *** [8c 7d Th] [5d]
PIUlimeira: bets 5920
Ale7anderr77: calls 5920
*** RIVER *** [8c 7d Th 5d] [Jc]
PIUlimeira: checks 
Ale7anderr77: bets 17125
PIUlimeira: folds 
Uncalled bet (17125) returned to Ale7anderr77
Ale7anderr77 collected 22240 from pot
*** SUMMARY ***
Total pot 22240 | Rake 0 
Board [8c 7d Th 5d Jc]
Seat 1: pazipro (big blind) folded before Flop
Seat 2: saupra506 folded before Flop (didn't bet)
Seat 3: Parrafelipe folded before Flop (didn't bet)
Seat 4: PIUlimeira folded on the River
Seat 5: Ale7anderr77 collected (22240)
Seat 6: Hookz folded before Flop (didn't bet)
Seat 7: esdeathonlol (button) folded before Flop (didn't bet)
Seat 8: Thrumbo (small blind) folded before Flop

PokerStars Hand #251205890730: Tournament #3767885527, $40+$10+$5 USD Hold'em No Limit - Level XIII (800/1600) - 2024/06/26 19:24:36 UTC [2024/06/26 15:24:36 ET]
Table '3767885527 94' 8-max Seat #8 is the button
Seat 1: pazipro (64458 in chips) 
Seat 2: saupra506 (24800 in chips) 
Seat 3: Parrafelipe (15092 in chips) 
Seat 4: PIUlimeira (42390 in chips) 
Seat 5: Ale7anderr77 (60670 in chips) 
Seat 6: Hookz (22732 in chips) 
Seat 7: esdeathonlol (23800 in chips) 
Seat 8: Thrumbo (146610 in chips) 
pazipro: posts the ante 200
saupra506: posts the ante 200
Parrafelipe: posts the ante 200
PIUlimeira: posts the ante 200
Ale7anderr77: posts the ante 200
Hookz: posts the ante 200
esdeathonlol: posts the ante 200
Thrumbo: posts the ante 200
pazipro: posts small blind 800
saupra506: posts big blind 1600
*** HOLE CARDS ***
Parrafelipe: folds 
PIUlimeira: folds 
Ale7anderr77: folds 
Hookz: folds 
esdeathonlol: raises 1600 to 3200
Thrumbo: folds 
pazipro: folds 
saupra506: calls 1600
*** FLOP *** [Js 2c 6s]
saupra506: checks 
esdeathonlol: bets 6400
saupra506: folds [Td]
Uncalled bet (6400) returned to esdeathonlol
esdeathonlol collected 8800 from pot
*** SUMMARY ***
Total pot 8800 | Rake 0 
Board [Js 2c 6s]
Seat 1: pazipro (small blind) folded before Flop
Seat 2: saupra506 (big blind) folded on the Flop
Seat 3: Parrafelipe folded before Flop (didn't bet)
Seat 4: PIUlimeira folded before Flop (didn't bet)
Seat 5: Ale7anderr77 folded before Flop (didn't bet)
Seat 6: Hookz folded before Flop (didn't bet)
Seat 7: esdeathonlol collected (8800)
Seat 8: Thrumbo (button) folded before Flop (didn't bet)

PokerStars Hand #251205906340: Tournament #3767885527, $40+$10+$5 USD Hold'em No Limit - Level XIII (800/1600) - 2024/06/26 19:25:33 UTC [2024/06/26 15:25:33 ET]
Table '3767885527 94' 8-max Seat #1 is the button
Seat 1: pazipro (63458 in chips) 
Seat 2: saupra506 (21400 in chips) 
Seat 3: Parrafelipe (14892 in chips) 
Seat 4: PIUlimeira (42190 in chips) 
Seat 5: Ale7anderr77 (60470 in chips) 
Seat 6: Hookz (22532 in chips) 
Seat 7: esdeathonlol (29200 in chips) 
Seat 8: Thrumbo (146410 in chips) 
pazipro: posts the ante 200
saupra506: posts the ante 200
Parrafelipe: posts the ante 200
PIUlimeira: posts the ante 200
Ale7anderr77: posts the ante 200
Hookz: posts the ante 200
esdeathonlol: posts the ante 200
Thrumbo: posts the ante 200
saupra506: posts small blind 800
Parrafelipe: posts big blind 1600
*** HOLE CARDS ***
PIUlimeira: raises 1600 to 3200
Ale7anderr77: folds 
Hookz: folds 
esdeathonlol: folds 
Thrumbo: folds 
pazipro: raises 4800 to 8000
saupra506: folds 
Parrafelipe: folds 
PIUlimeira: folds 
Uncalled bet (4800) returned to pazipro
pazipro collected 10400 from pot
pazipro: doesn't show hand 
*** SUMMARY ***
Total pot 10400 | Rake 0 
Seat 1: pazipro (button) collected (10400)
Seat 2: saupra506 (small blind) folded before Flop
Seat 3: Parrafelipe (big blind) folded before Flop
Seat 4: PIUlimeira folded before Flop
Seat 5: Ale7anderr77 folded before Flop (didn't bet)
Seat 6: Hookz folded before Flop (didn't bet)
Seat 7: esdeathonlol folded before Flop (didn't bet)
Seat 8: Thrumbo folded before Flop (didn't bet)

PokerStars Hand #251205918304: Tournament #3767885527, $40+$10+$5 USD Hold'em No Limit - Level XIII (800/1600) - 2024/06/26 19:26:16 UTC [2024/06/26 15:26:16 ET]
Table '3767885527 94' 8-max Seat #2 is the button
Seat 1: pazipro (70458 in chips) 
Seat 2: saupra506 (20400 in chips) 
Seat 3: Parrafelipe (13092 in chips) 
Seat 4: PIUlimeira (38790 in chips) 
Seat 5: Ale7anderr77 (60270 in chips) 
Seat 6: Hookz (22332 in chips) 
Seat 7: esdeathonlol (29000 in chips) 
Seat 8: Thrumbo (146210 in chips) 
pazipro: posts the ante 200
saupra506: posts the ante 200
Parrafelipe: posts the ante 200
PIUlimeira: posts the ante 200
Ale7anderr77: posts the ante 200
Hookz: posts the ante 200
esdeathonlol: posts the ante 200
Thrumbo: posts the ante 200
Parrafelipe: posts small blind 800
PIUlimeira: posts big blind 1600
*** HOLE CARDS ***
Ale7anderr77: raises 1600 to 3200
Hookz: raises 18932 to 22132 and is all-in
esdeathonlol: folds 
Thrumbo: folds 
pazipro: folds 
saupra506: folds 
Parrafelipe: folds 
PIUlimeira: folds 
Ale7anderr77: folds 
Uncalled bet (18932) returned to Hookz
Hookz collected 10400 from pot
Hookz: doesn't show hand 
*** SUMMARY ***
Total pot 10400 | Rake 0 
Seat 1: pazipro folded before Flop (didn't bet)
Seat 2: saupra506 (button) folded before Flop (didn't bet)
Seat 3: Parrafelipe (small blind) folded before Flop
Seat 4: PIUlimeira (big blind) folded before Flop
Seat 5: Ale7anderr77 folded before Flop
Seat 6: Hookz collected (10400)
Seat 7: esdeathonlol folded before Flop (didn't bet)
Seat 8: Thrumbo folded before Flop (didn't bet)

PokerStars Hand #251205932095: Tournament #3767885527, $40+$10+$5 USD Hold'em No Limit - Level XIII (800/1600) - 2024/06/26 19:27:07 UTC [2024/06/26 15:27:07 ET]
Table '3767885527 94' 8-max Seat #3 is the button
Seat 1: pazipro (70258 in chips) 
Seat 2: saupra506 (20200 in chips) 
Seat 3: Parrafelipe (12092 in chips) 
Seat 4: PIUlimeira (36990 in chips) 
Seat 5: Ale7anderr77 (56870 in chips) 
Seat 6: Hookz (29332 in chips) 
Seat 7: esdeathonlol (28800 in chips) 
Seat 8: Thrumbo (146010 in chips) 
pazipro: posts the ante 200
saupra506: posts the ante 200
Parrafelipe: posts the ante 200
PIUlimeira: posts the ante 200
Ale7anderr77: posts the ante 200
Hookz: posts the ante 200
esdeathonlol: posts the ante 200
Thrumbo: posts the ante 200
PIUlimeira: posts small blind 800
Ale7anderr77: posts big blind 1600
*** HOLE CARDS ***
Hookz: folds 
esdeathonlol: folds 
Thrumbo: folds 
pazipro: raises 1600 to 3200
saupra506: folds 
Parrafelipe: folds 
PIUlimeira: folds 
Ale7anderr77: calls 1600
*** FLOP *** [5s 3h 2d]
Ale7anderr77: checks 
pazipro: bets 2640
Ale7anderr77: raises 6387 to 9027
pazipro: folds 
Uncalled bet (6387) returned to Ale7anderr77
Ale7anderr77 collected 14080 from pot
*** SUMMARY ***
Total pot 14080 | Rake 0 
Board [5s 3h 2d]
Seat 1: pazipro folded on the Flop
Seat 2: saupra506 folded before Flop (didn't bet)
Seat 3: Parrafelipe (button) folded before Flop (didn't bet)
Seat 4: PIUlimeira (small blind) folded before Flop
Seat 5: Ale7anderr77 (big blind) collected (14080)
Seat 6: Hookz folded before Flop (didn't bet)
Seat 7: esdeathonlol folded before Flop (didn't bet)
Seat 8: Thrumbo folded before Flop (didn't bet)

PokerStars Hand #251205947468: Tournament #3767885527, $40+$10+$5 USD Hold'em No Limit - Level XIII (800/1600) - 2024/06/26 19:28:04 UTC [2024/06/26 15:28:04 ET]
Table '3767885527 94' 8-max Seat #4 is the button
Seat 1: pazipro (64218 in chips) 
Seat 2: saupra506 (20000 in chips) 
Seat 3: Parrafelipe (11892 in chips) 
Seat 4: PIUlimeira (35990 in chips) 
Seat 5: Ale7anderr77 (64910 in chips) 
Seat 6: Hookz (29132 in chips) 
Seat 7: esdeathonlol (28600 in chips) 
Seat 8: Thrumbo (145810 in chips) 
pazipro: posts the ante 200
saupra506: posts the ante 200
Parrafelipe: posts the ante 200
PIUlimeira: posts the ante 200
Ale7anderr77: posts the ante 200
Hookz: posts the ante 200
esdeathonlol: posts the ante 200
Thrumbo: posts the ante 200
Ale7anderr77: posts small blind 800
Hookz: posts big blind 1600
*** HOLE CARDS ***
esdeathonlol: folds 
Thrumbo: folds 
pazipro: folds 
saupra506: raises 1920 to 3520
Parrafelipe: folds 
PIUlimeira: folds 
Ale7anderr77: folds 
Hookz: folds 
Uncalled bet (1920) returned to saupra506
saupra506 collected 5600 from pot
*** SUMMARY ***
Total pot 5600 | Rake 0 
Seat 1: pazipro folded before Flop (didn't bet)
Seat 2: saupra506 collected (5600)
Seat 3: Parrafelipe folded before Flop (didn't bet)
Seat 4: PIUlimeira (button) folded before Flop (didn't bet)
Seat 5: Ale7anderr77 (small blind) folded before Flop
Seat 6: Hookz (big blind) folded before Flop
Seat 7: esdeathonlol folded before Flop (didn't bet)
Seat 8: Thrumbo folded before Flop (didn't bet)

PokerStars Hand #251205954400: Tournament #3767885527, $40+$10+$5 USD Hold'em No Limit - Level XIII (800/1600) - 2024/06/26 19:28:30 UTC [2024/06/26 15:28:30 ET]
Table '3767885527 94' 8-max Seat #5 is the button
Seat 1: pazipro (64018 in chips) 
Seat 2: saupra506 (23800 in chips) 
Seat 3: Parrafelipe (11692 in chips) 
Seat 4: PIUlimeira (35790 in chips) 
Seat 5: Ale7anderr77 (63910 in chips) 
Seat 6: Hookz (27332 in chips) 
Seat 7: esdeathonlol (28400 in chips) 
Seat 8: Thrumbo (145610 in chips) 
pazipro: posts the ante 200
saupra506: posts the ante 200
Parrafelipe: posts the ante 200
PIUlimeira: posts the ante 200
Ale7anderr77: posts the ante 200
Hookz: posts the ante 200
esdeathonlol: posts the ante 200
Thrumbo: posts the ante 200
Hookz: posts small blind 800
esdeathonlol: posts big blind 1600
*** HOLE CARDS ***
Thrumbo: folds 
pazipro: folds 
saupra506: folds 
Parrafelipe: folds 
PIUlimeira: folds 
Ale7anderr77: raises 1600 to 3200
Hookz: raises 23932 to 27132 and is all-in
esdeathonlol: folds 
Ale7anderr77: folds 
Uncalled bet (23932) returned to Hookz
Hookz collected 9600 from pot
Hookz: doesn't show hand 
*** SUMMARY ***
Total pot 9600 | Rake 0 
Seat 1: pazipro folded before Flop (didn't bet)
Seat 2: saupra506 folded before Flop (didn't bet)
Seat 3: Parrafelipe folded before Flop (didn't bet)
Seat 4: PIUlimeira folded before Flop (didn't bet)
Seat 5: Ale7anderr77 (button) folded before Flop
Seat 6: Hookz (small blind) collected (9600)
Seat 7: esdeathonlol (big blind) folded before Flop
Seat 8: Thrumbo folded before Flop (didn't bet)

PokerStars Hand #251205970421: Tournament #3767885527, $40+$10+$5 USD Hold'em No Limit - Level XIV (1000/2000) - 2024/06/26 19:29:30 UTC [2024/06/26 15:29:30 ET]
Table '3767885527 94' 8-max Seat #6 is the button
Seat 1: pazipro (63818 in chips) 
Seat 2: saupra506 (23600 in chips) 
Seat 3: Parrafelipe (11492 in chips) 
Seat 4: PIUlimeira (35590 in chips) 
Seat 5: Ale7anderr77 (60510 in chips) 
Seat 6: Hookz (33532 in chips) 
Seat 7: esdeathonlol (26600 in chips) 
Seat 8: Thrumbo (145410 in chips) 
pazipro: posts the ante 250
saupra506: posts the ante 250
Parrafelipe: posts the ante 250
PIUlimeira: posts the ante 250
Ale7anderr77: posts the ante 250
Hookz: posts the ante 250
esdeathonlol: posts the ante 250
Thrumbo: posts the ante 250
esdeathonlol: posts small blind 1000
Thrumbo: posts big blind 2000
*** HOLE CARDS ***
pazipro: raises 2000 to 4000
saupra506: folds 
Parrafelipe: folds 
PIUlimeira: folds 
Ale7anderr77: folds 
Hookz: folds 
esdeathonlol: folds 
Thrumbo: calls 2000
*** FLOP *** [5h 4s 9h]
Thrumbo: checks 
pazipro: checks 
*** TURN *** [5h 4s 9h] [Kh]
Thrumbo: checks 
pazipro: checks 
*** RIVER *** [5h 4s 9h Kh] [Ah]
Thrumbo: checks 
pazipro: checks 
*** SHOW DOWN ***
Thrumbo: shows [7c 5c] (a pair of Fives)
pazipro: shows [Qs Ad] (a pair of Aces)
pazipro collected 11000 from pot
*** SUMMARY ***
Total pot 11000 | Rake 0 
Board [5h 4s 9h Kh Ah]
Seat 1: pazipro showed [Qs Ad] and won (11000) with a pair of Aces
Seat 2: saupra506 folded before Flop (didn't bet)
Seat 3: Parrafelipe folded before Flop (didn't bet)
Seat 4: PIUlimeira folded before Flop (didn't bet)
Seat 5: Ale7anderr77 folded before Flop (didn't bet)
Seat 6: Hookz (button) folded before Flop (didn't bet)
Seat 7: esdeathonlol (small blind) folded before Flop
Seat 8: Thrumbo (big blind) showed [7c 5c] and lost with a pair of Fives

PokerStars Hand #251205987450: Tournament #3767885527, $40+$10+$5 USD Hold'em No Limit - Level XIV (1000/2000) - 2024/06/26 19:30:32 UTC [2024/06/26 15:30:32 ET]
Table '3767885527 94' 8-max Seat #7 is the button
Seat 1: pazipro (70568 in chips) 
Seat 2: saupra506 (23350 in chips) 
Seat 3: Parrafelipe (11242 in chips) 
Seat 4: PIUlimeira (35340 in chips) 
Seat 5: Ale7anderr77 (60260 in chips) 
Seat 6: Hookz (33282 in chips) 
Seat 7: esdeathonlol (25350 in chips) 
Seat 8: Thrumbo (141160 in chips) 
pazipro: posts the ante 250
saupra506: posts the ante 250
Parrafelipe: posts the ante 250
PIUlimeira: posts the ante 250
Ale7anderr77: posts the ante 250
Hookz: posts the ante 250
esdeathonlol: posts the ante 250
Thrumbo: posts the ante 250
Thrumbo: posts small blind 1000
pazipro: posts big blind 2000
*** HOLE CARDS ***
saupra506: folds 
Parrafelipe: folds 
PIUlimeira: folds 
Ale7anderr77: folds 
Hookz: folds 
esdeathonlol: raises 2000 to 4000
Thrumbo: folds 
pazipro: calls 2000
*** FLOP *** [Jc Qh 3d]
pazipro: checks 
esdeathonlol: bets 6000
pazipro: raises 23000 to 29000
esdeathonlol: folds 
Uncalled bet (23000) returned to pazipro
pazipro collected 23000 from pot
pazipro: doesn't show hand 
*** SUMMARY ***
Total pot 23000 | Rake 0 
Board [Jc Qh 3d]
Seat 1: pazipro (big blind) collected (23000)
Seat 2: saupra506 folded before Flop (didn't bet)
Seat 3: Parrafelipe folded before Flop (didn't bet)
Seat 4: PIUlimeira folded before Flop (didn't bet)
Seat 5: Ale7anderr77 folded before Flop (didn't bet)
Seat 6: Hookz folded before Flop (didn't bet)
Seat 7: esdeathonlol (button) folded on the Flop
Seat 8: Thrumbo (small blind) folded before Flop

PokerStars Hand #251206000911: Tournament #3767885527, $40+$10+$5 USD Hold'em No Limit - Level XIV (1000/2000) - 2024/06/26 19:31:21 UTC [2024/06/26 15:31:21 ET]
Table '3767885527 94' 8-max Seat #8 is the button
Seat 1: pazipro (83318 in chips) 
Seat 2: saupra506 (23100 in chips) 
Seat 3: Parrafelipe (10992 in chips) 
Seat 4: PIUlimeira (35090 in chips) 
Seat 5: Ale7anderr77 (60010 in chips) 
Seat 6: Hookz (33032 in chips) 
Seat 7: esdeathonlol (15100 in chips) 
Seat 8: Thrumbo (139910 in chips) 
pazipro: posts the ante 250
saupra506: posts the ante 250
Parrafelipe: posts the ante 250
PIUlimeira: posts the ante 250
Ale7anderr77: posts the ante 250
Hookz: posts the ante 250
esdeathonlol: posts the ante 250
Thrumbo: posts the ante 250
pazipro: posts small blind 1000
saupra506: posts big blind 2000
*** HOLE CARDS ***
Parrafelipe: folds 
PIUlimeira: folds 
Ale7anderr77: folds 
Hookz: folds 
esdeathonlol: folds 
Thrumbo: folds 
pazipro: raises 81068 to 83068 and is all-in
saupra506: folds 
Uncalled bet (81068) returned to pazipro
pazipro collected 6000 from pot
pazipro: doesn't show hand 
*** SUMMARY ***
Total pot 6000 | Rake 0 
Seat 1: pazipro (small blind) collected (6000)
Seat 2: saupra506 (big blind) folded before Flop
Seat 3: Parrafelipe folded before Flop (didn't bet)
Seat 4: PIUlimeira folded before Flop (didn't bet)
Seat 5: Ale7anderr77 folded before Flop (didn't bet)
Seat 6: Hookz folded before Flop (didn't bet)
Seat 7: esdeathonlol folded before Flop (didn't bet)
Seat 8: Thrumbo (button) folded before Flop (didn't bet)

PokerStars Hand #251206008118: Tournament #3767885527, $40+$10+$5 USD Hold'em No Limit - Level XIV (1000/2000) - 2024/06/26 19:31:47 UTC [2024/06/26 15:31:47 ET]
Table '3767885527 94' 8-max Seat #1 is the button
Seat 1: pazipro (87068 in chips) 
Seat 2: saupra506 (20850 in chips) 
Seat 3: Parrafelipe (10742 in chips) 
Seat 4: PIUlimeira (34840 in chips) 
Seat 5: Ale7anderr77 (59760 in chips) 
Seat 6: Hookz (32782 in chips) 
Seat 7: esdeathonlol (14850 in chips) 
Seat 8: Thrumbo (139660 in chips) 
pazipro: posts the ante 250
saupra506: posts the ante 250
Parrafelipe: posts the ante 250
PIUlimeira: posts the ante 250
Ale7anderr77: posts the ante 250
Hookz: posts the ante 250
esdeathonlol: posts the ante 250
Thrumbo: posts the ante 250
saupra506: posts small blind 1000
Parrafelipe: posts big blind 2000
*** HOLE CARDS ***
PIUlimeira: raises 2000 to 4000
Ale7anderr77: folds 
Hookz: folds 
esdeathonlol: folds 
Thrumbo: folds 
pazipro: folds 
saupra506: folds 
Parrafelipe: raises 6492 to 10492 and is all-in
PIUlimeira: calls 6492
*** FLOP *** [5d 8s 5s]
*** TURN *** [5d 8s 5s] [2h]
*** RIVER *** [5d 8s 5s 2h] [Kc]
*** SHOW DOWN ***
Parrafelipe: shows [Ks Qc] (two pair, Kings and Fives)
PIUlimeira: shows [Ad 6d] (a pair of Fives)
Parrafelipe collected 23984 from pot
*** SUMMARY ***
Total pot 23984 | Rake 0 
Board [5d 8s 5s 2h Kc]
Seat 1: pazipro (button) folded before Flop (didn't bet)
Seat 2: saupra506 (small blind) folded before Flop
Seat 3: Parrafelipe (big blind) showed [Ks Qc] and won (23984) with two pair, Kings and Fives
Seat 4: PIUlimeira showed [Ad 6d] and lost with a pair of Fives
Seat 5: Ale7anderr77 folded before Flop (didn't bet)
Seat 6: Hookz folded before Flop (didn't bet)
Seat 7: esdeathonlol folded before Flop (didn't bet)
Seat 8: Thrumbo folded before Flop (didn't bet)

PokerStars Hand #251206017394: Tournament #3767885527, $40+$10+$5 USD Hold'em No Limit - Level XIV (1000/2000) - 2024/06/26 19:32:20 UTC [2024/06/26 15:32:20 ET]
Table '3767885527 94' 8-max Seat #2 is the button
Seat 1: pazipro (86818 in chips) 
Seat 2: saupra506 (19600 in chips) 
Seat 3: Parrafelipe (23984 in chips) 
Seat 4: PIUlimeira (24098 in chips) 
Seat 5: Ale7anderr77 (59510 in chips) 
Seat 6: Hookz (32532 in chips) 
Seat 7: esdeathonlol (14600 in chips) 
Seat 8: Thrumbo (139410 in chips) 
pazipro: posts the ante 250
saupra506: posts the ante 250
Parrafelipe: posts the ante 250
PIUlimeira: posts the ante 250
Ale7anderr77: posts the ante 250
Hookz: posts the ante 250
esdeathonlol: posts the ante 250
Thrumbo: posts the ante 250
Parrafelipe: posts small blind 1000
PIUlimeira: posts big blind 2000
*** HOLE CARDS ***
Ale7anderr77: folds 
Hookz: folds 
esdeathonlol: folds 
Thrumbo: folds 
pazipro: raises 2000 to 4000
saupra506: folds 
Parrafelipe: folds 
PIUlimeira: calls 2000
*** FLOP *** [4s Ah 5h]
PIUlimeira: checks 
pazipro: bets 3300
PIUlimeira: calls 3300
*** TURN *** [4s Ah 5h] [9h]
PIUlimeira: checks 
pazipro: bets 5280
PIUlimeira: raises 11268 to 16548 and is all-in
pazipro: calls 11268
*** RIVER *** [4s Ah 5h 9h] [Th]
*** SHOW DOWN ***
PIUlimeira: shows [As Ac] (three of a kind, Aces)
pazipro: shows [Kh Kd] (a flush, Ace high)
pazipro collected 50696 from pot
PIUlimeira finished the tournament
*** SUMMARY ***
Total pot 50696 | Rake 0 
Board [4s Ah 5h 9h Th]
Seat 1: pazipro showed [Kh Kd] and won (50696) with a flush, Ace high
Seat 2: saupra506 (button) folded before Flop (didn't bet)
Seat 3: Parrafelipe (small blind) folded before Flop
Seat 4: PIUlimeira (big blind) showed [As Ac] and lost with three of a kind, Aces
Seat 5: Ale7anderr77 folded before Flop (didn't bet)
Seat 6: Hookz folded before Flop (didn't bet)
Seat 7: esdeathonlol folded before Flop (didn't bet)
Seat 8: Thrumbo folded before Flop (didn't bet)


PokerStars Hand #251206793997: Tournament #3767885527, $40+$10+$5 USD Hold'em No Limit - Level XVIII (2000/4000) - 2024/06/26 20:20:06 UTC [2024/06/26 16:20:06 ET]
Table '3767885527 93' 8-max Seat #7 is the button
Seat 1: lucaromanoo1 (161854 in chips) 
Seat 2: mobky (72000 in chips) 
Seat 3: supervaganj (155290 in chips) 
Seat 4: Vamoclan (70599 in chips) 
Seat 5: pj0901 (232619 in chips) 
Seat 6: Proosty2 (70728 in chips) 
Seat 7: gibbo888 (234866 in chips) 
Seat 8: DR. ELDAR (101766 in chips) 
lucaromanoo1: posts the ante 500
mobky: posts the ante 500
supervaganj: posts the ante 500
Vamoclan: posts the ante 500
pj0901: posts the ante 500
Proosty2: posts the ante 500
gibbo888: posts the ante 500
DR. ELDAR: posts the ante 500
DR. ELDAR: posts small blind 2000
lucaromanoo1: posts big blind 4000
*** HOLE CARDS ***
mobky: calls 4000
supervaganj: folds 
Vamoclan: folds 
pj0901: folds 
Proosty2: folds 
gibbo888: folds 
DR. ELDAR: folds 
lucaromanoo1: checks 
*** FLOP *** [4h Kd 3s]
lucaromanoo1: checks 
mobky: bets 4000
lucaromanoo1: calls 4000
*** TURN *** [4h Kd 3s] [8d]
lucaromanoo1: checks 
mobky: bets 11000
lucaromanoo1: calls 11000
*** RIVER *** [4h Kd 3s 8d] [5s]
lucaromanoo1: checks 
mobky: checks 
*** SHOW DOWN ***
lucaromanoo1: shows [Ks 7h] (a pair of Kings)
mobky: mucks hand 
lucaromanoo1 collected 44000 from pot
*** SUMMARY ***
Total pot 44000 | Rake 0 
Board [4h Kd 3s 8d 5s]
Seat 1: lucaromanoo1 (big blind) showed [Ks 7h] and won (44000) with a pair of Kings
Seat 2: mobky mucked
Seat 3: supervaganj folded before Flop (didn't bet)
Seat 4: Vamoclan folded before Flop (didn't bet)
Seat 5: pj0901 folded before Flop (didn't bet)
Seat 6: Proosty2 folded before Flop (didn't bet)
Seat 7: gibbo888 (button) folded before Flop (didn't bet)
Seat 8: DR. ELDAR (small blind) folded before Flop

PokerStars Hand #251206807867: Tournament #3767885527, $40+$10+$5 USD Hold'em No Limit - Level XVIII (2000/4000) - 2024/06/26 20:20:55 UTC [2024/06/26 16:20:55 ET]
Table '3767885527 93' 8-max Seat #8 is the button
Seat 1: lucaromanoo1 (186354 in chips) 
Seat 2: mobky (52500 in chips) 
Seat 3: supervaganj (154790 in chips) 
Seat 4: Vamoclan (70099 in chips) 
Seat 5: pj0901 (232119 in chips) 
Seat 6: Proosty2 (70228 in chips) 
Seat 7: gibbo888 (234366 in chips) 
Seat 8: DR. ELDAR (99266 in chips) 
lucaromanoo1: posts the ante 500
mobky: posts the ante 500
supervaganj: posts the ante 500
Vamoclan: posts the ante 500
pj0901: posts the ante 500
Proosty2: posts the ante 500
gibbo888: posts the ante 500
DR. ELDAR: posts the ante 500
lucaromanoo1: posts small blind 2000
mobky: posts big blind 4000
*** HOLE CARDS ***
supervaganj: folds 
Vamoclan: folds 
pj0901: folds 
Proosty2: folds 
gibbo888: folds 
DR. ELDAR: folds 
lucaromanoo1: raises 181854 to 185854 and is all-in
mobky: folds 
Uncalled bet (181854) returned to lucaromanoo1
lucaromanoo1 collected 12000 from pot
lucaromanoo1: doesn't show hand 
*** SUMMARY ***
Total pot 12000 | Rake 0 
Seat 1: lucaromanoo1 (small blind) collected (12000)
Seat 2: mobky (big blind) folded before Flop
Seat 3: supervaganj folded before Flop (didn't bet)
Seat 4: Vamoclan folded before Flop (didn't bet)
Seat 5: pj0901 folded before Flop (didn't bet)
Seat 6: Proosty2 folded before Flop (didn't bet)
Seat 7: gibbo888 folded before Flop (didn't bet)
Seat 8: DR. ELDAR (button) folded before Flop (didn't bet)

PokerStars Hand #251206820274: Tournament #3767885527, $40+$10+$5 USD Hold'em No Limit - Level XVIII (2000/4000) - 2024/06/26 20:21:39 UTC [2024/06/26 16:21:39 ET]
Table '3767885527 93' 8-max Seat #1 is the button
Seat 1: lucaromanoo1 (193854 in chips) 
Seat 2: mobky (48000 in chips) 
Seat 3: supervaganj (154290 in chips) 
Seat 4: Vamoclan (69599 in chips) 
Seat 5: pj0901 (231619 in chips) 
Seat 6: Proosty2 (69728 in chips) 
Seat 7: gibbo888 (233866 in chips) 
Seat 8: DR. ELDAR (98766 in chips) 
lucaromanoo1: posts the ante 500
mobky: posts the ante 500
supervaganj: posts the ante 500
Vamoclan: posts the ante 500
pj0901: posts the ante 500
Proosty2: posts the ante 500
gibbo888: posts the ante 500
DR. ELDAR: posts the ante 500
mobky: posts small blind 2000
supervaganj: posts big blind 4000
*** HOLE CARDS ***
Vamoclan: folds 
pj0901: folds 
Proosty2: raises 4000 to 8000
gibbo888: folds 
DR. ELDAR: folds 
lucaromanoo1: folds 
mobky: folds 
supervaganj: calls 4000
*** FLOP *** [Kd 2c 5d]
supervaganj: checks 
Proosty2: bets 5520
supervaganj: folds 
Uncalled bet (5520) returned to Proosty2
Proosty2 collected 22000 from pot
Proosty2: doesn't show hand 
*** SUMMARY ***
Total pot 22000 | Rake 0 
Board [Kd 2c 5d]
Seat 1: lucaromanoo1 (button) folded before Flop (didn't bet)
Seat 2: mobky (small blind) folded before Flop
Seat 3: supervaganj (big blind) folded on the Flop
Seat 4: Vamoclan folded before Flop (didn't bet)
Seat 5: pj0901 folded before Flop (didn't bet)
Seat 6: Proosty2 collected (22000)
Seat 7: gibbo888 folded before Flop (didn't bet)
Seat 8: DR. ELDAR folded before Flop (didn't bet)

PokerStars Hand #251206830724: Tournament #3767885527, $40+$10+$5 USD Hold'em No Limit - Level XVIII (2000/4000) - 2024/06/26 20:22:16 UTC [2024/06/26 16:22:16 ET]
Table '3767885527 93' 8-max Seat #2 is the button
Seat 1: lucaromanoo1 (193354 in chips) 
Seat 2: mobky (45500 in chips) 
Seat 3: supervaganj (145790 in chips) 
Seat 4: Vamoclan (69099 in chips) 
Seat 5: pj0901 (231119 in chips) 
Seat 6: Proosty2 (83228 in chips) 
Seat 7: gibbo888 (233366 in chips) 
Seat 8: DR. ELDAR (98266 in chips) 
lucaromanoo1: posts the ante 500
mobky: posts the ante 500
supervaganj: posts the ante 500
Vamoclan: posts the ante 500
pj0901: posts the ante 500
Proosty2: posts the ante 500
gibbo888: posts the ante 500
DR. ELDAR: posts the ante 500
supervaganj: posts small blind 2000
Vamoclan: posts big blind 4000
*** HOLE CARDS ***
pj0901 has timed out
pj0901: folds 
pj0901 is sitting out
Proosty2: raises 4000 to 8000
pj0901 has returned
gibbo888: folds 
DR. ELDAR: folds 
lucaromanoo1: folds 
mobky: calls 8000
supervaganj: folds 
Vamoclan: folds 
*** FLOP *** [2h Ts 9c]
Proosty2: checks 
mobky: checks 
*** TURN *** [2h Ts 9c] [8d]
Proosty2: checks 
mobky: bets 26000
Proosty2: folds 
Uncalled bet (26000) returned to mobky
mobky collected 26000 from pot
*** SUMMARY ***
Total pot 26000 | Rake 0 
Board [2h Ts 9c 8d]
Seat 1: lucaromanoo1 folded before Flop (didn't bet)
Seat 2: mobky (button) collected (26000)
Seat 3: supervaganj (small blind) folded before Flop
Seat 4: Vamoclan (big blind) folded before Flop
Seat 5: pj0901 folded before Flop (didn't bet)
Seat 6: Proosty2 folded on the Turn
Seat 7: gibbo888 folded before Flop (didn't bet)
Seat 8: DR. ELDAR folded before Flop (didn't bet)

PokerStars Hand #251206854632: Tournament #3767885527, $40+$10+$5 USD Hold'em No Limit - Level XVIII (2000/4000) - 2024/06/26 20:23:41 UTC [2024/06/26 16:23:41 ET]
Table '3767885527 93' 8-max Seat #3 is the button
Seat 1: lucaromanoo1 (192854 in chips) 
Seat 2: mobky (63000 in chips) 
Seat 3: supervaganj (143290 in chips) 
Seat 4: Vamoclan (64599 in chips) 
Seat 5: pj0901 (230619 in chips) 
Seat 6: Proosty2 (74728 in chips) 
Seat 7: gibbo888 (232866 in chips) 
Seat 8: DR. ELDAR (97766 in chips) 
lucaromanoo1: posts the ante 500
mobky: posts the ante 500
supervaganj: posts the ante 500
Vamoclan: posts the ante 500
pj0901: posts the ante 500
Proosty2: posts the ante 500
gibbo888: posts the ante 500
DR. ELDAR: posts the ante 500
Vamoclan: posts small blind 2000
pj0901: posts big blind 4000
*** HOLE CARDS ***
Proosty2: folds 
gibbo888: folds 
DR. ELDAR: folds 
lucaromanoo1: folds 
mobky: raises 4123 to 8123
supervaganj: folds 
Vamoclan: folds 
pj0901: raises 221996 to 230119 and is all-in
mobky: folds 
Uncalled bet (221996) returned to pj0901
pj0901 collected 22246 from pot
pj0901: doesn't show hand 
*** SUMMARY ***
Total pot 22246 | Rake 0 
Seat 1: lucaromanoo1 folded before Flop (didn't bet)
Seat 2: mobky folded before Flop
Seat 3: supervaganj (button) folded before Flop (didn't bet)
Seat 4: Vamoclan (small blind) folded before Flop
Seat 5: pj0901 (big blind) collected (22246)
Seat 6: Proosty2 folded before Flop (didn't bet)
Seat 7: gibbo888 folded before Flop (didn't bet)
Seat 8: DR. ELDAR folded before Flop (didn't bet)

PokerStars Hand #251206871845: Tournament #3767885527, $40+$10+$5 USD Hold'em No Limit - Level XVIII (2000/4000) - 2024/06/26 20:24:43 UTC [2024/06/26 16:24:43 ET]
Table '3767885527 93' 8-max Seat #4 is the button
Seat 1: lucaromanoo1 (192354 in chips) 
Seat 2: mobky (54377 in chips) 
Seat 3: supervaganj (142790 in chips) 
Seat 4: Vamoclan (62099 in chips) 
Seat 5: pj0901 (244242 in chips) 
Seat 6: Proosty2 (74228 in chips) 
Seat 7: gibbo888 (232366 in chips) 
Seat 8: DR. ELDAR (97266 in chips) 
lucaromanoo1: posts the ante 500
mobky: posts the ante 500
supervaganj: posts the ante 500
Vamoclan: posts the ante 500
pj0901: posts the ante 500
Proosty2: posts the ante 500
gibbo888: posts the ante 500
DR. ELDAR: posts the ante 500
pj0901: posts small blind 2000
Proosty2: posts big blind 4000
*** HOLE CARDS ***
gibbo888: folds 
DR. ELDAR: folds 
lucaromanoo1: folds 
mobky: folds 
supervaganj: folds 
Vamoclan: folds 
pj0901: raises 239742 to 243742 and is all-in
Proosty2: folds 
Uncalled bet (239742) returned to pj0901
pj0901 collected 12000 from pot
pj0901: doesn't show hand 
*** SUMMARY ***
Total pot 12000 | Rake 0 
Seat 1: lucaromanoo1 folded before Flop (didn't bet)
Seat 2: mobky folded before Flop (didn't bet)
Seat 3: supervaganj folded before Flop (didn't bet)
Seat 4: Vamoclan (button) folded before Flop (didn't bet)
Seat 5: pj0901 (small blind) collected (12000)
Seat 6: Proosty2 (big blind) folded before Flop
Seat 7: gibbo888 folded before Flop (didn't bet)
Seat 8: DR. ELDAR folded before Flop (didn't bet)

PokerStars Hand #251206877625: Tournament #3767885527, $40+$10+$5 USD Hold'em No Limit - Level XVIII (2000/4000) - 2024/06/26 20:25:04 UTC [2024/06/26 16:25:04 ET]
Table '3767885527 93' 8-max Seat #5 is the button
Seat 1: lucaromanoo1 (191854 in chips) 
Seat 2: mobky (53877 in chips) 
Seat 3: supervaganj (142290 in chips) 
Seat 4: Vamoclan (61599 in chips) 
Seat 5: pj0901 (251742 in chips) 
Seat 6: Proosty2 (69728 in chips) 
Seat 7: gibbo888 (231866 in chips) 
Seat 8: DR. ELDAR (96766 in chips) 
lucaromanoo1: posts the ante 500
mobky: posts the ante 500
supervaganj: posts the ante 500
Vamoclan: posts the ante 500
pj0901: posts the ante 500
Proosty2: posts the ante 500
gibbo888: posts the ante 500
DR. ELDAR: posts the ante 500
Proosty2: posts small blind 2000
gibbo888: posts big blind 4000
*** HOLE CARDS ***
DR. ELDAR: folds 
lucaromanoo1: folds 
mobky: folds 
supervaganj: folds 
Vamoclan: folds 
pj0901: folds 
Proosty2: calls 2000
gibbo888: raises 227366 to 231366 and is all-in
Proosty2: folds 
Uncalled bet (227366) returned to gibbo888
gibbo888 collected 12000 from pot
gibbo888: doesn't show hand 
*** SUMMARY ***
Total pot 12000 | Rake 0 
Seat 1: lucaromanoo1 folded before Flop (didn't bet)
Seat 2: mobky folded before Flop (didn't bet)
Seat 3: supervaganj folded before Flop (didn't bet)
Seat 4: Vamoclan folded before Flop (didn't bet)
Seat 5: pj0901 (button) folded before Flop (didn't bet)
Seat 6: Proosty2 (small blind) folded before Flop
Seat 7: gibbo888 (big blind) collected (12000)
Seat 8: DR. ELDAR folded before Flop (didn't bet)

PokerStars Hand #251206888352: Tournament #3767885527, $40+$10+$5 USD Hold'em No Limit - Level XVIII (2000/4000) - 2024/06/26 20:25:42 UTC [2024/06/26 16:25:42 ET]
Table '3767885527 93' 8-max Seat #6 is the button
Seat 1: lucaromanoo1 (191354 in chips) 
Seat 2: mobky (53377 in chips) 
Seat 3: supervaganj (141790 in chips) 
Seat 4: Vamoclan (61099 in chips) 
Seat 5: pj0901 (251242 in chips) 
Seat 6: Proosty2 (65228 in chips) 
Seat 7: gibbo888 (239366 in chips) 
Seat 8: DR. ELDAR (96266 in chips) 
lucaromanoo1: posts the ante 500
mobky: posts the ante 500
supervaganj: posts the ante 500
Vamoclan: posts the ante 500
pj0901: posts the ante 500
Proosty2: posts the ante 500
gibbo888: posts the ante 500
DR. ELDAR: posts the ante 500
gibbo888: posts small blind 2000
DR. ELDAR: posts big blind 4000
*** HOLE CARDS ***
lucaromanoo1: raises 4000 to 8000
mobky: calls 8000
supervaganj: folds 
Vamoclan: folds 
pj0901: folds 
Proosty2: folds 
gibbo888: calls 6000
DR. ELDAR: calls 4000
*** FLOP *** [2d Ad 9d]
gibbo888: checks 
DR. ELDAR: checks 
lucaromanoo1: checks 
mobky: checks 
*** TURN *** [2d Ad 9d] [Ks]
gibbo888: bets 15840
DR. ELDAR: folds 
lucaromanoo1: folds 
mobky: folds 
Uncalled bet (15840) returned to gibbo888
gibbo888 collected 36000 from pot
gibbo888: doesn't show hand 
*** SUMMARY ***
Total pot 36000 | Rake 0 
Board [2d Ad 9d Ks]
Seat 1: lucaromanoo1 folded on the Turn
Seat 2: mobky folded on the Turn
Seat 3: supervaganj folded before Flop (didn't bet)
Seat 4: Vamoclan folded before Flop (didn't bet)
Seat 5: pj0901 folded before Flop (didn't bet)
Seat 6: Proosty2 (button) folded before Flop (didn't bet)
Seat 7: gibbo888 (small blind) collected (36000)
Seat 8: DR. ELDAR (big blind) folded on the Turn

PokerStars Hand #251206903318: Tournament #3767885527, $40+$10+$5 USD Hold'em No Limit - Level XIX (2500/5000) - 2024/06/26 20:26:36 UTC [2024/06/26 16:26:36 ET]
Table '3767885527 93' 8-max Seat #7 is the button
Seat 1: lucaromanoo1 (182854 in chips) 
Seat 2: mobky (44877 in chips) 
Seat 3: supervaganj (141290 in chips) 
Seat 4: Vamoclan (60599 in chips) 
Seat 5: pj0901 (250742 in chips) 
Seat 6: Proosty2 (64728 in chips) 
Seat 7: gibbo888 (266866 in chips) 
Seat 8: DR. ELDAR (87766 in chips) 
lucaromanoo1: posts the ante 625
mobky: posts the ante 625
supervaganj: posts the ante 625
Vamoclan: posts the ante 625
pj0901: posts the ante 625
Proosty2: posts the ante 625
gibbo888: posts the ante 625
DR. ELDAR: posts the ante 625
DR. ELDAR: posts small blind 2500
lucaromanoo1: posts big blind 5000
*** HOLE CARDS ***
mobky: folds 
supervaganj: raises 5000 to 10000
Vamoclan: folds 
pj0901: folds 
Proosty2: folds 
gibbo888: folds 
DR. ELDAR: folds 
lucaromanoo1: calls 5000
*** FLOP *** [3c Qd Qs]
lucaromanoo1: checks 
supervaganj: bets 6900
lucaromanoo1: raises 15600 to 22500
supervaganj: folds 
Uncalled bet (15600) returned to lucaromanoo1
lucaromanoo1 collected 41300 from pot
lucaromanoo1: doesn't show hand 
*** SUMMARY ***
Total pot 41300 | Rake 0 
Board [3c Qd Qs]
Seat 1: lucaromanoo1 (big blind) collected (41300)
Seat 2: mobky folded before Flop (didn't bet)
Seat 3: supervaganj folded on the Flop
Seat 4: Vamoclan folded before Flop (didn't bet)
Seat 5: pj0901 folded before Flop (didn't bet)
Seat 6: Proosty2 folded before Flop (didn't bet)
Seat 7: gibbo888 (button) folded before Flop (didn't bet)
Seat 8: DR. ELDAR (small blind) folded before Flop

PokerStars Hand #251206918858: Tournament #3767885527, $40+$10+$5 USD Hold'em No Limit - Level XIX (2500/5000) - 2024/06/26 20:27:32 UTC [2024/06/26 16:27:32 ET]
Table '3767885527 93' 8-max Seat #8 is the button
Seat 1: lucaromanoo1 (206629 in chips) 
Seat 2: mobky (44252 in chips) 
Seat 3: supervaganj (123765 in chips) 
Seat 4: Vamoclan (59974 in chips) 
Seat 5: pj0901 (250117 in chips) 
Seat 6: Proosty2 (64103 in chips) 
Seat 7: gibbo888 (266241 in chips) 
Seat 8: DR. ELDAR (84641 in chips) 
lucaromanoo1: posts the ante 625
mobky: posts the ante 625
supervaganj: posts the ante 625
Vamoclan: posts the ante 625
pj0901: posts the ante 625
Proosty2: posts the ante 625
gibbo888: posts the ante 625
DR. ELDAR: posts the ante 625
lucaromanoo1: posts small blind 2500
mobky: posts big blind 5000
*** HOLE CARDS ***
supervaganj: folds 
Vamoclan: folds 
pj0901: raises 5000 to 10000
Proosty2: folds 
gibbo888: folds 
DR. ELDAR: folds 
lucaromanoo1: calls 7500
mobky: folds 
*** FLOP *** [8s 9s 8h]
lucaromanoo1: checks 
pj0901: checks 
*** TURN *** [8s 9s 8h] [2h]
lucaromanoo1: checks 
pj0901: checks 
*** RIVER *** [8s 9s 8h 2h] [Kd]
lucaromanoo1: checks 
pj0901: checks 
*** SHOW DOWN ***
lucaromanoo1: shows [7h 7s] (two pair, Eights and Sevens)
pj0901: mucks hand 
lucaromanoo1 collected 30000 from pot
*** SUMMARY ***
Total pot 30000 | Rake 0 
Board [8s 9s 8h 2h Kd]
Seat 1: lucaromanoo1 (small blind) showed [7h 7s] and won (30000) with two pair, Eights and Sevens
Seat 2: mobky (big blind) folded before Flop
Seat 3: supervaganj folded before Flop (didn't bet)
Seat 4: Vamoclan folded before Flop (didn't bet)
Seat 5: pj0901 mucked
Seat 6: Proosty2 folded before Flop (didn't bet)
Seat 7: gibbo888 folded before Flop (didn't bet)
Seat 8: DR. ELDAR (button) folded before Flop (didn't bet)

PokerStars Hand #251206944723: Tournament #3767885527, $40+$10+$5 USD Hold'em No Limit - Level XIX (2500/5000) - 2024/06/26 20:29:05 UTC [2024/06/26 16:29:05 ET]
Table '3767885527 93' 8-max Seat #1 is the button
Seat 1: lucaromanoo1 (226004 in chips) 
Seat 2: mobky (38627 in chips) 
Seat 3: supervaganj (123140 in chips) 
Seat 4: Vamoclan (59349 in chips) 
Seat 5: pj0901 (239492 in chips) 
Seat 6: Proosty2 (63478 in chips) 
Seat 7: gibbo888 (265616 in chips) 
Seat 8: DR. ELDAR (84016 in chips) 
lucaromanoo1: posts the ante 625
mobky: posts the ante 625
supervaganj: posts the ante 625
Vamoclan: posts the ante 625
pj0901: posts the ante 625
Proosty2: posts the ante 625
gibbo888: posts the ante 625
DR. ELDAR: posts the ante 625
mobky: posts small blind 2500
supervaganj: posts big blind 5000
*** HOLE CARDS ***
Vamoclan: folds 
pj0901: folds 
Proosty2: folds 
gibbo888: raises 5000 to 10000
DR. ELDAR: folds 
lucaromanoo1: folds 
mobky: folds 
supervaganj: calls 5000
*** FLOP *** [Ah 5d 2h]
supervaganj: checks 
gibbo888: bets 12100
supervaganj: folds 
Uncalled bet (12100) returned to gibbo888
gibbo888 collected 27500 from pot
gibbo888: doesn't show hand 
*** SUMMARY ***
Total pot 27500 | Rake 0 
Board [Ah 5d 2h]
Seat 1: lucaromanoo1 (button) folded before Flop (didn't bet)
Seat 2: mobky (small blind) folded before Flop
Seat 3: supervaganj (big blind) folded on the Flop
Seat 4: Vamoclan folded before Flop (didn't bet)
Seat 5: pj0901 folded before Flop (didn't bet)
Seat 6: Proosty2 folded before Flop (didn't bet)
Seat 7: gibbo888 collected (27500)
Seat 8: DR. ELDAR folded before Flop (didn't bet)

PokerStars Hand #251206960344: Tournament #3767885527, $40+$10+$5 USD Hold'em No Limit - Level XIX (2500/5000) - 2024/06/26 20:30:01 UTC [2024/06/26 16:30:01 ET]
Table '3767885527 93' 8-max Seat #2 is the button
Seat 1: lucaromanoo1 (225379 in chips) 
Seat 2: mobky (35502 in chips) 
Seat 3: supervaganj (112515 in chips) 
Seat 4: Vamoclan (58724 in chips) 
Seat 5: pj0901 (238867 in chips) 
Seat 6: Proosty2 (62853 in chips) 
Seat 7: gibbo888 (282491 in chips) 
Seat 8: DR. ELDAR (83391 in chips) 
lucaromanoo1: posts the ante 625
mobky: posts the ante 625
supervaganj: posts the ante 625
Vamoclan: posts the ante 625
pj0901: posts the ante 625
Proosty2: posts the ante 625
gibbo888: posts the ante 625
DR. ELDAR: posts the ante 625
supervaganj: posts small blind 2500
Vamoclan: posts big blind 5000
*** HOLE CARDS ***
pj0901: folds 
Proosty2: folds 
gibbo888: folds 
DR. ELDAR: folds 
lucaromanoo1: folds 
mobky: folds 
supervaganj: raises 106890 to 111890 and is all-in
Vamoclan: folds 
Uncalled bet (106890) returned to supervaganj
supervaganj collected 15000 from pot
supervaganj: doesn't show hand 
*** SUMMARY ***
Total pot 15000 | Rake 0 
Seat 1: lucaromanoo1 folded before Flop (didn't bet)
Seat 2: mobky (button) folded before Flop (didn't bet)
Seat 3: supervaganj (small blind) collected (15000)
Seat 4: Vamoclan (big blind) folded before Flop
Seat 5: pj0901 folded before Flop (didn't bet)
Seat 6: Proosty2 folded before Flop (didn't bet)
Seat 7: gibbo888 folded before Flop (didn't bet)
Seat 8: DR. ELDAR folded before Flop (didn't bet)

PokerStars Hand #251206971586: Tournament #3767885527, $40+$10+$5 USD Hold'em No Limit - Level XIX (2500/5000) - 2024/06/26 20:30:42 UTC [2024/06/26 16:30:42 ET]
Table '3767885527 93' 8-max Seat #3 is the button
Seat 1: lucaromanoo1 (224754 in chips) 
Seat 2: mobky (34877 in chips) 
Seat 3: supervaganj (121890 in chips) 
Seat 4: Vamoclan (53099 in chips) 
Seat 5: pj0901 (238242 in chips) 
Seat 6: Proosty2 (62228 in chips) 
Seat 7: gibbo888 (281866 in chips) 
Seat 8: DR. ELDAR (82766 in chips) 
lucaromanoo1: posts the ante 625
mobky: posts the ante 625
supervaganj: posts the ante 625
Vamoclan: posts the ante 625
pj0901: posts the ante 625
Proosty2: posts the ante 625
gibbo888: posts the ante 625
DR. ELDAR: posts the ante 625
Vamoclan: posts small blind 2500
pj0901: posts big blind 5000
*** HOLE CARDS ***
Proosty2: folds 
gibbo888: folds 
DR. ELDAR: folds 
lucaromanoo1: folds 
mobky: folds 
supervaganj: folds 
Vamoclan: folds 
Uncalled bet (2500) returned to pj0901
pj0901 collected 10000 from pot
pj0901: doesn't show hand 
*** SUMMARY ***
Total pot 10000 | Rake 0 
Seat 1: lucaromanoo1 folded before Flop (didn't bet)
Seat 2: mobky folded before Flop (didn't bet)
Seat 3: supervaganj (button) folded before Flop (didn't bet)
Seat 4: Vamoclan (small blind) folded before Flop
Seat 5: pj0901 (big blind) collected (10000)
Seat 6: Proosty2 folded before Flop (didn't bet)
Seat 7: gibbo888 folded before Flop (didn't bet)
Seat 8: DR. ELDAR folded before Flop (didn't bet)

PokerStars Hand #251206984975: Tournament #3767885527, $40+$10+$5 USD Hold'em No Limit - Level XIX (2500/5000) - 2024/06/26 20:31:30 UTC [2024/06/26 16:31:30 ET]
Table '3767885527 93' 8-max Seat #4 is the button
Seat 1: lucaromanoo1 (224129 in chips) 
Seat 2: mobky (34252 in chips) 
Seat 3: supervaganj (121265 in chips) 
Seat 4: Vamoclan (49974 in chips) 
Seat 5: pj0901 (245117 in chips) 
Seat 6: Proosty2 (61603 in chips) 
Seat 7: gibbo888 (281241 in chips) 
Seat 8: DR. ELDAR (82141 in chips) 
lucaromanoo1: posts the ante 625
mobky: posts the ante 625
supervaganj: posts the ante 625
Vamoclan: posts the ante 625
pj0901: posts the ante 625
Proosty2: posts the ante 625
gibbo888: posts the ante 625
DR. ELDAR: posts the ante 625
pj0901: posts small blind 2500
Proosty2: posts big blind 5000
*** HOLE CARDS ***
gibbo888: folds 
DR. ELDAR: folds 
lucaromanoo1: folds 
mobky has timed out
mobky: folds 
mobky is sitting out
mobky has returned
supervaganj: folds 
Vamoclan: folds 
pj0901: raises 239492 to 244492 and is all-in
Proosty2: folds 
Uncalled bet (239492) returned to pj0901
pj0901 collected 15000 from pot
pj0901: doesn't show hand 
*** SUMMARY ***
Total pot 15000 | Rake 0 
Seat 1: lucaromanoo1 folded before Flop (didn't bet)
Seat 2: mobky folded before Flop (didn't bet)
Seat 3: supervaganj folded before Flop (didn't bet)
Seat 4: Vamoclan (button) folded before Flop (didn't bet)
Seat 5: pj0901 (small blind) collected (15000)
Seat 6: Proosty2 (big blind) folded before Flop
Seat 7: gibbo888 folded before Flop (didn't bet)
Seat 8: DR. ELDAR folded before Flop (didn't bet)

PokerStars Hand #251206999200: Tournament #3767885527, $40+$10+$5 USD Hold'em No Limit - Level XIX (2500/5000) - 2024/06/26 20:32:20 UTC [2024/06/26 16:32:20 ET]
Table '3767885527 93' 8-max Seat #5 is the button
Seat 1: lucaromanoo1 (223504 in chips) 
Seat 2: mobky (33627 in chips) 
Seat 3: supervaganj (120640 in chips) 
Seat 4: Vamoclan (49349 in chips) 
Seat 5: pj0901 (254492 in chips) 
Seat 6: Proosty2 (55978 in chips) 
Seat 7: gibbo888 (280616 in chips) 
Seat 8: DR. ELDAR (81516 in chips) 
lucaromanoo1: posts the ante 625
mobky: posts the ante 625
supervaganj: posts the ante 625
Vamoclan: posts the ante 625
pj0901: posts the ante 625
Proosty2: posts the ante 625
gibbo888: posts the ante 625
DR. ELDAR: posts the ante 625
Proosty2: posts small blind 2500
gibbo888: posts big blind 5000
*** HOLE CARDS ***
DR. ELDAR: folds 
lucaromanoo1: folds 
mobky: folds 
supervaganj: raises 5000 to 10000
Vamoclan: folds 
pj0901: raises 15000 to 25000
Proosty2: folds 
gibbo888: raises 250000 to 275000
supervaganj: folds 
pj0901: folds 
Uncalled bet (250000) returned to gibbo888
gibbo888 collected 67500 from pot
gibbo888: doesn't show hand 
*** SUMMARY ***
Total pot 67500 | Rake 0 
Seat 1: lucaromanoo1 folded before Flop (didn't bet)
Seat 2: mobky folded before Flop (didn't bet)
Seat 3: supervaganj folded before Flop
Seat 4: Vamoclan folded before Flop (didn't bet)
Seat 5: pj0901 (button) folded before Flop
Seat 6: Proosty2 (small blind) folded before Flop
Seat 7: gibbo888 (big blind) collected (67500)
Seat 8: DR. ELDAR folded before Flop (didn't bet)

PokerStars Hand #251207031999: Tournament #3767885527, $40+$10+$5 USD Hold'em No Limit - Level XIX (2500/5000) - 2024/06/26 20:34:17 UTC [2024/06/26 16:34:17 ET]
Table '3767885527 93' 8-max Seat #6 is the button
Seat 1: lucaromanoo1 (222879 in chips) 
Seat 2: mobky (33002 in chips) 
Seat 3: supervaganj (110015 in chips) 
Seat 4: Vamoclan (48724 in chips) 
Seat 5: pj0901 (228867 in chips) 
Seat 6: Proosty2 (52853 in chips) 
Seat 7: gibbo888 (322491 in chips) 
Seat 8: DR. ELDAR (80891 in chips) 
lucaromanoo1: posts the ante 625
mobky: posts the ante 625
supervaganj: posts the ante 625
Vamoclan: posts the ante 625
pj0901: posts the ante 625
Proosty2: posts the ante 625
gibbo888: posts the ante 625
DR. ELDAR: posts the ante 625
gibbo888: posts small blind 2500
DR. ELDAR: posts big blind 5000
*** HOLE CARDS ***
lucaromanoo1: raises 5000 to 10000
mobky: folds 
supervaganj: folds 
Vamoclan: folds 
pj0901: folds 
Proosty2: folds 
gibbo888: folds 
DR. ELDAR: folds 
Uncalled bet (5000) returned to lucaromanoo1
lucaromanoo1 collected 17500 from pot
lucaromanoo1: doesn't show hand 
*** SUMMARY ***
Total pot 17500 | Rake 0 
Seat 1: lucaromanoo1 collected (17500)
Seat 2: mobky folded before Flop (didn't bet)
Seat 3: supervaganj folded before Flop (didn't bet)
Seat 4: Vamoclan folded before Flop (didn't bet)
Seat 5: pj0901 folded before Flop (didn't bet)
Seat 6: Proosty2 (button) folded before Flop (didn't bet)
Seat 7: gibbo888 (small blind) folded before Flop
Seat 8: DR. ELDAR (big blind) folded before Flop

PokerStars Hand #251207037505: Tournament #3767885527, $40+$10+$5 USD Hold'em No Limit - Level XIX (2500/5000) - 2024/06/26 20:34:36 UTC [2024/06/26 16:34:36 ET]
Table '3767885527 93' 8-max Seat #7 is the button
Seat 1: lucaromanoo1 (234754 in chips) 
Seat 2: mobky (32377 in chips) 
Seat 3: supervaganj (109390 in chips) 
Seat 4: Vamoclan (48099 in chips) 
Seat 5: pj0901 (228242 in chips) 
Seat 6: Proosty2 (52228 in chips) 
Seat 7: gibbo888 (319366 in chips) 
Seat 8: DR. ELDAR (75266 in chips) 
lucaromanoo1: posts the ante 625
mobky: posts the ante 625
supervaganj: posts the ante 625
Vamoclan: posts the ante 625
pj0901: posts the ante 625
Proosty2: posts the ante 625
gibbo888: posts the ante 625
DR. ELDAR: posts the ante 625
DR. ELDAR: posts small blind 2500
lucaromanoo1: posts big blind 5000
*** HOLE CARDS ***
mobky: folds 
supervaganj: folds 
Vamoclan: folds 
pj0901: raises 5000 to 10000
Proosty2: folds 
gibbo888: folds 
DR. ELDAR: folds 
lucaromanoo1: calls 5000
*** FLOP *** [Kh 3h 5h]
lucaromanoo1: checks 
pj0901: checks 
*** TURN *** [Kh 3h 5h] [3d]
lucaromanoo1: bets 21175
pj0901: calls 21175
*** RIVER *** [Kh 3h 5h 3d] [2c]
lucaromanoo1: bets 70000
pj0901: calls 70000
*** SHOW DOWN ***
lucaromanoo1: shows [Jh 4h] (a flush, King high)
pj0901: mucks hand 
lucaromanoo1 collected 209850 from pot
*** SUMMARY ***
Total pot 209850 | Rake 0 
Board [Kh 3h 5h 3d 2c]
Seat 1: lucaromanoo1 (big blind) showed [Jh 4h] and won (209850) with a flush, King high
Seat 2: mobky folded before Flop (didn't bet)
Seat 3: supervaganj folded before Flop (didn't bet)
Seat 4: Vamoclan folded before Flop (didn't bet)
Seat 5: pj0901 mucked
Seat 6: Proosty2 folded before Flop (didn't bet)
Seat 7: gibbo888 (button) folded before Flop (didn't bet)
Seat 8: DR. ELDAR (small blind) folded before Flop

PokerStars Hand #251207057855: Tournament #3767885527, $40+$10+$5 USD Hold'em No Limit - Level XIX (2500/5000) - 2024/06/26 20:35:48 UTC [2024/06/26 16:35:48 ET]
Table '3767885527 93' 8-max Seat #8 is the button
Seat 1: lucaromanoo1 (342804 in chips) 
Seat 2: mobky (31752 in chips) 
Seat 3: supervaganj (108765 in chips) 
Seat 4: Vamoclan (47474 in chips) 
Seat 5: pj0901 (126442 in chips) 
Seat 6: Proosty2 (51603 in chips) 
Seat 7: gibbo888 (318741 in chips) 
Seat 8: DR. ELDAR (72141 in chips) 
lucaromanoo1: posts the ante 625
mobky: posts the ante 625
supervaganj: posts the ante 625
Vamoclan: posts the ante 625
pj0901: posts the ante 625
Proosty2: posts the ante 625
gibbo888: posts the ante 625
DR. ELDAR: posts the ante 625
lucaromanoo1: posts small blind 2500
mobky: posts big blind 5000
*** HOLE CARDS ***
supervaganj: folds 
Vamoclan: folds 
pj0901: folds 
Proosty2: folds 
gibbo888: folds 
DR. ELDAR: folds 
lucaromanoo1: raises 337179 to 342179 and is all-in
mobky: calls 26127 and is all-in
Uncalled bet (311052) returned to lucaromanoo1
*** FLOP *** [Td 3c 3s]
*** TURN *** [Td 3c 3s] [Th]
*** RIVER *** [Td 3c 3s Th] [Ks]
*** SHOW DOWN ***
lucaromanoo1: shows [8h Ah] (two pair, Tens and Threes)
mobky: shows [Kh 5h] (two pair, Kings and Tens)
mobky collected 67254 from pot
*** SUMMARY ***
Total pot 67254 | Rake 0 
Board [Td 3c 3s Th Ks]
Seat 1: lucaromanoo1 (small blind) showed [8h Ah] and lost with two pair, Tens and Threes
Seat 2: mobky (big blind) showed [Kh 5h] and won (67254) with two pair, Kings and Tens
Seat 3: supervaganj folded before Flop (didn't bet)
Seat 4: Vamoclan folded before Flop (didn't bet)
Seat 5: pj0901 folded before Flop (didn't bet)
Seat 6: Proosty2 folded before Flop (didn't bet)
Seat 7: gibbo888 folded before Flop (didn't bet)
Seat 8: DR. ELDAR (button) folded before Flop (didn't bet)

PokerStars Hand #251207066741: Tournament #3767885527, $40+$10+$5 USD Hold'em No Limit - Level XX (3000/6000) - 2024/06/26 20:36:19 UTC [2024/06/26 16:36:19 ET]
Table '3767885527 93' 8-max Seat #1 is the button
Seat 1: lucaromanoo1 (311052 in chips) 
Seat 2: mobky (67254 in chips) 
Seat 3: supervaganj (108140 in chips) 
Seat 4: Vamoclan (46849 in chips) 
Seat 5: pj0901 (125817 in chips) 
Seat 6: Proosty2 (50978 in chips) 
Seat 7: gibbo888 (318116 in chips) 
Seat 8: DR. ELDAR (71516 in chips) 
lucaromanoo1: posts the ante 750
mobky: posts the ante 750
supervaganj: posts the ante 750
Vamoclan: posts the ante 750
pj0901: posts the ante 750
Proosty2: posts the ante 750
gibbo888: posts the ante 750
DR. ELDAR: posts the ante 750
mobky: posts small blind 3000
supervaganj: posts big blind 6000
*** HOLE CARDS ***
Vamoclan: folds 
pj0901: folds 
Proosty2: folds 
gibbo888: folds 
DR. ELDAR: folds 
lucaromanoo1: raises 304302 to 310302 and is all-in
mobky: calls 63504 and is all-in
supervaganj: folds 
Uncalled bet (243798) returned to lucaromanoo1
*** FLOP *** [2h Ad 7s]
*** TURN *** [2h Ad 7s] [5s]
*** RIVER *** [2h Ad 7s 5s] [Jh]
*** SHOW DOWN ***
mobky: shows [Kc Ks] (a pair of Kings)
lucaromanoo1: shows [Ah 5c] (two pair, Aces and Fives)
lucaromanoo1 collected 145008 from pot
mobky finished the tournament in 283rd place and received $104.64.
*** SUMMARY ***
Total pot 145008 | Rake 0 
Board [2h Ad 7s 5s Jh]
Seat 1: lucaromanoo1 (button) showed [Ah 5c] and won (145008) with two pair, Aces and Fives
Seat 2: mobky (small blind) showed [Kc Ks] and lost with a pair of Kings
Seat 3: supervaganj (big blind) folded before Flop
Seat 4: Vamoclan folded before Flop (didn't bet)
Seat 5: pj0901 folded before Flop (didn't bet)
Seat 6: Proosty2 folded before Flop (didn't bet)
Seat 7: gibbo888 folded before Flop (didn't bet)
Seat 8: DR. ELDAR folded before Flop (didn't bet)

PokerStars Hand #251207074223: Tournament #3767885527, $40+$10+$5 USD Hold'em No Limit - Level XX (3000/6000) - 2024/06/26 20:36:46 UTC [2024/06/26 16:36:46 ET]
Table '3767885527 93' 8-max Seat #3 is the button
Seat 1: lucaromanoo1 (388806 in chips) 
Seat 3: supervaganj (101390 in chips) 
Seat 4: Vamoclan (46099 in chips) 
Seat 5: pj0901 (125067 in chips) 
Seat 6: Proosty2 (50228 in chips) 
Seat 7: gibbo888 (317366 in chips) 
Seat 8: DR. ELDAR (70766 in chips) 
lucaromanoo1: posts the ante 750
supervaganj: posts the ante 750
Vamoclan: posts the ante 750
pj0901: posts the ante 750
Proosty2: posts the ante 750
gibbo888: posts the ante 750
DR. ELDAR: posts the ante 750
Vamoclan: posts small blind 3000
pj0901: posts big blind 6000
*** HOLE CARDS ***
GUIDAASCANIO is disconnected 
Proosty2: folds 
gibbo888: folds 
DR. ELDAR: raises 64016 to 70016 and is all-in
lucaromanoo1: folds 
supervaganj: folds 
Vamoclan: folds 
pj0901: folds 
Uncalled bet (64016) returned to DR. ELDAR
DR. ELDAR collected 20250 from pot
DR. ELDAR: doesn't show hand 
*** SUMMARY ***
Total pot 20250 | Rake 0 
Seat 1: lucaromanoo1 folded before Flop (didn't bet)
Seat 3: supervaganj (button) folded before Flop (didn't bet)
Seat 4: Vamoclan (small blind) folded before Flop
Seat 5: pj0901 (big blind) folded before Flop
Seat 6: Proosty2 folded before Flop (didn't bet)
Seat 7: gibbo888 folded before Flop (didn't bet)
Seat 8: DR. ELDAR collected (20250)

PokerStars Hand #251207085166: Tournament #3767885527, $40+$10+$5 USD Hold'em No Limit - Level XX (3000/6000) - 2024/06/26 20:37:24 UTC [2024/06/26 16:37:24 ET]
Table '3767885527 93' 8-max Seat #4 is the button
Seat 1: lucaromanoo1 (388056 in chips) 
Seat 2: GUIDAASCANIO (100980 in chips) 
Seat 3: supervaganj (100640 in chips) 
Seat 4: Vamoclan (42349 in chips) 
Seat 5: pj0901 (118317 in chips) 
Seat 6: Proosty2 (49478 in chips) 
Seat 7: gibbo888 (316616 in chips) 
Seat 8: DR. ELDAR (84266 in chips) 
lucaromanoo1: posts the ante 750
GUIDAASCANIO: posts the ante 750
supervaganj: posts the ante 750
Vamoclan: posts the ante 750
pj0901: posts the ante 750
Proosty2: posts the ante 750
gibbo888: posts the ante 750
DR. ELDAR: posts the ante 750
pj0901: posts small blind 3000
Proosty2: posts big blind 6000
*** HOLE CARDS ***
gibbo888: folds 
DR. ELDAR: folds 
lucaromanoo1: folds 
GUIDAASCANIO: folds 
supervaganj: folds 
Vamoclan: raises 35599 to 41599 and is all-in
pj0901: folds 
Proosty2: folds 
Uncalled bet (35599) returned to Vamoclan
Vamoclan collected 21000 from pot
Vamoclan: doesn't show hand 
*** SUMMARY ***
Total pot 21000 | Rake 0 
Seat 1: lucaromanoo1 folded before Flop (didn't bet)
Seat 2: GUIDAASCANIO folded before Flop (didn't bet)
Seat 3: supervaganj folded before Flop (didn't bet)
Seat 4: Vamoclan (button) collected (21000)
Seat 5: pj0901 (small blind) folded before Flop
Seat 6: Proosty2 (big blind) folded before Flop
Seat 7: gibbo888 folded before Flop (didn't bet)
Seat 8: DR. ELDAR folded before Flop (didn't bet)

PokerStars Hand #251207090923: Tournament #3767885527, $40+$10+$5 USD Hold'em No Limit - Level XX (3000/6000) - 2024/06/26 20:37:45 UTC [2024/06/26 16:37:45 ET]
Table '3767885527 93' 8-max Seat #5 is the button
Seat 1: lucaromanoo1 (387306 in chips) 
Seat 2: GUIDAASCANIO (100230 in chips) 
Seat 3: supervaganj (99890 in chips) 
Seat 4: Vamoclan (56599 in chips) 
Seat 5: pj0901 (114567 in chips) 
Seat 6: Proosty2 (42728 in chips) 
Seat 7: gibbo888 (315866 in chips) 
Seat 8: DR. ELDAR (83516 in chips) 
lucaromanoo1: posts the ante 750
GUIDAASCANIO: posts the ante 750
supervaganj: posts the ante 750
Vamoclan: posts the ante 750
pj0901: posts the ante 750
Proosty2: posts the ante 750
gibbo888: posts the ante 750
DR. ELDAR: posts the ante 750
Proosty2: posts small blind 3000
gibbo888: posts big blind 6000
*** HOLE CARDS ***
DR. ELDAR: raises 6600 to 12600
lucaromanoo1: folds 
GUIDAASCANIO: folds 
supervaganj: folds 
Vamoclan: folds 
pj0901: raises 11400 to 24000
Proosty2: folds 
gibbo888: folds 
DR. ELDAR: calls 11400
*** FLOP *** [2d Jc 7h]
DR. ELDAR: checks 
pj0901: bets 6000
DR. ELDAR: calls 6000
*** TURN *** [2d Jc 7h] [7c]
DR. ELDAR: checks 
pj0901: bets 12750
DR. ELDAR: raises 40016 to 52766 and is all-in
pj0901: calls 40016
*** RIVER *** [2d Jc 7h 7c] [3s]
*** SHOW DOWN ***
DR. ELDAR: shows [As 5s] (a pair of Sevens)
pj0901: shows [8c 8s] (two pair, Eights and Sevens)
pj0901 collected 180532 from pot
DR. ELDAR finished the tournament in 267th place and received $104.64.
*** SUMMARY ***
Total pot 180532 | Rake 0 
Board [2d Jc 7h 7c 3s]
Seat 1: lucaromanoo1 folded before Flop (didn't bet)
Seat 2: GUIDAASCANIO folded before Flop (didn't bet)
Seat 3: supervaganj folded before Flop (didn't bet)
Seat 4: Vamoclan folded before Flop (didn't bet)
Seat 5: pj0901 (button) showed [8c 8s] and won (180532) with two pair, Eights and Sevens
Seat 6: Proosty2 (small blind) folded before Flop
Seat 7: gibbo888 (big blind) folded before Flop
Seat 8: DR. ELDAR showed [As 5s] and lost with a pair of Sevens

PokerStars Hand #251207105841: Tournament #3767885527, $40+$10+$5 USD Hold'em No Limit - Level XX (3000/6000) - 2024/06/26 20:38:38 UTC [2024/06/26 16:38:38 ET]
Table '3767885527 93' 8-max Seat #6 is the button
Seat 1: lucaromanoo1 (386556 in chips) 
Seat 2: GUIDAASCANIO (99480 in chips) 
Seat 3: supervaganj (99140 in chips) 
Seat 4: Vamoclan (55849 in chips) 
Seat 5: pj0901 (211583 in chips) 
Seat 6: Proosty2 (38978 in chips) 
Seat 7: gibbo888 (309116 in chips) 
lucaromanoo1: posts the ante 750
GUIDAASCANIO: posts the ante 750
supervaganj: posts the ante 750
Vamoclan: posts the ante 750
pj0901: posts the ante 750
Proosty2: posts the ante 750
gibbo888: posts the ante 750
gibbo888: posts small blind 3000
lucaromanoo1: posts big blind 6000
*** HOLE CARDS ***
GUIDAASCANIO: folds 
supervaganj: folds 
Vamoclan: folds 
pj0901: raises 6000 to 12000
mp5610 is disconnected 
Proosty2: folds 
gibbo888: folds 
lucaromanoo1: calls 6000
*** FLOP *** [Jd 4c 2s]
lucaromanoo1: checks 
pj0901: bets 8063
lucaromanoo1: calls 8063
*** TURN *** [Jd 4c 2s] [4s]
lucaromanoo1: bets 15480
pj0901: calls 15480
*** RIVER *** [Jd 4c 2s 4s] [6c]
lucaromanoo1: checks 
pj0901: checks 
*** SHOW DOWN ***
lucaromanoo1: shows [7c 7d] (two pair, Sevens and Fours)
pj0901: mucks hand 
lucaromanoo1 collected 79336 from pot
*** SUMMARY ***
Total pot 79336 | Rake 0 
Board [Jd 4c 2s 4s 6c]
Seat 1: lucaromanoo1 (big blind) showed [7c 7d] and won (79336) with two pair, Sevens and Fours
Seat 2: GUIDAASCANIO folded before Flop (didn't bet)
Seat 3: supervaganj folded before Flop (didn't bet)
Seat 4: Vamoclan folded before Flop (didn't bet)
Seat 5: pj0901 mucked
Seat 6: Proosty2 (button) folded before Flop (didn't bet)
Seat 7: gibbo888 (small blind) folded before Flop

PokerStars Hand #251207125161: Tournament #3767885527, $40+$10+$5 USD Hold'em No Limit - Level XX (3000/6000) - 2024/06/26 20:39:46 UTC [2024/06/26 16:39:46 ET]
Table '3767885527 93' 8-max Seat #7 is the button
Seat 1: lucaromanoo1 (429599 in chips) 
Seat 2: GUIDAASCANIO (98730 in chips) 
Seat 3: supervaganj (98390 in chips) 
Seat 4: Vamoclan (55099 in chips) 
Seat 5: pj0901 (175290 in chips) 
Seat 6: Proosty2 (38228 in chips) 
Seat 7: gibbo888 (305366 in chips) 
Seat 8: mp5610 (121000 in chips) out of hand (moved from another table into small blind)
mp5610 will be allowed to play after the button
lucaromanoo1: posts the ante 750
GUIDAASCANIO: posts the ante 750
supervaganj: posts the ante 750
Vamoclan: posts the ante 750
pj0901: posts the ante 750
Proosty2: posts the ante 750
gibbo888: posts the ante 750
lucaromanoo1: posts small blind 3000
GUIDAASCANIO: posts big blind 6000
*** HOLE CARDS ***
supervaganj: raises 6000 to 12000
Vamoclan: folds 
pj0901: folds 
Proosty2: folds 
gibbo888: folds 
lucaromanoo1: folds 
GUIDAASCANIO: calls 6000
*** FLOP *** [5d 2s Td]
GUIDAASCANIO: checks 
supervaganj: bets 10643
GUIDAASCANIO: folds 
Uncalled bet (10643) returned to supervaganj
supervaganj collected 32250 from pot
supervaganj: doesn't show hand 
*** SUMMARY ***
Total pot 32250 | Rake 0 
Board [5d 2s Td]
Seat 1: lucaromanoo1 (small blind) folded before Flop
Seat 2: GUIDAASCANIO (big blind) folded on the Flop
Seat 3: supervaganj collected (32250)
Seat 4: Vamoclan folded before Flop (didn't bet)
Seat 5: pj0901 folded before Flop (didn't bet)
Seat 6: Proosty2 folded before Flop (didn't bet)
Seat 7: gibbo888 (button) folded before Flop (didn't bet)

PokerStars Hand #251207133875: Tournament #3767885527, $40+$10+$5 USD Hold'em No Limit - Level XX (3000/6000) - 2024/06/26 20:40:17 UTC [2024/06/26 16:40:17 ET]
Table '3767885527 93' 8-max Seat #1 is the button
Seat 1: lucaromanoo1 (425849 in chips) 
Seat 2: GUIDAASCANIO (85980 in chips) 
Seat 3: supervaganj (117890 in chips) 
Seat 4: Vamoclan (54349 in chips) 
Seat 5: pj0901 (174540 in chips) 
Seat 6: Proosty2 (37478 in chips) 
Seat 7: gibbo888 (304616 in chips) 
Seat 8: mp5610 (121000 in chips) 
lucaromanoo1: posts the ante 750
GUIDAASCANIO: posts the ante 750
supervaganj: posts the ante 750
Vamoclan: posts the ante 750
pj0901: posts the ante 750
Proosty2: posts the ante 750
gibbo888: posts the ante 750
mp5610: posts the ante 750
GUIDAASCANIO: posts small blind 3000
supervaganj: posts big blind 6000
*** HOLE CARDS ***
Vamoclan: folds 
pj0901: raises 6000 to 12000
Proosty2: folds 
gibbo888: folds 
mp5610: folds 
lucaromanoo1: folds 
GUIDAASCANIO: folds 
supervaganj: calls 6000
*** FLOP *** [Th 7s 6h]
supervaganj: checks 
pj0901: bets 8250
supervaganj: calls 8250
*** TURN *** [Th 7s 6h] [Qh]
supervaganj: checks 
pj0901: bets 25800
supervaganj: folds 
Uncalled bet (25800) returned to pj0901
pj0901 collected 49500 from pot
pj0901: doesn't show hand 
*** SUMMARY ***
Total pot 49500 | Rake 0 
Board [Th 7s 6h Qh]
Seat 1: lucaromanoo1 (button) folded before Flop (didn't bet)
Seat 2: GUIDAASCANIO (small blind) folded before Flop
Seat 3: supervaganj (big blind) folded on the Turn
Seat 4: Vamoclan folded before Flop (didn't bet)
Seat 5: pj0901 collected (49500)
Seat 6: Proosty2 folded before Flop (didn't bet)
Seat 7: gibbo888 folded before Flop (didn't bet)
Seat 8: mp5610 folded before Flop (didn't bet)

PokerStars Hand #251207150019: Tournament #3767885527, $40+$10+$5 USD Hold'em No Limit - Level XX (3000/6000) - 2024/06/26 20:41:15 UTC [2024/06/26 16:41:15 ET]
Table '3767885527 93' 8-max Seat #2 is the button
Seat 1: lucaromanoo1 (425099 in chips) 
Seat 2: GUIDAASCANIO (82230 in chips) 
Seat 3: supervaganj (96890 in chips) 
Seat 4: Vamoclan (53599 in chips) 
Seat 5: pj0901 (203040 in chips) 
Seat 6: Proosty2 (36728 in chips) 
Seat 7: gibbo888 (303866 in chips) 
Seat 8: mp5610 (120250 in chips) 
lucaromanoo1: posts the ante 750
GUIDAASCANIO: posts the ante 750
supervaganj: posts the ante 750
Vamoclan: posts the ante 750
pj0901: posts the ante 750
Proosty2: posts the ante 750
gibbo888: posts the ante 750
mp5610: posts the ante 750
supervaganj: posts small blind 3000
Vamoclan: posts big blind 6000
*** HOLE CARDS ***
pj0901 has timed out
pj0901: folds 
pj0901 is sitting out
Proosty2: folds 
gibbo888: raises 6000 to 12000
mp5610: folds 
pj0901 has returned
lucaromanoo1: calls 12000
GUIDAASCANIO: folds 
supervaganj: folds 
Vamoclan: folds 
*** FLOP *** [7d 5d 4d]
gibbo888: bets 26130
lucaromanoo1: calls 26130
*** TURN *** [7d 5d 4d] [Ad]
gibbo888: checks 
lucaromanoo1: checks 
*** RIVER *** [7d 5d 4d Ad] [Kh]
gibbo888: checks 
lucaromanoo1: bets 50193
gibbo888: calls 50193
*** SHOW DOWN ***
lucaromanoo1: shows [Ah Jd] (a flush, Ace high)
gibbo888: mucks hand 
lucaromanoo1 collected 191646 from pot
*** SUMMARY ***
Total pot 191646 | Rake 0 
Board [7d 5d 4d Ad Kh]
Seat 1: lucaromanoo1 showed [Ah Jd] and won (191646) with a flush, Ace high
Seat 2: GUIDAASCANIO (button) folded before Flop (didn't bet)
Seat 3: supervaganj (small blind) folded before Flop
Seat 4: Vamoclan (big blind) folded before Flop
Seat 5: pj0901 folded before Flop (didn't bet)
Seat 6: Proosty2 folded before Flop (didn't bet)
Seat 7: gibbo888 mucked
Seat 8: mp5610 folded before Flop (didn't bet)

PokerStars Hand #251207173831: Tournament #3767885527, $40+$10+$5 USD Hold'em No Limit - Level XX (3000/6000) - 2024/06/26 20:42:41 UTC [2024/06/26 16:42:41 ET]
Table '3767885527 93' 8-max Seat #3 is the button
Seat 1: lucaromanoo1 (527672 in chips) 
Seat 2: GUIDAASCANIO (81480 in chips) 
Seat 3: supervaganj (93140 in chips) 
Seat 4: Vamoclan (46849 in chips) 
Seat 5: pj0901 (202290 in chips) 
Seat 6: Proosty2 (35978 in chips) 
Seat 7: gibbo888 (214793 in chips) 
Seat 8: mp5610 (119500 in chips) 
lucaromanoo1: posts the ante 750
GUIDAASCANIO: posts the ante 750
supervaganj: posts the ante 750
Vamoclan: posts the ante 750
pj0901: posts the ante 750
Proosty2: posts the ante 750
gibbo888: posts the ante 750
mp5610: posts the ante 750
Vamoclan: posts small blind 3000
pj0901: posts big blind 6000
*** HOLE CARDS ***
Proosty2: folds 
gibbo888: folds 
mp5610: folds 
lucaromanoo1: folds 
GUIDAASCANIO: folds 
supervaganj: raises 6000 to 12000
Vamoclan: folds 
pj0901: raises 189540 to 201540 and is all-in
supervaganj: folds 
Uncalled bet (189540) returned to pj0901
pj0901 collected 33000 from pot
pj0901: doesn't show hand 
*** SUMMARY ***
Total pot 33000 | Rake 0 
Seat 1: lucaromanoo1 folded before Flop (didn't bet)
Seat 2: GUIDAASCANIO folded before Flop (didn't bet)
Seat 3: supervaganj (button) folded before Flop
Seat 4: Vamoclan (small blind) folded before Flop
Seat 5: pj0901 (big blind) collected (33000)
Seat 6: Proosty2 folded before Flop (didn't bet)
Seat 7: gibbo888 folded before Flop (didn't bet)
Seat 8: mp5610 folded before Flop (didn't bet)

PokerStars Hand #251207185765: Tournament #3767885527, $40+$10+$5 USD Hold'em No Limit - Level XX (3000/6000) - 2024/06/26 20:43:24 UTC [2024/06/26 16:43:24 ET]
Table '3767885527 93' 8-max Seat #4 is the button
Seat 1: lucaromanoo1 (526922 in chips) 
Seat 2: GUIDAASCANIO (80730 in chips) 
Seat 3: supervaganj (80390 in chips) 
Seat 4: Vamoclan (43099 in chips) 
Seat 5: pj0901 (222540 in chips) 
Seat 6: Proosty2 (35228 in chips) 
Seat 7: gibbo888 (214043 in chips) 
Seat 8: mp5610 (118750 in chips) 
lucaromanoo1: posts the ante 750
GUIDAASCANIO: posts the ante 750
supervaganj: posts the ante 750
Vamoclan: posts the ante 750
pj0901: posts the ante 750
Proosty2: posts the ante 750
gibbo888: posts the ante 750
mp5610: posts the ante 750
pj0901: posts small blind 3000
Proosty2: posts big blind 6000
*** HOLE CARDS ***
gibbo888: folds 
mp5610: folds 
lucaromanoo1: folds 
GUIDAASCANIO: folds 
supervaganj: folds 
Vamoclan: folds 
pj0901: raises 36000 to 42000
Proosty2: calls 28478 and is all-in
Uncalled bet (7522) returned to pj0901
*** FLOP *** [6h Jd 9c]
*** TURN *** [6h Jd 9c] [7c]
*** RIVER *** [6h Jd 9c 7c] [Jh]
*** SHOW DOWN ***
pj0901: shows [3h Kh] (a pair of Jacks)
Proosty2: shows [Qd Qh] (two pair, Queens and Jacks)
Proosty2 collected 74956 from pot
*** SUMMARY ***
Total pot 74956 | Rake 0 
Board [6h Jd 9c 7c Jh]
Seat 1: lucaromanoo1 folded before Flop (didn't bet)
Seat 2: GUIDAASCANIO folded before Flop (didn't bet)
Seat 3: supervaganj folded before Flop (didn't bet)
Seat 4: Vamoclan (button) folded before Flop (didn't bet)
Seat 5: pj0901 (small blind) showed [3h Kh] and lost with a pair of Jacks
Seat 6: Proosty2 (big blind) showed [Qd Qh] and won (74956) with two pair, Queens and Jacks
Seat 7: gibbo888 folded before Flop (didn't bet)
Seat 8: mp5610 folded before Flop (didn't bet)

PokerStars Hand #251207195393: Tournament #3767885527, $40+$10+$5 USD Hold'em No Limit - Level XX (3000/6000) - 2024/06/26 20:44:00 UTC [2024/06/26 16:44:00 ET]
Table '3767885527 93' 8-max Seat #5 is the button
Seat 1: lucaromanoo1 (526172 in chips) 
Seat 2: GUIDAASCANIO (79980 in chips) 
Seat 3: supervaganj (79640 in chips) 
Seat 4: Vamoclan (42349 in chips) 
Seat 5: pj0901 (187312 in chips) 
Seat 6: Proosty2 (74956 in chips) 
Seat 7: gibbo888 (213293 in chips) 
Seat 8: mp5610 (118000 in chips) 
lucaromanoo1: posts the ante 750
GUIDAASCANIO: posts the ante 750
supervaganj: posts the ante 750
Vamoclan: posts the ante 750
pj0901: posts the ante 750
Proosty2: posts the ante 750
gibbo888: posts the ante 750
mp5610: posts the ante 750
Proosty2: posts small blind 3000
gibbo888: posts big blind 6000
*** HOLE CARDS ***
mp5610: folds 
lucaromanoo1: folds 
GUIDAASCANIO: folds 
supervaganj: folds 
Vamoclan: folds 
pj0901: folds 
Proosty2: raises 68206 to 74206 and is all-in
gibbo888: calls 68206
*** FLOP *** [2s Js 9c]
*** TURN *** [2s Js 9c] [Ah]
*** RIVER *** [2s Js 9c Ah] [Jh]
*** SHOW DOWN ***
Proosty2: shows [4c Kd] (a pair of Jacks)
gibbo888: shows [Ac Jc] (a full house, Jacks full of Aces)
gibbo888 collected 154412 from pot
Proosty2 finished the tournament in 226th place and received $115.10.
*** SUMMARY ***
Total pot 154412 | Rake 0 
Board [2s Js 9c Ah Jh]
Seat 1: lucaromanoo1 folded before Flop (didn't bet)
Seat 2: GUIDAASCANIO folded before Flop (didn't bet)
Seat 3: supervaganj folded before Flop (didn't bet)
Seat 4: Vamoclan folded before Flop (didn't bet)
Seat 5: pj0901 (button) folded before Flop (didn't bet)
Seat 6: Proosty2 (small blind) showed [4c Kd] and lost with a pair of Jacks
Seat 7: gibbo888 (big blind) showed [Ac Jc] and won (154412) with a full house, Jacks full of Aces
Seat 8: mp5610 folded before Flop (didn't bet)

PokerStars Hand #251207203599: Tournament #3767885527, $40+$10+$5 USD Hold'em No Limit - Level XX (3000/6000) - 2024/06/26 20:44:30 UTC [2024/06/26 16:44:30 ET]
Table '3767885527 93' 8-max Seat #7 is the button
Seat 1: lucaromanoo1 (525422 in chips) 
Seat 2: GUIDAASCANIO (79230 in chips) 
Seat 3: supervaganj (78890 in chips) 
Seat 4: Vamoclan (41599 in chips) 
Seat 5: pj0901 (186562 in chips) 
Seat 7: gibbo888 (292749 in chips) 
Seat 8: mp5610 (117250 in chips) 
lucaromanoo1: posts the ante 750
GUIDAASCANIO: posts the ante 750
supervaganj: posts the ante 750
Vamoclan: posts the ante 750
pj0901: posts the ante 750
gibbo888: posts the ante 750
mp5610: posts the ante 750
mp5610: posts small blind 3000
lucaromanoo1: posts big blind 6000
*** HOLE CARDS ***
GUIDAASCANIO: folds 
supervaganj: folds 
Vamoclan: raises 34849 to 40849 and is all-in
pj0901: folds 
gibbo888: folds 
Biguethi339 is disconnected 
mp5610: folds 
lucaromanoo1: folds 
Uncalled bet (34849) returned to Vamoclan
Vamoclan collected 20250 from pot
Vamoclan: doesn't show hand 
*** SUMMARY ***
Total pot 20250 | Rake 0 
Seat 1: lucaromanoo1 (big blind) folded before Flop
Seat 2: GUIDAASCANIO folded before Flop (didn't bet)
Seat 3: supervaganj folded before Flop (didn't bet)
Seat 4: Vamoclan collected (20250)
Seat 5: pj0901 folded before Flop (didn't bet)
Seat 7: gibbo888 (button) folded before Flop (didn't bet)
Seat 8: mp5610 (small blind) folded before Flop

PokerStars Hand #251207210628: Tournament #3767885527, $40+$10+$5 USD Hold'em No Limit - Level XX (3000/6000) - 2024/06/26 20:44:56 UTC [2024/06/26 16:44:56 ET]
Table '3767885527 93' 8-max Seat #8 is the button
Seat 1: lucaromanoo1 (518672 in chips) 
Seat 2: GUIDAASCANIO (78480 in chips) 
Seat 3: supervaganj (78140 in chips) 
Seat 4: Vamoclan (55099 in chips) 
Seat 5: pj0901 (185812 in chips) 
Seat 6: Biguethi339 (231272 in chips) 
Seat 7: gibbo888 (291999 in chips) 
Seat 8: mp5610 (113500 in chips) 
lucaromanoo1: posts the ante 750
GUIDAASCANIO: posts the ante 750
supervaganj: posts the ante 750
Vamoclan: posts the ante 750
pj0901: posts the ante 750
Biguethi339: posts the ante 750
gibbo888: posts the ante 750
mp5610: posts the ante 750
lucaromanoo1: posts small blind 3000
GUIDAASCANIO: posts big blind 6000
*** HOLE CARDS ***
supervaganj: folds 
Vamoclan: raises 48349 to 54349 and is all-in
pj0901: folds 
Biguethi339: folds 
gibbo888: folds 
mp5610 has timed out
mp5610: folds 
mp5610 is sitting out
lucaromanoo1: folds 
mp5610 has returned
GUIDAASCANIO: folds 
Uncalled bet (48349) returned to Vamoclan
Vamoclan collected 21000 from pot
Vamoclan: doesn't show hand 
*** SUMMARY ***
Total pot 21000 | Rake 0 
Seat 1: lucaromanoo1 (small blind) folded before Flop
Seat 2: GUIDAASCANIO (big blind) folded before Flop
Seat 3: supervaganj folded before Flop (didn't bet)
Seat 4: Vamoclan collected (21000)
Seat 5: pj0901 folded before Flop (didn't bet)
Seat 6: Biguethi339 folded before Flop (didn't bet)
Seat 7: gibbo888 folded before Flop (didn't bet)
Seat 8: mp5610 (button) folded before Flop (didn't bet)

PokerStars Hand #251207225080: Tournament #3767885527, $40+$10+$5 USD Hold'em No Limit - Level XX (3000/6000) - 2024/06/26 20:45:48 UTC [2024/06/26 16:45:48 ET]
Table '3767885527 93' 8-max Seat #1 is the button
Seat 1: lucaromanoo1 (514922 in chips) 
Seat 2: GUIDAASCANIO (71730 in chips) 
Seat 3: supervaganj (77390 in chips) 
Seat 4: Vamoclan (69349 in chips) 
Seat 5: pj0901 (185062 in chips) 
Seat 6: Biguethi339 (230522 in chips) 
Seat 7: gibbo888 (291249 in chips) 
Seat 8: mp5610 (112750 in chips) 
lucaromanoo1: posts the ante 750
GUIDAASCANIO: posts the ante 750
supervaganj: posts the ante 750
Vamoclan: posts the ante 750
pj0901: posts the ante 750
Biguethi339: posts the ante 750
gibbo888: posts the ante 750
mp5610: posts the ante 750
GUIDAASCANIO: posts small blind 3000
supervaganj: posts big blind 6000
*** HOLE CARDS ***
Vamoclan: folds 
pj0901: folds 
Biguethi339: folds 
gibbo888: folds 
mp5610: raises 6000 to 12000
lucaromanoo1: raises 502172 to 514172 and is all-in
GUIDAASCANIO: folds 
supervaganj: folds 
mp5610: folds 
Uncalled bet (502172) returned to lucaromanoo1
lucaromanoo1 collected 39000 from pot
lucaromanoo1: doesn't show hand 
*** SUMMARY ***
Total pot 39000 | Rake 0 
Seat 1: lucaromanoo1 (button) collected (39000)
Seat 2: GUIDAASCANIO (small blind) folded before Flop
Seat 3: supervaganj (big blind) folded before Flop
Seat 4: Vamoclan folded before Flop (didn't bet)
Seat 5: pj0901 folded before Flop (didn't bet)
Seat 6: Biguethi339 folded before Flop (didn't bet)
Seat 7: gibbo888 folded before Flop (didn't bet)
Seat 8: mp5610 folded before Flop

PokerStars Hand #251207233575: Tournament #3767885527, $40+$10+$5 USD Hold'em No Limit - Level XXI (3500/7000) - 2024/06/26 20:46:19 UTC [2024/06/26 16:46:19 ET]
Table '3767885527 93' 8-max Seat #2 is the button
Seat 1: lucaromanoo1 (541172 in chips) 
Seat 2: GUIDAASCANIO (67980 in chips) 
Seat 3: supervaganj (70640 in chips) 
Seat 4: Vamoclan (68599 in chips) 
Seat 5: pj0901 (184312 in chips) 
Seat 6: Biguethi339 (229772 in chips) 
Seat 7: gibbo888 (290499 in chips) 
Seat 8: mp5610 (100000 in chips) 
lucaromanoo1: posts the ante 875
GUIDAASCANIO: posts the ante 875
supervaganj: posts the ante 875
Vamoclan: posts the ante 875
pj0901: posts the ante 875
Biguethi339: posts the ante 875
gibbo888: posts the ante 875
mp5610: posts the ante 875
supervaganj: posts small blind 3500
Vamoclan: posts big blind 7000
*** HOLE CARDS ***
pj0901: folds 
Biguethi339: raises 7000 to 14000
gibbo888: folds 
mp5610: folds 
lucaromanoo1: folds 
GUIDAASCANIO: folds 
supervaganj: raises 55765 to 69765 and is all-in
Vamoclan: folds 
Biguethi339: calls 55765
*** FLOP *** [9s 6h Tc]
*** TURN *** [9s 6h Tc] [Ac]
*** RIVER *** [9s 6h Tc Ac] [4s]
*** SHOW DOWN ***
supervaganj: shows [Kc Qd] (high card Ace)
Biguethi339: shows [9d Td] (two pair, Tens and Nines)
Biguethi339 collected 153530 from pot
supervaganj finished the tournament in 211th place and received $115.10.
*** SUMMARY ***
Total pot 153530 | Rake 0 
Board [9s 6h Tc Ac 4s]
Seat 1: lucaromanoo1 folded before Flop (didn't bet)
Seat 2: GUIDAASCANIO (button) folded before Flop (didn't bet)
Seat 3: supervaganj (small blind) showed [Kc Qd] and lost with high card Ace
Seat 4: Vamoclan (big blind) folded before Flop
Seat 5: pj0901 folded before Flop (didn't bet)
Seat 6: Biguethi339 showed [9d Td] and won (153530) with two pair, Tens and Nines
Seat 7: gibbo888 folded before Flop (didn't bet)
Seat 8: mp5610 folded before Flop (didn't bet)

PokerStars Hand #251207250235: Tournament #3767885527, $40+$10+$5 USD Hold'em No Limit - Level XXI (3500/7000) - 2024/06/26 20:47:19 UTC [2024/06/26 16:47:19 ET]
Table '3767885527 93' 8-max Seat #4 is the button
Seat 1: lucaromanoo1 (540297 in chips) 
Seat 2: GUIDAASCANIO (67105 in chips) 
Seat 4: Vamoclan (60724 in chips) 
Seat 5: pj0901 (183437 in chips) 
Seat 6: Biguethi339 (312662 in chips) 
Seat 7: gibbo888 (289624 in chips) 
Seat 8: mp5610 (99125 in chips) 
lucaromanoo1: posts the ante 875
GUIDAASCANIO: posts the ante 875
Vamoclan: posts the ante 875
pj0901: posts the ante 875
Biguethi339: posts the ante 875
gibbo888: posts the ante 875
mp5610: posts the ante 875
pj0901: posts small blind 3500
Biguethi339: posts big blind 7000
*** HOLE CARDS ***
gibbo888: folds 
mp5610: folds 
lucaromanoo1: folds 
GUIDAASCANIO: folds 
Vamoclan: folds 
pj0901: raises 16100 to 23100
Biguethi339: calls 16100
*** FLOP *** [4h 7d 4d]
pj0901: bets 10500
Biguethi339: calls 10500
*** TURN *** [4h 7d 4d] [Ts]
pj0901: checks 
Biguethi339: checks 
*** RIVER *** [4h 7d 4d Ts] [9d]
pj0901: bets 17500
Biguethi339: folds 
Uncalled bet (17500) returned to pj0901
pj0901 collected 73325 from pot
pj0901: doesn't show hand 
*** SUMMARY ***
Total pot 73325 | Rake 0 
Board [4h 7d 4d Ts 9d]
Seat 1: lucaromanoo1 folded before Flop (didn't bet)
Seat 2: GUIDAASCANIO folded before Flop (didn't bet)
Seat 4: Vamoclan (button) folded before Flop (didn't bet)
Seat 5: pj0901 (small blind) collected (73325)
Seat 6: Biguethi339 (big blind) folded on the River
Seat 7: gibbo888 folded before Flop (didn't bet)
Seat 8: mp5610 folded before Flop (didn't bet)

PokerStars Hand #251207275179: Tournament #3767885527, $40+$10+$5 USD Hold'em No Limit - Level XXI (3500/7000) - 2024/06/26 20:48:50 UTC [2024/06/26 16:48:50 ET]
Table '3767885527 93' 8-max Seat #5 is the button
Seat 1: lucaromanoo1 (539422 in chips) 
Seat 2: GUIDAASCANIO (66230 in chips) 
Seat 4: Vamoclan (59849 in chips) 
Seat 5: pj0901 (222287 in chips) 
Seat 6: Biguethi339 (278187 in chips) 
Seat 7: gibbo888 (288749 in chips) 
Seat 8: mp5610 (98250 in chips) 
lucaromanoo1: posts the ante 875
GUIDAASCANIO: posts the ante 875
Vamoclan: posts the ante 875
pj0901: posts the ante 875
Biguethi339: posts the ante 875
gibbo888: posts the ante 875
mp5610: posts the ante 875
Biguethi339: posts small blind 3500
gibbo888: posts big blind 7000
*** HOLE CARDS ***
mp5610: folds 
lucaromanoo1: folds 
GUIDAASCANIO: raises 49000 to 56000
Lenon318 is disconnected 
Vamoclan: folds 
pj0901: folds 
Biguethi339: folds 
gibbo888: folds 
Uncalled bet (49000) returned to GUIDAASCANIO
GUIDAASCANIO collected 23625 from pot
GUIDAASCANIO: doesn't show hand 
*** SUMMARY ***
Total pot 23625 | Rake 0 
Seat 1: lucaromanoo1 folded before Flop (didn't bet)
Seat 2: GUIDAASCANIO collected (23625)
Seat 4: Vamoclan folded before Flop (didn't bet)
Seat 5: pj0901 (button) folded before Flop (didn't bet)
Seat 6: Biguethi339 (small blind) folded before Flop
Seat 7: gibbo888 (big blind) folded before Flop
Seat 8: mp5610 folded before Flop (didn't bet)

PokerStars Hand #251207281379: Tournament #3767885527, $40+$10+$5 USD Hold'em No Limit - Level XXI (3500/7000) - 2024/06/26 20:49:13 UTC [2024/06/26 16:49:13 ET]
Table '3767885527 93' 8-max Seat #6 is the button
Seat 1: lucaromanoo1 (538547 in chips) 
Seat 2: GUIDAASCANIO (81980 in chips) 
Seat 3: Lenon318 (58738 in chips) 
Seat 4: Vamoclan (58974 in chips) 
Seat 5: pj0901 (221412 in chips) 
Seat 6: Biguethi339 (273812 in chips) 
Seat 7: gibbo888 (280874 in chips) 
Seat 8: mp5610 (97375 in chips) 
lucaromanoo1: posts the ante 875
GUIDAASCANIO: posts the ante 875
Lenon318: posts the ante 875
Vamoclan: posts the ante 875
pj0901: posts the ante 875
Biguethi339: posts the ante 875
gibbo888: posts the ante 875
mp5610: posts the ante 875
gibbo888: posts small blind 3500
mp5610: posts big blind 7000
*** HOLE CARDS ***
lucaromanoo1: folds 
GUIDAASCANIO: folds 
Lenon318: folds 
Vamoclan: folds 
pj0901: raises 7000 to 14000
Biguethi339: folds 
gibbo888: folds 
mp5610: raises 82500 to 96500 and is all-in
pj0901: folds 
Uncalled bet (82500) returned to mp5610
mp5610 collected 38500 from pot
*** SUMMARY ***
Total pot 38500 | Rake 0 
Seat 1: lucaromanoo1 folded before Flop (didn't bet)
Seat 2: GUIDAASCANIO folded before Flop (didn't bet)
Seat 3: Lenon318 folded before Flop (didn't bet)
Seat 4: Vamoclan folded before Flop (didn't bet)
Seat 5: pj0901 folded before Flop
Seat 6: Biguethi339 (button) folded before Flop (didn't bet)
Seat 7: gibbo888 (small blind) folded before Flop
Seat 8: mp5610 (big blind) collected (38500)

PokerStars Hand #251207289474: Tournament #3767885527, $40+$10+$5 USD Hold'em No Limit - Level XXI (3500/7000) - 2024/06/26 20:49:42 UTC [2024/06/26 16:49:42 ET]
Table '3767885527 93' 8-max Seat #7 is the button
Seat 1: lucaromanoo1 (537672 in chips) 
Seat 2: GUIDAASCANIO (81105 in chips) 
Seat 3: Lenon318 (57863 in chips) 
Seat 4: Vamoclan (58099 in chips) 
Seat 5: pj0901 (206537 in chips) 
Seat 6: Biguethi339 (272937 in chips) 
Seat 7: gibbo888 (276499 in chips) 
Seat 8: mp5610 (121000 in chips) 
lucaromanoo1: posts the ante 875
GUIDAASCANIO: posts the ante 875
Lenon318: posts the ante 875
Vamoclan: posts the ante 875
pj0901: posts the ante 875
Biguethi339: posts the ante 875
gibbo888: posts the ante 875
mp5610: posts the ante 875
mp5610: posts small blind 3500
lucaromanoo1: posts big blind 7000
*** HOLE CARDS ***
GUIDAASCANIO: folds 
Lenon318: folds 
Vamoclan: folds 
pj0901: raises 7000 to 14000
Biguethi339: raises 24500 to 38500
gibbo888: folds 
mp5610: folds 
lucaromanoo1: folds 
pj0901: raises 167162 to 205662 and is all-in
Biguethi339: calls 167162
*** FLOP *** [4h 6c 3s]
*** TURN *** [4h 6c 3s] [Tc]
*** RIVER *** [4h 6c 3s Tc] [8h]
*** SHOW DOWN ***
pj0901: shows [As Qh] (high card Ace)
Biguethi339: shows [Ks Kh] (a pair of Kings)
Biguethi339 collected 428824 from pot
pj0901 finished the tournament in 203rd place and received $115.10.
*** SUMMARY ***
Total pot 428824 | Rake 0 
Board [4h 6c 3s Tc 8h]
Seat 1: lucaromanoo1 (big blind) folded before Flop
Seat 2: GUIDAASCANIO folded before Flop (didn't bet)
Seat 3: Lenon318 folded before Flop (didn't bet)
Seat 4: Vamoclan folded before Flop (didn't bet)
Seat 5: pj0901 showed [As Qh] and lost with high card Ace
Seat 6: Biguethi339 showed [Ks Kh] and won (428824) with a pair of Kings
Seat 7: gibbo888 (button) folded before Flop (didn't bet)
Seat 8: mp5610 (small blind) folded before Flop

PokerStars Hand #251207302695: Tournament #3767885527, $40+$10+$5 USD Hold'em No Limit - Level XXI (3500/7000) - 2024/06/26 20:50:32 UTC [2024/06/26 16:50:32 ET]
Table '3767885527 93' 8-max Seat #8 is the button
Seat 1: lucaromanoo1 (529797 in chips) 
Seat 2: GUIDAASCANIO (80230 in chips) 
Seat 3: Lenon318 (56988 in chips) 
Seat 4: Vamoclan (57224 in chips) 
Seat 6: Biguethi339 (495224 in chips) 
Seat 7: gibbo888 (275624 in chips) 
Seat 8: mp5610 (116625 in chips) 
lucaromanoo1: posts the ante 875
GUIDAASCANIO: posts the ante 875
Lenon318: posts the ante 875
Vamoclan: posts the ante 875
Biguethi339: posts the ante 875
gibbo888: posts the ante 875
mp5610: posts the ante 875
lucaromanoo1: posts small blind 3500
GUIDAASCANIO: posts big blind 7000
*** HOLE CARDS ***
Lenon318: folds 
Vamoclan: raises 49349 to 56349 and is all-in
Biguethi339: folds 
gibbo888: folds 
mp5610: folds 
lucaromanoo1: raises 49349 to 105698
GUIDAASCANIO: folds 
Uncalled bet (49349) returned to lucaromanoo1
*** FLOP *** [5c As Th]
*** TURN *** [5c As Th] [7c]
*** RIVER *** [5c As Th 7c] [Kc]
*** SHOW DOWN ***
lucaromanoo1: shows [8d Ad] (a pair of Aces)
Vamoclan: shows [Kh Qs] (a pair of Kings)
lucaromanoo1 collected 125823 from pot
Vamoclan finished the tournament in 201st place and received $115.10.
*** SUMMARY ***
Total pot 125823 | Rake 0 
Board [5c As Th 7c Kc]
Seat 1: lucaromanoo1 (small blind) showed [8d Ad] and won (125823) with a pair of Aces
Seat 2: GUIDAASCANIO (big blind) folded before Flop
Seat 3: Lenon318 folded before Flop (didn't bet)
Seat 4: Vamoclan showed [Kh Qs] and lost with a pair of Kings
Seat 6: Biguethi339 folded before Flop (didn't bet)
Seat 7: gibbo888 folded before Flop (didn't bet)
Seat 8: mp5610 (button) folded before Flop (didn't bet)


PokerStars Hand #251205833491: Tournament #3767885527, $40+$10+$5 USD Hold'em No Limit - Level XIII (800/1600) - 2024/06/26 19:21:07 UTC [2024/06/26 15:21:07 ET]
Table '3767885527 92' 8-max Seat #7 is the button
Seat 1: SOUFODAMS (112349 in chips) 
Seat 2: Mr Pay Shent (39982 in chips) 
Seat 3: Pseudo Fruto (57997 in chips) 
Seat 4: RenanToniolo (132439 in chips) 
Seat 5: milkytravis (43402 in chips) 
Seat 6: sunn¥m4nn (44950 in chips) 
Seat 7: podiiii (48875 in chips) 
Seat 8: EDY R44 (36817 in chips) 
SOUFODAMS: posts the ante 200
Mr Pay Shent: posts the ante 200
Pseudo Fruto: posts the ante 200
RenanToniolo: posts the ante 200
milkytravis: posts the ante 200
sunn¥m4nn: posts the ante 200
podiiii: posts the ante 200
EDY R44: posts the ante 200
EDY R44: posts small blind 800
SOUFODAMS: posts big blind 1600
*** HOLE CARDS ***
Mr Pay Shent: folds 
Pseudo Fruto: raises 1600 to 3200
RenanToniolo: folds 
milkytravis: folds 
sunn¥m4nn: folds 
podiiii: folds 
EDY R44: calls 2400
SOUFODAMS: calls 1600
*** FLOP *** [2h Ac Ah]
EDY R44: checks 
SOUFODAMS: checks 
Pseudo Fruto: bets 3024
EDY R44: raises 3024 to 6048
SOUFODAMS: folds 
Pseudo Fruto: raises 5152 to 11200
EDY R44: raises 22217 to 33417 and is all-in
Pseudo Fruto: calls 22217
*** TURN *** [2h Ac Ah] [7d]
*** RIVER *** [2h Ac Ah 7d] [8s]
*** SHOW DOWN ***
EDY R44: shows [6s 7s] (two pair, Aces and Sevens)
Pseudo Fruto: shows [Jc As] (three of a kind, Aces)
Pseudo Fruto collected 78034 from pot
EDY R44 finished the tournament
*** SUMMARY ***
Total pot 78034 | Rake 0 
Board [2h Ac Ah 7d 8s]
Seat 1: SOUFODAMS (big blind) folded on the Flop
Seat 2: Mr Pay Shent folded before Flop (didn't bet)
Seat 3: Pseudo Fruto showed [Jc As] and won (78034) with three of a kind, Aces
Seat 4: RenanToniolo folded before Flop (didn't bet)
Seat 5: milkytravis folded before Flop (didn't bet)
Seat 6: sunn¥m4nn folded before Flop (didn't bet)
Seat 7: podiiii (button) folded before Flop (didn't bet)
Seat 8: EDY R44 (small blind) showed [6s 7s] and lost with two pair, Aces and Sevens

PokerStars Hand #251205863449: Tournament #3767885527, $40+$10+$5 USD Hold'em No Limit - Level XIII (800/1600) - 2024/06/26 19:22:57 UTC [2024/06/26 15:22:57 ET]
Table '3767885527 92' 8-max Seat #1 is the button
Seat 1: SOUFODAMS (108949 in chips) 
Seat 2: Mr Pay Shent (39782 in chips) 
Seat 3: Pseudo Fruto (99214 in chips) 
Seat 4: RenanToniolo (132239 in chips) 
Seat 5: milkytravis (43202 in chips) 
Seat 6: sunn¥m4nn (44750 in chips) 
Seat 7: podiiii (48675 in chips) 
SOUFODAMS: posts the ante 200
Mr Pay Shent: posts the ante 200
Pseudo Fruto: posts the ante 200
RenanToniolo: posts the ante 200
milkytravis: posts the ante 200
sunn¥m4nn: posts the ante 200
podiiii: posts the ante 200
Mr Pay Shent: posts small blind 800
Pseudo Fruto: posts big blind 1600
*** HOLE CARDS ***
RenanToniolo: folds 
milkytravis: folds 
sunn¥m4nn: folds 
podiiii: raises 1600 to 3200
SOUFODAMS: raises 6400 to 9600
Mr Pay Shent: folds 
Pseudo Fruto: folds 
podiiii: folds 
Uncalled bet (6400) returned to SOUFODAMS
SOUFODAMS collected 10200 from pot
SOUFODAMS: doesn't show hand 
*** SUMMARY ***
Total pot 10200 | Rake 0 
Seat 1: SOUFODAMS (button) collected (10200)
Seat 2: Mr Pay Shent (small blind) folded before Flop
Seat 3: Pseudo Fruto (big blind) folded before Flop
Seat 4: RenanToniolo folded before Flop (didn't bet)
Seat 5: milkytravis folded before Flop (didn't bet)
Seat 6: sunn¥m4nn folded before Flop (didn't bet)
Seat 7: podiiii folded before Flop

PokerStars Hand #251205877007: Tournament #3767885527, $40+$10+$5 USD Hold'em No Limit - Level XIII (800/1600) - 2024/06/26 19:23:46 UTC [2024/06/26 15:23:46 ET]
Table '3767885527 92' 8-max Seat #2 is the button
Seat 1: SOUFODAMS (115749 in chips) 
Seat 2: Mr Pay Shent (38782 in chips) 
Seat 3: Pseudo Fruto (97414 in chips) 
Seat 4: RenanToniolo (132039 in chips) 
Seat 5: milkytravis (43002 in chips) 
Seat 6: sunn¥m4nn (44550 in chips) 
Seat 7: podiiii (45275 in chips) 
Seat 8: robertzrc (25000 in chips) 
SOUFODAMS: posts the ante 200
Mr Pay Shent: posts the ante 200
Pseudo Fruto: posts the ante 200
RenanToniolo: posts the ante 200
milkytravis: posts the ante 200
sunn¥m4nn: posts the ante 200
podiiii: posts the ante 200
robertzrc: posts the ante 200
Pseudo Fruto: posts small blind 800
RenanToniolo: posts big blind 1600
*** HOLE CARDS ***
milkytravis: folds 
sunn¥m4nn: raises 1600 to 3200
podiiii: folds 
robertzrc: folds 
SOUFODAMS: folds 
Mr Pay Shent: folds 
Pseudo Fruto: folds 
RenanToniolo: calls 1600
*** FLOP *** [4h As 9h]
RenanToniolo: checks 
sunn¥m4nn: bets 2904
RenanToniolo: calls 2904
*** TURN *** [4h As 9h] [Kh]
RenanToniolo: checks 
sunn¥m4nn: bets 7304
RenanToniolo: calls 7304
*** RIVER *** [4h As 9h Kh] [8c]
RenanToniolo: checks 
sunn¥m4nn: bets 30942 and is all-in
RenanToniolo: calls 30942
*** SHOW DOWN ***
sunn¥m4nn: shows [Th Jh] (a flush, King high)
RenanToniolo: shows [Ah Ad] (three of a kind, Aces)
sunn¥m4nn collected 91100 from pot
*** SUMMARY ***
Total pot 91100 | Rake 0 
Board [4h As 9h Kh 8c]
Seat 1: SOUFODAMS folded before Flop (didn't bet)
Seat 2: Mr Pay Shent (button) folded before Flop (didn't bet)
Seat 3: Pseudo Fruto (small blind) folded before Flop
Seat 4: RenanToniolo (big blind) showed [Ah Ad] and lost with three of a kind, Aces
Seat 5: milkytravis folded before Flop (didn't bet)
Seat 6: sunn¥m4nn showed [Th Jh] and won (91100) with a flush, King high
Seat 7: podiiii folded before Flop (didn't bet)
Seat 8: robertzrc folded before Flop (didn't bet)

PokerStars Hand #251205905698: Tournament #3767885527, $40+$10+$5 USD Hold'em No Limit - Level XIII (800/1600) - 2024/06/26 19:25:30 UTC [2024/06/26 15:25:30 ET]
Table '3767885527 92' 8-max Seat #3 is the button
Seat 1: SOUFODAMS (115549 in chips) 
Seat 2: Mr Pay Shent (38582 in chips) 
Seat 3: Pseudo Fruto (96414 in chips) 
Seat 4: RenanToniolo (87489 in chips) 
Seat 5: milkytravis (42802 in chips) 
Seat 6: sunn¥m4nn (91100 in chips) 
Seat 7: podiiii (45075 in chips) 
Seat 8: robertzrc (24800 in chips) 
SOUFODAMS: posts the ante 200
Mr Pay Shent: posts the ante 200
Pseudo Fruto: posts the ante 200
RenanToniolo: posts the ante 200
milkytravis: posts the ante 200
sunn¥m4nn: posts the ante 200
podiiii: posts the ante 200
robertzrc: posts the ante 200
RenanToniolo: posts small blind 800
milkytravis: posts big blind 1600
*** HOLE CARDS ***
sunn¥m4nn: folds 
podiiii: folds 
robertzrc: folds 
SOUFODAMS: folds 
Mr Pay Shent: folds 
Pseudo Fruto: raises 1600 to 3200
RenanToniolo: folds 
milkytravis: calls 1600
*** FLOP *** [2s Kc 5d]
milkytravis: checks 
Pseudo Fruto: bets 2376
milkytravis: folds 
Uncalled bet (2376) returned to Pseudo Fruto
Pseudo Fruto collected 8800 from pot
Pseudo Fruto: doesn't show hand 
*** SUMMARY ***
Total pot 8800 | Rake 0 
Board [2s Kc 5d]
Seat 1: SOUFODAMS folded before Flop (didn't bet)
Seat 2: Mr Pay Shent folded before Flop (didn't bet)
Seat 3: Pseudo Fruto (button) collected (8800)
Seat 4: RenanToniolo (small blind) folded before Flop
Seat 5: milkytravis (big blind) folded on the Flop
Seat 6: sunn¥m4nn folded before Flop (didn't bet)
Seat 7: podiiii folded before Flop (didn't bet)
Seat 8: robertzrc folded before Flop (didn't bet)

PokerStars Hand #251205915217: Tournament #3767885527, $40+$10+$5 USD Hold'em No Limit - Level XIII (800/1600) - 2024/06/26 19:26:05 UTC [2024/06/26 15:26:05 ET]
Table '3767885527 92' 8-max Seat #4 is the button
Seat 1: SOUFODAMS (115349 in chips) 
Seat 2: Mr Pay Shent (38382 in chips) 
Seat 3: Pseudo Fruto (101814 in chips) 
Seat 4: RenanToniolo (86489 in chips) 
Seat 5: milkytravis (39402 in chips) 
Seat 6: sunn¥m4nn (90900 in chips) 
Seat 7: podiiii (44875 in chips) 
Seat 8: robertzrc (24600 in chips) 
SOUFODAMS: posts the ante 200
Mr Pay Shent: posts the ante 200
Pseudo Fruto: posts the ante 200
RenanToniolo: posts the ante 200
milkytravis: posts the ante 200
sunn¥m4nn: posts the ante 200
podiiii: posts the ante 200
robertzrc: posts the ante 200
milkytravis: posts small blind 800
sunn¥m4nn: posts big blind 1600
*** HOLE CARDS ***
podiiii: folds 
robertzrc: folds 
SOUFODAMS: folds 
Mr Pay Shent: folds 
Pseudo Fruto: folds 
RenanToniolo: raises 1600 to 3200
milkytravis: folds 
sunn¥m4nn: calls 1600
*** FLOP *** [7h 9s 9c]
sunn¥m4nn: checks 
RenanToniolo: checks 
*** TURN *** [7h 9s 9c] [2h]
sunn¥m4nn: checks 
RenanToniolo: bets 2200
sunn¥m4nn: folds 
Uncalled bet (2200) returned to RenanToniolo
RenanToniolo collected 8800 from pot
*** SUMMARY ***
Total pot 8800 | Rake 0 
Board [7h 9s 9c 2h]
Seat 1: SOUFODAMS folded before Flop (didn't bet)
Seat 2: Mr Pay Shent folded before Flop (didn't bet)
Seat 3: Pseudo Fruto folded before Flop (didn't bet)
Seat 4: RenanToniolo (button) collected (8800)
Seat 5: milkytravis (small blind) folded before Flop
Seat 6: sunn¥m4nn (big blind) folded on the Turn
Seat 7: podiiii folded before Flop (didn't bet)
Seat 8: robertzrc folded before Flop (didn't bet)

PokerStars Hand #251205933091: Tournament #3767885527, $40+$10+$5 USD Hold'em No Limit - Level XIII (800/1600) - 2024/06/26 19:27:10 UTC [2024/06/26 15:27:10 ET]
Table '3767885527 92' 8-max Seat #5 is the button
Seat 1: SOUFODAMS (115149 in chips) 
Seat 2: Mr Pay Shent (38182 in chips) 
Seat 3: Pseudo Fruto (101614 in chips) 
Seat 4: RenanToniolo (91889 in chips) 
Seat 5: milkytravis (38402 in chips) 
Seat 6: sunn¥m4nn (87500 in chips) 
Seat 7: podiiii (44675 in chips) 
Seat 8: robertzrc (24400 in chips) 
SOUFODAMS: posts the ante 200
Mr Pay Shent: posts the ante 200
Pseudo Fruto: posts the ante 200
RenanToniolo: posts the ante 200
milkytravis: posts the ante 200
sunn¥m4nn: posts the ante 200
podiiii: posts the ante 200
robertzrc: posts the ante 200
sunn¥m4nn: posts small blind 800
podiiii: posts big blind 1600
*** HOLE CARDS ***
robertzrc: calls 1600
SOUFODAMS: folds 
Mr Pay Shent: folds 
Pseudo Fruto: raises 1600 to 3200
RenanToniolo: folds 
milkytravis: folds 
sunn¥m4nn: folds 
podiiii: folds 
robertzrc: calls 1600
*** FLOP *** [As 8d 3d]
robertzrc: checks 
Pseudo Fruto: bets 2808
robertzrc: folds 
Uncalled bet (2808) returned to Pseudo Fruto
Pseudo Fruto collected 10400 from pot
Pseudo Fruto: doesn't show hand 
*** SUMMARY ***
Total pot 10400 | Rake 0 
Board [As 8d 3d]
Seat 1: SOUFODAMS folded before Flop (didn't bet)
Seat 2: Mr Pay Shent folded before Flop (didn't bet)
Seat 3: Pseudo Fruto collected (10400)
Seat 4: RenanToniolo folded before Flop (didn't bet)
Seat 5: milkytravis (button) folded before Flop (didn't bet)
Seat 6: sunn¥m4nn (small blind) folded before Flop
Seat 7: podiiii (big blind) folded before Flop
Seat 8: robertzrc folded on the Flop

PokerStars Hand #251205948757: Tournament #3767885527, $40+$10+$5 USD Hold'em No Limit - Level XIII (800/1600) - 2024/06/26 19:28:09 UTC [2024/06/26 15:28:09 ET]
Table '3767885527 92' 8-max Seat #6 is the button
Seat 1: SOUFODAMS (114949 in chips) 
Seat 2: Mr Pay Shent (37982 in chips) 
Seat 3: Pseudo Fruto (108614 in chips) 
Seat 4: RenanToniolo (91689 in chips) 
Seat 5: milkytravis (38202 in chips) 
Seat 6: sunn¥m4nn (86500 in chips) 
Seat 7: podiiii (42875 in chips) 
Seat 8: robertzrc (21000 in chips) 
SOUFODAMS: posts the ante 200
Mr Pay Shent: posts the ante 200
Pseudo Fruto: posts the ante 200
RenanToniolo: posts the ante 200
milkytravis: posts the ante 200
sunn¥m4nn: posts the ante 200
podiiii: posts the ante 200
robertzrc: posts the ante 200
podiiii: posts small blind 800
robertzrc: posts big blind 1600
*** HOLE CARDS ***
SOUFODAMS: folds 
Mr Pay Shent: folds 
Pseudo Fruto: folds 
RenanToniolo: raises 1600 to 3200
milkytravis: folds 
sunn¥m4nn: calls 3200
podiiii: folds 
robertzrc: calls 1600
*** FLOP *** [Th 4h 9d]
robertzrc: bets 3200
RenanToniolo: folds 
sunn¥m4nn: calls 3200
*** TURN *** [Th 4h 9d] [Ac]
robertzrc: checks 
sunn¥m4nn: checks 
*** RIVER *** [Th 4h 9d Ac] [8h]
robertzrc: checks 
sunn¥m4nn: checks 
*** SHOW DOWN ***
robertzrc: shows [7c 4c] (a pair of Fours)
sunn¥m4nn: shows [9s Ks] (a pair of Nines)
sunn¥m4nn collected 18400 from pot
*** SUMMARY ***
Total pot 18400 | Rake 0 
Board [Th 4h 9d Ac 8h]
Seat 1: SOUFODAMS folded before Flop (didn't bet)
Seat 2: Mr Pay Shent folded before Flop (didn't bet)
Seat 3: Pseudo Fruto folded before Flop (didn't bet)
Seat 4: RenanToniolo folded on the Flop
Seat 5: milkytravis folded before Flop (didn't bet)
Seat 6: sunn¥m4nn (button) showed [9s Ks] and won (18400) with a pair of Nines
Seat 7: podiiii (small blind) folded before Flop
Seat 8: robertzrc (big blind) showed [7c 4c] and lost with a pair of Fours

PokerStars Hand #251205969714: Tournament #3767885527, $40+$10+$5 USD Hold'em No Limit - Level XIV (1000/2000) - 2024/06/26 19:29:27 UTC [2024/06/26 15:29:27 ET]
Table '3767885527 92' 8-max Seat #7 is the button
Seat 1: SOUFODAMS (114749 in chips) 
Seat 2: Mr Pay Shent (37782 in chips) 
Seat 3: Pseudo Fruto (108414 in chips) 
Seat 4: RenanToniolo (88289 in chips) 
Seat 5: milkytravis (38002 in chips) 
Seat 6: sunn¥m4nn (98300 in chips) 
Seat 7: podiiii (41875 in chips) 
Seat 8: robertzrc (14400 in chips) 
SOUFODAMS: posts the ante 250
Mr Pay Shent: posts the ante 250
Pseudo Fruto: posts the ante 250
RenanToniolo: posts the ante 250
milkytravis: posts the ante 250
sunn¥m4nn: posts the ante 250
podiiii: posts the ante 250
robertzrc: posts the ante 250
robertzrc: posts small blind 1000
SOUFODAMS: posts big blind 2000
*** HOLE CARDS ***
Mr Pay Shent: folds 
Pseudo Fruto: folds 
RenanToniolo: folds 
milkytravis: raises 2000 to 4000
sunn¥m4nn: raises 5000 to 9000
podiiii: folds 
robertzrc: raises 5150 to 14150 and is all-in
SOUFODAMS: folds 
milkytravis: folds 
sunn¥m4nn: calls 5150
*** FLOP *** [7h Qc 5h]
*** TURN *** [7h Qc 5h] [9c]
*** RIVER *** [7h Qc 5h 9c] [7s]
*** SHOW DOWN ***
robertzrc: shows [3s Js] (a pair of Sevens)
sunn¥m4nn: shows [Td As] (a pair of Sevens - Ace kicker)
sunn¥m4nn collected 36300 from pot
robertzrc finished the tournament
*** SUMMARY ***
Total pot 36300 | Rake 0 
Board [7h Qc 5h 9c 7s]
Seat 1: SOUFODAMS (big blind) folded before Flop
Seat 2: Mr Pay Shent folded before Flop (didn't bet)
Seat 3: Pseudo Fruto folded before Flop (didn't bet)
Seat 4: RenanToniolo folded before Flop (didn't bet)
Seat 5: milkytravis folded before Flop
Seat 6: sunn¥m4nn showed [Td As] and won (36300) with a pair of Sevens
Seat 7: podiiii (button) folded before Flop (didn't bet)
Seat 8: robertzrc (small blind) showed [3s Js] and lost with a pair of Sevens

PokerStars Hand #251205985301: Tournament #3767885527, $40+$10+$5 USD Hold'em No Limit - Level XIV (1000/2000) - 2024/06/26 19:30:24 UTC [2024/06/26 15:30:24 ET]
Table '3767885527 92' 8-max Seat #1 is the button
Seat 1: SOUFODAMS (112499 in chips) 
Seat 2: Mr Pay Shent (37532 in chips) 
Seat 3: Pseudo Fruto (108164 in chips) 
Seat 4: RenanToniolo (88039 in chips) 
Seat 5: milkytravis (33752 in chips) 
Seat 6: sunn¥m4nn (120200 in chips) 
Seat 7: podiiii (41625 in chips) 
SOUFODAMS: posts the ante 250
Mr Pay Shent: posts the ante 250
Pseudo Fruto: posts the ante 250
RenanToniolo: posts the ante 250
milkytravis: posts the ante 250
sunn¥m4nn: posts the ante 250
podiiii: posts the ante 250
Mr Pay Shent: posts small blind 1000
Pseudo Fruto: posts big blind 2000
*** HOLE CARDS ***
RenanToniolo: folds 
milkytravis: folds 
sunn¥m4nn: folds 
podiiii: folds 
SOUFODAMS: folds 
drmentrop is disconnected 
Mr Pay Shent: calls 1000
Pseudo Fruto: raises 105914 to 107914 and is all-in
Mr Pay Shent: folds 
Uncalled bet (105914) returned to Pseudo Fruto
Pseudo Fruto collected 5750 from pot
Pseudo Fruto: doesn't show hand 
*** SUMMARY ***
Total pot 5750 | Rake 0 
Seat 1: SOUFODAMS (button) folded before Flop (didn't bet)
Seat 2: Mr Pay Shent (small blind) folded before Flop
Seat 3: Pseudo Fruto (big blind) collected (5750)
Seat 4: RenanToniolo folded before Flop (didn't bet)
Seat 5: milkytravis folded before Flop (didn't bet)
Seat 6: sunn¥m4nn folded before Flop (didn't bet)
Seat 7: podiiii folded before Flop (didn't bet)

PokerStars Hand #251205995437: Tournament #3767885527, $40+$10+$5 USD Hold'em No Limit - Level XIV (1000/2000) - 2024/06/26 19:31:01 UTC [2024/06/26 15:31:01 ET]
Table '3767885527 92' 8-max Seat #2 is the button
Seat 1: SOUFODAMS (112249 in chips) 
Seat 2: Mr Pay Shent (35282 in chips) 
Seat 3: Pseudo Fruto (111664 in chips) 
Seat 4: RenanToniolo (87789 in chips) 
Seat 5: milkytravis (33502 in chips) 
Seat 6: sunn¥m4nn (119950 in chips) 
Seat 7: podiiii (41375 in chips) 
Seat 8: drmentrop (25000 in chips) 
SOUFODAMS: posts the ante 250
Mr Pay Shent: posts the ante 250
Pseudo Fruto: posts the ante 250
RenanToniolo: posts the ante 250
milkytravis: posts the ante 250
sunn¥m4nn: posts the ante 250
podiiii: posts the ante 250
drmentrop: posts the ante 250
Pseudo Fruto: posts small blind 1000
RenanToniolo: posts big blind 2000
*** HOLE CARDS ***
milkytravis: folds 
sunn¥m4nn: folds 
podiiii: folds 
drmentrop: folds 
SOUFODAMS: folds 
Mr Pay Shent: folds 
Pseudo Fruto: folds 
Uncalled bet (1000) returned to RenanToniolo
RenanToniolo collected 4000 from pot
*** SUMMARY ***
Total pot 4000 | Rake 0 
Seat 1: SOUFODAMS folded before Flop (didn't bet)
Seat 2: Mr Pay Shent (button) folded before Flop (didn't bet)
Seat 3: Pseudo Fruto (small blind) folded before Flop
Seat 4: RenanToniolo (big blind) collected (4000)
Seat 5: milkytravis folded before Flop (didn't bet)
Seat 6: sunn¥m4nn folded before Flop (didn't bet)
Seat 7: podiiii folded before Flop (didn't bet)
Seat 8: drmentrop folded before Flop (didn't bet)

PokerStars Hand #251206001748: Tournament #3767885527, $40+$10+$5 USD Hold'em No Limit - Level XIV (1000/2000) - 2024/06/26 19:31:24 UTC [2024/06/26 15:31:24 ET]
Table '3767885527 92' 8-max Seat #3 is the button
Seat 1: SOUFODAMS (111999 in chips) 
Seat 2: Mr Pay Shent (35032 in chips) 
Seat 3: Pseudo Fruto (110414 in chips) 
Seat 4: RenanToniolo (90539 in chips) 
Seat 5: milkytravis (33252 in chips) 
Seat 6: sunn¥m4nn (119700 in chips) 
Seat 7: podiiii (41125 in chips) 
Seat 8: drmentrop (24750 in chips) 
SOUFODAMS: posts the ante 250
Mr Pay Shent: posts the ante 250
Pseudo Fruto: posts the ante 250
RenanToniolo: posts the ante 250
milkytravis: posts the ante 250
sunn¥m4nn: posts the ante 250
podiiii: posts the ante 250
drmentrop: posts the ante 250
RenanToniolo: posts small blind 1000
milkytravis: posts big blind 2000
*** HOLE CARDS ***
sunn¥m4nn: folds 
podiiii: folds 
drmentrop: folds 
SOUFODAMS: folds 
Mr Pay Shent: folds 
Pseudo Fruto: folds 
RenanToniolo: raises 4000 to 6000
milkytravis: raises 27002 to 33002 and is all-in
RenanToniolo: folds 
Uncalled bet (27002) returned to milkytravis
milkytravis collected 14000 from pot
milkytravis: doesn't show hand 
*** SUMMARY ***
Total pot 14000 | Rake 0 
Seat 1: SOUFODAMS folded before Flop (didn't bet)
Seat 2: Mr Pay Shent folded before Flop (didn't bet)
Seat 3: Pseudo Fruto (button) folded before Flop (didn't bet)
Seat 4: RenanToniolo (small blind) folded before Flop
Seat 5: milkytravis (big blind) collected (14000)
Seat 6: sunn¥m4nn folded before Flop (didn't bet)
Seat 7: podiiii folded before Flop (didn't bet)
Seat 8: drmentrop folded before Flop (didn't bet)

PokerStars Hand #251206012555: Tournament #3767885527, $40+$10+$5 USD Hold'em No Limit - Level XIV (1000/2000) - 2024/06/26 19:32:03 UTC [2024/06/26 15:32:03 ET]
Table '3767885527 92' 8-max Seat #4 is the button
Seat 1: SOUFODAMS (111749 in chips) 
Seat 2: Mr Pay Shent (34782 in chips) 
Seat 3: Pseudo Fruto (110164 in chips) 
Seat 4: RenanToniolo (84289 in chips) 
Seat 5: milkytravis (41002 in chips) 
Seat 6: sunn¥m4nn (119450 in chips) 
Seat 7: podiiii (40875 in chips) 
Seat 8: drmentrop (24500 in chips) 
SOUFODAMS: posts the ante 250
Mr Pay Shent: posts the ante 250
Pseudo Fruto: posts the ante 250
RenanToniolo: posts the ante 250
milkytravis: posts the ante 250
sunn¥m4nn: posts the ante 250
podiiii: posts the ante 250
drmentrop: posts the ante 250
milkytravis: posts small blind 1000
sunn¥m4nn: posts big blind 2000
*** HOLE CARDS ***
podiiii: folds 
drmentrop: raises 22250 to 24250 and is all-in
SOUFODAMS: folds 
Mr Pay Shent: folds 
Pseudo Fruto: calls 24250
RenanToniolo: folds 
milkytravis: folds 
sunn¥m4nn: folds 
*** FLOP *** [Jd Th 8c]
*** TURN *** [Jd Th 8c] [As]
*** RIVER *** [Jd Th 8c As] [3s]
*** SHOW DOWN ***
drmentrop: shows [Ah 7c] (a pair of Aces)
Pseudo Fruto: shows [Qc Qh] (a pair of Queens)
drmentrop collected 53500 from pot
*** SUMMARY ***
Total pot 53500 | Rake 0 
Board [Jd Th 8c As 3s]
Seat 1: SOUFODAMS folded before Flop (didn't bet)
Seat 2: Mr Pay Shent folded before Flop (didn't bet)
Seat 3: Pseudo Fruto showed [Qc Qh] and lost with a pair of Queens
Seat 4: RenanToniolo (button) folded before Flop (didn't bet)
Seat 5: milkytravis (small blind) folded before Flop
Seat 6: sunn¥m4nn (big blind) folded before Flop
Seat 7: podiiii folded before Flop (didn't bet)
Seat 8: drmentrop showed [Ah 7c] and won (53500) with a pair of Aces

PokerStars Hand #251206021497: Tournament #3767885527, $40+$10+$5 USD Hold'em No Limit - Level XIV (1000/2000) - 2024/06/26 19:32:35 UTC [2024/06/26 15:32:35 ET]
Table '3767885527 92' 8-max Seat #5 is the button
Seat 2: Mr Pay Shent (34532 in chips) 
Seat 3: Pseudo Fruto (85664 in chips) 
Seat 4: RenanToniolo (84039 in chips) 
Seat 5: milkytravis (39752 in chips) 
Seat 6: sunn¥m4nn (117200 in chips) 
Seat 7: podiiii (40625 in chips) 
Seat 8: drmentrop (53500 in chips) 
Mr Pay Shent: posts the ante 250
Pseudo Fruto: posts the ante 250
RenanToniolo: posts the ante 250
milkytravis: posts the ante 250
sunn¥m4nn: posts the ante 250
podiiii: posts the ante 250
drmentrop: posts the ante 250
sunn¥m4nn: posts small blind 1000
podiiii: posts big blind 2000
*** HOLE CARDS ***
drmentrop: folds 
Mr Pay Shent: folds 
Pseudo Fruto: folds 
RenanToniolo: folds 
milkytravis: folds 
sunn¥m4nn: folds 
Uncalled bet (1000) returned to podiiii
podiiii collected 3750 from pot
*** SUMMARY ***
Total pot 3750 | Rake 0 
Seat 2: Mr Pay Shent folded before Flop (didn't bet)
Seat 3: Pseudo Fruto folded before Flop (didn't bet)
Seat 4: RenanToniolo folded before Flop (didn't bet)
Seat 5: milkytravis (button) folded before Flop (didn't bet)
Seat 6: sunn¥m4nn (small blind) folded before Flop
Seat 7: podiiii (big blind) collected (3750)
Seat 8: drmentrop folded before Flop (didn't bet)

PokerStars Hand #251206026968: Tournament #3767885527, $40+$10+$5 USD Hold'em No Limit - Level XIV (1000/2000) - 2024/06/26 19:32:56 UTC [2024/06/26 15:32:56 ET]
Table '3767885527 92' 8-max Seat #6 is the button
Seat 2: Mr Pay Shent (34282 in chips) 
Seat 3: Pseudo Fruto (85414 in chips) 
Seat 4: RenanToniolo (83789 in chips) 
Seat 5: milkytravis (39502 in chips) 
Seat 6: sunn¥m4nn (115950 in chips) 
Seat 7: podiiii (43125 in chips) 
Seat 8: drmentrop (53250 in chips) 
Mr Pay Shent: posts the ante 250
Pseudo Fruto: posts the ante 250
RenanToniolo: posts the ante 250
milkytravis: posts the ante 250
sunn¥m4nn: posts the ante 250
podiiii: posts the ante 250
drmentrop: posts the ante 250
podiiii: posts small blind 1000
drmentrop: posts big blind 2000
*** HOLE CARDS ***
Mr Pay Shent: raises 2000 to 4000
Pseudo Fruto: raises 6000 to 10000
RenanToniolo: folds 
milkytravis: folds 
sunn¥m4nn: folds 
podiiii: raises 32875 to 42875 and is all-in
drmentrop: folds 
Mr Pay Shent: folds 
Pseudo Fruto: folds 
Uncalled bet (32875) returned to podiiii
podiiii collected 27750 from pot
kbção535 is disconnected 
*** SUMMARY ***
Total pot 27750 | Rake 0 
Seat 2: Mr Pay Shent folded before Flop
Seat 3: Pseudo Fruto folded before Flop
Seat 4: RenanToniolo folded before Flop (didn't bet)
Seat 5: milkytravis folded before Flop (didn't bet)
Seat 6: sunn¥m4nn (button) folded before Flop (didn't bet)
Seat 7: podiiii (small blind) collected (27750)
Seat 8: drmentrop (big blind) folded before Flop

PokerStars Hand #251206039921: Tournament #3767885527, $40+$10+$5 USD Hold'em No Limit - Level XIV (1000/2000) - 2024/06/26 19:33:43 UTC [2024/06/26 15:33:43 ET]
Table '3767885527 92' 8-max Seat #7 is the button
Seat 1: kbção535 (25000 in chips) 
Seat 2: Mr Pay Shent (30032 in chips) 
Seat 3: Pseudo Fruto (75164 in chips) 
Seat 4: RenanToniolo (83539 in chips) 
Seat 5: milkytravis (39252 in chips) 
Seat 6: sunn¥m4nn (115700 in chips) 
Seat 7: podiiii (60625 in chips) 
Seat 8: drmentrop (51000 in chips) 
kbção535: posts the ante 250
Mr Pay Shent: posts the ante 250
Pseudo Fruto: posts the ante 250
RenanToniolo: posts the ante 250
milkytravis: posts the ante 250
sunn¥m4nn: posts the ante 250
podiiii: posts the ante 250
drmentrop: posts the ante 250
drmentrop: posts small blind 1000
kbção535: posts big blind 2000
*** HOLE CARDS ***
Mr Pay Shent: folds 
Pseudo Fruto: folds 
RenanToniolo: raises 2000 to 4000
milkytravis: folds 
sunn¥m4nn: folds 
podiiii: folds 
drmentrop: folds 
kbção535: calls 2000
*** FLOP *** [4c Th Jh]
kbção535: bets 11000
RenanToniolo: folds 
Uncalled bet (11000) returned to kbção535
kbção535 collected 11000 from pot
kbção535: doesn't show hand 
*** SUMMARY ***
Total pot 11000 | Rake 0 
Board [4c Th Jh]
Seat 1: kbção535 (big blind) collected (11000)
Seat 2: Mr Pay Shent folded before Flop (didn't bet)
Seat 3: Pseudo Fruto folded before Flop (didn't bet)
Seat 4: RenanToniolo folded on the Flop
Seat 5: milkytravis folded before Flop (didn't bet)
Seat 6: sunn¥m4nn folded before Flop (didn't bet)
Seat 7: podiiii (button) folded before Flop (didn't bet)
Seat 8: drmentrop (small blind) folded before Flop

PokerStars Hand #251206049415: Tournament #3767885527, $40+$10+$5 USD Hold'em No Limit - Level XIV (1000/2000) - 2024/06/26 19:34:18 UTC [2024/06/26 15:34:18 ET]
Table '3767885527 92' 8-max Seat #8 is the button
Seat 1: kbção535 (31750 in chips) 
Seat 2: Mr Pay Shent (29782 in chips) 
Seat 3: Pseudo Fruto (74914 in chips) 
Seat 4: RenanToniolo (79289 in chips) 
Seat 5: milkytravis (39002 in chips) 
Seat 6: sunn¥m4nn (115450 in chips) 
Seat 7: podiiii (60375 in chips) 
Seat 8: drmentrop (49750 in chips) 
kbção535: posts the ante 250
Mr Pay Shent: posts the ante 250
Pseudo Fruto: posts the ante 250
RenanToniolo: posts the ante 250
milkytravis: posts the ante 250
sunn¥m4nn: posts the ante 250
podiiii: posts the ante 250
drmentrop: posts the ante 250
kbção535: posts small blind 1000
Mr Pay Shent: posts big blind 2000
*** HOLE CARDS ***
Pseudo Fruto: folds 
RenanToniolo: raises 2000 to 4000
milkytravis: raises 34752 to 38752 and is all-in
sunn¥m4nn: folds 
podiiii: folds 
drmentrop: folds 
kbção535: calls 30500 and is all-in
Mr Pay Shent: folds 
RenanToniolo: calls 34752
*** FLOP *** [3h Qs 6s]
*** TURN *** [3h Qs 6s] [7d]
*** RIVER *** [3h Qs 6s 7d] [5d]
*** SHOW DOWN ***
RenanToniolo: shows [Jd Jh] (a pair of Jacks)
milkytravis: shows [9c 9h] (a pair of Nines)
RenanToniolo collected 14504 from side pot
kbção535: shows [Ah 7h] (a pair of Sevens)
RenanToniolo collected 98500 from main pot
milkytravis finished the tournament
kbção535 finished the tournament
caio_pimenta is disconnected 
*** SUMMARY ***
Total pot 113004 Main pot 98500. Side pot 14504. | Rake 0 
Board [3h Qs 6s 7d 5d]
Seat 1: kbção535 (small blind) showed [Ah 7h] and lost with a pair of Sevens
Seat 2: Mr Pay Shent (big blind) folded before Flop
Seat 3: Pseudo Fruto folded before Flop (didn't bet)
Seat 4: RenanToniolo showed [Jd Jh] and won (113004) with a pair of Jacks
Seat 5: milkytravis showed [9c 9h] and lost with a pair of Nines
Seat 6: sunn¥m4nn folded before Flop (didn't bet)
Seat 7: podiiii folded before Flop (didn't bet)
Seat 8: drmentrop (button) folded before Flop (didn't bet)

PokerStars Hand #251206066777: Tournament #3767885527, $40+$10+$5 USD Hold'em No Limit - Level XIV (1000/2000) - 2024/06/26 19:35:21 UTC [2024/06/26 15:35:21 ET]
Table '3767885527 92' 8-max Seat #2 is the button
Seat 2: Mr Pay Shent (27532 in chips) 
Seat 3: Pseudo Fruto (74664 in chips) 
Seat 4: RenanToniolo (153291 in chips) 
Seat 5: caio_pimenta (49407 in chips) 
Seat 6: sunn¥m4nn (115200 in chips) 
Seat 7: podiiii (60125 in chips) 
Seat 8: drmentrop (49500 in chips) 
Mr Pay Shent: posts the ante 250
Pseudo Fruto: posts the ante 250
RenanToniolo: posts the ante 250
caio_pimenta: posts the ante 250
sunn¥m4nn: posts the ante 250
podiiii: posts the ante 250
drmentrop: posts the ante 250
Pseudo Fruto: posts small blind 1000
RenanToniolo: posts big blind 2000
*** HOLE CARDS ***
caio_pimenta: folds 
sunn¥m4nn: folds 
podiiii: raises 2000 to 4000
drmentrop: folds 
Mr Pay Shent: folds 
Pseudo Fruto: folds 
RenanToniolo: calls 2000
*** FLOP *** [9c Kc 8h]
RenanToniolo: checks 
podiiii: bets 6600
RenanToniolo: calls 6600
*** TURN *** [9c Kc 8h] [6c]
RenanToniolo: checks 
podiiii: checks 
*** RIVER *** [9c Kc 8h 6c] [5d]
RenanToniolo: checks 
podiiii: checks 
*** SHOW DOWN ***
RenanToniolo: shows [4d 8d] (a pair of Eights)
podiiii: mucks hand 
RenanToniolo collected 23950 from pot
*** SUMMARY ***
Total pot 23950 | Rake 0 
Board [9c Kc 8h 6c 5d]
Seat 2: Mr Pay Shent (button) folded before Flop (didn't bet)
Seat 3: Pseudo Fruto (small blind) folded before Flop
Seat 4: RenanToniolo (big blind) showed [4d 8d] and won (23950) with a pair of Eights
Seat 5: caio_pimenta folded before Flop (didn't bet)
Seat 6: sunn¥m4nn folded before Flop (didn't bet)
Seat 7: podiiii mucked
Seat 8: drmentrop folded before Flop (didn't bet)

PokerStars Hand #251206092033: Tournament #3767885527, $40+$10+$5 USD Hold'em No Limit - Level XIV (1000/2000) - 2024/06/26 19:36:53 UTC [2024/06/26 15:36:53 ET]
Table '3767885527 92' 8-max Seat #3 is the button
Seat 2: Mr Pay Shent (27282 in chips) 
Seat 3: Pseudo Fruto (73414 in chips) 
Seat 4: RenanToniolo (166391 in chips) 
Seat 5: caio_pimenta (49157 in chips) 
Seat 6: sunn¥m4nn (114950 in chips) 
Seat 7: podiiii (49275 in chips) 
Seat 8: drmentrop (49250 in chips) 
Mr Pay Shent: posts the ante 250
Pseudo Fruto: posts the ante 250
RenanToniolo: posts the ante 250
caio_pimenta: posts the ante 250
sunn¥m4nn: posts the ante 250
podiiii: posts the ante 250
drmentrop: posts the ante 250
RenanToniolo: posts small blind 1000
caio_pimenta: posts big blind 2000
*** HOLE CARDS ***
sunn¥m4nn: folds 
podiiii: folds 
drmentrop: folds 
Mr Pay Shent: raises 6750 to 8750
rabwallace1993 is disconnected 
Pseudo Fruto: folds 
RenanToniolo: folds 
caio_pimenta: calls 6750
*** FLOP *** [Ac 6h 2s]
caio_pimenta: checks 
Mr Pay Shent: bets 18282 and is all-in
caio_pimenta: folds 
Uncalled bet (18282) returned to Mr Pay Shent
Mr Pay Shent collected 20250 from pot
Mr Pay Shent: doesn't show hand 
*** SUMMARY ***
Total pot 20250 | Rake 0 
Board [Ac 6h 2s]
Seat 2: Mr Pay Shent collected (20250)
Seat 3: Pseudo Fruto (button) folded before Flop (didn't bet)
Seat 4: RenanToniolo (small blind) folded before Flop
Seat 5: caio_pimenta (big blind) folded on the Flop
Seat 6: sunn¥m4nn folded before Flop (didn't bet)
Seat 7: podiiii folded before Flop (didn't bet)
Seat 8: drmentrop folded before Flop (didn't bet)

PokerStars Hand #251206102801: Tournament #3767885527, $40+$10+$5 USD Hold'em No Limit - Level XIV (1000/2000) - 2024/06/26 19:37:32 UTC [2024/06/26 15:37:32 ET]
Table '3767885527 92' 8-max Seat #4 is the button
Seat 1: rabwallace1993 (84066 in chips) 
Seat 2: Mr Pay Shent (38532 in chips) 
Seat 3: Pseudo Fruto (73164 in chips) 
Seat 4: RenanToniolo (165141 in chips) 
Seat 5: caio_pimenta (40157 in chips) 
Seat 6: sunn¥m4nn (114700 in chips) 
Seat 7: podiiii (49025 in chips) 
Seat 8: drmentrop (49000 in chips) 
rabwallace1993: posts the ante 250
Mr Pay Shent: posts the ante 250
Pseudo Fruto: posts the ante 250
RenanToniolo: posts the ante 250
caio_pimenta: posts the ante 250
sunn¥m4nn: posts the ante 250
podiiii: posts the ante 250
drmentrop: posts the ante 250
caio_pimenta: posts small blind 1000
sunn¥m4nn: posts big blind 2000
*** HOLE CARDS ***
podiiii: folds 
drmentrop: folds 
rabwallace1993: raises 2000 to 4000
Mr Pay Shent: folds 
Pseudo Fruto: folds 
RenanToniolo: folds 
caio_pimenta: calls 3000
sunn¥m4nn: folds 
*** FLOP *** [Ac 4h 7s]
caio_pimenta: checks 
rabwallace1993: bets 6000
caio_pimenta: folds 
Uncalled bet (6000) returned to rabwallace1993
rabwallace1993 collected 12000 from pot
rabwallace1993: doesn't show hand 
*** SUMMARY ***
Total pot 12000 | Rake 0 
Board [Ac 4h 7s]
Seat 1: rabwallace1993 collected (12000)
Seat 2: Mr Pay Shent folded before Flop (didn't bet)
Seat 3: Pseudo Fruto folded before Flop (didn't bet)
Seat 4: RenanToniolo (button) folded before Flop (didn't bet)
Seat 5: caio_pimenta (small blind) folded on the Flop
Seat 6: sunn¥m4nn (big blind) folded before Flop
Seat 7: podiiii folded before Flop (didn't bet)
Seat 8: drmentrop folded before Flop (didn't bet)

PokerStars Hand #251206114055: Tournament #3767885527, $40+$10+$5 USD Hold'em No Limit - Level XIV (1000/2000) - 2024/06/26 19:38:14 UTC [2024/06/26 15:38:14 ET]
Table '3767885527 92' 8-max Seat #5 is the button
Seat 1: rabwallace1993 (91816 in chips) 
Seat 2: Mr Pay Shent (38282 in chips) 
Seat 3: Pseudo Fruto (72914 in chips) 
Seat 4: RenanToniolo (164891 in chips) 
Seat 5: caio_pimenta (35907 in chips) 
Seat 6: sunn¥m4nn (112450 in chips) 
Seat 7: podiiii (48775 in chips) 
Seat 8: drmentrop (48750 in chips) 
rabwallace1993: posts the ante 250
Mr Pay Shent: posts the ante 250
Pseudo Fruto: posts the ante 250
RenanToniolo: posts the ante 250
caio_pimenta: posts the ante 250
sunn¥m4nn: posts the ante 250
podiiii: posts the ante 250
drmentrop: posts the ante 250
sunn¥m4nn: posts small blind 1000
podiiii: posts big blind 2000
*** HOLE CARDS ***
drmentrop: folds 
rabwallace1993: raises 2000 to 4000
Mr Pay Shent: folds 
Pseudo Fruto: folds 
RenanToniolo: folds 
caio_pimenta: folds 
sunn¥m4nn: calls 3000
podiiii: calls 2000
*** FLOP *** [3h 7c 2d]
sunn¥m4nn: checks 
podiiii: bets 3500
rabwallace1993: calls 3500
sunn¥m4nn: calls 3500
*** TURN *** [3h 7c 2d] [Jh]
sunn¥m4nn: checks 
podiiii: bets 8085
rabwallace1993: raises 10085 to 18170
sunn¥m4nn: folds 
podiiii: raises 22855 to 41025 and is all-in
rabwallace1993: folds 
Uncalled bet (22855) returned to podiiii
podiiii collected 60840 from pot
*** SUMMARY ***
Total pot 60840 | Rake 0 
Board [3h 7c 2d Jh]
Seat 1: rabwallace1993 folded on the Turn
Seat 2: Mr Pay Shent folded before Flop (didn't bet)
Seat 3: Pseudo Fruto folded before Flop (didn't bet)
Seat 4: RenanToniolo folded before Flop (didn't bet)
Seat 5: caio_pimenta (button) folded before Flop (didn't bet)
Seat 6: sunn¥m4nn (small blind) folded on the Turn
Seat 7: podiiii (big blind) collected (60840)
Seat 8: drmentrop folded before Flop (didn't bet)

PokerStars Hand #251206152482: Tournament #3767885527, $40+$10+$5 USD Hold'em No Limit - Level XV (1250/2500) - 2024/06/26 19:40:34 UTC [2024/06/26 15:40:34 ET]
Table '3767885527 92' 8-max Seat #6 is the button
Seat 1: rabwallace1993 (65896 in chips) 
Seat 2: Mr Pay Shent (38032 in chips) 
Seat 3: Pseudo Fruto (72664 in chips) 
Seat 4: RenanToniolo (164641 in chips) 
Seat 5: caio_pimenta (35657 in chips) 
Seat 6: sunn¥m4nn (104700 in chips) 
Seat 7: podiiii (83695 in chips) 
Seat 8: drmentrop (48500 in chips) 
rabwallace1993: posts the ante 325
Mr Pay Shent: posts the ante 325
Pseudo Fruto: posts the ante 325
RenanToniolo: posts the ante 325
caio_pimenta: posts the ante 325
sunn¥m4nn: posts the ante 325
podiiii: posts the ante 325
drmentrop: posts the ante 325
podiiii: posts small blind 1250
drmentrop: posts big blind 2500
*** HOLE CARDS ***
rabwallace1993: folds 
Mr Pay Shent: folds 
Pseudo Fruto: folds 
RenanToniolo: raises 2500 to 5000
caio_pimenta: folds 
sunn¥m4nn: folds 
podiiii: folds 
drmentrop: calls 2500
*** FLOP *** [Kd Js 8h]
drmentrop: checks 
RenanToniolo: bets 3463
drmentrop: calls 3463
*** TURN *** [Kd Js 8h] [Ac]
drmentrop: checks 
RenanToniolo: bets 11856
drmentrop: folds 
Uncalled bet (11856) returned to RenanToniolo
RenanToniolo collected 20776 from pot
*** SUMMARY ***
Total pot 20776 | Rake 0 
Board [Kd Js 8h Ac]
Seat 1: rabwallace1993 folded before Flop (didn't bet)
Seat 2: Mr Pay Shent folded before Flop (didn't bet)
Seat 3: Pseudo Fruto folded before Flop (didn't bet)
Seat 4: RenanToniolo collected (20776)
Seat 5: caio_pimenta folded before Flop (didn't bet)
Seat 6: sunn¥m4nn (button) folded before Flop (didn't bet)
Seat 7: podiiii (small blind) folded before Flop
Seat 8: drmentrop (big blind) folded on the Turn

PokerStars Hand #251206164781: Tournament #3767885527, $40+$10+$5 USD Hold'em No Limit - Level XV (1250/2500) - 2024/06/26 19:41:18 UTC [2024/06/26 15:41:18 ET]
Table '3767885527 92' 8-max Seat #7 is the button
Seat 1: rabwallace1993 (65571 in chips) 
Seat 2: Mr Pay Shent (37707 in chips) 
Seat 3: Pseudo Fruto (72339 in chips) 
Seat 4: RenanToniolo (176629 in chips) 
Seat 5: caio_pimenta (35332 in chips) 
Seat 6: sunn¥m4nn (104375 in chips) 
Seat 7: podiiii (82120 in chips) 
Seat 8: drmentrop (39712 in chips) 
rabwallace1993: posts the ante 325
Mr Pay Shent: posts the ante 325
Pseudo Fruto: posts the ante 325
RenanToniolo: posts the ante 325
caio_pimenta: posts the ante 325
sunn¥m4nn: posts the ante 325
podiiii: posts the ante 325
drmentrop: posts the ante 325
drmentrop: posts small blind 1250
rabwallace1993: posts big blind 2500
*** HOLE CARDS ***
Mr Pay Shent: folds 
Pseudo Fruto: folds 
RenanToniolo: folds 
caio_pimenta: folds 
sunn¥m4nn: folds 
podiiii: raises 2500 to 5000
drmentrop: folds 
rabwallace1993: calls 2500
*** FLOP *** [Qh 7s 2h]
rabwallace1993: checks 
podiiii: bets 4571
rabwallace1993: calls 4571
*** TURN *** [Qh 7s 2h] [2s]
rabwallace1993: checks 
podiiii: checks 
*** RIVER *** [Qh 7s 2h 2s] [As]
rabwallace1993: bets 11496
podiiii: folds 
Uncalled bet (11496) returned to rabwallace1993
rabwallace1993 collected 22992 from pot
rabwallace1993: doesn't show hand 
*** SUMMARY ***
Total pot 22992 | Rake 0 
Board [Qh 7s 2h 2s As]
Seat 1: rabwallace1993 (big blind) collected (22992)
Seat 2: Mr Pay Shent folded before Flop (didn't bet)
Seat 3: Pseudo Fruto folded before Flop (didn't bet)
Seat 4: RenanToniolo folded before Flop (didn't bet)
Seat 5: caio_pimenta folded before Flop (didn't bet)
Seat 6: sunn¥m4nn folded before Flop (didn't bet)
Seat 7: podiiii (button) folded on the River
Seat 8: drmentrop (small blind) folded before Flop

PokerStars Hand #251206187661: Tournament #3767885527, $40+$10+$5 USD Hold'em No Limit - Level XV (1250/2500) - 2024/06/26 19:42:41 UTC [2024/06/26 15:42:41 ET]
Table '3767885527 92' 8-max Seat #8 is the button
Seat 1: rabwallace1993 (78667 in chips) 
Seat 2: Mr Pay Shent (37382 in chips) 
Seat 3: Pseudo Fruto (72014 in chips) 
Seat 4: RenanToniolo (176304 in chips) 
Seat 5: caio_pimenta (35007 in chips) 
Seat 6: sunn¥m4nn (104050 in chips) 
Seat 7: podiiii (72224 in chips) 
Seat 8: drmentrop (38137 in chips) 
rabwallace1993: posts the ante 325
Mr Pay Shent: posts the ante 325
Pseudo Fruto: posts the ante 325
RenanToniolo: posts the ante 325
caio_pimenta: posts the ante 325
sunn¥m4nn: posts the ante 325
podiiii: posts the ante 325
drmentrop: posts the ante 325
rabwallace1993: posts small blind 1250
Mr Pay Shent: posts big blind 2500
*** HOLE CARDS ***
Pseudo Fruto: folds 
RenanToniolo: folds 
caio_pimenta: folds 
sunn¥m4nn: folds 
podiiii: raises 2500 to 5000
drmentrop: folds 
rabwallace1993: calls 3750
Mr Pay Shent: folds 
*** FLOP *** [8c 8d 5h]
rabwallace1993: checks 
podiiii: bets 4750
rabwallace1993: calls 4750
*** TURN *** [8c 8d 5h] [2d]
rabwallace1993: checks 
podiiii: bets 12500
rabwallace1993: calls 12500
*** RIVER *** [8c 8d 5h 2d] [Th]
rabwallace1993: checks 
podiiii: checks 
*** SHOW DOWN ***
rabwallace1993: shows [As 4h] (a pair of Eights)
podiiii: mucks hand 
rabwallace1993 collected 49600 from pot
*** SUMMARY ***
Total pot 49600 | Rake 0 
Board [8c 8d 5h 2d Th]
Seat 1: rabwallace1993 (small blind) showed [As 4h] and won (49600) with a pair of Eights
Seat 2: Mr Pay Shent (big blind) folded before Flop
Seat 3: Pseudo Fruto folded before Flop (didn't bet)
Seat 4: RenanToniolo folded before Flop (didn't bet)
Seat 5: caio_pimenta folded before Flop (didn't bet)
Seat 6: sunn¥m4nn folded before Flop (didn't bet)
Seat 7: podiiii mucked
Seat 8: drmentrop (button) folded before Flop (didn't bet)

PokerStars Hand #251206218987: Tournament #3767885527, $40+$10+$5 USD Hold'em No Limit - Level XV (1250/2500) - 2024/06/26 19:44:36 UTC [2024/06/26 15:44:36 ET]
Table '3767885527 92' 8-max Seat #1 is the button
Seat 1: rabwallace1993 (105692 in chips) 
Seat 2: Mr Pay Shent (34557 in chips) 
Seat 3: Pseudo Fruto (71689 in chips) 
Seat 4: RenanToniolo (175979 in chips) 
Seat 5: caio_pimenta (34682 in chips) 
Seat 6: sunn¥m4nn (103725 in chips) 
Seat 7: podiiii (49649 in chips) 
Seat 8: drmentrop (37812 in chips) 
rabwallace1993: posts the ante 325
Mr Pay Shent: posts the ante 325
Pseudo Fruto: posts the ante 325
RenanToniolo: posts the ante 325
caio_pimenta: posts the ante 325
sunn¥m4nn: posts the ante 325
podiiii: posts the ante 325
drmentrop: posts the ante 325
Mr Pay Shent: posts small blind 1250
Pseudo Fruto: posts big blind 2500
*** HOLE CARDS ***
RenanToniolo: folds 
caio_pimenta: folds 
sunn¥m4nn: folds 
podiiii: folds 
drmentrop: folds 
rabwallace1993: raises 5000 to 7500
Mr Pay Shent: folds 
Pseudo Fruto: folds 
Uncalled bet (5000) returned to rabwallace1993
rabwallace1993 collected 8850 from pot
rabwallace1993: doesn't show hand 
*** SUMMARY ***
Total pot 8850 | Rake 0 
Seat 1: rabwallace1993 (button) collected (8850)
Seat 2: Mr Pay Shent (small blind) folded before Flop
Seat 3: Pseudo Fruto (big blind) folded before Flop
Seat 4: RenanToniolo folded before Flop (didn't bet)
Seat 5: caio_pimenta folded before Flop (didn't bet)
Seat 6: sunn¥m4nn folded before Flop (didn't bet)
Seat 7: podiiii folded before Flop (didn't bet)
Seat 8: drmentrop folded before Flop (didn't bet)

PokerStars Hand #251206227216: Tournament #3767885527, $40+$10+$5 USD Hold'em No Limit - Level XV (1250/2500) - 2024/06/26 19:45:05 UTC [2024/06/26 15:45:05 ET]
Table '3767885527 92' 8-max Seat #2 is the button
Seat 1: rabwallace1993 (111717 in chips) 
Seat 2: Mr Pay Shent (32982 in chips) 
Seat 3: Pseudo Fruto (68864 in chips) 
Seat 4: RenanToniolo (175654 in chips) 
Seat 5: caio_pimenta (34357 in chips) 
Seat 6: sunn¥m4nn (103400 in chips) 
Seat 7: podiiii (49324 in chips) 
Seat 8: drmentrop (37487 in chips) 
rabwallace1993: posts the ante 325
Mr Pay Shent: posts the ante 325
Pseudo Fruto: posts the ante 325
RenanToniolo: posts the ante 325
caio_pimenta: posts the ante 325
sunn¥m4nn: posts the ante 325
podiiii: posts the ante 325
drmentrop: posts the ante 325
Pseudo Fruto: posts small blind 1250
RenanToniolo: posts big blind 2500
*** HOLE CARDS ***
caio_pimenta: folds 
sunn¥m4nn: folds 
podiiii: raises 2500 to 5000
drmentrop: folds 
rabwallace1993: folds 
Mr Pay Shent: folds 
Pseudo Fruto: folds 
RenanToniolo: calls 2500
*** FLOP *** [Qd Th 9d]
RenanToniolo: checks 
podiiii: bets 4571
RenanToniolo: calls 4571
*** TURN *** [Qd Th 9d] [Jd]
RenanToniolo: checks 
podiiii: bets 7587
RenanToniolo: calls 7587
*** RIVER *** [Qd Th 9d Jd] [2s]
RenanToniolo: checks 
podiiii: bets 31841 and is all-in
RenanToniolo: folds 
Uncalled bet (31841) returned to podiiii
podiiii collected 38166 from pot
*** SUMMARY ***
Total pot 38166 | Rake 0 
Board [Qd Th 9d Jd 2s]
Seat 1: rabwallace1993 folded before Flop (didn't bet)
Seat 2: Mr Pay Shent (button) folded before Flop (didn't bet)
Seat 3: Pseudo Fruto (small blind) folded before Flop
Seat 4: RenanToniolo (big blind) folded on the River
Seat 5: caio_pimenta folded before Flop (didn't bet)
Seat 6: sunn¥m4nn folded before Flop (didn't bet)
Seat 7: podiiii collected (38166)
Seat 8: drmentrop folded before Flop (didn't bet)

PokerStars Hand #251206255670: Tournament #3767885527, $40+$10+$5 USD Hold'em No Limit - Level XV (1250/2500) - 2024/06/26 19:46:48 UTC [2024/06/26 15:46:48 ET]
Table '3767885527 92' 8-max Seat #3 is the button
Seat 1: rabwallace1993 (111392 in chips) 
Seat 2: Mr Pay Shent (32657 in chips) 
Seat 3: Pseudo Fruto (67289 in chips) 
Seat 4: RenanToniolo (158171 in chips) 
Seat 5: caio_pimenta (34032 in chips) 
Seat 6: sunn¥m4nn (103075 in chips) 
Seat 7: podiiii (70007 in chips) 
Seat 8: drmentrop (37162 in chips) 
rabwallace1993: posts the ante 325
Mr Pay Shent: posts the ante 325
Pseudo Fruto: posts the ante 325
RenanToniolo: posts the ante 325
caio_pimenta: posts the ante 325
sunn¥m4nn: posts the ante 325
podiiii: posts the ante 325
drmentrop: posts the ante 325
RenanToniolo: posts small blind 1250
caio_pimenta: posts big blind 2500
*** HOLE CARDS ***
sunn¥m4nn: folds 
podiiii: folds 
drmentrop: folds 
rabwallace1993: folds 
Mr Pay Shent: folds 
Pseudo Fruto: raises 2500 to 5000
RenanToniolo: folds 
caio_pimenta: folds 
Uncalled bet (2500) returned to Pseudo Fruto
Pseudo Fruto collected 8850 from pot
Pseudo Fruto: doesn't show hand 
*** SUMMARY ***
Total pot 8850 | Rake 0 
Seat 1: rabwallace1993 folded before Flop (didn't bet)
Seat 2: Mr Pay Shent folded before Flop (didn't bet)
Seat 3: Pseudo Fruto (button) collected (8850)
Seat 4: RenanToniolo (small blind) folded before Flop
Seat 5: caio_pimenta (big blind) folded before Flop
Seat 6: sunn¥m4nn folded before Flop (didn't bet)
Seat 7: podiiii folded before Flop (didn't bet)
Seat 8: drmentrop folded before Flop (didn't bet)

PokerStars Hand #251206262206: Tournament #3767885527, $40+$10+$5 USD Hold'em No Limit - Level XV (1250/2500) - 2024/06/26 19:47:12 UTC [2024/06/26 15:47:12 ET]
Table '3767885527 92' 8-max Seat #4 is the button
Seat 1: rabwallace1993 (111067 in chips) 
Seat 2: Mr Pay Shent (32332 in chips) 
Seat 3: Pseudo Fruto (73314 in chips) 
Seat 4: RenanToniolo (156596 in chips) 
Seat 5: caio_pimenta (31207 in chips) 
Seat 6: sunn¥m4nn (102750 in chips) 
Seat 7: podiiii (69682 in chips) 
Seat 8: drmentrop (36837 in chips) 
rabwallace1993: posts the ante 325
Mr Pay Shent: posts the ante 325
Pseudo Fruto: posts the ante 325
RenanToniolo: posts the ante 325
caio_pimenta: posts the ante 325
sunn¥m4nn: posts the ante 325
podiiii: posts the ante 325
drmentrop: posts the ante 325
caio_pimenta: posts small blind 1250
sunn¥m4nn: posts big blind 2500
*** HOLE CARDS ***
podiiii: folds 
drmentrop: folds 
rabwallace1993: folds 
Mr Pay Shent: folds 
Pseudo Fruto: raises 2500 to 5000
RenanToniolo: folds 
caio_pimenta: raises 25882 to 30882 and is all-in
sunn¥m4nn: folds 
Pseudo Fruto: calls 25882
*** FLOP *** [2h Tc 9s]
*** TURN *** [2h Tc 9s] [5c]
*** RIVER *** [2h Tc 9s 5c] [Td]
*** SHOW DOWN ***
caio_pimenta: shows [Ks Qs] (a pair of Tens)
Pseudo Fruto: shows [4s 4h] (two pair, Tens and Fours)
Pseudo Fruto collected 66864 from pot
caio_pimenta finished the tournament in 504th place
*** SUMMARY ***
Total pot 66864 | Rake 0 
Board [2h Tc 9s 5c Td]
Seat 1: rabwallace1993 folded before Flop (didn't bet)
Seat 2: Mr Pay Shent folded before Flop (didn't bet)
Seat 3: Pseudo Fruto showed [4s 4h] and won (66864) with two pair, Tens and Fours
Seat 4: RenanToniolo (button) folded before Flop (didn't bet)
Seat 5: caio_pimenta (small blind) showed [Ks Qs] and lost with a pair of Tens
Seat 6: sunn¥m4nn (big blind) folded before Flop
Seat 7: podiiii folded before Flop (didn't bet)
Seat 8: drmentrop folded before Flop (didn't bet)

PokerStars Hand #251206274828: Tournament #3767885527, $40+$10+$5 USD Hold'em No Limit - Level XV (1250/2500) - 2024/06/26 19:47:58 UTC [2024/06/26 15:47:58 ET]
Table '3767885527 92' 8-max Seat #6 is the button
Seat 1: rabwallace1993 (110742 in chips) 
Seat 2: Mr Pay Shent (32007 in chips) 
Seat 3: Pseudo Fruto (108971 in chips) 
Seat 4: RenanToniolo (156271 in chips) 
Seat 6: sunn¥m4nn (99925 in chips) 
Seat 7: podiiii (69357 in chips) 
Seat 8: drmentrop (36512 in chips) 
rabwallace1993: posts the ante 325
Mr Pay Shent: posts the ante 325
Pseudo Fruto: posts the ante 325
RenanToniolo: posts the ante 325
sunn¥m4nn: posts the ante 325
podiiii: posts the ante 325
drmentrop: posts the ante 325
podiiii: posts small blind 1250
drmentrop: posts big blind 2500
*** HOLE CARDS ***
rabwallace1993: folds 
Mr Pay Shent: raises 2500 to 5000
Pseudo Fruto: folds 
RenanToniolo: folds 
sunn¥m4nn: folds 
podiiii: folds 
drmentrop: calls 2500
*** FLOP *** [8d Ad Ts]
drmentrop: checks 
Mr Pay Shent: bets 6763
drmentrop: folds 
Uncalled bet (6763) returned to Mr Pay Shent
Mr Pay Shent collected 13525 from pot
Mr Pay Shent: doesn't show hand 
*** SUMMARY ***
Total pot 13525 | Rake 0 
Board [8d Ad Ts]
Seat 1: rabwallace1993 folded before Flop (didn't bet)
Seat 2: Mr Pay Shent collected (13525)
Seat 3: Pseudo Fruto folded before Flop (didn't bet)
Seat 4: RenanToniolo folded before Flop (didn't bet)
Seat 6: sunn¥m4nn (button) folded before Flop (didn't bet)
Seat 7: podiiii (small blind) folded before Flop
Seat 8: drmentrop (big blind) folded on the Flop

PokerStars Hand #251206283465: Tournament #3767885527, $40+$10+$5 USD Hold'em No Limit - Level XV (1250/2500) - 2024/06/26 19:48:30 UTC [2024/06/26 15:48:30 ET]
Table '3767885527 92' 8-max Seat #7 is the button
Seat 1: rabwallace1993 (110417 in chips) 
Seat 2: Mr Pay Shent (40207 in chips) 
Seat 3: Pseudo Fruto (108646 in chips) 
Seat 4: RenanToniolo (155946 in chips) 
Seat 6: sunn¥m4nn (99600 in chips) 
Seat 7: podiiii (67782 in chips) 
Seat 8: drmentrop (31187 in chips) 
rabwallace1993: posts the ante 325
Mr Pay Shent: posts the ante 325
Pseudo Fruto: posts the ante 325
RenanToniolo: posts the ante 325
sunn¥m4nn: posts the ante 325
podiiii: posts the ante 325
drmentrop: posts the ante 325
drmentrop: posts small blind 1250
rabwallace1993: posts big blind 2500
*** HOLE CARDS ***
Mr Pay Shent: folds 
Pseudo Fruto: raises 2500 to 5000
RenanToniolo: folds 
sunn¥m4nn: folds 
podiiii: folds 
S3d3m2 is disconnected 
drmentrop: raises 25862 to 30862 and is all-in
rabwallace1993: folds 
Pseudo Fruto: folds 
Uncalled bet (25862) returned to drmentrop
drmentrop collected 14775 from pot
*** SUMMARY ***
Total pot 14775 | Rake 0 
Seat 1: rabwallace1993 (big blind) folded before Flop
Seat 2: Mr Pay Shent folded before Flop (didn't bet)
Seat 3: Pseudo Fruto folded before Flop
Seat 4: RenanToniolo folded before Flop (didn't bet)
Seat 6: sunn¥m4nn folded before Flop (didn't bet)
Seat 7: podiiii (button) folded before Flop (didn't bet)
Seat 8: drmentrop (small blind) collected (14775)

PokerStars Hand #251206297124: Tournament #3767885527, $40+$10+$5 USD Hold'em No Limit - Level XVI (1500/3000) - 2024/06/26 19:49:19 UTC [2024/06/26 15:49:19 ET]
Table '3767885527 92' 8-max Seat #8 is the button
Seat 1: rabwallace1993 (107592 in chips) 
Seat 2: Mr Pay Shent (39882 in chips) 
Seat 3: Pseudo Fruto (103321 in chips) 
Seat 4: RenanToniolo (155621 in chips) 
Seat 5: S3d3m2 (104819 in chips) 
Seat 6: sunn¥m4nn (99275 in chips) 
Seat 7: podiiii (67457 in chips) 
Seat 8: drmentrop (40637 in chips) 
rabwallace1993: posts the ante 375
Mr Pay Shent: posts the ante 375
Pseudo Fruto: posts the ante 375
RenanToniolo: posts the ante 375
S3d3m2: posts the ante 375
sunn¥m4nn: posts the ante 375
podiiii: posts the ante 375
drmentrop: posts the ante 375
rabwallace1993: posts small blind 1500
Mr Pay Shent: posts big blind 3000
*** HOLE CARDS ***
Pseudo Fruto: raises 3000 to 6000
RenanToniolo: folds 
S3d3m2: folds 
sunn¥m4nn: folds 
podiiii: folds 
drmentrop: raises 34262 to 40262 and is all-in
rabwallace1993: folds 
Mr Pay Shent: folds 
Pseudo Fruto: calls 34262
*** FLOP *** [Ks Tc 9s]
*** TURN *** [Ks Tc 9s] [3d]
*** RIVER *** [Ks Tc 9s 3d] [2d]
*** SHOW DOWN ***
Pseudo Fruto: shows [Ac Jh] (high card Ace)
drmentrop: shows [As 6c] (high card Ace - lower kicker)
Pseudo Fruto collected 88024 from pot
drmentrop finished the tournament in 491st place
*** SUMMARY ***
Total pot 88024 | Rake 0 
Board [Ks Tc 9s 3d 2d]
Seat 1: rabwallace1993 (small blind) folded before Flop
Seat 2: Mr Pay Shent (big blind) folded before Flop
Seat 3: Pseudo Fruto showed [Ac Jh] and won (88024) with high card Ace
Seat 4: RenanToniolo folded before Flop (didn't bet)
Seat 5: S3d3m2 folded before Flop (didn't bet)
Seat 6: sunn¥m4nn folded before Flop (didn't bet)
Seat 7: podiiii folded before Flop (didn't bet)
Seat 8: drmentrop (button) showed [As 6c] and lost with high card Ace

PokerStars Hand #251206308628: Tournament #3767885527, $40+$10+$5 USD Hold'em No Limit - Level XVI (1500/3000) - 2024/06/26 19:50:00 UTC [2024/06/26 15:50:00 ET]
Table '3767885527 92' 8-max Seat #1 is the button
Seat 1: rabwallace1993 (105717 in chips) 
Seat 2: Mr Pay Shent (36507 in chips) 
Seat 3: Pseudo Fruto (150708 in chips) 
Seat 4: RenanToniolo (155246 in chips) 
Seat 5: S3d3m2 (104444 in chips) 
Seat 6: sunn¥m4nn (98900 in chips) 
Seat 7: podiiii (67082 in chips) 
rabwallace1993: posts the ante 375
Mr Pay Shent: posts the ante 375
Pseudo Fruto: posts the ante 375
RenanToniolo: posts the ante 375
S3d3m2: posts the ante 375
sunn¥m4nn: posts the ante 375
podiiii: posts the ante 375
Mr Pay Shent: posts small blind 1500
Pseudo Fruto: posts big blind 3000
*** HOLE CARDS ***
RenanToniolo: folds 
S3d3m2: folds 
sunn¥m4nn: raises 3000 to 6000
BorIska1993 is disconnected 
podiiii: raises 60707 to 66707 and is all-in
rabwallace1993: folds 
Mr Pay Shent: calls 34632 and is all-in
Pseudo Fruto: folds 
sunn¥m4nn: folds 
Uncalled bet (30575) returned to podiiii
*** FLOP *** [Kc 9h Ad]
*** TURN *** [Kc 9h Ad] [8c]
*** RIVER *** [Kc 9h Ad 8c] [As]
*** SHOW DOWN ***
Mr Pay Shent: shows [Qh Ac] (three of a kind, Aces)
podiiii: shows [5d 5c] (two pair, Aces and Fives)
Mr Pay Shent collected 83889 from pot
*** SUMMARY ***
Total pot 83889 | Rake 0 
Board [Kc 9h Ad 8c As]
Seat 1: rabwallace1993 (button) folded before Flop (didn't bet)
Seat 2: Mr Pay Shent (small blind) showed [Qh Ac] and won (83889) with three of a kind, Aces
Seat 3: Pseudo Fruto (big blind) folded before Flop
Seat 4: RenanToniolo folded before Flop (didn't bet)
Seat 5: S3d3m2 folded before Flop (didn't bet)
Seat 6: sunn¥m4nn folded before Flop
Seat 7: podiiii showed [5d 5c] and lost with two pair, Aces and Fives

PokerStars Hand #251206322383: Tournament #3767885527, $40+$10+$5 USD Hold'em No Limit - Level XVI (1500/3000) - 2024/06/26 19:50:49 UTC [2024/06/26 15:50:49 ET]
Table '3767885527 92' 8-max Seat #2 is the button
Seat 1: rabwallace1993 (105342 in chips) 
Seat 2: Mr Pay Shent (83889 in chips) 
Seat 3: Pseudo Fruto (147333 in chips) 
Seat 4: RenanToniolo (154871 in chips) 
Seat 5: S3d3m2 (104069 in chips) 
Seat 6: sunn¥m4nn (92525 in chips) 
Seat 7: podiiii (30575 in chips) 
Seat 8: BorIska1993 (181649 in chips) 
rabwallace1993: posts the ante 375
Mr Pay Shent: posts the ante 375
Pseudo Fruto: posts the ante 375
RenanToniolo: posts the ante 375
S3d3m2: posts the ante 375
sunn¥m4nn: posts the ante 375
podiiii: posts the ante 375
BorIska1993: posts the ante 375
Pseudo Fruto: posts small blind 1500
RenanToniolo: posts big blind 3000
*** HOLE CARDS ***
S3d3m2: raises 3000 to 6000
sunn¥m4nn: folds 
podiiii: folds 
BorIska1993: folds 
rabwallace1993 has timed out
rabwallace1993: folds 
rabwallace1993 is sitting out
Mr Pay Shent: folds 
rabwallace1993 has returned
Pseudo Fruto: raises 16500 to 22500
RenanToniolo: folds 
S3d3m2: raises 81194 to 103694 and is all-in
Pseudo Fruto: calls 81194
*** FLOP *** [5d 8d 7d]
*** TURN *** [5d 8d 7d] [2s]
*** RIVER *** [5d 8d 7d 2s] [Td]
*** SHOW DOWN ***
Pseudo Fruto: shows [Qd Ad] (a flush, Ace high)
S3d3m2: shows [Ah Kd] (a flush, King high)
Pseudo Fruto collected 213388 from pot
S3d3m2 finished the tournament in 467th place
*** SUMMARY ***
Total pot 213388 | Rake 0 
Board [5d 8d 7d 2s Td]
Seat 1: rabwallace1993 folded before Flop (didn't bet)
Seat 2: Mr Pay Shent (button) folded before Flop (didn't bet)
Seat 3: Pseudo Fruto (small blind) showed [Qd Ad] and won (213388) with a flush, Ace high
Seat 4: RenanToniolo (big blind) folded before Flop
Seat 5: S3d3m2 showed [Ah Kd] and lost with a flush, King high
Seat 6: sunn¥m4nn folded before Flop (didn't bet)
Seat 7: podiiii folded before Flop (didn't bet)
Seat 8: BorIska1993 folded before Flop (didn't bet)

PokerStars Hand #251206342528: Tournament #3767885527, $40+$10+$5 USD Hold'em No Limit - Level XVI (1500/3000) - 2024/06/26 19:52:01 UTC [2024/06/26 15:52:01 ET]
Table '3767885527 92' 8-max Seat #3 is the button
Seat 1: rabwallace1993 (104967 in chips) 
Seat 2: Mr Pay Shent (83514 in chips) 
Seat 3: Pseudo Fruto (256652 in chips) 
Seat 4: RenanToniolo (151496 in chips) 
Seat 6: sunn¥m4nn (92150 in chips) 
Seat 7: podiiii (30200 in chips) 
Seat 8: BorIska1993 (181274 in chips) 
rabwallace1993: posts the ante 375
Mr Pay Shent: posts the ante 375
Pseudo Fruto: posts the ante 375
RenanToniolo: posts the ante 375
sunn¥m4nn: posts the ante 375
podiiii: posts the ante 375
BorIska1993: posts the ante 375
RenanToniolo: posts small blind 1500
sunn¥m4nn: posts big blind 3000
*** HOLE CARDS ***
podiiii: folds 
BorIska1993: folds 
rabwallace1993: folds 
Mr Pay Shent: folds 
Pseudo Fruto: raises 3000 to 6000
RenanToniolo: folds 
mv14 is disconnected 
sunn¥m4nn: folds 
Uncalled bet (3000) returned to Pseudo Fruto
Pseudo Fruto collected 10125 from pot
Pseudo Fruto: doesn't show hand 
*** SUMMARY ***
Total pot 10125 | Rake 0 
Seat 1: rabwallace1993 folded before Flop (didn't bet)
Seat 2: Mr Pay Shent folded before Flop (didn't bet)
Seat 3: Pseudo Fruto (button) collected (10125)
Seat 4: RenanToniolo (small blind) folded before Flop
Seat 6: sunn¥m4nn (big blind) folded before Flop
Seat 7: podiiii folded before Flop (didn't bet)
Seat 8: BorIska1993 folded before Flop (didn't bet)

PokerStars Hand #251206348712: Tournament #3767885527, $40+$10+$5 USD Hold'em No Limit - Level XVI (1500/3000) - 2024/06/26 19:52:23 UTC [2024/06/26 15:52:23 ET]
Table '3767885527 92' 8-max Seat #4 is the button
Seat 1: rabwallace1993 (104592 in chips) 
Seat 2: Mr Pay Shent (83139 in chips) 
Seat 3: Pseudo Fruto (263402 in chips) 
Seat 4: RenanToniolo (149621 in chips) 
Seat 5: mv14 (32777 in chips) out of hand (moved from another table into small blind)
Seat 6: sunn¥m4nn (88775 in chips) 
Seat 7: podiiii (29825 in chips) 
Seat 8: BorIska1993 (180899 in chips) 
mv14 will be allowed to play after the button
rabwallace1993: posts the ante 375
Mr Pay Shent: posts the ante 375
Pseudo Fruto: posts the ante 375
RenanToniolo: posts the ante 375
sunn¥m4nn: posts the ante 375
podiiii: posts the ante 375
BorIska1993: posts the ante 375
sunn¥m4nn: posts small blind 1500
podiiii: posts big blind 3000
*** HOLE CARDS ***
BorIska1993: raises 3000 to 6000
rabwallace1993: raises 6000 to 12000
Mr Pay Shent: folds 
Pseudo Fruto: folds 
RenanToniolo: folds 
sunn¥m4nn: folds 
podiiii: folds 
BorIska1993: calls 6000
*** FLOP *** [Qs 6c Tc]
BorIska1993: checks 
rabwallace1993: checks 
*** TURN *** [Qs 6c Tc] [5d]
BorIska1993: bets 21900
rabwallace1993: calls 21900
*** RIVER *** [Qs 6c Tc 5d] [Js]
BorIska1993: checks 
rabwallace1993: bets 40463
BorIska1993: calls 40463
*** SHOW DOWN ***
rabwallace1993: shows [Ks Ah] (a straight, Ten to Ace)
BorIska1993: mucks hand 
rabwallace1993 collected 155851 from pot
*** SUMMARY ***
Total pot 155851 | Rake 0 
Board [Qs 6c Tc 5d Js]
Seat 1: rabwallace1993 showed [Ks Ah] and won (155851) with a straight, Ten to Ace
Seat 2: Mr Pay Shent folded before Flop (didn't bet)
Seat 3: Pseudo Fruto folded before Flop (didn't bet)
Seat 4: RenanToniolo (button) folded before Flop (didn't bet)
Seat 6: sunn¥m4nn (small blind) folded before Flop
Seat 7: podiiii (big blind) folded before Flop
Seat 8: BorIska1993 mucked

PokerStars Hand #251206385232: Tournament #3767885527, $40+$10+$5 USD Hold'em No Limit - Level XVI (1500/3000) - 2024/06/26 19:54:32 UTC [2024/06/26 15:54:32 ET]
Table '3767885527 92' 8-max Seat #6 is the button
Seat 1: rabwallace1993 (185705 in chips) 
Seat 2: Mr Pay Shent (82764 in chips) 
Seat 3: Pseudo Fruto (263027 in chips) 
Seat 4: RenanToniolo (149246 in chips) 
Seat 5: mv14 (32777 in chips) 
Seat 6: sunn¥m4nn (86900 in chips) 
Seat 7: podiiii (26450 in chips) 
Seat 8: BorIska1993 (106161 in chips) 
rabwallace1993: posts the ante 375
Mr Pay Shent: posts the ante 375
Pseudo Fruto: posts the ante 375
RenanToniolo: posts the ante 375
mv14: posts the ante 375
sunn¥m4nn: posts the ante 375
podiiii: posts the ante 375
BorIska1993: posts the ante 375
podiiii: posts small blind 1500
BorIska1993: posts big blind 3000
*** HOLE CARDS ***
rabwallace1993: folds 
Mr Pay Shent: folds 
Pseudo Fruto: raises 3000 to 6000
RenanToniolo: folds 
mv14: folds 
sunn¥m4nn: folds 
podiiii: folds 
BorIska1993: folds 
Uncalled bet (3000) returned to Pseudo Fruto
Pseudo Fruto collected 10500 from pot
Pseudo Fruto: doesn't show hand 
*** SUMMARY ***
Total pot 10500 | Rake 0 
Seat 1: rabwallace1993 folded before Flop (didn't bet)
Seat 2: Mr Pay Shent folded before Flop (didn't bet)
Seat 3: Pseudo Fruto collected (10500)
Seat 4: RenanToniolo folded before Flop (didn't bet)
Seat 5: mv14 folded before Flop (didn't bet)
Seat 6: sunn¥m4nn (button) folded before Flop (didn't bet)
Seat 7: podiiii (small blind) folded before Flop
Seat 8: BorIska1993 (big blind) folded before Flop

PokerStars Hand #251206482751: Tournament #3767885527, $40+$10+$5 USD Hold'em No Limit - Level XVI (1500/3000) - 2024/06/26 20:01:47 UTC [2024/06/26 16:01:47 ET]
Table '3767885527 92' 8-max Seat #7 is the button
Seat 1: rabwallace1993 (185330 in chips) 
Seat 2: Mr Pay Shent (82389 in chips) 
Seat 3: Pseudo Fruto (270152 in chips) 
Seat 4: RenanToniolo (148871 in chips) 
Seat 5: mv14 (32402 in chips) 
Seat 6: sunn¥m4nn (86525 in chips) 
Seat 7: podiiii (24575 in chips) 
Seat 8: BorIska1993 (102786 in chips) 
rabwallace1993: posts the ante 375
Mr Pay Shent: posts the ante 375
Pseudo Fruto: posts the ante 375
RenanToniolo: posts the ante 375
mv14: posts the ante 375
sunn¥m4nn: posts the ante 375
podiiii: posts the ante 375
BorIska1993: posts the ante 375
BorIska1993: posts small blind 1500
rabwallace1993: posts big blind 3000
*** HOLE CARDS ***
Mr Pay Shent: folds 
Pseudo Fruto: folds 
RenanToniolo: folds 
mv14: folds 
sunn¥m4nn: raises 3000 to 6000
podiiii: folds 
BorIska1993: calls 4500
rabwallace1993: calls 3000
*** FLOP *** [5d 7c 2d]
BorIska1993: checks 
rabwallace1993: checks 
sunn¥m4nn: checks 
*** TURN *** [5d 7c 2d] [Jh]
BorIska1993: checks 
rabwallace1993: checks 
sunn¥m4nn: bets 15000
BorIska1993: folds 
rabwallace1993: calls 15000
*** RIVER *** [5d 7c 2d Jh] [Qh]
rabwallace1993: checks 
sunn¥m4nn: checks 
*** SHOW DOWN ***
rabwallace1993: shows [Kh 5s] (a pair of Fives)
sunn¥m4nn: shows [Jd Ks] (a pair of Jacks)
sunn¥m4nn collected 51000 from pot
*** SUMMARY ***
Total pot 51000 | Rake 0 
Board [5d 7c 2d Jh Qh]
Seat 1: rabwallace1993 (big blind) showed [Kh 5s] and lost with a pair of Fives
Seat 2: Mr Pay Shent folded before Flop (didn't bet)
Seat 3: Pseudo Fruto folded before Flop (didn't bet)
Seat 4: RenanToniolo folded before Flop (didn't bet)
Seat 5: mv14 folded before Flop (didn't bet)
Seat 6: sunn¥m4nn showed [Jd Ks] and won (51000) with a pair of Jacks
Seat 7: podiiii (button) folded before Flop (didn't bet)
Seat 8: BorIska1993 (small blind) folded on the Turn

PokerStars Hand #251206518088: Tournament #3767885527, $40+$10+$5 USD Hold'em No Limit - Level XVI (1500/3000) - 2024/06/26 20:03:52 UTC [2024/06/26 16:03:52 ET]
Table '3767885527 92' 8-max Seat #8 is the button
Seat 1: rabwallace1993 (163955 in chips) 
Seat 2: Mr Pay Shent (82014 in chips) 
Seat 3: Pseudo Fruto (269777 in chips) 
Seat 4: RenanToniolo (148496 in chips) 
Seat 5: mv14 (32027 in chips) 
Seat 6: sunn¥m4nn (116150 in chips) 
Seat 7: podiiii (24200 in chips) 
Seat 8: BorIska1993 (96411 in chips) 
rabwallace1993: posts the ante 375
Mr Pay Shent: posts the ante 375
Pseudo Fruto: posts the ante 375
RenanToniolo: posts the ante 375
mv14: posts the ante 375
sunn¥m4nn: posts the ante 375
podiiii: posts the ante 375
BorIska1993: posts the ante 375
rabwallace1993: posts small blind 1500
Mr Pay Shent: posts big blind 3000
*** HOLE CARDS ***
Pseudo Fruto: folds 
RenanToniolo: folds 
mv14: raises 3000 to 6000
sunn¥m4nn: folds 
podiiii: folds 
BorIska1993: folds 
rabwallace1993: folds 
Mr Pay Shent: calls 3000
*** FLOP *** [9d 6h Ac]
Mr Pay Shent: checks 
mv14: bets 5670
Mr Pay Shent: raises 5670 to 11340
mv14: calls 5670
*** TURN *** [9d 6h Ac] [7s]
Mr Pay Shent: bets 39180
mv14: folds 
Uncalled bet (39180) returned to Mr Pay Shent
Mr Pay Shent collected 39180 from pot
Mr Pay Shent: doesn't show hand 
*** SUMMARY ***
Total pot 39180 | Rake 0 
Board [9d 6h Ac 7s]
Seat 1: rabwallace1993 (small blind) folded before Flop
Seat 2: Mr Pay Shent (big blind) collected (39180)
Seat 3: Pseudo Fruto folded before Flop (didn't bet)
Seat 4: RenanToniolo folded before Flop (didn't bet)
Seat 5: mv14 folded on the Turn
Seat 6: sunn¥m4nn folded before Flop (didn't bet)
Seat 7: podiiii folded before Flop (didn't bet)
Seat 8: BorIska1993 (button) folded before Flop (didn't bet)

PokerStars Hand #251206536329: Tournament #3767885527, $40+$10+$5 USD Hold'em No Limit - Level XVI (1500/3000) - 2024/06/26 20:04:56 UTC [2024/06/26 16:04:56 ET]
Table '3767885527 92' 8-max Seat #1 is the button
Seat 1: rabwallace1993 (162080 in chips) 
Seat 2: Mr Pay Shent (103479 in chips) 
Seat 3: Pseudo Fruto (269402 in chips) 
Seat 4: RenanToniolo (148121 in chips) 
Seat 5: mv14 (14312 in chips) 
Seat 6: sunn¥m4nn (115775 in chips) 
Seat 7: podiiii (23825 in chips) 
Seat 8: BorIska1993 (96036 in chips) 
rabwallace1993: posts the ante 375
Mr Pay Shent: posts the ante 375
Pseudo Fruto: posts the ante 375
RenanToniolo: posts the ante 375
mv14: posts the ante 375
sunn¥m4nn: posts the ante 375
podiiii: posts the ante 375
BorIska1993: posts the ante 375
Mr Pay Shent: posts small blind 1500
Pseudo Fruto: posts big blind 3000
*** HOLE CARDS ***
RenanToniolo: raises 3000 to 6000
mv14: folds 
sunn¥m4nn: folds 
podiiii: folds 
BorIska1993: folds 
rabwallace1993: folds 
Mr Pay Shent: folds 
Pseudo Fruto: folds 
Uncalled bet (3000) returned to RenanToniolo
RenanToniolo collected 10500 from pot
*** SUMMARY ***
Total pot 10500 | Rake 0 
Seat 1: rabwallace1993 (button) folded before Flop (didn't bet)
Seat 2: Mr Pay Shent (small blind) folded before Flop
Seat 3: Pseudo Fruto (big blind) folded before Flop
Seat 4: RenanToniolo collected (10500)
Seat 5: mv14 folded before Flop (didn't bet)
Seat 6: sunn¥m4nn folded before Flop (didn't bet)
Seat 7: podiiii folded before Flop (didn't bet)
Seat 8: BorIska1993 folded before Flop (didn't bet)

PokerStars Hand #251206550249: Tournament #3767885527, $40+$10+$5 USD Hold'em No Limit - Level XVI (1500/3000) - 2024/06/26 20:05:44 UTC [2024/06/26 16:05:44 ET]
Table '3767885527 92' 8-max Seat #2 is the button
Seat 1: rabwallace1993 (161705 in chips) 
Seat 2: Mr Pay Shent (101604 in chips) 
Seat 3: Pseudo Fruto (266027 in chips) 
Seat 4: RenanToniolo (155246 in chips) 
Seat 5: mv14 (13937 in chips) 
Seat 6: sunn¥m4nn (115400 in chips) 
Seat 7: podiiii (23450 in chips) 
Seat 8: BorIska1993 (95661 in chips) 
rabwallace1993: posts the ante 375
Mr Pay Shent: posts the ante 375
Pseudo Fruto: posts the ante 375
RenanToniolo: posts the ante 375
mv14: posts the ante 375
sunn¥m4nn: posts the ante 375
podiiii: posts the ante 375
BorIska1993: posts the ante 375
Pseudo Fruto: posts small blind 1500
RenanToniolo: posts big blind 3000
*** HOLE CARDS ***
mv14: folds 
sunn¥m4nn: folds 
podiiii: folds 
BorIska1993: folds 
rabwallace1993: folds 
Mr Pay Shent: folds 
Pseudo Fruto: raises 7500 to 10500
RenanToniolo: calls 7500
*** FLOP *** [Th Ac 8h]
Pseudo Fruto has timed out
Pseudo Fruto: checks 
RenanToniolo: bets 16000
Pseudo Fruto: raises 26000 to 42000
RenanToniolo: folds 
Uncalled bet (26000) returned to Pseudo Fruto
Pseudo Fruto collected 56000 from pot
Pseudo Fruto: doesn't show hand 
*** SUMMARY ***
Total pot 56000 | Rake 0 
Board [Th Ac 8h]
Seat 1: rabwallace1993 folded before Flop (didn't bet)
Seat 2: Mr Pay Shent (button) folded before Flop (didn't bet)
Seat 3: Pseudo Fruto (small blind) collected (56000)
Seat 4: RenanToniolo (big blind) folded on the Flop
Seat 5: mv14 folded before Flop (didn't bet)
Seat 6: sunn¥m4nn folded before Flop (didn't bet)
Seat 7: podiiii folded before Flop (didn't bet)
Seat 8: BorIska1993 folded before Flop (didn't bet)

PokerStars Hand #251206577141: Tournament #3767885527, $40+$10+$5 USD Hold'em No Limit - Level XVII (1750/3500) - 2024/06/26 20:07:18 UTC [2024/06/26 16:07:18 ET]
Table '3767885527 92' 8-max Seat #3 is the button
Seat 1: rabwallace1993 (161330 in chips) 
Seat 2: Mr Pay Shent (101229 in chips) 
Seat 3: Pseudo Fruto (295152 in chips) 
Seat 4: RenanToniolo (128371 in chips) 
Seat 5: mv14 (13562 in chips) 
Seat 6: sunn¥m4nn (115025 in chips) 
Seat 7: podiiii (23075 in chips) 
Seat 8: BorIska1993 (95286 in chips) 
rabwallace1993: posts the ante 450
Mr Pay Shent: posts the ante 450
Pseudo Fruto: posts the ante 450
RenanToniolo: posts the ante 450
mv14: posts the ante 450
sunn¥m4nn: posts the ante 450
podiiii: posts the ante 450
BorIska1993: posts the ante 450
RenanToniolo: posts small blind 1750
mv14: posts big blind 3500
*** HOLE CARDS ***
sunn¥m4nn: folds 
podiiii: folds 
BorIska1993: folds 
rabwallace1993: folds 
Mr Pay Shent: folds 
Pseudo Fruto: folds 
RenanToniolo: raises 12250 to 15750
mv14: calls 9612 and is all-in
Uncalled bet (2638) returned to RenanToniolo
*** FLOP *** [Qd Js 7s]
*** TURN *** [Qd Js 7s] [9h]
*** RIVER *** [Qd Js 7s 9h] [Jh]
*** SHOW DOWN ***
RenanToniolo: shows [6c 5d] (a pair of Jacks)
mv14: shows [4c Jc] (three of a kind, Jacks)
mv14 collected 29824 from pot
*** SUMMARY ***
Total pot 29824 | Rake 0 
Board [Qd Js 7s 9h Jh]
Seat 1: rabwallace1993 folded before Flop (didn't bet)
Seat 2: Mr Pay Shent folded before Flop (didn't bet)
Seat 3: Pseudo Fruto (button) folded before Flop (didn't bet)
Seat 4: RenanToniolo (small blind) showed [6c 5d] and lost with a pair of Jacks
Seat 5: mv14 (big blind) showed [4c Jc] and won (29824) with three of a kind, Jacks
Seat 6: sunn¥m4nn folded before Flop (didn't bet)
Seat 7: podiiii folded before Flop (didn't bet)
Seat 8: BorIska1993 folded before Flop (didn't bet)

PokerStars Hand #251206586348: Tournament #3767885527, $40+$10+$5 USD Hold'em No Limit - Level XVII (1750/3500) - 2024/06/26 20:07:51 UTC [2024/06/26 16:07:51 ET]
Table '3767885527 92' 8-max Seat #4 is the button
Seat 1: rabwallace1993 (160880 in chips) 
Seat 2: Mr Pay Shent (100779 in chips) 
Seat 3: Pseudo Fruto (294702 in chips) 
Seat 4: RenanToniolo (114809 in chips) 
Seat 5: mv14 (29824 in chips) 
Seat 6: sunn¥m4nn (114575 in chips) 
Seat 7: podiiii (22625 in chips) 
Seat 8: BorIska1993 (94836 in chips) 
rabwallace1993: posts the ante 450
Mr Pay Shent: posts the ante 450
Pseudo Fruto: posts the ante 450
RenanToniolo: posts the ante 450
mv14: posts the ante 450
sunn¥m4nn: posts the ante 450
podiiii: posts the ante 450
BorIska1993: posts the ante 450
mv14: posts small blind 1750
sunn¥m4nn: posts big blind 3500
*** HOLE CARDS ***
podiiii: raises 18675 to 22175 and is all-in
BorIska1993: folds 
rabwallace1993: folds 
Mr Pay Shent: folds 
Pseudo Fruto: folds 
RenanToniolo: folds 
mv14: folds 
sunn¥m4nn: calls 18675
*** FLOP *** [4s Ks 7s]
*** TURN *** [4s Ks 7s] [3h]
*** RIVER *** [4s Ks 7s 3h] [7h]
*** SHOW DOWN ***
sunn¥m4nn: shows [Ad Kh] (two pair, Kings and Sevens)
podiiii: shows [9d 9c] (two pair, Nines and Sevens)
sunn¥m4nn collected 49700 from pot
podiiii finished the tournament in 394th place
*** SUMMARY ***
Total pot 49700 | Rake 0 
Board [4s Ks 7s 3h 7h]
Seat 1: rabwallace1993 folded before Flop (didn't bet)
Seat 2: Mr Pay Shent folded before Flop (didn't bet)
Seat 3: Pseudo Fruto folded before Flop (didn't bet)
Seat 4: RenanToniolo (button) folded before Flop (didn't bet)
Seat 5: mv14 (small blind) folded before Flop
Seat 6: sunn¥m4nn (big blind) showed [Ad Kh] and won (49700) with two pair, Kings and Sevens
Seat 7: podiiii showed [9d 9c] and lost with two pair, Nines and Sevens
Seat 8: BorIska1993 folded before Flop (didn't bet)

PokerStars Hand #251206594589: Tournament #3767885527, $40+$10+$5 USD Hold'em No Limit - Level XVII (1750/3500) - 2024/06/26 20:08:20 UTC [2024/06/26 16:08:20 ET]
Table '3767885527 92' 8-max Seat #5 is the button
Seat 1: rabwallace1993 (160430 in chips) 
Seat 2: Mr Pay Shent (100329 in chips) 
Seat 3: Pseudo Fruto (294252 in chips) 
Seat 4: RenanToniolo (114359 in chips) 
Seat 5: mv14 (27624 in chips) 
Seat 6: sunn¥m4nn (141650 in chips) 
Seat 8: BorIska1993 (94386 in chips) 
rabwallace1993: posts the ante 450
Mr Pay Shent: posts the ante 450
Pseudo Fruto: posts the ante 450
RenanToniolo: posts the ante 450
mv14: posts the ante 450
sunn¥m4nn: posts the ante 450
BorIska1993: posts the ante 450
sunn¥m4nn: posts small blind 1750
BorIska1993: posts big blind 3500
*** HOLE CARDS ***
rabwallace1993: folds 
Mr Pay Shent: raises 3500 to 7000
Pseudo Fruto: folds 
RenanToniolo: folds 
mv14: folds 
sunn¥m4nn: folds 
BorIska1993: calls 3500
*** FLOP *** [6c Jd 5s]
BorIska1993: checks 
Mr Pay Shent: checks 
*** TURN *** [6c Jd 5s] [7s]
BorIska1993: bets 6237
Mr Pay Shent: calls 6237
*** RIVER *** [6c Jd 5s 7s] [5d]
BorIska1993: bets 16001
Mr Pay Shent: calls 16001
*** SHOW DOWN ***
BorIska1993: shows [Ad 7d] (two pair, Sevens and Fives)
Mr Pay Shent: mucks hand 
BorIska1993 collected 63376 from pot
*** SUMMARY ***
Total pot 63376 | Rake 0 
Board [6c Jd 5s 7s 5d]
Seat 1: rabwallace1993 folded before Flop (didn't bet)
Seat 2: Mr Pay Shent mucked
Seat 3: Pseudo Fruto folded before Flop (didn't bet)
Seat 4: RenanToniolo folded before Flop (didn't bet)
Seat 5: mv14 (button) folded before Flop (didn't bet)
Seat 6: sunn¥m4nn (small blind) folded before Flop
Seat 8: BorIska1993 (big blind) showed [Ad 7d] and won (63376) with two pair, Sevens and Fives

PokerStars Hand #251206607239: Tournament #3767885527, $40+$10+$5 USD Hold'em No Limit - Level XVII (1750/3500) - 2024/06/26 20:09:04 UTC [2024/06/26 16:09:04 ET]
Table '3767885527 92' 8-max Seat #6 is the button
Seat 1: rabwallace1993 (159980 in chips) 
Seat 2: Mr Pay Shent (70641 in chips) 
Seat 3: Pseudo Fruto (293802 in chips) 
Seat 4: RenanToniolo (113909 in chips) 
Seat 5: mv14 (27174 in chips) 
Seat 6: sunn¥m4nn (139450 in chips) 
Seat 7: esdeathonlol (28675 in chips) out of hand (moved from another table into small blind)
Seat 8: BorIska1993 (128074 in chips) 
esdeathonlol will be allowed to play after the button
rabwallace1993: posts the ante 450
Mr Pay Shent: posts the ante 450
Pseudo Fruto: posts the ante 450
RenanToniolo: posts the ante 450
mv14: posts the ante 450
sunn¥m4nn: posts the ante 450
BorIska1993: posts the ante 450
BorIska1993: posts small blind 1750
rabwallace1993: posts big blind 3500
*** HOLE CARDS ***
Mr Pay Shent: folds 
Pseudo Fruto: folds 
RenanToniolo: folds 
mv14: folds 
sunn¥m4nn: raises 3500 to 7000
BorIska1993: folds 
rabwallace1993: folds 
Uncalled bet (3500) returned to sunn¥m4nn
sunn¥m4nn collected 11900 from pot
sunn¥m4nn: doesn't show hand 
*** SUMMARY ***
Total pot 11900 | Rake 0 
Seat 1: rabwallace1993 (big blind) folded before Flop
Seat 2: Mr Pay Shent folded before Flop (didn't bet)
Seat 3: Pseudo Fruto folded before Flop (didn't bet)
Seat 4: RenanToniolo folded before Flop (didn't bet)
Seat 5: mv14 folded before Flop (didn't bet)
Seat 6: sunn¥m4nn (button) collected (11900)
Seat 8: BorIska1993 (small blind) folded before Flop

PokerStars Hand #251206618581: Tournament #3767885527, $40+$10+$5 USD Hold'em No Limit - Level XVII (1750/3500) - 2024/06/26 20:09:44 UTC [2024/06/26 16:09:44 ET]
Table '3767885527 92' 8-max Seat #8 is the button
Seat 1: rabwallace1993 (156030 in chips) 
Seat 2: Mr Pay Shent (70191 in chips) 
Seat 3: Pseudo Fruto (293352 in chips) 
Seat 4: RenanToniolo (113459 in chips) 
Seat 5: mv14 (26724 in chips) 
Seat 6: sunn¥m4nn (147400 in chips) 
Seat 7: esdeathonlol (28675 in chips) 
Seat 8: BorIska1993 (125874 in chips) 
rabwallace1993: posts the ante 450
Mr Pay Shent: posts the ante 450
Pseudo Fruto: posts the ante 450
RenanToniolo: posts the ante 450
mv14: posts the ante 450
sunn¥m4nn: posts the ante 450
esdeathonlol: posts the ante 450
BorIska1993: posts the ante 450
rabwallace1993: posts small blind 1750
Mr Pay Shent: posts big blind 3500
*** HOLE CARDS ***
Pseudo Fruto: folds 
RenanToniolo: folds 
mv14: folds 
sunn¥m4nn: folds 
esdeathonlol: folds 
BorIska1993: raises 3500 to 7000
rabwallace1993: calls 5250
Mr Pay Shent: calls 3500
*** FLOP *** [2h 6c 6h]
rabwallace1993: checks 
Mr Pay Shent: checks 
BorIska1993: bets 7350
rabwallace1993: calls 7350
Mr Pay Shent: folds 
*** TURN *** [2h 6c 6h] [Ts]
rabwallace1993: checks 
BorIska1993: checks 
*** RIVER *** [2h 6c 6h Ts] [8s]
rabwallace1993: checks 
BorIska1993: checks 
*** SHOW DOWN ***
rabwallace1993: shows [3s As] (a pair of Sixes)
BorIska1993: shows [7s 7h] (two pair, Sevens and Sixes)
BorIska1993 collected 39300 from pot
*** SUMMARY ***
Total pot 39300 | Rake 0 
Board [2h 6c 6h Ts 8s]
Seat 1: rabwallace1993 (small blind) showed [3s As] and lost with a pair of Sixes
Seat 2: Mr Pay Shent (big blind) folded on the Flop
Seat 3: Pseudo Fruto folded before Flop (didn't bet)
Seat 4: RenanToniolo folded before Flop (didn't bet)
Seat 5: mv14 folded before Flop (didn't bet)
Seat 6: sunn¥m4nn folded before Flop (didn't bet)
Seat 7: esdeathonlol folded before Flop (didn't bet)
Seat 8: BorIska1993 (button) showed [7s 7h] and won (39300) with two pair, Sevens and Sixes

PokerStars Hand #251206643533: Tournament #3767885527, $40+$10+$5 USD Hold'em No Limit - Level XVII (1750/3500) - 2024/06/26 20:11:11 UTC [2024/06/26 16:11:11 ET]
Table '3767885527 92' 8-max Seat #1 is the button
Seat 1: rabwallace1993 (141230 in chips) 
Seat 2: Mr Pay Shent (62741 in chips) 
Seat 3: Pseudo Fruto (292902 in chips) 
Seat 4: RenanToniolo (113009 in chips) 
Seat 5: mv14 (26274 in chips) 
Seat 6: sunn¥m4nn (146950 in chips) 
Seat 7: esdeathonlol (28225 in chips) 
Seat 8: BorIska1993 (150374 in chips) 
rabwallace1993: posts the ante 450
Mr Pay Shent: posts the ante 450
Pseudo Fruto: posts the ante 450
RenanToniolo: posts the ante 450
mv14: posts the ante 450
sunn¥m4nn: posts the ante 450
esdeathonlol: posts the ante 450
BorIska1993: posts the ante 450
Mr Pay Shent: posts small blind 1750
Pseudo Fruto: posts big blind 3500
*** HOLE CARDS ***
RenanToniolo: folds 
mv14: folds 
sunn¥m4nn: folds 
esdeathonlol: folds 
BorIska1993: folds 
rabwallace1993: folds 
Mr Pay Shent: folds 
Uncalled bet (1750) returned to Pseudo Fruto
Pseudo Fruto collected 7100 from pot
Pseudo Fruto: doesn't show hand 
*** SUMMARY ***
Total pot 7100 | Rake 0 
Seat 1: rabwallace1993 (button) folded before Flop (didn't bet)
Seat 2: Mr Pay Shent (small blind) folded before Flop
Seat 3: Pseudo Fruto (big blind) collected (7100)
Seat 4: RenanToniolo folded before Flop (didn't bet)
Seat 5: mv14 folded before Flop (didn't bet)
Seat 6: sunn¥m4nn folded before Flop (didn't bet)
Seat 7: esdeathonlol folded before Flop (didn't bet)
Seat 8: BorIska1993 folded before Flop (didn't bet)

PokerStars Hand #251206648845: Tournament #3767885527, $40+$10+$5 USD Hold'em No Limit - Level XVII (1750/3500) - 2024/06/26 20:11:30 UTC [2024/06/26 16:11:30 ET]
Table '3767885527 92' 8-max Seat #2 is the button
Seat 1: rabwallace1993 (140780 in chips) 
Seat 2: Mr Pay Shent (60541 in chips) 
Seat 3: Pseudo Fruto (297802 in chips) 
Seat 4: RenanToniolo (112559 in chips) 
Seat 5: mv14 (25824 in chips) 
Seat 6: sunn¥m4nn (146500 in chips) 
Seat 7: esdeathonlol (27775 in chips) 
Seat 8: BorIska1993 (149924 in chips) 
rabwallace1993: posts the ante 450
Mr Pay Shent: posts the ante 450
Pseudo Fruto: posts the ante 450
RenanToniolo: posts the ante 450
mv14: posts the ante 450
sunn¥m4nn: posts the ante 450
esdeathonlol: posts the ante 450
BorIska1993: posts the ante 450
Pseudo Fruto: posts small blind 1750
RenanToniolo: posts big blind 3500
*** HOLE CARDS ***
mv14: folds 
sunn¥m4nn: folds 
esdeathonlol: folds 
BorIska1993: folds 
rabwallace1993: folds 
Mr Pay Shent: raises 56591 to 60091 and is all-in
Pseudo Fruto: raises 56591 to 116682
RenanToniolo: folds 
Uncalled bet (56591) returned to Pseudo Fruto
*** FLOP *** [Kh 6h 7h]
*** TURN *** [Kh 6h 7h] [3c]
*** RIVER *** [Kh 6h 7h 3c] [Qh]
*** SHOW DOWN ***
Pseudo Fruto: shows [As Kc] (a pair of Kings)
Mr Pay Shent: shows [2d Ac] (high card Ace)
Pseudo Fruto collected 127282 from pot
Mr Pay Shent finished the tournament in 377th place
*** SUMMARY ***
Total pot 127282 | Rake 0 
Board [Kh 6h 7h 3c Qh]
Seat 1: rabwallace1993 folded before Flop (didn't bet)
Seat 2: Mr Pay Shent (button) showed [2d Ac] and lost with high card Ace
Seat 3: Pseudo Fruto (small blind) showed [As Kc] and won (127282) with a pair of Kings
Seat 4: RenanToniolo (big blind) folded before Flop
Seat 5: mv14 folded before Flop (didn't bet)
Seat 6: sunn¥m4nn folded before Flop (didn't bet)
Seat 7: esdeathonlol folded before Flop (didn't bet)
Seat 8: BorIska1993 folded before Flop (didn't bet)


PokerStars Hand #251206987410: Tournament #3767885527, $40+$10+$5 USD Hold'em No Limit - Level XIX (2500/5000) - 2024/06/26 20:31:39 UTC [2024/06/26 16:31:39 ET]
Table '3767885527 63' 8-max Seat #5 is the button
Seat 1: T3RSS1 (51554 in chips) 
Seat 2: Giginis (280251 in chips) 
Seat 3: Antanavinis (74238 in chips) 
Seat 4: BorIska1993 (132514 in chips) 
Seat 5: haitzi1 (30414 in chips) 
Seat 6: Varle84 (86978 in chips) 
Seat 7: RRoleto (39827 in chips) 
Seat 8: Snoopy95_2.0 (135824 in chips) 
T3RSS1: posts the ante 625
Giginis: posts the ante 625
Antanavinis: posts the ante 625
BorIska1993: posts the ante 625
haitzi1: posts the ante 625
Varle84: posts the ante 625
RRoleto: posts the ante 625
Snoopy95_2.0: posts the ante 625
Varle84: posts small blind 2500
RRoleto: posts big blind 5000
*** HOLE CARDS ***
Snoopy95_2.0: folds 
T3RSS1: folds 
Giginis: folds 
Antanavinis: folds 
BorIska1993: folds 
haitzi1: folds 
Varle84: raises 81353 to 86353 and is all-in
RRoleto: folds 
Uncalled bet (81353) returned to Varle84
Varle84 collected 15000 from pot
*** SUMMARY ***
Total pot 15000 | Rake 0 
Seat 1: T3RSS1 folded before Flop (didn't bet)
Seat 2: Giginis folded before Flop (didn't bet)
Seat 3: Antanavinis folded before Flop (didn't bet)
Seat 4: BorIska1993 folded before Flop (didn't bet)
Seat 5: haitzi1 (button) folded before Flop (didn't bet)
Seat 6: Varle84 (small blind) collected (15000)
Seat 7: RRoleto (big blind) folded before Flop
Seat 8: Snoopy95_2.0 folded before Flop (didn't bet)

PokerStars Hand #251206997044: Tournament #3767885527, $40+$10+$5 USD Hold'em No Limit - Level XIX (2500/5000) - 2024/06/26 20:32:13 UTC [2024/06/26 16:32:13 ET]
Table '3767885527 63' 8-max Seat #6 is the button
Seat 1: T3RSS1 (50929 in chips) 
Seat 2: Giginis (279626 in chips) 
Seat 3: Antanavinis (73613 in chips) 
Seat 4: BorIska1993 (131889 in chips) 
Seat 5: haitzi1 (29789 in chips) 
Seat 6: Varle84 (96353 in chips) 
Seat 7: RRoleto (34202 in chips) 
Seat 8: Snoopy95_2.0 (135199 in chips) 
T3RSS1: posts the ante 625
Giginis: posts the ante 625
Antanavinis: posts the ante 625
BorIska1993: posts the ante 625
haitzi1: posts the ante 625
Varle84: posts the ante 625
RRoleto: posts the ante 625
Snoopy95_2.0: posts the ante 625
RRoleto: posts small blind 2500
Snoopy95_2.0: posts big blind 5000
*** HOLE CARDS ***
T3RSS1: folds 
Giginis: raises 5000 to 10000
Antanavinis: raises 62500 to 72500
BorIska1993: folds 
haitzi1: folds 
Varle84: folds 
RRoleto: folds 
Snoopy95_2.0: folds 
Giginis: folds 
Uncalled bet (62500) returned to Antanavinis
Antanavinis collected 32500 from pot
Antanavinis: doesn't show hand 
*** SUMMARY ***
Total pot 32500 | Rake 0 
Seat 1: T3RSS1 folded before Flop (didn't bet)
Seat 2: Giginis folded before Flop
Seat 3: Antanavinis collected (32500)
Seat 4: BorIska1993 folded before Flop (didn't bet)
Seat 5: haitzi1 folded before Flop (didn't bet)
Seat 6: Varle84 (button) folded before Flop (didn't bet)
Seat 7: RRoleto (small blind) folded before Flop
Seat 8: Snoopy95_2.0 (big blind) folded before Flop

PokerStars Hand #251207031980: Tournament #3767885527, $40+$10+$5 USD Hold'em No Limit - Level XIX (2500/5000) - 2024/06/26 20:34:17 UTC [2024/06/26 16:34:17 ET]
Table '3767885527 63' 8-max Seat #7 is the button
Seat 1: T3RSS1 (50304 in chips) 
Seat 2: Giginis (269001 in chips) 
Seat 3: Antanavinis (95488 in chips) 
Seat 4: BorIska1993 (131264 in chips) 
Seat 5: haitzi1 (29164 in chips) 
Seat 6: Varle84 (95728 in chips) 
Seat 7: RRoleto (31077 in chips) 
Seat 8: Snoopy95_2.0 (129574 in chips) 
T3RSS1: posts the ante 625
Giginis: posts the ante 625
Antanavinis: posts the ante 625
BorIska1993: posts the ante 625
haitzi1: posts the ante 625
Varle84: posts the ante 625
RRoleto: posts the ante 625
Snoopy95_2.0: posts the ante 625
Snoopy95_2.0: posts small blind 2500
T3RSS1: posts big blind 5000
*** HOLE CARDS ***
Giginis: folds 
Antanavinis: folds 
BorIska1993: folds 
haitzi1: folds 
Varle84: folds 
RRoleto: folds 
Snoopy95_2.0: raises 123949 to 128949 and is all-in
T3RSS1: folds 
Uncalled bet (123949) returned to Snoopy95_2.0
Snoopy95_2.0 collected 15000 from pot
Snoopy95_2.0: doesn't show hand 
*** SUMMARY ***
Total pot 15000 | Rake 0 
Seat 1: T3RSS1 (big blind) folded before Flop
Seat 2: Giginis folded before Flop (didn't bet)
Seat 3: Antanavinis folded before Flop (didn't bet)
Seat 4: BorIska1993 folded before Flop (didn't bet)
Seat 5: haitzi1 folded before Flop (didn't bet)
Seat 6: Varle84 folded before Flop (didn't bet)
Seat 7: RRoleto (button) folded before Flop (didn't bet)
Seat 8: Snoopy95_2.0 (small blind) collected (15000)

PokerStars Hand #251207041341: Tournament #3767885527, $40+$10+$5 USD Hold'em No Limit - Level XIX (2500/5000) - 2024/06/26 20:34:50 UTC [2024/06/26 16:34:50 ET]
Table '3767885527 63' 8-max Seat #8 is the button
Seat 1: T3RSS1 (44679 in chips) 
Seat 2: Giginis (268376 in chips) 
Seat 3: Antanavinis (94863 in chips) 
Seat 4: BorIska1993 (130639 in chips) 
Seat 5: haitzi1 (28539 in chips) 
Seat 6: Varle84 (95103 in chips) 
Seat 7: RRoleto (30452 in chips) 
Seat 8: Snoopy95_2.0 (138949 in chips) 
T3RSS1: posts the ante 625
Giginis: posts the ante 625
Antanavinis: posts the ante 625
BorIska1993: posts the ante 625
haitzi1: posts the ante 625
Varle84: posts the ante 625
RRoleto: posts the ante 625
Snoopy95_2.0: posts the ante 625
T3RSS1: posts small blind 2500
Giginis: posts big blind 5000
*** HOLE CARDS ***
Antanavinis: folds 
BorIska1993: folds 
haitzi1: folds 
Varle84: folds 
RRoleto: folds 
Snoopy95_2.0: calls 5000
T3RSS1: folds 
Giginis: raises 18000 to 23000
Snoopy95_2.0: folds 
Uncalled bet (18000) returned to Giginis
Giginis collected 17500 from pot
*** SUMMARY ***
Total pot 17500 | Rake 0 
Seat 1: T3RSS1 (small blind) folded before Flop
Seat 2: Giginis (big blind) collected (17500)
Seat 3: Antanavinis folded before Flop (didn't bet)
Seat 4: BorIska1993 folded before Flop (didn't bet)
Seat 5: haitzi1 folded before Flop (didn't bet)
Seat 6: Varle84 folded before Flop (didn't bet)
Seat 7: RRoleto folded before Flop (didn't bet)
Seat 8: Snoopy95_2.0 (button) folded before Flop

PokerStars Hand #251207053943: Tournament #3767885527, $40+$10+$5 USD Hold'em No Limit - Level XIX (2500/5000) - 2024/06/26 20:35:34 UTC [2024/06/26 16:35:34 ET]
Table '3767885527 63' 8-max Seat #1 is the button
Seat 1: T3RSS1 (41554 in chips) 
Seat 2: Giginis (280251 in chips) 
Seat 3: Antanavinis (94238 in chips) 
Seat 4: BorIska1993 (130014 in chips) 
Seat 5: haitzi1 (27914 in chips) 
Seat 6: Varle84 (94478 in chips) 
Seat 7: RRoleto (29827 in chips) 
Seat 8: Snoopy95_2.0 (133324 in chips) 
T3RSS1: posts the ante 625
Giginis: posts the ante 625
Antanavinis: posts the ante 625
BorIska1993: posts the ante 625
haitzi1: posts the ante 625
Varle84: posts the ante 625
RRoleto: posts the ante 625
Snoopy95_2.0: posts the ante 625
Giginis: posts small blind 2500
Antanavinis: posts big blind 5000
*** HOLE CARDS ***
BorIska1993: folds 
haitzi1: raises 22289 to 27289 and is all-in
Varle84: folds 
RRoleto: folds 
Snoopy95_2.0: folds 
T3RSS1: folds 
Giginis: folds 
Antanavinis: folds 
Uncalled bet (22289) returned to haitzi1
haitzi1 collected 17500 from pot
*** SUMMARY ***
Total pot 17500 | Rake 0 
Seat 1: T3RSS1 (button) folded before Flop (didn't bet)
Seat 2: Giginis (small blind) folded before Flop
Seat 3: Antanavinis (big blind) folded before Flop
Seat 4: BorIska1993 folded before Flop (didn't bet)
Seat 5: haitzi1 collected (17500)
Seat 6: Varle84 folded before Flop (didn't bet)
Seat 7: RRoleto folded before Flop (didn't bet)
Seat 8: Snoopy95_2.0 folded before Flop (didn't bet)

PokerStars Hand #251207061403: Tournament #3767885527, $40+$10+$5 USD Hold'em No Limit - Level XX (3000/6000) - 2024/06/26 20:36:01 UTC [2024/06/26 16:36:01 ET]
Table '3767885527 63' 8-max Seat #2 is the button
Seat 1: T3RSS1 (40929 in chips) 
Seat 2: Giginis (277126 in chips) 
Seat 3: Antanavinis (88613 in chips) 
Seat 4: BorIska1993 (129389 in chips) 
Seat 5: haitzi1 (39789 in chips) 
Seat 6: Varle84 (93853 in chips) 
Seat 7: RRoleto (29202 in chips) 
Seat 8: Snoopy95_2.0 (132699 in chips) 
T3RSS1: posts the ante 750
Giginis: posts the ante 750
Antanavinis: posts the ante 750
BorIska1993: posts the ante 750
haitzi1: posts the ante 750
Varle84: posts the ante 750
RRoleto: posts the ante 750
Snoopy95_2.0: posts the ante 750
Antanavinis: posts small blind 3000
BorIska1993: posts big blind 6000
*** HOLE CARDS ***
haitzi1: folds 
Varle84: folds 
RRoleto: folds 
Snoopy95_2.0: folds 
T3RSS1: folds 
Giginis: folds 
Antanavinis: calls 3000
BorIska1993: checks 
*** FLOP *** [Td 6s Tc]
Antanavinis: checks 
BorIska1993: checks 
*** TURN *** [Td 6s Tc] [Th]
Antanavinis: bets 13500
BorIska1993: folds 
Uncalled bet (13500) returned to Antanavinis
Antanavinis collected 18000 from pot
Antanavinis: doesn't show hand 
*** SUMMARY ***
Total pot 18000 | Rake 0 
Board [Td 6s Tc Th]
Seat 1: T3RSS1 folded before Flop (didn't bet)
Seat 2: Giginis (button) folded before Flop (didn't bet)
Seat 3: Antanavinis (small blind) collected (18000)
Seat 4: BorIska1993 (big blind) folded on the Turn
Seat 5: haitzi1 folded before Flop (didn't bet)
Seat 6: Varle84 folded before Flop (didn't bet)
Seat 7: RRoleto folded before Flop (didn't bet)
Seat 8: Snoopy95_2.0 folded before Flop (didn't bet)

PokerStars Hand #251207075694: Tournament #3767885527, $40+$10+$5 USD Hold'em No Limit - Level XX (3000/6000) - 2024/06/26 20:36:51 UTC [2024/06/26 16:36:51 ET]
Table '3767885527 63' 8-max Seat #3 is the button
Seat 1: T3RSS1 (40179 in chips) 
Seat 2: Giginis (276376 in chips) 
Seat 3: Antanavinis (99863 in chips) 
Seat 4: BorIska1993 (122639 in chips) 
Seat 5: haitzi1 (39039 in chips) 
Seat 6: Varle84 (93103 in chips) 
Seat 7: RRoleto (28452 in chips) 
Seat 8: Snoopy95_2.0 (131949 in chips) 
T3RSS1: posts the ante 750
Giginis: posts the ante 750
Antanavinis: posts the ante 750
BorIska1993: posts the ante 750
haitzi1: posts the ante 750
Varle84: posts the ante 750
RRoleto: posts the ante 750
Snoopy95_2.0: posts the ante 750
BorIska1993: posts small blind 3000
haitzi1: posts big blind 6000
*** HOLE CARDS ***
Varle84: folds 
RRoleto: folds 
Snoopy95_2.0: calls 6000
T3RSS1: folds 
Giginis: folds 
Antanavinis: folds 
BorIska1993: calls 3000
haitzi1: checks 
*** FLOP *** [Ad 6h 3h]
BorIska1993: checks 
haitzi1: checks 
Snoopy95_2.0: bets 6000
BorIska1993: folds 
haitzi1: folds 
Uncalled bet (6000) returned to Snoopy95_2.0
Snoopy95_2.0 collected 24000 from pot
Snoopy95_2.0: doesn't show hand 
*** SUMMARY ***
Total pot 24000 | Rake 0 
Board [Ad 6h 3h]
Seat 1: T3RSS1 folded before Flop (didn't bet)
Seat 2: Giginis folded before Flop (didn't bet)
Seat 3: Antanavinis (button) folded before Flop (didn't bet)
Seat 4: BorIska1993 (small blind) folded on the Flop
Seat 5: haitzi1 (big blind) folded on the Flop
Seat 6: Varle84 folded before Flop (didn't bet)
Seat 7: RRoleto folded before Flop (didn't bet)
Seat 8: Snoopy95_2.0 collected (24000)

PokerStars Hand #251207085336: Tournament #3767885527, $40+$10+$5 USD Hold'em No Limit - Level XX (3000/6000) - 2024/06/26 20:37:25 UTC [2024/06/26 16:37:25 ET]
Table '3767885527 63' 8-max Seat #4 is the button
Seat 1: T3RSS1 (39429 in chips) 
Seat 2: Giginis (275626 in chips) 
Seat 3: Antanavinis (99113 in chips) 
Seat 4: BorIska1993 (115889 in chips) 
Seat 5: haitzi1 (32289 in chips) 
Seat 6: Varle84 (92353 in chips) 
Seat 7: RRoleto (27702 in chips) 
Seat 8: Snoopy95_2.0 (149199 in chips) 
T3RSS1: posts the ante 750
Giginis: posts the ante 750
Antanavinis: posts the ante 750
BorIska1993: posts the ante 750
haitzi1: posts the ante 750
Varle84: posts the ante 750
RRoleto: posts the ante 750
Snoopy95_2.0: posts the ante 750
haitzi1: posts small blind 3000
Varle84: posts big blind 6000
*** HOLE CARDS ***
RRoleto: folds 
Snoopy95_2.0: folds 
T3RSS1: folds 
Giginis: folds 
Antanavinis: folds 
BorIska1993: raises 6000 to 12000
haitzi1: folds 
Varle84: raises 79603 to 91603 and is all-in
BorIska1993: folds 
Uncalled bet (79603) returned to Varle84
Varle84 collected 33000 from pot
*** SUMMARY ***
Total pot 33000 | Rake 0 
Seat 1: T3RSS1 folded before Flop (didn't bet)
Seat 2: Giginis folded before Flop (didn't bet)
Seat 3: Antanavinis folded before Flop (didn't bet)
Seat 4: BorIska1993 (button) folded before Flop
Seat 5: haitzi1 (small blind) folded before Flop
Seat 6: Varle84 (big blind) collected (33000)
Seat 7: RRoleto folded before Flop (didn't bet)
Seat 8: Snoopy95_2.0 folded before Flop (didn't bet)

PokerStars Hand #251207100786: Tournament #3767885527, $40+$10+$5 USD Hold'em No Limit - Level XX (3000/6000) - 2024/06/26 20:38:20 UTC [2024/06/26 16:38:20 ET]
Table '3767885527 63' 8-max Seat #5 is the button
Seat 1: T3RSS1 (38679 in chips) 
Seat 2: Giginis (274876 in chips) 
Seat 3: Antanavinis (98363 in chips) 
Seat 4: BorIska1993 (103139 in chips) 
Seat 5: haitzi1 (28539 in chips) 
Seat 6: Varle84 (112603 in chips) 
Seat 7: RRoleto (26952 in chips) 
Seat 8: Snoopy95_2.0 (148449 in chips) 
T3RSS1: posts the ante 750
Giginis: posts the ante 750
Antanavinis: posts the ante 750
BorIska1993: posts the ante 750
haitzi1: posts the ante 750
Varle84: posts the ante 750
RRoleto: posts the ante 750
Snoopy95_2.0: posts the ante 750
Varle84: posts small blind 3000
RRoleto: posts big blind 6000
*** HOLE CARDS ***
Snoopy95_2.0: calls 6000
T3RSS1: raises 31929 to 37929 and is all-in
Giginis: folds 
Antanavinis: folds 
BorIska1993: folds 
haitzi1: folds 
Varle84: folds 
RRoleto: calls 20202 and is all-in
Snoopy95_2.0: calls 31929
*** FLOP *** [2s Ts 9d]
*** TURN *** [2s Ts 9d] [Ah]
*** RIVER *** [2s Ts 9d Ah] [9h]
*** SHOW DOWN ***
Snoopy95_2.0: shows [Tc Jc] (two pair, Tens and Nines)
T3RSS1: shows [Ad Qs] (two pair, Aces and Nines)
T3RSS1 collected 23454 from side pot
RRoleto: shows [2c As] (two pair, Aces and Nines - lower kicker)
T3RSS1 collected 87606 from main pot
RRoleto finished the tournament in 263rd place and received $104.64.
*** SUMMARY ***
Total pot 111060 Main pot 87606. Side pot 23454. | Rake 0 
Board [2s Ts 9d Ah 9h]
Seat 1: T3RSS1 showed [Ad Qs] and won (111060) with two pair, Aces and Nines
Seat 2: Giginis folded before Flop (didn't bet)
Seat 3: Antanavinis folded before Flop (didn't bet)
Seat 4: BorIska1993 folded before Flop (didn't bet)
Seat 5: haitzi1 (button) folded before Flop (didn't bet)
Seat 6: Varle84 (small blind) folded before Flop
Seat 7: RRoleto (big blind) showed [2c As] and lost with two pair, Aces and Nines
Seat 8: Snoopy95_2.0 showed [Tc Jc] and lost with two pair, Tens and Nines

PokerStars Hand #251207113713: Tournament #3767885527, $40+$10+$5 USD Hold'em No Limit - Level XX (3000/6000) - 2024/06/26 20:39:05 UTC [2024/06/26 16:39:05 ET]
Table '3767885527 63' 8-max Seat #6 is the button
Seat 1: T3RSS1 (111060 in chips) 
Seat 2: Giginis (274126 in chips) 
Seat 3: Antanavinis (97613 in chips) 
Seat 4: BorIska1993 (102389 in chips) 
Seat 5: haitzi1 (27789 in chips) 
Seat 6: Varle84 (108853 in chips) 
Seat 8: Snoopy95_2.0 (109770 in chips) 
T3RSS1: posts the ante 750
Giginis: posts the ante 750
Antanavinis: posts the ante 750
BorIska1993: posts the ante 750
haitzi1: posts the ante 750
Varle84: posts the ante 750
Snoopy95_2.0: posts the ante 750
Snoopy95_2.0: posts small blind 3000
T3RSS1: posts big blind 6000
*** HOLE CARDS ***
Giginis: folds 
Antanavinis: folds 
BorIska1993: folds 
VICTOR TXR1 is disconnected 
haitzi1: folds 
Varle84: raises 6000 to 12000
Snoopy95_2.0: calls 9000
T3RSS1: calls 6000
*** FLOP *** [Js 4c 3h]
Snoopy95_2.0: checks 
T3RSS1: checks 
Varle84: bets 12780
Snoopy95_2.0: folds 
T3RSS1: raises 85530 to 98310 and is all-in
Varle84: folds 
Uncalled bet (85530) returned to T3RSS1
T3RSS1 collected 66810 from pot
*** SUMMARY ***
Total pot 66810 | Rake 0 
Board [Js 4c 3h]
Seat 1: T3RSS1 (big blind) collected (66810)
Seat 2: Giginis folded before Flop (didn't bet)
Seat 3: Antanavinis folded before Flop (didn't bet)
Seat 4: BorIska1993 folded before Flop (didn't bet)
Seat 5: haitzi1 folded before Flop (didn't bet)
Seat 6: Varle84 (button) folded on the Flop
Seat 8: Snoopy95_2.0 (small blind) folded on the Flop

PokerStars Hand #251207136075: Tournament #3767885527, $40+$10+$5 USD Hold'em No Limit - Level XX (3000/6000) - 2024/06/26 20:40:25 UTC [2024/06/26 16:40:25 ET]
Table '3767885527 63' 8-max Seat #8 is the button
Seat 1: T3RSS1 (152340 in chips) 
Seat 2: Giginis (273376 in chips) 
Seat 3: Antanavinis (96863 in chips) 
Seat 4: BorIska1993 (101639 in chips) 
Seat 5: haitzi1 (27039 in chips) 
Seat 6: Varle84 (83323 in chips) 
Seat 7: VICTOR TXR1 (122957 in chips) 
Seat 8: Snoopy95_2.0 (97020 in chips) 
T3RSS1: posts the ante 750
Giginis: posts the ante 750
Antanavinis: posts the ante 750
BorIska1993: posts the ante 750
haitzi1: posts the ante 750
Varle84: posts the ante 750
VICTOR TXR1: posts the ante 750
Snoopy95_2.0: posts the ante 750
T3RSS1: posts small blind 3000
Giginis: posts big blind 6000
*** HOLE CARDS ***
Antanavinis: raises 6000 to 12000
BorIska1993: folds 
haitzi1: folds 
Varle84: folds 
VICTOR TXR1: folds 
Snoopy95_2.0: folds 
T3RSS1: folds 
Giginis: calls 6000
*** FLOP *** [7s 6s Qc]
Giginis: checks 
Antanavinis: bets 10890
Giginis: calls 10890
*** TURN *** [7s 6s Qc] [9h]
Giginis: checks 
Antanavinis: bets 25080
Giginis: raises 64920 to 90000
Antanavinis: calls 48143 and is all-in
Uncalled bet (16777) returned to Giginis
*** RIVER *** [7s 6s Qc 9h] [8s]
*** SHOW DOWN ***
Giginis: shows [6h 9s] (two pair, Nines and Sixes)
Antanavinis: shows [Ks Kc] (a pair of Kings)
Giginis collected 201226 from pot
Antanavinis finished the tournament in 240th place and received $115.10.
*** SUMMARY ***
Total pot 201226 | Rake 0 
Board [7s 6s Qc 9h 8s]
Seat 1: T3RSS1 (small blind) folded before Flop
Seat 2: Giginis (big blind) showed [6h 9s] and won (201226) with two pair, Nines and Sixes
Seat 3: Antanavinis showed [Ks Kc] and lost with a pair of Kings
Seat 4: BorIska1993 folded before Flop (didn't bet)
Seat 5: haitzi1 folded before Flop (didn't bet)
Seat 6: Varle84 folded before Flop (didn't bet)
Seat 7: VICTOR TXR1 folded before Flop (didn't bet)
Seat 8: Snoopy95_2.0 (button) folded before Flop (didn't bet)

PokerStars Hand #251207156206: Tournament #3767885527, $40+$10+$5 USD Hold'em No Limit - Level XX (3000/6000) - 2024/06/26 20:41:37 UTC [2024/06/26 16:41:37 ET]
Table '3767885527 63' 8-max Seat #1 is the button
Seat 1: T3RSS1 (148590 in chips) 
Seat 2: Giginis (377739 in chips) 
Seat 4: BorIska1993 (100889 in chips) 
Seat 5: haitzi1 (26289 in chips) 
Seat 6: Varle84 (82573 in chips) 
Seat 7: VICTOR TXR1 (122207 in chips) 
Seat 8: Snoopy95_2.0 (96270 in chips) 
T3RSS1: posts the ante 750
Giginis: posts the ante 750
BorIska1993: posts the ante 750
haitzi1: posts the ante 750
Varle84: posts the ante 750
VICTOR TXR1: posts the ante 750
Snoopy95_2.0: posts the ante 750
Giginis: posts small blind 3000
BorIska1993: posts big blind 6000
*** HOLE CARDS ***
haitzi1: folds 
Varle84: folds 
VICTOR TXR1: raises 6960 to 12960
Snoopy95_2.0: folds 
T3RSS1: folds 
Giginis: folds 
BorIska1993: raises 87179 to 100139 and is all-in
VICTOR TXR1: folds 
Uncalled bet (87179) returned to BorIska1993
BorIska1993 collected 34170 from pot
BorIska1993: doesn't show hand 
*** SUMMARY ***
Total pot 34170 | Rake 0 
Seat 1: T3RSS1 (button) folded before Flop (didn't bet)
Seat 2: Giginis (small blind) folded before Flop
Seat 4: BorIska1993 (big blind) collected (34170)
Seat 5: haitzi1 folded before Flop (didn't bet)
Seat 6: Varle84 folded before Flop (didn't bet)
Seat 7: VICTOR TXR1 folded before Flop
Seat 8: Snoopy95_2.0 folded before Flop (didn't bet)

PokerStars Hand #251207163344: Tournament #3767885527, $40+$10+$5 USD Hold'em No Limit - Level XX (3000/6000) - 2024/06/26 20:42:03 UTC [2024/06/26 16:42:03 ET]
Table '3767885527 63' 8-max Seat #2 is the button
Seat 1: T3RSS1 (147840 in chips) 
Seat 2: Giginis (373989 in chips) 
Seat 4: BorIska1993 (121349 in chips) 
Seat 5: haitzi1 (25539 in chips) 
Seat 6: Varle84 (81823 in chips) 
Seat 7: VICTOR TXR1 (108497 in chips) 
Seat 8: Snoopy95_2.0 (95520 in chips) 
T3RSS1: posts the ante 750
Giginis: posts the ante 750
BorIska1993: posts the ante 750
haitzi1: posts the ante 750
Varle84: posts the ante 750
VICTOR TXR1: posts the ante 750
Snoopy95_2.0: posts the ante 750
BorIska1993: posts small blind 3000
haitzi1: posts big blind 6000
*** HOLE CARDS ***
Varle84: raises 75073 to 81073 and is all-in
VICTOR TXR1: folds 
Snoopy95_2.0: folds 
T3RSS1: folds 
Giginis: folds 
BorIska1993: raises 39526 to 120599 and is all-in
haitzi1: folds 
Uncalled bet (39526) returned to BorIska1993
*** FLOP *** [3s 2s Kc]
*** TURN *** [3s 2s Kc] [4s]
*** RIVER *** [3s 2s Kc 4s] [5s]
*** SHOW DOWN ***
BorIska1993: shows [Tc Ah] (a straight, Ace to Five)
Varle84: shows [Jc Ac] (a straight, Ace to Five)
BorIska1993 collected 86698 from pot
Varle84 collected 86698 from pot
*** SUMMARY ***
Total pot 173396 | Rake 0 
Board [3s 2s Kc 4s 5s]
Seat 1: T3RSS1 folded before Flop (didn't bet)
Seat 2: Giginis (button) folded before Flop (didn't bet)
Seat 4: BorIska1993 (small blind) showed [Tc Ah] and won (86698) with a straight, Ace to Five
Seat 5: haitzi1 (big blind) folded before Flop
Seat 6: Varle84 showed [Jc Ac] and won (86698) with a straight, Ace to Five
Seat 7: VICTOR TXR1 folded before Flop (didn't bet)
Seat 8: Snoopy95_2.0 folded before Flop (didn't bet)

PokerStars Hand #251207172961: Tournament #3767885527, $40+$10+$5 USD Hold'em No Limit - Level XX (3000/6000) - 2024/06/26 20:42:38 UTC [2024/06/26 16:42:38 ET]
Table '3767885527 63' 8-max Seat #4 is the button
Seat 1: T3RSS1 (147090 in chips) 
Seat 2: Giginis (373239 in chips) 
Seat 4: BorIska1993 (126224 in chips) 
Seat 5: haitzi1 (18789 in chips) 
Seat 6: Varle84 (86698 in chips) 
Seat 7: VICTOR TXR1 (107747 in chips) 
Seat 8: Snoopy95_2.0 (94770 in chips) 
T3RSS1: posts the ante 750
Giginis: posts the ante 750
BorIska1993: posts the ante 750
haitzi1: posts the ante 750
Varle84: posts the ante 750
VICTOR TXR1: posts the ante 750
Snoopy95_2.0: posts the ante 750
haitzi1: posts small blind 3000
Varle84: posts big blind 6000
*** HOLE CARDS ***
VICTOR TXR1: folds 
Snoopy95_2.0: calls 6000
T3RSS1: folds 
Giginis: folds 
BorIska1993: folds 
haitzi1: raises 12039 to 18039 and is all-in
Varle84: folds 
Snoopy95_2.0: calls 12039
*** FLOP *** [9h 9d Jd]
*** TURN *** [9h 9d Jd] [5h]
MaCheCazzoFai is disconnected 
*** RIVER *** [9h 9d Jd 5h] [9s]
*** SHOW DOWN ***
haitzi1: shows [8h Qs] (three of a kind, Nines)
Snoopy95_2.0: shows [Ac 7s] (three of a kind, Nines - Ace kicker)
Snoopy95_2.0 collected 47328 from pot
haitzi1 finished the tournament in 231st place and received $115.10.
*** SUMMARY ***
Total pot 47328 | Rake 0 
Board [9h 9d Jd 5h 9s]
Seat 1: T3RSS1 folded before Flop (didn't bet)
Seat 2: Giginis folded before Flop (didn't bet)
Seat 4: BorIska1993 (button) folded before Flop (didn't bet)
Seat 5: haitzi1 (small blind) showed [8h Qs] and lost with three of a kind, Nines
Seat 6: Varle84 (big blind) folded before Flop
Seat 7: VICTOR TXR1 folded before Flop (didn't bet)
Seat 8: Snoopy95_2.0 showed [Ac 7s] and won (47328) with three of a kind, Nines

PokerStars Hand #251207182610: Tournament #3767885527, $40+$10+$5 USD Hold'em No Limit - Level XX (3000/6000) - 2024/06/26 20:43:13 UTC [2024/06/26 16:43:13 ET]
Table '3767885527 63' 8-max Seat #6 is the button
Seat 1: T3RSS1 (146340 in chips) 
Seat 2: Giginis (372489 in chips) 
Seat 3: MaCheCazzoFai (117831 in chips) 
Seat 4: BorIska1993 (125474 in chips) 
Seat 6: Varle84 (79948 in chips) 
Seat 7: VICTOR TXR1 (106997 in chips) 
Seat 8: Snoopy95_2.0 (123309 in chips) 
T3RSS1: posts the ante 750
Giginis: posts the ante 750
MaCheCazzoFai: posts the ante 750
BorIska1993: posts the ante 750
Varle84: posts the ante 750
VICTOR TXR1: posts the ante 750
Snoopy95_2.0: posts the ante 750
VICTOR TXR1: posts small blind 3000
Snoopy95_2.0: posts big blind 6000
*** HOLE CARDS ***
T3RSS1: folds 
Giginis: folds 
MaCheCazzoFai: folds 
BorIska1993: folds 
Varle84: raises 73198 to 79198 and is all-in
VICTOR TXR1: folds 
Snoopy95_2.0: folds 
Uncalled bet (73198) returned to Varle84
Varle84 collected 20250 from pot
*** SUMMARY ***
Total pot 20250 | Rake 0 
Seat 1: T3RSS1 folded before Flop (didn't bet)
Seat 2: Giginis folded before Flop (didn't bet)
Seat 3: MaCheCazzoFai folded before Flop (didn't bet)
Seat 4: BorIska1993 folded before Flop (didn't bet)
Seat 6: Varle84 (button) collected (20250)
Seat 7: VICTOR TXR1 (small blind) folded before Flop
Seat 8: Snoopy95_2.0 (big blind) folded before Flop

PokerStars Hand #251207190264: Tournament #3767885527, $40+$10+$5 USD Hold'em No Limit - Level XX (3000/6000) - 2024/06/26 20:43:41 UTC [2024/06/26 16:43:41 ET]
Table '3767885527 63' 8-max Seat #7 is the button
Seat 1: T3RSS1 (145590 in chips) 
Seat 2: Giginis (371739 in chips) 
Seat 3: MaCheCazzoFai (117081 in chips) 
Seat 4: BorIska1993 (124724 in chips) 
Seat 6: Varle84 (93448 in chips) 
Seat 7: VICTOR TXR1 (103247 in chips) 
Seat 8: Snoopy95_2.0 (116559 in chips) 
T3RSS1: posts the ante 750
Giginis: posts the ante 750
MaCheCazzoFai: posts the ante 750
BorIska1993: posts the ante 750
Varle84: posts the ante 750
VICTOR TXR1: posts the ante 750
Snoopy95_2.0: posts the ante 750
Snoopy95_2.0: posts small blind 3000
T3RSS1: posts big blind 6000
*** HOLE CARDS ***
Giginis: folds 
MaCheCazzoFai: raises 6000 to 12000
BorIska1993: folds 
Varle84: folds 
VICTOR TXR1: folds 
Snoopy95_2.0: folds 
T3RSS1: folds 
Uncalled bet (6000) returned to MaCheCazzoFai
MaCheCazzoFai collected 20250 from pot
MaCheCazzoFai: doesn't show hand 
*** SUMMARY ***
Total pot 20250 | Rake 0 
Seat 1: T3RSS1 (big blind) folded before Flop
Seat 2: Giginis folded before Flop (didn't bet)
Seat 3: MaCheCazzoFai collected (20250)
Seat 4: BorIska1993 folded before Flop (didn't bet)
Seat 6: Varle84 folded before Flop (didn't bet)
Seat 7: VICTOR TXR1 (button) folded before Flop (didn't bet)
Seat 8: Snoopy95_2.0 (small blind) folded before Flop

PokerStars Hand #251207196620: Tournament #3767885527, $40+$10+$5 USD Hold'em No Limit - Level XX (3000/6000) - 2024/06/26 20:44:04 UTC [2024/06/26 16:44:04 ET]
Table '3767885527 63' 8-max Seat #8 is the button
Seat 1: T3RSS1 (138840 in chips) 
Seat 2: Giginis (370989 in chips) 
Seat 3: MaCheCazzoFai (130581 in chips) 
Seat 4: BorIska1993 (123974 in chips) 
Seat 6: Varle84 (92698 in chips) 
Seat 7: VICTOR TXR1 (102497 in chips) 
Seat 8: Snoopy95_2.0 (112809 in chips) 
T3RSS1: posts the ante 750
Giginis: posts the ante 750
MaCheCazzoFai: posts the ante 750
BorIska1993: posts the ante 750
Varle84: posts the ante 750
VICTOR TXR1: posts the ante 750
Snoopy95_2.0: posts the ante 750
T3RSS1: posts small blind 3000
Giginis: posts big blind 6000
*** HOLE CARDS ***
MaCheCazzoFai: folds 
BorIska1993: folds 
Varle84: folds 
VICTOR TXR1: raises 6000 to 12000
Snoopy95_2.0: folds 
T3RSS1: folds 
Giginis: calls 6000
*** FLOP *** [5s 7d Ah]
Giginis: checks 
VICTOR TXR1: bets 9998
Giginis: folds 
Uncalled bet (9998) returned to VICTOR TXR1
VICTOR TXR1 collected 32250 from pot
VICTOR TXR1: doesn't show hand 
*** SUMMARY ***
Total pot 32250 | Rake 0 
Board [5s 7d Ah]
Seat 1: T3RSS1 (small blind) folded before Flop
Seat 2: Giginis (big blind) folded on the Flop
Seat 3: MaCheCazzoFai folded before Flop (didn't bet)
Seat 4: BorIska1993 folded before Flop (didn't bet)
Seat 6: Varle84 folded before Flop (didn't bet)
Seat 7: VICTOR TXR1 collected (32250)
Seat 8: Snoopy95_2.0 (button) folded before Flop (didn't bet)

PokerStars Hand #251207208319: Tournament #3767885527, $40+$10+$5 USD Hold'em No Limit - Level XX (3000/6000) - 2024/06/26 20:44:47 UTC [2024/06/26 16:44:47 ET]
Table '3767885527 63' 8-max Seat #1 is the button
Seat 1: T3RSS1 (135090 in chips) 
Seat 2: Giginis (358239 in chips) 
Seat 3: MaCheCazzoFai (129831 in chips) 
Seat 4: BorIska1993 (123224 in chips) 
Seat 6: Varle84 (91948 in chips) 
Seat 7: VICTOR TXR1 (121997 in chips) 
Seat 8: Snoopy95_2.0 (112059 in chips) 
T3RSS1: posts the ante 750
Giginis: posts the ante 750
MaCheCazzoFai: posts the ante 750
BorIska1993: posts the ante 750
Varle84: posts the ante 750
VICTOR TXR1: posts the ante 750
Snoopy95_2.0: posts the ante 750
Giginis: posts small blind 3000
MaCheCazzoFai: posts big blind 6000
*** HOLE CARDS ***
BorIska1993: folds 
Varle84: folds 
NOEXITNO is disconnected 
VICTOR TXR1: folds 
Snoopy95_2.0: raises 6000 to 12000
T3RSS1: folds 
Giginis: folds 
MaCheCazzoFai: raises 117081 to 129081 and is all-in
Snoopy95_2.0: folds 
Uncalled bet (117081) returned to MaCheCazzoFai
MaCheCazzoFai collected 32250 from pot
MaCheCazzoFai: doesn't show hand 
*** SUMMARY ***
Total pot 32250 | Rake 0 
Seat 1: T3RSS1 (button) folded before Flop (didn't bet)
Seat 2: Giginis (small blind) folded before Flop
Seat 3: MaCheCazzoFai (big blind) collected (32250)
Seat 4: BorIska1993 folded before Flop (didn't bet)
Seat 6: Varle84 folded before Flop (didn't bet)
Seat 7: VICTOR TXR1 folded before Flop (didn't bet)
Seat 8: Snoopy95_2.0 folded before Flop

PokerStars Hand #251207216266: Tournament #3767885527, $40+$10+$5 USD Hold'em No Limit - Level XX (3000/6000) - 2024/06/26 20:45:16 UTC [2024/06/26 16:45:16 ET]
Table '3767885527 63' 8-max Seat #2 is the button
Seat 1: T3RSS1 (134340 in chips) 
Seat 2: Giginis (354489 in chips) 
Seat 3: MaCheCazzoFai (149331 in chips) 
Seat 4: BorIska1993 (122474 in chips) 
Seat 5: NOEXITNO (69770 in chips) 
Seat 6: Varle84 (91198 in chips) 
Seat 7: VICTOR TXR1 (121247 in chips) 
Seat 8: Snoopy95_2.0 (99309 in chips) 
T3RSS1: posts the ante 750
Giginis: posts the ante 750
MaCheCazzoFai: posts the ante 750
BorIska1993: posts the ante 750
NOEXITNO: posts the ante 750
Varle84: posts the ante 750
VICTOR TXR1: posts the ante 750
Snoopy95_2.0: posts the ante 750
MaCheCazzoFai: posts small blind 3000
BorIska1993: posts big blind 6000
*** HOLE CARDS ***
NOEXITNO: folds 
Varle84: raises 6000 to 12000
VICTOR TXR1: folds 
Snoopy95_2.0: folds 
T3RSS1: folds 
Giginis: folds 
MaCheCazzoFai: folds 
BorIska1993: calls 6000
*** FLOP *** [5c 2d 7s]
BorIska1993: checks 
Varle84: bets 17160
BorIska1993: folds 
Uncalled bet (17160) returned to Varle84
Varle84 collected 33000 from pot
*** SUMMARY ***
Total pot 33000 | Rake 0 
Board [5c 2d 7s]
Seat 1: T3RSS1 folded before Flop (didn't bet)
Seat 2: Giginis (button) folded before Flop (didn't bet)
Seat 3: MaCheCazzoFai (small blind) folded before Flop
Seat 4: BorIska1993 (big blind) folded on the Flop
Seat 5: NOEXITNO folded before Flop (didn't bet)
Seat 6: Varle84 collected (33000)
Seat 7: VICTOR TXR1 folded before Flop (didn't bet)
Seat 8: Snoopy95_2.0 folded before Flop (didn't bet)

PokerStars Hand #251207230533: Tournament #3767885527, $40+$10+$5 USD Hold'em No Limit - Level XXI (3500/7000) - 2024/06/26 20:46:08 UTC [2024/06/26 16:46:08 ET]
Table '3767885527 63' 8-max Seat #3 is the button
Seat 1: T3RSS1 (133590 in chips) 
Seat 2: Giginis (353739 in chips) 
Seat 3: MaCheCazzoFai (145581 in chips) 
Seat 4: BorIska1993 (109724 in chips) 
Seat 5: NOEXITNO (69020 in chips) 
Seat 6: Varle84 (111448 in chips) 
Seat 7: VICTOR TXR1 (120497 in chips) 
Seat 8: Snoopy95_2.0 (98559 in chips) 
T3RSS1: posts the ante 875
Giginis: posts the ante 875
MaCheCazzoFai: posts the ante 875
BorIska1993: posts the ante 875
NOEXITNO: posts the ante 875
Varle84: posts the ante 875
VICTOR TXR1: posts the ante 875
Snoopy95_2.0: posts the ante 875
BorIska1993: posts small blind 3500
NOEXITNO: posts big blind 7000
*** HOLE CARDS ***
Varle84: folds 
VICTOR TXR1: folds 
Snoopy95_2.0: folds 
T3RSS1: raises 125715 to 132715 and is all-in
Giginis: folds 
MaCheCazzoFai: folds 
BorIska1993: calls 105349 and is all-in
NOEXITNO: calls 61145 and is all-in
Uncalled bet (23866) returned to T3RSS1
*** FLOP *** [Kh 3c 6c]
*** TURN *** [Kh 3c 6c] [3h]
*** RIVER *** [Kh 3c 6c 3h] [Ts]
*** SHOW DOWN ***
BorIska1993: shows [8c 8d] (two pair, Eights and Threes)
T3RSS1: shows [Ad Kc] (two pair, Kings and Threes)
T3RSS1 collected 81408 from side pot
NOEXITNO: shows [Jd Jc] (two pair, Jacks and Threes)
T3RSS1 collected 211435 from main pot
BorIska1993 finished the tournament in 213th place and received $115.10.
NOEXITNO finished the tournament in 214th place and received $115.10.
*** SUMMARY ***
Total pot 292843 Main pot 211435. Side pot 81408. | Rake 0 
Board [Kh 3c 6c 3h Ts]
Seat 1: T3RSS1 showed [Ad Kc] and won (292843) with two pair, Kings and Threes
Seat 2: Giginis folded before Flop (didn't bet)
Seat 3: MaCheCazzoFai (button) folded before Flop (didn't bet)
Seat 4: BorIska1993 (small blind) showed [8c 8d] and lost with two pair, Eights and Threes
Seat 5: NOEXITNO (big blind) showed [Jd Jc] and lost with two pair, Jacks and Threes
Seat 6: Varle84 folded before Flop (didn't bet)
Seat 7: VICTOR TXR1 folded before Flop (didn't bet)
Seat 8: Snoopy95_2.0 folded before Flop (didn't bet)

PokerStars Hand #251207242317: Tournament #3767885527, $40+$10+$5 USD Hold'em No Limit - Level XXI (3500/7000) - 2024/06/26 20:46:51 UTC [2024/06/26 16:46:51 ET]
Table '3767885527 63' 8-max Seat #6 is the button
Seat 1: T3RSS1 (316709 in chips) 
Seat 2: Giginis (352864 in chips) 
Seat 3: MaCheCazzoFai (144706 in chips) 
Seat 6: Varle84 (110573 in chips) 
Seat 7: VICTOR TXR1 (119622 in chips) 
Seat 8: Snoopy95_2.0 (97684 in chips) 
T3RSS1: posts the ante 875
Giginis: posts the ante 875
MaCheCazzoFai: posts the ante 875
Varle84: posts the ante 875
VICTOR TXR1: posts the ante 875
Snoopy95_2.0: posts the ante 875
VICTOR TXR1: posts small blind 3500
Snoopy95_2.0: posts big blind 7000
*** HOLE CARDS ***
T3RSS1: folds 
Billionai8 is disconnected 
Giginis: raises 7000 to 14000
MaCheCazzoFai: folds 
Varle84: folds 
VICTOR TXR1: folds 
Snoopy95_2.0: folds 
Uncalled bet (7000) returned to Giginis
Giginis collected 22750 from pot
*** SUMMARY ***
Total pot 22750 | Rake 0 
Seat 1: T3RSS1 folded before Flop (didn't bet)
Seat 2: Giginis collected (22750)
Seat 3: MaCheCazzoFai folded before Flop (didn't bet)
Seat 6: Varle84 (button) folded before Flop (didn't bet)
Seat 7: VICTOR TXR1 (small blind) folded before Flop
Seat 8: Snoopy95_2.0 (big blind) folded before Flop

PokerStars Hand #251207250608: Tournament #3767885527, $40+$10+$5 USD Hold'em No Limit - Level XXI (3500/7000) - 2024/06/26 20:47:21 UTC [2024/06/26 16:47:21 ET]
Table '3767885527 63' 8-max Seat #7 is the button
Seat 1: T3RSS1 (315834 in chips) 
Seat 2: Giginis (367739 in chips) 
Seat 3: MaCheCazzoFai (143831 in chips) 
Seat 4: Billionai8 (474062 in chips) 
Seat 6: Varle84 (109698 in chips) 
Seat 7: VICTOR TXR1 (115247 in chips) 
Seat 8: Snoopy95_2.0 (89809 in chips) 
T3RSS1: posts the ante 875
Giginis: posts the ante 875
MaCheCazzoFai: posts the ante 875
Billionai8: posts the ante 875
Varle84: posts the ante 875
VICTOR TXR1: posts the ante 875
Snoopy95_2.0: posts the ante 875
Snoopy95_2.0: posts small blind 3500
T3RSS1: posts big blind 7000
*** HOLE CARDS ***
Giginis: folds 
MaCheCazzoFai: folds 
Billionai8: raises 7000 to 14000
Varle84: raises 94823 to 108823 and is all-in
VICTOR TXR1: folds 
Snoopy95_2.0: folds 
T3RSS1: folds 
Billionai8: folds 
Uncalled bet (94823) returned to Varle84
Varle84 collected 44625 from pot
*** SUMMARY ***
Total pot 44625 | Rake 0 
Seat 1: T3RSS1 (big blind) folded before Flop
Seat 2: Giginis folded before Flop (didn't bet)
Seat 3: MaCheCazzoFai folded before Flop (didn't bet)
Seat 4: Billionai8 folded before Flop
Seat 6: Varle84 collected (44625)
Seat 7: VICTOR TXR1 (button) folded before Flop (didn't bet)
Seat 8: Snoopy95_2.0 (small blind) folded before Flop

PokerStars Hand #251207258684: Tournament #3767885527, $40+$10+$5 USD Hold'em No Limit - Level XXI (3500/7000) - 2024/06/26 20:47:50 UTC [2024/06/26 16:47:50 ET]
Table '3767885527 63' 8-max Seat #8 is the button
Seat 1: T3RSS1 (307959 in chips) 
Seat 2: Giginis (366864 in chips) 
Seat 3: MaCheCazzoFai (142956 in chips) 
Seat 4: Billionai8 (459187 in chips) 
Seat 6: Varle84 (139448 in chips) 
Seat 7: VICTOR TXR1 (114372 in chips) 
Seat 8: Snoopy95_2.0 (85434 in chips) 
T3RSS1: posts the ante 875
Giginis: posts the ante 875
MaCheCazzoFai: posts the ante 875
Billionai8: posts the ante 875
Varle84: posts the ante 875
VICTOR TXR1: posts the ante 875
Snoopy95_2.0: posts the ante 875
T3RSS1: posts small blind 3500
Giginis: posts big blind 7000
*** HOLE CARDS ***
MaCheCazzoFai: folds 
Billionai8: folds 
Varle84: raises 7000 to 14000
VICTOR TXR1: folds 
Snoopy95_2.0: folds 
T3RSS1: folds 
Giginis: calls 7000
*** FLOP *** [8s 7d 6h]
Giginis: checks 
Varle84: bets 25200
Giginis: folds 
Uncalled bet (25200) returned to Varle84
Varle84 collected 37625 from pot
*** SUMMARY ***
Total pot 37625 | Rake 0 
Board [8s 7d 6h]
Seat 1: T3RSS1 (small blind) folded before Flop
Seat 2: Giginis (big blind) folded on the Flop
Seat 3: MaCheCazzoFai folded before Flop (didn't bet)
Seat 4: Billionai8 folded before Flop (didn't bet)
Seat 6: Varle84 collected (37625)
Seat 7: VICTOR TXR1 folded before Flop (didn't bet)
Seat 8: Snoopy95_2.0 (button) folded before Flop (didn't bet)

PokerStars Hand #251207277085: Tournament #3767885527, $40+$10+$5 USD Hold'em No Limit - Level XXI (3500/7000) - 2024/06/26 20:48:57 UTC [2024/06/26 16:48:57 ET]
Table '3767885527 63' 8-max Seat #1 is the button
Seat 1: T3RSS1 (303584 in chips) 
Seat 2: Giginis (351989 in chips) 
Seat 3: MaCheCazzoFai (142081 in chips) 
Seat 4: Billionai8 (458312 in chips) 
Seat 6: Varle84 (162198 in chips) 
Seat 7: VICTOR TXR1 (113497 in chips) 
Seat 8: Snoopy95_2.0 (84559 in chips) 
T3RSS1: posts the ante 875
Giginis: posts the ante 875
MaCheCazzoFai: posts the ante 875
Billionai8: posts the ante 875
Varle84: posts the ante 875
VICTOR TXR1: posts the ante 875
Snoopy95_2.0: posts the ante 875
Giginis: posts small blind 3500
MaCheCazzoFai: posts big blind 7000
*** HOLE CARDS ***
Billionai8: raises 7000 to 14000
Varle84: folds 
VICTOR TXR1: folds 
Snoopy95_2.0: folds 
T3RSS1: folds 
Giginis: folds 
MaCheCazzoFai: raises 127206 to 141206 and is all-in
Billionai8: calls 127206
*** FLOP *** [4h Ks Qh]
*** TURN *** [4h Ks Qh] [2s]
*** RIVER *** [4h Ks Qh 2s] [7h]
*** SHOW DOWN ***
MaCheCazzoFai: shows [Kd Ah] (a pair of Kings)
Billionai8: shows [3d 3s] (a pair of Threes)
MaCheCazzoFai collected 292037 from pot
*** SUMMARY ***
Total pot 292037 | Rake 0 
Board [4h Ks Qh 2s 7h]
Seat 1: T3RSS1 (button) folded before Flop (didn't bet)
Seat 2: Giginis (small blind) folded before Flop
Seat 3: MaCheCazzoFai (big blind) showed [Kd Ah] and won (292037) with a pair of Kings
Seat 4: Billionai8 showed [3d 3s] and lost with a pair of Threes
Seat 6: Varle84 folded before Flop (didn't bet)
Seat 7: VICTOR TXR1 folded before Flop (didn't bet)
Seat 8: Snoopy95_2.0 folded before Flop (didn't bet)

PokerStars Hand #251207286056: Tournament #3767885527, $40+$10+$5 USD Hold'em No Limit - Level XXI (3500/7000) - 2024/06/26 20:49:30 UTC [2024/06/26 16:49:30 ET]
Table '3767885527 63' 8-max Seat #2 is the button
Seat 1: T3RSS1 (302709 in chips) 
Seat 2: Giginis (347614 in chips) 
Seat 3: MaCheCazzoFai (292037 in chips) 
Seat 4: Billionai8 (316231 in chips) 
Seat 5: Joes38 (228746 in chips) 
Seat 6: Varle84 (161323 in chips) 
Seat 7: VICTOR TXR1 (112622 in chips) 
Seat 8: Snoopy95_2.0 (83684 in chips) 
T3RSS1: posts the ante 875
Giginis: posts the ante 875
MaCheCazzoFai: posts the ante 875
Billionai8: posts the ante 875
Joes38: posts the ante 875
Varle84: posts the ante 875
VICTOR TXR1: posts the ante 875
Snoopy95_2.0: posts the ante 875
MaCheCazzoFai: posts small blind 3500
Billionai8: posts big blind 7000
*** HOLE CARDS ***
Joes38: folds 
Varle84: folds 
VICTOR TXR1: folds 
Snoopy95_2.0: folds 
T3RSS1: folds 
Giginis: raises 7000 to 14000
MaCheCazzoFai: raises 42000 to 56000
Billionai8: folds 
Giginis: folds 
Uncalled bet (42000) returned to MaCheCazzoFai
MaCheCazzoFai collected 42000 from pot
MaCheCazzoFai: doesn't show hand 
*** SUMMARY ***
Total pot 42000 | Rake 0 
Seat 1: T3RSS1 folded before Flop (didn't bet)
Seat 2: Giginis (button) folded before Flop
Seat 3: MaCheCazzoFai (small blind) collected (42000)
Seat 4: Billionai8 (big blind) folded before Flop
Seat 5: Joes38 folded before Flop (didn't bet)
Seat 6: Varle84 folded before Flop (didn't bet)
Seat 7: VICTOR TXR1 folded before Flop (didn't bet)
Seat 8: Snoopy95_2.0 folded before Flop (didn't bet)

PokerStars Hand #251207294998: Tournament #3767885527, $40+$10+$5 USD Hold'em No Limit - Level XXI (3500/7000) - 2024/06/26 20:50:03 UTC [2024/06/26 16:50:03 ET]
Table '3767885527 63' 8-max Seat #3 is the button
Seat 1: T3RSS1 (301834 in chips) 
Seat 2: Giginis (332739 in chips) 
Seat 3: MaCheCazzoFai (319162 in chips) 
Seat 4: Billionai8 (308356 in chips) 
Seat 5: Joes38 (227871 in chips) 
Seat 6: Varle84 (160448 in chips) 
Seat 7: VICTOR TXR1 (111747 in chips) 
Seat 8: Snoopy95_2.0 (82809 in chips) 
T3RSS1: posts the ante 875
Giginis: posts the ante 875
MaCheCazzoFai: posts the ante 875
Billionai8: posts the ante 875
Joes38: posts the ante 875
Varle84: posts the ante 875
VICTOR TXR1: posts the ante 875
Snoopy95_2.0: posts the ante 875
Billionai8: posts small blind 3500
Joes38: posts big blind 7000
*** HOLE CARDS ***
Varle84: folds 
VICTOR TXR1: folds 
Snoopy95_2.0: folds 
T3RSS1: raises 7000 to 14000
Giginis: folds 
MaCheCazzoFai: folds 
Billionai8: folds 
Joes38: folds 
Uncalled bet (7000) returned to T3RSS1
T3RSS1 collected 24500 from pot
*** SUMMARY ***
Total pot 24500 | Rake 0 
Seat 1: T3RSS1 collected (24500)
Seat 2: Giginis folded before Flop (didn't bet)
Seat 3: MaCheCazzoFai (button) folded before Flop (didn't bet)
Seat 4: Billionai8 (small blind) folded before Flop
Seat 5: Joes38 (big blind) folded before Flop
Seat 6: Varle84 folded before Flop (didn't bet)
Seat 7: VICTOR TXR1 folded before Flop (didn't bet)
Seat 8: Snoopy95_2.0 folded before Flop (didn't bet)

PokerStars Hand #251207302119: Tournament #3767885527, $40+$10+$5 USD Hold'em No Limit - Level XXI (3500/7000) - 2024/06/26 20:50:29 UTC [2024/06/26 16:50:29 ET]
Table '3767885527 63' 8-max Seat #4 is the button
Seat 1: T3RSS1 (318459 in chips) 
Seat 3: MaCheCazzoFai (318287 in chips) 
Seat 4: Billionai8 (303981 in chips) 
Seat 5: Joes38 (219996 in chips) 
Seat 6: Varle84 (159573 in chips) 
Seat 7: VICTOR TXR1 (110872 in chips) 
Seat 8: Snoopy95_2.0 (81934 in chips) 
T3RSS1: posts the ante 875
MaCheCazzoFai: posts the ante 875
Billionai8: posts the ante 875
Joes38: posts the ante 875
Varle84: posts the ante 875
VICTOR TXR1: posts the ante 875
Snoopy95_2.0: posts the ante 875
Joes38: posts small blind 3500
Varle84: posts big blind 7000
*** HOLE CARDS ***
VICTOR TXR1: folds 
Snoopy95_2.0: folds 
T3RSS1: folds 
MaCheCazzoFai: folds 
Billionai8: folds 
Joes38: folds 
Uncalled bet (3500) returned to Varle84
Varle84 collected 13125 from pot
*** SUMMARY ***
Total pot 13125 | Rake 0 
Seat 1: T3RSS1 folded before Flop (didn't bet)
Seat 3: MaCheCazzoFai folded before Flop (didn't bet)
Seat 4: Billionai8 (button) folded before Flop (didn't bet)
Seat 5: Joes38 (small blind) folded before Flop
Seat 6: Varle84 (big blind) collected (13125)
Seat 7: VICTOR TXR1 folded before Flop (didn't bet)
Seat 8: Snoopy95_2.0 folded before Flop (didn't bet)

PokerStars Hand #251207305894: Tournament #3767885527, $40+$10+$5 USD Hold'em No Limit - Level XXI (3500/7000) - 2024/06/26 20:50:43 UTC [2024/06/26 16:50:43 ET]
Table '3767885527 63' 8-max Seat #5 is the button
Seat 1: T3RSS1 (317584 in chips) 
Seat 3: MaCheCazzoFai (317412 in chips) 
Seat 4: Billionai8 (303106 in chips) 
Seat 5: Joes38 (215621 in chips) 
Seat 6: Varle84 (168323 in chips) 
Seat 7: VICTOR TXR1 (109997 in chips) 
Seat 8: Snoopy95_2.0 (81059 in chips) 
T3RSS1: posts the ante 875
MaCheCazzoFai: posts the ante 875
Billionai8: posts the ante 875
Joes38: posts the ante 875
Varle84: posts the ante 875
VICTOR TXR1: posts the ante 875
Snoopy95_2.0: posts the ante 875
Varle84: posts small blind 3500
VICTOR TXR1: posts big blind 7000
*** HOLE CARDS ***
Snoopy95_2.0: folds 
T3RSS1: raises 7000 to 14000
MaCheCazzoFai: raises 28000 to 42000
Billionai8: folds 
Joes38: folds 
Varle84: folds 
VICTOR TXR1: folds 
T3RSS1: folds 
Uncalled bet (28000) returned to MaCheCazzoFai
gibbo888 is disconnected 
MaCheCazzoFai collected 44625 from pot
MaCheCazzoFai: doesn't show hand 
*** SUMMARY ***
Total pot 44625 | Rake 0 
Seat 1: T3RSS1 folded before Flop
Seat 3: MaCheCazzoFai collected (44625)
Seat 4: Billionai8 folded before Flop (didn't bet)
Seat 5: Joes38 (button) folded before Flop (didn't bet)
Seat 6: Varle84 (small blind) folded before Flop
Seat 7: VICTOR TXR1 (big blind) folded before Flop
Seat 8: Snoopy95_2.0 folded before Flop (didn't bet)

PokerStars Hand #251207311364: Tournament #3767885527, $40+$10+$5 USD Hold'em No Limit - Level XXI (3500/7000) - 2024/06/26 20:51:03 UTC [2024/06/26 16:51:03 ET]
Table '3767885527 63' 8-max Seat #6 is the button
Seat 1: T3RSS1 (302709 in chips) 
Seat 2: gibbo888 (274749 in chips) 
Seat 3: MaCheCazzoFai (347162 in chips) 
Seat 4: Billionai8 (302231 in chips) 
Seat 5: Joes38 (214746 in chips) 
Seat 6: Varle84 (163948 in chips) 
Seat 7: VICTOR TXR1 (102122 in chips) 
Seat 8: Snoopy95_2.0 (80184 in chips) 
T3RSS1: posts the ante 875
gibbo888: posts the ante 875
MaCheCazzoFai: posts the ante 875
Billionai8: posts the ante 875
Joes38: posts the ante 875
Varle84: posts the ante 875
VICTOR TXR1: posts the ante 875
Snoopy95_2.0: posts the ante 875
VICTOR TXR1: posts small blind 3500
Snoopy95_2.0: posts big blind 7000
*** HOLE CARDS ***
T3RSS1 is disconnected 
T3RSS1 is connected 
T3RSS1 is disconnected 
T3RSS1 is connected 
T3RSS1: raises 7700 to 14700
gibbo888: folds 
MaCheCazzoFai: folds 
Billionai8: folds 
Joes38: folds 
Varle84: folds 
VICTOR TXR1: folds 
Snoopy95_2.0: calls 7700
*** FLOP *** [3h Ac 5h]
Snoopy95_2.0: checks 
T3RSS1: bets 20349
Snoopy95_2.0: raises 44260 to 64609 and is all-in
T3RSS1: calls 44260
*** TURN *** [3h Ac 5h] [9c]
*** RIVER *** [3h Ac 5h 9c] [7h]
*** SHOW DOWN ***
Snoopy95_2.0: shows [4c 5d] (a pair of Fives)
T3RSS1: shows [Ad Qc] (a pair of Aces)
T3RSS1 collected 169118 from pot
Snoopy95_2.0 finished the tournament in 196th place and received $115.10.
*** SUMMARY ***
Total pot 169118 | Rake 0 
Board [3h Ac 5h 9c 7h]
Seat 1: T3RSS1 showed [Ad Qc] and won (169118) with a pair of Aces
Seat 2: gibbo888 folded before Flop (didn't bet)
Seat 3: MaCheCazzoFai folded before Flop (didn't bet)
Seat 4: Billionai8 folded before Flop (didn't bet)
Seat 5: Joes38 folded before Flop (didn't bet)
Seat 6: Varle84 (button) folded before Flop (didn't bet)
Seat 7: VICTOR TXR1 (small blind) folded before Flop
Seat 8: Snoopy95_2.0 (big blind) showed [4c 5d] and lost with a pair of Fives

PokerStars Hand #251207323587: Tournament #3767885527, $40+$10+$5 USD Hold'em No Limit - Level XXI (3500/7000) - 2024/06/26 20:51:48 UTC [2024/06/26 16:51:48 ET]
Table '3767885527 63' 8-max Seat #7 is the button
Seat 1: T3RSS1 (391643 in chips) 
Seat 2: gibbo888 (273874 in chips) 
Seat 3: MaCheCazzoFai (346287 in chips) 
Seat 4: Billionai8 (301356 in chips) 
Seat 5: Joes38 (213871 in chips) 
Seat 6: Varle84 (163073 in chips) 
Seat 7: VICTOR TXR1 (97747 in chips) 
T3RSS1: posts the ante 875
gibbo888: posts the ante 875
MaCheCazzoFai: posts the ante 875
Billionai8: posts the ante 875
Joes38: posts the ante 875
Varle84: posts the ante 875
VICTOR TXR1: posts the ante 875
T3RSS1: posts small blind 3500
gibbo888: posts big blind 7000
*** HOLE CARDS ***
MaCheCazzoFai: folds 
Billionai8: folds 
Joes38: folds 
Varle84: raises 7000 to 14000
VICTOR TXR1: folds 
T3RSS1: folds 
gibbo888: calls 7000
*** FLOP *** [8h 2c Qd]
gibbo888: checks 
Varle84: bets 11620
GuyFromGipsy is disconnected 
gibbo888: raises 19880 to 31500
Varle84: calls 19880
*** TURN *** [8h 2c Qd] [8s]
gibbo888: checks 
Varle84: bets 22680
gibbo888: folds 
Uncalled bet (22680) returned to Varle84
Varle84 collected 100625 from pot
*** SUMMARY ***
Total pot 100625 | Rake 0 
Board [8h 2c Qd 8s]
Seat 1: T3RSS1 (small blind) folded before Flop
Seat 2: gibbo888 (big blind) folded on the Turn
Seat 3: MaCheCazzoFai folded before Flop (didn't bet)
Seat 4: Billionai8 folded before Flop (didn't bet)
Seat 5: Joes38 folded before Flop (didn't bet)
Seat 6: Varle84 collected (100625)
Seat 7: VICTOR TXR1 (button) folded before Flop (didn't bet)

PokerStars Hand #251207343174: Tournament #3767885527, $40+$10+$5 USD Hold'em No Limit - Level XXI (3500/7000) - 2024/06/26 20:53:01 UTC [2024/06/26 16:53:01 ET]
Table '3767885527 63' 8-max Seat #1 is the button
Seat 1: T3RSS1 (387268 in chips) 
Seat 2: gibbo888 (227499 in chips) 
Seat 3: MaCheCazzoFai (345412 in chips) 
Seat 4: Billionai8 (300481 in chips) 
Seat 5: Joes38 (212996 in chips) 
Seat 6: Varle84 (217323 in chips) 
Seat 7: VICTOR TXR1 (96872 in chips) 
Seat 8: GuyFromGipsy (228893 in chips) 
T3RSS1: posts the ante 875
gibbo888: posts the ante 875
MaCheCazzoFai: posts the ante 875
Billionai8: posts the ante 875
Joes38: posts the ante 875
Varle84: posts the ante 875
VICTOR TXR1: posts the ante 875
GuyFromGipsy: posts the ante 875
gibbo888: posts small blind 3500
MaCheCazzoFai: posts big blind 7000
*** HOLE CARDS ***
Billionai8: folds 
Joes38: folds 
Varle84: folds 
VICTOR TXR1: folds 
GuyFromGipsy: folds 
T3RSS1: raises 7700 to 14700
gibbo888: folds 
MaCheCazzoFai: calls 7700
*** FLOP *** [Qc 5c Ac]
MaCheCazzoFai: checks 
T3RSS1: bets 13167
MaCheCazzoFai: raises 16559 to 29726
T3RSS1: calls 16559
*** TURN *** [Qc 5c Ac] [Jc]
MaCheCazzoFai: checks 
T3RSS1: checks 
*** RIVER *** [Qc 5c Ac Jc] [Td]
MaCheCazzoFai: checks 
T3RSS1: checks 
*** SHOW DOWN ***
MaCheCazzoFai: shows [Kc 6c] (a flush, Ace high)
T3RSS1: mucks hand 
MaCheCazzoFai collected 99352 from pot
*** SUMMARY ***
Total pot 99352 | Rake 0 
Board [Qc 5c Ac Jc Td]
Seat 1: T3RSS1 (button) mucked
Seat 2: gibbo888 (small blind) folded before Flop
Seat 3: MaCheCazzoFai (big blind) showed [Kc 6c] and won (99352) with a flush, Ace high
Seat 4: Billionai8 folded before Flop (didn't bet)
Seat 5: Joes38 folded before Flop (didn't bet)
Seat 6: Varle84 folded before Flop (didn't bet)
Seat 7: VICTOR TXR1 folded before Flop (didn't bet)
Seat 8: GuyFromGipsy folded before Flop (didn't bet)

PokerStars Hand #251207361275: Tournament #3767885527, $40+$10+$5 USD Hold'em No Limit - Level XXI (3500/7000) - 2024/06/26 20:54:09 UTC [2024/06/26 16:54:09 ET]
Table '3767885527 63' 8-max Seat #2 is the button
Seat 1: T3RSS1 (341967 in chips) 
Seat 2: gibbo888 (223124 in chips) 
Seat 3: MaCheCazzoFai (399463 in chips) 
Seat 4: Billionai8 (299606 in chips) 
Seat 5: Joes38 (212121 in chips) 
Seat 6: Varle84 (216448 in chips) 
Seat 7: VICTOR TXR1 (95997 in chips) 
Seat 8: GuyFromGipsy (228018 in chips) 
T3RSS1: posts the ante 875
gibbo888: posts the ante 875
MaCheCazzoFai: posts the ante 875
Billionai8: posts the ante 875
Joes38: posts the ante 875
Varle84: posts the ante 875
VICTOR TXR1: posts the ante 875
GuyFromGipsy: posts the ante 875
MaCheCazzoFai: posts small blind 3500
Billionai8: posts big blind 7000
*** HOLE CARDS ***
Joes38: raises 8400 to 15400
Varle84: folds 
VICTOR TXR1: folds 
GuyFromGipsy: folds 
T3RSS1: folds 
gibbo888: folds 
MaCheCazzoFai: folds 
Billionai8: folds 
Uncalled bet (8400) returned to Joes38
Joes38 collected 24500 from pot
*** SUMMARY ***
Total pot 24500 | Rake 0 
Seat 1: T3RSS1 folded before Flop (didn't bet)
Seat 2: gibbo888 (button) folded before Flop (didn't bet)
Seat 3: MaCheCazzoFai (small blind) folded before Flop
Seat 4: Billionai8 (big blind) folded before Flop
Seat 5: Joes38 collected (24500)
Seat 6: Varle84 folded before Flop (didn't bet)
Seat 7: VICTOR TXR1 folded before Flop (didn't bet)
Seat 8: GuyFromGipsy folded before Flop (didn't bet)

PokerStars Hand #251207367304: Tournament #3767885527, $40+$10+$5 USD Hold'em No Limit - Level XXI (3500/7000) - 2024/06/26 20:54:32 UTC [2024/06/26 16:54:32 ET]
Table '3767885527 63' 8-max Seat #3 is the button
Seat 1: T3RSS1 (341092 in chips) 
Seat 2: gibbo888 (222249 in chips) 
Seat 3: MaCheCazzoFai (395088 in chips) 
Seat 4: Billionai8 (291731 in chips) 
Seat 5: Joes38 (228746 in chips) 
Seat 6: Varle84 (215573 in chips) 
Seat 7: VICTOR TXR1 (95122 in chips) 
Seat 8: GuyFromGipsy (227143 in chips) 
T3RSS1: posts the ante 875
gibbo888: posts the ante 875
MaCheCazzoFai: posts the ante 875
Billionai8: posts the ante 875
Joes38: posts the ante 875
Varle84: posts the ante 875
VICTOR TXR1: posts the ante 875
GuyFromGipsy: posts the ante 875
Billionai8: posts small blind 3500
Joes38: posts big blind 7000
*** HOLE CARDS ***
Varle84: raises 7000 to 14000
VICTOR TXR1: folds 
GuyFromGipsy: folds 
T3RSS1: folds 
gibbo888: folds 
MaCheCazzoFai: folds 
Billionai8: folds 
Joes38: folds 
Uncalled bet (7000) returned to Varle84
Varle84 collected 24500 from pot
*** SUMMARY ***
Total pot 24500 | Rake 0 
Seat 1: T3RSS1 folded before Flop (didn't bet)
Seat 2: gibbo888 folded before Flop (didn't bet)
Seat 3: MaCheCazzoFai (button) folded before Flop (didn't bet)
Seat 4: Billionai8 (small blind) folded before Flop
Seat 5: Joes38 (big blind) folded before Flop
Seat 6: Varle84 collected (24500)
Seat 7: VICTOR TXR1 folded before Flop (didn't bet)
Seat 8: GuyFromGipsy folded before Flop (didn't bet)

PokerStars Hand #251207373646: Tournament #3767885527, $40+$10+$5 USD Hold'em No Limit - Level XXI (3500/7000) - 2024/06/26 20:54:55 UTC [2024/06/26 16:54:55 ET]
Table '3767885527 63' 8-max Seat #4 is the button
Seat 1: T3RSS1 (340217 in chips) 
Seat 2: gibbo888 (221374 in chips) 
Seat 3: MaCheCazzoFai (394213 in chips) 
Seat 4: Billionai8 (287356 in chips) 
Seat 5: Joes38 (220871 in chips) 
Seat 6: Varle84 (232198 in chips) 
Seat 7: VICTOR TXR1 (94247 in chips) 
Seat 8: GuyFromGipsy (226268 in chips) 
T3RSS1: posts the ante 875
gibbo888: posts the ante 875
MaCheCazzoFai: posts the ante 875
Billionai8: posts the ante 875
Joes38: posts the ante 875
Varle84: posts the ante 875
VICTOR TXR1: posts the ante 875
GuyFromGipsy: posts the ante 875
Joes38: posts small blind 3500
Varle84: posts big blind 7000
*** HOLE CARDS ***
VICTOR TXR1: folds 
GuyFromGipsy: folds 
T3RSS1: folds 
gibbo888: raises 7000 to 14000
MaCheCazzoFai: folds 
Billionai8: raises 28000 to 42000
Joes38: folds 
Varle84: folds 
gibbo888: calls 28000
*** FLOP *** [5d 8s 4d]
gibbo888: checks 
Billionai8: checks 
*** TURN *** [5d 8s 4d] [Td]
gibbo888: checks 
Billionai8: checks 
*** RIVER *** [5d 8s 4d Td] [Js]
gibbo888: checks 
Billionai8: checks 
*** SHOW DOWN ***
gibbo888: shows [Qd Kc] (high card King)
Billionai8: shows [4h Kh] (a pair of Fours)
Billionai8 collected 101500 from pot
*** SUMMARY ***
Total pot 101500 | Rake 0 
Board [5d 8s 4d Td Js]
Seat 1: T3RSS1 folded before Flop (didn't bet)
Seat 2: gibbo888 showed [Qd Kc] and lost with high card King
Seat 3: MaCheCazzoFai folded before Flop (didn't bet)
Seat 4: Billionai8 (button) showed [4h Kh] and won (101500) with a pair of Fours
Seat 5: Joes38 (small blind) folded before Flop
Seat 6: Varle84 (big blind) folded before Flop
Seat 7: VICTOR TXR1 folded before Flop (didn't bet)
Seat 8: GuyFromGipsy folded before Flop (didn't bet)

PokerStars Hand #251207474919: Tournament #3767885527, $40+$10+$5 USD Hold'em No Limit - Level XXI (3500/7000) - 2024/06/26 21:02:48 UTC [2024/06/26 17:02:48 ET]
Table '3767885527 63' 8-max Seat #5 is the button
Seat 1: T3RSS1 (339342 in chips) 
Seat 2: gibbo888 (178499 in chips) 
Seat 3: MaCheCazzoFai (393338 in chips) 
Seat 4: Billionai8 (345981 in chips) 
Seat 5: Joes38 (216496 in chips) 
Seat 6: Varle84 (224323 in chips) 
Seat 7: VICTOR TXR1 (93372 in chips) 
Seat 8: GuyFromGipsy (225393 in chips) 
T3RSS1: posts the ante 875
gibbo888: posts the ante 875
MaCheCazzoFai: posts the ante 875
Billionai8: posts the ante 875
Joes38: posts the ante 875
Varle84: posts the ante 875
VICTOR TXR1: posts the ante 875
GuyFromGipsy: posts the ante 875
Varle84: posts small blind 3500
VICTOR TXR1: posts big blind 7000
*** HOLE CARDS ***
GuyFromGipsy: folds 
T3RSS1: folds 
gibbo888: raises 7000 to 14000
MaCheCazzoFai: folds 
Billionai8: folds 
Joes38: folds 
Varle84: folds 
VICTOR TXR1: folds 
Uncalled bet (7000) returned to gibbo888
gibbo888 collected 24500 from pot
*** SUMMARY ***
Total pot 24500 | Rake 0 
Seat 1: T3RSS1 folded before Flop (didn't bet)
Seat 2: gibbo888 collected (24500)
Seat 3: MaCheCazzoFai folded before Flop (didn't bet)
Seat 4: Billionai8 folded before Flop (didn't bet)
Seat 5: Joes38 (button) folded before Flop (didn't bet)
Seat 6: Varle84 (small blind) folded before Flop
Seat 7: VICTOR TXR1 (big blind) folded before Flop
Seat 8: GuyFromGipsy folded before Flop (didn't bet)

PokerStars Hand #251207480591: Tournament #3767885527, $40+$10+$5 USD Hold'em No Limit - Level XXI (3500/7000) - 2024/06/26 21:03:09 UTC [2024/06/26 17:03:09 ET]
Table '3767885527 63' 8-max Seat #6 is the button
Seat 1: T3RSS1 (338467 in chips) 
Seat 2: gibbo888 (195124 in chips) 
Seat 3: MaCheCazzoFai (392463 in chips) 
Seat 4: Billionai8 (345106 in chips) 
Seat 5: Joes38 (215621 in chips) 
Seat 6: Varle84 (219948 in chips) 
Seat 7: VICTOR TXR1 (85497 in chips) 
Seat 8: GuyFromGipsy (224518 in chips) 
T3RSS1: posts the ante 875
gibbo888: posts the ante 875
MaCheCazzoFai: posts the ante 875
Billionai8: posts the ante 875
Joes38: posts the ante 875
Varle84: posts the ante 875
VICTOR TXR1: posts the ante 875
GuyFromGipsy: posts the ante 875
VICTOR TXR1: posts small blind 3500
GuyFromGipsy: posts big blind 7000
*** HOLE CARDS ***
T3RSS1: folds 
gibbo888: folds 
MaCheCazzoFai: folds 
Billionai8: folds 
Joes38: folds 
Varle84: folds 
VICTOR TXR1: calls 3500
GuyFromGipsy: raises 216643 to 223643 and is all-in
VICTOR TXR1: folds 
Uncalled bet (216643) returned to GuyFromGipsy
GuyFromGipsy collected 21000 from pot
GuyFromGipsy: doesn't show hand 
*** SUMMARY ***
Total pot 21000 | Rake 0 
Seat 1: T3RSS1 folded before Flop (didn't bet)
Seat 2: gibbo888 folded before Flop (didn't bet)
Seat 3: MaCheCazzoFai folded before Flop (didn't bet)
Seat 4: Billionai8 folded before Flop (didn't bet)
Seat 5: Joes38 folded before Flop (didn't bet)
Seat 6: Varle84 (button) folded before Flop (didn't bet)
Seat 7: VICTOR TXR1 (small blind) folded before Flop
Seat 8: GuyFromGipsy (big blind) collected (21000)

PokerStars Hand #251207500261: Tournament #3767885527, $40+$10+$5 USD Hold'em No Limit - Level XXII (4000/8000) - 2024/06/26 21:04:21 UTC [2024/06/26 17:04:21 ET]
Table '3767885527 63' 8-max Seat #7 is the button
Seat 1: T3RSS1 (337592 in chips) 
Seat 2: gibbo888 (194249 in chips) 
Seat 3: MaCheCazzoFai (391588 in chips) 
Seat 4: Billionai8 (344231 in chips) 
Seat 5: Joes38 (214746 in chips) 
Seat 6: Varle84 (219073 in chips) 
Seat 7: VICTOR TXR1 (77622 in chips) 
Seat 8: GuyFromGipsy (237643 in chips) 
T3RSS1: posts the ante 1000
gibbo888: posts the ante 1000
MaCheCazzoFai: posts the ante 1000
Billionai8: posts the ante 1000
Joes38: posts the ante 1000
Varle84: posts the ante 1000
VICTOR TXR1: posts the ante 1000
GuyFromGipsy: posts the ante 1000
GuyFromGipsy: posts small blind 4000
T3RSS1: posts big blind 8000
*** HOLE CARDS ***
gibbo888: folds 
MaCheCazzoFai: folds 
Billionai8: folds 
Joes38: folds 
Varle84: raises 8000 to 16000
VICTOR TXR1: folds 
GuyFromGipsy: raises 32000 to 48000
T3RSS1: folds 
Varle84: folds 
Uncalled bet (32000) returned to GuyFromGipsy
GuyFromGipsy collected 48000 from pot
GuyFromGipsy: doesn't show hand 
*** SUMMARY ***
Total pot 48000 | Rake 0 
Seat 1: T3RSS1 (big blind) folded before Flop
Seat 2: gibbo888 folded before Flop (didn't bet)
Seat 3: MaCheCazzoFai folded before Flop (didn't bet)
Seat 4: Billionai8 folded before Flop (didn't bet)
Seat 5: Joes38 folded before Flop (didn't bet)
Seat 6: Varle84 folded before Flop
Seat 7: VICTOR TXR1 (button) folded before Flop (didn't bet)
Seat 8: GuyFromGipsy (small blind) collected (48000)

PokerStars Hand #251207512232: Tournament #3767885527, $40+$10+$5 USD Hold'em No Limit - Level XXII (4000/8000) - 2024/06/26 21:05:06 UTC [2024/06/26 17:05:06 ET]
Table '3767885527 63' 8-max Seat #8 is the button
Seat 1: T3RSS1 (328592 in chips) 
Seat 2: gibbo888 (193249 in chips) 
Seat 3: MaCheCazzoFai (390588 in chips) 
Seat 4: Billionai8 (343231 in chips) 
Seat 5: Joes38 (213746 in chips) 
Seat 6: Varle84 (202073 in chips) 
Seat 7: VICTOR TXR1 (76622 in chips) 
Seat 8: GuyFromGipsy (268643 in chips) 
T3RSS1: posts the ante 1000
gibbo888: posts the ante 1000
MaCheCazzoFai: posts the ante 1000
Billionai8: posts the ante 1000
Joes38: posts the ante 1000
Varle84: posts the ante 1000
VICTOR TXR1: posts the ante 1000
GuyFromGipsy: posts the ante 1000
T3RSS1: posts small blind 4000
gibbo888: posts big blind 8000
*** HOLE CARDS ***
MaCheCazzoFai: raises 8000 to 16000
Billionai8: folds 
Joes38: folds 
Varle84: folds 
VICTOR TXR1: folds 
GuyFromGipsy: folds 
T3RSS1: folds 
gibbo888: folds 
Uncalled bet (8000) returned to MaCheCazzoFai
MaCheCazzoFai collected 28000 from pot
MaCheCazzoFai: doesn't show hand 
*** SUMMARY ***
Total pot 28000 | Rake 0 
Seat 1: T3RSS1 (small blind) folded before Flop
Seat 2: gibbo888 (big blind) folded before Flop
Seat 3: MaCheCazzoFai collected (28000)
Seat 4: Billionai8 folded before Flop (didn't bet)
Seat 5: Joes38 folded before Flop (didn't bet)
Seat 6: Varle84 folded before Flop (didn't bet)
Seat 7: VICTOR TXR1 folded before Flop (didn't bet)
Seat 8: GuyFromGipsy (button) folded before Flop (didn't bet)

PokerStars Hand #251207523520: Tournament #3767885527, $40+$10+$5 USD Hold'em No Limit - Level XXII (4000/8000) - 2024/06/26 21:05:43 UTC [2024/06/26 17:05:43 ET]
Table '3767885527 63' 8-max Seat #1 is the button
Seat 1: T3RSS1 (323592 in chips) 
Seat 2: gibbo888 (184249 in chips) 
Seat 3: MaCheCazzoFai (409588 in chips) 
Seat 4: Billionai8 (342231 in chips) 
Seat 6: Varle84 (201073 in chips) 
Seat 7: VICTOR TXR1 (75622 in chips) 
Seat 8: GuyFromGipsy (267643 in chips) 
T3RSS1: posts the ante 1000
gibbo888: posts the ante 1000
MaCheCazzoFai: posts the ante 1000
Billionai8: posts the ante 1000
Varle84: posts the ante 1000
VICTOR TXR1: posts the ante 1000
GuyFromGipsy: posts the ante 1000
gibbo888: posts small blind 4000
MaCheCazzoFai: posts big blind 8000
*** HOLE CARDS ***
Billionai8: folds 
Varle84: folds 
Juicy_J_93 is disconnected 
VICTOR TXR1: folds 
GuyFromGipsy: folds 
T3RSS1: folds 
gibbo888: folds 
Uncalled bet (4000) returned to MaCheCazzoFai
MaCheCazzoFai collected 15000 from pot
MaCheCazzoFai: doesn't show hand 
*** SUMMARY ***
Total pot 15000 | Rake 0 
Seat 1: T3RSS1 (button) folded before Flop (didn't bet)
Seat 2: gibbo888 (small blind) folded before Flop
Seat 3: MaCheCazzoFai (big blind) collected (15000)
Seat 4: Billionai8 folded before Flop (didn't bet)
Seat 6: Varle84 folded before Flop (didn't bet)
Seat 7: VICTOR TXR1 folded before Flop (didn't bet)
Seat 8: GuyFromGipsy folded before Flop (didn't bet)

PokerStars Hand #251207530156: Tournament #3767885527, $40+$10+$5 USD Hold'em No Limit - Level XXII (4000/8000) - 2024/06/26 21:06:05 UTC [2024/06/26 17:06:05 ET]
Table '3767885527 63' 8-max Seat #2 is the button
Seat 1: T3RSS1 (322592 in chips) 
Seat 2: gibbo888 (179249 in chips) 
Seat 3: MaCheCazzoFai (419588 in chips) 
Seat 4: Billionai8 (341231 in chips) 
Seat 5: Juicy_J_93 (166051 in chips) 
Seat 6: Varle84 (200073 in chips) 
Seat 7: VICTOR TXR1 (74622 in chips) 
Seat 8: GuyFromGipsy (266643 in chips) 
T3RSS1: posts the ante 1000
gibbo888: posts the ante 1000
MaCheCazzoFai: posts the ante 1000
Billionai8: posts the ante 1000
Juicy_J_93: posts the ante 1000
Varle84: posts the ante 1000
VICTOR TXR1: posts the ante 1000
GuyFromGipsy: posts the ante 1000
MaCheCazzoFai: posts small blind 4000
Billionai8: posts big blind 8000
*** HOLE CARDS ***
Juicy_J_93: folds 
Varle84: folds 
VICTOR TXR1: folds 
GuyFromGipsy: folds 
T3RSS1: folds 
gibbo888: folds 
MaCheCazzoFai: calls 4000
Billionai8: checks 
*** FLOP *** [8d 9h 5h]
MaCheCazzoFai: checks 
Billionai8: checks 
*** TURN *** [8d 9h 5h] [Qh]
MaCheCazzoFai: bets 16000
Billionai8: folds 
Uncalled bet (16000) returned to MaCheCazzoFai
MaCheCazzoFai collected 24000 from pot
MaCheCazzoFai: doesn't show hand 
*** SUMMARY ***
Total pot 24000 | Rake 0 
Board [8d 9h 5h Qh]
Seat 1: T3RSS1 folded before Flop (didn't bet)
Seat 2: gibbo888 (button) folded before Flop (didn't bet)
Seat 3: MaCheCazzoFai (small blind) collected (24000)
Seat 4: Billionai8 (big blind) folded on the Turn
Seat 5: Juicy_J_93 folded before Flop (didn't bet)
Seat 6: Varle84 folded before Flop (didn't bet)
Seat 7: VICTOR TXR1 folded before Flop (didn't bet)
Seat 8: GuyFromGipsy folded before Flop (didn't bet)

PokerStars Hand #251207543368: Tournament #3767885527, $40+$10+$5 USD Hold'em No Limit - Level XXII (4000/8000) - 2024/06/26 21:06:49 UTC [2024/06/26 17:06:49 ET]
Table '3767885527 63' 8-max Seat #3 is the button
Seat 1: T3RSS1 (321592 in chips) 
Seat 2: gibbo888 (178249 in chips) 
Seat 3: MaCheCazzoFai (434588 in chips) 
Seat 4: Billionai8 (332231 in chips) 
Seat 5: Juicy_J_93 (165051 in chips) 
Seat 6: Varle84 (199073 in chips) 
Seat 7: VICTOR TXR1 (73622 in chips) 
Seat 8: GuyFromGipsy (265643 in chips) 
T3RSS1: posts the ante 1000
gibbo888: posts the ante 1000
MaCheCazzoFai: posts the ante 1000
Billionai8: posts the ante 1000
Juicy_J_93: posts the ante 1000
Varle84: posts the ante 1000
VICTOR TXR1: posts the ante 1000
GuyFromGipsy: posts the ante 1000
Billionai8: posts small blind 4000
Juicy_J_93: posts big blind 8000
*** HOLE CARDS ***
Varle84: folds 
VICTOR TXR1: folds 
GuyFromGipsy: folds 
T3RSS1: folds 
gibbo888: folds 
MaCheCazzoFai: folds 
Billionai8: raises 323231 to 331231 and is all-in
Juicy_J_93: folds 
Uncalled bet (323231) returned to Billionai8
Billionai8 collected 24000 from pot
Billionai8: doesn't show hand 
*** SUMMARY ***
Total pot 24000 | Rake 0 
Seat 1: T3RSS1 folded before Flop (didn't bet)
Seat 2: gibbo888 folded before Flop (didn't bet)
Seat 3: MaCheCazzoFai (button) folded before Flop (didn't bet)
Seat 4: Billionai8 (small blind) collected (24000)
Seat 5: Juicy_J_93 (big blind) folded before Flop
Seat 6: Varle84 folded before Flop (didn't bet)
Seat 7: VICTOR TXR1 folded before Flop (didn't bet)
Seat 8: GuyFromGipsy folded before Flop (didn't bet)

PokerStars Hand #251207552217: Tournament #3767885527, $40+$10+$5 USD Hold'em No Limit - Level XXII (4000/8000) - 2024/06/26 21:07:19 UTC [2024/06/26 17:07:19 ET]
Table '3767885527 63' 8-max Seat #4 is the button
Seat 1: T3RSS1 (320592 in chips) 
Seat 2: gibbo888 (177249 in chips) 
Seat 3: MaCheCazzoFai (433588 in chips) 
Seat 4: Billionai8 (347231 in chips) 
Seat 5: Juicy_J_93 (156051 in chips) 
Seat 6: Varle84 (198073 in chips) 
Seat 7: VICTOR TXR1 (72622 in chips) 
Seat 8: GuyFromGipsy (264643 in chips) 
T3RSS1: posts the ante 1000
gibbo888: posts the ante 1000
MaCheCazzoFai: posts the ante 1000
Billionai8: posts the ante 1000
Juicy_J_93: posts the ante 1000
Varle84: posts the ante 1000
VICTOR TXR1: posts the ante 1000
GuyFromGipsy: posts the ante 1000
Juicy_J_93: posts small blind 4000
Varle84: posts big blind 8000
*** HOLE CARDS ***
VICTOR TXR1: raises 63622 to 71622 and is all-in
GuyFromGipsy: folds 
T3RSS1: folds 
gibbo888: folds 
MaCheCazzoFai: folds 
Billionai8: folds 
Juicy_J_93: folds 
Varle84: folds 
Uncalled bet (63622) returned to VICTOR TXR1
VICTOR TXR1 collected 28000 from pot
VICTOR TXR1: doesn't show hand 
*** SUMMARY ***
Total pot 28000 | Rake 0 
Seat 1: T3RSS1 folded before Flop (didn't bet)
Seat 2: gibbo888 folded before Flop (didn't bet)
Seat 3: MaCheCazzoFai folded before Flop (didn't bet)
Seat 4: Billionai8 (button) folded before Flop (didn't bet)
Seat 5: Juicy_J_93 (small blind) folded before Flop
Seat 6: Varle84 (big blind) folded before Flop
Seat 7: VICTOR TXR1 collected (28000)
Seat 8: GuyFromGipsy folded before Flop (didn't bet)

PokerStars Hand #251207562158: Tournament #3767885527, $40+$10+$5 USD Hold'em No Limit - Level XXII (4000/8000) - 2024/06/26 21:07:52 UTC [2024/06/26 17:07:52 ET]
Table '3767885527 63' 8-max Seat #5 is the button
Seat 1: T3RSS1 (319592 in chips) 
Seat 2: gibbo888 (176249 in chips) 
Seat 3: MaCheCazzoFai (432588 in chips) 
Seat 4: Billionai8 (346231 in chips) 
Seat 5: Juicy_J_93 (151051 in chips) 
Seat 6: Varle84 (189073 in chips) 
Seat 7: VICTOR TXR1 (91622 in chips) 
Seat 8: GuyFromGipsy (263643 in chips) 
T3RSS1: posts the ante 1000
gibbo888: posts the ante 1000
MaCheCazzoFai: posts the ante 1000
Billionai8: posts the ante 1000
Juicy_J_93: posts the ante 1000
Varle84: posts the ante 1000
VICTOR TXR1: posts the ante 1000
GuyFromGipsy: posts the ante 1000
Varle84: posts small blind 4000
VICTOR TXR1: posts big blind 8000
*** HOLE CARDS ***
GuyFromGipsy: folds 
T3RSS1: folds 
gibbo888: folds 
MaCheCazzoFai: folds 
Billionai8: folds 
Juicy_J_93: raises 8000 to 16000
Varle84: folds 
VICTOR TXR1: folds 
Uncalled bet (8000) returned to Juicy_J_93
Juicy_J_93 collected 28000 from pot
Juicy_J_93: doesn't show hand 
*** SUMMARY ***
Total pot 28000 | Rake 0 
Seat 1: T3RSS1 folded before Flop (didn't bet)
Seat 2: gibbo888 folded before Flop (didn't bet)
Seat 3: MaCheCazzoFai folded before Flop (didn't bet)
Seat 4: Billionai8 folded before Flop (didn't bet)
Seat 5: Juicy_J_93 (button) collected (28000)
Seat 6: Varle84 (small blind) folded before Flop
Seat 7: VICTOR TXR1 (big blind) folded before Flop
Seat 8: GuyFromGipsy folded before Flop (didn't bet)

PokerStars Hand #251207571153: Tournament #3767885527, $40+$10+$5 USD Hold'em No Limit - Level XXII (4000/8000) - 2024/06/26 21:08:21 UTC [2024/06/26 17:08:21 ET]
Table '3767885527 63' 8-max Seat #6 is the button
Seat 1: T3RSS1 (318592 in chips) 
Seat 2: gibbo888 (175249 in chips) 
Seat 3: MaCheCazzoFai (431588 in chips) 
Seat 4: Billionai8 (345231 in chips) 
Seat 5: Juicy_J_93 (170051 in chips) 
Seat 6: Varle84 (184073 in chips) 
Seat 7: VICTOR TXR1 (82622 in chips) 
Seat 8: GuyFromGipsy (262643 in chips) 
T3RSS1: posts the ante 1000
gibbo888: posts the ante 1000
MaCheCazzoFai: posts the ante 1000
Billionai8: posts the ante 1000
Juicy_J_93: posts the ante 1000
Varle84: posts the ante 1000
VICTOR TXR1: posts the ante 1000
GuyFromGipsy: posts the ante 1000
VICTOR TXR1: posts small blind 4000
GuyFromGipsy: posts big blind 8000
*** HOLE CARDS ***
T3RSS1: folds 
gibbo888: folds 
MaCheCazzoFai: folds 
Billionai8: folds 
Juicy_J_93: folds 
Varle84: folds 
VICTOR TXR1: folds 
Uncalled bet (4000) returned to GuyFromGipsy
GuyFromGipsy collected 16000 from pot
GuyFromGipsy: doesn't show hand 
*** SUMMARY ***
Total pot 16000 | Rake 0 
Seat 1: T3RSS1 folded before Flop (didn't bet)
Seat 2: gibbo888 folded before Flop (didn't bet)
Seat 3: MaCheCazzoFai folded before Flop (didn't bet)
Seat 4: Billionai8 folded before Flop (didn't bet)
Seat 5: Juicy_J_93 folded before Flop (didn't bet)
Seat 6: Varle84 (button) folded before Flop (didn't bet)
Seat 7: VICTOR TXR1 (small blind) folded before Flop
Seat 8: GuyFromGipsy (big blind) collected (16000)

PokerStars Hand #251207576231: Tournament #3767885527, $40+$10+$5 USD Hold'em No Limit - Level XXII (4000/8000) - 2024/06/26 21:08:38 UTC [2024/06/26 17:08:38 ET]
Table '3767885527 63' 8-max Seat #7 is the button
Seat 1: T3RSS1 (317592 in chips) 
Seat 2: gibbo888 (174249 in chips) 
Seat 3: MaCheCazzoFai (430588 in chips) 
Seat 4: Billionai8 (344231 in chips) 
Seat 5: Juicy_J_93 (169051 in chips) 
Seat 6: Varle84 (183073 in chips) 
Seat 7: VICTOR TXR1 (77622 in chips) 
Seat 8: GuyFromGipsy (273643 in chips) 
T3RSS1: posts the ante 1000
gibbo888: posts the ante 1000
MaCheCazzoFai: posts the ante 1000
Billionai8: posts the ante 1000
Juicy_J_93: posts the ante 1000
Varle84: posts the ante 1000
VICTOR TXR1: posts the ante 1000
GuyFromGipsy: posts the ante 1000
GuyFromGipsy: posts small blind 4000
T3RSS1: posts big blind 8000
*** HOLE CARDS ***
gibbo888: folds 
MaCheCazzoFai: folds 
Billionai8: raises 8000 to 16000
Juicy_J_93: folds 
Varle84: raises 166073 to 182073 and is all-in
VICTOR TXR1: folds 
GuyFromGipsy: folds 
T3RSS1: folds 
Billionai8: folds 
Uncalled bet (166073) returned to Varle84
Varle84 collected 52000 from pot
*** SUMMARY ***
Total pot 52000 | Rake 0 
Seat 1: T3RSS1 (big blind) folded before Flop
Seat 2: gibbo888 folded before Flop (didn't bet)
Seat 3: MaCheCazzoFai folded before Flop (didn't bet)
Seat 4: Billionai8 folded before Flop
Seat 5: Juicy_J_93 folded before Flop (didn't bet)
Seat 6: Varle84 collected (52000)
Seat 7: VICTOR TXR1 (button) folded before Flop (didn't bet)
Seat 8: GuyFromGipsy (small blind) folded before Flop

PokerStars Hand #251207591755: Tournament #3767885527, $40+$10+$5 USD Hold'em No Limit - Level XXII (4000/8000) - 2024/06/26 21:09:29 UTC [2024/06/26 17:09:29 ET]
Table '3767885527 63' 8-max Seat #8 is the button
Seat 1: T3RSS1 (308592 in chips) 
Seat 2: gibbo888 (173249 in chips) 
Seat 3: MaCheCazzoFai (429588 in chips) 
Seat 4: Billionai8 (327231 in chips) 
Seat 5: Juicy_J_93 (168051 in chips) 
Seat 6: Varle84 (218073 in chips) 
Seat 7: VICTOR TXR1 (76622 in chips) 
Seat 8: GuyFromGipsy (268643 in chips) 
T3RSS1: posts the ante 1000
gibbo888: posts the ante 1000
MaCheCazzoFai: posts the ante 1000
Billionai8: posts the ante 1000
Juicy_J_93: posts the ante 1000
Varle84: posts the ante 1000
VICTOR TXR1: posts the ante 1000
GuyFromGipsy: posts the ante 1000
T3RSS1: posts small blind 4000
gibbo888: posts big blind 8000
*** HOLE CARDS ***
MaCheCazzoFai: folds 
Billionai8: folds 
Juicy_J_93: folds 
Varle84: folds 
VICTOR TXR1: raises 67622 to 75622 and is all-in
GuyFromGipsy has timed out
GuyFromGipsy: folds 
GuyFromGipsy is sitting out
T3RSS1: raises 231970 to 307592 and is all-in
gibbo888: folds 
Uncalled bet (231970) returned to T3RSS1
*** FLOP *** [6d Kd Qd]
GuyFromGipsy has returned
*** TURN *** [6d Kd Qd] [Qs]
*** RIVER *** [6d Kd Qd Qs] [6s]
*** SHOW DOWN ***
T3RSS1: shows [Ks Ad] (two pair, Kings and Queens)
VICTOR TXR1: shows [As 4d] (two pair, Queens and Sixes)
T3RSS1 collected 167244 from pot
VICTOR TXR1 finished the tournament in 160th place and received $126.61.
*** SUMMARY ***
Total pot 167244 | Rake 0 
Board [6d Kd Qd Qs 6s]
Seat 1: T3RSS1 (small blind) showed [Ks Ad] and won (167244) with two pair, Kings and Queens
Seat 2: gibbo888 (big blind) folded before Flop
Seat 3: MaCheCazzoFai folded before Flop (didn't bet)
Seat 4: Billionai8 folded before Flop (didn't bet)
Seat 5: Juicy_J_93 folded before Flop (didn't bet)
Seat 6: Varle84 folded before Flop (didn't bet)
Seat 7: VICTOR TXR1 showed [As 4d] and lost with two pair, Queens and Sixes
Seat 8: GuyFromGipsy (button) folded before Flop (didn't bet)

PokerStars Hand #251207602298: Tournament #3767885527, $40+$10+$5 USD Hold'em No Limit - Level XXII (4000/8000) - 2024/06/26 21:10:03 UTC [2024/06/26 17:10:03 ET]
Table '3767885527 63' 8-max Seat #1 is the button
Seat 1: T3RSS1 (399214 in chips) 
Seat 2: gibbo888 (164249 in chips) 
Seat 3: MaCheCazzoFai (428588 in chips) 
Seat 4: Billionai8 (326231 in chips) 
Seat 5: Juicy_J_93 (167051 in chips) 
Seat 6: Varle84 (217073 in chips) 
Seat 8: GuyFromGipsy (267643 in chips) 
T3RSS1: posts the ante 1000
gibbo888: posts the ante 1000
MaCheCazzoFai: posts the ante 1000
Billionai8: posts the ante 1000
Juicy_J_93: posts the ante 1000
Varle84: posts the ante 1000
GuyFromGipsy: posts the ante 1000
gibbo888: posts small blind 4000
MaCheCazzoFai: posts big blind 8000
*** HOLE CARDS ***
Billionai8: folds 
Juicy_J_93: folds 
Varle84: folds 
GuyFromGipsy: raises 8000 to 16000
T3RSS1: folds 
gibbo888: folds 
MaCheCazzoFai: raises 40000 to 56000
GuyFromGipsy: raises 210643 to 266643 and is all-in
MaCheCazzoFai: folds 
Uncalled bet (210643) returned to GuyFromGipsy
GuyFromGipsy collected 123000 from pot
GuyFromGipsy: doesn't show hand 
*** SUMMARY ***
Total pot 123000 | Rake 0 
Seat 1: T3RSS1 (button) folded before Flop (didn't bet)
Seat 2: gibbo888 (small blind) folded before Flop
Seat 3: MaCheCazzoFai (big blind) folded before Flop
Seat 4: Billionai8 folded before Flop (didn't bet)
Seat 5: Juicy_J_93 folded before Flop (didn't bet)
Seat 6: Varle84 folded before Flop (didn't bet)
Seat 8: GuyFromGipsy collected (123000)

PokerStars Hand #251207612875: Tournament #3767885527, $40+$10+$5 USD Hold'em No Limit - Level XXII (4000/8000) - 2024/06/26 21:10:38 UTC [2024/06/26 17:10:38 ET]
Table '3767885527 63' 8-max Seat #2 is the button
Seat 1: T3RSS1 (398214 in chips) 
Seat 2: gibbo888 (159249 in chips) 
Seat 3: MaCheCazzoFai (371588 in chips) 
Seat 4: Billionai8 (325231 in chips) 
Seat 5: Juicy_J_93 (166051 in chips) 
Seat 6: Varle84 (216073 in chips) 
Seat 8: GuyFromGipsy (333643 in chips) 
T3RSS1: posts the ante 1000
gibbo888: posts the ante 1000
MaCheCazzoFai: posts the ante 1000
Billionai8: posts the ante 1000
Juicy_J_93: posts the ante 1000
Varle84: posts the ante 1000
GuyFromGipsy: posts the ante 1000
MaCheCazzoFai: posts small blind 4000
Billionai8: posts big blind 8000
*** HOLE CARDS ***
Juicy_J_93: folds 
Varle84: folds 
GuyFromGipsy: folds 
T3RSS1: folds 
gibbo888: folds 
MaCheCazzoFai: calls 4000
Billionai8: raises 20000 to 28000
MaCheCazzoFai: folds 
Uncalled bet (20000) returned to Billionai8
Billionai8 collected 23000 from pot
Billionai8: doesn't show hand 
*** SUMMARY ***
Total pot 23000 | Rake 0 
Seat 1: T3RSS1 folded before Flop (didn't bet)
Seat 2: gibbo888 (button) folded before Flop (didn't bet)
Seat 3: MaCheCazzoFai (small blind) folded before Flop
Seat 4: Billionai8 (big blind) collected (23000)
Seat 5: Juicy_J_93 folded before Flop (didn't bet)
Seat 6: Varle84 folded before Flop (didn't bet)
Seat 8: GuyFromGipsy folded before Flop (didn't bet)

PokerStars Hand #251207624603: Tournament #3767885527, $40+$10+$5 USD Hold'em No Limit - Level XXII (4000/8000) - 2024/06/26 21:11:16 UTC [2024/06/26 17:11:16 ET]
Table '3767885527 63' 8-max Seat #3 is the button
Seat 1: T3RSS1 (397214 in chips) 
Seat 2: gibbo888 (158249 in chips) 
Seat 3: MaCheCazzoFai (362588 in chips) 
Seat 4: Billionai8 (339231 in chips) 
Seat 5: Juicy_J_93 (165051 in chips) 
Seat 6: Varle84 (215073 in chips) 
Seat 8: GuyFromGipsy (332643 in chips) 
T3RSS1: posts the ante 1000
gibbo888: posts the ante 1000
MaCheCazzoFai: posts the ante 1000
Billionai8: posts the ante 1000
Juicy_J_93: posts the ante 1000
Varle84: posts the ante 1000
GuyFromGipsy: posts the ante 1000
Billionai8: posts small blind 4000
Juicy_J_93: posts big blind 8000
*** HOLE CARDS ***
Varle84: folds 
GuyFromGipsy: folds 
T3RSS1: raises 8800 to 16800
gibbo888: folds 
MaCheCazzoFai: calls 16800
Billionai8: calls 12800
JAYJOEEEEE is disconnected 
Juicy_J_93: calls 8800
*** FLOP *** [6h 4c 6s]
Billionai8: checks 
Juicy_J_93: checks 
T3RSS1: checks 
MaCheCazzoFai: checks 
*** TURN *** [6h 4c 6s] [9d]
Billionai8: checks 
Juicy_J_93: checks 
T3RSS1: checks 
MaCheCazzoFai: bets 37100
Billionai8: folds 
Juicy_J_93: folds 
T3RSS1: folds 
Uncalled bet (37100) returned to MaCheCazzoFai
MaCheCazzoFai collected 74200 from pot
MaCheCazzoFai: doesn't show hand 
*** SUMMARY ***
Total pot 74200 | Rake 0 
Board [6h 4c 6s 9d]
Seat 1: T3RSS1 folded on the Turn
Seat 2: gibbo888 folded before Flop (didn't bet)
Seat 3: MaCheCazzoFai (button) collected (74200)
Seat 4: Billionai8 (small blind) folded on the Turn
Seat 5: Juicy_J_93 (big blind) folded on the Turn
Seat 6: Varle84 folded before Flop (didn't bet)
Seat 8: GuyFromGipsy folded before Flop (didn't bet)

PokerStars Hand #251207653615: Tournament #3767885527, $40+$10+$5 USD Hold'em No Limit - Level XXII (4000/8000) - 2024/06/26 21:12:51 UTC [2024/06/26 17:12:51 ET]
Table '3767885527 63' 8-max Seat #4 is the button
Seat 1: T3RSS1 (379414 in chips) 
Seat 2: gibbo888 (157249 in chips) 
Seat 3: MaCheCazzoFai (418988 in chips) 
Seat 4: Billionai8 (321431 in chips) 
Seat 5: Juicy_J_93 (147251 in chips) 
Seat 6: Varle84 (214073 in chips) 
Seat 7: JAYJOEEEEE (372572 in chips) 
Seat 8: GuyFromGipsy (331643 in chips) 
T3RSS1: posts the ante 1000
gibbo888: posts the ante 1000
MaCheCazzoFai: posts the ante 1000
Billionai8: posts the ante 1000
Juicy_J_93: posts the ante 1000
Varle84: posts the ante 1000
JAYJOEEEEE: posts the ante 1000
GuyFromGipsy: posts the ante 1000
Juicy_J_93: posts small blind 4000
Varle84: posts big blind 8000
*** HOLE CARDS ***
JAYJOEEEEE: raises 9600 to 17600
GuyFromGipsy: folds 
T3RSS1: folds 
gibbo888: folds 
MaCheCazzoFai: calls 17600
Billionai8: folds 
Juicy_J_93: folds 
Varle84: calls 9600
*** FLOP *** [Td 3d 6c]
Varle84: checks 
JAYJOEEEEE: bets 19440
MaCheCazzoFai: calls 19440
Varle84: folds 
*** TURN *** [Td 3d 6c] [Qc]
JAYJOEEEEE: bets 46656
MaCheCazzoFai: raises 98496 to 145152
JAYJOEEEEE: calls 98496
*** RIVER *** [Td 3d 6c Qc] [9d]
JAYJOEEEEE: checks 
MaCheCazzoFai: checks 
*** SHOW DOWN ***
JAYJOEEEEE: shows [Qs Kh] (a pair of Queens)
MaCheCazzoFai: shows [Ts Tc] (three of a kind, Tens)
MaCheCazzoFai collected 393984 from pot
*** SUMMARY ***
Total pot 393984 | Rake 0 
Board [Td 3d 6c Qc 9d]
Seat 1: T3RSS1 folded before Flop (didn't bet)
Seat 2: gibbo888 folded before Flop (didn't bet)
Seat 3: MaCheCazzoFai showed [Ts Tc] and won (393984) with three of a kind, Tens
Seat 4: Billionai8 (button) folded before Flop (didn't bet)
Seat 5: Juicy_J_93 (small blind) folded before Flop
Seat 6: Varle84 (big blind) folded on the Flop
Seat 7: JAYJOEEEEE showed [Qs Kh] and lost with a pair of Queens
Seat 8: GuyFromGipsy folded before Flop (didn't bet)

PokerStars Hand #251207684806: Tournament #3767885527, $40+$10+$5 USD Hold'em No Limit - Level XXIII (5000/10000) - 2024/06/26 21:14:32 UTC [2024/06/26 17:14:32 ET]
Table '3767885527 63' 8-max Seat #5 is the button
Seat 1: T3RSS1 (378414 in chips) 
Seat 2: gibbo888 (156249 in chips) 
Seat 3: MaCheCazzoFai (629780 in chips) 
Seat 4: Billionai8 (320431 in chips) 
Seat 5: Juicy_J_93 (142251 in chips) 
Seat 6: Varle84 (195473 in chips) 
Seat 7: JAYJOEEEEE (189380 in chips) 
Seat 8: GuyFromGipsy (330643 in chips) 
T3RSS1: posts the ante 1250
gibbo888: posts the ante 1250
MaCheCazzoFai: posts the ante 1250
Billionai8: posts the ante 1250
Juicy_J_93: posts the ante 1250
Varle84: posts the ante 1250
JAYJOEEEEE: posts the ante 1250
GuyFromGipsy: posts the ante 1250
Varle84: posts small blind 5000
JAYJOEEEEE: posts big blind 10000
*** HOLE CARDS ***
GuyFromGipsy: folds 
T3RSS1: raises 11000 to 21000
gibbo888: folds 
MaCheCazzoFai: folds 
Billionai8: calls 21000
Juicy_J_93: folds 
Varle84: folds 
JAYJOEEEEE: folds 
*** FLOP *** [Qd 6s 7h]
T3RSS1: bets 22110
Billionai8: calls 22110
*** TURN *** [Qd 6s 7h] [Ts]
T3RSS1: bets 56722
Billionai8: calls 56722
*** RIVER *** [Qd 6s 7h Ts] [8d]
T3RSS1: checks 
Billionai8: checks 
*** SHOW DOWN ***
T3RSS1: shows [As 9s] (a straight, Six to Ten)
Billionai8: mucks hand 
T3RSS1 collected 224664 from pot
*** SUMMARY ***
Total pot 224664 | Rake 0 
Board [Qd 6s 7h Ts 8d]
Seat 1: T3RSS1 showed [As 9s] and won (224664) with a straight, Six to Ten
Seat 2: gibbo888 folded before Flop (didn't bet)
Seat 3: MaCheCazzoFai folded before Flop (didn't bet)
Seat 4: Billionai8 mucked
Seat 5: Juicy_J_93 (button) folded before Flop (didn't bet)
Seat 6: Varle84 (small blind) folded before Flop
Seat 7: JAYJOEEEEE (big blind) folded before Flop
Seat 8: GuyFromGipsy folded before Flop (didn't bet)

PokerStars Hand #251207716607: Tournament #3767885527, $40+$10+$5 USD Hold'em No Limit - Level XXIII (5000/10000) - 2024/06/26 21:16:15 UTC [2024/06/26 17:16:15 ET]
Table '3767885527 63' 8-max Seat #6 is the button
Seat 1: T3RSS1 (501996 in chips) 
Seat 2: gibbo888 (154999 in chips) 
Seat 3: MaCheCazzoFai (628530 in chips) 
Seat 4: Billionai8 (219349 in chips) 
Seat 5: Juicy_J_93 (141001 in chips) 
Seat 6: Varle84 (189223 in chips) 
Seat 7: JAYJOEEEEE (178130 in chips) 
Seat 8: GuyFromGipsy (329393 in chips) 
T3RSS1: posts the ante 1250
gibbo888: posts the ante 1250
MaCheCazzoFai: posts the ante 1250
Billionai8: posts the ante 1250
Juicy_J_93: posts the ante 1250
Varle84: posts the ante 1250
JAYJOEEEEE: posts the ante 1250
GuyFromGipsy: posts the ante 1250
JAYJOEEEEE: posts small blind 5000
GuyFromGipsy: posts big blind 10000
*** HOLE CARDS ***
T3RSS1: folds 
gibbo888: raises 12000 to 22000
MaCheCazzoFai: folds 
Billionai8: folds 
Juicy_J_93: folds 
Varle84: folds 
JAYJOEEEEE: folds 
GuyFromGipsy: calls 12000
*** FLOP *** [Kh 2c 7d]
GuyFromGipsy: checks 
gibbo888: bets 131749 and is all-in
GuyFromGipsy: folds 
Uncalled bet (131749) returned to gibbo888
gibbo888 collected 59000 from pot
gibbo888: doesn't show hand 
*** SUMMARY ***
Total pot 59000 | Rake 0 
Board [Kh 2c 7d]
Seat 1: T3RSS1 folded before Flop (didn't bet)
Seat 2: gibbo888 collected (59000)
Seat 3: MaCheCazzoFai folded before Flop (didn't bet)
Seat 4: Billionai8 folded before Flop (didn't bet)
Seat 5: Juicy_J_93 folded before Flop (didn't bet)
Seat 6: Varle84 (button) folded before Flop (didn't bet)
Seat 7: JAYJOEEEEE (small blind) folded before Flop
Seat 8: GuyFromGipsy (big blind) folded on the Flop

PokerStars Hand #251207733118: Tournament #3767885527, $40+$10+$5 USD Hold'em No Limit - Level XXIII (5000/10000) - 2024/06/26 21:17:09 UTC [2024/06/26 17:17:09 ET]
Table '3767885527 63' 8-max Seat #7 is the button
Seat 1: T3RSS1 (500746 in chips) 
Seat 2: gibbo888 (190749 in chips) 
Seat 3: MaCheCazzoFai (627280 in chips) 
Seat 4: Billionai8 (218099 in chips) 
Seat 5: Juicy_J_93 (139751 in chips) 
Seat 6: Varle84 (187973 in chips) 
Seat 7: JAYJOEEEEE (171880 in chips) 
Seat 8: GuyFromGipsy (306143 in chips) 
T3RSS1: posts the ante 1250
gibbo888: posts the ante 1250
MaCheCazzoFai: posts the ante 1250
Billionai8: posts the ante 1250
Juicy_J_93: posts the ante 1250
Varle84: posts the ante 1250
JAYJOEEEEE: posts the ante 1250
GuyFromGipsy: posts the ante 1250
GuyFromGipsy: posts small blind 5000
T3RSS1: posts big blind 10000
*** HOLE CARDS ***
gibbo888: folds 
MaCheCazzoFai: folds 
Billionai8: folds 
Juicy_J_93: folds 
Varle84: folds 
JAYJOEEEEE: folds 
GuyFromGipsy: folds 
Uncalled bet (5000) returned to T3RSS1
T3RSS1 collected 20000 from pot
T3RSS1: doesn't show hand 
*** SUMMARY ***
Total pot 20000 | Rake 0 
Seat 1: T3RSS1 (big blind) collected (20000)
Seat 2: gibbo888 folded before Flop (didn't bet)
Seat 3: MaCheCazzoFai folded before Flop (didn't bet)
Seat 4: Billionai8 folded before Flop (didn't bet)
Seat 5: Juicy_J_93 folded before Flop (didn't bet)
Seat 6: Varle84 folded before Flop (didn't bet)
Seat 7: JAYJOEEEEE (button) folded before Flop (didn't bet)
Seat 8: GuyFromGipsy (small blind) folded before Flop

PokerStars Hand #251207738507: Tournament #3767885527, $40+$10+$5 USD Hold'em No Limit - Level XXIII (5000/10000) - 2024/06/26 21:17:26 UTC [2024/06/26 17:17:26 ET]
Table '3767885527 63' 8-max Seat #8 is the button
Seat 1: T3RSS1 (514496 in chips) 
Seat 2: gibbo888 (189499 in chips) 
Seat 3: MaCheCazzoFai (626030 in chips) 
Seat 4: Billionai8 (216849 in chips) 
Seat 5: Juicy_J_93 (138501 in chips) 
Seat 6: Varle84 (186723 in chips) 
Seat 7: JAYJOEEEEE (170630 in chips) 
Seat 8: GuyFromGipsy (299893 in chips) 
T3RSS1: posts the ante 1250
gibbo888: posts the ante 1250
MaCheCazzoFai: posts the ante 1250
Billionai8: posts the ante 1250
Juicy_J_93: posts the ante 1250
Varle84: posts the ante 1250
JAYJOEEEEE: posts the ante 1250
GuyFromGipsy: posts the ante 1250
T3RSS1: posts small blind 5000
gibbo888: posts big blind 10000
*** HOLE CARDS ***
MaCheCazzoFai: raises 10000 to 20000
Billionai8: folds 
Juicy_J_93: folds 
Varle84: folds 
JAYJOEEEEE: raises 149380 to 169380 and is all-in
GuyFromGipsy: folds 
T3RSS1: folds 
gibbo888: folds 
MaCheCazzoFai: folds 
Uncalled bet (149380) returned to JAYJOEEEEE
JAYJOEEEEE collected 65000 from pot
JAYJOEEEEE: doesn't show hand 
*** SUMMARY ***
Total pot 65000 | Rake 0 
Seat 1: T3RSS1 (small blind) folded before Flop
Seat 2: gibbo888 (big blind) folded before Flop
Seat 3: MaCheCazzoFai folded before Flop
Seat 4: Billionai8 folded before Flop (didn't bet)
Seat 5: Juicy_J_93 folded before Flop (didn't bet)
Seat 6: Varle84 folded before Flop (didn't bet)
Seat 7: JAYJOEEEEE collected (65000)
Seat 8: GuyFromGipsy (button) folded before Flop (didn't bet)

PokerStars Hand #251207748778: Tournament #3767885527, $40+$10+$5 USD Hold'em No Limit - Level XXIII (5000/10000) - 2024/06/26 21:17:59 UTC [2024/06/26 17:17:59 ET]
Table '3767885527 63' 8-max Seat #1 is the button
Seat 1: T3RSS1 (508246 in chips) 
Seat 2: gibbo888 (178249 in chips) 
Seat 3: MaCheCazzoFai (604780 in chips) 
Seat 4: Billionai8 (215599 in chips) 
Seat 5: Juicy_J_93 (137251 in chips) 
Seat 6: Varle84 (185473 in chips) 
Seat 7: JAYJOEEEEE (214380 in chips) 
Seat 8: GuyFromGipsy (298643 in chips) 
T3RSS1: posts the ante 1250
gibbo888: posts the ante 1250
MaCheCazzoFai: posts the ante 1250
Billionai8: posts the ante 1250
Juicy_J_93: posts the ante 1250
Varle84: posts the ante 1250
JAYJOEEEEE: posts the ante 1250
GuyFromGipsy: posts the ante 1250
gibbo888: posts small blind 5000
MaCheCazzoFai: posts big blind 10000
*** HOLE CARDS ***
Billionai8: folds 
Juicy_J_93: folds 
Varle84: raises 174223 to 184223 and is all-in
JAYJOEEEEE: folds 
GuyFromGipsy: folds 
T3RSS1: folds 
gibbo888: calls 171999 and is all-in
MaCheCazzoFai: folds 
Uncalled bet (7224) returned to Varle84
*** FLOP *** [As Ks Ad]
*** TURN *** [As Ks Ad] [4c]
*** RIVER *** [As Ks Ad 4c] [6h]
*** SHOW DOWN ***
gibbo888: shows [Ah Ac] (four of a kind, Aces)
Varle84: shows [8c 8s] (two pair, Aces and Eights)
gibbo888 collected 373998 from pot
*** SUMMARY ***
Total pot 373998 | Rake 0 
Board [As Ks Ad 4c 6h]
Seat 1: T3RSS1 (button) folded before Flop (didn't bet)
Seat 2: gibbo888 (small blind) showed [Ah Ac] and won (373998) with four of a kind, Aces
Seat 3: MaCheCazzoFai (big blind) folded before Flop
Seat 4: Billionai8 folded before Flop (didn't bet)
Seat 5: Juicy_J_93 folded before Flop (didn't bet)
Seat 6: Varle84 showed [8c 8s] and lost with two pair, Aces and Eights
Seat 7: JAYJOEEEEE folded before Flop (didn't bet)
Seat 8: GuyFromGipsy folded before Flop (didn't bet)

PokerStars Hand #251207761006: Tournament #3767885527, $40+$10+$5 USD Hold'em No Limit - Level XXIII (5000/10000) - 2024/06/26 21:18:39 UTC [2024/06/26 17:18:39 ET]
Table '3767885527 63' 8-max Seat #2 is the button
Seat 1: T3RSS1 (506996 in chips) 
Seat 2: gibbo888 (373998 in chips) 
Seat 3: MaCheCazzoFai (593530 in chips) 
Seat 4: Billionai8 (214349 in chips) 
Seat 5: Juicy_J_93 (136001 in chips) 
Seat 6: Varle84 (7224 in chips) 
Seat 7: JAYJOEEEEE (213130 in chips) 
Seat 8: GuyFromGipsy (297393 in chips) 
T3RSS1: posts the ante 1250
gibbo888: posts the ante 1250
MaCheCazzoFai: posts the ante 1250
Billionai8: posts the ante 1250
Juicy_J_93: posts the ante 1250
Varle84: posts the ante 1250
JAYJOEEEEE: posts the ante 1250
GuyFromGipsy: posts the ante 1250
MaCheCazzoFai: posts small blind 5000
Billionai8: posts big blind 10000
*** HOLE CARDS ***
Juicy_J_93: folds 
Varle84: calls 5974 and is all-in
JAYJOEEEEE: folds 
GuyFromGipsy: folds 
T3RSS1: folds 
gibbo888: folds 
MaCheCazzoFai: folds 
Uncalled bet (4026) returned to Billionai8
*** FLOP *** [Qc 2s Js]
*** TURN *** [Qc 2s Js] [5c]
*** RIVER *** [Qc 2s Js 5c] [3s]
*** SHOW DOWN ***
Billionai8: shows [5d Jd] (two pair, Jacks and Fives)
Varle84: shows [9c 3c] (a pair of Threes)
Billionai8 collected 26948 from pot
Varle84 finished the tournament in 137th place and received $139.27.
*** SUMMARY ***
Total pot 26948 | Rake 0 
Board [Qc 2s Js 5c 3s]
Seat 1: T3RSS1 folded before Flop (didn't bet)
Seat 2: gibbo888 (button) folded before Flop (didn't bet)
Seat 3: MaCheCazzoFai (small blind) folded before Flop
Seat 4: Billionai8 (big blind) showed [5d Jd] and won (26948) with two pair, Jacks and Fives
Seat 5: Juicy_J_93 folded before Flop (didn't bet)
Seat 6: Varle84 showed [9c 3c] and lost with a pair of Threes
Seat 7: JAYJOEEEEE folded before Flop (didn't bet)
Seat 8: GuyFromGipsy folded before Flop (didn't bet)


PokerStars Hand #251205405838: Tournament #3767885527, $40+$10+$5 USD Hold'em No Limit - Level XI (600/1200) - 2024/06/26 18:52:41 UTC [2024/06/26 14:52:41 ET]
Table '3767885527 61' 8-max Seat #7 is the button
Seat 1: ipayou (27075 in chips) 
Seat 2: MezuuÜuuT (13245 in chips) 
Seat 3: Hjerterdame1 (87216 in chips) 
Seat 4: ederpalasson (54943 in chips) 
Seat 6: ThalleSx (20480 in chips) 
Seat 7: fournn (59435 in chips) 
Seat 8: vagoyras (49499 in chips) 
ipayou: posts the ante 150
MezuuÜuuT: posts the ante 150
Hjerterdame1: posts the ante 150
ederpalasson: posts the ante 150
ThalleSx: posts the ante 150
fournn: posts the ante 150
vagoyras: posts the ante 150
vagoyras: posts small blind 600
ipayou: posts big blind 1200
*** HOLE CARDS ***
nacho2390 is disconnected 
MezuuÜuuT: folds 
Hjerterdame1: folds 
ederpalasson: raises 1200 to 2400
ThalleSx: folds 
fournn: folds 
vagoyras: folds 
ipayou: folds 
Uncalled bet (1200) returned to ederpalasson
ederpalasson collected 4050 from pot
ederpalasson: doesn't show hand 
*** SUMMARY ***
Total pot 4050 | Rake 0 
Seat 1: ipayou (big blind) folded before Flop
Seat 2: MezuuÜuuT folded before Flop (didn't bet)
Seat 3: Hjerterdame1 folded before Flop (didn't bet)
Seat 4: ederpalasson collected (4050)
Seat 6: ThalleSx folded before Flop (didn't bet)
Seat 7: fournn (button) folded before Flop (didn't bet)
Seat 8: vagoyras (small blind) folded before Flop

PokerStars Hand #251205418986: Tournament #3767885527, $40+$10+$5 USD Hold'em No Limit - Level XI (600/1200) - 2024/06/26 18:53:31 UTC [2024/06/26 14:53:31 ET]
Table '3767885527 61' 8-max Seat #8 is the button
Seat 1: ipayou (25725 in chips) 
Seat 2: MezuuÜuuT (13095 in chips) 
Seat 3: Hjerterdame1 (87066 in chips) 
Seat 4: ederpalasson (57643 in chips) 
Seat 5: nacho2390 (25000 in chips) 
Seat 6: ThalleSx (20330 in chips) 
Seat 7: fournn (59285 in chips) 
Seat 8: vagoyras (48749 in chips) 
ipayou: posts the ante 150
MezuuÜuuT: posts the ante 150
Hjerterdame1: posts the ante 150
ederpalasson: posts the ante 150
nacho2390: posts the ante 150
ThalleSx: posts the ante 150
fournn: posts the ante 150
vagoyras: posts the ante 150
ipayou: posts small blind 600
MezuuÜuuT: posts big blind 1200
*** HOLE CARDS ***
Hjerterdame1: raises 2000 to 3200
ederpalasson: folds 
nacho2390: raises 21650 to 24850 and is all-in
ThalleSx: folds 
fournn: folds 
vagoyras: folds 
ipayou: folds 
MezuuÜuuT: folds 
Hjerterdame1: folds [As]
Uncalled bet (21650) returned to nacho2390
nacho2390 collected 9400 from pot
nacho2390: doesn't show hand 
*** SUMMARY ***
Total pot 9400 | Rake 0 
Seat 1: ipayou (small blind) folded before Flop
Seat 2: MezuuÜuuT (big blind) folded before Flop
Seat 3: Hjerterdame1 folded before Flop
Seat 4: ederpalasson folded before Flop (didn't bet)
Seat 5: nacho2390 collected (9400)
Seat 6: ThalleSx folded before Flop (didn't bet)
Seat 7: fournn folded before Flop (didn't bet)
Seat 8: vagoyras (button) folded before Flop (didn't bet)

PokerStars Hand #251205436927: Tournament #3767885527, $40+$10+$5 USD Hold'em No Limit - Level XI (600/1200) - 2024/06/26 18:54:39 UTC [2024/06/26 14:54:39 ET]
Table '3767885527 61' 8-max Seat #1 is the button
Seat 1: ipayou (24975 in chips) 
Seat 2: MezuuÜuuT (11745 in chips) 
Seat 3: Hjerterdame1 (83716 in chips) 
Seat 4: ederpalasson (57493 in chips) 
Seat 5: nacho2390 (31050 in chips) 
Seat 6: ThalleSx (20180 in chips) 
Seat 7: fournn (59135 in chips) 
Seat 8: vagoyras (48599 in chips) 
ipayou: posts the ante 150
MezuuÜuuT: posts the ante 150
Hjerterdame1: posts the ante 150
ederpalasson: posts the ante 150
nacho2390: posts the ante 150
ThalleSx: posts the ante 150
fournn: posts the ante 150
vagoyras: posts the ante 150
MezuuÜuuT: posts small blind 600
Hjerterdame1: posts big blind 1200
*** HOLE CARDS ***
ederpalasson: raises 1200 to 2400
nacho2390: folds 
ThalleSx: folds 
fournn: folds 
vagoyras: folds 
ipayou: folds 
MezuuÜuuT: raises 9195 to 11595 and is all-in
Hjerterdame1: folds 
ederpalasson: calls 9195
*** FLOP *** [5s Qs 4h]
*** TURN *** [5s Qs 4h] [8s]
*** RIVER *** [5s Qs 4h 8s] [Ks]
*** SHOW DOWN ***
MezuuÜuuT: shows [Jh Ah] (high card Ace)
ederpalasson: shows [Tc 9c] (high card King)
MezuuÜuuT collected 25590 from pot
*** SUMMARY ***
Total pot 25590 | Rake 0 
Board [5s Qs 4h 8s Ks]
Seat 1: ipayou (button) folded before Flop (didn't bet)
Seat 2: MezuuÜuuT (small blind) showed [Jh Ah] and won (25590) with high card Ace
Seat 3: Hjerterdame1 (big blind) folded before Flop
Seat 4: ederpalasson showed [Tc 9c] and lost with high card King
Seat 5: nacho2390 folded before Flop (didn't bet)
Seat 6: ThalleSx folded before Flop (didn't bet)
Seat 7: fournn folded before Flop (didn't bet)
Seat 8: vagoyras folded before Flop (didn't bet)

PokerStars Hand #251205528139: Tournament #3767885527, $40+$10+$5 USD Hold'em No Limit - Level XI (600/1200) - 2024/06/26 19:02:04 UTC [2024/06/26 15:02:04 ET]
Table '3767885527 61' 8-max Seat #2 is the button
Seat 1: ipayou (24825 in chips) 
Seat 2: MezuuÜuuT (25590 in chips) 
Seat 3: Hjerterdame1 (82366 in chips) 
Seat 4: ederpalasson (45748 in chips) 
Seat 5: nacho2390 (30900 in chips) 
Seat 6: ThalleSx (20030 in chips) 
Seat 7: fournn (58985 in chips) 
Seat 8: vagoyras (48449 in chips) 
ipayou: posts the ante 150
MezuuÜuuT: posts the ante 150
Hjerterdame1: posts the ante 150
ederpalasson: posts the ante 150
nacho2390: posts the ante 150
ThalleSx: posts the ante 150
fournn: posts the ante 150
vagoyras: posts the ante 150
Hjerterdame1: posts small blind 600
ederpalasson: posts big blind 1200
*** HOLE CARDS ***
nacho2390: folds 
ThalleSx: folds 
fournn: folds 
vagoyras: folds 
ipayou: folds 
MezuuÜuuT: raises 1440 to 2640
Hjerterdame1: calls 2040
ederpalasson: folds 
*** FLOP *** [3h Ad 8c]
Hjerterdame1: checks 
MezuuÜuuT: checks 
*** TURN *** [3h Ad 8c] [5d]
Hjerterdame1: checks 
MezuuÜuuT: checks 
*** RIVER *** [3h Ad 8c 5d] [As]
Hjerterdame1: bets 3840
MezuuÜuuT: raises 5160 to 9000
Hjerterdame1: calls 5160
*** SHOW DOWN ***
MezuuÜuuT: shows [6c Ah] (three of a kind, Aces)
Hjerterdame1: shows [Ac 9h] (three of a kind, Aces - Nine kicker)
Hjerterdame1 collected 25680 from pot
*** SUMMARY ***
Total pot 25680 | Rake 0 
Board [3h Ad 8c 5d As]
Seat 1: ipayou folded before Flop (didn't bet)
Seat 2: MezuuÜuuT (button) showed [6c Ah] and lost with three of a kind, Aces
Seat 3: Hjerterdame1 (small blind) showed [Ac 9h] and won (25680) with three of a kind, Aces
Seat 4: ederpalasson (big blind) folded before Flop
Seat 5: nacho2390 folded before Flop (didn't bet)
Seat 6: ThalleSx folded before Flop (didn't bet)
Seat 7: fournn folded before Flop (didn't bet)
Seat 8: vagoyras folded before Flop (didn't bet)

PokerStars Hand #251205548705: Tournament #3767885527, $40+$10+$5 USD Hold'em No Limit - Level XI (600/1200) - 2024/06/26 19:03:27 UTC [2024/06/26 15:03:27 ET]
Table '3767885527 61' 8-max Seat #3 is the button
Seat 1: ipayou (24675 in chips) 
Seat 2: MezuuÜuuT (13800 in chips) 
Seat 3: Hjerterdame1 (96256 in chips) 
Seat 4: ederpalasson (44398 in chips) 
Seat 5: nacho2390 (30750 in chips) 
Seat 6: ThalleSx (19880 in chips) 
Seat 7: fournn (58835 in chips) 
Seat 8: vagoyras (48299 in chips) 
ipayou: posts the ante 150
MezuuÜuuT: posts the ante 150
Hjerterdame1: posts the ante 150
ederpalasson: posts the ante 150
nacho2390: posts the ante 150
ThalleSx: posts the ante 150
fournn: posts the ante 150
vagoyras: posts the ante 150
ederpalasson: posts small blind 600
nacho2390: posts big blind 1200
*** HOLE CARDS ***
ThalleSx: folds 
fournn: folds 
vagoyras: folds 
ipayou: raises 1200 to 2400
MezuuÜuuT: folds 
Hjerterdame1: folds 
ederpalasson: folds 
nacho2390: raises 28200 to 30600 and is all-in
ipayou: folds 
Uncalled bet (28200) returned to nacho2390
nacho2390 collected 6600 from pot
nacho2390: doesn't show hand 
*** SUMMARY ***
Total pot 6600 | Rake 0 
Seat 1: ipayou folded before Flop
Seat 2: MezuuÜuuT folded before Flop (didn't bet)
Seat 3: Hjerterdame1 (button) folded before Flop (didn't bet)
Seat 4: ederpalasson (small blind) folded before Flop
Seat 5: nacho2390 (big blind) collected (6600)
Seat 6: ThalleSx folded before Flop (didn't bet)
Seat 7: fournn folded before Flop (didn't bet)
Seat 8: vagoyras folded before Flop (didn't bet)

PokerStars Hand #251205556518: Tournament #3767885527, $40+$10+$5 USD Hold'em No Limit - Level XI (600/1200) - 2024/06/26 19:03:58 UTC [2024/06/26 15:03:58 ET]
Table '3767885527 61' 8-max Seat #4 is the button
Seat 1: ipayou (22125 in chips) 
Seat 2: MezuuÜuuT (13650 in chips) 
Seat 3: Hjerterdame1 (96106 in chips) 
Seat 4: ederpalasson (43648 in chips) 
Seat 5: nacho2390 (34800 in chips) 
Seat 6: ThalleSx (19730 in chips) 
Seat 7: fournn (58685 in chips) 
Seat 8: vagoyras (48149 in chips) 
ipayou: posts the ante 150
MezuuÜuuT: posts the ante 150
Hjerterdame1: posts the ante 150
ederpalasson: posts the ante 150
nacho2390: posts the ante 150
ThalleSx: posts the ante 150
fournn: posts the ante 150
vagoyras: posts the ante 150
nacho2390: posts small blind 600
ThalleSx: posts big blind 1200
*** HOLE CARDS ***
fournn: folds 
vagoyras: folds 
ipayou: folds 
MezuuÜuuT: folds 
Hjerterdame1: folds 
ederpalasson: folds 
nacho2390: folds 
Uncalled bet (600) returned to ThalleSx
ThalleSx collected 2400 from pot
ThalleSx: doesn't show hand 
*** SUMMARY ***
Total pot 2400 | Rake 0 
Seat 1: ipayou folded before Flop (didn't bet)
Seat 2: MezuuÜuuT folded before Flop (didn't bet)
Seat 3: Hjerterdame1 folded before Flop (didn't bet)
Seat 4: ederpalasson (button) folded before Flop (didn't bet)
Seat 5: nacho2390 (small blind) folded before Flop
Seat 6: ThalleSx (big blind) collected (2400)
Seat 7: fournn folded before Flop (didn't bet)
Seat 8: vagoyras folded before Flop (didn't bet)

PokerStars Hand #251205563690: Tournament #3767885527, $40+$10+$5 USD Hold'em No Limit - Level XI (600/1200) - 2024/06/26 19:04:26 UTC [2024/06/26 15:04:26 ET]
Table '3767885527 61' 8-max Seat #5 is the button
Seat 1: ipayou (21975 in chips) 
Seat 2: MezuuÜuuT (13500 in chips) 
Seat 3: Hjerterdame1 (95956 in chips) 
Seat 4: ederpalasson (43498 in chips) 
Seat 5: nacho2390 (34050 in chips) 
Seat 6: ThalleSx (21380 in chips) 
Seat 7: fournn (58535 in chips) 
Seat 8: vagoyras (47999 in chips) 
ipayou: posts the ante 150
MezuuÜuuT: posts the ante 150
Hjerterdame1: posts the ante 150
ederpalasson: posts the ante 150
nacho2390: posts the ante 150
ThalleSx: posts the ante 150
fournn: posts the ante 150
vagoyras: posts the ante 150
ThalleSx: posts small blind 600
fournn: posts big blind 1200
*** HOLE CARDS ***
vagoyras: folds 
ipayou: raises 1200 to 2400
MezuuÜuuT: folds 
Hjerterdame1: folds 
ederpalasson: raises 3000 to 5400
nacho2390: folds 
ThalleSx: folds 
fournn: folds 
ipayou: raises 16425 to 21825 and is all-in
ederpalasson: folds 
Uncalled bet (16425) returned to ipayou
ipayou collected 13800 from pot
*** SUMMARY ***
Total pot 13800 | Rake 0 
Seat 1: ipayou collected (13800)
Seat 2: MezuuÜuuT folded before Flop (didn't bet)
Seat 3: Hjerterdame1 folded before Flop (didn't bet)
Seat 4: ederpalasson folded before Flop
Seat 5: nacho2390 (button) folded before Flop (didn't bet)
Seat 6: ThalleSx (small blind) folded before Flop
Seat 7: fournn (big blind) folded before Flop
Seat 8: vagoyras folded before Flop (didn't bet)

PokerStars Hand #251205582065: Tournament #3767885527, $40+$10+$5 USD Hold'em No Limit - Level XI (600/1200) - 2024/06/26 19:05:36 UTC [2024/06/26 15:05:36 ET]
Table '3767885527 61' 8-max Seat #6 is the button
Seat 1: ipayou (30225 in chips) 
Seat 2: MezuuÜuuT (13350 in chips) 
Seat 3: Hjerterdame1 (95806 in chips) 
Seat 4: ederpalasson (37948 in chips) 
Seat 5: nacho2390 (33900 in chips) 
Seat 6: ThalleSx (20630 in chips) 
Seat 7: fournn (57185 in chips) 
Seat 8: vagoyras (47849 in chips) 
ipayou: posts the ante 150
MezuuÜuuT: posts the ante 150
Hjerterdame1: posts the ante 150
ederpalasson: posts the ante 150
nacho2390: posts the ante 150
ThalleSx: posts the ante 150
fournn: posts the ante 150
vagoyras: posts the ante 150
fournn: posts small blind 600
vagoyras: posts big blind 1200
*** HOLE CARDS ***
ipayou: folds 
MezuuÜuuT: folds 
Hjerterdame1: folds 
ederpalasson: folds 
nacho2390: folds 
ThalleSx: raises 19280 to 20480 and is all-in
fournn: folds 
vagoyras: folds 
Uncalled bet (19280) returned to ThalleSx
ThalleSx collected 4200 from pot
ThalleSx: doesn't show hand 
*** SUMMARY ***
Total pot 4200 | Rake 0 
Seat 1: ipayou folded before Flop (didn't bet)
Seat 2: MezuuÜuuT folded before Flop (didn't bet)
Seat 3: Hjerterdame1 folded before Flop (didn't bet)
Seat 4: ederpalasson folded before Flop (didn't bet)
Seat 5: nacho2390 folded before Flop (didn't bet)
Seat 6: ThalleSx (button) collected (4200)
Seat 7: fournn (small blind) folded before Flop
Seat 8: vagoyras (big blind) folded before Flop

PokerStars Hand #251205596018: Tournament #3767885527, $40+$10+$5 USD Hold'em No Limit - Level XI (600/1200) - 2024/06/26 19:06:29 UTC [2024/06/26 15:06:29 ET]
Table '3767885527 61' 8-max Seat #7 is the button
Seat 1: ipayou (30075 in chips) 
Seat 2: MezuuÜuuT (13200 in chips) 
Seat 3: Hjerterdame1 (95656 in chips) 
Seat 4: ederpalasson (37798 in chips) 
Seat 5: nacho2390 (33750 in chips) 
Seat 6: ThalleSx (23480 in chips) 
Seat 7: fournn (56435 in chips) 
Seat 8: vagoyras (46499 in chips) 
ipayou: posts the ante 150
MezuuÜuuT: posts the ante 150
Hjerterdame1: posts the ante 150
ederpalasson: posts the ante 150
nacho2390: posts the ante 150
ThalleSx: posts the ante 150
fournn: posts the ante 150
vagoyras: posts the ante 150
vagoyras: posts small blind 600
ipayou: posts big blind 1200
*** HOLE CARDS ***
MezuuÜuuT: folds 
Hjerterdame1: folds 
ederpalasson: folds 
nacho2390: raises 1320 to 2520
ThalleSx: folds 
fournn: folds 
vagoyras: folds 
ipayou: calls 1320
*** FLOP *** [3s 7h Ah]
ipayou: checks 
nacho2390: bets 1800
ipayou: raises 3480 to 5280
nacho2390: calls 3480
*** TURN *** [3s 7h Ah] [7c]
ipayou: bets 7800
nacho2390: calls 7800
*** RIVER *** [3s 7h Ah 7c] [9d]
ipayou: bets 14325 and is all-in
nacho2390: calls 14325
*** SHOW DOWN ***
ipayou: shows [Ad Ts] (two pair, Aces and Sevens)
nacho2390: shows [Qs Qc] (two pair, Queens and Sevens)
ipayou collected 61650 from pot
*** SUMMARY ***
Total pot 61650 | Rake 0 
Board [3s 7h Ah 7c 9d]
Seat 1: ipayou (big blind) showed [Ad Ts] and won (61650) with two pair, Aces and Sevens
Seat 2: MezuuÜuuT folded before Flop (didn't bet)
Seat 3: Hjerterdame1 folded before Flop (didn't bet)
Seat 4: ederpalasson folded before Flop (didn't bet)
Seat 5: nacho2390 showed [Qs Qc] and lost with two pair, Queens and Sevens
Seat 6: ThalleSx folded before Flop (didn't bet)
Seat 7: fournn (button) folded before Flop (didn't bet)
Seat 8: vagoyras (small blind) folded before Flop

PokerStars Hand #251205629947: Tournament #3767885527, $40+$10+$5 USD Hold'em No Limit - Level XI (600/1200) - 2024/06/26 19:08:36 UTC [2024/06/26 15:08:36 ET]
Table '3767885527 61' 8-max Seat #8 is the button
Seat 1: ipayou (61650 in chips) 
Seat 2: MezuuÜuuT (13050 in chips) 
Seat 3: Hjerterdame1 (95506 in chips) 
Seat 4: ederpalasson (37648 in chips) 
Seat 5: nacho2390 (3675 in chips) 
Seat 6: ThalleSx (23330 in chips) 
Seat 7: fournn (56285 in chips) 
Seat 8: vagoyras (45749 in chips) 
ipayou: posts the ante 150
MezuuÜuuT: posts the ante 150
Hjerterdame1: posts the ante 150
ederpalasson: posts the ante 150
nacho2390: posts the ante 150
ThalleSx: posts the ante 150
fournn: posts the ante 150
vagoyras: posts the ante 150
ipayou: posts small blind 600
MezuuÜuuT: posts big blind 1200
*** HOLE CARDS ***
Hjerterdame1: folds 
ederpalasson: folds 
nacho2390: folds 
ThalleSx: folds 
fournn: folds 
vagoyras: folds 
ipayou: raises 1320 to 2520
MezuuÜuuT: calls 1320
*** FLOP *** [Qh Kd 7c]
ipayou: checks 
MezuuÜuuT: checks 
*** TURN *** [Qh Kd 7c] [9h]
ipayou: bets 1800
MezuuÜuuT: folds 
Uncalled bet (1800) returned to ipayou
ipayou collected 6240 from pot
*** SUMMARY ***
Total pot 6240 | Rake 0 
Board [Qh Kd 7c 9h]
Seat 1: ipayou (small blind) collected (6240)
Seat 2: MezuuÜuuT (big blind) folded on the Turn
Seat 3: Hjerterdame1 folded before Flop (didn't bet)
Seat 4: ederpalasson folded before Flop (didn't bet)
Seat 5: nacho2390 folded before Flop (didn't bet)
Seat 6: ThalleSx folded before Flop (didn't bet)
Seat 7: fournn folded before Flop (didn't bet)
Seat 8: vagoyras (button) folded before Flop (didn't bet)

PokerStars Hand #251205645549: Tournament #3767885527, $40+$10+$5 USD Hold'em No Limit - Level XII (700/1400) - 2024/06/26 19:09:35 UTC [2024/06/26 15:09:35 ET]
Table '3767885527 61' 8-max Seat #1 is the button
Seat 1: ipayou (65220 in chips) 
Seat 2: MezuuÜuuT (10380 in chips) 
Seat 3: Hjerterdame1 (95356 in chips) 
Seat 4: ederpalasson (37498 in chips) 
Seat 5: nacho2390 (3525 in chips) 
Seat 6: ThalleSx (23180 in chips) 
Seat 7: fournn (56135 in chips) 
Seat 8: vagoyras (45599 in chips) 
ipayou: posts the ante 175
MezuuÜuuT: posts the ante 175
Hjerterdame1: posts the ante 175
ederpalasson: posts the ante 175
nacho2390: posts the ante 175
ThalleSx: posts the ante 175
fournn: posts the ante 175
vagoyras: posts the ante 175
MezuuÜuuT: posts small blind 700
Hjerterdame1: posts big blind 1400
*** HOLE CARDS ***
ederpalasson: folds 
nacho2390: folds 
ThalleSx: folds 
fournn: raises 1680 to 3080
vagoyras: folds 
ipayou: folds 
MezuuÜuuT: folds 
Hjerterdame1: folds 
Uncalled bet (1680) returned to fournn
fournn collected 4900 from pot
fournn: doesn't show hand 
*** SUMMARY ***
Total pot 4900 | Rake 0 
Seat 1: ipayou (button) folded before Flop (didn't bet)
Seat 2: MezuuÜuuT (small blind) folded before Flop
Seat 3: Hjerterdame1 (big blind) folded before Flop
Seat 4: ederpalasson folded before Flop (didn't bet)
Seat 5: nacho2390 folded before Flop (didn't bet)
Seat 6: ThalleSx folded before Flop (didn't bet)
Seat 7: fournn collected (4900)
Seat 8: vagoyras folded before Flop (didn't bet)

PokerStars Hand #251205652198: Tournament #3767885527, $40+$10+$5 USD Hold'em No Limit - Level XII (700/1400) - 2024/06/26 19:09:59 UTC [2024/06/26 15:09:59 ET]
Table '3767885527 61' 8-max Seat #2 is the button
Seat 1: ipayou (65045 in chips) 
Seat 2: MezuuÜuuT (9505 in chips) 
Seat 3: Hjerterdame1 (93781 in chips) 
Seat 4: ederpalasson (37323 in chips) 
Seat 5: nacho2390 (3350 in chips) 
Seat 6: ThalleSx (23005 in chips) 
Seat 7: fournn (59460 in chips) 
Seat 8: vagoyras (45424 in chips) 
ipayou: posts the ante 175
MezuuÜuuT: posts the ante 175
Hjerterdame1: posts the ante 175
ederpalasson: posts the ante 175
nacho2390: posts the ante 175
ThalleSx: posts the ante 175
fournn: posts the ante 175
vagoyras: posts the ante 175
Hjerterdame1: posts small blind 700
ederpalasson: posts big blind 1400
*** HOLE CARDS ***
nacho2390: folds 
ThalleSx: folds 
fournn: folds 
vagoyras: folds 
ipayou: folds 
MezuuÜuuT: folds 
Hjerterdame1: raises 2800 to 4200
ederpalasson: raises 6300 to 10500
Hjerterdame1: calls 6300
*** FLOP *** [Jc 2h 9d]
Hjerterdame1: bets 11200
ederpalasson: folds 
Uncalled bet (11200) returned to Hjerterdame1
Hjerterdame1 collected 22400 from pot
Hjerterdame1: doesn't show hand 
*** SUMMARY ***
Total pot 22400 | Rake 0 
Board [Jc 2h 9d]
Seat 1: ipayou folded before Flop (didn't bet)
Seat 2: MezuuÜuuT (button) folded before Flop (didn't bet)
Seat 3: Hjerterdame1 (small blind) collected (22400)
Seat 4: ederpalasson (big blind) folded on the Flop
Seat 5: nacho2390 folded before Flop (didn't bet)
Seat 6: ThalleSx folded before Flop (didn't bet)
Seat 7: fournn folded before Flop (didn't bet)
Seat 8: vagoyras folded before Flop (didn't bet)

PokerStars Hand #251205669543: Tournament #3767885527, $40+$10+$5 USD Hold'em No Limit - Level XII (700/1400) - 2024/06/26 19:11:04 UTC [2024/06/26 15:11:04 ET]
Table '3767885527 61' 8-max Seat #3 is the button
Seat 1: ipayou (64870 in chips) 
Seat 2: MezuuÜuuT (9330 in chips) 
Seat 3: Hjerterdame1 (105506 in chips) 
Seat 4: ederpalasson (26648 in chips) 
Seat 5: nacho2390 (3175 in chips) 
Seat 6: ThalleSx (22830 in chips) 
Seat 7: fournn (59285 in chips) 
Seat 8: vagoyras (45249 in chips) 
ipayou: posts the ante 175
MezuuÜuuT: posts the ante 175
Hjerterdame1: posts the ante 175
ederpalasson: posts the ante 175
nacho2390: posts the ante 175
ThalleSx: posts the ante 175
fournn: posts the ante 175
vagoyras: posts the ante 175
ederpalasson: posts small blind 700
nacho2390: posts big blind 1400
*** HOLE CARDS ***
ThalleSx: folds 
fournn: folds 
vagoyras: folds 
ipayou: folds 
MezuuÜuuT: folds 
Hjerterdame1: folds 
ederpalasson: raises 2800 to 4200
nacho2390: calls 1600 and is all-in
Uncalled bet (1200) returned to ederpalasson
*** FLOP *** [Ks 7h Jh]
*** TURN *** [Ks 7h Jh] [Kh]
*** RIVER *** [Ks 7h Jh Kh] [Ah]
*** SHOW DOWN ***
ederpalasson: shows [As Jc] (two pair, Aces and Kings)
nacho2390: shows [3h 2s] (a flush, Ace high)
nacho2390 collected 7400 from pot
*** SUMMARY ***
Total pot 7400 | Rake 0 
Board [Ks 7h Jh Kh Ah]
Seat 1: ipayou folded before Flop (didn't bet)
Seat 2: MezuuÜuuT folded before Flop (didn't bet)
Seat 3: Hjerterdame1 (button) folded before Flop (didn't bet)
Seat 4: ederpalasson (small blind) showed [As Jc] and lost with two pair, Aces and Kings
Seat 5: nacho2390 (big blind) showed [3h 2s] and won (7400) with a flush, Ace high
Seat 6: ThalleSx folded before Flop (didn't bet)
Seat 7: fournn folded before Flop (didn't bet)
Seat 8: vagoyras folded before Flop (didn't bet)

PokerStars Hand #251205680094: Tournament #3767885527, $40+$10+$5 USD Hold'em No Limit - Level XII (700/1400) - 2024/06/26 19:11:43 UTC [2024/06/26 15:11:43 ET]
Table '3767885527 61' 8-max Seat #4 is the button
Seat 1: ipayou (64695 in chips) 
Seat 2: MezuuÜuuT (9155 in chips) 
Seat 3: Hjerterdame1 (105331 in chips) 
Seat 4: ederpalasson (23473 in chips) 
Seat 5: nacho2390 (7400 in chips) 
Seat 6: ThalleSx (22655 in chips) 
Seat 7: fournn (59110 in chips) 
Seat 8: vagoyras (45074 in chips) 
ipayou: posts the ante 175
MezuuÜuuT: posts the ante 175
Hjerterdame1: posts the ante 175
ederpalasson: posts the ante 175
nacho2390: posts the ante 175
ThalleSx: posts the ante 175
fournn: posts the ante 175
vagoyras: posts the ante 175
nacho2390: posts small blind 700
ThalleSx: posts big blind 1400
*** HOLE CARDS ***
fournn: folds 
vagoyras: folds 
ipayou: folds 
MezuuÜuuT: folds 
Hjerterdame1: folds 
ederpalasson: folds 
nacho2390: raises 5825 to 7225 and is all-in
ThalleSx: calls 5825
*** FLOP *** [Qc 6c Ad]
*** TURN *** [Qc 6c Ad] [6h]
*** RIVER *** [Qc 6c Ad 6h] [9c]
*** SHOW DOWN ***
nacho2390: shows [Kh Qh] (two pair, Queens and Sixes)
ThalleSx: shows [5c Td] (a pair of Sixes)
nacho2390 collected 15850 from pot
*** SUMMARY ***
Total pot 15850 | Rake 0 
Board [Qc 6c Ad 6h 9c]
Seat 1: ipayou folded before Flop (didn't bet)
Seat 2: MezuuÜuuT folded before Flop (didn't bet)
Seat 3: Hjerterdame1 folded before Flop (didn't bet)
Seat 4: ederpalasson (button) folded before Flop (didn't bet)
Seat 5: nacho2390 (small blind) showed [Kh Qh] and won (15850) with two pair, Queens and Sixes
Seat 6: ThalleSx (big blind) showed [5c Td] and lost with a pair of Sixes
Seat 7: fournn folded before Flop (didn't bet)
Seat 8: vagoyras folded before Flop (didn't bet)

PokerStars Hand #251205691552: Tournament #3767885527, $40+$10+$5 USD Hold'em No Limit - Level XII (700/1400) - 2024/06/26 19:12:25 UTC [2024/06/26 15:12:25 ET]
Table '3767885527 61' 8-max Seat #5 is the button
Seat 1: ipayou (64520 in chips) 
Seat 2: MezuuÜuuT (8980 in chips) 
Seat 3: Hjerterdame1 (105156 in chips) 
Seat 4: ederpalasson (23298 in chips) 
Seat 5: nacho2390 (15850 in chips) 
Seat 6: ThalleSx (15255 in chips) 
Seat 7: fournn (58935 in chips) 
Seat 8: vagoyras (44899 in chips) 
ipayou: posts the ante 175
MezuuÜuuT: posts the ante 175
Hjerterdame1: posts the ante 175
ederpalasson: posts the ante 175
nacho2390: posts the ante 175
ThalleSx: posts the ante 175
fournn: posts the ante 175
vagoyras: posts the ante 175
ThalleSx: posts small blind 700
fournn: posts big blind 1400
*** HOLE CARDS ***
vagoyras: raises 1400 to 2800
ipayou: folds 
MezuuÜuuT: folds 
Hjerterdame1: folds 
ederpalasson: folds 
nacho2390: folds 
ThalleSx: raises 12280 to 15080 and is all-in
fournn: raises 43680 to 58760 and is all-in
vagoyras: folds 
Uncalled bet (43680) returned to fournn
*** FLOP *** [5s 3c 9d]
*** TURN *** [5s 3c 9d] [Ah]
*** RIVER *** [5s 3c 9d Ah] [Jd]
*** SHOW DOWN ***
ThalleSx: shows [Kh Ac] (a pair of Aces)
fournn: shows [Qd As] (a pair of Aces - lower kicker)
ThalleSx collected 34360 from pot
*** SUMMARY ***
Total pot 34360 | Rake 0 
Board [5s 3c 9d Ah Jd]
Seat 1: ipayou folded before Flop (didn't bet)
Seat 2: MezuuÜuuT folded before Flop (didn't bet)
Seat 3: Hjerterdame1 folded before Flop (didn't bet)
Seat 4: ederpalasson folded before Flop (didn't bet)
Seat 5: nacho2390 (button) folded before Flop (didn't bet)
Seat 6: ThalleSx (small blind) showed [Kh Ac] and won (34360) with a pair of Aces
Seat 7: fournn (big blind) showed [Qd As] and lost with a pair of Aces
Seat 8: vagoyras folded before Flop

PokerStars Hand #251205706826: Tournament #3767885527, $40+$10+$5 USD Hold'em No Limit - Level XII (700/1400) - 2024/06/26 19:13:21 UTC [2024/06/26 15:13:21 ET]
Table '3767885527 61' 8-max Seat #6 is the button
Seat 1: ipayou (64345 in chips) 
Seat 2: MezuuÜuuT (8805 in chips) 
Seat 3: Hjerterdame1 (104981 in chips) 
Seat 4: ederpalasson (23123 in chips) 
Seat 5: nacho2390 (15675 in chips) 
Seat 6: ThalleSx (34360 in chips) 
Seat 7: fournn (43680 in chips) 
Seat 8: vagoyras (41924 in chips) 
ipayou: posts the ante 175
MezuuÜuuT: posts the ante 175
Hjerterdame1: posts the ante 175
ederpalasson: posts the ante 175
nacho2390: posts the ante 175
ThalleSx: posts the ante 175
fournn: posts the ante 175
vagoyras: posts the ante 175
fournn: posts small blind 700
vagoyras: posts big blind 1400
*** HOLE CARDS ***
ipayou: folds 
MezuuÜuuT: folds 
Hjerterdame1: folds 
ederpalasson: raises 1400 to 2800
nacho2390: folds 
ThalleSx: folds 
fournn: folds 
vagoyras: folds 
Uncalled bet (1400) returned to ederpalasson
ederpalasson collected 4900 from pot
ederpalasson: doesn't show hand 
*** SUMMARY ***
Total pot 4900 | Rake 0 
Seat 1: ipayou folded before Flop (didn't bet)
Seat 2: MezuuÜuuT folded before Flop (didn't bet)
Seat 3: Hjerterdame1 folded before Flop (didn't bet)
Seat 4: ederpalasson collected (4900)
Seat 5: nacho2390 folded before Flop (didn't bet)
Seat 6: ThalleSx (button) folded before Flop (didn't bet)
Seat 7: fournn (small blind) folded before Flop
Seat 8: vagoyras (big blind) folded before Flop

PokerStars Hand #251205714150: Tournament #3767885527, $40+$10+$5 USD Hold'em No Limit - Level XII (700/1400) - 2024/06/26 19:13:49 UTC [2024/06/26 15:13:49 ET]
Table '3767885527 61' 8-max Seat #7 is the button
Seat 2: MezuuÜuuT (8630 in chips) 
Seat 3: Hjerterdame1 (104806 in chips) 
Seat 4: ederpalasson (26448 in chips) 
Seat 5: nacho2390 (15500 in chips) 
Seat 6: ThalleSx (34185 in chips) 
Seat 7: fournn (42805 in chips) 
Seat 8: vagoyras (40349 in chips) 
MezuuÜuuT: posts the ante 175
Hjerterdame1: posts the ante 175
ederpalasson: posts the ante 175
nacho2390: posts the ante 175
ThalleSx: posts the ante 175
fournn: posts the ante 175
vagoyras: posts the ante 175
vagoyras: posts small blind 700
MezuuÜuuT: posts big blind 1400
*** HOLE CARDS ***
Hjerterdame1: folds 
ederpalasson: raises 1400 to 2800
nacho2390: folds 
ThalleSx: folds 
fournn: folds 
vagoyras: folds 
MezuuÜuuT: calls 1400
*** FLOP *** [Qs 2d 5c]
MezuuÜuuT: checks 
ederpalasson: bets 7000
MezuuÜuuT: calls 5655 and is all-in
Uncalled bet (1345) returned to ederpalasson
*** TURN *** [Qs 2d 5c] [9h]
*** RIVER *** [Qs 2d 5c 9h] [2c]
*** SHOW DOWN ***
MezuuÜuuT: shows [5h Ah] (two pair, Fives and Deuces)
ederpalasson: shows [Kc Jc] (a pair of Deuces)
MezuuÜuuT collected 18835 from pot
*** SUMMARY ***
Total pot 18835 | Rake 0 
Board [Qs 2d 5c 9h 2c]
Seat 2: MezuuÜuuT (big blind) showed [5h Ah] and won (18835) with two pair, Fives and Deuces
Seat 3: Hjerterdame1 folded before Flop (didn't bet)
Seat 4: ederpalasson showed [Kc Jc] and lost with a pair of Deuces
Seat 5: nacho2390 folded before Flop (didn't bet)
Seat 6: ThalleSx folded before Flop (didn't bet)
Seat 7: fournn (button) folded before Flop (didn't bet)
Seat 8: vagoyras (small blind) folded before Flop

PokerStars Hand #251205733267: Tournament #3767885527, $40+$10+$5 USD Hold'em No Limit - Level XII (700/1400) - 2024/06/26 19:14:59 UTC [2024/06/26 15:14:59 ET]
Table '3767885527 61' 8-max Seat #8 is the button
Seat 2: MezuuÜuuT (18835 in chips) 
Seat 3: Hjerterdame1 (104631 in chips) 
Seat 4: ederpalasson (17818 in chips) 
Seat 5: nacho2390 (15325 in chips) 
Seat 6: ThalleSx (34010 in chips) 
Seat 7: fournn (42630 in chips) 
Seat 8: vagoyras (39474 in chips) 
MezuuÜuuT: posts the ante 175
Hjerterdame1: posts the ante 175
ederpalasson: posts the ante 175
nacho2390: posts the ante 175
ThalleSx: posts the ante 175
fournn: posts the ante 175
vagoyras: posts the ante 175
MezuuÜuuT: posts small blind 700
Hjerterdame1: posts big blind 1400
*** HOLE CARDS ***
ederpalasson: folds 
nacho2390: folds 
ThalleSx: raises 1400 to 2800
MyOnlyMemory is disconnected 
fournn: folds 
vagoyras: folds 
MezuuÜuuT: folds 
Hjerterdame1: folds 
Uncalled bet (1400) returned to ThalleSx
ThalleSx collected 4725 from pot
ThalleSx: doesn't show hand 
*** SUMMARY ***
Total pot 4725 | Rake 0 
Seat 2: MezuuÜuuT (small blind) folded before Flop
Seat 3: Hjerterdame1 (big blind) folded before Flop
Seat 4: ederpalasson folded before Flop (didn't bet)
Seat 5: nacho2390 folded before Flop (didn't bet)
Seat 6: ThalleSx collected (4725)
Seat 7: fournn folded before Flop (didn't bet)
Seat 8: vagoyras (button) folded before Flop (didn't bet)

PokerStars Hand #251205741477: Tournament #3767885527, $40+$10+$5 USD Hold'em No Limit - Level XII (700/1400) - 2024/06/26 19:15:29 UTC [2024/06/26 15:15:29 ET]
Table '3767885527 61' 8-max Seat #2 is the button
Seat 1: MyOnlyMemory (25000 in chips) 
Seat 2: MezuuÜuuT (17960 in chips) 
Seat 3: Hjerterdame1 (103056 in chips) 
Seat 4: ederpalasson (17643 in chips) 
Seat 5: nacho2390 (15150 in chips) 
Seat 6: ThalleSx (37160 in chips) 
Seat 7: fournn (42455 in chips) 
Seat 8: vagoyras (39299 in chips) 
MyOnlyMemory: posts the ante 175
MezuuÜuuT: posts the ante 175
Hjerterdame1: posts the ante 175
ederpalasson: posts the ante 175
nacho2390: posts the ante 175
ThalleSx: posts the ante 175
fournn: posts the ante 175
vagoyras: posts the ante 175
Hjerterdame1: posts small blind 700
ederpalasson: posts big blind 1400
*** HOLE CARDS ***
nacho2390: folds 
ThalleSx: folds 
fournn: folds 
vagoyras: folds 
MyOnlyMemory: raises 23425 to 24825 and is all-in
MezuuÜuuT: folds 
Hjerterdame1 has timed out
Hjerterdame1: folds 
Hjerterdame1 is sitting out
ederpalasson: folds 
Uncalled bet (23425) returned to MyOnlyMemory
MyOnlyMemory collected 4900 from pot
*** SUMMARY ***
Total pot 4900 | Rake 0 
Seat 1: MyOnlyMemory collected (4900)
Seat 2: MezuuÜuuT (button) folded before Flop (didn't bet)
Seat 3: Hjerterdame1 (small blind) folded before Flop
Seat 4: ederpalasson (big blind) folded before Flop
Seat 5: nacho2390 folded before Flop (didn't bet)
Seat 6: ThalleSx folded before Flop (didn't bet)
Seat 7: fournn folded before Flop (didn't bet)
Seat 8: vagoyras folded before Flop (didn't bet)

PokerStars Hand #251205775063: Tournament #3767885527, $40+$10+$5 USD Hold'em No Limit - Level XII (700/1400) - 2024/06/26 19:17:33 UTC [2024/06/26 15:17:33 ET]
Table '3767885527 61' 8-max Seat #3 is the button
Seat 1: MyOnlyMemory (28325 in chips) 
Seat 2: MezuuÜuuT (17785 in chips) 
Seat 3: Hjerterdame1 (102181 in chips) is sitting out
Seat 4: ederpalasson (16068 in chips) 
Seat 5: nacho2390 (14975 in chips) 
Seat 6: ThalleSx (36985 in chips) 
Seat 7: fournn (42280 in chips) 
Seat 8: vagoyras (39124 in chips) 
MyOnlyMemory: posts the ante 175
MezuuÜuuT: posts the ante 175
Hjerterdame1: posts the ante 175
ederpalasson: posts the ante 175
nacho2390: posts the ante 175
ThalleSx: posts the ante 175
fournn: posts the ante 175
vagoyras: posts the ante 175
ederpalasson: posts small blind 700
nacho2390: posts big blind 1400
*** HOLE CARDS ***
ThalleSx: folds 
fournn: folds 
vagoyras: folds 
MyOnlyMemory: folds 
MezuuÜuuT: raises 16210 to 17610 and is all-in
Hjerterdame1: folds 
ederpalasson: folds 
nacho2390: folds 
Uncalled bet (16210) returned to MezuuÜuuT
MezuuÜuuT collected 4900 from pot
MezuuÜuuT: doesn't show hand 
*** SUMMARY ***
Total pot 4900 | Rake 0 
Seat 1: MyOnlyMemory folded before Flop (didn't bet)
Seat 2: MezuuÜuuT collected (4900)
Seat 3: Hjerterdame1 (button) folded before Flop (didn't bet)
Seat 4: ederpalasson (small blind) folded before Flop
Seat 5: nacho2390 (big blind) folded before Flop
Seat 6: ThalleSx folded before Flop (didn't bet)
Seat 7: fournn folded before Flop (didn't bet)
Seat 8: vagoyras folded before Flop (didn't bet)

PokerStars Hand #251205782758: Tournament #3767885527, $40+$10+$5 USD Hold'em No Limit - Level XII (700/1400) - 2024/06/26 19:18:01 UTC [2024/06/26 15:18:01 ET]
Table '3767885527 61' 8-max Seat #4 is the button
Seat 1: MyOnlyMemory (28150 in chips) 
Seat 2: MezuuÜuuT (21110 in chips) 
Seat 3: Hjerterdame1 (102006 in chips) is sitting out
Seat 4: ederpalasson (15193 in chips) 
Seat 5: nacho2390 (13400 in chips) 
Seat 6: ThalleSx (36810 in chips) 
Seat 7: fournn (42105 in chips) 
Seat 8: vagoyras (38949 in chips) 
MyOnlyMemory: posts the ante 175
MezuuÜuuT: posts the ante 175
Hjerterdame1: posts the ante 175
ederpalasson: posts the ante 175
nacho2390: posts the ante 175
ThalleSx: posts the ante 175
fournn: posts the ante 175
vagoyras: posts the ante 175
nacho2390: posts small blind 700
ThalleSx: posts big blind 1400
*** HOLE CARDS ***
fournn: folds 
vagoyras: folds 
MyOnlyMemory: folds 
MezuuÜuuT: folds 
Hjerterdame1: folds 
ederpalasson: raises 13618 to 15018 and is all-in
nacho2390: folds 
ThalleSx: folds 
Uncalled bet (13618) returned to ederpalasson
ederpalasson collected 4900 from pot
ederpalasson: doesn't show hand 
*** SUMMARY ***
Total pot 4900 | Rake 0 
Seat 1: MyOnlyMemory folded before Flop (didn't bet)
Seat 2: MezuuÜuuT folded before Flop (didn't bet)
Seat 3: Hjerterdame1 folded before Flop (didn't bet)
Seat 4: ederpalasson (button) collected (4900)
Seat 5: nacho2390 (small blind) folded before Flop
Seat 6: ThalleSx (big blind) folded before Flop
Seat 7: fournn folded before Flop (didn't bet)
Seat 8: vagoyras folded before Flop (didn't bet)

PokerStars Hand #251205791259: Tournament #3767885527, $40+$10+$5 USD Hold'em No Limit - Level XII (700/1400) - 2024/06/26 19:18:32 UTC [2024/06/26 15:18:32 ET]
Table '3767885527 61' 8-max Seat #5 is the button
Seat 1: MyOnlyMemory (27975 in chips) 
Seat 2: MezuuÜuuT (20935 in chips) 
Seat 3: Hjerterdame1 (101831 in chips) is sitting out
Seat 4: ederpalasson (18518 in chips) 
Seat 5: nacho2390 (12525 in chips) 
Seat 6: ThalleSx (35235 in chips) 
Seat 7: fournn (41930 in chips) 
Seat 8: vagoyras (38774 in chips) 
MyOnlyMemory: posts the ante 175
MezuuÜuuT: posts the ante 175
Hjerterdame1: posts the ante 175
ederpalasson: posts the ante 175
nacho2390: posts the ante 175
ThalleSx: posts the ante 175
fournn: posts the ante 175
vagoyras: posts the ante 175
ThalleSx: posts small blind 700
fournn: posts big blind 1400
*** HOLE CARDS ***
vagoyras: folds 
Hjerterdame1 has returned
MyOnlyMemory: raises 1400 to 2800
MezuuÜuuT: folds 
Hjerterdame1: calls 2800
ederpalasson: folds 
nacho2390: folds 
ThalleSx: folds 
fournn: calls 1400
*** FLOP *** [Th 2s Ad]
fournn: checks 
MyOnlyMemory: checks 
Hjerterdame1: bets 4200
fournn: folds 
MyOnlyMemory: folds 
Uncalled bet (4200) returned to Hjerterdame1
Hjerterdame1 collected 10500 from pot
Hjerterdame1: doesn't show hand 
*** SUMMARY ***
Total pot 10500 | Rake 0 
Board [Th 2s Ad]
Seat 1: MyOnlyMemory folded on the Flop
Seat 2: MezuuÜuuT folded before Flop (didn't bet)
Seat 3: Hjerterdame1 collected (10500)
Seat 4: ederpalasson folded before Flop (didn't bet)
Seat 5: nacho2390 (button) folded before Flop (didn't bet)
Seat 6: ThalleSx (small blind) folded before Flop
Seat 7: fournn (big blind) folded on the Flop
Seat 8: vagoyras folded before Flop (didn't bet)

PokerStars Hand #251205815348: Tournament #3767885527, $40+$10+$5 USD Hold'em No Limit - Level XIII (800/1600) - 2024/06/26 19:20:00 UTC [2024/06/26 15:20:00 ET]
Table '3767885527 61' 8-max Seat #6 is the button
Seat 1: MyOnlyMemory (25000 in chips) 
Seat 2: MezuuÜuuT (20760 in chips) 
Seat 3: Hjerterdame1 (109356 in chips) 
Seat 4: ederpalasson (18343 in chips) 
Seat 5: nacho2390 (12350 in chips) 
Seat 6: ThalleSx (34360 in chips) 
Seat 7: fournn (38955 in chips) 
Seat 8: vagoyras (38599 in chips) 
MyOnlyMemory: posts the ante 200
MezuuÜuuT: posts the ante 200
Hjerterdame1: posts the ante 200
ederpalasson: posts the ante 200
nacho2390: posts the ante 200
ThalleSx: posts the ante 200
fournn: posts the ante 200
vagoyras: posts the ante 200
fournn: posts small blind 800
vagoyras: posts big blind 1600
*** HOLE CARDS ***
MyOnlyMemory: folds 
MezuuÜuuT: folds 
Hjerterdame1: folds 
ederpalasson: folds 
nacho2390: raises 10550 to 12150 and is all-in
ThalleSx: folds 
fournn: raises 26605 to 38755 and is all-in
vagoyras: folds 
Uncalled bet (26605) returned to fournn
*** FLOP *** [Qs 4c 9d]
*** TURN *** [Qs 4c 9d] [Jd]
*** RIVER *** [Qs 4c 9d Jd] [7c]
*** SHOW DOWN ***
fournn: shows [9s Ad] (a pair of Nines)
nacho2390: shows [Ah Jc] (a pair of Jacks)
nacho2390 collected 27500 from pot
*** SUMMARY ***
Total pot 27500 | Rake 0 
Board [Qs 4c 9d Jd 7c]
Seat 1: MyOnlyMemory folded before Flop (didn't bet)
Seat 2: MezuuÜuuT folded before Flop (didn't bet)
Seat 3: Hjerterdame1 folded before Flop (didn't bet)
Seat 4: ederpalasson folded before Flop (didn't bet)
Seat 5: nacho2390 showed [Ah Jc] and won (27500) with a pair of Jacks
Seat 6: ThalleSx (button) folded before Flop (didn't bet)
Seat 7: fournn (small blind) showed [9s Ad] and lost with a pair of Nines
Seat 8: vagoyras (big blind) folded before Flop

PokerStars Hand #251205827390: Tournament #3767885527, $40+$10+$5 USD Hold'em No Limit - Level XIII (800/1600) - 2024/06/26 19:20:45 UTC [2024/06/26 15:20:45 ET]
Table '3767885527 61' 8-max Seat #7 is the button
Seat 1: MyOnlyMemory (24800 in chips) 
Seat 2: MezuuÜuuT (20560 in chips) 
Seat 3: Hjerterdame1 (109156 in chips) 
Seat 4: ederpalasson (18143 in chips) 
Seat 5: nacho2390 (27500 in chips) 
Seat 6: ThalleSx (34160 in chips) 
Seat 7: fournn (26605 in chips) 
Seat 8: vagoyras (36799 in chips) 
MyOnlyMemory: posts the ante 200
MezuuÜuuT: posts the ante 200
Hjerterdame1: posts the ante 200
ederpalasson: posts the ante 200
nacho2390: posts the ante 200
ThalleSx: posts the ante 200
fournn: posts the ante 200
vagoyras: posts the ante 200
vagoyras: posts small blind 800
MyOnlyMemory: posts big blind 1600
*** HOLE CARDS ***
MezuuÜuuT: folds 
Hjerterdame1: folds 
ederpalasson: folds 
nacho2390: calls 1600
ThalleSx: folds 
fournn: folds 
vagoyras: raises 4000 to 5600
MyOnlyMemory: folds 
nacho2390: folds 
Uncalled bet (4000) returned to vagoyras
vagoyras collected 6400 from pot
vagoyras: doesn't show hand 
*** SUMMARY ***
Total pot 6400 | Rake 0 
Seat 1: MyOnlyMemory (big blind) folded before Flop
Seat 2: MezuuÜuuT folded before Flop (didn't bet)
Seat 3: Hjerterdame1 folded before Flop (didn't bet)
Seat 4: ederpalasson folded before Flop (didn't bet)
Seat 5: nacho2390 folded before Flop
Seat 6: ThalleSx folded before Flop (didn't bet)
Seat 7: fournn (button) folded before Flop (didn't bet)
Seat 8: vagoyras (small blind) collected (6400)

PokerStars Hand #251205846835: Tournament #3767885527, $40+$10+$5 USD Hold'em No Limit - Level XIII (800/1600) - 2024/06/26 19:21:56 UTC [2024/06/26 15:21:56 ET]
Table '3767885527 61' 8-max Seat #8 is the button
Seat 1: MyOnlyMemory (23000 in chips) 
Seat 2: MezuuÜuuT (20360 in chips) 
Seat 3: Hjerterdame1 (108956 in chips) 
Seat 4: ederpalasson (17943 in chips) 
Seat 5: nacho2390 (25700 in chips) 
Seat 6: ThalleSx (33960 in chips) 
Seat 7: fournn (26405 in chips) 
Seat 8: vagoyras (41399 in chips) 
MyOnlyMemory: posts the ante 200
MezuuÜuuT: posts the ante 200
Hjerterdame1: posts the ante 200
ederpalasson: posts the ante 200
nacho2390: posts the ante 200
ThalleSx: posts the ante 200
fournn: posts the ante 200
vagoyras: posts the ante 200
MyOnlyMemory: posts small blind 800
MezuuÜuuT: posts big blind 1600
*** HOLE CARDS ***
Hjerterdame1: raises 1600 to 3200
ederpalasson: folds 
nacho2390: folds 
ThalleSx: folds 
fournn: folds 
vagoyras: folds 
MyOnlyMemory: raises 19600 to 22800 and is all-in
MezuuÜuuT: folds 
Hjerterdame1: folds [Ah]
Uncalled bet (19600) returned to MyOnlyMemory
MyOnlyMemory collected 9600 from pot
*** SUMMARY ***
Total pot 9600 | Rake 0 
Seat 1: MyOnlyMemory (small blind) collected (9600)
Seat 2: MezuuÜuuT (big blind) folded before Flop
Seat 3: Hjerterdame1 folded before Flop
Seat 4: ederpalasson folded before Flop (didn't bet)
Seat 5: nacho2390 folded before Flop (didn't bet)
Seat 6: ThalleSx folded before Flop (didn't bet)
Seat 7: fournn folded before Flop (didn't bet)
Seat 8: vagoyras (button) folded before Flop (didn't bet)

PokerStars Hand #251205858889: Tournament #3767885527, $40+$10+$5 USD Hold'em No Limit - Level XIII (800/1600) - 2024/06/26 19:22:40 UTC [2024/06/26 15:22:40 ET]
Table '3767885527 61' 8-max Seat #1 is the button
Seat 1: MyOnlyMemory (29200 in chips) 
Seat 2: MezuuÜuuT (18560 in chips) 
Seat 3: Hjerterdame1 (105556 in chips) 
Seat 4: ederpalasson (17743 in chips) 
Seat 5: nacho2390 (25500 in chips) 
Seat 6: ThalleSx (33760 in chips) 
Seat 7: fournn (26205 in chips) 
Seat 8: vagoyras (41199 in chips) 
MyOnlyMemory: posts the ante 200
MezuuÜuuT: posts the ante 200
Hjerterdame1: posts the ante 200
ederpalasson: posts the ante 200
nacho2390: posts the ante 200
ThalleSx: posts the ante 200
fournn: posts the ante 200
vagoyras: posts the ante 200
MezuuÜuuT: posts small blind 800
Hjerterdame1: posts big blind 1600
*** HOLE CARDS ***
ederpalasson: raises 1600 to 3200
nacho2390: folds 
ThalleSx: folds 
fournn: folds 
vagoyras: folds 
MyOnlyMemory: folds 
MezuuÜuuT: folds 
Hjerterdame1: folds 
Uncalled bet (1600) returned to ederpalasson
ederpalasson collected 5600 from pot
ederpalasson: doesn't show hand 
*** SUMMARY ***
Total pot 5600 | Rake 0 
Seat 1: MyOnlyMemory (button) folded before Flop (didn't bet)
Seat 2: MezuuÜuuT (small blind) folded before Flop
Seat 3: Hjerterdame1 (big blind) folded before Flop
Seat 4: ederpalasson collected (5600)
Seat 5: nacho2390 folded before Flop (didn't bet)
Seat 6: ThalleSx folded before Flop (didn't bet)
Seat 7: fournn folded before Flop (didn't bet)
Seat 8: vagoyras folded before Flop (didn't bet)

PokerStars Hand #251205863876: Tournament #3767885527, $40+$10+$5 USD Hold'em No Limit - Level XIII (800/1600) - 2024/06/26 19:22:58 UTC [2024/06/26 15:22:58 ET]
Table '3767885527 61' 8-max Seat #2 is the button
Seat 1: MyOnlyMemory (29000 in chips) 
Seat 2: MezuuÜuuT (17560 in chips) 
Seat 3: Hjerterdame1 (103756 in chips) 
Seat 4: ederpalasson (21543 in chips) 
Seat 5: nacho2390 (25300 in chips) 
Seat 6: ThalleSx (33560 in chips) 
Seat 7: fournn (26005 in chips) 
Seat 8: vagoyras (40999 in chips) 
MyOnlyMemory: posts the ante 200
MezuuÜuuT: posts the ante 200
Hjerterdame1: posts the ante 200
ederpalasson: posts the ante 200
nacho2390: posts the ante 200
ThalleSx: posts the ante 200
fournn: posts the ante 200
vagoyras: posts the ante 200
Hjerterdame1: posts small blind 800
ederpalasson: posts big blind 1600
*** HOLE CARDS ***
nacho2390: folds 
ThalleSx: folds 
fournn: folds 
vagoyras: raises 1600 to 3200
MyOnlyMemory: folds 
MezuuÜuuT: folds 
Hjerterdame1: folds 
ederpalasson: calls 1600
*** FLOP *** [Jc 7c 4d]
ederpalasson: checks 
vagoyras: bets 2904
ederpalasson: folds 
Uncalled bet (2904) returned to vagoyras
vagoyras collected 8800 from pot
vagoyras: doesn't show hand 
*** SUMMARY ***
Total pot 8800 | Rake 0 
Board [Jc 7c 4d]
Seat 1: MyOnlyMemory folded before Flop (didn't bet)
Seat 2: MezuuÜuuT (button) folded before Flop (didn't bet)
Seat 3: Hjerterdame1 (small blind) folded before Flop
Seat 4: ederpalasson (big blind) folded on the Flop
Seat 5: nacho2390 folded before Flop (didn't bet)
Seat 6: ThalleSx folded before Flop (didn't bet)
Seat 7: fournn folded before Flop (didn't bet)
Seat 8: vagoyras collected (8800)

PokerStars Hand #251205889213: Tournament #3767885527, $40+$10+$5 USD Hold'em No Limit - Level XIII (800/1600) - 2024/06/26 19:24:31 UTC [2024/06/26 15:24:31 ET]
Table '3767885527 61' 8-max Seat #3 is the button
Seat 1: MyOnlyMemory (28800 in chips) 
Seat 2: MezuuÜuuT (17360 in chips) 
Seat 3: Hjerterdame1 (102756 in chips) 
Seat 4: ederpalasson (18143 in chips) 
Seat 5: nacho2390 (25100 in chips) 
Seat 6: ThalleSx (33360 in chips) 
Seat 7: fournn (25805 in chips) 
Seat 8: vagoyras (46399 in chips) 
MyOnlyMemory: posts the ante 200
MezuuÜuuT: posts the ante 200
Hjerterdame1: posts the ante 200
ederpalasson: posts the ante 200
nacho2390: posts the ante 200
ThalleSx: posts the ante 200
fournn: posts the ante 200
vagoyras: posts the ante 200
ederpalasson: posts small blind 800
nacho2390: posts big blind 1600
*** HOLE CARDS ***
ThalleSx: folds 
fournn: folds 
vagoyras: folds 
MyOnlyMemory: folds 
MezuuÜuuT: raises 15560 to 17160 and is all-in
Hjerterdame1: folds 
ederpalasson: folds 
nacho2390: folds 
Uncalled bet (15560) returned to MezuuÜuuT
MezuuÜuuT collected 5600 from pot
MezuuÜuuT: doesn't show hand 
*** SUMMARY ***
Total pot 5600 | Rake 0 
Seat 1: MyOnlyMemory folded before Flop (didn't bet)
Seat 2: MezuuÜuuT collected (5600)
Seat 3: Hjerterdame1 (button) folded before Flop (didn't bet)
Seat 4: ederpalasson (small blind) folded before Flop
Seat 5: nacho2390 (big blind) folded before Flop
Seat 6: ThalleSx folded before Flop (didn't bet)
Seat 7: fournn folded before Flop (didn't bet)
Seat 8: vagoyras folded before Flop (didn't bet)

PokerStars Hand #251205901575: Tournament #3767885527, $40+$10+$5 USD Hold'em No Limit - Level XIII (800/1600) - 2024/06/26 19:25:15 UTC [2024/06/26 15:25:15 ET]
Table '3767885527 61' 8-max Seat #4 is the button
Seat 1: MyOnlyMemory (28600 in chips) 
Seat 2: MezuuÜuuT (21160 in chips) 
Seat 3: Hjerterdame1 (102556 in chips) 
Seat 4: ederpalasson (17143 in chips) 
Seat 5: nacho2390 (23300 in chips) 
Seat 6: ThalleSx (33160 in chips) 
Seat 7: fournn (25605 in chips) 
Seat 8: vagoyras (46199 in chips) 
MyOnlyMemory: posts the ante 200
MezuuÜuuT: posts the ante 200
Hjerterdame1: posts the ante 200
ederpalasson: posts the ante 200
nacho2390: posts the ante 200
ThalleSx: posts the ante 200
fournn: posts the ante 200
vagoyras: posts the ante 200
nacho2390: posts small blind 800
ThalleSx: posts big blind 1600
*** HOLE CARDS ***
fournn: folds 
vagoyras: folds 
MyOnlyMemory: folds 
MezuuÜuuT: folds 
Hjerterdame1: folds 
ederpalasson: folds 
nacho2390: raises 21500 to 23100 and is all-in
ThalleSx: folds 
Uncalled bet (21500) returned to nacho2390
nacho2390 collected 4800 from pot
nacho2390: doesn't show hand 
*** SUMMARY ***
Total pot 4800 | Rake 0 
Seat 1: MyOnlyMemory folded before Flop (didn't bet)
Seat 2: MezuuÜuuT folded before Flop (didn't bet)
Seat 3: Hjerterdame1 folded before Flop (didn't bet)
Seat 4: ederpalasson (button) folded before Flop (didn't bet)
Seat 5: nacho2390 (small blind) collected (4800)
Seat 6: ThalleSx (big blind) folded before Flop
Seat 7: fournn folded before Flop (didn't bet)
Seat 8: vagoyras folded before Flop (didn't bet)

PokerStars Hand #251205909946: Tournament #3767885527, $40+$10+$5 USD Hold'em No Limit - Level XIII (800/1600) - 2024/06/26 19:25:46 UTC [2024/06/26 15:25:46 ET]
Table '3767885527 61' 8-max Seat #5 is the button
Seat 1: MyOnlyMemory (28400 in chips) 
Seat 2: MezuuÜuuT (20960 in chips) 
Seat 3: Hjerterdame1 (102356 in chips) 
Seat 4: ederpalasson (16943 in chips) 
Seat 5: nacho2390 (26300 in chips) 
Seat 6: ThalleSx (31360 in chips) 
Seat 7: fournn (25405 in chips) 
Seat 8: vagoyras (45999 in chips) 
MyOnlyMemory: posts the ante 200
MezuuÜuuT: posts the ante 200
Hjerterdame1: posts the ante 200
ederpalasson: posts the ante 200
nacho2390: posts the ante 200
ThalleSx: posts the ante 200
fournn: posts the ante 200
vagoyras: posts the ante 200
ThalleSx: posts small blind 800
fournn: posts big blind 1600
*** HOLE CARDS ***
vagoyras: folds 
MyOnlyMemory: folds 
MezuuÜuuT: folds 
Hjerterdame1: folds 
ederpalasson: folds 
nacho2390: raises 24500 to 26100 and is all-in
ThalleSx: folds 
fournn: folds 
Uncalled bet (24500) returned to nacho2390
nacho2390 collected 5600 from pot
nacho2390: doesn't show hand 
*** SUMMARY ***
Total pot 5600 | Rake 0 
Seat 1: MyOnlyMemory folded before Flop (didn't bet)
Seat 2: MezuuÜuuT folded before Flop (didn't bet)
Seat 3: Hjerterdame1 folded before Flop (didn't bet)
Seat 4: ederpalasson folded before Flop (didn't bet)
Seat 5: nacho2390 (button) collected (5600)
Seat 6: ThalleSx (small blind) folded before Flop
Seat 7: fournn (big blind) folded before Flop
Seat 8: vagoyras folded before Flop (didn't bet)

PokerStars Hand #251205922095: Tournament #3767885527, $40+$10+$5 USD Hold'em No Limit - Level XIII (800/1600) - 2024/06/26 19:26:30 UTC [2024/06/26 15:26:30 ET]
Table '3767885527 61' 8-max Seat #6 is the button
Seat 1: MyOnlyMemory (28200 in chips) 
Seat 2: MezuuÜuuT (20760 in chips) 
Seat 3: Hjerterdame1 (102156 in chips) 
Seat 4: ederpalasson (16743 in chips) 
Seat 5: nacho2390 (30100 in chips) 
Seat 6: ThalleSx (30360 in chips) 
Seat 7: fournn (23605 in chips) 
Seat 8: vagoyras (45799 in chips) 
MyOnlyMemory: posts the ante 200
MezuuÜuuT: posts the ante 200
Hjerterdame1: posts the ante 200
ederpalasson: posts the ante 200
nacho2390: posts the ante 200
ThalleSx: posts the ante 200
fournn: posts the ante 200
vagoyras: posts the ante 200
fournn: posts small blind 800
vagoyras: posts big blind 1600
*** HOLE CARDS ***
MyOnlyMemory: folds 
MezuuÜuuT: folds 
Hjerterdame1: raises 1600 to 3200
ederpalasson: folds 
nacho2390: folds 
ThalleSx: folds 
fournn: calls 2400
vagoyras: raises 8800 to 12000
Hjerterdame1: folds 
fournn: folds 
Uncalled bet (8800) returned to vagoyras
vagoyras collected 11200 from pot
vagoyras: doesn't show hand 
*** SUMMARY ***
Total pot 11200 | Rake 0 
Seat 1: MyOnlyMemory folded before Flop (didn't bet)
Seat 2: MezuuÜuuT folded before Flop (didn't bet)
Seat 3: Hjerterdame1 folded before Flop
Seat 4: ederpalasson folded before Flop (didn't bet)
Seat 5: nacho2390 folded before Flop (didn't bet)
Seat 6: ThalleSx (button) folded before Flop (didn't bet)
Seat 7: fournn (small blind) folded before Flop
Seat 8: vagoyras (big blind) collected (11200)

PokerStars Hand #251205934739: Tournament #3767885527, $40+$10+$5 USD Hold'em No Limit - Level XIII (800/1600) - 2024/06/26 19:27:17 UTC [2024/06/26 15:27:17 ET]
Table '3767885527 61' 8-max Seat #7 is the button
Seat 1: MyOnlyMemory (28000 in chips) 
Seat 2: MezuuÜuuT (20560 in chips) 
Seat 3: Hjerterdame1 (98756 in chips) 
Seat 4: ederpalasson (16543 in chips) 
Seat 5: nacho2390 (29900 in chips) 
Seat 6: ThalleSx (30160 in chips) 
Seat 7: fournn (20205 in chips) 
Seat 8: vagoyras (53599 in chips) 
MyOnlyMemory: posts the ante 200
MezuuÜuuT: posts the ante 200
Hjerterdame1: posts the ante 200
ederpalasson: posts the ante 200
nacho2390: posts the ante 200
ThalleSx: posts the ante 200
fournn: posts the ante 200
vagoyras: posts the ante 200
vagoyras: posts small blind 800
MyOnlyMemory: posts big blind 1600
*** HOLE CARDS ***
MezuuÜuuT: folds 
Hjerterdame1: folds 
ederpalasson: raises 14400 to 16000
nacho2390: folds 
ThalleSx: folds 
fournn: raises 4005 to 20005 and is all-in
vagoyras: folds 
MyOnlyMemory: folds 
ederpalasson: calls 343 and is all-in
Uncalled bet (3662) returned to fournn
*** FLOP *** [8s Td 5d]
*** TURN *** [8s Td 5d] [As]
*** RIVER *** [8s Td 5d As] [4d]
*** SHOW DOWN ***
ederpalasson: shows [5s 5c] (three of a kind, Fives)
fournn: shows [Ac Qc] (a pair of Aces)
ederpalasson collected 36686 from pot
*** SUMMARY ***
Total pot 36686 | Rake 0 
Board [8s Td 5d As 4d]
Seat 1: MyOnlyMemory (big blind) folded before Flop
Seat 2: MezuuÜuuT folded before Flop (didn't bet)
Seat 3: Hjerterdame1 folded before Flop (didn't bet)
Seat 4: ederpalasson showed [5s 5c] and won (36686) with three of a kind, Fives
Seat 5: nacho2390 folded before Flop (didn't bet)
Seat 6: ThalleSx folded before Flop (didn't bet)
Seat 7: fournn (button) showed [Ac Qc] and lost with a pair of Aces
Seat 8: vagoyras (small blind) folded before Flop

PokerStars Hand #251205945216: Tournament #3767885527, $40+$10+$5 USD Hold'em No Limit - Level XIII (800/1600) - 2024/06/26 19:27:56 UTC [2024/06/26 15:27:56 ET]
Table '3767885527 61' 8-max Seat #8 is the button
Seat 1: MyOnlyMemory (26200 in chips) 
Seat 2: MezuuÜuuT (20360 in chips) 
Seat 3: Hjerterdame1 (98556 in chips) 
Seat 4: ederpalasson (36686 in chips) 
Seat 5: nacho2390 (29700 in chips) 
Seat 6: ThalleSx (29960 in chips) 
Seat 7: fournn (3662 in chips) 
Seat 8: vagoyras (52599 in chips) 
MyOnlyMemory: posts the ante 200
MezuuÜuuT: posts the ante 200
Hjerterdame1: posts the ante 200
ederpalasson: posts the ante 200
nacho2390: posts the ante 200
ThalleSx: posts the ante 200
fournn: posts the ante 200
vagoyras: posts the ante 200
MyOnlyMemory: posts small blind 800
MezuuÜuuT: posts big blind 1600
*** HOLE CARDS ***
Hjerterdame1: calls 1600
ederpalasson: folds 
nacho2390: folds 
ThalleSx: raises 3200 to 4800
fournn: folds 
vagoyras: folds 
MyOnlyMemory: folds 
MezuuÜuuT: folds 
Hjerterdame1: calls 3200
*** FLOP *** [6h 9c 2s]
Hjerterdame1: checks 
ThalleSx: bets 4160
Hjerterdame1: raises 10960 to 15120
ThalleSx: raises 9840 to 24960 and is all-in
Hjerterdame1: calls 9840
*** TURN *** [6h 9c 2s] [8s]
*** RIVER *** [6h 9c 2s 8s] [7h]
*** SHOW DOWN ***
Hjerterdame1: shows [9d Td] (a straight, Six to Ten)
ThalleSx: shows [Jd Js] (a pair of Jacks)
Hjerterdame1 collected 63520 from pot
ThalleSx finished the tournament
*** SUMMARY ***
Total pot 63520 | Rake 0 
Board [6h 9c 2s 8s 7h]
Seat 1: MyOnlyMemory (small blind) folded before Flop
Seat 2: MezuuÜuuT (big blind) folded before Flop
Seat 3: Hjerterdame1 showed [9d Td] and won (63520) with a straight, Six to Ten
Seat 4: ederpalasson folded before Flop (didn't bet)
Seat 5: nacho2390 folded before Flop (didn't bet)
Seat 6: ThalleSx showed [Jd Js] and lost with a pair of Jacks
Seat 7: fournn folded before Flop (didn't bet)
Seat 8: vagoyras (button) folded before Flop (didn't bet)

PokerStars Hand #251205964100: Tournament #3767885527, $40+$10+$5 USD Hold'em No Limit - Level XIII (800/1600) - 2024/06/26 19:29:07 UTC [2024/06/26 15:29:07 ET]
Table '3767885527 61' 8-max Seat #1 is the button
Seat 1: MyOnlyMemory (25200 in chips) 
Seat 2: MezuuÜuuT (18560 in chips) 
Seat 3: Hjerterdame1 (132116 in chips) 
Seat 4: ederpalasson (36486 in chips) 
Seat 5: nacho2390 (29500 in chips) 
Seat 7: fournn (3462 in chips) 
Seat 8: vagoyras (52399 in chips) 
MyOnlyMemory: posts the ante 200
MezuuÜuuT: posts the ante 200
Hjerterdame1: posts the ante 200
ederpalasson: posts the ante 200
nacho2390: posts the ante 200
fournn: posts the ante 200
vagoyras: posts the ante 200
MezuuÜuuT: posts small blind 800
Hjerterdame1: posts big blind 1600
*** HOLE CARDS ***
ederpalasson: folds 
nacho2390: raises 1600 to 3200
fournn: folds 
vagoyras: folds 
MyOnlyMemory: folds 
MezuuÜuuT: folds 
Hjerterdame1: folds 
Uncalled bet (1600) returned to nacho2390
nacho2390 collected 5400 from pot
nacho2390: doesn't show hand 
*** SUMMARY ***
Total pot 5400 | Rake 0 
Seat 1: MyOnlyMemory (button) folded before Flop (didn't bet)
Seat 2: MezuuÜuuT (small blind) folded before Flop
Seat 3: Hjerterdame1 (big blind) folded before Flop
Seat 4: ederpalasson folded before Flop (didn't bet)
Seat 5: nacho2390 collected (5400)
Seat 7: fournn folded before Flop (didn't bet)
Seat 8: vagoyras folded before Flop (didn't bet)

PokerStars Hand #251205972453: Tournament #3767885527, $40+$10+$5 USD Hold'em No Limit - Level XIV (1000/2000) - 2024/06/26 19:29:37 UTC [2024/06/26 15:29:37 ET]
Table '3767885527 61' 8-max Seat #2 is the button
Seat 1: MyOnlyMemory (25000 in chips) 
Seat 2: MezuuÜuuT (17560 in chips) 
Seat 3: Hjerterdame1 (130316 in chips) 
Seat 4: ederpalasson (36286 in chips) 
Seat 5: nacho2390 (33100 in chips) 
Seat 7: fournn (3262 in chips) 
Seat 8: vagoyras (52199 in chips) 
MyOnlyMemory: posts the ante 250
MezuuÜuuT: posts the ante 250
Hjerterdame1: posts the ante 250
ederpalasson: posts the ante 250
nacho2390: posts the ante 250
fournn: posts the ante 250
vagoyras: posts the ante 250
Hjerterdame1: posts small blind 1000
ederpalasson: posts big blind 2000
*** HOLE CARDS ***
nacho2390: folds 
XARANDROS is disconnected 
fournn: folds 
vagoyras: raises 2000 to 4000
MyOnlyMemory: raises 20750 to 24750 and is all-in
MezuuÜuuT: folds 
Hjerterdame1: folds 
ederpalasson: folds 
vagoyras: folds 
Uncalled bet (20750) returned to MyOnlyMemory
MyOnlyMemory collected 12750 from pot
*** SUMMARY ***
Total pot 12750 | Rake 0 
Seat 1: MyOnlyMemory collected (12750)
Seat 2: MezuuÜuuT (button) folded before Flop (didn't bet)
Seat 3: Hjerterdame1 (small blind) folded before Flop
Seat 4: ederpalasson (big blind) folded before Flop
Seat 5: nacho2390 folded before Flop (didn't bet)
Seat 7: fournn folded before Flop (didn't bet)
Seat 8: vagoyras folded before Flop

PokerStars Hand #251205985005: Tournament #3767885527, $40+$10+$5 USD Hold'em No Limit - Level XIV (1000/2000) - 2024/06/26 19:30:23 UTC [2024/06/26 15:30:23 ET]
Table '3767885527 61' 8-max Seat #3 is the button
Seat 1: MyOnlyMemory (33500 in chips) 
Seat 2: MezuuÜuuT (17310 in chips) 
Seat 3: Hjerterdame1 (129066 in chips) 
Seat 4: ederpalasson (34036 in chips) 
Seat 5: nacho2390 (32850 in chips) 
Seat 6: XARANDROS (25000 in chips) 
Seat 7: fournn (3012 in chips) 
Seat 8: vagoyras (47949 in chips) 
MyOnlyMemory: posts the ante 250
MezuuÜuuT: posts the ante 250
Hjerterdame1: posts the ante 250
ederpalasson: posts the ante 250
nacho2390: posts the ante 250
XARANDROS: posts the ante 250
fournn: posts the ante 250
vagoyras: posts the ante 250
ederpalasson: posts small blind 1000
nacho2390: posts big blind 2000
*** HOLE CARDS ***
XARANDROS: raises 7000 to 9000
fournn: folds 
vagoyras: folds 
MyOnlyMemory: folds 
MezuuÜuuT: folds 
Hjerterdame1: folds 
ederpalasson: folds 
nacho2390: folds 
Uncalled bet (7000) returned to XARANDROS
XARANDROS collected 7000 from pot
*** SUMMARY ***
Total pot 7000 | Rake 0 
Seat 1: MyOnlyMemory folded before Flop (didn't bet)
Seat 2: MezuuÜuuT folded before Flop (didn't bet)
Seat 3: Hjerterdame1 (button) folded before Flop (didn't bet)
Seat 4: ederpalasson (small blind) folded before Flop
Seat 5: nacho2390 (big blind) folded before Flop
Seat 6: XARANDROS collected (7000)
Seat 7: fournn folded before Flop (didn't bet)
Seat 8: vagoyras folded before Flop (didn't bet)

PokerStars Hand #251205996344: Tournament #3767885527, $40+$10+$5 USD Hold'em No Limit - Level XIV (1000/2000) - 2024/06/26 19:31:04 UTC [2024/06/26 15:31:04 ET]
Table '3767885527 61' 8-max Seat #4 is the button
Seat 1: MyOnlyMemory (33250 in chips) 
Seat 2: MezuuÜuuT (17060 in chips) 
Seat 3: Hjerterdame1 (128816 in chips) 
Seat 4: ederpalasson (32786 in chips) 
Seat 5: nacho2390 (30600 in chips) 
Seat 6: XARANDROS (29750 in chips) 
Seat 7: fournn (2762 in chips) 
Seat 8: vagoyras (47699 in chips) 
MyOnlyMemory: posts the ante 250
MezuuÜuuT: posts the ante 250
Hjerterdame1: posts the ante 250
ederpalasson: posts the ante 250
nacho2390: posts the ante 250
XARANDROS: posts the ante 250
fournn: posts the ante 250
vagoyras: posts the ante 250
nacho2390: posts small blind 1000
XARANDROS: posts big blind 2000
*** HOLE CARDS ***
fournn: folds 
vagoyras: folds 
MyOnlyMemory: folds 
MezuuÜuuT: folds 
Hjerterdame1: raises 4000 to 6000
ederpalasson: folds 
nacho2390: folds 
XARANDROS: calls 4000
*** FLOP *** [9h As 3h]
XARANDROS: checks 
Hjerterdame1: bets 6000
XARANDROS: folds 
Uncalled bet (6000) returned to Hjerterdame1
Hjerterdame1 collected 15000 from pot
Hjerterdame1: doesn't show hand 
*** SUMMARY ***
Total pot 15000 | Rake 0 
Board [9h As 3h]
Seat 1: MyOnlyMemory folded before Flop (didn't bet)
Seat 2: MezuuÜuuT folded before Flop (didn't bet)
Seat 3: Hjerterdame1 collected (15000)
Seat 4: ederpalasson (button) folded before Flop (didn't bet)
Seat 5: nacho2390 (small blind) folded before Flop
Seat 6: XARANDROS (big blind) folded on the Flop
Seat 7: fournn folded before Flop (didn't bet)
Seat 8: vagoyras folded before Flop (didn't bet)

PokerStars Hand #251206018648: Tournament #3767885527, $40+$10+$5 USD Hold'em No Limit - Level XIV (1000/2000) - 2024/06/26 19:32:25 UTC [2024/06/26 15:32:25 ET]
Table '3767885527 61' 8-max Seat #5 is the button
Seat 1: MyOnlyMemory (33000 in chips) 
Seat 2: MezuuÜuuT (16810 in chips) 
Seat 3: Hjerterdame1 (137566 in chips) 
Seat 4: ederpalasson (32536 in chips) 
Seat 5: nacho2390 (29350 in chips) 
Seat 6: XARANDROS (23500 in chips) 
Seat 7: fournn (2512 in chips) 
Seat 8: vagoyras (47449 in chips) 
MyOnlyMemory: posts the ante 250
MezuuÜuuT: posts the ante 250
Hjerterdame1: posts the ante 250
ederpalasson: posts the ante 250
nacho2390: posts the ante 250
XARANDROS: posts the ante 250
fournn: posts the ante 250
vagoyras: posts the ante 250
XARANDROS: posts small blind 1000
fournn: posts big blind 2000
*** HOLE CARDS ***
vagoyras: folds 
MyOnlyMemory: raises 2000 to 4000
MezuuÜuuT: folds 
Hjerterdame1: calls 4000
ederpalasson: calls 4000
nacho2390: raises 25100 to 29100 and is all-in
XARANDROS: folds 
fournn: calls 262 and is all-in
MyOnlyMemory: raises 3650 to 32750 and is all-in
Hjerterdame1: folds 
ederpalasson: folds 
Uncalled bet (3650) returned to MyOnlyMemory
*** FLOP *** [Ad 6d 8h]
*** TURN *** [Ad 6d 8h] [3d]
*** RIVER *** [Ad 6d 8h 3d] [3h]
*** SHOW DOWN ***
MyOnlyMemory: shows [5c 5h] (two pair, Fives and Threes)
nacho2390: shows [Ac Jh] (two pair, Aces and Threes)
nacho2390 collected 57152 from side pot
fournn: shows [Qd 4d] (a flush, Ace high)
fournn collected 14310 from main pot
*** SUMMARY ***
Total pot 71462 Main pot 14310. Side pot 57152. | Rake 0 
Board [Ad 6d 8h 3d 3h]
Seat 1: MyOnlyMemory showed [5c 5h] and lost with two pair, Fives and Threes
Seat 2: MezuuÜuuT folded before Flop (didn't bet)
Seat 3: Hjerterdame1 folded before Flop
Seat 4: ederpalasson folded before Flop
Seat 5: nacho2390 (button) showed [Ac Jh] and won (57152) with two pair, Aces and Threes
Seat 6: XARANDROS (small blind) folded before Flop
Seat 7: fournn (big blind) showed [Qd 4d] and won (14310) with a flush, Ace high
Seat 8: vagoyras folded before Flop (didn't bet)

PokerStars Hand #251206037259: Tournament #3767885527, $40+$10+$5 USD Hold'em No Limit - Level XIV (1000/2000) - 2024/06/26 19:33:33 UTC [2024/06/26 15:33:33 ET]
Table '3767885527 61' 8-max Seat #6 is the button
Seat 1: MyOnlyMemory (3650 in chips) 
Seat 2: MezuuÜuuT (16560 in chips) 
Seat 3: Hjerterdame1 (133316 in chips) 
Seat 4: ederpalasson (28286 in chips) 
Seat 5: nacho2390 (57152 in chips) 
Seat 6: XARANDROS (22250 in chips) 
Seat 7: fournn (14310 in chips) 
Seat 8: vagoyras (47199 in chips) 
MyOnlyMemory: posts the ante 250
MezuuÜuuT: posts the ante 250
Hjerterdame1: posts the ante 250
ederpalasson: posts the ante 250
nacho2390: posts the ante 250
XARANDROS: posts the ante 250
fournn: posts the ante 250
vagoyras: posts the ante 250
fournn: posts small blind 1000
vagoyras: posts big blind 2000
*** HOLE CARDS ***
MyOnlyMemory: folds 
MezuuÜuuT: folds 
Hjerterdame1: raises 4000 to 6000
ederpalasson: folds 
nacho2390: folds 
XARANDROS: folds 
fournn: folds 
vagoyras: folds 
Uncalled bet (4000) returned to Hjerterdame1
Hjerterdame1 collected 7000 from pot
Hjerterdame1: doesn't show hand 
*** SUMMARY ***
Total pot 7000 | Rake 0 
Seat 1: MyOnlyMemory folded before Flop (didn't bet)
Seat 2: MezuuÜuuT folded before Flop (didn't bet)
Seat 3: Hjerterdame1 collected (7000)
Seat 4: ederpalasson folded before Flop (didn't bet)
Seat 5: nacho2390 folded before Flop (didn't bet)
Seat 6: XARANDROS (button) folded before Flop (didn't bet)
Seat 7: fournn (small blind) folded before Flop
Seat 8: vagoyras (big blind) folded before Flop

PokerStars Hand #251206052041: Tournament #3767885527, $40+$10+$5 USD Hold'em No Limit - Level XIV (1000/2000) - 2024/06/26 19:34:27 UTC [2024/06/26 15:34:27 ET]
Table '3767885527 61' 8-max Seat #7 is the button
Seat 1: MyOnlyMemory (3400 in chips) 
Seat 2: MezuuÜuuT (16310 in chips) 
Seat 3: Hjerterdame1 (138066 in chips) 
Seat 4: ederpalasson (28036 in chips) 
Seat 5: nacho2390 (56902 in chips) 
Seat 6: XARANDROS (22000 in chips) 
Seat 7: fournn (13060 in chips) 
Seat 8: vagoyras (44949 in chips) 
MyOnlyMemory: posts the ante 250
MezuuÜuuT: posts the ante 250
Hjerterdame1: posts the ante 250
ederpalasson: posts the ante 250
nacho2390: posts the ante 250
XARANDROS: posts the ante 250
fournn: posts the ante 250
vagoyras: posts the ante 250
vagoyras: posts small blind 1000
MyOnlyMemory: posts big blind 2000
*** HOLE CARDS ***
MezuuÜuuT: folds 
Hjerterdame1: folds 
ederpalasson: raises 2000 to 4000
nacho2390: folds 
XARANDROS: folds 
fournn: raises 8810 to 12810 and is all-in
vagoyras: folds 
MyOnlyMemory: calls 1150 and is all-in
ederpalasson: calls 8810
*** FLOP *** [Tc 9s 6c]
*** TURN *** [Tc 9s 6c] [Js]
*** RIVER *** [Tc 9s 6c Js] [9d]
*** SHOW DOWN ***
ederpalasson: shows [Qh As] (a pair of Nines)
fournn: shows [Ac Ts] (two pair, Tens and Nines)
fournn collected 19320 from side pot
MyOnlyMemory: shows [5d 6h] (two pair, Nines and Sixes)
fournn collected 12450 from main pot
MyOnlyMemory is sitting out
MyOnlyMemory finished the tournament
*** SUMMARY ***
Total pot 31770 Main pot 12450. Side pot 19320. | Rake 0 
Board [Tc 9s 6c Js 9d]
Seat 1: MyOnlyMemory (big blind) showed [5d 6h] and lost with two pair, Nines and Sixes
Seat 2: MezuuÜuuT folded before Flop (didn't bet)
Seat 3: Hjerterdame1 folded before Flop (didn't bet)
Seat 4: ederpalasson showed [Qh As] and lost with a pair of Nines
Seat 5: nacho2390 folded before Flop (didn't bet)
Seat 6: XARANDROS folded before Flop (didn't bet)
Seat 7: fournn (button) showed [Ac Ts] and won (31770) with two pair, Tens and Nines
Seat 8: vagoyras (small blind) folded before Flop


PokerStars Hand #251205109405: Tournament #3767885527, $40+$10+$5 USD Hold'em No Limit - Level IX (400/800) - 2024/06/26 18:33:44 UTC [2024/06/26 14:33:44 ET]
Table '3767885527 60' 8-max Seat #3 is the button
Seat 1: BerriSwEEE27 (25193 in chips) 
Seat 2: billisrd350 (27642 in chips) 
Seat 3: Amandaraujo (48387 in chips) 
Seat 4: kuenne71 (91409 in chips) 
Seat 5: Godfather_RJ (7105 in chips) 
Seat 6: Jayda26 (4412 in chips) 
Seat 7: DrawinDead321 (36369 in chips) 
Seat 8: TamTam93AT (81898 in chips) 
BerriSwEEE27: posts the ante 100
billisrd350: posts the ante 100
Amandaraujo: posts the ante 100
kuenne71: posts the ante 100
Godfather_RJ: posts the ante 100
Jayda26: posts the ante 100
DrawinDead321: posts the ante 100
TamTam93AT: posts the ante 100
kuenne71: posts small blind 400
Godfather_RJ: posts big blind 800
*** HOLE CARDS ***
Jayda26: folds 
DrawinDead321: raises 800 to 1600
TamTam93AT: folds 
BerriSwEEE27: folds 
billisrd350: folds 
Amandaraujo: calls 1600
kuenne71: folds 
Godfather_RJ: calls 800
*** FLOP *** [Ah 2h Jh]
Godfather_RJ: checks 
DrawinDead321: bets 3800
Amandaraujo: folds 
Godfather_RJ: folds 
Uncalled bet (3800) returned to DrawinDead321
DrawinDead321 collected 6000 from pot
*** SUMMARY ***
Total pot 6000 | Rake 0 
Board [Ah 2h Jh]
Seat 1: BerriSwEEE27 folded before Flop (didn't bet)
Seat 2: billisrd350 folded before Flop (didn't bet)
Seat 3: Amandaraujo (button) folded on the Flop
Seat 4: kuenne71 (small blind) folded before Flop
Seat 5: Godfather_RJ (big blind) folded on the Flop
Seat 6: Jayda26 folded before Flop (didn't bet)
Seat 7: DrawinDead321 collected (6000)
Seat 8: TamTam93AT folded before Flop (didn't bet)

PokerStars Hand #251205119056: Tournament #3767885527, $40+$10+$5 USD Hold'em No Limit - Level IX (400/800) - 2024/06/26 18:34:22 UTC [2024/06/26 14:34:22 ET]
Table '3767885527 60' 8-max Seat #4 is the button
Seat 1: BerriSwEEE27 (25093 in chips) 
Seat 2: billisrd350 (27542 in chips) 
Seat 3: Amandaraujo (46687 in chips) 
Seat 4: kuenne71 (90909 in chips) 
Seat 5: Godfather_RJ (5405 in chips) 
Seat 6: Jayda26 (4312 in chips) 
Seat 7: DrawinDead321 (40669 in chips) 
Seat 8: TamTam93AT (81798 in chips) 
BerriSwEEE27: posts the ante 100
billisrd350: posts the ante 100
Amandaraujo: posts the ante 100
kuenne71: posts the ante 100
Godfather_RJ: posts the ante 100
Jayda26: posts the ante 100
DrawinDead321: posts the ante 100
TamTam93AT: posts the ante 100
Godfather_RJ: posts small blind 400
Jayda26: posts big blind 800
*** HOLE CARDS ***
DrawinDead321: raises 800 to 1600
TamTam93AT: folds 
BerriSwEEE27: folds 
billisrd350: calls 1600
Amandaraujo: raises 2400 to 4000
kuenne71: folds 
Godfather_RJ: folds 
Jayda26: raises 212 to 4212 and is all-in
DrawinDead321: raises 36357 to 40569 and is all-in
billisrd350: folds 
Amandaraujo: folds 
Uncalled bet (36357) returned to DrawinDead321
*** FLOP *** [Ad Qs 4c]
*** TURN *** [Ad Qs 4c] [7s]
*** RIVER *** [Ad Qs 4c 7s] [8s]
*** SHOW DOWN ***
Jayda26: shows [9h Ac] (a pair of Aces)
DrawinDead321: shows [Kc As] (a pair of Aces - King kicker)
DrawinDead321 collected 15224 from pot
Jayda26 finished the tournament
*** SUMMARY ***
Total pot 15224 | Rake 0 
Board [Ad Qs 4c 7s 8s]
Seat 1: BerriSwEEE27 folded before Flop (didn't bet)
Seat 2: billisrd350 folded before Flop
Seat 3: Amandaraujo folded before Flop
Seat 4: kuenne71 (button) folded before Flop (didn't bet)
Seat 5: Godfather_RJ (small blind) folded before Flop
Seat 6: Jayda26 (big blind) showed [9h Ac] and lost with a pair of Aces
Seat 7: DrawinDead321 showed [Kc As] and won (15224) with a pair of Aces
Seat 8: TamTam93AT folded before Flop (didn't bet)

PokerStars Hand #251205129609: Tournament #3767885527, $40+$10+$5 USD Hold'em No Limit - Level IX (400/800) - 2024/06/26 18:35:03 UTC [2024/06/26 14:35:03 ET]
Table '3767885527 60' 8-max Seat #5 is the button
Seat 1: BerriSwEEE27 (24993 in chips) 
Seat 2: billisrd350 (25842 in chips) 
Seat 3: Amandaraujo (42587 in chips) 
Seat 4: kuenne71 (90809 in chips) 
Seat 5: Godfather_RJ (4905 in chips) 
Seat 7: DrawinDead321 (51581 in chips) 
Seat 8: TamTam93AT (81698 in chips) 
BerriSwEEE27: posts the ante 100
billisrd350: posts the ante 100
Amandaraujo: posts the ante 100
kuenne71: posts the ante 100
Godfather_RJ: posts the ante 100
DrawinDead321: posts the ante 100
TamTam93AT: posts the ante 100
DrawinDead321: posts small blind 400
TamTam93AT: posts big blind 800
*** HOLE CARDS ***
BerriSwEEE27: raises 880 to 1680
billisrd350: folds 
Amandaraujo: raises 1680 to 3360
kuenne71: folds 
Godfather_RJ: folds 
DrawinDead321: folds 
TamTam93AT: folds 
BerriSwEEE27: raises 21533 to 24893 and is all-in
Amandaraujo: folds 
Uncalled bet (21533) returned to BerriSwEEE27
BerriSwEEE27 collected 8620 from pot
*** SUMMARY ***
Total pot 8620 | Rake 0 
Seat 1: BerriSwEEE27 collected (8620)
Seat 2: billisrd350 folded before Flop (didn't bet)
Seat 3: Amandaraujo folded before Flop
Seat 4: kuenne71 folded before Flop (didn't bet)
Seat 5: Godfather_RJ (button) folded before Flop (didn't bet)
Seat 7: DrawinDead321 (small blind) folded before Flop
Seat 8: TamTam93AT (big blind) folded before Flop

PokerStars Hand #251205136323: Tournament #3767885527, $40+$10+$5 USD Hold'em No Limit - Level IX (400/800) - 2024/06/26 18:35:30 UTC [2024/06/26 14:35:30 ET]
Table '3767885527 60' 8-max Seat #7 is the button
Seat 1: BerriSwEEE27 (30153 in chips) 
Seat 2: billisrd350 (25742 in chips) 
Seat 3: Amandaraujo (39127 in chips) 
Seat 4: kuenne71 (90709 in chips) 
Seat 5: Godfather_RJ (4805 in chips) 
Seat 7: DrawinDead321 (51081 in chips) 
Seat 8: TamTam93AT (80798 in chips) 
BerriSwEEE27: posts the ante 100
billisrd350: posts the ante 100
Amandaraujo: posts the ante 100
kuenne71: posts the ante 100
Godfather_RJ: posts the ante 100
DrawinDead321: posts the ante 100
TamTam93AT: posts the ante 100
TamTam93AT: posts small blind 400
BerriSwEEE27: posts big blind 800
*** HOLE CARDS ***
billisrd350: folds 
Amandaraujo: raises 2700 to 3500
kuenne71: folds 
Godfather_RJ: folds 
DrawinDead321: folds 
TamTam93AT: folds 
BerriSwEEE27: folds 
Uncalled bet (2700) returned to Amandaraujo
Amandaraujo collected 2700 from pot
*** SUMMARY ***
Total pot 2700 | Rake 0 
Seat 1: BerriSwEEE27 (big blind) folded before Flop
Seat 2: billisrd350 folded before Flop (didn't bet)
Seat 3: Amandaraujo collected (2700)
Seat 4: kuenne71 folded before Flop (didn't bet)
Seat 5: Godfather_RJ folded before Flop (didn't bet)
Seat 7: DrawinDead321 (button) folded before Flop (didn't bet)
Seat 8: TamTam93AT (small blind) folded before Flop

PokerStars Hand #251205145676: Tournament #3767885527, $40+$10+$5 USD Hold'em No Limit - Level IX (400/800) - 2024/06/26 18:36:06 UTC [2024/06/26 14:36:06 ET]
Table '3767885527 60' 8-max Seat #8 is the button
Seat 1: BerriSwEEE27 (29253 in chips) 
Seat 2: billisrd350 (25642 in chips) 
Seat 3: Amandaraujo (40927 in chips) 
Seat 4: kuenne71 (90609 in chips) 
Seat 5: Godfather_RJ (4705 in chips) 
Seat 7: DrawinDead321 (50981 in chips) 
Seat 8: TamTam93AT (80298 in chips) 
BerriSwEEE27: posts the ante 100
billisrd350: posts the ante 100
Amandaraujo: posts the ante 100
kuenne71: posts the ante 100
Godfather_RJ: posts the ante 100
DrawinDead321: posts the ante 100
TamTam93AT: posts the ante 100
BerriSwEEE27: posts small blind 400
billisrd350: posts big blind 800
*** HOLE CARDS ***
Amandaraujo: raises 800 to 1600
kuenne71: folds 
Godfather_RJ: folds 
DrawinDead321: folds 
TamTam93AT: folds 
BerriSwEEE27: folds 
billisrd350: calls 800
*** FLOP *** [Ac 3s Kd]
billisrd350: checks 
Amandaraujo: bets 2150
billisrd350: calls 2150
*** TURN *** [Ac 3s Kd] [Jh]
billisrd350: checks 
Amandaraujo: bets 3200
billisrd350: calls 3200
*** RIVER *** [Ac 3s Kd Jh] [4h]
billisrd350: checks 
Amandaraujo: bets 7500
billisrd350: calls 7500
*** SHOW DOWN ***
Amandaraujo: shows [Qs 5h] (high card Ace)
billisrd350: shows [7s As] (a pair of Aces)
billisrd350 collected 30000 from pot
*** SUMMARY ***
Total pot 30000 | Rake 0 
Board [Ac 3s Kd Jh 4h]
Seat 1: BerriSwEEE27 (small blind) folded before Flop
Seat 2: billisrd350 (big blind) showed [7s As] and won (30000) with a pair of Aces
Seat 3: Amandaraujo showed [Qs 5h] and lost with high card Ace
Seat 4: kuenne71 folded before Flop (didn't bet)
Seat 5: Godfather_RJ folded before Flop (didn't bet)
Seat 7: DrawinDead321 folded before Flop (didn't bet)
Seat 8: TamTam93AT (button) folded before Flop (didn't bet)

PokerStars Hand #251205163720: Tournament #3767885527, $40+$10+$5 USD Hold'em No Limit - Level IX (400/800) - 2024/06/26 18:37:16 UTC [2024/06/26 14:37:16 ET]
Table '3767885527 60' 8-max Seat #1 is the button
Seat 1: BerriSwEEE27 (28753 in chips) 
Seat 2: billisrd350 (41092 in chips) 
Seat 3: Amandaraujo (26377 in chips) 
Seat 4: kuenne71 (90509 in chips) 
Seat 5: Godfather_RJ (4605 in chips) 
Seat 6: Teddygram902 (25000 in chips) 
Seat 7: DrawinDead321 (50881 in chips) 
Seat 8: TamTam93AT (80198 in chips) 
BerriSwEEE27: posts the ante 100
billisrd350: posts the ante 100
Amandaraujo: posts the ante 100
kuenne71: posts the ante 100
Godfather_RJ: posts the ante 100
Teddygram902: posts the ante 100
DrawinDead321: posts the ante 100
TamTam93AT: posts the ante 100
billisrd350: posts small blind 400
Amandaraujo: posts big blind 800
*** HOLE CARDS ***
kuenne71: folds 
Godfather_RJ: folds 
Teddygram902: folds 
DrawinDead321: folds 
TamTam93AT: folds 
BerriSwEEE27: folds 
billisrd350: calls 400
Amandaraujo: raises 2400 to 3200
billisrd350: raises 37792 to 40992 and is all-in
Amandaraujo: calls 23077 and is all-in
Uncalled bet (14715) returned to billisrd350
*** FLOP *** [Ad 9h 2c]
*** TURN *** [Ad 9h 2c] [Qs]
*** RIVER *** [Ad 9h 2c Qs] [5s]
*** SHOW DOWN ***
billisrd350: shows [6s 6c] (a pair of Sixes)
Amandaraujo: shows [Ts 9d] (a pair of Nines)
Amandaraujo collected 53354 from pot
*** SUMMARY ***
Total pot 53354 | Rake 0 
Board [Ad 9h 2c Qs 5s]
Seat 1: BerriSwEEE27 (button) folded before Flop (didn't bet)
Seat 2: billisrd350 (small blind) showed [6s 6c] and lost with a pair of Sixes
Seat 3: Amandaraujo (big blind) showed [Ts 9d] and won (53354) with a pair of Nines
Seat 4: kuenne71 folded before Flop (didn't bet)
Seat 5: Godfather_RJ folded before Flop (didn't bet)
Seat 6: Teddygram902 folded before Flop (didn't bet)
Seat 7: DrawinDead321 folded before Flop (didn't bet)
Seat 8: TamTam93AT folded before Flop (didn't bet)

PokerStars Hand #251205177588: Tournament #3767885527, $40+$10+$5 USD Hold'em No Limit - Level IX (400/800) - 2024/06/26 18:38:10 UTC [2024/06/26 14:38:10 ET]
Table '3767885527 60' 8-max Seat #2 is the button
Seat 1: BerriSwEEE27 (28653 in chips) 
Seat 2: billisrd350 (14715 in chips) 
Seat 3: Amandaraujo (53354 in chips) 
Seat 4: kuenne71 (90409 in chips) 
Seat 5: Godfather_RJ (4505 in chips) 
Seat 6: Teddygram902 (24900 in chips) 
Seat 7: DrawinDead321 (50781 in chips) 
Seat 8: TamTam93AT (80098 in chips) 
BerriSwEEE27: posts the ante 100
billisrd350: posts the ante 100
Amandaraujo: posts the ante 100
kuenne71: posts the ante 100
Godfather_RJ: posts the ante 100
Teddygram902: posts the ante 100
DrawinDead321: posts the ante 100
TamTam93AT: posts the ante 100
Amandaraujo: posts small blind 400
kuenne71: posts big blind 800
*** HOLE CARDS ***
Godfather_RJ: folds 
Teddygram902: folds 
DrawinDead321: folds 
TamTam93AT: folds 
BerriSwEEE27: raises 880 to 1680
billisrd350: raises 12935 to 14615 and is all-in
Amandaraujo: folds 
kuenne71: folds 
BerriSwEEE27: folds 
Uncalled bet (12935) returned to billisrd350
billisrd350 collected 5360 from pot
billisrd350: doesn't show hand 
*** SUMMARY ***
Total pot 5360 | Rake 0 
Seat 1: BerriSwEEE27 folded before Flop
Seat 2: billisrd350 (button) collected (5360)
Seat 3: Amandaraujo (small blind) folded before Flop
Seat 4: kuenne71 (big blind) folded before Flop
Seat 5: Godfather_RJ folded before Flop (didn't bet)
Seat 6: Teddygram902 folded before Flop (didn't bet)
Seat 7: DrawinDead321 folded before Flop (didn't bet)
Seat 8: TamTam93AT folded before Flop (didn't bet)

PokerStars Hand #251205182901: Tournament #3767885527, $40+$10+$5 USD Hold'em No Limit - Level IX (400/800) - 2024/06/26 18:38:30 UTC [2024/06/26 14:38:30 ET]
Table '3767885527 60' 8-max Seat #3 is the button
Seat 1: BerriSwEEE27 (26873 in chips) 
Seat 2: billisrd350 (18295 in chips) 
Seat 3: Amandaraujo (52854 in chips) 
Seat 4: kuenne71 (89509 in chips) 
Seat 5: Godfather_RJ (4405 in chips) 
Seat 6: Teddygram902 (24800 in chips) 
Seat 7: DrawinDead321 (50681 in chips) 
Seat 8: TamTam93AT (79998 in chips) 
BerriSwEEE27: posts the ante 100
billisrd350: posts the ante 100
Amandaraujo: posts the ante 100
kuenne71: posts the ante 100
Godfather_RJ: posts the ante 100
Teddygram902: posts the ante 100
DrawinDead321: posts the ante 100
TamTam93AT: posts the ante 100
kuenne71: posts small blind 400
Godfather_RJ: posts big blind 800
*** HOLE CARDS ***
Teddygram902: folds 
DrawinDead321: folds 
TamTam93AT: raises 880 to 1680
BerriSwEEE27: folds 
billisrd350: calls 1680
Amandaraujo: calls 1680
kuenne71: calls 1280
Godfather_RJ: calls 880
*** FLOP *** [Jd 5c Qh]
kuenne71: checks 
Godfather_RJ: checks 
TamTam93AT: checks 
billisrd350: checks 
Amandaraujo: checks 
*** TURN *** [Jd 5c Qh] [Ad]
kuenne71: checks 
Godfather_RJ: checks 
TamTam93AT: bets 2300
billisrd350: folds 
Amandaraujo: folds 
kuenne71: folds 
Godfather_RJ: folds 
Uncalled bet (2300) returned to TamTam93AT
TamTam93AT collected 9200 from pot
TamTam93AT: doesn't show hand 
*** SUMMARY ***
Total pot 9200 | Rake 0 
Board [Jd 5c Qh Ad]
Seat 1: BerriSwEEE27 folded before Flop (didn't bet)
Seat 2: billisrd350 folded on the Turn
Seat 3: Amandaraujo (button) folded on the Turn
Seat 4: kuenne71 (small blind) folded on the Turn
Seat 5: Godfather_RJ (big blind) folded on the Turn
Seat 6: Teddygram902 folded before Flop (didn't bet)
Seat 7: DrawinDead321 folded before Flop (didn't bet)
Seat 8: TamTam93AT collected (9200)

PokerStars Hand #251205199305: Tournament #3767885527, $40+$10+$5 USD Hold'em No Limit - Level IX (400/800) - 2024/06/26 18:39:34 UTC [2024/06/26 14:39:34 ET]
Table '3767885527 60' 8-max Seat #4 is the button
Seat 1: BerriSwEEE27 (26773 in chips) 
Seat 2: billisrd350 (16515 in chips) 
Seat 3: Amandaraujo (51074 in chips) 
Seat 4: kuenne71 (87729 in chips) 
Seat 5: Godfather_RJ (2625 in chips) 
Seat 6: Teddygram902 (24700 in chips) 
Seat 7: DrawinDead321 (50581 in chips) 
Seat 8: TamTam93AT (87418 in chips) 
BerriSwEEE27: posts the ante 100
billisrd350: posts the ante 100
Amandaraujo: posts the ante 100
kuenne71: posts the ante 100
Godfather_RJ: posts the ante 100
Teddygram902: posts the ante 100
DrawinDead321: posts the ante 100
TamTam93AT: posts the ante 100
Godfather_RJ: posts small blind 400
Teddygram902: posts big blind 800
*** HOLE CARDS ***
DrawinDead321: folds 
TamTam93AT: raises 960 to 1760
BerriSwEEE27: folds 
billisrd350: folds 
Amandaraujo: calls 1760
kuenne71: folds 
Godfather_RJ: folds 
Teddygram902: folds 
*** FLOP *** [Qh Jd 7h]
DrawinDead321 is disconnected 
DrawinDead321 is disconnected 
TamTam93AT: bets 3864
Amandaraujo: calls 3864
*** TURN *** [Qh Jd 7h] [5h]
TamTam93AT: checks 
Amandaraujo: checks 
*** RIVER *** [Qh Jd 7h 5h] [7d]
TamTam93AT: bets 9274
Amandaraujo: calls 9274
*** SHOW DOWN ***
TamTam93AT: shows [Ad Ac] (two pair, Aces and Sevens)
Amandaraujo: mucks hand 
TamTam93AT collected 31796 from pot
*** SUMMARY ***
Total pot 31796 | Rake 0 
Board [Qh Jd 7h 5h 7d]
Seat 1: BerriSwEEE27 folded before Flop (didn't bet)
Seat 2: billisrd350 folded before Flop (didn't bet)
Seat 3: Amandaraujo mucked
Seat 4: kuenne71 (button) folded before Flop (didn't bet)
Seat 5: Godfather_RJ (small blind) folded before Flop
Seat 6: Teddygram902 (big blind) folded before Flop
Seat 7: DrawinDead321 folded before Flop (didn't bet)
Seat 8: TamTam93AT showed [Ad Ac] and won (31796) with two pair, Aces and Sevens

PokerStars Hand #251205215342: Tournament #3767885527, $40+$10+$5 USD Hold'em No Limit - Level IX (400/800) - 2024/06/26 18:40:35 UTC [2024/06/26 14:40:35 ET]
Table '3767885527 60' 8-max Seat #5 is the button
Seat 1: BerriSwEEE27 (26673 in chips) 
Seat 2: billisrd350 (16415 in chips) 
Seat 3: Amandaraujo (36076 in chips) 
Seat 4: kuenne71 (87629 in chips) 
Seat 5: Godfather_RJ (2125 in chips) 
Seat 6: Teddygram902 (23800 in chips) 
Seat 7: DrawinDead321 (50481 in chips) 
Seat 8: TamTam93AT (104216 in chips) 
BerriSwEEE27: posts the ante 100
billisrd350: posts the ante 100
Amandaraujo: posts the ante 100
kuenne71: posts the ante 100
Godfather_RJ: posts the ante 100
Teddygram902: posts the ante 100
DrawinDead321: posts the ante 100
TamTam93AT: posts the ante 100
Teddygram902: posts small blind 400
DrawinDead321: posts big blind 800
*** HOLE CARDS ***
TamTam93AT: folds 
BerriSwEEE27: raises 880 to 1680
billisrd350: folds 
Amandaraujo: folds 
kuenne71: folds 
Godfather_RJ: folds 
Teddygram902: folds 
DrawinDead321: calls 880
*** FLOP *** [Tc 2c 6h]
DrawinDead321: checks 
BerriSwEEE27: bets 1144
DrawinDead321: calls 1144
*** TURN *** [Tc 2c 6h] [5d]
DrawinDead321: checks 
BerriSwEEE27: bets 5200
DrawinDead321: calls 5200
*** RIVER *** [Tc 2c 6h 5d] [Ad]
DrawinDead321: checks 
BerriSwEEE27: bets 18549 and is all-in
DrawinDead321: folds 
Uncalled bet (18549) returned to BerriSwEEE27
BerriSwEEE27 collected 17248 from pot
*** SUMMARY ***
Total pot 17248 | Rake 0 
Board [Tc 2c 6h 5d Ad]
Seat 1: BerriSwEEE27 collected (17248)
Seat 2: billisrd350 folded before Flop (didn't bet)
Seat 3: Amandaraujo folded before Flop (didn't bet)
Seat 4: kuenne71 folded before Flop (didn't bet)
Seat 5: Godfather_RJ (button) folded before Flop (didn't bet)
Seat 6: Teddygram902 (small blind) folded before Flop
Seat 7: DrawinDead321 (big blind) folded on the River
Seat 8: TamTam93AT folded before Flop (didn't bet)

PokerStars Hand #251205233752: Tournament #3767885527, $40+$10+$5 USD Hold'em No Limit - Level IX (400/800) - 2024/06/26 18:41:46 UTC [2024/06/26 14:41:46 ET]
Table '3767885527 60' 8-max Seat #6 is the button
Seat 1: BerriSwEEE27 (35797 in chips) 
Seat 2: billisrd350 (16315 in chips) 
Seat 3: Amandaraujo (35976 in chips) 
Seat 4: kuenne71 (87529 in chips) 
Seat 5: Godfather_RJ (2025 in chips) 
Seat 6: Teddygram902 (23300 in chips) 
Seat 7: DrawinDead321 (42357 in chips) 
Seat 8: TamTam93AT (104116 in chips) 
BerriSwEEE27: posts the ante 100
billisrd350: posts the ante 100
Amandaraujo: posts the ante 100
kuenne71: posts the ante 100
Godfather_RJ: posts the ante 100
Teddygram902: posts the ante 100
DrawinDead321: posts the ante 100
TamTam93AT: posts the ante 100
DrawinDead321: posts small blind 400
TamTam93AT: posts big blind 800
*** HOLE CARDS ***
BerriSwEEE27: raises 880 to 1680
billisrd350: folds 
Amandaraujo: calls 1680
kuenne71: calls 1680
Godfather_RJ: folds 
Teddygram902: raises 21520 to 23200 and is all-in
DrawinDead321: folds 
TamTam93AT: folds 
BerriSwEEE27: raises 12497 to 35697 and is all-in
Amandaraujo: folds 
kuenne71: folds 
Uncalled bet (12497) returned to BerriSwEEE27
*** FLOP *** [2d 6h As]
*** TURN *** [2d 6h As] [7d]
*** RIVER *** [2d 6h As 7d] [5c]
*** SHOW DOWN ***
BerriSwEEE27: shows [Ks Ad] (a pair of Aces)
Teddygram902: shows [Qs Ah] (a pair of Aces - lower kicker)
BerriSwEEE27 collected 51760 from pot
Teddygram902 finished the tournament
*** SUMMARY ***
Total pot 51760 | Rake 0 
Board [2d 6h As 7d 5c]
Seat 1: BerriSwEEE27 showed [Ks Ad] and won (51760) with a pair of Aces
Seat 2: billisrd350 folded before Flop (didn't bet)
Seat 3: Amandaraujo folded before Flop
Seat 4: kuenne71 folded before Flop
Seat 5: Godfather_RJ folded before Flop (didn't bet)
Seat 6: Teddygram902 (button) showed [Qs Ah] and lost with a pair of Aces
Seat 7: DrawinDead321 (small blind) folded before Flop
Seat 8: TamTam93AT (big blind) folded before Flop


PokerStars Hand #251205110414: Tournament #3767885527, $40+$10+$5 USD Hold'em No Limit - Level IX (400/800) - 2024/06/26 18:33:48 UTC [2024/06/26 14:33:48 ET]
Table '3767885527 59' 8-max Seat #7 is the button
Seat 1: vitor762 (22998 in chips) 
Seat 2: mikilool (24820 in chips) 
Seat 3: DaDumon (44609 in chips) 
Seat 4: Pkrscott1992 (70539 in chips) 
Seat 5: SkemGeeMan (25405 in chips) 
Seat 6: JACKPOT786 (30981 in chips) 
Seat 7: sandarobert1 (105968 in chips) 
Seat 8: thrasher71 (44724 in chips) 
vitor762: posts the ante 100
mikilool: posts the ante 100
DaDumon: posts the ante 100
Pkrscott1992: posts the ante 100
SkemGeeMan: posts the ante 100
JACKPOT786: posts the ante 100
sandarobert1: posts the ante 100
thrasher71: posts the ante 100
thrasher71: posts small blind 400
vitor762: posts big blind 800
*** HOLE CARDS ***
mikilool: folds 
DaDumon: folds 
Pkrscott1992: raises 800 to 1600
SkemGeeMan: folds 
JACKPOT786: folds 
sandarobert1: calls 1600
thrasher71: calls 1200
vitor762: calls 800
*** FLOP *** [8c Qh 5h]
thrasher71: checks 
vitor762: checks 
Pkrscott1992: checks 
sandarobert1: checks 
*** TURN *** [8c Qh 5h] [9c]
thrasher71: checks 
vitor762: checks 
Pkrscott1992: checks 
sandarobert1: bets 2520
thrasher71: raises 6280 to 8800
vitor762: folds 
Pkrscott1992: folds 
sandarobert1: folds 
Uncalled bet (6280) returned to thrasher71
thrasher71 collected 12240 from pot
thrasher71: doesn't show hand 
*** SUMMARY ***
Total pot 12240 | Rake 0 
Board [8c Qh 5h 9c]
Seat 1: vitor762 (big blind) folded on the Turn
Seat 2: mikilool folded before Flop (didn't bet)
Seat 3: DaDumon folded before Flop (didn't bet)
Seat 4: Pkrscott1992 folded on the Turn
Seat 5: SkemGeeMan folded before Flop (didn't bet)
Seat 6: JACKPOT786 folded before Flop (didn't bet)
Seat 7: sandarobert1 (button) folded on the Turn
Seat 8: thrasher71 (small blind) collected (12240)

PokerStars Hand #251205156405: Tournament #3767885527, $40+$10+$5 USD Hold'em No Limit - Level IX (400/800) - 2024/06/26 18:36:48 UTC [2024/06/26 14:36:48 ET]
Table '3767885527 59' 8-max Seat #8 is the button
Seat 1: vitor762 (21298 in chips) 
Seat 2: mikilool (24720 in chips) 
Seat 3: DaDumon (44509 in chips) 
Seat 4: Pkrscott1992 (68839 in chips) 
Seat 5: SkemGeeMan (25305 in chips) 
Seat 6: JACKPOT786 (30881 in chips) 
Seat 7: sandarobert1 (101748 in chips) 
Seat 8: thrasher71 (52744 in chips) 
vitor762: posts the ante 100
mikilool: posts the ante 100
DaDumon: posts the ante 100
Pkrscott1992: posts the ante 100
SkemGeeMan: posts the ante 100
JACKPOT786: posts the ante 100
sandarobert1: posts the ante 100
thrasher71: posts the ante 100
vitor762: posts small blind 400
mikilool: posts big blind 800
*** HOLE CARDS ***
DaDumon: folds 
Pkrscott1992: folds 
SkemGeeMan: folds 
JACKPOT786 has timed out
JACKPOT786: folds 
JACKPOT786 is sitting out
sandarobert1: folds 
JACKPOT786 has returned
thrasher71 has timed out
thrasher71: folds 
thrasher71 is sitting out
thrasher71 has returned
vitor762: calls 400
mikilool: raises 2000 to 2800
vitor762: folds 
Uncalled bet (2000) returned to mikilool
mikilool collected 2400 from pot
mikilool: doesn't show hand 
*** SUMMARY ***
Total pot 2400 | Rake 0 
Seat 1: vitor762 (small blind) folded before Flop
Seat 2: mikilool (big blind) collected (2400)
Seat 3: DaDumon folded before Flop (didn't bet)
Seat 4: Pkrscott1992 folded before Flop (didn't bet)
Seat 5: SkemGeeMan folded before Flop (didn't bet)
Seat 6: JACKPOT786 folded before Flop (didn't bet)
Seat 7: sandarobert1 folded before Flop (didn't bet)
Seat 8: thrasher71 (button) folded before Flop (didn't bet)

PokerStars Hand #251205181794: Tournament #3767885527, $40+$10+$5 USD Hold'em No Limit - Level IX (400/800) - 2024/06/26 18:38:26 UTC [2024/06/26 14:38:26 ET]
Table '3767885527 59' 8-max Seat #1 is the button
Seat 1: vitor762 (20398 in chips) 
Seat 2: mikilool (26220 in chips) 
Seat 3: DaDumon (44409 in chips) 
Seat 4: Pkrscott1992 (68739 in chips) 
Seat 5: SkemGeeMan (25205 in chips) 
Seat 6: JACKPOT786 (30781 in chips) 
Seat 7: sandarobert1 (101648 in chips) 
Seat 8: thrasher71 (52644 in chips) 
vitor762: posts the ante 100
mikilool: posts the ante 100
DaDumon: posts the ante 100
Pkrscott1992: posts the ante 100
SkemGeeMan: posts the ante 100
JACKPOT786: posts the ante 100
sandarobert1: posts the ante 100
thrasher71: posts the ante 100
mikilool: posts small blind 400
DaDumon: posts big blind 800
*** HOLE CARDS ***
Pkrscott1992: folds 
SkemGeeMan: folds 
JACKPOT786: folds 
sandarobert1: folds 
thrasher71: raises 800 to 1600
vitor762: folds 
mikilool: folds 
DaDumon: calls 800
*** FLOP *** [6c Kh 7h]
DaDumon: checks 
thrasher71: checks 
*** TURN *** [6c Kh 7h] [8c]
DaDumon: checks 
thrasher71: bets 1320
DaDumon: calls 1320
*** RIVER *** [6c Kh 7h 8c] [6s]
DaDumon: checks 
thrasher71: bets 5280
DaDumon: folds 
Uncalled bet (5280) returned to thrasher71
thrasher71 collected 7040 from pot
thrasher71: doesn't show hand 
*** SUMMARY ***
Total pot 7040 | Rake 0 
Board [6c Kh 7h 8c 6s]
Seat 1: vitor762 (button) folded before Flop (didn't bet)
Seat 2: mikilool (small blind) folded before Flop
Seat 3: DaDumon (big blind) folded on the River
Seat 4: Pkrscott1992 folded before Flop (didn't bet)
Seat 5: SkemGeeMan folded before Flop (didn't bet)
Seat 6: JACKPOT786 folded before Flop (didn't bet)
Seat 7: sandarobert1 folded before Flop (didn't bet)
Seat 8: thrasher71 collected (7040)

PokerStars Hand #251205208539: Tournament #3767885527, $40+$10+$5 USD Hold'em No Limit - Level IX (400/800) - 2024/06/26 18:40:09 UTC [2024/06/26 14:40:09 ET]
Table '3767885527 59' 8-max Seat #2 is the button
Seat 1: vitor762 (20298 in chips) 
Seat 2: mikilool (25720 in chips) 
Seat 3: DaDumon (41389 in chips) 
Seat 4: Pkrscott1992 (68639 in chips) 
Seat 5: SkemGeeMan (25105 in chips) 
Seat 6: JACKPOT786 (30681 in chips) 
Seat 7: sandarobert1 (101548 in chips) 
Seat 8: thrasher71 (56664 in chips) 
vitor762: posts the ante 100
mikilool: posts the ante 100
DaDumon: posts the ante 100
Pkrscott1992: posts the ante 100
SkemGeeMan: posts the ante 100
JACKPOT786: posts the ante 100
sandarobert1: posts the ante 100
thrasher71: posts the ante 100
DaDumon: posts small blind 400
Pkrscott1992: posts big blind 800
*** HOLE CARDS ***
SkemGeeMan: folds 
JACKPOT786: folds 
sandarobert1: raises 960 to 1760
thrasher71 has timed out
thrasher71: folds 
thrasher71 is sitting out
thrasher71 has returned
vitor762: raises 2640 to 4400
mikilool: folds 
DaDumon: folds 
Pkrscott1992: folds 
sandarobert1: calls 2640
*** FLOP *** [Qs Ks Kc]
sandarobert1: checks 
vitor762: bets 3200
sandarobert1: calls 3200
*** TURN *** [Qs Ks Kc] [9h]
sandarobert1: checks 
vitor762: checks 
*** RIVER *** [Qs Ks Kc 9h] [Td]
sandarobert1: bets 13416
vitor762: folds 
Uncalled bet (13416) returned to sandarobert1
sandarobert1 collected 17200 from pot
*** SUMMARY ***
Total pot 17200 | Rake 0 
Board [Qs Ks Kc 9h Td]
Seat 1: vitor762 folded on the River
Seat 2: mikilool (button) folded before Flop (didn't bet)
Seat 3: DaDumon (small blind) folded before Flop
Seat 4: Pkrscott1992 (big blind) folded before Flop
Seat 5: SkemGeeMan folded before Flop (didn't bet)
Seat 6: JACKPOT786 folded before Flop (didn't bet)
Seat 7: sandarobert1 collected (17200)
Seat 8: thrasher71 folded before Flop (didn't bet)

PokerStars Hand #251205246561: Tournament #3767885527, $40+$10+$5 USD Hold'em No Limit - Level X (500/1000) - 2024/06/26 18:42:35 UTC [2024/06/26 14:42:35 ET]
Table '3767885527 59' 8-max Seat #3 is the button
Seat 1: vitor762 (12598 in chips) 
Seat 2: mikilool (25620 in chips) 
Seat 3: DaDumon (40889 in chips) 
Seat 4: Pkrscott1992 (67739 in chips) 
Seat 5: SkemGeeMan (25005 in chips) 
Seat 6: JACKPOT786 (30581 in chips) 
Seat 7: sandarobert1 (111048 in chips) 
Seat 8: thrasher71 (56564 in chips) 
vitor762: posts the ante 125
mikilool: posts the ante 125
DaDumon: posts the ante 125
Pkrscott1992: posts the ante 125
SkemGeeMan: posts the ante 125
JACKPOT786: posts the ante 125
sandarobert1: posts the ante 125
thrasher71: posts the ante 125
Pkrscott1992: posts small blind 500
SkemGeeMan: posts big blind 1000
*** HOLE CARDS ***
JACKPOT786: folds 
sandarobert1: folds 
thrasher71: folds 
vitor762: folds 
mikilool: folds 
DaDumon: raises 1000 to 2000
Pkrscott1992: folds 
SkemGeeMan: calls 1000
*** FLOP *** [6h 8d Qd]
SkemGeeMan: checks 
DaDumon: bets 3020
SkemGeeMan: folds 
Uncalled bet (3020) returned to DaDumon
DaDumon collected 5500 from pot
DaDumon: doesn't show hand 
*** SUMMARY ***
Total pot 5500 | Rake 0 
Board [6h 8d Qd]
Seat 1: vitor762 folded before Flop (didn't bet)
Seat 2: mikilool folded before Flop (didn't bet)
Seat 3: DaDumon (button) collected (5500)
Seat 4: Pkrscott1992 (small blind) folded before Flop
Seat 5: SkemGeeMan (big blind) folded on the Flop
Seat 6: JACKPOT786 folded before Flop (didn't bet)
Seat 7: sandarobert1 folded before Flop (didn't bet)
Seat 8: thrasher71 folded before Flop (didn't bet)

PokerStars Hand #251205272142: Tournament #3767885527, $40+$10+$5 USD Hold'em No Limit - Level X (500/1000) - 2024/06/26 18:44:13 UTC [2024/06/26 14:44:13 ET]
Table '3767885527 59' 8-max Seat #4 is the button
Seat 1: vitor762 (12473 in chips) 
Seat 2: mikilool (25495 in chips) 
Seat 3: DaDumon (44264 in chips) 
Seat 4: Pkrscott1992 (67114 in chips) 
Seat 5: SkemGeeMan (22880 in chips) 
Seat 6: JACKPOT786 (30456 in chips) 
Seat 7: sandarobert1 (110923 in chips) 
Seat 8: thrasher71 (56439 in chips) 
vitor762: posts the ante 125
mikilool: posts the ante 125
DaDumon: posts the ante 125
Pkrscott1992: posts the ante 125
SkemGeeMan: posts the ante 125
JACKPOT786: posts the ante 125
sandarobert1: posts the ante 125
thrasher71: posts the ante 125
SkemGeeMan: posts small blind 500
JACKPOT786: posts big blind 1000
*** HOLE CARDS ***
sandarobert1: raises 1200 to 2200
thrasher71: folds 
vitor762: folds 
mikilool: folds 
DaDumon: folds 
Pkrscott1992: calls 2200
SkemGeeMan: folds 
JACKPOT786: calls 1200
*** FLOP *** [5s Qh 8c]
JACKPOT786: checks 
sandarobert1: bets 2835
Pkrscott1992: calls 2835
JACKPOT786: calls 2835
*** TURN *** [5s Qh 8c] [2s]
JACKPOT786: checks 
sandarobert1: checks 
Pkrscott1992: bets 9000
JACKPOT786: folds 
sandarobert1: folds 
Uncalled bet (9000) returned to Pkrscott1992
Pkrscott1992 collected 16605 from pot
Pkrscott1992: doesn't show hand 
*** SUMMARY ***
Total pot 16605 | Rake 0 
Board [5s Qh 8c 2s]
Seat 1: vitor762 folded before Flop (didn't bet)
Seat 2: mikilool folded before Flop (didn't bet)
Seat 3: DaDumon folded before Flop (didn't bet)
Seat 4: Pkrscott1992 (button) collected (16605)
Seat 5: SkemGeeMan (small blind) folded before Flop
Seat 6: JACKPOT786 (big blind) folded on the Turn
Seat 7: sandarobert1 folded on the Turn
Seat 8: thrasher71 folded before Flop (didn't bet)

PokerStars Hand #251205290523: Tournament #3767885527, $40+$10+$5 USD Hold'em No Limit - Level X (500/1000) - 2024/06/26 18:45:22 UTC [2024/06/26 14:45:22 ET]
Table '3767885527 59' 8-max Seat #5 is the button
Seat 1: vitor762 (12348 in chips) 
Seat 2: mikilool (25370 in chips) 
Seat 3: DaDumon (44139 in chips) 
Seat 4: Pkrscott1992 (78559 in chips) 
Seat 5: SkemGeeMan (22255 in chips) 
Seat 6: JACKPOT786 (25296 in chips) 
Seat 7: sandarobert1 (105763 in chips) 
Seat 8: thrasher71 (56314 in chips) 
vitor762: posts the ante 125
mikilool: posts the ante 125
DaDumon: posts the ante 125
Pkrscott1992: posts the ante 125
SkemGeeMan: posts the ante 125
JACKPOT786: posts the ante 125
sandarobert1: posts the ante 125
thrasher71: posts the ante 125
JACKPOT786: posts small blind 500
sandarobert1: posts big blind 1000
*** HOLE CARDS ***
thrasher71: folds 
vitor762: folds 
mikilool: folds 
DaDumon: folds 
Pkrscott1992: raises 1000 to 2000
SkemGeeMan: folds 
JACKPOT786: folds 
sandarobert1: calls 1000
*** FLOP *** [2h 9c Qs]
sandarobert1: checks 
Pkrscott1992: bets 2000
sandarobert1: calls 2000
*** TURN *** [2h 9c Qs] [Ah]
sandarobert1: checks 
Pkrscott1992: bets 5000
sandarobert1: folds 
Uncalled bet (5000) returned to Pkrscott1992
Pkrscott1992 collected 9500 from pot
Pkrscott1992: doesn't show hand 
*** SUMMARY ***
Total pot 9500 | Rake 0 
Board [2h 9c Qs Ah]
Seat 1: vitor762 folded before Flop (didn't bet)
Seat 2: mikilool folded before Flop (didn't bet)
Seat 3: DaDumon folded before Flop (didn't bet)
Seat 4: Pkrscott1992 collected (9500)
Seat 5: SkemGeeMan (button) folded before Flop (didn't bet)
Seat 6: JACKPOT786 (small blind) folded before Flop
Seat 7: sandarobert1 (big blind) folded on the Turn
Seat 8: thrasher71 folded before Flop (didn't bet)

PokerStars Hand #251205306333: Tournament #3767885527, $40+$10+$5 USD Hold'em No Limit - Level X (500/1000) - 2024/06/26 18:46:21 UTC [2024/06/26 14:46:21 ET]
Table '3767885527 59' 8-max Seat #6 is the button
Seat 1: vitor762 (12223 in chips) 
Seat 2: mikilool (25245 in chips) 
Seat 3: DaDumon (44014 in chips) 
Seat 5: SkemGeeMan (22130 in chips) 
Seat 6: JACKPOT786 (24671 in chips) 
Seat 7: sandarobert1 (101638 in chips) 
Seat 8: thrasher71 (56189 in chips) 
vitor762: posts the ante 125
mikilool: posts the ante 125
DaDumon: posts the ante 125
SkemGeeMan: posts the ante 125
JACKPOT786: posts the ante 125
sandarobert1: posts the ante 125
thrasher71: posts the ante 125
sandarobert1: posts small blind 500
thrasher71: posts big blind 1000
*** HOLE CARDS ***
vitor762: raises 1000 to 2000
mikilool: folds 
DaDumon: folds 
SkemGeeMan: raises 20005 to 22005 and is all-in
JACKPOT786: folds 
sandarobert1: folds 
Brauliocsp is disconnected 
thrasher71 has timed out
thrasher71: folds 
thrasher71 is sitting out
thrasher71 has returned
vitor762: folds 
Uncalled bet (20005) returned to SkemGeeMan
SkemGeeMan collected 6375 from pot
SkemGeeMan: doesn't show hand 
*** SUMMARY ***
Total pot 6375 | Rake 0 
Seat 1: vitor762 folded before Flop
Seat 2: mikilool folded before Flop (didn't bet)
Seat 3: DaDumon folded before Flop (didn't bet)
Seat 5: SkemGeeMan collected (6375)
Seat 6: JACKPOT786 (button) folded before Flop (didn't bet)
Seat 7: sandarobert1 (small blind) folded before Flop
Seat 8: thrasher71 (big blind) folded before Flop

PokerStars Hand #251205319416: Tournament #3767885527, $40+$10+$5 USD Hold'em No Limit - Level X (500/1000) - 2024/06/26 18:47:11 UTC [2024/06/26 14:47:11 ET]
Table '3767885527 59' 8-max Seat #7 is the button
Seat 1: vitor762 (10098 in chips) 
Seat 2: mikilool (25120 in chips) 
Seat 3: DaDumon (43889 in chips) 
Seat 4: Brauliocsp (25000 in chips) 
Seat 5: SkemGeeMan (26380 in chips) 
Seat 6: JACKPOT786 (24546 in chips) 
Seat 7: sandarobert1 (101013 in chips) 
Seat 8: thrasher71 (55064 in chips) 
vitor762: posts the ante 125
mikilool: posts the ante 125
DaDumon: posts the ante 125
Brauliocsp: posts the ante 125
SkemGeeMan: posts the ante 125
JACKPOT786: posts the ante 125
sandarobert1: posts the ante 125
thrasher71: posts the ante 125
thrasher71: posts small blind 500
vitor762: posts big blind 1000
*** HOLE CARDS ***
mikilool: raises 1000 to 2000
DaDumon: folds 
Brauliocsp: folds 
SkemGeeMan: folds 
JACKPOT786: folds 
sandarobert1: folds 
thrasher71 has timed out
thrasher71: folds 
thrasher71 is sitting out
thrasher71 has returned
vitor762: raises 7973 to 9973 and is all-in
mikilool: calls 7973
*** FLOP *** [9h 3c Js]
*** TURN *** [9h 3c Js] [6s]
*** RIVER *** [9h 3c Js 6s] [Td]
*** SHOW DOWN ***
vitor762: shows [9c 9d] (three of a kind, Nines)
mikilool: shows [As Qs] (high card Ace)
vitor762 collected 21446 from pot
*** SUMMARY ***
Total pot 21446 | Rake 0 
Board [9h 3c Js 6s Td]
Seat 1: vitor762 (big blind) showed [9c 9d] and won (21446) with three of a kind, Nines
Seat 2: mikilool showed [As Qs] and lost with high card Ace
Seat 3: DaDumon folded before Flop (didn't bet)
Seat 4: Brauliocsp folded before Flop (didn't bet)
Seat 5: SkemGeeMan folded before Flop (didn't bet)
Seat 6: JACKPOT786 folded before Flop (didn't bet)
Seat 7: sandarobert1 (button) folded before Flop (didn't bet)
Seat 8: thrasher71 (small blind) folded before Flop

PokerStars Hand #251205332711: Tournament #3767885527, $40+$10+$5 USD Hold'em No Limit - Level X (500/1000) - 2024/06/26 18:48:02 UTC [2024/06/26 14:48:02 ET]
Table '3767885527 59' 8-max Seat #8 is the button
Seat 1: vitor762 (21446 in chips) 
Seat 2: mikilool (15022 in chips) 
Seat 3: DaDumon (43764 in chips) 
Seat 4: Brauliocsp (24875 in chips) 
Seat 5: SkemGeeMan (26255 in chips) 
Seat 6: JACKPOT786 (24421 in chips) 
Seat 7: sandarobert1 (100888 in chips) 
Seat 8: thrasher71 (54439 in chips) 
vitor762: posts the ante 125
mikilool: posts the ante 125
DaDumon: posts the ante 125
Brauliocsp: posts the ante 125
SkemGeeMan: posts the ante 125
JACKPOT786: posts the ante 125
sandarobert1: posts the ante 125
thrasher71: posts the ante 125
vitor762: posts small blind 500
mikilool: posts big blind 1000
*** HOLE CARDS ***
DaDumon: raises 1000 to 2000
Brauliocsp: folds 
SkemGeeMan: folds 
JACKPOT786: folds 
sandarobert1: folds 
thrasher71: folds 
vitor762: folds 
mikilool: folds 
Uncalled bet (1000) returned to DaDumon
DaDumon collected 3500 from pot
DaDumon: doesn't show hand 
*** SUMMARY ***
Total pot 3500 | Rake 0 
Seat 1: vitor762 (small blind) folded before Flop
Seat 2: mikilool (big blind) folded before Flop
Seat 3: DaDumon collected (3500)
Seat 4: Brauliocsp folded before Flop (didn't bet)
Seat 5: SkemGeeMan folded before Flop (didn't bet)
Seat 6: JACKPOT786 folded before Flop (didn't bet)
Seat 7: sandarobert1 folded before Flop (didn't bet)
Seat 8: thrasher71 (button) folded before Flop (didn't bet)

PokerStars Hand #251205344455: Tournament #3767885527, $40+$10+$5 USD Hold'em No Limit - Level X (500/1000) - 2024/06/26 18:48:46 UTC [2024/06/26 14:48:46 ET]
Table '3767885527 59' 8-max Seat #1 is the button
Seat 1: vitor762 (20821 in chips) 
Seat 2: mikilool (13897 in chips) 
Seat 3: DaDumon (46139 in chips) 
Seat 4: Brauliocsp (24750 in chips) 
Seat 5: SkemGeeMan (26130 in chips) 
Seat 6: JACKPOT786 (24296 in chips) 
Seat 7: sandarobert1 (100763 in chips) 
Seat 8: thrasher71 (54314 in chips) 
vitor762: posts the ante 125
mikilool: posts the ante 125
DaDumon: posts the ante 125
Brauliocsp: posts the ante 125
SkemGeeMan: posts the ante 125
JACKPOT786: posts the ante 125
sandarobert1: posts the ante 125
thrasher71: posts the ante 125
mikilool: posts small blind 500
DaDumon: posts big blind 1000
*** HOLE CARDS ***
Brauliocsp: folds 
SkemGeeMan has timed out
SkemGeeMan: folds 
SkemGeeMan is sitting out
JACKPOT786: folds 
sandarobert1: folds 
SkemGeeMan has returned
thrasher71 has timed out
thrasher71: folds 
thrasher71 is sitting out
thrasher71 has returned
vitor762: folds 
mikilool: folds 
Uncalled bet (500) returned to DaDumon
DaDumon collected 2000 from pot
DaDumon: doesn't show hand 
*** SUMMARY ***
Total pot 2000 | Rake 0 
Seat 1: vitor762 (button) folded before Flop (didn't bet)
Seat 2: mikilool (small blind) folded before Flop
Seat 3: DaDumon (big blind) collected (2000)
Seat 4: Brauliocsp folded before Flop (didn't bet)
Seat 5: SkemGeeMan folded before Flop (didn't bet)
Seat 6: JACKPOT786 folded before Flop (didn't bet)
Seat 7: sandarobert1 folded before Flop (didn't bet)
Seat 8: thrasher71 folded before Flop (didn't bet)

PokerStars Hand #251205363134: Tournament #3767885527, $40+$10+$5 USD Hold'em No Limit - Level X (500/1000) - 2024/06/26 18:49:58 UTC [2024/06/26 14:49:58 ET]
Table '3767885527 59' 8-max Seat #2 is the button
Seat 1: vitor762 (20696 in chips) 
Seat 2: mikilool (13272 in chips) 
Seat 3: DaDumon (47514 in chips) 
Seat 4: Brauliocsp (24625 in chips) 
Seat 5: SkemGeeMan (26005 in chips) 
Seat 6: JACKPOT786 (24171 in chips) 
Seat 7: sandarobert1 (100638 in chips) 
Seat 8: thrasher71 (54189 in chips) 
vitor762: posts the ante 125
mikilool: posts the ante 125
DaDumon: posts the ante 125
Brauliocsp: posts the ante 125
SkemGeeMan: posts the ante 125
JACKPOT786: posts the ante 125
sandarobert1: posts the ante 125
thrasher71: posts the ante 125
DaDumon: posts small blind 500
Brauliocsp: posts big blind 1000
*** HOLE CARDS ***
SkemGeeMan: folds 
JACKPOT786: folds 
sandarobert1: raises 1000 to 2000
thrasher71: folds 
vitor762: folds 
mikilool: folds 
DaDumon: folds 
Brauliocsp: calls 1000
*** FLOP *** [3s Qc 9h]
Brauliocsp: checks 
sandarobert1: bets 1925
Brauliocsp: folds 
Uncalled bet (1925) returned to sandarobert1
sandarobert1 collected 5500 from pot
*** SUMMARY ***
Total pot 5500 | Rake 0 
Board [3s Qc 9h]
Seat 1: vitor762 folded before Flop (didn't bet)
Seat 2: mikilool (button) folded before Flop (didn't bet)
Seat 3: DaDumon (small blind) folded before Flop
Seat 4: Brauliocsp (big blind) folded on the Flop
Seat 5: SkemGeeMan folded before Flop (didn't bet)
Seat 6: JACKPOT786 folded before Flop (didn't bet)
Seat 7: sandarobert1 collected (5500)
Seat 8: thrasher71 folded before Flop (didn't bet)

PokerStars Hand #251205378621: Tournament #3767885527, $40+$10+$5 USD Hold'em No Limit - Level X (500/1000) - 2024/06/26 18:50:57 UTC [2024/06/26 14:50:57 ET]
Table '3767885527 59' 8-max Seat #3 is the button
Seat 1: vitor762 (20571 in chips) 
Seat 2: mikilool (13147 in chips) 
Seat 3: DaDumon (46889 in chips) 
Seat 4: Brauliocsp (22500 in chips) 
Seat 5: SkemGeeMan (25880 in chips) 
Seat 6: JACKPOT786 (24046 in chips) 
Seat 7: sandarobert1 (104013 in chips) 
Seat 8: thrasher71 (54064 in chips) 
vitor762: posts the ante 125
mikilool: posts the ante 125
DaDumon: posts the ante 125
Brauliocsp: posts the ante 125
SkemGeeMan: posts the ante 125
JACKPOT786: posts the ante 125
sandarobert1: posts the ante 125
thrasher71: posts the ante 125
Brauliocsp: posts small blind 500
SkemGeeMan: posts big blind 1000
*** HOLE CARDS ***
JACKPOT786: folds 
sandarobert1: folds 
thrasher71: raises 1000 to 2000
vitor762: folds 
mikilool: folds 
DaDumon: folds 
Brauliocsp: folds 
SkemGeeMan: folds 
Uncalled bet (1000) returned to thrasher71
thrasher71 collected 3500 from pot
thrasher71: doesn't show hand 
*** SUMMARY ***
Total pot 3500 | Rake 0 
Seat 1: vitor762 folded before Flop (didn't bet)
Seat 2: mikilool folded before Flop (didn't bet)
Seat 3: DaDumon (button) folded before Flop (didn't bet)
Seat 4: Brauliocsp (small blind) folded before Flop
Seat 5: SkemGeeMan (big blind) folded before Flop
Seat 6: JACKPOT786 folded before Flop (didn't bet)
Seat 7: sandarobert1 folded before Flop (didn't bet)
Seat 8: thrasher71 collected (3500)

PokerStars Hand #251205387982: Tournament #3767885527, $40+$10+$5 USD Hold'em No Limit - Level X (500/1000) - 2024/06/26 18:51:33 UTC [2024/06/26 14:51:33 ET]
Table '3767885527 59' 8-max Seat #4 is the button
Seat 1: vitor762 (20446 in chips) 
Seat 2: mikilool (13022 in chips) 
Seat 3: DaDumon (46764 in chips) 
Seat 4: Brauliocsp (21875 in chips) 
Seat 5: SkemGeeMan (24755 in chips) 
Seat 6: JACKPOT786 (23921 in chips) 
Seat 7: sandarobert1 (103888 in chips) 
Seat 8: thrasher71 (56439 in chips) 
vitor762: posts the ante 125
mikilool: posts the ante 125
DaDumon: posts the ante 125
Brauliocsp: posts the ante 125
SkemGeeMan: posts the ante 125
JACKPOT786: posts the ante 125
sandarobert1: posts the ante 125
thrasher71: posts the ante 125
SkemGeeMan: posts small blind 500
JACKPOT786: posts big blind 1000
*** HOLE CARDS ***
sandarobert1: raises 1000 to 2000
thrasher71: folds 
vitor762: folds 
mikilool: folds 
DaDumon: calls 2000
Brauliocsp: raises 19750 to 21750 and is all-in
SkemGeeMan: folds 
JACKPOT786: folds 
sandarobert1: folds 
DaDumon: calls 19750
*** FLOP *** [Qh 2s 2h]
*** TURN *** [Qh 2s 2h] [As]
*** RIVER *** [Qh 2s 2h As] [Ts]
*** SHOW DOWN ***
DaDumon: shows [3s 3d] (two pair, Threes and Deuces)
Brauliocsp: shows [Jd Js] (two pair, Jacks and Deuces)
Brauliocsp collected 48000 from pot
*** SUMMARY ***
Total pot 48000 | Rake 0 
Board [Qh 2s 2h As Ts]
Seat 1: vitor762 folded before Flop (didn't bet)
Seat 2: mikilool folded before Flop (didn't bet)
Seat 3: DaDumon showed [3s 3d] and lost with two pair, Threes and Deuces
Seat 4: Brauliocsp (button) showed [Jd Js] and won (48000) with two pair, Jacks and Deuces
Seat 5: SkemGeeMan (small blind) folded before Flop
Seat 6: JACKPOT786 (big blind) folded before Flop
Seat 7: sandarobert1 folded before Flop
Seat 8: thrasher71 folded before Flop (didn't bet)

PokerStars Hand #251205408563: Tournament #3767885527, $40+$10+$5 USD Hold'em No Limit - Level XI (600/1200) - 2024/06/26 18:52:51 UTC [2024/06/26 14:52:51 ET]
Table '3767885527 59' 8-max Seat #5 is the button
Seat 1: vitor762 (20321 in chips) 
Seat 2: mikilool (12897 in chips) 
Seat 3: DaDumon (24889 in chips) 
Seat 4: Brauliocsp (48000 in chips) 
Seat 5: SkemGeeMan (24130 in chips) 
Seat 6: JACKPOT786 (22796 in chips) 
Seat 7: sandarobert1 (101763 in chips) 
Seat 8: thrasher71 (56314 in chips) 
vitor762: posts the ante 150
mikilool: posts the ante 150
DaDumon: posts the ante 150
Brauliocsp: posts the ante 150
SkemGeeMan: posts the ante 150
JACKPOT786: posts the ante 150
sandarobert1: posts the ante 150
thrasher71: posts the ante 150
JACKPOT786: posts small blind 600
sandarobert1: posts big blind 1200
*** HOLE CARDS ***
thrasher71 has timed out
thrasher71: folds 
thrasher71 is sitting out
thrasher71 has returned
vitor762: folds 
mikilool: raises 11547 to 12747 and is all-in
DaDumon: folds 
Brauliocsp: folds 
SkemGeeMan: folds 
JACKPOT786: raises 9899 to 22646 and is all-in
sandarobert1: folds 
Uncalled bet (9899) returned to JACKPOT786
*** FLOP *** [2s 5h 4h]
*** TURN *** [2s 5h 4h] [6s]
*** RIVER *** [2s 5h 4h 6s] [Qd]
*** SHOW DOWN ***
JACKPOT786: shows [Ks Ad] (high card Ace)
mikilool: shows [Td As] (high card Ace - lower kicker)
JACKPOT786 collected 27894 from pot
mikilool finished the tournament
*** SUMMARY ***
Total pot 27894 | Rake 0 
Board [2s 5h 4h 6s Qd]
Seat 1: vitor762 folded before Flop (didn't bet)
Seat 2: mikilool showed [Td As] and lost with high card Ace
Seat 3: DaDumon folded before Flop (didn't bet)
Seat 4: Brauliocsp folded before Flop (didn't bet)
Seat 5: SkemGeeMan (button) folded before Flop (didn't bet)
Seat 6: JACKPOT786 (small blind) showed [Ks Ad] and won (27894) with high card Ace
Seat 7: sandarobert1 (big blind) folded before Flop
Seat 8: thrasher71 folded before Flop (didn't bet)


PokerStars Hand #251205536182: Tournament #3767885527, $40+$10+$5 USD Hold'em No Limit - Level XI (600/1200) - 2024/06/26 19:02:37 UTC [2024/06/26 15:02:37 ET]
Table '3767885527 58' 8-max Seat #1 is the button
Seat 1: krumbumbuli (17400 in chips) 
Seat 2: Philipoune (50891 in chips) 
Seat 3: Defence_BOMB (32394 in chips) 
Seat 4: alushi6 (24400 in chips) 
Seat 6: conradofpg (42390 in chips) 
Seat 7: jammy1875 (71068 in chips) 
Seat 8: DRY BLECKBERRY (54168 in chips) 
krumbumbuli: posts the ante 150
Philipoune: posts the ante 150
Defence_BOMB: posts the ante 150
alushi6: posts the ante 150
conradofpg: posts the ante 150
jammy1875: posts the ante 150
DRY BLECKBERRY: posts the ante 150
Philipoune: posts small blind 600
Defence_BOMB: posts big blind 1200
*** HOLE CARDS ***
alushi6: folds 
conradofpg: folds 
jammy1875: raises 1200 to 2400
DRY BLECKBERRY: raises 4800 to 7200
krumbumbuli: folds 
Philipoune: folds 
Defence_BOMB: folds 
MTTSharkSnG is disconnected 
jammy1875: calls 4800
*** FLOP *** [Kh 2d 8h]
jammy1875: checks 
DRY BLECKBERRY: bets 4800
jammy1875: calls 4800
*** TURN *** [Kh 2d 8h] [4s]
jammy1875: checks 
DRY BLECKBERRY: checks 
*** RIVER *** [Kh 2d 8h 4s] [3h]
jammy1875: bets 15825
DRY BLECKBERRY: folds 
Uncalled bet (15825) returned to jammy1875
jammy1875 collected 26850 from pot
*** SUMMARY ***
Total pot 26850 | Rake 0 
Board [Kh 2d 8h 4s 3h]
Seat 1: krumbumbuli (button) folded before Flop (didn't bet)
Seat 2: Philipoune (small blind) folded before Flop
Seat 3: Defence_BOMB (big blind) folded before Flop
Seat 4: alushi6 folded before Flop (didn't bet)
Seat 6: conradofpg folded before Flop (didn't bet)
Seat 7: jammy1875 collected (26850)
Seat 8: DRY BLECKBERRY folded on the River

PokerStars Hand #251205553975: Tournament #3767885527, $40+$10+$5 USD Hold'em No Limit - Level XI (600/1200) - 2024/06/26 19:03:48 UTC [2024/06/26 15:03:48 ET]
Table '3767885527 58' 8-max Seat #2 is the button
Seat 1: krumbumbuli (17250 in chips) 
Seat 2: Philipoune (50141 in chips) 
Seat 3: Defence_BOMB (31044 in chips) 
Seat 4: alushi6 (24250 in chips) 
Seat 5: MTTSharkSnG (25000 in chips) 
Seat 6: conradofpg (42240 in chips) 
Seat 7: jammy1875 (85768 in chips) 
Seat 8: DRY BLECKBERRY (42018 in chips) 
krumbumbuli: posts the ante 150
Philipoune: posts the ante 150
Defence_BOMB: posts the ante 150
alushi6: posts the ante 150
MTTSharkSnG: posts the ante 150
conradofpg: posts the ante 150
jammy1875: posts the ante 150
DRY BLECKBERRY: posts the ante 150
Defence_BOMB: posts small blind 600
alushi6: posts big blind 1200
*** HOLE CARDS ***
MTTSharkSnG: folds 
conradofpg: folds 
jammy1875: folds 
DRY BLECKBERRY: raises 1200 to 2400
krumbumbuli: folds 
Philipoune: folds 
Defence_BOMB: raises 28494 to 30894 and is all-in
alushi6: folds 
DRY BLECKBERRY: folds 
Uncalled bet (28494) returned to Defence_BOMB
Defence_BOMB collected 7200 from pot
Defence_BOMB: doesn't show hand 
*** SUMMARY ***
Total pot 7200 | Rake 0 
Seat 1: krumbumbuli folded before Flop (didn't bet)
Seat 2: Philipoune (button) folded before Flop (didn't bet)
Seat 3: Defence_BOMB (small blind) collected (7200)
Seat 4: alushi6 (big blind) folded before Flop
Seat 5: MTTSharkSnG folded before Flop (didn't bet)
Seat 6: conradofpg folded before Flop (didn't bet)
Seat 7: jammy1875 folded before Flop (didn't bet)
Seat 8: DRY BLECKBERRY folded before Flop

PokerStars Hand #251205561952: Tournament #3767885527, $40+$10+$5 USD Hold'em No Limit - Level XI (600/1200) - 2024/06/26 19:04:19 UTC [2024/06/26 15:04:19 ET]
Table '3767885527 58' 8-max Seat #3 is the button
Seat 1: krumbumbuli (17100 in chips) 
Seat 2: Philipoune (49991 in chips) 
Seat 3: Defence_BOMB (35694 in chips) 
Seat 4: alushi6 (22900 in chips) 
Seat 5: MTTSharkSnG (24850 in chips) 
Seat 6: conradofpg (42090 in chips) 
Seat 7: jammy1875 (85618 in chips) 
Seat 8: DRY BLECKBERRY (39468 in chips) 
krumbumbuli: posts the ante 150
Philipoune: posts the ante 150
Defence_BOMB: posts the ante 150
alushi6: posts the ante 150
MTTSharkSnG: posts the ante 150
conradofpg: posts the ante 150
jammy1875: posts the ante 150
DRY BLECKBERRY: posts the ante 150
alushi6: posts small blind 600
MTTSharkSnG: posts big blind 1200
*** HOLE CARDS ***
conradofpg: folds 
jammy1875: folds 
DRY BLECKBERRY: folds 
krumbumbuli: folds 
Philipoune: folds 
Defence_BOMB: folds 
alushi6: calls 600
MTTSharkSnG: raises 23500 to 24700 and is all-in
alushi6: folds 
Uncalled bet (23500) returned to MTTSharkSnG
MTTSharkSnG collected 3600 from pot
MTTSharkSnG: doesn't show hand 
*** SUMMARY ***
Total pot 3600 | Rake 0 
Seat 1: krumbumbuli folded before Flop (didn't bet)
Seat 2: Philipoune folded before Flop (didn't bet)
Seat 3: Defence_BOMB (button) folded before Flop (didn't bet)
Seat 4: alushi6 (small blind) folded before Flop
Seat 5: MTTSharkSnG (big blind) collected (3600)
Seat 6: conradofpg folded before Flop (didn't bet)
Seat 7: jammy1875 folded before Flop (didn't bet)
Seat 8: DRY BLECKBERRY folded before Flop (didn't bet)

PokerStars Hand #251205570283: Tournament #3767885527, $40+$10+$5 USD Hold'em No Limit - Level XI (600/1200) - 2024/06/26 19:04:52 UTC [2024/06/26 15:04:52 ET]
Table '3767885527 58' 8-max Seat #4 is the button
Seat 1: krumbumbuli (16950 in chips) 
Seat 2: Philipoune (49841 in chips) 
Seat 3: Defence_BOMB (35544 in chips) 
Seat 4: alushi6 (21550 in chips) 
Seat 5: MTTSharkSnG (27100 in chips) 
Seat 6: conradofpg (41940 in chips) 
Seat 7: jammy1875 (85468 in chips) 
Seat 8: DRY BLECKBERRY (39318 in chips) 
krumbumbuli: posts the ante 150
Philipoune: posts the ante 150
Defence_BOMB: posts the ante 150
alushi6: posts the ante 150
MTTSharkSnG: posts the ante 150
conradofpg: posts the ante 150
jammy1875: posts the ante 150
DRY BLECKBERRY: posts the ante 150
MTTSharkSnG: posts small blind 600
conradofpg: posts big blind 1200
*** HOLE CARDS ***
jammy1875: folds 
DRY BLECKBERRY: raises 1200 to 2400
krumbumbuli: folds 
Philipoune: folds 
Defence_BOMB: folds 
alushi6: folds 
MTTSharkSnG: raises 6000 to 8400
conradofpg has timed out
conradofpg: folds 
conradofpg is sitting out
DRY BLECKBERRY: folds 
Uncalled bet (6000) returned to MTTSharkSnG
conradofpg has returned
MTTSharkSnG collected 7200 from pot
MTTSharkSnG: doesn't show hand 
*** SUMMARY ***
Total pot 7200 | Rake 0 
Seat 1: krumbumbuli folded before Flop (didn't bet)
Seat 2: Philipoune folded before Flop (didn't bet)
Seat 3: Defence_BOMB folded before Flop (didn't bet)
Seat 4: alushi6 (button) folded before Flop (didn't bet)
Seat 5: MTTSharkSnG (small blind) collected (7200)
Seat 6: conradofpg (big blind) folded before Flop
Seat 7: jammy1875 folded before Flop (didn't bet)
Seat 8: DRY BLECKBERRY folded before Flop

PokerStars Hand #251205581428: Tournament #3767885527, $40+$10+$5 USD Hold'em No Limit - Level XI (600/1200) - 2024/06/26 19:05:34 UTC [2024/06/26 15:05:34 ET]
Table '3767885527 58' 8-max Seat #5 is the button
Seat 1: krumbumbuli (16800 in chips) 
Seat 2: Philipoune (49691 in chips) 
Seat 3: Defence_BOMB (35394 in chips) 
Seat 4: alushi6 (21400 in chips) 
Seat 5: MTTSharkSnG (31750 in chips) 
Seat 6: conradofpg (40590 in chips) 
Seat 7: jammy1875 (85318 in chips) 
Seat 8: DRY BLECKBERRY (36768 in chips) 
krumbumbuli: posts the ante 150
Philipoune: posts the ante 150
Defence_BOMB: posts the ante 150
alushi6: posts the ante 150
MTTSharkSnG: posts the ante 150
conradofpg: posts the ante 150
jammy1875: posts the ante 150
DRY BLECKBERRY: posts the ante 150
conradofpg: posts small blind 600
jammy1875: posts big blind 1200
*** HOLE CARDS ***
DRY BLECKBERRY: folds 
krumbumbuli: folds 
Philipoune: folds 
Defence_BOMB: folds 
alushi6: folds 
MTTSharkSnG: folds 
conradofpg: folds 
Uncalled bet (600) returned to jammy1875
jammy1875 collected 2400 from pot
*** SUMMARY ***
Total pot 2400 | Rake 0 
Seat 1: krumbumbuli folded before Flop (didn't bet)
Seat 2: Philipoune folded before Flop (didn't bet)
Seat 3: Defence_BOMB folded before Flop (didn't bet)
Seat 4: alushi6 folded before Flop (didn't bet)
Seat 5: MTTSharkSnG (button) folded before Flop (didn't bet)
Seat 6: conradofpg (small blind) folded before Flop
Seat 7: jammy1875 (big blind) collected (2400)
Seat 8: DRY BLECKBERRY folded before Flop (didn't bet)

PokerStars Hand #251205586748: Tournament #3767885527, $40+$10+$5 USD Hold'em No Limit - Level XI (600/1200) - 2024/06/26 19:05:54 UTC [2024/06/26 15:05:54 ET]
Table '3767885527 58' 8-max Seat #6 is the button
Seat 1: krumbumbuli (16650 in chips) 
Seat 2: Philipoune (49541 in chips) 
Seat 3: Defence_BOMB (35244 in chips) 
Seat 4: alushi6 (21250 in chips) 
Seat 5: MTTSharkSnG (31600 in chips) 
Seat 6: conradofpg (39840 in chips) 
Seat 7: jammy1875 (86968 in chips) 
Seat 8: DRY BLECKBERRY (36618 in chips) 
krumbumbuli: posts the ante 150
Philipoune: posts the ante 150
Defence_BOMB: posts the ante 150
alushi6: posts the ante 150
MTTSharkSnG: posts the ante 150
conradofpg: posts the ante 150
jammy1875: posts the ante 150
DRY BLECKBERRY: posts the ante 150
jammy1875: posts small blind 600
DRY BLECKBERRY: posts big blind 1200
*** HOLE CARDS ***
krumbumbuli: raises 15300 to 16500 and is all-in
Philipoune: folds 
Defence_BOMB: folds 
alushi6: folds 
MTTSharkSnG: folds 
conradofpg: folds 
jammy1875 has timed out
jammy1875: folds 
jammy1875 is sitting out
DRY BLECKBERRY: folds 
Uncalled bet (15300) returned to krumbumbuli
krumbumbuli collected 4200 from pot
krumbumbuli: doesn't show hand 
*** SUMMARY ***
Total pot 4200 | Rake 0 
Seat 1: krumbumbuli collected (4200)
Seat 2: Philipoune folded before Flop (didn't bet)
Seat 3: Defence_BOMB folded before Flop (didn't bet)
Seat 4: alushi6 folded before Flop (didn't bet)
Seat 5: MTTSharkSnG folded before Flop (didn't bet)
Seat 6: conradofpg (button) folded before Flop (didn't bet)
Seat 7: jammy1875 (small blind) folded before Flop
Seat 8: DRY BLECKBERRY (big blind) folded before Flop

PokerStars Hand #251205599329: Tournament #3767885527, $40+$10+$5 USD Hold'em No Limit - Level XI (600/1200) - 2024/06/26 19:06:41 UTC [2024/06/26 15:06:41 ET]
Table '3767885527 58' 8-max Seat #7 is the button
Seat 1: krumbumbuli (19500 in chips) 
Seat 2: Philipoune (49391 in chips) 
Seat 3: Defence_BOMB (35094 in chips) 
Seat 4: alushi6 (21100 in chips) 
Seat 5: MTTSharkSnG (31450 in chips) 
Seat 6: conradofpg (39690 in chips) 
Seat 7: jammy1875 (86218 in chips) is sitting out
Seat 8: DRY BLECKBERRY (35268 in chips) 
krumbumbuli: posts the ante 150
Philipoune: posts the ante 150
Defence_BOMB: posts the ante 150
alushi6: posts the ante 150
MTTSharkSnG: posts the ante 150
conradofpg: posts the ante 150
jammy1875: posts the ante 150
DRY BLECKBERRY: posts the ante 150
DRY BLECKBERRY: posts small blind 600
krumbumbuli: posts big blind 1200
*** HOLE CARDS ***
Philipoune: folds 
jammy1875 has returned
Defence_BOMB: folds 
alushi6: raises 1200 to 2400
MTTSharkSnG: folds 
conradofpg: folds 
jammy1875: calls 2400
DRY BLECKBERRY: folds 
krumbumbuli: calls 1200
*** FLOP *** [6d Qd As]
krumbumbuli: checks 
alushi6: checks 
jammy1875: bets 3600
krumbumbuli: calls 3600
alushi6: folds 
*** TURN *** [6d Qd As] [6s]
krumbumbuli: checks 
jammy1875: bets 16200
krumbumbuli: folds 
Uncalled bet (16200) returned to jammy1875
jammy1875 collected 16200 from pot
*** SUMMARY ***
Total pot 16200 | Rake 0 
Board [6d Qd As 6s]
Seat 1: krumbumbuli (big blind) folded on the Turn
Seat 2: Philipoune folded before Flop (didn't bet)
Seat 3: Defence_BOMB folded before Flop (didn't bet)
Seat 4: alushi6 folded on the Flop
Seat 5: MTTSharkSnG folded before Flop (didn't bet)
Seat 6: conradofpg folded before Flop (didn't bet)
Seat 7: jammy1875 (button) collected (16200)
Seat 8: DRY BLECKBERRY (small blind) folded before Flop

PokerStars Hand #251205616568: Tournament #3767885527, $40+$10+$5 USD Hold'em No Limit - Level XI (600/1200) - 2024/06/26 19:07:46 UTC [2024/06/26 15:07:46 ET]
Table '3767885527 58' 8-max Seat #8 is the button
Seat 1: krumbumbuli (13350 in chips) 
Seat 2: Philipoune (49241 in chips) 
Seat 3: Defence_BOMB (34944 in chips) 
Seat 4: alushi6 (18550 in chips) 
Seat 5: MTTSharkSnG (31300 in chips) 
Seat 6: conradofpg (39540 in chips) 
Seat 7: jammy1875 (96268 in chips) 
Seat 8: DRY BLECKBERRY (34518 in chips) 
krumbumbuli: posts the ante 150
Philipoune: posts the ante 150
Defence_BOMB: posts the ante 150
alushi6: posts the ante 150
MTTSharkSnG: posts the ante 150
conradofpg: posts the ante 150
jammy1875: posts the ante 150
DRY BLECKBERRY: posts the ante 150
krumbumbuli: posts small blind 600
Philipoune: posts big blind 1200
*** HOLE CARDS ***
Defence_BOMB: folds 
alushi6: folds 
MTTSharkSnG: folds 
conradofpg: raises 1200 to 2400
jammy1875: calls 2400
DRY BLECKBERRY: folds 
krumbumbuli: calls 1800
Philipoune: raises 46691 to 49091 and is all-in
conradofpg: folds 
jammy1875: folds 
krumbumbuli: calls 10800 and is all-in
Uncalled bet (35891) returned to Philipoune
*** FLOP *** [Qs 2c Kh]
*** TURN *** [Qs 2c Kh] [As]
*** RIVER *** [Qs 2c Kh As] [2d]
*** SHOW DOWN ***
krumbumbuli: shows [6d 9d] (a pair of Deuces)
Philipoune: shows [Jd Kc] (two pair, Kings and Deuces)
Philipoune collected 32400 from pot
krumbumbuli finished the tournament
*** SUMMARY ***
Total pot 32400 | Rake 0 
Board [Qs 2c Kh As 2d]
Seat 1: krumbumbuli (small blind) showed [6d 9d] and lost with a pair of Deuces
Seat 2: Philipoune (big blind) showed [Jd Kc] and won (32400) with two pair, Kings and Deuces
Seat 3: Defence_BOMB folded before Flop (didn't bet)
Seat 4: alushi6 folded before Flop (didn't bet)
Seat 5: MTTSharkSnG folded before Flop (didn't bet)
Seat 6: conradofpg folded before Flop
Seat 7: jammy1875 folded before Flop
Seat 8: DRY BLECKBERRY (button) folded before Flop (didn't bet)

PokerStars Hand #251205630096: Tournament #3767885527, $40+$10+$5 USD Hold'em No Limit - Level XI (600/1200) - 2024/06/26 19:08:37 UTC [2024/06/26 15:08:37 ET]
Table '3767885527 58' 8-max Seat #2 is the button
Seat 2: Philipoune (68291 in chips) 
Seat 3: Defence_BOMB (34794 in chips) 
Seat 4: alushi6 (18400 in chips) 
Seat 5: MTTSharkSnG (31150 in chips) 
Seat 6: conradofpg (36990 in chips) 
Seat 7: jammy1875 (93718 in chips) 
Seat 8: DRY BLECKBERRY (34368 in chips) 
Philipoune: posts the ante 150
Defence_BOMB: posts the ante 150
alushi6: posts the ante 150
MTTSharkSnG: posts the ante 150
conradofpg: posts the ante 150
jammy1875: posts the ante 150
DRY BLECKBERRY: posts the ante 150
Defence_BOMB: posts small blind 600
alushi6: posts big blind 1200
*** HOLE CARDS ***
MTTSharkSnG: folds 
conradofpg: folds 
jammy1875: raises 1200 to 2400
DRY BLECKBERRY: folds 
Philipoune: folds 
Defence_BOMB: folds 
leitalopez is disconnected 
alushi6: calls 1200
*** FLOP *** [8h 7c Kc]
alushi6: checks 
jammy1875: bets 3600
alushi6: calls 3600
*** TURN *** [8h 7c Kc] [Qs]
alushi6: checks 
jammy1875: bets 4800
alushi6: folds 
Uncalled bet (4800) returned to jammy1875
jammy1875 collected 13650 from pot
*** SUMMARY ***
Total pot 13650 | Rake 0 
Board [8h 7c Kc Qs]
Seat 2: Philipoune (button) folded before Flop (didn't bet)
Seat 3: Defence_BOMB (small blind) folded before Flop
Seat 4: alushi6 (big blind) folded on the Turn
Seat 5: MTTSharkSnG folded before Flop (didn't bet)
Seat 6: conradofpg folded before Flop (didn't bet)
Seat 7: jammy1875 collected (13650)
Seat 8: DRY BLECKBERRY folded before Flop (didn't bet)

PokerStars Hand #251205652099: Tournament #3767885527, $40+$10+$5 USD Hold'em No Limit - Level XII (700/1400) - 2024/06/26 19:09:59 UTC [2024/06/26 15:09:59 ET]
Table '3767885527 58' 8-max Seat #3 is the button
Seat 1: leitalopez (25000 in chips) 
Seat 2: Philipoune (68141 in chips) 
Seat 3: Defence_BOMB (34044 in chips) 
Seat 4: alushi6 (12250 in chips) 
Seat 5: MTTSharkSnG (31000 in chips) 
Seat 6: conradofpg (36840 in chips) 
Seat 7: jammy1875 (101218 in chips) 
Seat 8: DRY BLECKBERRY (34218 in chips) 
leitalopez: posts the ante 175
Philipoune: posts the ante 175
Defence_BOMB: posts the ante 175
alushi6: posts the ante 175
MTTSharkSnG: posts the ante 175
conradofpg: posts the ante 175
jammy1875: posts the ante 175
DRY BLECKBERRY: posts the ante 175
alushi6: posts small blind 700
MTTSharkSnG: posts big blind 1400
*** HOLE CARDS ***
conradofpg: folds 
jammy1875: raises 1400 to 2800
DRY BLECKBERRY: folds 
leitalopez: folds 
Philipoune: folds 
Defence_BOMB: folds 
alushi6: raises 9275 to 12075 and is all-in
MTTSharkSnG: folds 
jammy1875: calls 9275
*** FLOP *** [Ac Th Qh]
*** TURN *** [Ac Th Qh] [5d]
*** RIVER *** [Ac Th Qh 5d] [Ad]
*** SHOW DOWN ***
alushi6: shows [Kh Ah] (three of a kind, Aces)
jammy1875: shows [As 4h] (three of a kind, Aces - lower kicker)
alushi6 collected 26950 from pot
*** SUMMARY ***
Total pot 26950 | Rake 0 
Board [Ac Th Qh 5d Ad]
Seat 1: leitalopez folded before Flop (didn't bet)
Seat 2: Philipoune folded before Flop (didn't bet)
Seat 3: Defence_BOMB (button) folded before Flop (didn't bet)
Seat 4: alushi6 (small blind) showed [Kh Ah] and won (26950) with three of a kind, Aces
Seat 5: MTTSharkSnG (big blind) folded before Flop
Seat 6: conradofpg folded before Flop (didn't bet)
Seat 7: jammy1875 showed [As 4h] and lost with three of a kind, Aces
Seat 8: DRY BLECKBERRY folded before Flop (didn't bet)

PokerStars Hand #251205662045: Tournament #3767885527, $40+$10+$5 USD Hold'em No Limit - Level XII (700/1400) - 2024/06/26 19:10:36 UTC [2024/06/26 15:10:36 ET]
Table '3767885527 58' 8-max Seat #4 is the button
Seat 1: leitalopez (24825 in chips) 
Seat 2: Philipoune (67966 in chips) 
Seat 3: Defence_BOMB (33869 in chips) 
Seat 4: alushi6 (26950 in chips) 
Seat 5: MTTSharkSnG (29425 in chips) 
Seat 6: conradofpg (36665 in chips) 
Seat 7: jammy1875 (88968 in chips) 
Seat 8: DRY BLECKBERRY (34043 in chips) 
leitalopez: posts the ante 175
Philipoune: posts the ante 175
Defence_BOMB: posts the ante 175
alushi6: posts the ante 175
MTTSharkSnG: posts the ante 175
conradofpg: posts the ante 175
jammy1875: posts the ante 175
DRY BLECKBERRY: posts the ante 175
MTTSharkSnG: posts small blind 700
conradofpg: posts big blind 1400
*** HOLE CARDS ***
jammy1875: raises 1400 to 2800
DRY BLECKBERRY: folds 
leitalopez: raises 21850 to 24650 and is all-in
Philipoune: folds 
Defence_BOMB: folds 
alushi6: folds 
MTTSharkSnG: folds 
conradofpg: folds 
jammy1875: folds 
Uncalled bet (21850) returned to leitalopez
leitalopez collected 9100 from pot
leitalopez: doesn't show hand 
*** SUMMARY ***
Total pot 9100 | Rake 0 
Seat 1: leitalopez collected (9100)
Seat 2: Philipoune folded before Flop (didn't bet)
Seat 3: Defence_BOMB folded before Flop (didn't bet)
Seat 4: alushi6 (button) folded before Flop (didn't bet)
Seat 5: MTTSharkSnG (small blind) folded before Flop
Seat 6: conradofpg (big blind) folded before Flop
Seat 7: jammy1875 folded before Flop
Seat 8: DRY BLECKBERRY folded before Flop (didn't bet)

PokerStars Hand #251205672029: Tournament #3767885527, $40+$10+$5 USD Hold'em No Limit - Level XII (700/1400) - 2024/06/26 19:11:13 UTC [2024/06/26 15:11:13 ET]
Table '3767885527 58' 8-max Seat #5 is the button
Seat 1: leitalopez (30950 in chips) 
Seat 2: Philipoune (67791 in chips) 
Seat 3: Defence_BOMB (33694 in chips) 
Seat 4: alushi6 (26775 in chips) 
Seat 5: MTTSharkSnG (28550 in chips) 
Seat 6: conradofpg (35090 in chips) 
Seat 7: jammy1875 (85993 in chips) 
Seat 8: DRY BLECKBERRY (33868 in chips) 
leitalopez: posts the ante 175
Philipoune: posts the ante 175
Defence_BOMB: posts the ante 175
alushi6: posts the ante 175
MTTSharkSnG: posts the ante 175
conradofpg: posts the ante 175
jammy1875: posts the ante 175
DRY BLECKBERRY: posts the ante 175
conradofpg: posts small blind 700
jammy1875: posts big blind 1400
*** HOLE CARDS ***
DRY BLECKBERRY: folds 
leitalopez: folds 
Philipoune: folds 
Defence_BOMB: folds 
alushi6: raises 1400 to 2800
MTTSharkSnG: raises 25575 to 28375 and is all-in
conradofpg: folds 
jammy1875: folds 
alushi6: calls 23800 and is all-in
Uncalled bet (1775) returned to MTTSharkSnG
*** FLOP *** [As Qd 4c]
*** TURN *** [As Qd 4c] [7h]
*** RIVER *** [As Qd 4c 7h] [7s]
*** SHOW DOWN ***
alushi6: shows [Td Ts] (two pair, Tens and Sevens)
MTTSharkSnG: shows [Tc Th] (two pair, Tens and Sevens)
alushi6 collected 28350 from pot
MTTSharkSnG collected 28350 from pot
*** SUMMARY ***
Total pot 56700 | Rake 0 
Board [As Qd 4c 7h 7s]
Seat 1: leitalopez folded before Flop (didn't bet)
Seat 2: Philipoune folded before Flop (didn't bet)
Seat 3: Defence_BOMB folded before Flop (didn't bet)
Seat 4: alushi6 showed [Td Ts] and won (28350) with two pair, Tens and Sevens
Seat 5: MTTSharkSnG (button) showed [Tc Th] and won (28350) with two pair, Tens and Sevens
Seat 6: conradofpg (small blind) folded before Flop
Seat 7: jammy1875 (big blind) folded before Flop
Seat 8: DRY BLECKBERRY folded before Flop (didn't bet)

PokerStars Hand #251205681985: Tournament #3767885527, $40+$10+$5 USD Hold'em No Limit - Level XII (700/1400) - 2024/06/26 19:11:50 UTC [2024/06/26 15:11:50 ET]
Table '3767885527 58' 8-max Seat #6 is the button
Seat 1: leitalopez (30775 in chips) 
Seat 2: Philipoune (67616 in chips) 
Seat 3: Defence_BOMB (33519 in chips) 
Seat 4: alushi6 (28350 in chips) 
Seat 5: MTTSharkSnG (30125 in chips) 
Seat 6: conradofpg (34215 in chips) 
Seat 7: jammy1875 (84418 in chips) 
Seat 8: DRY BLECKBERRY (33693 in chips) 
leitalopez: posts the ante 175
Philipoune: posts the ante 175
Defence_BOMB: posts the ante 175
alushi6: posts the ante 175
MTTSharkSnG: posts the ante 175
conradofpg: posts the ante 175
jammy1875: posts the ante 175
DRY BLECKBERRY: posts the ante 175
jammy1875: posts small blind 700
DRY BLECKBERRY: posts big blind 1400
*** HOLE CARDS ***
leitalopez: raises 1400 to 2800
Philipoune: folds 
Defence_BOMB: folds 
alushi6: folds 
MTTSharkSnG: folds 
conradofpg: folds 
jammy1875: calls 2100
DRY BLECKBERRY: folds 
*** FLOP *** [4d 6s Qh]
jammy1875: checks 
leitalopez: bets 2772
jammy1875: calls 2772
*** TURN *** [4d 6s Qh] [Jc]
jammy1875: checks 
leitalopez: bets 4602
jammy1875: calls 4602
*** RIVER *** [4d 6s Qh Jc] [Kc]
jammy1875: checks 
leitalopez: checks 
*** SHOW DOWN ***
jammy1875: shows [5s 3s] (high card King)
leitalopez: shows [Kd Td] (a pair of Kings)
leitalopez collected 23148 from pot
*** SUMMARY ***
Total pot 23148 | Rake 0 
Board [4d 6s Qh Jc Kc]
Seat 1: leitalopez showed [Kd Td] and won (23148) with a pair of Kings
Seat 2: Philipoune folded before Flop (didn't bet)
Seat 3: Defence_BOMB folded before Flop (didn't bet)
Seat 4: alushi6 folded before Flop (didn't bet)
Seat 5: MTTSharkSnG folded before Flop (didn't bet)
Seat 6: conradofpg (button) folded before Flop (didn't bet)
Seat 7: jammy1875 (small blind) showed [5s 3s] and lost with high card King
Seat 8: DRY BLECKBERRY (big blind) folded before Flop

PokerStars Hand #251205698362: Tournament #3767885527, $40+$10+$5 USD Hold'em No Limit - Level XII (700/1400) - 2024/06/26 19:12:50 UTC [2024/06/26 15:12:50 ET]
Table '3767885527 58' 8-max Seat #7 is the button
Seat 1: leitalopez (43574 in chips) 
Seat 2: Philipoune (67441 in chips) 
Seat 3: Defence_BOMB (33344 in chips) 
Seat 4: alushi6 (28175 in chips) 
Seat 5: MTTSharkSnG (29950 in chips) 
Seat 6: conradofpg (34040 in chips) 
Seat 7: jammy1875 (74069 in chips) 
Seat 8: DRY BLECKBERRY (32118 in chips) 
leitalopez: posts the ante 175
Philipoune: posts the ante 175
Defence_BOMB: posts the ante 175
alushi6: posts the ante 175
MTTSharkSnG: posts the ante 175
conradofpg: posts the ante 175
jammy1875: posts the ante 175
DRY BLECKBERRY: posts the ante 175
DRY BLECKBERRY: posts small blind 700
leitalopez: posts big blind 1400
*** HOLE CARDS ***
Philipoune: folds 
Defence_BOMB: folds 
alushi6: folds 
MTTSharkSnG: raises 28375 to 29775 and is all-in
conradofpg: folds 
jammy1875: folds 
DRY BLECKBERRY: folds 
leitalopez: folds 
Uncalled bet (28375) returned to MTTSharkSnG
MTTSharkSnG collected 4900 from pot
MTTSharkSnG: doesn't show hand 
*** SUMMARY ***
Total pot 4900 | Rake 0 
Seat 1: leitalopez (big blind) folded before Flop
Seat 2: Philipoune folded before Flop (didn't bet)
Seat 3: Defence_BOMB folded before Flop (didn't bet)
Seat 4: alushi6 folded before Flop (didn't bet)
Seat 5: MTTSharkSnG collected (4900)
Seat 6: conradofpg folded before Flop (didn't bet)
Seat 7: jammy1875 (button) folded before Flop (didn't bet)
Seat 8: DRY BLECKBERRY (small blind) folded before Flop

PokerStars Hand #251205704639: Tournament #3767885527, $40+$10+$5 USD Hold'em No Limit - Level XII (700/1400) - 2024/06/26 19:13:13 UTC [2024/06/26 15:13:13 ET]
Table '3767885527 58' 8-max Seat #8 is the button
Seat 1: leitalopez (41999 in chips) 
Seat 2: Philipoune (67266 in chips) 
Seat 3: Defence_BOMB (33169 in chips) 
Seat 4: alushi6 (28000 in chips) 
Seat 5: MTTSharkSnG (33275 in chips) 
Seat 6: conradofpg (33865 in chips) 
Seat 7: jammy1875 (73894 in chips) 
Seat 8: DRY BLECKBERRY (31243 in chips) 
leitalopez: posts the ante 175
Philipoune: posts the ante 175
Defence_BOMB: posts the ante 175
alushi6: posts the ante 175
MTTSharkSnG: posts the ante 175
conradofpg: posts the ante 175
jammy1875: posts the ante 175
DRY BLECKBERRY: posts the ante 175
leitalopez: posts small blind 700
Philipoune: posts big blind 1400
*** HOLE CARDS ***
Defence_BOMB: folds 
alushi6: folds 
MTTSharkSnG: folds 
conradofpg: folds 
jammy1875: folds 
DRY BLECKBERRY: folds 
leitalopez: calls 700
Philipoune: checks 
*** FLOP *** [4s 9s Qd]
leitalopez: checks 
Philipoune: checks 
*** TURN *** [4s 9s Qd] [Jd]
leitalopez: bets 1400
Philipoune: folds 
Uncalled bet (1400) returned to leitalopez
leitalopez collected 4200 from pot
leitalopez: doesn't show hand 
*** SUMMARY ***
Total pot 4200 | Rake 0 
Board [4s 9s Qd Jd]
Seat 1: leitalopez (small blind) collected (4200)
Seat 2: Philipoune (big blind) folded on the Turn
Seat 3: Defence_BOMB folded before Flop (didn't bet)
Seat 4: alushi6 folded before Flop (didn't bet)
Seat 5: MTTSharkSnG folded before Flop (didn't bet)
Seat 6: conradofpg folded before Flop (didn't bet)
Seat 7: jammy1875 folded before Flop (didn't bet)
Seat 8: DRY BLECKBERRY (button) folded before Flop (didn't bet)

PokerStars Hand #251205716057: Tournament #3767885527, $40+$10+$5 USD Hold'em No Limit - Level XII (700/1400) - 2024/06/26 19:13:56 UTC [2024/06/26 15:13:56 ET]
Table '3767885527 58' 8-max Seat #1 is the button
Seat 1: leitalopez (44624 in chips) 
Seat 2: Philipoune (65691 in chips) 
Seat 3: Defence_BOMB (32994 in chips) 
Seat 4: alushi6 (27825 in chips) 
Seat 5: MTTSharkSnG (33100 in chips) 
Seat 6: conradofpg (33690 in chips) 
Seat 7: jammy1875 (73719 in chips) 
Seat 8: DRY BLECKBERRY (31068 in chips) 
leitalopez: posts the ante 175
Philipoune: posts the ante 175
Defence_BOMB: posts the ante 175
alushi6: posts the ante 175
MTTSharkSnG: posts the ante 175
conradofpg: posts the ante 175
jammy1875: posts the ante 175
DRY BLECKBERRY: posts the ante 175
Philipoune: posts small blind 700
Defence_BOMB: posts big blind 1400
*** HOLE CARDS ***
alushi6: raises 1400 to 2800
MTTSharkSnG: folds 
conradofpg: folds 
jammy1875: folds 
DRY BLECKBERRY: raises 4200 to 7000
leitalopez: folds 
Philipoune: folds 
Defence_BOMB: folds 
alushi6: raises 20650 to 27650 and is all-in
DRY BLECKBERRY: calls 20650
*** FLOP *** [7s 4d 5s]
*** TURN *** [7s 4d 5s] [Qh]
*** RIVER *** [7s 4d 5s Qh] [Ah]
*** SHOW DOWN ***
alushi6: shows [Kd Ad] (a pair of Aces)
DRY BLECKBERRY: shows [Ks As] (a pair of Aces)
alushi6 collected 29400 from pot
DRY BLECKBERRY collected 29400 from pot
*** SUMMARY ***
Total pot 58800 | Rake 0 
Board [7s 4d 5s Qh Ah]
Seat 1: leitalopez (button) folded before Flop (didn't bet)
Seat 2: Philipoune (small blind) folded before Flop
Seat 3: Defence_BOMB (big blind) folded before Flop
Seat 4: alushi6 showed [Kd Ad] and won (29400) with a pair of Aces
Seat 5: MTTSharkSnG folded before Flop (didn't bet)
Seat 6: conradofpg folded before Flop (didn't bet)
Seat 7: jammy1875 folded before Flop (didn't bet)
Seat 8: DRY BLECKBERRY showed [Ks As] and won (29400) with a pair of Aces

PokerStars Hand #251205730536: Tournament #3767885527, $40+$10+$5 USD Hold'em No Limit - Level XII (700/1400) - 2024/06/26 19:14:49 UTC [2024/06/26 15:14:49 ET]
Table '3767885527 58' 8-max Seat #2 is the button
Seat 1: leitalopez (44449 in chips) 
Seat 2: Philipoune (64816 in chips) 
Seat 3: Defence_BOMB (31419 in chips) 
Seat 4: alushi6 (29400 in chips) 
Seat 5: MTTSharkSnG (32925 in chips) 
Seat 6: conradofpg (33515 in chips) 
Seat 7: jammy1875 (73544 in chips) 
Seat 8: DRY BLECKBERRY (32643 in chips) 
leitalopez: posts the ante 175
Philipoune: posts the ante 175
Defence_BOMB: posts the ante 175
alushi6: posts the ante 175
MTTSharkSnG: posts the ante 175
conradofpg: posts the ante 175
jammy1875: posts the ante 175
DRY BLECKBERRY: posts the ante 175
Defence_BOMB: posts small blind 700
alushi6: posts big blind 1400
*** HOLE CARDS ***
MTTSharkSnG: folds 
conradofpg: folds 
jammy1875: folds 
DRY BLECKBERRY: raises 1400 to 2800
leitalopez: folds 
Philipoune: folds 
Defence_BOMB: folds 
alushi6: folds 
Uncalled bet (1400) returned to DRY BLECKBERRY
DRY BLECKBERRY collected 4900 from pot
DRY BLECKBERRY: doesn't show hand 
*** SUMMARY ***
Total pot 4900 | Rake 0 
Seat 1: leitalopez folded before Flop (didn't bet)
Seat 2: Philipoune (button) folded before Flop (didn't bet)
Seat 3: Defence_BOMB (small blind) folded before Flop
Seat 4: alushi6 (big blind) folded before Flop
Seat 5: MTTSharkSnG folded before Flop (didn't bet)
Seat 6: conradofpg folded before Flop (didn't bet)
Seat 7: jammy1875 folded before Flop (didn't bet)
Seat 8: DRY BLECKBERRY collected (4900)

PokerStars Hand #251205739557: Tournament #3767885527, $40+$10+$5 USD Hold'em No Limit - Level XII (700/1400) - 2024/06/26 19:15:22 UTC [2024/06/26 15:15:22 ET]
Table '3767885527 58' 8-max Seat #3 is the button
Seat 1: leitalopez (44274 in chips) 
Seat 2: Philipoune (64641 in chips) 
Seat 3: Defence_BOMB (30544 in chips) 
Seat 4: alushi6 (27825 in chips) 
Seat 5: MTTSharkSnG (32750 in chips) 
Seat 6: conradofpg (33340 in chips) 
Seat 7: jammy1875 (73369 in chips) 
Seat 8: DRY BLECKBERRY (35968 in chips) 
leitalopez: posts the ante 175
Philipoune: posts the ante 175
Defence_BOMB: posts the ante 175
alushi6: posts the ante 175
MTTSharkSnG: posts the ante 175
conradofpg: posts the ante 175
jammy1875: posts the ante 175
DRY BLECKBERRY: posts the ante 175
alushi6: posts small blind 700
MTTSharkSnG: posts big blind 1400
*** HOLE CARDS ***
conradofpg: folds 
jammy1875: folds 
DRY BLECKBERRY: raises 1400 to 2800
leitalopez: folds 
Philipoune: folds 
Defence_BOMB: folds 
alushi6: raises 24850 to 27650 and is all-in
MTTSharkSnG: raises 4925 to 32575 and is all-in
DRY BLECKBERRY: calls 29775
*** FLOP *** [3d 2d 7s]
*** TURN *** [3d 2d 7s] [8d]
*** RIVER *** [3d 2d 7s 8d] [Js]
*** SHOW DOWN ***
MTTSharkSnG: shows [Jc Ac] (a pair of Jacks)
DRY BLECKBERRY: shows [Kh Ah] (high card Ace)
MTTSharkSnG collected 9850 from side pot
alushi6: shows [Ks Qs] (high card King)
MTTSharkSnG collected 84350 from main pot
alushi6 finished the tournament
*** SUMMARY ***
Total pot 94200 Main pot 84350. Side pot 9850. | Rake 0 
Board [3d 2d 7s 8d Js]
Seat 1: leitalopez folded before Flop (didn't bet)
Seat 2: Philipoune folded before Flop (didn't bet)
Seat 3: Defence_BOMB (button) folded before Flop (didn't bet)
Seat 4: alushi6 (small blind) showed [Ks Qs] and lost with high card King
Seat 5: MTTSharkSnG (big blind) showed [Jc Ac] and won (94200) with a pair of Jacks
Seat 6: conradofpg folded before Flop (didn't bet)
Seat 7: jammy1875 folded before Flop (didn't bet)
Seat 8: DRY BLECKBERRY showed [Kh Ah] and lost with high card Ace

PokerStars Hand #251205752366: Tournament #3767885527, $40+$10+$5 USD Hold'em No Limit - Level XII (700/1400) - 2024/06/26 19:16:09 UTC [2024/06/26 15:16:09 ET]
Table '3767885527 58' 8-max Seat #5 is the button
Seat 1: leitalopez (44099 in chips) 
Seat 2: Philipoune (64466 in chips) 
Seat 3: Defence_BOMB (30369 in chips) 
Seat 5: MTTSharkSnG (94200 in chips) 
Seat 6: conradofpg (33165 in chips) 
Seat 7: jammy1875 (73194 in chips) 
Seat 8: DRY BLECKBERRY (3218 in chips) 
leitalopez: posts the ante 175
Philipoune: posts the ante 175
Defence_BOMB: posts the ante 175
MTTSharkSnG: posts the ante 175
conradofpg: posts the ante 175
jammy1875: posts the ante 175
DRY BLECKBERRY: posts the ante 175
conradofpg: posts small blind 700
jammy1875: posts big blind 1400
*** HOLE CARDS ***
DRY BLECKBERRY: folds 
leitalopez: folds 
Philipoune: folds 
Defence_BOMB: folds 
MTTSharkSnG: raises 1400 to 2800
conradofpg: folds 
jammy1875: raises 4200 to 7000
KingDugdale is disconnected 
MTTSharkSnG: calls 4200
*** FLOP *** [6h 5c 2s]
jammy1875: bets 5600
MTTSharkSnG: calls 5600
*** TURN *** [6h 5c 2s] [Qc]
jammy1875: bets 12163
MTTSharkSnG: folds 
Uncalled bet (12163) returned to jammy1875
jammy1875 collected 27125 from pot
*** SUMMARY ***
Total pot 27125 | Rake 0 
Board [6h 5c 2s Qc]
Seat 1: leitalopez folded before Flop (didn't bet)
Seat 2: Philipoune folded before Flop (didn't bet)
Seat 3: Defence_BOMB folded before Flop (didn't bet)
Seat 5: MTTSharkSnG (button) folded on the Turn
Seat 6: conradofpg (small blind) folded before Flop
Seat 7: jammy1875 (big blind) collected (27125)
Seat 8: DRY BLECKBERRY folded before Flop (didn't bet)

PokerStars Hand #251205773369: Tournament #3767885527, $40+$10+$5 USD Hold'em No Limit - Level XII (700/1400) - 2024/06/26 19:17:27 UTC [2024/06/26 15:17:27 ET]
Table '3767885527 58' 8-max Seat #6 is the button
Seat 1: leitalopez (43924 in chips) 
Seat 2: Philipoune (64291 in chips) 
Seat 3: Defence_BOMB (30194 in chips) 
Seat 4: KingDugdale (25000 in chips) 
Seat 5: MTTSharkSnG (81425 in chips) 
Seat 6: conradofpg (32290 in chips) 
Seat 7: jammy1875 (87544 in chips) 
Seat 8: DRY BLECKBERRY (3043 in chips) 
leitalopez: posts the ante 175
Philipoune: posts the ante 175
Defence_BOMB: posts the ante 175
KingDugdale: posts the ante 175
MTTSharkSnG: posts the ante 175
conradofpg: posts the ante 175
jammy1875: posts the ante 175
DRY BLECKBERRY: posts the ante 175
jammy1875: posts small blind 700
DRY BLECKBERRY: posts big blind 1400
*** HOLE CARDS ***
leitalopez: raises 1400 to 2800
Philipoune: folds 
Defence_BOMB: raises 4200 to 7000
KingDugdale: folds 
MTTSharkSnG: folds 
conradofpg: folds 
jammy1875: folds 
DRY BLECKBERRY: calls 1468 and is all-in
leitalopez: folds 
Uncalled bet (4132) returned to Defence_BOMB
*** FLOP *** [3d Th 7c]
*** TURN *** [3d Th 7c] [Kh]
*** RIVER *** [3d Th 7c Kh] [6h]
*** SHOW DOWN ***
DRY BLECKBERRY: shows [Tc As] (a pair of Tens)
Defence_BOMB: shows [Kc Ad] (a pair of Kings)
Defence_BOMB collected 10636 from pot
DRY BLECKBERRY finished the tournament
*** SUMMARY ***
Total pot 10636 | Rake 0 
Board [3d Th 7c Kh 6h]
Seat 1: leitalopez folded before Flop
Seat 2: Philipoune folded before Flop (didn't bet)
Seat 3: Defence_BOMB showed [Kc Ad] and won (10636) with a pair of Kings
Seat 4: KingDugdale folded before Flop (didn't bet)
Seat 5: MTTSharkSnG folded before Flop (didn't bet)
Seat 6: conradofpg (button) folded before Flop (didn't bet)
Seat 7: jammy1875 (small blind) folded before Flop
Seat 8: DRY BLECKBERRY (big blind) showed [Tc As] and lost with a pair of Tens

PokerStars Hand #251205785433: Tournament #3767885527, $40+$10+$5 USD Hold'em No Limit - Level XII (700/1400) - 2024/06/26 19:18:11 UTC [2024/06/26 15:18:11 ET]
Table '3767885527 58' 8-max Seat #7 is the button
Seat 1: leitalopez (40949 in chips) 
Seat 2: Philipoune (64116 in chips) 
Seat 3: Defence_BOMB (37787 in chips) 
Seat 4: KingDugdale (24825 in chips) 
Seat 5: MTTSharkSnG (81250 in chips) 
Seat 6: conradofpg (32115 in chips) 
Seat 7: jammy1875 (86669 in chips) 
leitalopez: posts the ante 175
Philipoune: posts the ante 175
Defence_BOMB: posts the ante 175
KingDugdale: posts the ante 175
MTTSharkSnG: posts the ante 175
conradofpg: posts the ante 175
jammy1875: posts the ante 175
leitalopez: posts small blind 700
Philipoune: posts big blind 1400
*** HOLE CARDS ***
Defence_BOMB: folds 
KingDugdale: folds 
MTTSharkSnG: folds 
conradofpg: folds 
jammy1875: folds 
leitalopez: calls 700
Philipoune: raises 62541 to 63941 and is all-in
leitalopez: folds 
Uncalled bet (62541) returned to Philipoune
Philipoune collected 4025 from pot
Philipoune: doesn't show hand 
*** SUMMARY ***
Total pot 4025 | Rake 0 
Seat 1: leitalopez (small blind) folded before Flop
Seat 2: Philipoune (big blind) collected (4025)
Seat 3: Defence_BOMB folded before Flop (didn't bet)
Seat 4: KingDugdale folded before Flop (didn't bet)
Seat 5: MTTSharkSnG folded before Flop (didn't bet)
Seat 6: conradofpg folded before Flop (didn't bet)
Seat 7: jammy1875 (button) folded before Flop (didn't bet)

PokerStars Hand #251205793783: Tournament #3767885527, $40+$10+$5 USD Hold'em No Limit - Level XII (700/1400) - 2024/06/26 19:18:41 UTC [2024/06/26 15:18:41 ET]
Table '3767885527 58' 8-max Seat #1 is the button
Seat 1: leitalopez (39374 in chips) 
Seat 2: Philipoune (66566 in chips) 
Seat 3: Defence_BOMB (37612 in chips) 
Seat 4: KingDugdale (24650 in chips) 
Seat 5: MTTSharkSnG (81075 in chips) 
Seat 6: conradofpg (31940 in chips) 
Seat 7: jammy1875 (86494 in chips) 
leitalopez: posts the ante 175
Philipoune: posts the ante 175
Defence_BOMB: posts the ante 175
KingDugdale: posts the ante 175
MTTSharkSnG: posts the ante 175
conradofpg: posts the ante 175
jammy1875: posts the ante 175
Philipoune: posts small blind 700
Defence_BOMB: posts big blind 1400
*** HOLE CARDS ***
KingDugdale: folds 
MTTSharkSnG: folds 
conradofpg: raises 1400 to 2800
jammy1875: raises 8400 to 11200
leitalopez: folds 
Philipoune: folds 
oO-HaiRoller-Oo is disconnected 
Defence_BOMB: folds 
conradofpg: folds 
Uncalled bet (8400) returned to jammy1875
jammy1875 collected 8925 from pot
*** SUMMARY ***
Total pot 8925 | Rake 0 
Seat 1: leitalopez (button) folded before Flop (didn't bet)
Seat 2: Philipoune (small blind) folded before Flop
Seat 3: Defence_BOMB (big blind) folded before Flop
Seat 4: KingDugdale folded before Flop (didn't bet)
Seat 5: MTTSharkSnG folded before Flop (didn't bet)
Seat 6: conradofpg folded before Flop
Seat 7: jammy1875 collected (8925)

PokerStars Hand #251205806355: Tournament #3767885527, $40+$10+$5 USD Hold'em No Limit - Level XIII (800/1600) - 2024/06/26 19:19:27 UTC [2024/06/26 15:19:27 ET]
Table '3767885527 58' 8-max Seat #2 is the button
Seat 1: leitalopez (39199 in chips) 
Seat 2: Philipoune (65691 in chips) 
Seat 3: Defence_BOMB (36037 in chips) 
Seat 4: KingDugdale (24475 in chips) 
Seat 5: MTTSharkSnG (80900 in chips) 
Seat 6: conradofpg (28965 in chips) 
Seat 7: jammy1875 (92444 in chips) 
Seat 8: oO-HaiRoller-Oo (25000 in chips) 
leitalopez: posts the ante 200
Philipoune: posts the ante 200
Defence_BOMB: posts the ante 200
KingDugdale: posts the ante 200
MTTSharkSnG: posts the ante 200
conradofpg: posts the ante 200
jammy1875: posts the ante 200
oO-HaiRoller-Oo: posts the ante 200
Defence_BOMB: posts small blind 800
KingDugdale: posts big blind 1600
*** HOLE CARDS ***
MTTSharkSnG: folds 
conradofpg: folds 
jammy1875: raises 1600 to 3200
oO-HaiRoller-Oo: folds 
leitalopez: raises 35799 to 38999 and is all-in
Philipoune: folds 
Defence_BOMB: folds 
KingDugdale: folds 
jammy1875: folds 
Uncalled bet (35799) returned to leitalopez
leitalopez collected 10400 from pot
leitalopez: doesn't show hand 
*** SUMMARY ***
Total pot 10400 | Rake 0 
Seat 1: leitalopez collected (10400)
Seat 2: Philipoune (button) folded before Flop (didn't bet)
Seat 3: Defence_BOMB (small blind) folded before Flop
Seat 4: KingDugdale (big blind) folded before Flop
Seat 5: MTTSharkSnG folded before Flop (didn't bet)
Seat 6: conradofpg folded before Flop (didn't bet)
Seat 7: jammy1875 folded before Flop
Seat 8: oO-HaiRoller-Oo folded before Flop (didn't bet)

PokerStars Hand #251205813172: Tournament #3767885527, $40+$10+$5 USD Hold'em No Limit - Level XIII (800/1600) - 2024/06/26 19:19:52 UTC [2024/06/26 15:19:52 ET]
Table '3767885527 58' 8-max Seat #3 is the button
Seat 1: leitalopez (46199 in chips) 
Seat 2: Philipoune (65491 in chips) 
Seat 3: Defence_BOMB (35037 in chips) 
Seat 4: KingDugdale (22675 in chips) 
Seat 5: MTTSharkSnG (80700 in chips) 
Seat 6: conradofpg (28765 in chips) 
Seat 7: jammy1875 (89044 in chips) 
Seat 8: oO-HaiRoller-Oo (24800 in chips) 
leitalopez: posts the ante 200
Philipoune: posts the ante 200
Defence_BOMB: posts the ante 200
KingDugdale: posts the ante 200
MTTSharkSnG: posts the ante 200
conradofpg: posts the ante 200
jammy1875: posts the ante 200
oO-HaiRoller-Oo: posts the ante 200
KingDugdale: posts small blind 800
MTTSharkSnG: posts big blind 1600
*** HOLE CARDS ***
conradofpg: raises 1600 to 3200
jammy1875: calls 3200
oO-HaiRoller-Oo: folds 
leitalopez: folds 
Philipoune: folds 
Defence_BOMB: folds 
KingDugdale: folds 
MTTSharkSnG: folds 
*** FLOP *** [2s 7h 6c]
conradofpg: checks 
jammy1875: checks 
*** TURN *** [2s 7h 6c] [Kh]
conradofpg: checks 
jammy1875: bets 4800
conradofpg: calls 4800
*** RIVER *** [2s 7h 6c Kh] [Qs]
conradofpg: checks 
jammy1875: bets 8400
conradofpg: folds 
Uncalled bet (8400) returned to jammy1875
jammy1875 collected 20000 from pot
*** SUMMARY ***
Total pot 20000 | Rake 0 
Board [2s 7h 6c Kh Qs]
Seat 1: leitalopez folded before Flop (didn't bet)
Seat 2: Philipoune folded before Flop (didn't bet)
Seat 3: Defence_BOMB (button) folded before Flop (didn't bet)
Seat 4: KingDugdale (small blind) folded before Flop
Seat 5: MTTSharkSnG (big blind) folded before Flop
Seat 6: conradofpg folded on the River
Seat 7: jammy1875 collected (20000)
Seat 8: oO-HaiRoller-Oo folded before Flop (didn't bet)

PokerStars Hand #251205843603: Tournament #3767885527, $40+$10+$5 USD Hold'em No Limit - Level XIII (800/1600) - 2024/06/26 19:21:44 UTC [2024/06/26 15:21:44 ET]
Table '3767885527 58' 8-max Seat #4 is the button
Seat 1: leitalopez (45999 in chips) 
Seat 2: Philipoune (65291 in chips) 
Seat 3: Defence_BOMB (34837 in chips) 
Seat 4: KingDugdale (21675 in chips) 
Seat 5: MTTSharkSnG (78900 in chips) 
Seat 6: conradofpg (20565 in chips) 
Seat 7: jammy1875 (100844 in chips) 
Seat 8: oO-HaiRoller-Oo (24600 in chips) 
leitalopez: posts the ante 200
Philipoune: posts the ante 200
Defence_BOMB: posts the ante 200
KingDugdale: posts the ante 200
MTTSharkSnG: posts the ante 200
conradofpg: posts the ante 200
jammy1875: posts the ante 200
oO-HaiRoller-Oo: posts the ante 200
MTTSharkSnG: posts small blind 800
conradofpg: posts big blind 1600
*** HOLE CARDS ***
jammy1875: folds 
oO-HaiRoller-Oo: raises 22800 to 24400 and is all-in
leitalopez: folds 
Philipoune: folds 
Defence_BOMB: folds 
KingDugdale: folds 
MTTSharkSnG: folds 
conradofpg: folds 
Uncalled bet (22800) returned to oO-HaiRoller-Oo
oO-HaiRoller-Oo collected 5600 from pot
oO-HaiRoller-Oo: doesn't show hand 
*** SUMMARY ***
Total pot 5600 | Rake 0 
Seat 1: leitalopez folded before Flop (didn't bet)
Seat 2: Philipoune folded before Flop (didn't bet)
Seat 3: Defence_BOMB folded before Flop (didn't bet)
Seat 4: KingDugdale (button) folded before Flop (didn't bet)
Seat 5: MTTSharkSnG (small blind) folded before Flop
Seat 6: conradofpg (big blind) folded before Flop
Seat 7: jammy1875 folded before Flop (didn't bet)
Seat 8: oO-HaiRoller-Oo collected (5600)

PokerStars Hand #251205850436: Tournament #3767885527, $40+$10+$5 USD Hold'em No Limit - Level XIII (800/1600) - 2024/06/26 19:22:09 UTC [2024/06/26 15:22:09 ET]
Table '3767885527 58' 8-max Seat #5 is the button
Seat 1: leitalopez (45799 in chips) 
Seat 2: Philipoune (65091 in chips) 
Seat 3: Defence_BOMB (34637 in chips) 
Seat 4: KingDugdale (21475 in chips) 
Seat 5: MTTSharkSnG (77900 in chips) 
Seat 6: conradofpg (18765 in chips) 
Seat 7: jammy1875 (100644 in chips) 
Seat 8: oO-HaiRoller-Oo (28400 in chips) 
leitalopez: posts the ante 200
Philipoune: posts the ante 200
Defence_BOMB: posts the ante 200
KingDugdale: posts the ante 200
MTTSharkSnG: posts the ante 200
conradofpg: posts the ante 200
jammy1875: posts the ante 200
oO-HaiRoller-Oo: posts the ante 200
conradofpg: posts small blind 800
jammy1875: posts big blind 1600
*** HOLE CARDS ***
oO-HaiRoller-Oo: folds 
leitalopez: folds 
Philipoune: folds 
Defence_BOMB: folds 
KingDugdale: raises 19675 to 21275 and is all-in
MTTSharkSnG: folds 
conradofpg: folds 
jammy1875: calls 19675
*** FLOP *** [Qh Qc Js]
*** TURN *** [Qh Qc Js] [Jh]
*** RIVER *** [Qh Qc Js Jh] [5h]
*** SHOW DOWN ***
jammy1875: shows [9s Ac] (two pair, Queens and Jacks)
KingDugdale: shows [Kc 9c] (two pair, Queens and Jacks - lower kicker)
jammy1875 collected 44950 from pot
KingDugdale finished the tournament
*** SUMMARY ***
Total pot 44950 | Rake 0 
Board [Qh Qc Js Jh 5h]
Seat 1: leitalopez folded before Flop (didn't bet)
Seat 2: Philipoune folded before Flop (didn't bet)
Seat 3: Defence_BOMB folded before Flop (didn't bet)
Seat 4: KingDugdale showed [Kc 9c] and lost with two pair, Queens and Jacks
Seat 5: MTTSharkSnG (button) folded before Flop (didn't bet)
Seat 6: conradofpg (small blind) folded before Flop
Seat 7: jammy1875 (big blind) showed [9s Ac] and won (44950) with two pair, Queens and Jacks
Seat 8: oO-HaiRoller-Oo folded before Flop (didn't bet)

PokerStars Hand #251205859502: Tournament #3767885527, $40+$10+$5 USD Hold'em No Limit - Level XIII (800/1600) - 2024/06/26 19:22:42 UTC [2024/06/26 15:22:42 ET]
Table '3767885527 58' 8-max Seat #6 is the button
Seat 1: leitalopez (45599 in chips) 
Seat 2: Philipoune (64891 in chips) 
Seat 3: Defence_BOMB (34437 in chips) 
Seat 5: MTTSharkSnG (77700 in chips) 
Seat 6: conradofpg (17765 in chips) 
Seat 7: jammy1875 (124119 in chips) 
Seat 8: oO-HaiRoller-Oo (28200 in chips) 
leitalopez: posts the ante 200
Philipoune: posts the ante 200
Defence_BOMB: posts the ante 200
MTTSharkSnG: posts the ante 200
conradofpg: posts the ante 200
jammy1875: posts the ante 200
oO-HaiRoller-Oo: posts the ante 200
jammy1875: posts small blind 800
oO-HaiRoller-Oo: posts big blind 1600
*** HOLE CARDS ***
leitalopez: folds 
Philipoune: folds 
Defence_BOMB: folds 
MTTSharkSnG: folds 
conradofpg: folds 
jammy1875: raises 1600 to 3200
oO-HaiRoller-Oo: calls 1600
*** FLOP *** [Jc 9d 5d]
jammy1875: bets 3200
oO-HaiRoller-Oo: calls 3200
*** TURN *** [Jc 9d 5d] [2h]
jammy1875: checks 
oO-HaiRoller-Oo: bets 21600 and is all-in
jammy1875: folds 
Uncalled bet (21600) returned to oO-HaiRoller-Oo
oO-HaiRoller-Oo collected 14200 from pot
oO-HaiRoller-Oo: doesn't show hand 
*** SUMMARY ***
Total pot 14200 | Rake 0 
Board [Jc 9d 5d 2h]
Seat 1: leitalopez folded before Flop (didn't bet)
Seat 2: Philipoune folded before Flop (didn't bet)
Seat 3: Defence_BOMB folded before Flop (didn't bet)
Seat 5: MTTSharkSnG folded before Flop (didn't bet)
Seat 6: conradofpg (button) folded before Flop (didn't bet)
Seat 7: jammy1875 (small blind) folded on the Turn
Seat 8: oO-HaiRoller-Oo (big blind) collected (14200)

PokerStars Hand #251205874752: Tournament #3767885527, $40+$10+$5 USD Hold'em No Limit - Level XIII (800/1600) - 2024/06/26 19:23:38 UTC [2024/06/26 15:23:38 ET]
Table '3767885527 58' 8-max Seat #7 is the button
Seat 1: leitalopez (45399 in chips) 
Seat 2: Philipoune (64691 in chips) 
Seat 3: Defence_BOMB (34237 in chips) 
Seat 4: Renailmatto (25000 in chips) 
Seat 5: MTTSharkSnG (77500 in chips) 
Seat 6: conradofpg (17565 in chips) 
Seat 7: jammy1875 (117519 in chips) 
Seat 8: oO-HaiRoller-Oo (35800 in chips) 
leitalopez: posts the ante 200
Philipoune: posts the ante 200
Defence_BOMB: posts the ante 200
Renailmatto: posts the ante 200
MTTSharkSnG: posts the ante 200
conradofpg: posts the ante 200
jammy1875: posts the ante 200
oO-HaiRoller-Oo: posts the ante 200
oO-HaiRoller-Oo: posts small blind 800
leitalopez: posts big blind 1600
*** HOLE CARDS ***
Philipoune: folds 
Defence_BOMB: folds 
Renailmatto: raises 1600 to 3200
MTTSharkSnG: folds 
conradofpg: folds 
jammy1875: folds 
oO-HaiRoller-Oo: calls 2400
leitalopez: calls 1600
*** FLOP *** [9h Kd Qs]
oO-HaiRoller-Oo: checks 
leitalopez: checks 
Renailmatto: bets 5600
oO-HaiRoller-Oo: calls 5600
leitalopez: folds 
*** TURN *** [9h Kd Qs] [Ts]
oO-HaiRoller-Oo: checks 
Renailmatto: checks 
*** RIVER *** [9h Kd Qs Ts] [6c]
oO-HaiRoller-Oo: bets 26800 and is all-in
Renailmatto: folds 
Uncalled bet (26800) returned to oO-HaiRoller-Oo
oO-HaiRoller-Oo collected 22400 from pot
oO-HaiRoller-Oo: doesn't show hand 
*** SUMMARY ***
Total pot 22400 | Rake 0 
Board [9h Kd Qs Ts 6c]
Seat 1: leitalopez (big blind) folded on the Flop
Seat 2: Philipoune folded before Flop (didn't bet)
Seat 3: Defence_BOMB folded before Flop (didn't bet)
Seat 4: Renailmatto folded on the River
Seat 5: MTTSharkSnG folded before Flop (didn't bet)
Seat 6: conradofpg folded before Flop (didn't bet)
Seat 7: jammy1875 (button) folded before Flop (didn't bet)
Seat 8: oO-HaiRoller-Oo (small blind) collected (22400)

PokerStars Hand #251205891218: Tournament #3767885527, $40+$10+$5 USD Hold'em No Limit - Level XIII (800/1600) - 2024/06/26 19:24:38 UTC [2024/06/26 15:24:38 ET]
Table '3767885527 58' 8-max Seat #8 is the button
Seat 1: leitalopez (41999 in chips) 
Seat 2: Philipoune (64491 in chips) 
Seat 3: Defence_BOMB (34037 in chips) 
Seat 4: Renailmatto (16000 in chips) 
Seat 5: MTTSharkSnG (77300 in chips) 
Seat 6: conradofpg (17365 in chips) 
Seat 7: jammy1875 (117319 in chips) 
Seat 8: oO-HaiRoller-Oo (49200 in chips) 
leitalopez: posts the ante 200
Philipoune: posts the ante 200
Defence_BOMB: posts the ante 200
Renailmatto: posts the ante 200
MTTSharkSnG: posts the ante 200
conradofpg: posts the ante 200
jammy1875: posts the ante 200
oO-HaiRoller-Oo: posts the ante 200
leitalopez: posts small blind 800
Philipoune: posts big blind 1600
*** HOLE CARDS ***
Defence_BOMB: folds 
Renailmatto: raises 14200 to 15800 and is all-in
MTTSharkSnG: folds 
conradofpg: folds 
jammy1875: folds 
oO-HaiRoller-Oo: folds 
leitalopez: folds 
Philipoune: folds 
Uncalled bet (14200) returned to Renailmatto
Renailmatto collected 5600 from pot
*** SUMMARY ***
Total pot 5600 | Rake 0 
Seat 1: leitalopez (small blind) folded before Flop
Seat 2: Philipoune (big blind) folded before Flop
Seat 3: Defence_BOMB folded before Flop (didn't bet)
Seat 4: Renailmatto collected (5600)
Seat 5: MTTSharkSnG folded before Flop (didn't bet)
Seat 6: conradofpg folded before Flop (didn't bet)
Seat 7: jammy1875 folded before Flop (didn't bet)
Seat 8: oO-HaiRoller-Oo (button) folded before Flop (didn't bet)

PokerStars Hand #251205896482: Tournament #3767885527, $40+$10+$5 USD Hold'em No Limit - Level XIII (800/1600) - 2024/06/26 19:24:57 UTC [2024/06/26 15:24:57 ET]
Table '3767885527 58' 8-max Seat #1 is the button
Seat 1: leitalopez (40999 in chips) 
Seat 2: Philipoune (62691 in chips) 
Seat 3: Defence_BOMB (33837 in chips) 
Seat 4: Renailmatto (19800 in chips) 
Seat 5: MTTSharkSnG (77100 in chips) 
Seat 6: conradofpg (17165 in chips) 
Seat 7: jammy1875 (117119 in chips) 
Seat 8: oO-HaiRoller-Oo (49000 in chips) 
leitalopez: posts the ante 200
Philipoune: posts the ante 200
Defence_BOMB: posts the ante 200
Renailmatto: posts the ante 200
MTTSharkSnG: posts the ante 200
conradofpg: posts the ante 200
jammy1875: posts the ante 200
oO-HaiRoller-Oo: posts the ante 200
Philipoune: posts small blind 800
Defence_BOMB: posts big blind 1600
*** HOLE CARDS ***
Renailmatto: folds 
MTTSharkSnG: folds 
conradofpg: folds 
jammy1875: folds 
oO-HaiRoller-Oo: folds 
leitalopez: raises 1600 to 3200
Philipoune: folds 
Defence_BOMB: folds 
Uncalled bet (1600) returned to leitalopez
leitalopez collected 5600 from pot
leitalopez: doesn't show hand 
*** SUMMARY ***
Total pot 5600 | Rake 0 
Seat 1: leitalopez (button) collected (5600)
Seat 2: Philipoune (small blind) folded before Flop
Seat 3: Defence_BOMB (big blind) folded before Flop
Seat 4: Renailmatto folded before Flop (didn't bet)
Seat 5: MTTSharkSnG folded before Flop (didn't bet)
Seat 6: conradofpg folded before Flop (didn't bet)
Seat 7: jammy1875 folded before Flop (didn't bet)
Seat 8: oO-HaiRoller-Oo folded before Flop (didn't bet)

PokerStars Hand #251205903815: Tournament #3767885527, $40+$10+$5 USD Hold'em No Limit - Level XIII (800/1600) - 2024/06/26 19:25:23 UTC [2024/06/26 15:25:23 ET]
Table '3767885527 58' 8-max Seat #2 is the button
Seat 1: leitalopez (44799 in chips) 
Seat 2: Philipoune (61691 in chips) 
Seat 3: Defence_BOMB (32037 in chips) 
Seat 4: Renailmatto (19600 in chips) 
Seat 5: MTTSharkSnG (76900 in chips) 
Seat 6: conradofpg (16965 in chips) 
Seat 7: jammy1875 (116919 in chips) 
Seat 8: oO-HaiRoller-Oo (48800 in chips) 
leitalopez: posts the ante 200
Philipoune: posts the ante 200
Defence_BOMB: posts the ante 200
Renailmatto: posts the ante 200
MTTSharkSnG: posts the ante 200
conradofpg: posts the ante 200
jammy1875: posts the ante 200
oO-HaiRoller-Oo: posts the ante 200
Defence_BOMB: posts small blind 800
Renailmatto: posts big blind 1600
*** HOLE CARDS ***
MTTSharkSnG: folds 
conradofpg: raises 15165 to 16765 and is all-in
jammy1875: raises 19965 to 36730
oO-HaiRoller-Oo: folds 
leitalopez: folds 
Philipoune: folds 
Defence_BOMB: folds 
Renailmatto: folds 
Uncalled bet (19965) returned to jammy1875
*** FLOP *** [3c Qh 2c]
*** TURN *** [3c Qh 2c] [9d]
*** RIVER *** [3c Qh 2c 9d] [2s]
*** SHOW DOWN ***
conradofpg: shows [Jh Js] (two pair, Jacks and Deuces)
jammy1875: shows [9s 9h] (a full house, Nines full of Deuces)
jammy1875 collected 37530 from pot
conradofpg finished the tournament
*** SUMMARY ***
Total pot 37530 | Rake 0 
Board [3c Qh 2c 9d 2s]
Seat 1: leitalopez folded before Flop (didn't bet)
Seat 2: Philipoune (button) folded before Flop (didn't bet)
Seat 3: Defence_BOMB (small blind) folded before Flop
Seat 4: Renailmatto (big blind) folded before Flop
Seat 5: MTTSharkSnG folded before Flop (didn't bet)
Seat 6: conradofpg showed [Jh Js] and lost with two pair, Jacks and Deuces
Seat 7: jammy1875 showed [9s 9h] and won (37530) with a full house, Nines full of Deuces
Seat 8: oO-HaiRoller-Oo folded before Flop (didn't bet)

PokerStars Hand #251205913936: Tournament #3767885527, $40+$10+$5 USD Hold'em No Limit - Level XIII (800/1600) - 2024/06/26 19:26:00 UTC [2024/06/26 15:26:00 ET]
Table '3767885527 58' 8-max Seat #3 is the button
Seat 1: leitalopez (44599 in chips) 
Seat 2: Philipoune (61491 in chips) 
Seat 3: Defence_BOMB (31037 in chips) 
Seat 4: Renailmatto (17800 in chips) 
Seat 5: MTTSharkSnG (76700 in chips) 
Seat 7: jammy1875 (137484 in chips) 
Seat 8: oO-HaiRoller-Oo (48600 in chips) 
leitalopez: posts the ante 200
Philipoune: posts the ante 200
Defence_BOMB: posts the ante 200
Renailmatto: posts the ante 200
MTTSharkSnG: posts the ante 200
jammy1875: posts the ante 200
oO-HaiRoller-Oo: posts the ante 200
Renailmatto: posts small blind 800
MTTSharkSnG: posts big blind 1600
*** HOLE CARDS ***
jammy1875: folds 
oO-HaiRoller-Oo: folds 
leitalopez: raises 1600 to 3200
Philipoune: folds 
Defence_BOMB: raises 27637 to 30837 and is all-in
Renailmatto: folds 
MTTSharkSnG: folds 
leitalopez: folds 
Uncalled bet (27637) returned to Defence_BOMB
Defence_BOMB collected 10200 from pot
Defence_BOMB: doesn't show hand 
*** SUMMARY ***
Total pot 10200 | Rake 0 
Seat 1: leitalopez folded before Flop
Seat 2: Philipoune folded before Flop (didn't bet)
Seat 3: Defence_BOMB (button) collected (10200)
Seat 4: Renailmatto (small blind) folded before Flop
Seat 5: MTTSharkSnG (big blind) folded before Flop
Seat 7: jammy1875 folded before Flop (didn't bet)
Seat 8: oO-HaiRoller-Oo folded before Flop (didn't bet)

PokerStars Hand #251205920621: Tournament #3767885527, $40+$10+$5 USD Hold'em No Limit - Level XIII (800/1600) - 2024/06/26 19:26:25 UTC [2024/06/26 15:26:25 ET]
Table '3767885527 58' 8-max Seat #4 is the button
Seat 1: leitalopez (41199 in chips) 
Seat 2: Philipoune (61291 in chips) 
Seat 3: Defence_BOMB (37837 in chips) 
Seat 4: Renailmatto (16800 in chips) 
Seat 5: MTTSharkSnG (74900 in chips) 
Seat 7: jammy1875 (137284 in chips) 
Seat 8: oO-HaiRoller-Oo (48400 in chips) 
leitalopez: posts the ante 200
Philipoune: posts the ante 200
Defence_BOMB: posts the ante 200
Renailmatto: posts the ante 200
MTTSharkSnG: posts the ante 200
jammy1875: posts the ante 200
oO-HaiRoller-Oo: posts the ante 200
MTTSharkSnG: posts small blind 800
jammy1875: posts big blind 1600
*** HOLE CARDS ***
oO-HaiRoller-Oo: folds 
leitalopez: folds 
Philipoune: raises 1600 to 3200
Defence_BOMB: folds 
Renailmatto: folds 
MTTSharkSnG: folds 
jammy1875: folds 
Uncalled bet (1600) returned to Philipoune
Philipoune collected 5400 from pot
Philipoune: doesn't show hand 
*** SUMMARY ***
Total pot 5400 | Rake 0 
Seat 1: leitalopez folded before Flop (didn't bet)
Seat 2: Philipoune collected (5400)
Seat 3: Defence_BOMB folded before Flop (didn't bet)
Seat 4: Renailmatto (button) folded before Flop (didn't bet)
Seat 5: MTTSharkSnG (small blind) folded before Flop
Seat 7: jammy1875 (big blind) folded before Flop
Seat 8: oO-HaiRoller-Oo folded before Flop (didn't bet)

PokerStars Hand #251205929066: Tournament #3767885527, $40+$10+$5 USD Hold'em No Limit - Level XIII (800/1600) - 2024/06/26 19:26:56 UTC [2024/06/26 15:26:56 ET]
Table '3767885527 58' 8-max Seat #5 is the button
Seat 1: leitalopez (40999 in chips) 
Seat 2: Philipoune (64891 in chips) 
Seat 3: Defence_BOMB (37637 in chips) 
Seat 4: Renailmatto (16600 in chips) 
Seat 5: MTTSharkSnG (73900 in chips) 
Seat 7: jammy1875 (135484 in chips) 
Seat 8: oO-HaiRoller-Oo (48200 in chips) 
leitalopez: posts the ante 200
Philipoune: posts the ante 200
Defence_BOMB: posts the ante 200
Renailmatto: posts the ante 200
MTTSharkSnG: posts the ante 200
jammy1875: posts the ante 200
oO-HaiRoller-Oo: posts the ante 200
jammy1875: posts small blind 800
oO-HaiRoller-Oo: posts big blind 1600
*** HOLE CARDS ***
JovemPromessa is disconnected 
leitalopez: folds 
Philipoune: raises 1600 to 3200
Defence_BOMB: folds 
Renailmatto: folds 
MTTSharkSnG: folds 
jammy1875: raises 8000 to 11200
oO-HaiRoller-Oo: folds 
Philipoune: calls 8000
*** FLOP *** [9s 2s 8c]
jammy1875: bets 9600
Philipoune: calls 9600
*** TURN *** [9s 2s 8c] [5c]
jammy1875: bets 44600
Philipoune: calls 43891 and is all-in
Uncalled bet (709) returned to jammy1875
*** RIVER *** [9s 2s 8c 5c] [As]
*** SHOW DOWN ***
jammy1875: shows [7d 7s] (a pair of Sevens)
Philipoune: shows [9h 9d] (three of a kind, Nines)
Philipoune collected 132382 from pot
*** SUMMARY ***
Total pot 132382 | Rake 0 
Board [9s 2s 8c 5c As]
Seat 1: leitalopez folded before Flop (didn't bet)
Seat 2: Philipoune showed [9h 9d] and won (132382) with three of a kind, Nines
Seat 3: Defence_BOMB folded before Flop (didn't bet)
Seat 4: Renailmatto folded before Flop (didn't bet)
Seat 5: MTTSharkSnG (button) folded before Flop (didn't bet)
Seat 7: jammy1875 (small blind) showed [7d 7s] and lost with a pair of Sevens
Seat 8: oO-HaiRoller-Oo (big blind) folded before Flop

PokerStars Hand #251205954734: Tournament #3767885527, $40+$10+$5 USD Hold'em No Limit - Level XIII (800/1600) - 2024/06/26 19:28:32 UTC [2024/06/26 15:28:32 ET]
Table '3767885527 58' 8-max Seat #7 is the button
Seat 1: leitalopez (40799 in chips) 
Seat 2: Philipoune (132382 in chips) 
Seat 3: Defence_BOMB (37437 in chips) 
Seat 4: Renailmatto (16400 in chips) 
Seat 5: MTTSharkSnG (73700 in chips) 
Seat 6: JovemPromessa (25000 in chips) 
Seat 7: jammy1875 (70593 in chips) 
Seat 8: oO-HaiRoller-Oo (46400 in chips) 
leitalopez: posts the ante 200
Philipoune: posts the ante 200
Defence_BOMB: posts the ante 200
Renailmatto: posts the ante 200
MTTSharkSnG: posts the ante 200
JovemPromessa: posts the ante 200
jammy1875: posts the ante 200
oO-HaiRoller-Oo: posts the ante 200
oO-HaiRoller-Oo: posts small blind 800
leitalopez: posts big blind 1600
*** HOLE CARDS ***
Philipoune: folds 
Defence_BOMB: raises 1920 to 3520
Renailmatto: calls 3520
MTTSharkSnG: folds 
JovemPromessa: raises 20480 to 24000
jammy1875: folds 
oO-HaiRoller-Oo: folds 
leitalopez: folds 
Defence_BOMB: folds 
Renailmatto: calls 12680 and is all-in
Uncalled bet (7800) returned to JovemPromessa
*** FLOP *** [Ac Qh 4s]
*** TURN *** [Ac Qh 4s] [7h]
*** RIVER *** [Ac Qh 4s 7h] [Kh]
*** SHOW DOWN ***
Renailmatto: shows [Th 9h] (a flush, King high)
JovemPromessa: shows [Jh As] (a pair of Aces)
Renailmatto collected 39920 from pot
*** SUMMARY ***
Total pot 39920 | Rake 0 
Board [Ac Qh 4s 7h Kh]
Seat 1: leitalopez (big blind) folded before Flop
Seat 2: Philipoune folded before Flop (didn't bet)
Seat 3: Defence_BOMB folded before Flop
Seat 4: Renailmatto showed [Th 9h] and won (39920) with a flush, King high
Seat 5: MTTSharkSnG folded before Flop (didn't bet)
Seat 6: JovemPromessa showed [Jh As] and lost with a pair of Aces
Seat 7: jammy1875 (button) folded before Flop (didn't bet)
Seat 8: oO-HaiRoller-Oo (small blind) folded before Flop

PokerStars Hand #251205965990: Tournament #3767885527, $40+$10+$5 USD Hold'em No Limit - Level XIV (1000/2000) - 2024/06/26 19:29:14 UTC [2024/06/26 15:29:14 ET]
Table '3767885527 58' 8-max Seat #8 is the button
Seat 1: leitalopez (38999 in chips) 
Seat 2: Philipoune (132182 in chips) 
Seat 3: Defence_BOMB (33717 in chips) 
Seat 4: Renailmatto (39920 in chips) 
Seat 5: MTTSharkSnG (73500 in chips) 
Seat 6: JovemPromessa (8600 in chips) 
Seat 7: jammy1875 (70393 in chips) 
Seat 8: oO-HaiRoller-Oo (45400 in chips) 
leitalopez: posts the ante 250
Philipoune: posts the ante 250
Defence_BOMB: posts the ante 250
Renailmatto: posts the ante 250
MTTSharkSnG: posts the ante 250
JovemPromessa: posts the ante 250
jammy1875: posts the ante 250
oO-HaiRoller-Oo: posts the ante 250
leitalopez: posts small blind 1000
Philipoune: posts big blind 2000
*** HOLE CARDS ***
Defence_BOMB: folds 
Renailmatto: folds 
MTTSharkSnG: folds 
JovemPromessa: folds 
jammy1875: folds 
oO-HaiRoller-Oo: raises 2200 to 4200
leitalopez: raises 34549 to 38749 and is all-in
Philipoune: folds 
oO-HaiRoller-Oo: folds [Kc]
Uncalled bet (34549) returned to leitalopez
leitalopez collected 12400 from pot
leitalopez: doesn't show hand 
*** SUMMARY ***
Total pot 12400 | Rake 0 
Seat 1: leitalopez (small blind) collected (12400)
Seat 2: Philipoune (big blind) folded before Flop
Seat 3: Defence_BOMB folded before Flop (didn't bet)
Seat 4: Renailmatto folded before Flop (didn't bet)
Seat 5: MTTSharkSnG folded before Flop (didn't bet)
Seat 6: JovemPromessa folded before Flop (didn't bet)
Seat 7: jammy1875 folded before Flop (didn't bet)
Seat 8: oO-HaiRoller-Oo (button) folded before Flop

PokerStars Hand #251205979313: Tournament #3767885527, $40+$10+$5 USD Hold'em No Limit - Level XIV (1000/2000) - 2024/06/26 19:30:02 UTC [2024/06/26 15:30:02 ET]
Table '3767885527 58' 8-max Seat #1 is the button
Seat 1: leitalopez (46949 in chips) 
Seat 2: Philipoune (129932 in chips) 
Seat 3: Defence_BOMB (33467 in chips) 
Seat 4: Renailmatto (39670 in chips) 
Seat 5: MTTSharkSnG (73250 in chips) 
Seat 6: JovemPromessa (8350 in chips) 
Seat 7: jammy1875 (70143 in chips) 
Seat 8: oO-HaiRoller-Oo (40950 in chips) 
leitalopez: posts the ante 250
Philipoune: posts the ante 250
Defence_BOMB: posts the ante 250
Renailmatto: posts the ante 250
MTTSharkSnG: posts the ante 250
JovemPromessa: posts the ante 250
jammy1875: posts the ante 250
oO-HaiRoller-Oo: posts the ante 250
Philipoune: posts small blind 1000
Defence_BOMB: posts big blind 2000
*** HOLE CARDS ***
Renailmatto: folds 
MTTSharkSnG: folds 
JovemPromessa: folds 
jammy1875: raises 2000 to 4000
oO-HaiRoller-Oo: folds 
leitalopez: folds 
Philipoune: folds 
Defence_BOMB: raises 29217 to 33217 and is all-in
jammy1875: calls 29217
*** FLOP *** [Kh 2s Th]
*** TURN *** [Kh 2s Th] [3c]
*** RIVER *** [Kh 2s Th 3c] [Jh]
*** SHOW DOWN ***
Defence_BOMB: shows [5s 5h] (a pair of Fives)
jammy1875: shows [Kc Ts] (two pair, Kings and Tens)
jammy1875 collected 69434 from pot
Defence_BOMB finished the tournament
*** SUMMARY ***
Total pot 69434 | Rake 0 
Board [Kh 2s Th 3c Jh]
Seat 1: leitalopez (button) folded before Flop (didn't bet)
Seat 2: Philipoune (small blind) folded before Flop
Seat 3: Defence_BOMB (big blind) showed [5s 5h] and lost with a pair of Fives
Seat 4: Renailmatto folded before Flop (didn't bet)
Seat 5: MTTSharkSnG folded before Flop (didn't bet)
Seat 6: JovemPromessa folded before Flop (didn't bet)
Seat 7: jammy1875 showed [Kc Ts] and won (69434) with two pair, Kings and Tens
Seat 8: oO-HaiRoller-Oo folded before Flop (didn't bet)

PokerStars Hand #251205991436: Tournament #3767885527, $40+$10+$5 USD Hold'em No Limit - Level XIV (1000/2000) - 2024/06/26 19:30:46 UTC [2024/06/26 15:30:46 ET]
Table '3767885527 58' 8-max Seat #2 is the button
Seat 1: leitalopez (46699 in chips) 
Seat 2: Philipoune (128682 in chips) 
Seat 4: Renailmatto (39420 in chips) 
Seat 5: MTTSharkSnG (73000 in chips) 
Seat 6: JovemPromessa (8100 in chips) 
Seat 7: jammy1875 (106110 in chips) 
Seat 8: oO-HaiRoller-Oo (40700 in chips) 
leitalopez: posts the ante 250
Philipoune: posts the ante 250
Renailmatto: posts the ante 250
MTTSharkSnG: posts the ante 250
JovemPromessa: posts the ante 250
jammy1875: posts the ante 250
oO-HaiRoller-Oo: posts the ante 250
Renailmatto: posts small blind 1000
MTTSharkSnG: posts big blind 2000
*** HOLE CARDS ***
JovemPromessa: raises 4000 to 6000
jammy1875: calls 6000
oO-HaiRoller-Oo: folds 
leitalopez: folds 
Philipoune: raises 122432 to 128432 and is all-in
Renailmatto: folds 
MTTSharkSnG: folds 
JovemPromessa: calls 1850 and is all-in
jammy1875: folds 
Uncalled bet (120582) returned to Philipoune
*** FLOP *** [2d 8d 4c]
*** TURN *** [2d 8d 4c] [5d]
*** RIVER *** [2d 8d 4c 5d] [7h]
*** SHOW DOWN ***
JovemPromessa: shows [Jc Ac] (high card Ace)
Philipoune: shows [9s 9h] (a pair of Nines)
Philipoune collected 26450 from pot
JovemPromessa finished the tournament
*** SUMMARY ***
Total pot 26450 | Rake 0 
Board [2d 8d 4c 5d 7h]
Seat 1: leitalopez folded before Flop (didn't bet)
Seat 2: Philipoune (button) showed [9s 9h] and won (26450) with a pair of Nines
Seat 4: Renailmatto (small blind) folded before Flop
Seat 5: MTTSharkSnG (big blind) folded before Flop
Seat 6: JovemPromessa showed [Jc Ac] and lost with high card Ace
Seat 7: jammy1875 folded before Flop
Seat 8: oO-HaiRoller-Oo folded before Flop (didn't bet)

PokerStars Hand #251205999281: Tournament #3767885527, $40+$10+$5 USD Hold'em No Limit - Level XIV (1000/2000) - 2024/06/26 19:31:15 UTC [2024/06/26 15:31:15 ET]
Table '3767885527 58' 8-max Seat #4 is the button
Seat 1: leitalopez (46449 in chips) 
Seat 2: Philipoune (147032 in chips) 
Seat 4: Renailmatto (38170 in chips) 
Seat 5: MTTSharkSnG (70750 in chips) 
Seat 7: jammy1875 (99860 in chips) 
Seat 8: oO-HaiRoller-Oo (40450 in chips) 
leitalopez: posts the ante 250
Philipoune: posts the ante 250
Renailmatto: posts the ante 250
MTTSharkSnG: posts the ante 250
jammy1875: posts the ante 250
oO-HaiRoller-Oo: posts the ante 250
MTTSharkSnG: posts small blind 1000
jammy1875: posts big blind 2000
*** HOLE CARDS ***
jeyun is disconnected 
oO-HaiRoller-Oo: raises 2200 to 4200
leitalopez: folds 
Philipoune: folds 
Renailmatto: folds 
MTTSharkSnG: folds 
jammy1875: folds 
Uncalled bet (2200) returned to oO-HaiRoller-Oo
oO-HaiRoller-Oo collected 6500 from pot
oO-HaiRoller-Oo: doesn't show hand 
tarantullv is disconnected 
*** SUMMARY ***
Total pot 6500 | Rake 0 
Seat 1: leitalopez folded before Flop (didn't bet)
Seat 2: Philipoune folded before Flop (didn't bet)
Seat 4: Renailmatto (button) folded before Flop (didn't bet)
Seat 5: MTTSharkSnG (small blind) folded before Flop
Seat 7: jammy1875 (big blind) folded before Flop
Seat 8: oO-HaiRoller-Oo collected (6500)

PokerStars Hand #251206003860: Tournament #3767885527, $40+$10+$5 USD Hold'em No Limit - Level XIV (1000/2000) - 2024/06/26 19:31:31 UTC [2024/06/26 15:31:31 ET]
Table '3767885527 58' 8-max Seat #5 is the button
Seat 1: leitalopez (46199 in chips) 
Seat 2: Philipoune (146782 in chips) 
Seat 3: jeyun (38917 in chips) 
Seat 4: Renailmatto (37920 in chips) 
Seat 5: MTTSharkSnG (69500 in chips) 
Seat 6: tarantullv (25000 in chips) out of hand (moved from another table into small blind)
Seat 7: jammy1875 (97610 in chips) 
Seat 8: oO-HaiRoller-Oo (44700 in chips) 
tarantullv will be allowed to play after the button
leitalopez: posts the ante 250
Philipoune: posts the ante 250
jeyun: posts the ante 250
Renailmatto: posts the ante 250
MTTSharkSnG: posts the ante 250
jammy1875: posts the ante 250
oO-HaiRoller-Oo: posts the ante 250
jammy1875: posts small blind 1000
oO-HaiRoller-Oo: posts big blind 2000
*** HOLE CARDS ***
leitalopez: folds 
Philipoune: folds 
jeyun: raises 2000 to 4000
Renailmatto: folds 
MTTSharkSnG: folds 
jammy1875: folds 
oO-HaiRoller-Oo: calls 2000
*** FLOP *** [Td 6s 3s]
oO-HaiRoller-Oo: checks 
jeyun: bets 3548
oO-HaiRoller-Oo: folds 
Uncalled bet (3548) returned to jeyun
jeyun collected 10750 from pot
*** SUMMARY ***
Total pot 10750 | Rake 0 
Board [Td 6s 3s]
Seat 1: leitalopez folded before Flop (didn't bet)
Seat 2: Philipoune folded before Flop (didn't bet)
Seat 3: jeyun collected (10750)
Seat 4: Renailmatto folded before Flop (didn't bet)
Seat 5: MTTSharkSnG (button) folded before Flop (didn't bet)
Seat 7: jammy1875 (small blind) folded before Flop
Seat 8: oO-HaiRoller-Oo (big blind) folded on the Flop

PokerStars Hand #251206017275: Tournament #3767885527, $40+$10+$5 USD Hold'em No Limit - Level XIV (1000/2000) - 2024/06/26 19:32:20 UTC [2024/06/26 15:32:20 ET]
Table '3767885527 58' 8-max Seat #7 is the button
Seat 1: leitalopez (45949 in chips) 
Seat 2: Philipoune (146532 in chips) 
Seat 3: jeyun (45417 in chips) 
Seat 4: Renailmatto (37670 in chips) 
Seat 5: MTTSharkSnG (69250 in chips) 
Seat 6: tarantullv (25000 in chips) 
Seat 7: jammy1875 (96360 in chips) 
Seat 8: oO-HaiRoller-Oo (40450 in chips) 
leitalopez: posts the ante 250
Philipoune: posts the ante 250
jeyun: posts the ante 250
Renailmatto: posts the ante 250
MTTSharkSnG: posts the ante 250
tarantullv: posts the ante 250
jammy1875: posts the ante 250
oO-HaiRoller-Oo: posts the ante 250
oO-HaiRoller-Oo: posts small blind 1000
leitalopez: posts big blind 2000
*** HOLE CARDS ***
Philipoune: folds 
jeyun: folds 
Renailmatto: folds 
MTTSharkSnG: raises 2000 to 4000
tarantullv: raises 20750 to 24750 and is all-in
jammy1875: folds 
oO-HaiRoller-Oo: folds 
leitalopez: folds 
MTTSharkSnG: folds 
Uncalled bet (20750) returned to tarantullv
tarantullv collected 13000 from pot
tarantullv: doesn't show hand 
*** SUMMARY ***
Total pot 13000 | Rake 0 
Seat 1: leitalopez (big blind) folded before Flop
Seat 2: Philipoune folded before Flop (didn't bet)
Seat 3: jeyun folded before Flop (didn't bet)
Seat 4: Renailmatto folded before Flop (didn't bet)
Seat 5: MTTSharkSnG folded before Flop
Seat 6: tarantullv collected (13000)
Seat 7: jammy1875 (button) folded before Flop (didn't bet)
Seat 8: oO-HaiRoller-Oo (small blind) folded before Flop

PokerStars Hand #251206024916: Tournament #3767885527, $40+$10+$5 USD Hold'em No Limit - Level XIV (1000/2000) - 2024/06/26 19:32:48 UTC [2024/06/26 15:32:48 ET]
Table '3767885527 58' 8-max Seat #8 is the button
Seat 1: leitalopez (43699 in chips) 
Seat 2: Philipoune (146282 in chips) 
Seat 3: jeyun (45167 in chips) 
Seat 4: Renailmatto (37420 in chips) 
Seat 5: MTTSharkSnG (65000 in chips) 
Seat 6: tarantullv (33750 in chips) 
Seat 7: jammy1875 (96110 in chips) 
Seat 8: oO-HaiRoller-Oo (39200 in chips) 
leitalopez: posts the ante 250
Philipoune: posts the ante 250
jeyun: posts the ante 250
Renailmatto: posts the ante 250
MTTSharkSnG: posts the ante 250
tarantullv: posts the ante 250
jammy1875: posts the ante 250
oO-HaiRoller-Oo: posts the ante 250
leitalopez: posts small blind 1000
Philipoune: posts big blind 2000
*** HOLE CARDS ***
jeyun: folds 
Renailmatto: folds 
MTTSharkSnG: folds 
tarantullv: folds 
jammy1875: folds 
oO-HaiRoller-Oo: raises 36950 to 38950 and is all-in
leitalopez: folds 
Philipoune: folds 
Uncalled bet (36950) returned to oO-HaiRoller-Oo
oO-HaiRoller-Oo collected 7000 from pot
oO-HaiRoller-Oo: doesn't show hand 
*** SUMMARY ***
Total pot 7000 | Rake 0 
Seat 1: leitalopez (small blind) folded before Flop
Seat 2: Philipoune (big blind) folded before Flop
Seat 3: jeyun folded before Flop (didn't bet)
Seat 4: Renailmatto folded before Flop (didn't bet)
Seat 5: MTTSharkSnG folded before Flop (didn't bet)
Seat 6: tarantullv folded before Flop (didn't bet)
Seat 7: jammy1875 folded before Flop (didn't bet)
Seat 8: oO-HaiRoller-Oo (button) collected (7000)

PokerStars Hand #251206029154: Tournament #3767885527, $40+$10+$5 USD Hold'em No Limit - Level XIV (1000/2000) - 2024/06/26 19:33:04 UTC [2024/06/26 15:33:04 ET]
Table '3767885527 58' 8-max Seat #1 is the button
Seat 1: leitalopez (42449 in chips) 
Seat 2: Philipoune (144032 in chips) 
Seat 3: jeyun (44917 in chips) 
Seat 4: Renailmatto (37170 in chips) 
Seat 5: MTTSharkSnG (64750 in chips) 
Seat 6: tarantullv (33500 in chips) 
Seat 7: jammy1875 (95860 in chips) 
Seat 8: oO-HaiRoller-Oo (43950 in chips) 
leitalopez: posts the ante 250
Philipoune: posts the ante 250
jeyun: posts the ante 250
Renailmatto: posts the ante 250
MTTSharkSnG: posts the ante 250
tarantullv: posts the ante 250
jammy1875: posts the ante 250
oO-HaiRoller-Oo: posts the ante 250
Philipoune: posts small blind 1000
jeyun: posts big blind 2000
*** HOLE CARDS ***
Renailmatto: folds 
MTTSharkSnG: raises 2000 to 4000
tarantullv: folds 
jammy1875: calls 4000
oO-HaiRoller-Oo: folds 
leitalopez: folds 
Philipoune: folds 
jeyun: calls 2000
*** FLOP *** [Ac As 6c]
jeyun: checks 
MTTSharkSnG: bets 4318
jammy1875: calls 4318
jeyun: folds 
*** TURN *** [Ac As 6c] [Qs]
MTTSharkSnG: bets 8758
jammy1875: calls 8758
*** RIVER *** [Ac As 6c Qs] [9c]
MTTSharkSnG: checks 
jammy1875: bets 22576
MTTSharkSnG: folds 
Uncalled bet (22576) returned to jammy1875
jammy1875 collected 41152 from pot
*** SUMMARY ***
Total pot 41152 | Rake 0 
Board [Ac As 6c Qs 9c]
Seat 1: leitalopez (button) folded before Flop (didn't bet)
Seat 2: Philipoune (small blind) folded before Flop
Seat 3: jeyun (big blind) folded on the Flop
Seat 4: Renailmatto folded before Flop (didn't bet)
Seat 5: MTTSharkSnG folded on the River
Seat 6: tarantullv folded before Flop (didn't bet)
Seat 7: jammy1875 collected (41152)
Seat 8: oO-HaiRoller-Oo folded before Flop (didn't bet)

PokerStars Hand #251206061077: Tournament #3767885527, $40+$10+$5 USD Hold'em No Limit - Level XIV (1000/2000) - 2024/06/26 19:35:00 UTC [2024/06/26 15:35:00 ET]
Table '3767885527 58' 8-max Seat #2 is the button
Seat 1: leitalopez (42199 in chips) 
Seat 2: Philipoune (142782 in chips) 
Seat 3: jeyun (40667 in chips) 
Seat 4: Renailmatto (36920 in chips) 
Seat 5: MTTSharkSnG (47424 in chips) 
Seat 6: tarantullv (33250 in chips) 
Seat 7: jammy1875 (119686 in chips) 
Seat 8: oO-HaiRoller-Oo (43700 in chips) 
leitalopez: posts the ante 250
Philipoune: posts the ante 250
jeyun: posts the ante 250
Renailmatto: posts the ante 250
MTTSharkSnG: posts the ante 250
tarantullv: posts the ante 250
jammy1875: posts the ante 250
oO-HaiRoller-Oo: posts the ante 250
jeyun: posts small blind 1000
Renailmatto: posts big blind 2000
*** HOLE CARDS ***
MTTSharkSnG: folds 
tarantullv: folds 
jammy1875: raises 2000 to 4000
oO-HaiRoller-Oo: folds 
leitalopez: folds 
Philipoune: folds 
jeyun: raises 36417 to 40417 and is all-in
Renailmatto: folds 
jammy1875: folds 
Uncalled bet (36417) returned to jeyun
jeyun collected 12000 from pot
*** SUMMARY ***
Total pot 12000 | Rake 0 
Seat 1: leitalopez folded before Flop (didn't bet)
Seat 2: Philipoune (button) folded before Flop (didn't bet)
Seat 3: jeyun (small blind) collected (12000)
Seat 4: Renailmatto (big blind) folded before Flop
Seat 5: MTTSharkSnG folded before Flop (didn't bet)
Seat 6: tarantullv folded before Flop (didn't bet)
Seat 7: jammy1875 folded before Flop
Seat 8: oO-HaiRoller-Oo folded before Flop (didn't bet)

PokerStars Hand #251206071448: Tournament #3767885527, $40+$10+$5 USD Hold'em No Limit - Level XIV (1000/2000) - 2024/06/26 19:35:38 UTC [2024/06/26 15:35:38 ET]
Table '3767885527 58' 8-max Seat #3 is the button
Seat 1: leitalopez (41949 in chips) 
Seat 2: Philipoune (142532 in chips) 
Seat 3: jeyun (48417 in chips) 
Seat 4: Renailmatto (34670 in chips) 
Seat 5: MTTSharkSnG (47174 in chips) 
Seat 6: tarantullv (33000 in chips) 
Seat 7: jammy1875 (115436 in chips) 
Seat 8: oO-HaiRoller-Oo (43450 in chips) 
leitalopez: posts the ante 250
Philipoune: posts the ante 250
jeyun: posts the ante 250
Renailmatto: posts the ante 250
MTTSharkSnG: posts the ante 250
tarantullv: posts the ante 250
jammy1875: posts the ante 250
oO-HaiRoller-Oo: posts the ante 250
Renailmatto: posts small blind 1000
MTTSharkSnG: posts big blind 2000
*** HOLE CARDS ***
tarantullv: folds 
jammy1875: folds 
oO-HaiRoller-Oo: raises 2200 to 4200
leitalopez: folds 
Philipoune: folds 
jeyun: folds 
Renailmatto: calls 3200
MTTSharkSnG: calls 2200
*** FLOP *** [6s Ts Ah]
Renailmatto: checks 
MTTSharkSnG: checks 
oO-HaiRoller-Oo: bets 6000
Renailmatto: folds 
MTTSharkSnG: folds 
Uncalled bet (6000) returned to oO-HaiRoller-Oo
oO-HaiRoller-Oo collected 14600 from pot
oO-HaiRoller-Oo: doesn't show hand 
*** SUMMARY ***
Total pot 14600 | Rake 0 
Board [6s Ts Ah]
Seat 1: leitalopez folded before Flop (didn't bet)
Seat 2: Philipoune folded before Flop (didn't bet)
Seat 3: jeyun (button) folded before Flop (didn't bet)
Seat 4: Renailmatto (small blind) folded on the Flop
Seat 5: MTTSharkSnG (big blind) folded on the Flop
Seat 6: tarantullv folded before Flop (didn't bet)
Seat 7: jammy1875 folded before Flop (didn't bet)
Seat 8: oO-HaiRoller-Oo collected (14600)

PokerStars Hand #251206081406: Tournament #3767885527, $40+$10+$5 USD Hold'em No Limit - Level XIV (1000/2000) - 2024/06/26 19:36:14 UTC [2024/06/26 15:36:14 ET]
Table '3767885527 58' 8-max Seat #4 is the button
Seat 1: leitalopez (41699 in chips) 
Seat 2: Philipoune (142282 in chips) 
Seat 3: jeyun (48167 in chips) 
Seat 4: Renailmatto (30220 in chips) 
Seat 5: MTTSharkSnG (42724 in chips) 
Seat 6: tarantullv (32750 in chips) 
Seat 7: jammy1875 (115186 in chips) 
Seat 8: oO-HaiRoller-Oo (53600 in chips) 
leitalopez: posts the ante 250
Philipoune: posts the ante 250
jeyun: posts the ante 250
Renailmatto: posts the ante 250
MTTSharkSnG: posts the ante 250
tarantullv: posts the ante 250
jammy1875: posts the ante 250
oO-HaiRoller-Oo: posts the ante 250
MTTSharkSnG: posts small blind 1000
tarantullv: posts big blind 2000
*** HOLE CARDS ***
jammy1875: folds 
oO-HaiRoller-Oo: folds 
leitalopez: folds 
Philipoune: folds 
jeyun: folds 
Renailmatto: folds 
MTTSharkSnG: folds 
Uncalled bet (1000) returned to tarantullv
tarantullv collected 4000 from pot
tarantullv: doesn't show hand 
*** SUMMARY ***
Total pot 4000 | Rake 0 
Seat 1: leitalopez folded before Flop (didn't bet)
Seat 2: Philipoune folded before Flop (didn't bet)
Seat 3: jeyun folded before Flop (didn't bet)
Seat 4: Renailmatto (button) folded before Flop (didn't bet)
Seat 5: MTTSharkSnG (small blind) folded before Flop
Seat 6: tarantullv (big blind) collected (4000)
Seat 7: jammy1875 folded before Flop (didn't bet)
Seat 8: oO-HaiRoller-Oo folded before Flop (didn't bet)

PokerStars Hand #251206083960: Tournament #3767885527, $40+$10+$5 USD Hold'em No Limit - Level XIV (1000/2000) - 2024/06/26 19:36:24 UTC [2024/06/26 15:36:24 ET]
Table '3767885527 58' 8-max Seat #5 is the button
Seat 1: leitalopez (41449 in chips) 
Seat 2: Philipoune (142032 in chips) 
Seat 3: jeyun (47917 in chips) 
Seat 4: Renailmatto (29970 in chips) 
Seat 5: MTTSharkSnG (41474 in chips) 
Seat 6: tarantullv (35500 in chips) 
Seat 7: jammy1875 (114936 in chips) 
Seat 8: oO-HaiRoller-Oo (53350 in chips) 
leitalopez: posts the ante 250
Philipoune: posts the ante 250
jeyun: posts the ante 250
Renailmatto: posts the ante 250
MTTSharkSnG: posts the ante 250
tarantullv: posts the ante 250
jammy1875: posts the ante 250
oO-HaiRoller-Oo: posts the ante 250
tarantullv: posts small blind 1000
jammy1875: posts big blind 2000
*** HOLE CARDS ***
oO-HaiRoller-Oo: folds 
leitalopez: raises 2000 to 4000
Philipoune: folds 
jeyun: folds 
Renailmatto: folds 
MTTSharkSnG: folds 
tarantullv: folds 
jammy1875: raises 110686 to 114686 and is all-in
leitalopez: calls 37199 and is all-in
Uncalled bet (73487) returned to jammy1875
*** FLOP *** [Ks 6c 4s]
*** TURN *** [Ks 6c 4s] [3h]
*** RIVER *** [Ks 6c 4s 3h] [2h]
*** SHOW DOWN ***
jammy1875: shows [2d 2c] (three of a kind, Deuces)
leitalopez: shows [Tc Td] (a pair of Tens)
jammy1875 collected 85398 from pot
leitalopez finished the tournament in 645th place
*** SUMMARY ***
Total pot 85398 | Rake 0 
Board [Ks 6c 4s 3h 2h]
Seat 1: leitalopez showed [Tc Td] and lost with a pair of Tens
Seat 2: Philipoune folded before Flop (didn't bet)
Seat 3: jeyun folded before Flop (didn't bet)
Seat 4: Renailmatto folded before Flop (didn't bet)
Seat 5: MTTSharkSnG (button) folded before Flop (didn't bet)
Seat 6: tarantullv (small blind) folded before Flop
Seat 7: jammy1875 (big blind) showed [2d 2c] and won (85398) with three of a kind, Deuces
Seat 8: oO-HaiRoller-Oo folded before Flop (didn't bet)


PokerStars Hand #251206681673: Tournament #3767885527, $40+$10+$5 USD Hold'em No Limit - Level XVII (1750/3500) - 2024/06/26 20:13:26 UTC [2024/06/26 16:13:26 ET]
Table '3767885527 57' 8-max Seat #1 is the button
Seat 1: yaniw777 (117541 in chips) 
Seat 2: LV_Arturs (62787 in chips) 
Seat 3: fellipeschmeil (55233 in chips) 
Seat 4: chuchukat (271199 in chips) 
Seat 5: lftgjc (137479 in chips) 
Seat 6: PavanaTTo23 (28951 in chips) 
Seat 7: drinho2pac (89661 in chips) 
Seat 8: Pedrozadota (111334 in chips) 
yaniw777: posts the ante 450
LV_Arturs: posts the ante 450
fellipeschmeil: posts the ante 450
chuchukat: posts the ante 450
lftgjc: posts the ante 450
PavanaTTo23: posts the ante 450
drinho2pac: posts the ante 450
Pedrozadota: posts the ante 450
LV_Arturs: posts small blind 1750
fellipeschmeil: posts big blind 3500
*** HOLE CARDS ***
chuchukat: raises 3500 to 7000
lftgjc: folds 
PavanaTTo23: folds 
drinho2pac: folds 
Pedrozadota: raises 3500 to 10500
yaniw777: folds 
LV_Arturs: folds 
fellipeschmeil: folds 
chuchukat: raises 260249 to 270749 and is all-in
Pedrozadota: folds 
Uncalled bet (260249) returned to chuchukat
chuchukat collected 29850 from pot
chuchukat: doesn't show hand 
*** SUMMARY ***
Total pot 29850 | Rake 0 
Seat 1: yaniw777 (button) folded before Flop (didn't bet)
Seat 2: LV_Arturs (small blind) folded before Flop
Seat 3: fellipeschmeil (big blind) folded before Flop
Seat 4: chuchukat collected (29850)
Seat 5: lftgjc folded before Flop (didn't bet)
Seat 6: PavanaTTo23 folded before Flop (didn't bet)
Seat 7: drinho2pac folded before Flop (didn't bet)
Seat 8: Pedrozadota folded before Flop

PokerStars Hand #251206693722: Tournament #3767885527, $40+$10+$5 USD Hold'em No Limit - Level XVII (1750/3500) - 2024/06/26 20:14:10 UTC [2024/06/26 16:14:10 ET]
Table '3767885527 57' 8-max Seat #2 is the button
Seat 1: yaniw777 (117091 in chips) 
Seat 2: LV_Arturs (60587 in chips) 
Seat 3: fellipeschmeil (51283 in chips) 
Seat 4: chuchukat (290099 in chips) 
Seat 5: lftgjc (137029 in chips) 
Seat 6: PavanaTTo23 (28501 in chips) 
Seat 7: drinho2pac (89211 in chips) 
Seat 8: Pedrozadota (100384 in chips) 
yaniw777: posts the ante 450
LV_Arturs: posts the ante 450
fellipeschmeil: posts the ante 450
chuchukat: posts the ante 450
lftgjc: posts the ante 450
PavanaTTo23: posts the ante 450
drinho2pac: posts the ante 450
Pedrozadota: posts the ante 450
fellipeschmeil: posts small blind 1750
chuchukat: posts big blind 3500
*** HOLE CARDS ***
lftgjc: folds 
PavanaTTo23: folds 
drinho2pac: raises 3850 to 7350
Pedrozadota: folds 
yaniw777: folds 
LV_Arturs: calls 7350
fellipeschmeil: folds 
chuchukat: folds 
*** FLOP *** [3h 7d 7c]
drinho2pac: checks 
LV_Arturs: checks 
*** TURN *** [3h 7d 7c] [9s]
drinho2pac: checks 
LV_Arturs: bets 7065
drinho2pac: calls 7065
*** RIVER *** [3h 7d 7c 9s] [5s]
drinho2pac: checks 
LV_Arturs: checks 
*** SHOW DOWN ***
drinho2pac: shows [Td Ad] (a pair of Sevens)
LV_Arturs: shows [As 3s] (two pair, Sevens and Threes)
LV_Arturs collected 37680 from pot
*** SUMMARY ***
Total pot 37680 | Rake 0 
Board [3h 7d 7c 9s 5s]
Seat 1: yaniw777 folded before Flop (didn't bet)
Seat 2: LV_Arturs (button) showed [As 3s] and won (37680) with two pair, Sevens and Threes
Seat 3: fellipeschmeil (small blind) folded before Flop
Seat 4: chuchukat (big blind) folded before Flop
Seat 5: lftgjc folded before Flop (didn't bet)
Seat 6: PavanaTTo23 folded before Flop (didn't bet)
Seat 7: drinho2pac showed [Td Ad] and lost with a pair of Sevens
Seat 8: Pedrozadota folded before Flop (didn't bet)

PokerStars Hand #251206715099: Tournament #3767885527, $40+$10+$5 USD Hold'em No Limit - Level XVII (1750/3500) - 2024/06/26 20:15:25 UTC [2024/06/26 16:15:25 ET]
Table '3767885527 57' 8-max Seat #3 is the button
Seat 1: yaniw777 (116641 in chips) 
Seat 2: LV_Arturs (83402 in chips) 
Seat 3: fellipeschmeil (49083 in chips) 
Seat 4: chuchukat (286149 in chips) 
Seat 5: lftgjc (136579 in chips) 
Seat 6: PavanaTTo23 (28051 in chips) 
Seat 7: drinho2pac (74346 in chips) 
Seat 8: Pedrozadota (99934 in chips) 
yaniw777: posts the ante 450
LV_Arturs: posts the ante 450
fellipeschmeil: posts the ante 450
chuchukat: posts the ante 450
lftgjc: posts the ante 450
PavanaTTo23: posts the ante 450
drinho2pac: posts the ante 450
Pedrozadota: posts the ante 450
chuchukat: posts small blind 1750
lftgjc: posts big blind 3500
*** HOLE CARDS ***
PavanaTTo23: folds 
drinho2pac: folds 
Pedrozadota: folds 
yaniw777: folds 
LV_Arturs: raises 3675 to 7175
fellipeschmeil: folds 
chuchukat: folds 
lftgjc: calls 3675
*** FLOP *** [7c 8s Qh]
lftgjc: checks 
LV_Arturs: checks 
*** TURN *** [7c 8s Qh] [Kd]
lftgjc: checks 
LV_Arturs: bets 12250
lftgjc: folds 
Uncalled bet (12250) returned to LV_Arturs
LV_Arturs collected 19700 from pot
*** SUMMARY ***
Total pot 19700 | Rake 0 
Board [7c 8s Qh Kd]
Seat 1: yaniw777 folded before Flop (didn't bet)
Seat 2: LV_Arturs collected (19700)
Seat 3: fellipeschmeil (button) folded before Flop (didn't bet)
Seat 4: chuchukat (small blind) folded before Flop
Seat 5: lftgjc (big blind) folded on the Turn
Seat 6: PavanaTTo23 folded before Flop (didn't bet)
Seat 7: drinho2pac folded before Flop (didn't bet)
Seat 8: Pedrozadota folded before Flop (didn't bet)

PokerStars Hand #251206737415: Tournament #3767885527, $40+$10+$5 USD Hold'em No Limit - Level XVIII (2000/4000) - 2024/06/26 20:16:45 UTC [2024/06/26 16:16:45 ET]
Table '3767885527 57' 8-max Seat #4 is the button
Seat 1: yaniw777 (116191 in chips) 
Seat 2: LV_Arturs (95477 in chips) 
Seat 3: fellipeschmeil (48633 in chips) 
Seat 4: chuchukat (283949 in chips) 
Seat 5: lftgjc (128954 in chips) 
Seat 6: PavanaTTo23 (27601 in chips) 
Seat 7: drinho2pac (73896 in chips) 
Seat 8: Pedrozadota (99484 in chips) 
yaniw777: posts the ante 500
LV_Arturs: posts the ante 500
fellipeschmeil: posts the ante 500
chuchukat: posts the ante 500
lftgjc: posts the ante 500
PavanaTTo23: posts the ante 500
drinho2pac: posts the ante 500
Pedrozadota: posts the ante 500
lftgjc: posts small blind 2000
PavanaTTo23: posts big blind 4000
*** HOLE CARDS ***
drinho2pac: folds 
Pedrozadota: folds 
yaniw777: raises 4400 to 8400
LV_Arturs: folds 
fellipeschmeil: folds 
chuchukat: folds 
lftgjc: folds 
PavanaTTo23: calls 4400
*** FLOP *** [2c Qd 6h]
PavanaTTo23: bets 18701 and is all-in
yaniw777: calls 18701
*** TURN *** [2c Qd 6h] [9h]
*** RIVER *** [2c Qd 6h 9h] [Qs]
*** SHOW DOWN ***
PavanaTTo23: shows [4d 3c] (a pair of Queens)
yaniw777: shows [Ac Js] (a pair of Queens - Ace kicker)
yaniw777 collected 60202 from pot
PavanaTTo23 finished the tournament in 344th place
*** SUMMARY ***
Total pot 60202 | Rake 0 
Board [2c Qd 6h 9h Qs]
Seat 1: yaniw777 showed [Ac Js] and won (60202) with a pair of Queens
Seat 2: LV_Arturs folded before Flop (didn't bet)
Seat 3: fellipeschmeil folded before Flop (didn't bet)
Seat 4: chuchukat (button) folded before Flop (didn't bet)
Seat 5: lftgjc (small blind) folded before Flop
Seat 6: PavanaTTo23 (big blind) showed [4d 3c] and lost with a pair of Queens
Seat 7: drinho2pac folded before Flop (didn't bet)
Seat 8: Pedrozadota folded before Flop (didn't bet)

PokerStars Hand #251206752041: Tournament #3767885527, $40+$10+$5 USD Hold'em No Limit - Level XVIII (2000/4000) - 2024/06/26 20:17:38 UTC [2024/06/26 16:17:38 ET]
Table '3767885527 57' 8-max Seat #5 is the button
Seat 1: yaniw777 (148792 in chips) 
Seat 2: LV_Arturs (94977 in chips) 
Seat 3: fellipeschmeil (48133 in chips) 
Seat 4: chuchukat (283449 in chips) 
Seat 5: lftgjc (126454 in chips) 
Seat 7: drinho2pac (73396 in chips) 
Seat 8: Pedrozadota (98984 in chips) 
yaniw777: posts the ante 500
LV_Arturs: posts the ante 500
fellipeschmeil: posts the ante 500
chuchukat: posts the ante 500
lftgjc: posts the ante 500
drinho2pac: posts the ante 500
Pedrozadota: posts the ante 500
drinho2pac: posts small blind 2000
Pedrozadota: posts big blind 4000
*** HOLE CARDS ***
yaniw777: raises 4400 to 8400
LV_Arturs: folds 
fellipeschmeil: folds 
chuchukat: calls 8400
lftgjc: raises 18000 to 26400
vip_1985Z is disconnected 
drinho2pac: folds 
Pedrozadota: folds 
yaniw777: folds 
chuchukat: folds 
Uncalled bet (18000) returned to lftgjc
lftgjc collected 34700 from pot
lftgjc: doesn't show hand 
*** SUMMARY ***
Total pot 34700 | Rake 0 
Seat 1: yaniw777 folded before Flop
Seat 2: LV_Arturs folded before Flop (didn't bet)
Seat 3: fellipeschmeil folded before Flop (didn't bet)
Seat 4: chuchukat folded before Flop
Seat 5: lftgjc (button) collected (34700)
Seat 7: drinho2pac (small blind) folded before Flop
Seat 8: Pedrozadota (big blind) folded before Flop

PokerStars Hand #251206765771: Tournament #3767885527, $40+$10+$5 USD Hold'em No Limit - Level XVIII (2000/4000) - 2024/06/26 20:18:26 UTC [2024/06/26 16:18:26 ET]
Table '3767885527 57' 8-max Seat #7 is the button
Seat 1: yaniw777 (139892 in chips) 
Seat 2: LV_Arturs (94477 in chips) 
Seat 3: fellipeschmeil (47633 in chips) 
Seat 4: chuchukat (274549 in chips) 
Seat 5: lftgjc (152254 in chips) 
Seat 6: vip_1985Z (36634 in chips) 
Seat 7: drinho2pac (70896 in chips) 
Seat 8: Pedrozadota (94484 in chips) 
yaniw777: posts the ante 500
LV_Arturs: posts the ante 500
fellipeschmeil: posts the ante 500
chuchukat: posts the ante 500
lftgjc: posts the ante 500
vip_1985Z: posts the ante 500
drinho2pac: posts the ante 500
Pedrozadota: posts the ante 500
Pedrozadota: posts small blind 2000
yaniw777: posts big blind 4000
*** HOLE CARDS ***
LV_Arturs: folds 
fellipeschmeil: folds 
chuchukat: folds 
lftgjc: folds 
vip_1985Z: folds 
drinho2pac: raises 4400 to 8400
Pedrozadota: folds 
yaniw777: folds 
Uncalled bet (4400) returned to drinho2pac
drinho2pac collected 14000 from pot
*** SUMMARY ***
Total pot 14000 | Rake 0 
Seat 1: yaniw777 (big blind) folded before Flop
Seat 2: LV_Arturs folded before Flop (didn't bet)
Seat 3: fellipeschmeil folded before Flop (didn't bet)
Seat 4: chuchukat folded before Flop (didn't bet)
Seat 5: lftgjc folded before Flop (didn't bet)
Seat 6: vip_1985Z folded before Flop (didn't bet)
Seat 7: drinho2pac (button) collected (14000)
Seat 8: Pedrozadota (small blind) folded before Flop

PokerStars Hand #251206777375: Tournament #3767885527, $40+$10+$5 USD Hold'em No Limit - Level XVIII (2000/4000) - 2024/06/26 20:19:07 UTC [2024/06/26 16:19:07 ET]
Table '3767885527 57' 8-max Seat #8 is the button
Seat 1: yaniw777 (135392 in chips) 
Seat 2: LV_Arturs (93977 in chips) 
Seat 3: fellipeschmeil (47133 in chips) 
Seat 4: chuchukat (274049 in chips) 
Seat 5: lftgjc (151754 in chips) 
Seat 6: vip_1985Z (36134 in chips) 
Seat 7: drinho2pac (80396 in chips) 
Seat 8: Pedrozadota (91984 in chips) 
yaniw777: posts the ante 500
LV_Arturs: posts the ante 500
fellipeschmeil: posts the ante 500
chuchukat: posts the ante 500
lftgjc: posts the ante 500
vip_1985Z: posts the ante 500
drinho2pac: posts the ante 500
Pedrozadota: posts the ante 500
yaniw777: posts small blind 2000
LV_Arturs: posts big blind 4000
*** HOLE CARDS ***
fellipeschmeil: folds 
chuchukat: folds 
lftgjc: folds 
vip_1985Z: folds 
drinho2pac: folds 
Pedrozadota: folds 
yaniw777: folds 
Uncalled bet (2000) returned to LV_Arturs
LV_Arturs collected 8000 from pot
*** SUMMARY ***
Total pot 8000 | Rake 0 
Seat 1: yaniw777 (small blind) folded before Flop
Seat 2: LV_Arturs (big blind) collected (8000)
Seat 3: fellipeschmeil folded before Flop (didn't bet)
Seat 4: chuchukat folded before Flop (didn't bet)
Seat 5: lftgjc folded before Flop (didn't bet)
Seat 6: vip_1985Z folded before Flop (didn't bet)
Seat 7: drinho2pac folded before Flop (didn't bet)
Seat 8: Pedrozadota (button) folded before Flop (didn't bet)

PokerStars Hand #251206785934: Tournament #3767885527, $40+$10+$5 USD Hold'em No Limit - Level XVIII (2000/4000) - 2024/06/26 20:19:38 UTC [2024/06/26 16:19:38 ET]
Table '3767885527 57' 8-max Seat #1 is the button
Seat 1: yaniw777 (132892 in chips) 
Seat 2: LV_Arturs (99477 in chips) 
Seat 3: fellipeschmeil (46633 in chips) 
Seat 4: chuchukat (273549 in chips) 
Seat 5: lftgjc (151254 in chips) 
Seat 6: vip_1985Z (35634 in chips) 
Seat 7: drinho2pac (79896 in chips) 
Seat 8: Pedrozadota (91484 in chips) 
yaniw777: posts the ante 500
LV_Arturs: posts the ante 500
fellipeschmeil: posts the ante 500
chuchukat: posts the ante 500
lftgjc: posts the ante 500
vip_1985Z: posts the ante 500
drinho2pac: posts the ante 500
Pedrozadota: posts the ante 500
LV_Arturs: posts small blind 2000
fellipeschmeil: posts big blind 4000
*** HOLE CARDS ***
chuchukat: folds 
lftgjc: folds 
vip_1985Z: folds 
drinho2pac: folds 
Pedrozadota: raises 4400 to 8400
yaniw777: folds 
LV_Arturs: folds 
fellipeschmeil: calls 4400
*** FLOP *** [Kh Qs 3s]
fellipeschmeil: checks 
Pedrozadota: bets 4000
fellipeschmeil: folds 
Uncalled bet (4000) returned to Pedrozadota
Pedrozadota collected 22800 from pot
Pedrozadota: doesn't show hand 
*** SUMMARY ***
Total pot 22800 | Rake 0 
Board [Kh Qs 3s]
Seat 1: yaniw777 (button) folded before Flop (didn't bet)
Seat 2: LV_Arturs (small blind) folded before Flop
Seat 3: fellipeschmeil (big blind) folded on the Flop
Seat 4: chuchukat folded before Flop (didn't bet)
Seat 5: lftgjc folded before Flop (didn't bet)
Seat 6: vip_1985Z folded before Flop (didn't bet)
Seat 7: drinho2pac folded before Flop (didn't bet)
Seat 8: Pedrozadota collected (22800)

PokerStars Hand #251206797298: Tournament #3767885527, $40+$10+$5 USD Hold'em No Limit - Level XVIII (2000/4000) - 2024/06/26 20:20:18 UTC [2024/06/26 16:20:18 ET]
Table '3767885527 57' 8-max Seat #2 is the button
Seat 1: yaniw777 (132392 in chips) 
Seat 2: LV_Arturs (96977 in chips) 
Seat 3: fellipeschmeil (37733 in chips) 
Seat 4: chuchukat (273049 in chips) 
Seat 5: lftgjc (150754 in chips) 
Seat 6: vip_1985Z (35134 in chips) 
Seat 7: drinho2pac (79396 in chips) 
Seat 8: Pedrozadota (105384 in chips) 
yaniw777: posts the ante 500
LV_Arturs: posts the ante 500
fellipeschmeil: posts the ante 500
chuchukat: posts the ante 500
lftgjc: posts the ante 500
vip_1985Z: posts the ante 500
drinho2pac: posts the ante 500
Pedrozadota: posts the ante 500
fellipeschmeil: posts small blind 2000
chuchukat: posts big blind 4000
*** HOLE CARDS ***
lftgjc: raises 4000 to 8000
vip_1985Z: folds 
drinho2pac: folds 
Pedrozadota: folds 
yaniw777: folds 
LV_Arturs: folds 
fellipeschmeil: folds 
chuchukat: calls 4000
*** FLOP *** [Td 2s 7s]
chuchukat: checks 
lftgjc: checks 
*** TURN *** [Td 2s 7s] [6d]
chuchukat: bets 8000
lftgjc: calls 8000
*** RIVER *** [Td 2s 7s 6d] [8h]
chuchukat: bets 48000
lftgjc: folds 
Uncalled bet (48000) returned to chuchukat
chuchukat collected 38000 from pot
chuchukat: doesn't show hand 
*** SUMMARY ***
Total pot 38000 | Rake 0 
Board [Td 2s 7s 6d 8h]
Seat 1: yaniw777 folded before Flop (didn't bet)
Seat 2: LV_Arturs (button) folded before Flop (didn't bet)
Seat 3: fellipeschmeil (small blind) folded before Flop
Seat 4: chuchukat (big blind) collected (38000)
Seat 5: lftgjc folded on the River
Seat 6: vip_1985Z folded before Flop (didn't bet)
Seat 7: drinho2pac folded before Flop (didn't bet)
Seat 8: Pedrozadota folded before Flop (didn't bet)

PokerStars Hand #251206817201: Tournament #3767885527, $40+$10+$5 USD Hold'em No Limit - Level XVIII (2000/4000) - 2024/06/26 20:21:28 UTC [2024/06/26 16:21:28 ET]
Table '3767885527 57' 8-max Seat #3 is the button
Seat 1: yaniw777 (131892 in chips) 
Seat 2: LV_Arturs (96477 in chips) 
Seat 3: fellipeschmeil (35233 in chips) 
Seat 4: chuchukat (294549 in chips) 
Seat 5: lftgjc (134254 in chips) 
Seat 6: vip_1985Z (34634 in chips) 
Seat 7: drinho2pac (78896 in chips) 
Seat 8: Pedrozadota (104884 in chips) 
yaniw777: posts the ante 500
LV_Arturs: posts the ante 500
fellipeschmeil: posts the ante 500
chuchukat: posts the ante 500
lftgjc: posts the ante 500
vip_1985Z: posts the ante 500
drinho2pac: posts the ante 500
Pedrozadota: posts the ante 500
chuchukat: posts small blind 2000
lftgjc: posts big blind 4000
*** HOLE CARDS ***
vip_1985Z: folds 
drinho2pac: folds 
Pedrozadota: folds 
yaniw777: folds 
LV_Arturs: folds 
fellipeschmeil: folds 
chuchukat: raises 10000 to 14000
lftgjc: raises 18000 to 32000
chuchukat: folds 
Uncalled bet (18000) returned to lftgjc
lftgjc collected 32000 from pot
lftgjc: doesn't show hand 
*** SUMMARY ***
Total pot 32000 | Rake 0 
Seat 1: yaniw777 folded before Flop (didn't bet)
Seat 2: LV_Arturs folded before Flop (didn't bet)
Seat 3: fellipeschmeil (button) folded before Flop (didn't bet)
Seat 4: chuchukat (small blind) folded before Flop
Seat 5: lftgjc (big blind) collected (32000)
Seat 6: vip_1985Z folded before Flop (didn't bet)
Seat 7: drinho2pac folded before Flop (didn't bet)
Seat 8: Pedrozadota folded before Flop (didn't bet)

PokerStars Hand #251206830495: Tournament #3767885527, $40+$10+$5 USD Hold'em No Limit - Level XVIII (2000/4000) - 2024/06/26 20:22:16 UTC [2024/06/26 16:22:16 ET]
Table '3767885527 57' 8-max Seat #4 is the button
Seat 1: yaniw777 (131392 in chips) 
Seat 2: LV_Arturs (95977 in chips) 
Seat 3: fellipeschmeil (34733 in chips) 
Seat 4: chuchukat (280049 in chips) 
Seat 5: lftgjc (151754 in chips) 
Seat 6: vip_1985Z (34134 in chips) 
Seat 7: drinho2pac (78396 in chips) 
Seat 8: Pedrozadota (104384 in chips) 
yaniw777: posts the ante 500
LV_Arturs: posts the ante 500
fellipeschmeil: posts the ante 500
chuchukat: posts the ante 500
lftgjc: posts the ante 500
vip_1985Z: posts the ante 500
drinho2pac: posts the ante 500
Pedrozadota: posts the ante 500
lftgjc: posts small blind 2000
vip_1985Z: posts big blind 4000
*** HOLE CARDS ***
drinho2pac: folds 
Pedrozadota: folds 
yaniw777: folds 
LV_Arturs: folds 
fellipeschmeil: folds 
chuchukat: raises 4000 to 8000
lftgjc: folds 
vip_1985Z: folds 
Uncalled bet (4000) returned to chuchukat
chuchukat collected 14000 from pot
chuchukat: doesn't show hand 
*** SUMMARY ***
Total pot 14000 | Rake 0 
Seat 1: yaniw777 folded before Flop (didn't bet)
Seat 2: LV_Arturs folded before Flop (didn't bet)
Seat 3: fellipeschmeil folded before Flop (didn't bet)
Seat 4: chuchukat (button) collected (14000)
Seat 5: lftgjc (small blind) folded before Flop
Seat 6: vip_1985Z (big blind) folded before Flop
Seat 7: drinho2pac folded before Flop (didn't bet)
Seat 8: Pedrozadota folded before Flop (didn't bet)

PokerStars Hand #251206840407: Tournament #3767885527, $40+$10+$5 USD Hold'em No Limit - Level XVIII (2000/4000) - 2024/06/26 20:22:51 UTC [2024/06/26 16:22:51 ET]
Table '3767885527 57' 8-max Seat #5 is the button
Seat 1: yaniw777 (130892 in chips) 
Seat 2: LV_Arturs (95477 in chips) 
Seat 3: fellipeschmeil (34233 in chips) 
Seat 4: chuchukat (289549 in chips) 
Seat 5: lftgjc (149254 in chips) 
Seat 6: vip_1985Z (29634 in chips) 
Seat 7: drinho2pac (77896 in chips) 
Seat 8: Pedrozadota (103884 in chips) 
yaniw777: posts the ante 500
LV_Arturs: posts the ante 500
fellipeschmeil: posts the ante 500
chuchukat: posts the ante 500
lftgjc: posts the ante 500
vip_1985Z: posts the ante 500
drinho2pac: posts the ante 500
Pedrozadota: posts the ante 500
vip_1985Z: posts small blind 2000
drinho2pac: posts big blind 4000
*** HOLE CARDS ***
Pedrozadota: folds 
yaniw777: folds 
LV_Arturs: folds 
fellipeschmeil: folds 
chuchukat: raises 4000 to 8000
lftgjc: folds 
vip_1985Z: folds 
drinho2pac: folds 
Uncalled bet (4000) returned to chuchukat
chuchukat collected 14000 from pot
chuchukat: doesn't show hand 
*** SUMMARY ***
Total pot 14000 | Rake 0 
Seat 1: yaniw777 folded before Flop (didn't bet)
Seat 2: LV_Arturs folded before Flop (didn't bet)
Seat 3: fellipeschmeil folded before Flop (didn't bet)
Seat 4: chuchukat collected (14000)
Seat 5: lftgjc (button) folded before Flop (didn't bet)
Seat 6: vip_1985Z (small blind) folded before Flop
Seat 7: drinho2pac (big blind) folded before Flop
Seat 8: Pedrozadota folded before Flop (didn't bet)

PokerStars Hand #251206852851: Tournament #3767885527, $40+$10+$5 USD Hold'em No Limit - Level XVIII (2000/4000) - 2024/06/26 20:23:35 UTC [2024/06/26 16:23:35 ET]
Table '3767885527 57' 8-max Seat #6 is the button
Seat 1: yaniw777 (130392 in chips) 
Seat 2: LV_Arturs (94977 in chips) 
Seat 3: fellipeschmeil (33733 in chips) 
Seat 4: chuchukat (299049 in chips) 
Seat 5: lftgjc (148754 in chips) 
Seat 6: vip_1985Z (27134 in chips) 
Seat 7: drinho2pac (73396 in chips) 
Seat 8: Pedrozadota (103384 in chips) 
yaniw777: posts the ante 500
LV_Arturs: posts the ante 500
fellipeschmeil: posts the ante 500
chuchukat: posts the ante 500
lftgjc: posts the ante 500
vip_1985Z: posts the ante 500
drinho2pac: posts the ante 500
Pedrozadota: posts the ante 500
drinho2pac: posts small blind 2000
Pedrozadota: posts big blind 4000
*** HOLE CARDS ***
yaniw777: raises 4400 to 8400
LV_Arturs: folds 
fellipeschmeil: folds 
chuchukat: folds 
lftgjc: folds 
vip_1985Z: folds 
drinho2pac: folds 
Pedrozadota: folds 
Uncalled bet (4400) returned to yaniw777
yaniw777 collected 14000 from pot
yaniw777: doesn't show hand 
*** SUMMARY ***
Total pot 14000 | Rake 0 
Seat 1: yaniw777 collected (14000)
Seat 2: LV_Arturs folded before Flop (didn't bet)
Seat 3: fellipeschmeil folded before Flop (didn't bet)
Seat 4: chuchukat folded before Flop (didn't bet)
Seat 5: lftgjc folded before Flop (didn't bet)
Seat 6: vip_1985Z (button) folded before Flop (didn't bet)
Seat 7: drinho2pac (small blind) folded before Flop
Seat 8: Pedrozadota (big blind) folded before Flop

PokerStars Hand #251206867419: Tournament #3767885527, $40+$10+$5 USD Hold'em No Limit - Level XVIII (2000/4000) - 2024/06/26 20:24:27 UTC [2024/06/26 16:24:27 ET]
Table '3767885527 57' 8-max Seat #7 is the button
Seat 1: yaniw777 (139892 in chips) 
Seat 2: LV_Arturs (94477 in chips) 
Seat 3: fellipeschmeil (33233 in chips) 
Seat 4: chuchukat (298549 in chips) 
Seat 5: lftgjc (148254 in chips) 
Seat 6: vip_1985Z (26634 in chips) 
Seat 7: drinho2pac (70896 in chips) 
Seat 8: Pedrozadota (98884 in chips) 
yaniw777: posts the ante 500
LV_Arturs: posts the ante 500
fellipeschmeil: posts the ante 500
chuchukat: posts the ante 500
lftgjc: posts the ante 500
vip_1985Z: posts the ante 500
drinho2pac: posts the ante 500
Pedrozadota: posts the ante 500
Pedrozadota: posts small blind 2000
yaniw777: posts big blind 4000
*** HOLE CARDS ***
LV_Arturs: folds 
fellipeschmeil: folds 
chuchukat: folds 
lftgjc: folds 
vip_1985Z: folds 
drinho2pac: folds 
Pedrozadota has timed out
Pedrozadota: folds 
Pedrozadota is sitting out
Uncalled bet (2000) returned to yaniw777
yaniw777 collected 8000 from pot
yaniw777: doesn't show hand 
Pedrozadota has returned
*** SUMMARY ***
Total pot 8000 | Rake 0 
Seat 1: yaniw777 (big blind) collected (8000)
Seat 2: LV_Arturs folded before Flop (didn't bet)
Seat 3: fellipeschmeil folded before Flop (didn't bet)
Seat 4: chuchukat folded before Flop (didn't bet)
Seat 5: lftgjc folded before Flop (didn't bet)
Seat 6: vip_1985Z folded before Flop (didn't bet)
Seat 7: drinho2pac (button) folded before Flop (didn't bet)
Seat 8: Pedrozadota (small blind) folded before Flop

PokerStars Hand #251206880994: Tournament #3767885527, $40+$10+$5 USD Hold'em No Limit - Level XVIII (2000/4000) - 2024/06/26 20:25:15 UTC [2024/06/26 16:25:15 ET]
Table '3767885527 57' 8-max Seat #8 is the button
Seat 1: yaniw777 (145392 in chips) 
Seat 2: LV_Arturs (93977 in chips) 
Seat 3: fellipeschmeil (32733 in chips) 
Seat 4: chuchukat (298049 in chips) 
Seat 5: lftgjc (147754 in chips) 
Seat 6: vip_1985Z (26134 in chips) 
Seat 7: drinho2pac (70396 in chips) 
Seat 8: Pedrozadota (96384 in chips) 
yaniw777: posts the ante 500
LV_Arturs: posts the ante 500
fellipeschmeil: posts the ante 500
chuchukat: posts the ante 500
lftgjc: posts the ante 500
vip_1985Z: posts the ante 500
drinho2pac: posts the ante 500
Pedrozadota: posts the ante 500
yaniw777: posts small blind 2000
LV_Arturs: posts big blind 4000
*** HOLE CARDS ***
fellipeschmeil: folds 
chuchukat: folds 
lftgjc: folds 
vip_1985Z: folds 
drinho2pac: folds 
Pedrozadota: raises 4400 to 8400
yaniw777: folds 
LV_Arturs: raises 85077 to 93477 and is all-in
Pedrozadota: folds 
Uncalled bet (85077) returned to LV_Arturs
LV_Arturs collected 22800 from pot
*** SUMMARY ***
Total pot 22800 | Rake 0 
Seat 1: yaniw777 (small blind) folded before Flop
Seat 2: LV_Arturs (big blind) collected (22800)
Seat 3: fellipeschmeil folded before Flop (didn't bet)
Seat 4: chuchukat folded before Flop (didn't bet)
Seat 5: lftgjc folded before Flop (didn't bet)
Seat 6: vip_1985Z folded before Flop (didn't bet)
Seat 7: drinho2pac folded before Flop (didn't bet)
Seat 8: Pedrozadota (button) folded before Flop

PokerStars Hand #251206897605: Tournament #3767885527, $40+$10+$5 USD Hold'em No Limit - Level XIX (2500/5000) - 2024/06/26 20:26:15 UTC [2024/06/26 16:26:15 ET]
Table '3767885527 57' 8-max Seat #1 is the button
Seat 1: yaniw777 (142892 in chips) 
Seat 2: LV_Arturs (107877 in chips) 
Seat 3: fellipeschmeil (32233 in chips) 
Seat 4: chuchukat (297549 in chips) 
Seat 5: lftgjc (147254 in chips) 
Seat 6: vip_1985Z (25634 in chips) 
Seat 7: drinho2pac (69896 in chips) 
Seat 8: Pedrozadota (87484 in chips) 
yaniw777: posts the ante 625
LV_Arturs: posts the ante 625
fellipeschmeil: posts the ante 625
chuchukat: posts the ante 625
lftgjc: posts the ante 625
vip_1985Z: posts the ante 625
drinho2pac: posts the ante 625
Pedrozadota: posts the ante 625
LV_Arturs: posts small blind 2500
fellipeschmeil: posts big blind 5000
*** HOLE CARDS ***
chuchukat: folds 
lftgjc: folds 
vip_1985Z: raises 20000 to 25000
drinho2pac: folds 
Pedrozadota: folds 
yaniw777: raises 117267 to 142267 and is all-in
LV_Arturs: folds 
fellipeschmeil: folds 
vip_1985Z: calls 9 and is all-in
Uncalled bet (117258) returned to yaniw777
*** FLOP *** [4d Ad Qs]
*** TURN *** [4d Ad Qs] [Ah]
*** RIVER *** [4d Ad Qs Ah] [Tc]
*** SHOW DOWN ***
vip_1985Z: shows [Ks As] (three of a kind, Aces)
yaniw777: shows [6s 6d] (two pair, Aces and Sixes)
vip_1985Z collected 62518 from pot
*** SUMMARY ***
Total pot 62518 | Rake 0 
Board [4d Ad Qs Ah Tc]
Seat 1: yaniw777 (button) showed [6s 6d] and lost with two pair, Aces and Sixes
Seat 2: LV_Arturs (small blind) folded before Flop
Seat 3: fellipeschmeil (big blind) folded before Flop
Seat 4: chuchukat folded before Flop (didn't bet)
Seat 5: lftgjc folded before Flop (didn't bet)
Seat 6: vip_1985Z showed [Ks As] and won (62518) with three of a kind, Aces
Seat 7: drinho2pac folded before Flop (didn't bet)
Seat 8: Pedrozadota folded before Flop (didn't bet)

PokerStars Hand #251206926650: Tournament #3767885527, $40+$10+$5 USD Hold'em No Limit - Level XIX (2500/5000) - 2024/06/26 20:27:59 UTC [2024/06/26 16:27:59 ET]
Table '3767885527 57' 8-max Seat #2 is the button
Seat 1: yaniw777 (117258 in chips) 
Seat 2: LV_Arturs (104752 in chips) 
Seat 3: fellipeschmeil (26608 in chips) 
Seat 4: chuchukat (296924 in chips) 
Seat 5: lftgjc (146629 in chips) 
Seat 6: vip_1985Z (62518 in chips) 
Seat 7: drinho2pac (69271 in chips) 
Seat 8: Pedrozadota (86859 in chips) 
yaniw777: posts the ante 625
LV_Arturs: posts the ante 625
fellipeschmeil: posts the ante 625
chuchukat: posts the ante 625
lftgjc: posts the ante 625
vip_1985Z: posts the ante 625
drinho2pac: posts the ante 625
Pedrozadota: posts the ante 625
fellipeschmeil: posts small blind 2500
chuchukat: posts big blind 5000
*** HOLE CARDS ***
lftgjc: folds 
vip_1985Z: folds 
drinho2pac: folds 
Pedrozadota: folds 
yaniw777: raises 5000 to 10000
LV_Arturs: folds 
fellipeschmeil: folds 
chuchukat: raises 30000 to 40000
yaniw777: folds 
Uncalled bet (30000) returned to chuchukat
chuchukat collected 27500 from pot
chuchukat: doesn't show hand 
*** SUMMARY ***
Total pot 27500 | Rake 0 
Seat 1: yaniw777 folded before Flop
Seat 2: LV_Arturs (button) folded before Flop (didn't bet)
Seat 3: fellipeschmeil (small blind) folded before Flop
Seat 4: chuchukat (big blind) collected (27500)
Seat 5: lftgjc folded before Flop (didn't bet)
Seat 6: vip_1985Z folded before Flop (didn't bet)
Seat 7: drinho2pac folded before Flop (didn't bet)
Seat 8: Pedrozadota folded before Flop (didn't bet)

PokerStars Hand #251206948693: Tournament #3767885527, $40+$10+$5 USD Hold'em No Limit - Level XIX (2500/5000) - 2024/06/26 20:29:19 UTC [2024/06/26 16:29:19 ET]
Table '3767885527 57' 8-max Seat #3 is the button
Seat 1: yaniw777 (106633 in chips) 
Seat 2: LV_Arturs (104127 in chips) 
Seat 3: fellipeschmeil (23483 in chips) 
Seat 4: chuchukat (313799 in chips) 
Seat 5: lftgjc (146004 in chips) 
Seat 6: vip_1985Z (61893 in chips) 
Seat 7: drinho2pac (68646 in chips) 
Seat 8: Pedrozadota (86234 in chips) 
yaniw777: posts the ante 625
LV_Arturs: posts the ante 625
fellipeschmeil: posts the ante 625
chuchukat: posts the ante 625
lftgjc: posts the ante 625
vip_1985Z: posts the ante 625
drinho2pac: posts the ante 625
Pedrozadota: posts the ante 625
chuchukat: posts small blind 2500
lftgjc: posts big blind 5000
*** HOLE CARDS ***
vip_1985Z: folds 
drinho2pac: folds 
Pedrozadota: folds 
yaniw777: folds 
LV_Arturs: raises 5250 to 10250
fellipeschmeil: folds 
chuchukat: folds 
lftgjc: calls 5250
*** FLOP *** [Jd 2c 8s]
lftgjc: checks 
LV_Arturs: bets 9000
lftgjc: folds 
Uncalled bet (9000) returned to LV_Arturs
LV_Arturs collected 28000 from pot
*** SUMMARY ***
Total pot 28000 | Rake 0 
Board [Jd 2c 8s]
Seat 1: yaniw777 folded before Flop (didn't bet)
Seat 2: LV_Arturs collected (28000)
Seat 3: fellipeschmeil (button) folded before Flop (didn't bet)
Seat 4: chuchukat (small blind) folded before Flop
Seat 5: lftgjc (big blind) folded on the Flop
Seat 6: vip_1985Z folded before Flop (didn't bet)
Seat 7: drinho2pac folded before Flop (didn't bet)
Seat 8: Pedrozadota folded before Flop (didn't bet)

PokerStars Hand #251206974963: Tournament #3767885527, $40+$10+$5 USD Hold'em No Limit - Level XIX (2500/5000) - 2024/06/26 20:30:54 UTC [2024/06/26 16:30:54 ET]
Table '3767885527 57' 8-max Seat #4 is the button
Seat 1: yaniw777 (106008 in chips) 
Seat 2: LV_Arturs (121252 in chips) 
Seat 3: fellipeschmeil (22858 in chips) 
Seat 4: chuchukat (310674 in chips) 
Seat 5: lftgjc (135129 in chips) 
Seat 6: vip_1985Z (61268 in chips) 
Seat 7: drinho2pac (68021 in chips) 
Seat 8: Pedrozadota (85609 in chips) 
yaniw777: posts the ante 625
LV_Arturs: posts the ante 625
fellipeschmeil: posts the ante 625
chuchukat: posts the ante 625
lftgjc: posts the ante 625
vip_1985Z: posts the ante 625
drinho2pac: posts the ante 625
Pedrozadota: posts the ante 625
lftgjc: posts small blind 2500
vip_1985Z: posts big blind 5000
*** HOLE CARDS ***
drinho2pac: folds 
Pedrozadota: raises 45000 to 50000
yaniw777: folds 
LV_Arturs: folds 
fellipeschmeil: folds 
chuchukat: folds 
lftgjc: folds 
vip_1985Z: folds 
Uncalled bet (45000) returned to Pedrozadota
Pedrozadota collected 17500 from pot
Pedrozadota: doesn't show hand 
*** SUMMARY ***
Total pot 17500 | Rake 0 
Seat 1: yaniw777 folded before Flop (didn't bet)
Seat 2: LV_Arturs folded before Flop (didn't bet)
Seat 3: fellipeschmeil folded before Flop (didn't bet)
Seat 4: chuchukat (button) folded before Flop (didn't bet)
Seat 5: lftgjc (small blind) folded before Flop
Seat 6: vip_1985Z (big blind) folded before Flop
Seat 7: drinho2pac folded before Flop (didn't bet)
Seat 8: Pedrozadota collected (17500)

PokerStars Hand #251206984965: Tournament #3767885527, $40+$10+$5 USD Hold'em No Limit - Level XIX (2500/5000) - 2024/06/26 20:31:30 UTC [2024/06/26 16:31:30 ET]
Table '3767885527 57' 8-max Seat #5 is the button
Seat 1: yaniw777 (105383 in chips) 
Seat 2: LV_Arturs (120627 in chips) 
Seat 3: fellipeschmeil (22233 in chips) 
Seat 4: chuchukat (310049 in chips) 
Seat 5: lftgjc (132004 in chips) 
Seat 6: vip_1985Z (55643 in chips) 
Seat 7: drinho2pac (67396 in chips) 
Seat 8: Pedrozadota (97484 in chips) 
yaniw777: posts the ante 625
LV_Arturs: posts the ante 625
fellipeschmeil: posts the ante 625
chuchukat: posts the ante 625
lftgjc: posts the ante 625
vip_1985Z: posts the ante 625
drinho2pac: posts the ante 625
Pedrozadota: posts the ante 625
vip_1985Z: posts small blind 2500
drinho2pac: posts big blind 5000
*** HOLE CARDS ***
Pedrozadota: folds 
yaniw777: folds 
LV_Arturs: folds 
fellipeschmeil: folds 
chuchukat: raises 304424 to 309424 and is all-in
lftgjc: folds 
vip_1985Z: folds 
drinho2pac: folds 
Uncalled bet (304424) returned to chuchukat
chuchukat collected 17500 from pot
chuchukat: doesn't show hand 
*** SUMMARY ***
Total pot 17500 | Rake 0 
Seat 1: yaniw777 folded before Flop (didn't bet)
Seat 2: LV_Arturs folded before Flop (didn't bet)
Seat 3: fellipeschmeil folded before Flop (didn't bet)
Seat 4: chuchukat collected (17500)
Seat 5: lftgjc (button) folded before Flop (didn't bet)
Seat 6: vip_1985Z (small blind) folded before Flop
Seat 7: drinho2pac (big blind) folded before Flop
Seat 8: Pedrozadota folded before Flop (didn't bet)

PokerStars Hand #251206999112: Tournament #3767885527, $40+$10+$5 USD Hold'em No Limit - Level XIX (2500/5000) - 2024/06/26 20:32:20 UTC [2024/06/26 16:32:20 ET]
Table '3767885527 57' 8-max Seat #6 is the button
Seat 1: yaniw777 (104758 in chips) 
Seat 2: LV_Arturs (120002 in chips) 
Seat 3: fellipeschmeil (21608 in chips) 
Seat 4: chuchukat (321924 in chips) 
Seat 5: lftgjc (131379 in chips) 
Seat 6: vip_1985Z (52518 in chips) 
Seat 7: drinho2pac (61771 in chips) 
Seat 8: Pedrozadota (96859 in chips) 
yaniw777: posts the ante 625
LV_Arturs: posts the ante 625
fellipeschmeil: posts the ante 625
chuchukat: posts the ante 625
lftgjc: posts the ante 625
vip_1985Z: posts the ante 625
drinho2pac: posts the ante 625
Pedrozadota: posts the ante 625
drinho2pac: posts small blind 2500
Pedrozadota: posts big blind 5000
*** HOLE CARDS ***
yaniw777: raises 5000 to 10000
LV_Arturs: folds 
fellipeschmeil: folds 
chuchukat: folds 
lftgjc: raises 15000 to 25000
vip_1985Z: folds 
drinho2pac: folds 
Pedrozadota: folds 
yaniw777: raises 79133 to 104133 and is all-in
lftgjc: calls 79133
*** FLOP *** [3d Qc 9h]
*** TURN *** [3d Qc 9h] [4s]
*** RIVER *** [3d Qc 9h 4s] [3c]
*** SHOW DOWN ***
yaniw777: shows [Kc Ks] (two pair, Kings and Threes)
lftgjc: shows [Ah As] (two pair, Aces and Threes)
lftgjc collected 220766 from pot
*** SUMMARY ***
Total pot 220766 | Rake 0 
Board [3d Qc 9h 4s 3c]
Seat 1: yaniw777 showed [Kc Ks] and lost with two pair, Kings and Threes
Seat 2: LV_Arturs folded before Flop (didn't bet)
Seat 3: fellipeschmeil folded before Flop (didn't bet)
Seat 4: chuchukat folded before Flop (didn't bet)
Seat 5: lftgjc showed [Ah As] and won (220766) with two pair, Aces and Threes
Seat 6: vip_1985Z (button) folded before Flop (didn't bet)
Seat 7: drinho2pac (small blind) folded before Flop
Seat 8: Pedrozadota (big blind) folded before Flop

PokerStars Hand #251207031976: Tournament #3767885527, $40+$10+$5 USD Hold'em No Limit - Level XIX (2500/5000) - 2024/06/26 20:34:17 UTC [2024/06/26 16:34:17 ET]
Table '3767885527 57' 8-max Seat #7 is the button
Seat 2: LV_Arturs (119377 in chips) 
Seat 3: fellipeschmeil (20983 in chips) 
Seat 4: chuchukat (321299 in chips) 
Seat 5: lftgjc (247387 in chips) 
Seat 6: vip_1985Z (51893 in chips) 
Seat 7: drinho2pac (58646 in chips) 
Seat 8: Pedrozadota (91234 in chips) 
LV_Arturs: posts the ante 625
fellipeschmeil: posts the ante 625
chuchukat: posts the ante 625
lftgjc: posts the ante 625
vip_1985Z: posts the ante 625
drinho2pac: posts the ante 625
Pedrozadota: posts the ante 625
Pedrozadota: posts small blind 2500
LV_Arturs: posts big blind 5000
*** HOLE CARDS ***
fellipeschmeil: raises 15000 to 20000
chuchukat: calls 20000
lftgjc: folds 
vip_1985Z: folds 
drinho2pac: raises 38021 to 58021 and is all-in
Pedrozadota: folds 
LV_Arturs: folds 
fellipeschmeil: calls 358 and is all-in
chuchukat: calls 38021
*** FLOP *** [Ts 2c Ad]
*** TURN *** [Ts 2c Ad] [7h]
*** RIVER *** [Ts 2c Ad 7h] [Ac]
*** SHOW DOWN ***
chuchukat: shows [Ah Jh] (three of a kind, Aces)
drinho2pac: shows [5d 5h] (two pair, Aces and Fives)
Naaarrrr is disconnected 
chuchukat collected 75326 from side pot
fellipeschmeil: shows [Qs As] (three of a kind, Aces - Queen kicker)
fellipeschmeil collected 72949 from main pot
drinho2pac finished the tournament in 295th place and received $104.64.
*** SUMMARY ***
Total pot 148275 Main pot 72949. Side pot 75326. | Rake 0 
Board [Ts 2c Ad 7h Ac]
Seat 2: LV_Arturs (big blind) folded before Flop
Seat 3: fellipeschmeil showed [Qs As] and won (72949) with three of a kind, Aces
Seat 4: chuchukat showed [Ah Jh] and won (75326) with three of a kind, Aces
Seat 5: lftgjc folded before Flop (didn't bet)
Seat 6: vip_1985Z folded before Flop (didn't bet)
Seat 7: drinho2pac (button) showed [5d 5h] and lost with two pair, Aces and Fives
Seat 8: Pedrozadota (small blind) folded before Flop

PokerStars Hand #251207050594: Tournament #3767885527, $40+$10+$5 USD Hold'em No Limit - Level XIX (2500/5000) - 2024/06/26 20:35:22 UTC [2024/06/26 16:35:22 ET]
Table '3767885527 57' 8-max Seat #8 is the button
Seat 1: Naaarrrr (227788 in chips) out of hand (moved from another table into small blind)
Seat 2: LV_Arturs (113752 in chips) 
Seat 3: fellipeschmeil (72949 in chips) 
Seat 4: chuchukat (337979 in chips) 
Seat 5: lftgjc (246762 in chips) 
Seat 6: vip_1985Z (51268 in chips) 
Seat 8: Pedrozadota (88109 in chips) 
Naaarrrr will be allowed to play after the button
LV_Arturs: posts the ante 625
fellipeschmeil: posts the ante 625
chuchukat: posts the ante 625
lftgjc: posts the ante 625
vip_1985Z: posts the ante 625
Pedrozadota: posts the ante 625
LV_Arturs: posts small blind 2500
fellipeschmeil: posts big blind 5000
*** HOLE CARDS ***
chuchukat: folds 
lftgjc: raises 5000 to 10000
vip_1985Z: folds 
Pedrozadota: folds 
LV_Arturs: raises 103127 to 113127 and is all-in
fellipeschmeil: folds 
gomsipjorn is disconnected 
lftgjc: folds 
Uncalled bet (103127) returned to LV_Arturs
LV_Arturs collected 28750 from pot
*** SUMMARY ***
Total pot 28750 | Rake 0 
Seat 2: LV_Arturs (small blind) collected (28750)
Seat 3: fellipeschmeil (big blind) folded before Flop
Seat 4: chuchukat folded before Flop (didn't bet)
Seat 5: lftgjc folded before Flop
Seat 6: vip_1985Z folded before Flop (didn't bet)
Seat 8: Pedrozadota (button) folded before Flop (didn't bet)

PokerStars Hand #251207061607: Tournament #3767885527, $40+$10+$5 USD Hold'em No Limit - Level XX (3000/6000) - 2024/06/26 20:36:01 UTC [2024/06/26 16:36:01 ET]
Table '3767885527 57' 8-max Seat #2 is the button
Seat 1: Naaarrrr (227788 in chips) 
Seat 2: LV_Arturs (131877 in chips) 
Seat 3: fellipeschmeil (67324 in chips) 
Seat 4: chuchukat (337354 in chips) 
Seat 5: lftgjc (236137 in chips) 
Seat 6: vip_1985Z (50643 in chips) 
Seat 7: gomsipjorn (229711 in chips) 
Seat 8: Pedrozadota (87484 in chips) 
Naaarrrr: posts the ante 750
LV_Arturs: posts the ante 750
fellipeschmeil: posts the ante 750
chuchukat: posts the ante 750
lftgjc: posts the ante 750
vip_1985Z: posts the ante 750
gomsipjorn: posts the ante 750
Pedrozadota: posts the ante 750
fellipeschmeil: posts small blind 3000
chuchukat: posts big blind 6000
*** HOLE CARDS ***
lftgjc: folds 
vip_1985Z: folds 
gomsipjorn: raises 7200 to 13200
Pedrozadota: folds 
Naaarrrr: folds 
LV_Arturs: folds 
fellipeschmeil: folds 
chuchukat: raises 37800 to 51000
gomsipjorn: folds 
Uncalled bet (37800) returned to chuchukat
chuchukat collected 35400 from pot
chuchukat: doesn't show hand 
*** SUMMARY ***
Total pot 35400 | Rake 0 
Seat 1: Naaarrrr folded before Flop (didn't bet)
Seat 2: LV_Arturs (button) folded before Flop (didn't bet)
Seat 3: fellipeschmeil (small blind) folded before Flop
Seat 4: chuchukat (big blind) collected (35400)
Seat 5: lftgjc folded before Flop (didn't bet)
Seat 6: vip_1985Z folded before Flop (didn't bet)
Seat 7: gomsipjorn folded before Flop
Seat 8: Pedrozadota folded before Flop (didn't bet)

PokerStars Hand #251207073081: Tournament #3767885527, $40+$10+$5 USD Hold'em No Limit - Level XX (3000/6000) - 2024/06/26 20:36:42 UTC [2024/06/26 16:36:42 ET]
Table '3767885527 57' 8-max Seat #3 is the button
Seat 1: Naaarrrr (227038 in chips) 
Seat 2: LV_Arturs (131127 in chips) 
Seat 3: fellipeschmeil (63574 in chips) 
Seat 4: chuchukat (358804 in chips) 
Seat 5: lftgjc (235387 in chips) 
Seat 6: vip_1985Z (49893 in chips) 
Seat 7: gomsipjorn (215761 in chips) 
Seat 8: Pedrozadota (86734 in chips) 
Naaarrrr: posts the ante 750
LV_Arturs: posts the ante 750
fellipeschmeil: posts the ante 750
chuchukat: posts the ante 750
lftgjc: posts the ante 750
vip_1985Z: posts the ante 750
gomsipjorn: posts the ante 750
Pedrozadota: posts the ante 750
chuchukat: posts small blind 3000
lftgjc: posts big blind 6000
*** HOLE CARDS ***
vip_1985Z: folds 
gomsipjorn: folds 
Pedrozadota: folds 
Naaarrrr: folds 
LV_Arturs: folds 
fellipeschmeil: folds 
chuchukat: raises 15000 to 21000
lftgjc: raises 33000 to 54000
chuchukat: folds 
Uncalled bet (33000) returned to lftgjc
lftgjc collected 48000 from pot
lftgjc: doesn't show hand 
*** SUMMARY ***
Total pot 48000 | Rake 0 
Seat 1: Naaarrrr folded before Flop (didn't bet)
Seat 2: LV_Arturs folded before Flop (didn't bet)
Seat 3: fellipeschmeil (button) folded before Flop (didn't bet)
Seat 4: chuchukat (small blind) folded before Flop
Seat 5: lftgjc (big blind) collected (48000)
Seat 6: vip_1985Z folded before Flop (didn't bet)
Seat 7: gomsipjorn folded before Flop (didn't bet)
Seat 8: Pedrozadota folded before Flop (didn't bet)

PokerStars Hand #251207083107: Tournament #3767885527, $40+$10+$5 USD Hold'em No Limit - Level XX (3000/6000) - 2024/06/26 20:37:17 UTC [2024/06/26 16:37:17 ET]
Table '3767885527 57' 8-max Seat #4 is the button
Seat 1: Naaarrrr (226288 in chips) 
Seat 2: LV_Arturs (130377 in chips) 
Seat 3: fellipeschmeil (62824 in chips) 
Seat 4: chuchukat (337054 in chips) 
Seat 5: lftgjc (261637 in chips) 
Seat 6: vip_1985Z (49143 in chips) 
Seat 7: gomsipjorn (215011 in chips) 
Seat 8: Pedrozadota (85984 in chips) 
Naaarrrr: posts the ante 750
LV_Arturs: posts the ante 750
fellipeschmeil: posts the ante 750
chuchukat: posts the ante 750
lftgjc: posts the ante 750
vip_1985Z: posts the ante 750
gomsipjorn: posts the ante 750
Pedrozadota: posts the ante 750
lftgjc: posts small blind 3000
vip_1985Z: posts big blind 6000
*** HOLE CARDS ***
gomsipjorn: raises 6000 to 12000
Pedrozadota: folds 
Naaarrrr: folds 
LV_Arturs: folds 
fellipeschmeil: folds 
chuchukat: calls 12000
lftgjc: folds 
vip_1985Z: calls 6000
*** FLOP *** [5h Ts 2d]
vip_1985Z: bets 36393 and is all-in
gomsipjorn: folds 
chuchukat: folds 
Uncalled bet (36393) returned to vip_1985Z
vip_1985Z collected 45000 from pot
vip_1985Z: doesn't show hand 
*** SUMMARY ***
Total pot 45000 | Rake 0 
Board [5h Ts 2d]
Seat 1: Naaarrrr folded before Flop (didn't bet)
Seat 2: LV_Arturs folded before Flop (didn't bet)
Seat 3: fellipeschmeil folded before Flop (didn't bet)
Seat 4: chuchukat (button) folded on the Flop
Seat 5: lftgjc (small blind) folded before Flop
Seat 6: vip_1985Z (big blind) collected (45000)
Seat 7: gomsipjorn folded on the Flop
Seat 8: Pedrozadota folded before Flop (didn't bet)

PokerStars Hand #251207097684: Tournament #3767885527, $40+$10+$5 USD Hold'em No Limit - Level XX (3000/6000) - 2024/06/26 20:38:08 UTC [2024/06/26 16:38:08 ET]
Table '3767885527 57' 8-max Seat #5 is the button
Seat 1: Naaarrrr (225538 in chips) 
Seat 2: LV_Arturs (129627 in chips) 
Seat 3: fellipeschmeil (62074 in chips) 
Seat 4: chuchukat (324304 in chips) 
Seat 5: lftgjc (257887 in chips) 
Seat 6: vip_1985Z (81393 in chips) 
Seat 7: gomsipjorn (202261 in chips) 
Seat 8: Pedrozadota (85234 in chips) 
Naaarrrr: posts the ante 750
LV_Arturs: posts the ante 750
fellipeschmeil: posts the ante 750
chuchukat: posts the ante 750
lftgjc: posts the ante 750
vip_1985Z: posts the ante 750
gomsipjorn: posts the ante 750
Pedrozadota: posts the ante 750
vip_1985Z: posts small blind 3000
gomsipjorn: posts big blind 6000
*** HOLE CARDS ***
Pedrozadota: folds 
Naaarrrr: folds 
LV_Arturs: folds 
fellipeschmeil: folds 
chuchukat: raises 6000 to 12000
lftgjc: folds 
vip_1985Z: folds 
gomsipjorn: folds 
Uncalled bet (6000) returned to chuchukat
chuchukat collected 21000 from pot
chuchukat: doesn't show hand 
*** SUMMARY ***
Total pot 21000 | Rake 0 
Seat 1: Naaarrrr folded before Flop (didn't bet)
Seat 2: LV_Arturs folded before Flop (didn't bet)
Seat 3: fellipeschmeil folded before Flop (didn't bet)
Seat 4: chuchukat collected (21000)
Seat 5: lftgjc (button) folded before Flop (didn't bet)
Seat 6: vip_1985Z (small blind) folded before Flop
Seat 7: gomsipjorn (big blind) folded before Flop
Seat 8: Pedrozadota folded before Flop (didn't bet)

PokerStars Hand #251207104273: Tournament #3767885527, $40+$10+$5 USD Hold'em No Limit - Level XX (3000/6000) - 2024/06/26 20:38:32 UTC [2024/06/26 16:38:32 ET]
Table '3767885527 57' 8-max Seat #6 is the button
Seat 1: Naaarrrr (224788 in chips) 
Seat 2: LV_Arturs (128877 in chips) 
Seat 3: fellipeschmeil (61324 in chips) 
Seat 4: chuchukat (338554 in chips) 
Seat 5: lftgjc (257137 in chips) 
Seat 6: vip_1985Z (77643 in chips) 
Seat 7: gomsipjorn (195511 in chips) 
Seat 8: Pedrozadota (84484 in chips) 
Naaarrrr: posts the ante 750
LV_Arturs: posts the ante 750
fellipeschmeil: posts the ante 750
chuchukat: posts the ante 750
lftgjc: posts the ante 750
vip_1985Z: posts the ante 750
gomsipjorn: posts the ante 750
Pedrozadota: posts the ante 750
gomsipjorn: posts small blind 3000
Pedrozadota: posts big blind 6000
*** HOLE CARDS ***
Naaarrrr: folds 
LV_Arturs: folds 
fellipeschmeil: folds 
chuchukat: folds 
lftgjc: folds 
vip_1985Z: folds 
gomsipjorn: calls 3000
Pedrozadota: checks 
*** FLOP *** [4c 7h Qc]
gomsipjorn: checks 
Pedrozadota: bets 6000
gomsipjorn: folds 
Uncalled bet (6000) returned to Pedrozadota
Pedrozadota collected 18000 from pot
Pedrozadota: doesn't show hand 
*** SUMMARY ***
Total pot 18000 | Rake 0 
Board [4c 7h Qc]
Seat 1: Naaarrrr folded before Flop (didn't bet)
Seat 2: LV_Arturs folded before Flop (didn't bet)
Seat 3: fellipeschmeil folded before Flop (didn't bet)
Seat 4: chuchukat folded before Flop (didn't bet)
Seat 5: lftgjc folded before Flop (didn't bet)
Seat 6: vip_1985Z (button) folded before Flop (didn't bet)
Seat 7: gomsipjorn (small blind) folded on the Flop
Seat 8: Pedrozadota (big blind) collected (18000)

PokerStars Hand #251207116119: Tournament #3767885527, $40+$10+$5 USD Hold'em No Limit - Level XX (3000/6000) - 2024/06/26 20:39:14 UTC [2024/06/26 16:39:14 ET]
Table '3767885527 57' 8-max Seat #7 is the button
Seat 1: Naaarrrr (224038 in chips) 
Seat 2: LV_Arturs (128127 in chips) 
Seat 3: fellipeschmeil (60574 in chips) 
Seat 4: chuchukat (337804 in chips) 
Seat 5: lftgjc (256387 in chips) 
Seat 6: vip_1985Z (76893 in chips) 
Seat 7: gomsipjorn (188761 in chips) 
Seat 8: Pedrozadota (95734 in chips) 
Naaarrrr: posts the ante 750
LV_Arturs: posts the ante 750
fellipeschmeil: posts the ante 750
chuchukat: posts the ante 750
lftgjc: posts the ante 750
vip_1985Z: posts the ante 750
gomsipjorn: posts the ante 750
Pedrozadota: posts the ante 750
Pedrozadota: posts small blind 3000
Naaarrrr: posts big blind 6000
*** HOLE CARDS ***
LV_Arturs: folds 
fellipeschmeil: folds 
chuchukat: folds 
lftgjc: folds 
vip_1985Z: folds 
gomsipjorn: folds 
Pedrozadota: raises 88984 to 94984 and is all-in
Naaarrrr: calls 88984
*** FLOP *** [Qh 4h 5s]
*** TURN *** [Qh 4h 5s] [Kc]
*** RIVER *** [Qh 4h 5s Kc] [Qd]
*** SHOW DOWN ***
Pedrozadota: shows [Jc 9c] (a pair of Queens)
Naaarrrr: shows [Ah Tc] (a pair of Queens - Ace kicker)
Naaarrrr collected 195968 from pot
Pedrozadota finished the tournament in 253rd place and received $104.64.
*** SUMMARY ***
Total pot 195968 | Rake 0 
Board [Qh 4h 5s Kc Qd]
Seat 1: Naaarrrr (big blind) showed [Ah Tc] and won (195968) with a pair of Queens
Seat 2: LV_Arturs folded before Flop (didn't bet)
Seat 3: fellipeschmeil folded before Flop (didn't bet)
Seat 4: chuchukat folded before Flop (didn't bet)
Seat 5: lftgjc folded before Flop (didn't bet)
Seat 6: vip_1985Z folded before Flop (didn't bet)
Seat 7: gomsipjorn (button) folded before Flop (didn't bet)
Seat 8: Pedrozadota (small blind) showed [Jc 9c] and lost with a pair of Queens

PokerStars Hand #251207124024: Tournament #3767885527, $40+$10+$5 USD Hold'em No Limit - Level XX (3000/6000) - 2024/06/26 20:39:42 UTC [2024/06/26 16:39:42 ET]
Table '3767885527 57' 8-max Seat #1 is the button
Seat 1: Naaarrrr (324272 in chips) 
Seat 2: LV_Arturs (127377 in chips) 
Seat 3: fellipeschmeil (59824 in chips) 
Seat 4: chuchukat (337054 in chips) 
Seat 5: lftgjc (255637 in chips) 
Seat 6: vip_1985Z (76143 in chips) 
Seat 7: gomsipjorn (188011 in chips) 
Naaarrrr: posts the ante 750
LV_Arturs: posts the ante 750
fellipeschmeil: posts the ante 750
chuchukat: posts the ante 750
lftgjc: posts the ante 750
vip_1985Z: posts the ante 750
gomsipjorn: posts the ante 750
LV_Arturs: posts small blind 3000
fellipeschmeil: posts big blind 6000
*** HOLE CARDS ***
chuchukat: folds 
lftgjc: folds 
vip_1985Z: folds 
gomsipjorn: folds 
Naaarrrr: raises 6000 to 12000
LV_Arturs: folds 
fellipeschmeil: calls 6000
*** FLOP *** [4c Ts 3d]
fellipeschmeil: checks 
Naaarrrr: bets 6000
fellipeschmeil: raises 41074 to 47074 and is all-in
Naaarrrr: calls 41074
*** TURN *** [4c Ts 3d] [5s]
*** RIVER *** [4c Ts 3d 5s] [8h]
*** SHOW DOWN ***
fellipeschmeil: shows [5d 6h] (a pair of Fives)
Naaarrrr: shows [Tc Jc] (a pair of Tens)
Naaarrrr collected 126398 from pot
fellipeschmeil finished the tournament in 249th place and received $104.64.
*** SUMMARY ***
Total pot 126398 | Rake 0 
Board [4c Ts 3d 5s 8h]
Seat 1: Naaarrrr (button) showed [Tc Jc] and won (126398) with a pair of Tens
Seat 2: LV_Arturs (small blind) folded before Flop
Seat 3: fellipeschmeil (big blind) showed [5d 6h] and lost with a pair of Fives
Seat 4: chuchukat folded before Flop (didn't bet)
Seat 5: lftgjc folded before Flop (didn't bet)
Seat 6: vip_1985Z folded before Flop (didn't bet)
Seat 7: gomsipjorn folded before Flop (didn't bet)


PokerStars Hand #251205060848: Tournament #3767885527, $40+$10+$5 USD Hold'em No Limit - Level VIII (350/700) - 2024/06/26 18:30:34 UTC [2024/06/26 14:30:34 ET]
Table '3767885527 37' 8-max Seat #7 is the button
Seat 1: Katwoman0106 (25000 in chips) 
Seat 2: fAArid88 (15471 in chips) 
Seat 3: Sully1993_11 (20248 in chips) 
Seat 4: nahumdj (36537 in chips) 
Seat 5: johnyguedes1 (71457 in chips) 
Seat 6: yuzoyai (10651 in chips) 
Seat 7: junior_re612 (44625 in chips) 
Seat 8: epo9 (33020 in chips) 
Katwoman0106: posts the ante 90
fAArid88: posts the ante 90
Sully1993_11: posts the ante 90
nahumdj: posts the ante 90
johnyguedes1: posts the ante 90
yuzoyai: posts the ante 90
junior_re612: posts the ante 90
epo9: posts the ante 90
epo9: posts small blind 350
Katwoman0106: posts big blind 700
*** HOLE CARDS ***
fAArid88: folds 
Sully1993_11: calls 700
nahumdj: folds 
johnyguedes1: folds 
yuzoyai: folds 
junior_re612: raises 1750 to 2450
epo9: folds 
Katwoman0106: calls 1750
Sully1993_11: calls 1750
*** FLOP *** [3c 5c Ks]
Katwoman0106: checks 
Sully1993_11: checks 
junior_re612: bets 2772
Katwoman0106: folds 
Sully1993_11: folds 
Uncalled bet (2772) returned to junior_re612
junior_re612 collected 8420 from pot
junior_re612: doesn't show hand 
*** SUMMARY ***
Total pot 8420 | Rake 0 
Board [3c 5c Ks]
Seat 1: Katwoman0106 (big blind) folded on the Flop
Seat 2: fAArid88 folded before Flop (didn't bet)
Seat 3: Sully1993_11 folded on the Flop
Seat 4: nahumdj folded before Flop (didn't bet)
Seat 5: johnyguedes1 folded before Flop (didn't bet)
Seat 6: yuzoyai folded before Flop (didn't bet)
Seat 7: junior_re612 (button) collected (8420)
Seat 8: epo9 (small blind) folded before Flop

PokerStars Hand #251205079554: Tournament #3767885527, $40+$10+$5 USD Hold'em No Limit - Level VIII (350/700) - 2024/06/26 18:31:47 UTC [2024/06/26 14:31:47 ET]
Table '3767885527 37' 8-max Seat #8 is the button
Seat 1: Katwoman0106 (22460 in chips) 
Seat 2: fAArid88 (15381 in chips) 
Seat 3: Sully1993_11 (17708 in chips) 
Seat 4: nahumdj (36447 in chips) 
Seat 5: johnyguedes1 (71367 in chips) 
Seat 6: yuzoyai (10561 in chips) 
Seat 7: junior_re612 (50505 in chips) 
Seat 8: epo9 (32580 in chips) 
Katwoman0106: posts the ante 90
fAArid88: posts the ante 90
Sully1993_11: posts the ante 90
nahumdj: posts the ante 90
johnyguedes1: posts the ante 90
yuzoyai: posts the ante 90
junior_re612: posts the ante 90
epo9: posts the ante 90
Katwoman0106: posts small blind 350
fAArid88: posts big blind 700
*** HOLE CARDS ***
Sully1993_11: folds 
nahumdj: folds 
johnyguedes1: folds 
yuzoyai: folds 
junior_re612: raises 700 to 1400
epo9: folds 
Katwoman0106: folds 
fAArid88: folds 
Uncalled bet (700) returned to junior_re612
junior_re612 collected 2470 from pot
junior_re612: doesn't show hand 
*** SUMMARY ***
Total pot 2470 | Rake 0 
Seat 1: Katwoman0106 (small blind) folded before Flop
Seat 2: fAArid88 (big blind) folded before Flop
Seat 3: Sully1993_11 folded before Flop (didn't bet)
Seat 4: nahumdj folded before Flop (didn't bet)
Seat 5: johnyguedes1 folded before Flop (didn't bet)
Seat 6: yuzoyai folded before Flop (didn't bet)
Seat 7: junior_re612 collected (2470)
Seat 8: epo9 (button) folded before Flop (didn't bet)

PokerStars Hand #251205088586: Tournament #3767885527, $40+$10+$5 USD Hold'em No Limit - Level IX (400/800) - 2024/06/26 18:32:23 UTC [2024/06/26 14:32:23 ET]
Table '3767885527 37' 8-max Seat #1 is the button
Seat 1: Katwoman0106 (22020 in chips) 
Seat 2: fAArid88 (14591 in chips) 
Seat 3: Sully1993_11 (17618 in chips) 
Seat 4: nahumdj (36357 in chips) 
Seat 5: johnyguedes1 (71277 in chips) 
Seat 6: yuzoyai (10471 in chips) 
Seat 7: junior_re612 (52185 in chips) 
Seat 8: epo9 (32490 in chips) 
Katwoman0106: posts the ante 100
fAArid88: posts the ante 100
Sully1993_11: posts the ante 100
nahumdj: posts the ante 100
johnyguedes1: posts the ante 100
yuzoyai: posts the ante 100
junior_re612: posts the ante 100
epo9: posts the ante 100
fAArid88: posts small blind 400
Sully1993_11: posts big blind 800
*** HOLE CARDS ***
nahumdj: folds 
johnyguedes1: raises 880 to 1680
yuzoyai: folds 
junior_re612: folds 
epo9: folds 
Katwoman0106: calls 1680
fAArid88: folds 
Sully1993_11: folds 
*** FLOP *** [Ad Ah 9s]
johnyguedes1: checks 
Katwoman0106: checks 
*** TURN *** [Ad Ah 9s] [6h]
johnyguedes1: bets 4449
Katwoman0106: folds 
Uncalled bet (4449) returned to johnyguedes1
johnyguedes1 collected 5360 from pot
johnyguedes1: doesn't show hand 
*** SUMMARY ***
Total pot 5360 | Rake 0 
Board [Ad Ah 9s 6h]
Seat 1: Katwoman0106 (button) folded on the Turn
Seat 2: fAArid88 (small blind) folded before Flop
Seat 3: Sully1993_11 (big blind) folded before Flop
Seat 4: nahumdj folded before Flop (didn't bet)
Seat 5: johnyguedes1 collected (5360)
Seat 6: yuzoyai folded before Flop (didn't bet)
Seat 7: junior_re612 folded before Flop (didn't bet)
Seat 8: epo9 folded before Flop (didn't bet)

PokerStars Hand #251205104056: Tournament #3767885527, $40+$10+$5 USD Hold'em No Limit - Level IX (400/800) - 2024/06/26 18:33:23 UTC [2024/06/26 14:33:23 ET]
Table '3767885527 37' 8-max Seat #2 is the button
Seat 1: Katwoman0106 (20240 in chips) 
Seat 2: fAArid88 (14091 in chips) 
Seat 3: Sully1993_11 (16718 in chips) 
Seat 4: nahumdj (36257 in chips) 
Seat 5: johnyguedes1 (74857 in chips) 
Seat 6: yuzoyai (10371 in chips) 
Seat 7: junior_re612 (52085 in chips) 
Seat 8: epo9 (32390 in chips) 
Katwoman0106: posts the ante 100
fAArid88: posts the ante 100
Sully1993_11: posts the ante 100
nahumdj: posts the ante 100
johnyguedes1: posts the ante 100
yuzoyai: posts the ante 100
junior_re612: posts the ante 100
epo9: posts the ante 100
Sully1993_11: posts small blind 400
nahumdj: posts big blind 800
*** HOLE CARDS ***
johnyguedes1: folds 
yuzoyai: folds 
junior_re612: folds 
epo9: raises 800 to 1600
Katwoman0106: folds 
fAArid88: folds 
Sully1993_11: calls 1200
nahumdj: calls 800
*** FLOP *** [Kc Ad 8d]
Sully1993_11: bets 2800
nahumdj: calls 2800
epo9: calls 2800
*** TURN *** [Kc Ad 8d] [Ks]
Sully1993_11: checks 
nahumdj: checks 
epo9: bets 4000
Sully1993_11: calls 4000
nahumdj: folds 
*** RIVER *** [Kc Ad 8d Ks] [4h]
Sully1993_11: checks 
epo9: checks 
*** SHOW DOWN ***
Sully1993_11: shows [Qh Ah] (two pair, Aces and Kings)
epo9: mucks hand 
Sully1993_11 collected 22000 from pot
*** SUMMARY ***
Total pot 22000 | Rake 0 
Board [Kc Ad 8d Ks 4h]
Seat 1: Katwoman0106 folded before Flop (didn't bet)
Seat 2: fAArid88 (button) folded before Flop (didn't bet)
Seat 3: Sully1993_11 (small blind) showed [Qh Ah] and won (22000) with two pair, Aces and Kings
Seat 4: nahumdj (big blind) folded on the Turn
Seat 5: johnyguedes1 folded before Flop (didn't bet)
Seat 6: yuzoyai folded before Flop (didn't bet)
Seat 7: junior_re612 folded before Flop (didn't bet)
Seat 8: epo9 mucked

PokerStars Hand #251205120323: Tournament #3767885527, $40+$10+$5 USD Hold'em No Limit - Level IX (400/800) - 2024/06/26 18:34:27 UTC [2024/06/26 14:34:27 ET]
Table '3767885527 37' 8-max Seat #3 is the button
Seat 1: Katwoman0106 (20140 in chips) 
Seat 2: fAArid88 (13991 in chips) 
Seat 3: Sully1993_11 (30218 in chips) 
Seat 4: nahumdj (31757 in chips) 
Seat 5: johnyguedes1 (74757 in chips) 
Seat 6: yuzoyai (10271 in chips) 
Seat 7: junior_re612 (51985 in chips) 
Seat 8: epo9 (23890 in chips) 
Katwoman0106: posts the ante 100
fAArid88: posts the ante 100
Sully1993_11: posts the ante 100
nahumdj: posts the ante 100
johnyguedes1: posts the ante 100
yuzoyai: posts the ante 100
junior_re612: posts the ante 100
epo9: posts the ante 100
nahumdj: posts small blind 400
johnyguedes1: posts big blind 800
*** HOLE CARDS ***
yuzoyai: folds 
junior_re612: folds 
epo9: folds 
Katwoman0106: folds 
fAArid88: folds 
Sully1993_11: folds 
nahumdj: folds 
Uncalled bet (400) returned to johnyguedes1
johnyguedes1 collected 1600 from pot
johnyguedes1: doesn't show hand 
*** SUMMARY ***
Total pot 1600 | Rake 0 
Seat 1: Katwoman0106 folded before Flop (didn't bet)
Seat 2: fAArid88 folded before Flop (didn't bet)
Seat 3: Sully1993_11 (button) folded before Flop (didn't bet)
Seat 4: nahumdj (small blind) folded before Flop
Seat 5: johnyguedes1 (big blind) collected (1600)
Seat 6: yuzoyai folded before Flop (didn't bet)
Seat 7: junior_re612 folded before Flop (didn't bet)
Seat 8: epo9 folded before Flop (didn't bet)

PokerStars Hand #251205130850: Tournament #3767885527, $40+$10+$5 USD Hold'em No Limit - Level IX (400/800) - 2024/06/26 18:35:08 UTC [2024/06/26 14:35:08 ET]
Table '3767885527 37' 8-max Seat #4 is the button
Seat 1: Katwoman0106 (20040 in chips) 
Seat 2: fAArid88 (13891 in chips) 
Seat 3: Sully1993_11 (30118 in chips) 
Seat 4: nahumdj (31257 in chips) 
Seat 5: johnyguedes1 (75857 in chips) 
Seat 6: yuzoyai (10171 in chips) 
Seat 7: junior_re612 (51885 in chips) 
Seat 8: epo9 (23790 in chips) 
Katwoman0106: posts the ante 100
fAArid88: posts the ante 100
Sully1993_11: posts the ante 100
nahumdj: posts the ante 100
johnyguedes1: posts the ante 100
yuzoyai: posts the ante 100
junior_re612: posts the ante 100
epo9: posts the ante 100
johnyguedes1: posts small blind 400
yuzoyai: posts big blind 800
*** HOLE CARDS ***
junior_re612: folds 
epo9: folds 
Katwoman0106: folds 
fAArid88: folds 
Sully1993_11: calls 800
nahumdj: folds 
johnyguedes1: raises 2400 to 3200
yuzoyai: raises 6871 to 10071 and is all-in
Sully1993_11: folds 
johnyguedes1: calls 6871
*** FLOP *** [7h 2c Qs]
*** TURN *** [7h 2c Qs] [5h]
*** RIVER *** [7h 2c Qs 5h] [5c]
*** SHOW DOWN ***
johnyguedes1: shows [Tc Jc] (a pair of Fives)
yuzoyai: shows [Ah Qh] (two pair, Queens and Fives)
yuzoyai collected 21742 from pot
*** SUMMARY ***
Total pot 21742 | Rake 0 
Board [7h 2c Qs 5h 5c]
Seat 1: Katwoman0106 folded before Flop (didn't bet)
Seat 2: fAArid88 folded before Flop (didn't bet)
Seat 3: Sully1993_11 folded before Flop
Seat 4: nahumdj (button) folded before Flop (didn't bet)
Seat 5: johnyguedes1 (small blind) showed [Tc Jc] and lost with a pair of Fives
Seat 6: yuzoyai (big blind) showed [Ah Qh] and won (21742) with two pair, Queens and Fives
Seat 7: junior_re612 folded before Flop (didn't bet)
Seat 8: epo9 folded before Flop (didn't bet)

PokerStars Hand #251205149407: Tournament #3767885527, $40+$10+$5 USD Hold'em No Limit - Level IX (400/800) - 2024/06/26 18:36:21 UTC [2024/06/26 14:36:21 ET]
Table '3767885527 37' 8-max Seat #5 is the button
Seat 1: Katwoman0106 (19940 in chips) 
Seat 2: fAArid88 (13791 in chips) 
Seat 3: Sully1993_11 (29218 in chips) 
Seat 4: nahumdj (31157 in chips) 
Seat 5: johnyguedes1 (65686 in chips) 
Seat 6: yuzoyai (21742 in chips) 
Seat 7: junior_re612 (51785 in chips) 
Seat 8: epo9 (23690 in chips) 
Katwoman0106: posts the ante 100
fAArid88: posts the ante 100
Sully1993_11: posts the ante 100
nahumdj: posts the ante 100
johnyguedes1: posts the ante 100
yuzoyai: posts the ante 100
junior_re612: posts the ante 100
epo9: posts the ante 100
yuzoyai: posts small blind 400
junior_re612: posts big blind 800
*** HOLE CARDS ***
epo9: folds 
Katwoman0106: folds 
fAArid88: folds 
Sully1993_11: raises 1600 to 2400
nahumdj: folds 
johnyguedes1: folds 
yuzoyai: folds 
junior_re612: folds 
Uncalled bet (1600) returned to Sully1993_11
Sully1993_11 collected 2800 from pot
Sully1993_11: doesn't show hand 
*** SUMMARY ***
Total pot 2800 | Rake 0 
Seat 1: Katwoman0106 folded before Flop (didn't bet)
Seat 2: fAArid88 folded before Flop (didn't bet)
Seat 3: Sully1993_11 collected (2800)
Seat 4: nahumdj folded before Flop (didn't bet)
Seat 5: johnyguedes1 (button) folded before Flop (didn't bet)
Seat 6: yuzoyai (small blind) folded before Flop
Seat 7: junior_re612 (big blind) folded before Flop
Seat 8: epo9 folded before Flop (didn't bet)

PokerStars Hand #251205158420: Tournament #3767885527, $40+$10+$5 USD Hold'em No Limit - Level IX (400/800) - 2024/06/26 18:36:56 UTC [2024/06/26 14:36:56 ET]
Table '3767885527 37' 8-max Seat #6 is the button
Seat 1: Katwoman0106 (19840 in chips) 
Seat 2: fAArid88 (13691 in chips) 
Seat 3: Sully1993_11 (31118 in chips) 
Seat 4: nahumdj (31057 in chips) 
Seat 5: johnyguedes1 (65586 in chips) 
Seat 6: yuzoyai (21242 in chips) 
Seat 7: junior_re612 (50885 in chips) 
Seat 8: epo9 (23590 in chips) 
Katwoman0106: posts the ante 100
fAArid88: posts the ante 100
Sully1993_11: posts the ante 100
nahumdj: posts the ante 100
johnyguedes1: posts the ante 100
yuzoyai: posts the ante 100
junior_re612: posts the ante 100
epo9: posts the ante 100
junior_re612: posts small blind 400
epo9: posts big blind 800
*** HOLE CARDS ***
Katwoman0106: raises 800 to 1600
fAArid88: folds 
Sully1993_11: folds 
nahumdj: folds 
johnyguedes1: folds 
yuzoyai: folds 
junior_re612: calls 1200
epo9: calls 800
*** FLOP *** [8s 3h Th]
junior_re612: checks 
epo9: bets 2400
Katwoman0106: calls 2400
junior_re612: folds 
*** TURN *** [8s 3h Th] [4c]
epo9: bets 7200
Katwoman0106: raises 8540 to 15740 and is all-in
epo9: calls 8540
*** RIVER *** [8s 3h Th 4c] [Ad]
*** SHOW DOWN ***
epo9: shows [9h Kh] (high card Ace)
Katwoman0106: shows [Td Kd] (a pair of Tens)
Katwoman0106 collected 41880 from pot
*** SUMMARY ***
Total pot 41880 | Rake 0 
Board [8s 3h Th 4c Ad]
Seat 1: Katwoman0106 showed [Td Kd] and won (41880) with a pair of Tens
Seat 2: fAArid88 folded before Flop (didn't bet)
Seat 3: Sully1993_11 folded before Flop (didn't bet)
Seat 4: nahumdj folded before Flop (didn't bet)
Seat 5: johnyguedes1 folded before Flop (didn't bet)
Seat 6: yuzoyai (button) folded before Flop (didn't bet)
Seat 7: junior_re612 (small blind) folded on the Flop
Seat 8: epo9 (big blind) showed [9h Kh] and lost with high card Ace

PokerStars Hand #251205177548: Tournament #3767885527, $40+$10+$5 USD Hold'em No Limit - Level IX (400/800) - 2024/06/26 18:38:09 UTC [2024/06/26 14:38:09 ET]
Table '3767885527 37' 8-max Seat #7 is the button
Seat 1: Katwoman0106 (41880 in chips) 
Seat 2: fAArid88 (13591 in chips) 
Seat 3: Sully1993_11 (31018 in chips) 
Seat 4: nahumdj (30957 in chips) 
Seat 5: johnyguedes1 (65486 in chips) 
Seat 6: yuzoyai (21142 in chips) 
Seat 7: junior_re612 (49185 in chips) 
Seat 8: epo9 (3750 in chips) 
Katwoman0106: posts the ante 100
fAArid88: posts the ante 100
Sully1993_11: posts the ante 100
nahumdj: posts the ante 100
johnyguedes1: posts the ante 100
yuzoyai: posts the ante 100
junior_re612: posts the ante 100
epo9: posts the ante 100
epo9: posts small blind 400
Katwoman0106: posts big blind 800
*** HOLE CARDS ***
fAArid88: folds 
Sully1993_11: calls 800
nahumdj: folds 
johnyguedes1: folds 
yuzoyai: folds 
junior_re612: folds 
epo9: calls 400
Katwoman0106: checks 
*** FLOP *** [3s 6d Jd]
epo9: checks 
Katwoman0106: checks 
Sully1993_11: checks 
*** TURN *** [3s 6d Jd] [Qc]
epo9: bets 2850 and is all-in
Katwoman0106: folds 
Sully1993_11: folds 
Uncalled bet (2850) returned to epo9
epo9 collected 3200 from pot
*** SUMMARY ***
Total pot 3200 | Rake 0 
Board [3s 6d Jd Qc]
Seat 1: Katwoman0106 (big blind) folded on the Turn
Seat 2: fAArid88 folded before Flop (didn't bet)
Seat 3: Sully1993_11 folded on the Turn
Seat 4: nahumdj folded before Flop (didn't bet)
Seat 5: johnyguedes1 folded before Flop (didn't bet)
Seat 6: yuzoyai folded before Flop (didn't bet)
Seat 7: junior_re612 (button) folded before Flop (didn't bet)
Seat 8: epo9 (small blind) collected (3200)

PokerStars Hand #251205191801: Tournament #3767885527, $40+$10+$5 USD Hold'em No Limit - Level IX (400/800) - 2024/06/26 18:39:05 UTC [2024/06/26 14:39:05 ET]
Table '3767885527 37' 8-max Seat #8 is the button
Seat 1: Katwoman0106 (40980 in chips) 
Seat 2: fAArid88 (13491 in chips) 
Seat 3: Sully1993_11 (30118 in chips) 
Seat 4: nahumdj (30857 in chips) 
Seat 5: johnyguedes1 (65386 in chips) 
Seat 6: yuzoyai (21042 in chips) 
Seat 7: junior_re612 (49085 in chips) 
Seat 8: epo9 (6050 in chips) 
Katwoman0106: posts the ante 100
fAArid88: posts the ante 100
Sully1993_11: posts the ante 100
nahumdj: posts the ante 100
johnyguedes1: posts the ante 100
yuzoyai: posts the ante 100
junior_re612: posts the ante 100
epo9: posts the ante 100
Katwoman0106: posts small blind 400
fAArid88: posts big blind 800
*** HOLE CARDS ***
Sully1993_11: folds 
nahumdj: raises 800 to 1600
johnyguedes1: folds 
yuzoyai: folds 
junior_re612: folds 
epo9: folds 
Katwoman0106: folds 
fAArid88: raises 11791 to 13391 and is all-in
nahumdj: calls 11791
*** FLOP *** [4h Kc 2c]
*** TURN *** [4h Kc 2c] [4c]
*** RIVER *** [4h Kc 2c 4c] [8c]
*** SHOW DOWN ***
fAArid88: shows [Tc Ts] (a flush, King high)
nahumdj: shows [9s 9d] (two pair, Nines and Fours)
fAArid88 collected 27982 from pot
*** SUMMARY ***
Total pot 27982 | Rake 0 
Board [4h Kc 2c 4c 8c]
Seat 1: Katwoman0106 (small blind) folded before Flop
Seat 2: fAArid88 (big blind) showed [Tc Ts] and won (27982) with a flush, King high
Seat 3: Sully1993_11 folded before Flop (didn't bet)
Seat 4: nahumdj showed [9s 9d] and lost with two pair, Nines and Fours
Seat 5: johnyguedes1 folded before Flop (didn't bet)
Seat 6: yuzoyai folded before Flop (didn't bet)
Seat 7: junior_re612 folded before Flop (didn't bet)
Seat 8: epo9 (button) folded before Flop (didn't bet)

PokerStars Hand #251205202869: Tournament #3767885527, $40+$10+$5 USD Hold'em No Limit - Level IX (400/800) - 2024/06/26 18:39:48 UTC [2024/06/26 14:39:48 ET]
Table '3767885527 37' 8-max Seat #1 is the button
Seat 1: Katwoman0106 (40480 in chips) 
Seat 2: fAArid88 (27982 in chips) 
Seat 3: Sully1993_11 (30018 in chips) 
Seat 4: nahumdj (17366 in chips) 
Seat 5: johnyguedes1 (65286 in chips) 
Seat 6: yuzoyai (20942 in chips) 
Seat 7: junior_re612 (48985 in chips) 
Seat 8: epo9 (5950 in chips) 
Katwoman0106: posts the ante 100
fAArid88: posts the ante 100
Sully1993_11: posts the ante 100
nahumdj: posts the ante 100
johnyguedes1: posts the ante 100
yuzoyai: posts the ante 100
junior_re612: posts the ante 100
epo9: posts the ante 100
fAArid88: posts small blind 400
Sully1993_11: posts big blind 800
*** HOLE CARDS ***
nahumdj: folds 
johnyguedes1: folds 
yuzoyai: folds 
junior_re612: raises 800 to 1600
epo9: folds 
Katwoman0106: folds 
fAArid88: folds 
Sully1993_11: folds 
Uncalled bet (800) returned to junior_re612
junior_re612 collected 2800 from pot
junior_re612: doesn't show hand 
*** SUMMARY ***
Total pot 2800 | Rake 0 
Seat 1: Katwoman0106 (button) folded before Flop (didn't bet)
Seat 2: fAArid88 (small blind) folded before Flop
Seat 3: Sully1993_11 (big blind) folded before Flop
Seat 4: nahumdj folded before Flop (didn't bet)
Seat 5: johnyguedes1 folded before Flop (didn't bet)
Seat 6: yuzoyai folded before Flop (didn't bet)
Seat 7: junior_re612 collected (2800)
Seat 8: epo9 folded before Flop (didn't bet)

PokerStars Hand #251205212451: Tournament #3767885527, $40+$10+$5 USD Hold'em No Limit - Level IX (400/800) - 2024/06/26 18:40:24 UTC [2024/06/26 14:40:24 ET]
Table '3767885527 37' 8-max Seat #2 is the button
Seat 1: Katwoman0106 (40380 in chips) 
Seat 2: fAArid88 (27482 in chips) 
Seat 3: Sully1993_11 (29118 in chips) 
Seat 4: nahumdj (17266 in chips) 
Seat 5: johnyguedes1 (65186 in chips) 
Seat 6: yuzoyai (20842 in chips) 
Seat 7: junior_re612 (50885 in chips) 
Seat 8: epo9 (5850 in chips) 
Katwoman0106: posts the ante 100
fAArid88: posts the ante 100
Sully1993_11: posts the ante 100
nahumdj: posts the ante 100
johnyguedes1: posts the ante 100
yuzoyai: posts the ante 100
junior_re612: posts the ante 100
epo9: posts the ante 100
Sully1993_11: posts small blind 400
nahumdj: posts big blind 800
*** HOLE CARDS ***
johnyguedes1: folds 
yuzoyai: folds 
junior_re612: raises 800 to 1600
epo9: calls 1600
Katwoman0106: calls 1600
fAArid88: folds 
Sully1993_11: folds 
nahumdj: folds 
*** FLOP *** [Jd 7c 7h]
junior_re612: checks 
epo9: bets 4150 and is all-in
Katwoman0106: calls 4150
junior_re612: folds 
*** TURN *** [Jd 7c 7h] [Ah]
*** RIVER *** [Jd 7c 7h Ah] [Qd]
*** SHOW DOWN ***
epo9: shows [Ks Qs] (two pair, Queens and Sevens)
Katwoman0106: shows [7d 7s] (four of a kind, Sevens)
Katwoman0106 collected 15100 from pot
epo9 finished the tournament
*** SUMMARY ***
Total pot 15100 | Rake 0 
Board [Jd 7c 7h Ah Qd]
Seat 1: Katwoman0106 showed [7d 7s] and won (15100) with four of a kind, Sevens
Seat 2: fAArid88 (button) folded before Flop (didn't bet)
Seat 3: Sully1993_11 (small blind) folded before Flop
Seat 4: nahumdj (big blind) folded before Flop
Seat 5: johnyguedes1 folded before Flop (didn't bet)
Seat 6: yuzoyai folded before Flop (didn't bet)
Seat 7: junior_re612 folded on the Flop
Seat 8: epo9 showed [Ks Qs] and lost with two pair, Queens and Sevens

PokerStars Hand #251205229299: Tournament #3767885527, $40+$10+$5 USD Hold'em No Limit - Level IX (400/800) - 2024/06/26 18:41:29 UTC [2024/06/26 14:41:29 ET]
Table '3767885527 37' 8-max Seat #3 is the button
Seat 1: Katwoman0106 (49630 in chips) 
Seat 2: fAArid88 (27382 in chips) 
Seat 3: Sully1993_11 (28618 in chips) 
Seat 4: nahumdj (16366 in chips) 
Seat 5: johnyguedes1 (65086 in chips) 
Seat 6: yuzoyai (20742 in chips) 
Seat 7: junior_re612 (49185 in chips) 
Katwoman0106: posts the ante 100
fAArid88: posts the ante 100
Sully1993_11: posts the ante 100
nahumdj: posts the ante 100
johnyguedes1: posts the ante 100
yuzoyai: posts the ante 100
junior_re612: posts the ante 100
nahumdj: posts small blind 400
johnyguedes1: posts big blind 800
*** HOLE CARDS ***
yuzoyai: folds 
junior_re612: folds 
Katwoman0106: folds 
fAArid88: folds 
Sully1993_11: folds 
nahumdj: folds 
Uncalled bet (400) returned to johnyguedes1
johnyguedes1 collected 1500 from pot
johnyguedes1: doesn't show hand 
*** SUMMARY ***
Total pot 1500 | Rake 0 
Seat 1: Katwoman0106 folded before Flop (didn't bet)
Seat 2: fAArid88 folded before Flop (didn't bet)
Seat 3: Sully1993_11 (button) folded before Flop (didn't bet)
Seat 4: nahumdj (small blind) folded before Flop
Seat 5: johnyguedes1 (big blind) collected (1500)
Seat 6: yuzoyai folded before Flop (didn't bet)
Seat 7: junior_re612 folded before Flop (didn't bet)

PokerStars Hand #251205233398: Tournament #3767885527, $40+$10+$5 USD Hold'em No Limit - Level IX (400/800) - 2024/06/26 18:41:45 UTC [2024/06/26 14:41:45 ET]
Table '3767885527 37' 8-max Seat #4 is the button
Seat 1: Katwoman0106 (49530 in chips) 
Seat 2: fAArid88 (27282 in chips) 
Seat 3: Sully1993_11 (28518 in chips) 
Seat 4: nahumdj (15866 in chips) 
Seat 5: johnyguedes1 (66086 in chips) 
Seat 6: yuzoyai (20642 in chips) 
Seat 7: junior_re612 (49085 in chips) 
Katwoman0106: posts the ante 100
fAArid88: posts the ante 100
Sully1993_11: posts the ante 100
nahumdj: posts the ante 100
johnyguedes1: posts the ante 100
yuzoyai: posts the ante 100
junior_re612: posts the ante 100
johnyguedes1: posts small blind 400
yuzoyai: posts big blind 800
*** HOLE CARDS ***
junior_re612: raises 800 to 1600
Katwoman0106: folds 
fAArid88: folds 
Sully1993_11: calls 1600
nahumdj: raises 14166 to 15766 and is all-in
johnyguedes1: folds 
yuzoyai: folds 
junior_re612: folds 
Sully1993_11: folds 
Uncalled bet (14166) returned to nahumdj
nahumdj collected 6700 from pot
*** SUMMARY ***
Total pot 6700 | Rake 0 
Seat 1: Katwoman0106 folded before Flop (didn't bet)
Seat 2: fAArid88 folded before Flop (didn't bet)
Seat 3: Sully1993_11 folded before Flop
Seat 4: nahumdj (button) collected (6700)
Seat 5: johnyguedes1 (small blind) folded before Flop
Seat 6: yuzoyai (big blind) folded before Flop
Seat 7: junior_re612 folded before Flop

PokerStars Hand #251205245960: Tournament #3767885527, $40+$10+$5 USD Hold'em No Limit - Level X (500/1000) - 2024/06/26 18:42:33 UTC [2024/06/26 14:42:33 ET]
Table '3767885527 37' 8-max Seat #5 is the button
Seat 1: Katwoman0106 (49430 in chips) 
Seat 2: fAArid88 (27182 in chips) 
Seat 3: Sully1993_11 (26818 in chips) 
Seat 4: nahumdj (20866 in chips) 
Seat 5: johnyguedes1 (65586 in chips) 
Seat 6: yuzoyai (19742 in chips) 
Seat 7: junior_re612 (47385 in chips) 
Seat 8: Amandaraujo (34196 in chips) 
Katwoman0106: posts the ante 125
fAArid88: posts the ante 125
Sully1993_11: posts the ante 125
nahumdj: posts the ante 125
johnyguedes1: posts the ante 125
yuzoyai: posts the ante 125
junior_re612: posts the ante 125
Amandaraujo: posts the ante 125
yuzoyai: posts small blind 500
junior_re612: posts big blind 1000
*** HOLE CARDS ***
Amandaraujo: raises 1000 to 2000
Katwoman0106: folds 
fAArid88: folds 
Sully1993_11: folds 
nahumdj: folds 
johnyguedes1: folds 
yuzoyai: folds 
junior_re612: calls 1000
*** FLOP *** [2h Qs Kc]
junior_re612: checks 
Amandaraujo: bets 3750
junior_re612: folds 
Uncalled bet (3750) returned to Amandaraujo
Amandaraujo collected 5500 from pot
Amandaraujo: doesn't show hand 
*** SUMMARY ***
Total pot 5500 | Rake 0 
Board [2h Qs Kc]
Seat 1: Katwoman0106 folded before Flop (didn't bet)
Seat 2: fAArid88 folded before Flop (didn't bet)
Seat 3: Sully1993_11 folded before Flop (didn't bet)
Seat 4: nahumdj folded before Flop (didn't bet)
Seat 5: johnyguedes1 (button) folded before Flop (didn't bet)
Seat 6: yuzoyai (small blind) folded before Flop
Seat 7: junior_re612 (big blind) folded on the Flop
Seat 8: Amandaraujo collected (5500)

PokerStars Hand #251205263306: Tournament #3767885527, $40+$10+$5 USD Hold'em No Limit - Level X (500/1000) - 2024/06/26 18:43:39 UTC [2024/06/26 14:43:39 ET]
Table '3767885527 37' 8-max Seat #6 is the button
Seat 1: Katwoman0106 (49305 in chips) 
Seat 2: fAArid88 (27057 in chips) 
Seat 3: Sully1993_11 (26693 in chips) 
Seat 4: nahumdj (20741 in chips) 
Seat 5: johnyguedes1 (65461 in chips) 
Seat 6: yuzoyai (19117 in chips) 
Seat 7: junior_re612 (45260 in chips) 
Seat 8: Amandaraujo (37571 in chips) 
Katwoman0106: posts the ante 125
fAArid88: posts the ante 125
Sully1993_11: posts the ante 125
nahumdj: posts the ante 125
johnyguedes1: posts the ante 125
yuzoyai: posts the ante 125
junior_re612: posts the ante 125
Amandaraujo: posts the ante 125
junior_re612: posts small blind 500
Amandaraujo: posts big blind 1000
*** HOLE CARDS ***
Katwoman0106: folds 
fAArid88: raises 1000 to 2000
Sully1993_11: folds 
nahumdj: folds 
johnyguedes1: folds 
yuzoyai: folds 
junior_re612: folds 
Amandaraujo: calls 1000
*** FLOP *** [Ts Qh Qd]
Amandaraujo: checks 
fAArid88: checks 
*** TURN *** [Ts Qh Qd] [4s]
Amandaraujo: checks 
fAArid88: bets 1375
Amandaraujo: calls 1375
*** RIVER *** [Ts Qh Qd 4s] [4d]
Amandaraujo: checks 
fAArid88: checks 
*** SHOW DOWN ***
Amandaraujo: shows [3d 3h] (two pair, Queens and Fours)
fAArid88: shows [Ah 9h] (two pair, Queens and Fours - Ace kicker)
fAArid88 collected 8250 from pot
*** SUMMARY ***
Total pot 8250 | Rake 0 
Board [Ts Qh Qd 4s 4d]
Seat 1: Katwoman0106 folded before Flop (didn't bet)
Seat 2: fAArid88 showed [Ah 9h] and won (8250) with two pair, Queens and Fours
Seat 3: Sully1993_11 folded before Flop (didn't bet)
Seat 4: nahumdj folded before Flop (didn't bet)
Seat 5: johnyguedes1 folded before Flop (didn't bet)
Seat 6: yuzoyai (button) folded before Flop (didn't bet)
Seat 7: junior_re612 (small blind) folded before Flop
Seat 8: Amandaraujo (big blind) showed [3d 3h] and lost with two pair, Queens and Fours

PokerStars Hand #251205277832: Tournament #3767885527, $40+$10+$5 USD Hold'em No Limit - Level X (500/1000) - 2024/06/26 18:44:34 UTC [2024/06/26 14:44:34 ET]
Table '3767885527 37' 8-max Seat #7 is the button
Seat 1: Katwoman0106 (49180 in chips) 
Seat 2: fAArid88 (31807 in chips) 
Seat 3: Sully1993_11 (26568 in chips) 
Seat 4: nahumdj (20616 in chips) 
Seat 5: johnyguedes1 (65336 in chips) 
Seat 6: yuzoyai (18992 in chips) 
Seat 7: junior_re612 (44635 in chips) 
Seat 8: Amandaraujo (34071 in chips) 
Katwoman0106: posts the ante 125
fAArid88: posts the ante 125
Sully1993_11: posts the ante 125
nahumdj: posts the ante 125
johnyguedes1: posts the ante 125
yuzoyai: posts the ante 125
junior_re612: posts the ante 125
Amandaraujo: posts the ante 125
Amandaraujo: posts small blind 500
Katwoman0106: posts big blind 1000
*** HOLE CARDS ***
fAArid88: folds 
Sully1993_11: folds 
nahumdj: folds 
johnyguedes1: folds 
yuzoyai: folds 
junior_re612: raises 1500 to 2500
Amandaraujo: calls 2000
Katwoman0106: calls 1500
*** FLOP *** [5s Qh Js]
Amandaraujo: bets 4250
Katwoman0106: folds 
junior_re612: calls 4250
*** TURN *** [5s Qh Js] [6c]
Amandaraujo: checks 
junior_re612: checks 
*** RIVER *** [5s Qh Js 6c] [5h]
Amandaraujo: checks 
junior_re612: bets 12750
Amandaraujo: folds 
Uncalled bet (12750) returned to junior_re612
junior_re612 collected 17000 from pot
junior_re612: doesn't show hand 
*** SUMMARY ***
Total pot 17000 | Rake 0 
Board [5s Qh Js 6c 5h]
Seat 1: Katwoman0106 (big blind) folded on the Flop
Seat 2: fAArid88 folded before Flop (didn't bet)
Seat 3: Sully1993_11 folded before Flop (didn't bet)
Seat 4: nahumdj folded before Flop (didn't bet)
Seat 5: johnyguedes1 folded before Flop (didn't bet)
Seat 6: yuzoyai folded before Flop (didn't bet)
Seat 7: junior_re612 (button) collected (17000)
Seat 8: Amandaraujo (small blind) folded on the River

PokerStars Hand #251205293414: Tournament #3767885527, $40+$10+$5 USD Hold'em No Limit - Level X (500/1000) - 2024/06/26 18:45:33 UTC [2024/06/26 14:45:33 ET]
Table '3767885527 37' 8-max Seat #8 is the button
Seat 1: Katwoman0106 (46555 in chips) 
Seat 2: fAArid88 (31682 in chips) 
Seat 3: Sully1993_11 (26443 in chips) 
Seat 4: nahumdj (20491 in chips) 
Seat 5: johnyguedes1 (65211 in chips) 
Seat 6: yuzoyai (18867 in chips) 
Seat 7: junior_re612 (54760 in chips) 
Seat 8: Amandaraujo (27196 in chips) 
Katwoman0106: posts the ante 125
fAArid88: posts the ante 125
Sully1993_11: posts the ante 125
nahumdj: posts the ante 125
johnyguedes1: posts the ante 125
yuzoyai: posts the ante 125
junior_re612: posts the ante 125
Amandaraujo: posts the ante 125
Katwoman0106: posts small blind 500
fAArid88: posts big blind 1000
*** HOLE CARDS ***
Sully1993_11: folds 
nahumdj: raises 1000 to 2000
johnyguedes1: folds 
yuzoyai: folds 
junior_re612: calls 2000
Amandaraujo: raises 2000 to 4000
Katwoman0106: folds 
fAArid88: folds 
nahumdj: raises 16366 to 20366 and is all-in
junior_re612: folds 
Amandaraujo: calls 16366
*** FLOP *** [9d 4s 7d]
*** TURN *** [9d 4s 7d] [Ts]
*** RIVER *** [9d 4s 7d Ts] [Td]
*** SHOW DOWN ***
nahumdj: shows [As Kc] (a pair of Tens)
Amandaraujo: shows [Jh 8s] (a straight, Seven to Jack)
Amandaraujo collected 45232 from pot
nahumdj finished the tournament
Naaarrrr is disconnected 
*** SUMMARY ***
Total pot 45232 | Rake 0 
Board [9d 4s 7d Ts Td]
Seat 1: Katwoman0106 (small blind) folded before Flop
Seat 2: fAArid88 (big blind) folded before Flop
Seat 3: Sully1993_11 folded before Flop (didn't bet)
Seat 4: nahumdj showed [As Kc] and lost with a pair of Tens
Seat 5: johnyguedes1 folded before Flop (didn't bet)
Seat 6: yuzoyai folded before Flop (didn't bet)
Seat 7: junior_re612 folded before Flop
Seat 8: Amandaraujo (button) showed [Jh 8s] and won (45232) with a straight, Seven to Jack

PokerStars Hand #251205306343: Tournament #3767885527, $40+$10+$5 USD Hold'em No Limit - Level X (500/1000) - 2024/06/26 18:46:21 UTC [2024/06/26 14:46:21 ET]
Table '3767885527 37' 8-max Seat #1 is the button
Seat 1: Katwoman0106 (45930 in chips) 
Seat 2: fAArid88 (30557 in chips) 
Seat 3: Sully1993_11 (26318 in chips) 
Seat 4: Naaarrrr (25000 in chips) 
Seat 5: johnyguedes1 (65086 in chips) 
Seat 6: yuzoyai (18742 in chips) 
Seat 7: junior_re612 (52635 in chips) 
Seat 8: Amandaraujo (51937 in chips) 
Katwoman0106: posts the ante 125
fAArid88: posts the ante 125
Sully1993_11: posts the ante 125
Naaarrrr: posts the ante 125
johnyguedes1: posts the ante 125
yuzoyai: posts the ante 125
junior_re612: posts the ante 125
Amandaraujo: posts the ante 125
fAArid88: posts small blind 500
Sully1993_11: posts big blind 1000
*** HOLE CARDS ***
Naaarrrr: raises 1000 to 2000
johnyguedes1: folds 
yuzoyai: folds 
junior_re612: folds 
Amandaraujo: calls 2000
Katwoman0106: calls 2000
fAArid88: folds 
Sully1993_11: calls 1000
*** FLOP *** [5s 7s 8c]
Sully1993_11: checks 
Naaarrrr: checks 
Amandaraujo: checks 
Katwoman0106: bets 8333
Sully1993_11: raises 15860 to 24193 and is all-in
Naaarrrr: folds 
Amandaraujo: folds 
Katwoman0106: calls 15860
*** TURN *** [5s 7s 8c] [Th]
*** RIVER *** [5s 7s 8c Th] [Jh]
*** SHOW DOWN ***
Sully1993_11: shows [7h 5h] (two pair, Sevens and Fives)
Katwoman0106: shows [4d 6d] (a straight, Four to Eight)
Katwoman0106 collected 57886 from pot
Sully1993_11 finished the tournament
*** SUMMARY ***
Total pot 57886 | Rake 0 
Board [5s 7s 8c Th Jh]
Seat 1: Katwoman0106 (button) showed [4d 6d] and won (57886) with a straight, Four to Eight
Seat 2: fAArid88 (small blind) folded before Flop
Seat 3: Sully1993_11 (big blind) showed [7h 5h] and lost with two pair, Sevens and Fives
Seat 4: Naaarrrr folded on the Flop
Seat 5: johnyguedes1 folded before Flop (didn't bet)
Seat 6: yuzoyai folded before Flop (didn't bet)
Seat 7: junior_re612 folded before Flop (didn't bet)
Seat 8: Amandaraujo folded on the Flop

PokerStars Hand #251205323229: Tournament #3767885527, $40+$10+$5 USD Hold'em No Limit - Level X (500/1000) - 2024/06/26 18:47:26 UTC [2024/06/26 14:47:26 ET]
Table '3767885527 37' 8-max Seat #2 is the button
Seat 1: Katwoman0106 (77498 in chips) 
Seat 2: fAArid88 (29932 in chips) 
Seat 4: Naaarrrr (22875 in chips) 
Seat 5: johnyguedes1 (64961 in chips) 
Seat 6: yuzoyai (18617 in chips) 
Seat 7: junior_re612 (52510 in chips) 
Seat 8: Amandaraujo (49812 in chips) 
Katwoman0106: posts the ante 125
fAArid88: posts the ante 125
Naaarrrr: posts the ante 125
johnyguedes1: posts the ante 125
yuzoyai: posts the ante 125
junior_re612: posts the ante 125
Amandaraujo: posts the ante 125
Naaarrrr: posts small blind 500
johnyguedes1: posts big blind 1000
*** HOLE CARDS ***
yuzoyai: folds 
junior_re612: folds 
Amandaraujo: raises 1000 to 2000
Katwoman0106: folds 
fAArid88: folds 
Naaarrrr: folds 
paulscot1 is disconnected 
johnyguedes1: calls 1000
*** FLOP *** [Kh Jh 2d]
johnyguedes1: checks 
Amandaraujo: checks 
*** TURN *** [Kh Jh 2d] [6c]
johnyguedes1: checks 
Amandaraujo: checks 
*** RIVER *** [Kh Jh 2d 6c] [8c]
johnyguedes1: checks 
Amandaraujo: checks 
*** SHOW DOWN ***
johnyguedes1: shows [7d 7c] (a pair of Sevens)
Amandaraujo: mucks hand 
johnyguedes1 collected 5375 from pot
*** SUMMARY ***
Total pot 5375 | Rake 0 
Board [Kh Jh 2d 6c 8c]
Seat 1: Katwoman0106 folded before Flop (didn't bet)
Seat 2: fAArid88 (button) folded before Flop (didn't bet)
Seat 4: Naaarrrr (small blind) folded before Flop
Seat 5: johnyguedes1 (big blind) showed [7d 7c] and won (5375) with a pair of Sevens
Seat 6: yuzoyai folded before Flop (didn't bet)
Seat 7: junior_re612 folded before Flop (didn't bet)
Seat 8: Amandaraujo mucked

PokerStars Hand #251205333204: Tournament #3767885527, $40+$10+$5 USD Hold'em No Limit - Level X (500/1000) - 2024/06/26 18:48:04 UTC [2024/06/26 14:48:04 ET]
Table '3767885527 37' 8-max Seat #4 is the button
Seat 1: Katwoman0106 (77373 in chips) 
Seat 2: fAArid88 (29807 in chips) 
Seat 3: paulscot1 (25000 in chips) 
Seat 4: Naaarrrr (22250 in chips) 
Seat 5: johnyguedes1 (68211 in chips) 
Seat 6: yuzoyai (18492 in chips) 
Seat 7: junior_re612 (52385 in chips) 
Seat 8: Amandaraujo (47687 in chips) 
Katwoman0106: posts the ante 125
fAArid88: posts the ante 125
paulscot1: posts the ante 125
Naaarrrr: posts the ante 125
johnyguedes1: posts the ante 125
yuzoyai: posts the ante 125
junior_re612: posts the ante 125
Amandaraujo: posts the ante 125
johnyguedes1: posts small blind 500
yuzoyai: posts big blind 1000
*** HOLE CARDS ***
junior_re612: folds 
Amandaraujo: folds 
Katwoman0106: folds 
fAArid88: folds 
paulscot1: raises 1650 to 2650
Naaarrrr: calls 2650
johnyguedes1: folds 
yuzoyai: folds 
*** FLOP *** [Qs Ts Tc]
paulscot1: bets 2574
Naaarrrr: folds 
Uncalled bet (2574) returned to paulscot1
paulscot1 collected 7800 from pot
paulscot1: doesn't show hand 
*** SUMMARY ***
Total pot 7800 | Rake 0 
Board [Qs Ts Tc]
Seat 1: Katwoman0106 folded before Flop (didn't bet)
Seat 2: fAArid88 folded before Flop (didn't bet)
Seat 3: paulscot1 collected (7800)
Seat 4: Naaarrrr (button) folded on the Flop
Seat 5: johnyguedes1 (small blind) folded before Flop
Seat 6: yuzoyai (big blind) folded before Flop
Seat 7: junior_re612 folded before Flop (didn't bet)
Seat 8: Amandaraujo folded before Flop (didn't bet)

PokerStars Hand #251205342935: Tournament #3767885527, $40+$10+$5 USD Hold'em No Limit - Level X (500/1000) - 2024/06/26 18:48:41 UTC [2024/06/26 14:48:41 ET]
Table '3767885527 37' 8-max Seat #5 is the button
Seat 1: Katwoman0106 (77248 in chips) 
Seat 2: fAArid88 (29682 in chips) 
Seat 3: paulscot1 (30025 in chips) 
Seat 4: Naaarrrr (19475 in chips) 
Seat 5: johnyguedes1 (67586 in chips) 
Seat 6: yuzoyai (17367 in chips) 
Seat 7: junior_re612 (52260 in chips) 
Seat 8: Amandaraujo (47562 in chips) 
Katwoman0106: posts the ante 125
fAArid88: posts the ante 125
paulscot1: posts the ante 125
Naaarrrr: posts the ante 125
johnyguedes1: posts the ante 125
yuzoyai: posts the ante 125
junior_re612: posts the ante 125
Amandaraujo: posts the ante 125
yuzoyai: posts small blind 500
junior_re612: posts big blind 1000
*** HOLE CARDS ***
Amandaraujo: folds 
Katwoman0106: folds 
fAArid88: folds 
paulscot1: folds 
Naaarrrr: raises 1000 to 2000
johnyguedes1: folds 
yuzoyai: folds 
junior_re612: folds 
Uncalled bet (1000) returned to Naaarrrr
Naaarrrr collected 3500 from pot
Naaarrrr: doesn't show hand 
*** SUMMARY ***
Total pot 3500 | Rake 0 
Seat 1: Katwoman0106 folded before Flop (didn't bet)
Seat 2: fAArid88 folded before Flop (didn't bet)
Seat 3: paulscot1 folded before Flop (didn't bet)
Seat 4: Naaarrrr collected (3500)
Seat 5: johnyguedes1 (button) folded before Flop (didn't bet)
Seat 6: yuzoyai (small blind) folded before Flop
Seat 7: junior_re612 (big blind) folded before Flop
Seat 8: Amandaraujo folded before Flop (didn't bet)

PokerStars Hand #251205352104: Tournament #3767885527, $40+$10+$5 USD Hold'em No Limit - Level X (500/1000) - 2024/06/26 18:49:16 UTC [2024/06/26 14:49:16 ET]
Table '3767885527 37' 8-max Seat #6 is the button
Seat 1: Katwoman0106 (77123 in chips) 
Seat 2: fAArid88 (29557 in chips) 
Seat 3: paulscot1 (29900 in chips) 
Seat 4: Naaarrrr (21850 in chips) 
Seat 5: johnyguedes1 (67461 in chips) 
Seat 6: yuzoyai (16742 in chips) 
Seat 7: junior_re612 (51135 in chips) 
Seat 8: Amandaraujo (47437 in chips) 
Katwoman0106: posts the ante 125
fAArid88: posts the ante 125
paulscot1: posts the ante 125
Naaarrrr: posts the ante 125
johnyguedes1: posts the ante 125
yuzoyai: posts the ante 125
junior_re612: posts the ante 125
Amandaraujo: posts the ante 125
junior_re612: posts small blind 500
Amandaraujo: posts big blind 1000
*** HOLE CARDS ***
Katwoman0106: folds 
fAArid88: raises 1000 to 2000
paulscot1: folds 
Naaarrrr: folds 
johnyguedes1: folds 
yuzoyai: calls 2000
junior_re612: folds 
Amandaraujo: calls 1000
*** FLOP *** [8h Qh 2s]
Amandaraujo: checks 
fAArid88: checks 
yuzoyai: bets 1950
Amandaraujo: folds 
fAArid88: raises 12050 to 14000
yuzoyai: raises 617 to 14617 and is all-in
fAArid88: calls 617
*** TURN *** [8h Qh 2s] [2d]
*** RIVER *** [8h Qh 2s 2d] [5c]
*** SHOW DOWN ***
fAArid88: shows [9s 8s] (two pair, Eights and Deuces)
yuzoyai: shows [Td Qd] (two pair, Queens and Deuces)
yuzoyai collected 36734 from pot
*** SUMMARY ***
Total pot 36734 | Rake 0 
Board [8h Qh 2s 2d 5c]
Seat 1: Katwoman0106 folded before Flop (didn't bet)
Seat 2: fAArid88 showed [9s 8s] and lost with two pair, Eights and Deuces
Seat 3: paulscot1 folded before Flop (didn't bet)
Seat 4: Naaarrrr folded before Flop (didn't bet)
Seat 5: johnyguedes1 folded before Flop (didn't bet)
Seat 6: yuzoyai (button) showed [Td Qd] and won (36734) with two pair, Queens and Deuces
Seat 7: junior_re612 (small blind) folded before Flop
Seat 8: Amandaraujo (big blind) folded on the Flop

PokerStars Hand #251205372845: Tournament #3767885527, $40+$10+$5 USD Hold'em No Limit - Level X (500/1000) - 2024/06/26 18:50:35 UTC [2024/06/26 14:50:35 ET]
Table '3767885527 37' 8-max Seat #7 is the button
Seat 1: Katwoman0106 (76998 in chips) 
Seat 2: fAArid88 (12815 in chips) 
Seat 3: paulscot1 (29775 in chips) 
Seat 4: Naaarrrr (21725 in chips) 
Seat 5: johnyguedes1 (67336 in chips) 
Seat 6: yuzoyai (36734 in chips) 
Seat 7: junior_re612 (50510 in chips) 
Seat 8: Amandaraujo (45312 in chips) 
Katwoman0106: posts the ante 125
fAArid88: posts the ante 125
paulscot1: posts the ante 125
Naaarrrr: posts the ante 125
johnyguedes1: posts the ante 125
yuzoyai: posts the ante 125
junior_re612: posts the ante 125
Amandaraujo: posts the ante 125
Amandaraujo: posts small blind 500
Katwoman0106: posts big blind 1000
*** HOLE CARDS ***
fAArid88: raises 11690 to 12690 and is all-in
paulscot1: folds 
Naaarrrr: folds 
johnyguedes1: folds 
yuzoyai: folds 
junior_re612: folds 
Amandaraujo: folds 
Katwoman0106: folds 
Uncalled bet (11690) returned to fAArid88
fAArid88 collected 3500 from pot
fAArid88: doesn't show hand 
*** SUMMARY ***
Total pot 3500 | Rake 0 
Seat 1: Katwoman0106 (big blind) folded before Flop
Seat 2: fAArid88 collected (3500)
Seat 3: paulscot1 folded before Flop (didn't bet)
Seat 4: Naaarrrr folded before Flop (didn't bet)
Seat 5: johnyguedes1 folded before Flop (didn't bet)
Seat 6: yuzoyai folded before Flop (didn't bet)
Seat 7: junior_re612 (button) folded before Flop (didn't bet)
Seat 8: Amandaraujo (small blind) folded before Flop

PokerStars Hand #251205380018: Tournament #3767885527, $40+$10+$5 USD Hold'em No Limit - Level X (500/1000) - 2024/06/26 18:51:03 UTC [2024/06/26 14:51:03 ET]
Table '3767885527 37' 8-max Seat #8 is the button
Seat 1: Katwoman0106 (75873 in chips) 
Seat 2: fAArid88 (15190 in chips) 
Seat 3: paulscot1 (29650 in chips) 
Seat 4: Naaarrrr (21600 in chips) 
Seat 5: johnyguedes1 (67211 in chips) 
Seat 6: yuzoyai (36609 in chips) 
Seat 7: junior_re612 (50385 in chips) 
Seat 8: Amandaraujo (44687 in chips) 
Katwoman0106: posts the ante 125
fAArid88: posts the ante 125
paulscot1: posts the ante 125
Naaarrrr: posts the ante 125
johnyguedes1: posts the ante 125
yuzoyai: posts the ante 125
junior_re612: posts the ante 125
Amandaraujo: posts the ante 125
Katwoman0106: posts small blind 500
fAArid88: posts big blind 1000
*** HOLE CARDS ***
paulscot1: folds 
Naaarrrr: folds 
johnyguedes1: folds 
yuzoyai: folds 
junior_re612: folds 
Amandaraujo: raises 1000 to 2000
Katwoman0106: folds 
fAArid88: folds 
Uncalled bet (1000) returned to Amandaraujo
Amandaraujo collected 3500 from pot
Amandaraujo: doesn't show hand 
*** SUMMARY ***
Total pot 3500 | Rake 0 
Seat 1: Katwoman0106 (small blind) folded before Flop
Seat 2: fAArid88 (big blind) folded before Flop
Seat 3: paulscot1 folded before Flop (didn't bet)
Seat 4: Naaarrrr folded before Flop (didn't bet)
Seat 5: johnyguedes1 folded before Flop (didn't bet)
Seat 6: yuzoyai folded before Flop (didn't bet)
Seat 7: junior_re612 folded before Flop (didn't bet)
Seat 8: Amandaraujo (button) collected (3500)

PokerStars Hand #251205388503: Tournament #3767885527, $40+$10+$5 USD Hold'em No Limit - Level X (500/1000) - 2024/06/26 18:51:35 UTC [2024/06/26 14:51:35 ET]
Table '3767885527 37' 8-max Seat #1 is the button
Seat 1: Katwoman0106 (75248 in chips) 
Seat 2: fAArid88 (14065 in chips) 
Seat 3: paulscot1 (29525 in chips) 
Seat 4: Naaarrrr (21475 in chips) 
Seat 5: johnyguedes1 (67086 in chips) 
Seat 6: yuzoyai (36484 in chips) 
Seat 7: junior_re612 (50260 in chips) 
Seat 8: Amandaraujo (47062 in chips) 
Katwoman0106: posts the ante 125
fAArid88: posts the ante 125
paulscot1: posts the ante 125
Naaarrrr: posts the ante 125
johnyguedes1: posts the ante 125
yuzoyai: posts the ante 125
junior_re612: posts the ante 125
Amandaraujo: posts the ante 125
fAArid88: posts small blind 500
paulscot1: posts big blind 1000
*** HOLE CARDS ***
Naaarrrr: folds 
johnyguedes1: folds 
yuzoyai: folds 
junior_re612: raises 1000 to 2000
Amandaraujo: calls 2000
Katwoman0106: folds 
fAArid88: folds 
paulscot1: folds 
*** FLOP *** [Kc 6d 4d]
junior_re612: bets 2150
Amandaraujo: calls 2150
*** TURN *** [Kc 6d 4d] [8c]
junior_re612: checks 
Amandaraujo: bets 6400
junior_re612: folds 
Uncalled bet (6400) returned to Amandaraujo
Amandaraujo collected 10800 from pot
*** SUMMARY ***
Total pot 10800 | Rake 0 
Board [Kc 6d 4d 8c]
Seat 1: Katwoman0106 (button) folded before Flop (didn't bet)
Seat 2: fAArid88 (small blind) folded before Flop
Seat 3: paulscot1 (big blind) folded before Flop
Seat 4: Naaarrrr folded before Flop (didn't bet)
Seat 5: johnyguedes1 folded before Flop (didn't bet)
Seat 6: yuzoyai folded before Flop (didn't bet)
Seat 7: junior_re612 folded on the Turn
Seat 8: Amandaraujo collected (10800)

PokerStars Hand #251205408535: Tournament #3767885527, $40+$10+$5 USD Hold'em No Limit - Level XI (600/1200) - 2024/06/26 18:52:51 UTC [2024/06/26 14:52:51 ET]
Table '3767885527 37' 8-max Seat #2 is the button
Seat 1: Katwoman0106 (75123 in chips) 
Seat 2: fAArid88 (13440 in chips) 
Seat 3: paulscot1 (28400 in chips) 
Seat 4: Naaarrrr (21350 in chips) 
Seat 5: johnyguedes1 (66961 in chips) 
Seat 6: yuzoyai (36359 in chips) 
Seat 7: junior_re612 (45985 in chips) 
Seat 8: Amandaraujo (53587 in chips) 
Katwoman0106: posts the ante 150
fAArid88: posts the ante 150
paulscot1: posts the ante 150
Naaarrrr: posts the ante 150
johnyguedes1: posts the ante 150
yuzoyai: posts the ante 150
junior_re612: posts the ante 150
Amandaraujo: posts the ante 150
paulscot1: posts small blind 600
Naaarrrr: posts big blind 1200
*** HOLE CARDS ***
johnyguedes1: raises 1320 to 2520
yuzoyai: folds 
junior_re612: folds 
Amandaraujo: calls 2520
Katwoman0106: folds 
fAArid88: calls 2520
paulscot1: folds 
Naaarrrr: calls 1320
*** FLOP *** [Ah 2h Kh]
Naaarrrr: checks 
johnyguedes1: checks 
Amandaraujo: checks 
fAArid88: checks 
*** TURN *** [Ah 2h Kh] [5c]
Naaarrrr: checks 
johnyguedes1: checks 
Amandaraujo: checks 
fAArid88: checks 
*** RIVER *** [Ah 2h Kh 5c] [8d]
Naaarrrr: checks 
johnyguedes1: bets 9860
Amandaraujo: folds 
fAArid88: folds 
Naaarrrr: folds 
Uncalled bet (9860) returned to johnyguedes1
johnyguedes1 collected 11880 from pot
johnyguedes1: doesn't show hand 
*** SUMMARY ***
Total pot 11880 | Rake 0 
Board [Ah 2h Kh 5c 8d]
Seat 1: Katwoman0106 folded before Flop (didn't bet)
Seat 2: fAArid88 (button) folded on the River
Seat 3: paulscot1 (small blind) folded before Flop
Seat 4: Naaarrrr (big blind) folded on the River
Seat 5: johnyguedes1 collected (11880)
Seat 6: yuzoyai folded before Flop (didn't bet)
Seat 7: junior_re612 folded before Flop (didn't bet)
Seat 8: Amandaraujo folded on the River

PokerStars Hand #251205436915: Tournament #3767885527, $40+$10+$5 USD Hold'em No Limit - Level XI (600/1200) - 2024/06/26 18:54:39 UTC [2024/06/26 14:54:39 ET]
Table '3767885527 37' 8-max Seat #3 is the button
Seat 1: Katwoman0106 (74973 in chips) 
Seat 2: fAArid88 (10770 in chips) 
Seat 3: paulscot1 (27650 in chips) 
Seat 4: Naaarrrr (18680 in chips) 
Seat 5: johnyguedes1 (76171 in chips) 
Seat 6: yuzoyai (36209 in chips) 
Seat 7: junior_re612 (45835 in chips) 
Seat 8: Amandaraujo (50917 in chips) 
Katwoman0106: posts the ante 150
fAArid88: posts the ante 150
paulscot1: posts the ante 150
Naaarrrr: posts the ante 150
johnyguedes1: posts the ante 150
yuzoyai: posts the ante 150
junior_re612: posts the ante 150
Amandaraujo: posts the ante 150
Naaarrrr: posts small blind 600
johnyguedes1: posts big blind 1200
*** HOLE CARDS ***
yuzoyai: folds 
junior_re612: folds 
Amandaraujo: folds 
Katwoman0106: folds 
fAArid88: folds 
paulscot1: raises 1440 to 2640
Naaarrrr: folds 
johnyguedes1: calls 1440
*** FLOP *** [6c 4d Kh]
johnyguedes1: checks 
paulscot1: bets 2400
johnyguedes1: raises 4440 to 6840
paulscot1: raises 18020 to 24860 and is all-in
johnyguedes1: folds 
Uncalled bet (18020) returned to paulscot1
paulscot1 collected 20760 from pot
paulscot1: doesn't show hand 
*** SUMMARY ***
Total pot 20760 | Rake 0 
Board [6c 4d Kh]
Seat 1: Katwoman0106 folded before Flop (didn't bet)
Seat 2: fAArid88 folded before Flop (didn't bet)
Seat 3: paulscot1 (button) collected (20760)
Seat 4: Naaarrrr (small blind) folded before Flop
Seat 5: johnyguedes1 (big blind) folded on the Flop
Seat 6: yuzoyai folded before Flop (didn't bet)
Seat 7: junior_re612 folded before Flop (didn't bet)
Seat 8: Amandaraujo folded before Flop (didn't bet)

PokerStars Hand #251205528176: Tournament #3767885527, $40+$10+$5 USD Hold'em No Limit - Level XI (600/1200) - 2024/06/26 19:02:04 UTC [2024/06/26 15:02:04 ET]
Table '3767885527 37' 8-max Seat #4 is the button
Seat 1: Katwoman0106 (74823 in chips) 
Seat 2: fAArid88 (10620 in chips) 
Seat 3: paulscot1 (38780 in chips) 
Seat 4: Naaarrrr (17930 in chips) 
Seat 5: johnyguedes1 (66541 in chips) 
Seat 6: yuzoyai (36059 in chips) 
Seat 7: junior_re612 (45685 in chips) 
Seat 8: Amandaraujo (50767 in chips) 
Katwoman0106: posts the ante 150
fAArid88: posts the ante 150
paulscot1: posts the ante 150
Naaarrrr: posts the ante 150
johnyguedes1: posts the ante 150
yuzoyai: posts the ante 150
junior_re612: posts the ante 150
Amandaraujo: posts the ante 150
johnyguedes1: posts small blind 600
yuzoyai: posts big blind 1200
*** HOLE CARDS ***
junior_re612: folds 
Amandaraujo: raises 1200 to 2400
Katwoman0106: folds 
fAArid88: folds 
paulscot1: folds 
Naaarrrr: folds 
johnyguedes1: folds 
yuzoyai: raises 33509 to 35909 and is all-in
Amandaraujo: folds 
Uncalled bet (33509) returned to yuzoyai
yuzoyai collected 6600 from pot
yuzoyai: doesn't show hand 
*** SUMMARY ***
Total pot 6600 | Rake 0 
Seat 1: Katwoman0106 folded before Flop (didn't bet)
Seat 2: fAArid88 folded before Flop (didn't bet)
Seat 3: paulscot1 folded before Flop (didn't bet)
Seat 4: Naaarrrr (button) folded before Flop (didn't bet)
Seat 5: johnyguedes1 (small blind) folded before Flop
Seat 6: yuzoyai (big blind) collected (6600)
Seat 7: junior_re612 folded before Flop (didn't bet)
Seat 8: Amandaraujo folded before Flop

PokerStars Hand #251205539837: Tournament #3767885527, $40+$10+$5 USD Hold'em No Limit - Level XI (600/1200) - 2024/06/26 19:02:52 UTC [2024/06/26 15:02:52 ET]
Table '3767885527 37' 8-max Seat #5 is the button
Seat 1: Katwoman0106 (74673 in chips) 
Seat 2: fAArid88 (10470 in chips) 
Seat 3: paulscot1 (38630 in chips) 
Seat 4: Naaarrrr (17780 in chips) 
Seat 5: johnyguedes1 (65791 in chips) 
Seat 6: yuzoyai (40109 in chips) 
Seat 7: junior_re612 (45535 in chips) 
Seat 8: Amandaraujo (48217 in chips) 
Katwoman0106: posts the ante 150
fAArid88: posts the ante 150
paulscot1: posts the ante 150
Naaarrrr: posts the ante 150
johnyguedes1: posts the ante 150
yuzoyai: posts the ante 150
junior_re612: posts the ante 150
Amandaraujo: posts the ante 150
yuzoyai: posts small blind 600
junior_re612: posts big blind 1200
*** HOLE CARDS ***
Amandaraujo: calls 1200
Katwoman0106: calls 1200
fAArid88: folds 
paulscot1: folds 
Naaarrrr: folds 
johnyguedes1: calls 1200
yuzoyai: calls 600
junior_re612: checks 
*** FLOP *** [6c 3h Qd]
yuzoyai: bets 2376
junior_re612: calls 2376
Amandaraujo: folds 
Katwoman0106: raises 7164 to 9540
johnyguedes1: folds 
yuzoyai: folds 
junior_re612: raises 34645 to 44185 and is all-in
Katwoman0106: folds [Qh]
Uncalled bet (34645) returned to junior_re612
junior_re612 collected 28656 from pot
junior_re612: doesn't show hand 
*** SUMMARY ***
Total pot 28656 | Rake 0 
Board [6c 3h Qd]
Seat 1: Katwoman0106 folded on the Flop
Seat 2: fAArid88 folded before Flop (didn't bet)
Seat 3: paulscot1 folded before Flop (didn't bet)
Seat 4: Naaarrrr folded before Flop (didn't bet)
Seat 5: johnyguedes1 (button) folded on the Flop
Seat 6: yuzoyai (small blind) folded on the Flop
Seat 7: junior_re612 (big blind) collected (28656)
Seat 8: Amandaraujo folded on the Flop

PokerStars Hand #251205565547: Tournament #3767885527, $40+$10+$5 USD Hold'em No Limit - Level XI (600/1200) - 2024/06/26 19:04:33 UTC [2024/06/26 15:04:33 ET]
Table '3767885527 37' 8-max Seat #6 is the button
Seat 1: Katwoman0106 (63783 in chips) 
Seat 2: fAArid88 (10320 in chips) 
Seat 3: paulscot1 (38480 in chips) 
Seat 4: Naaarrrr (17630 in chips) 
Seat 5: johnyguedes1 (64441 in chips) 
Seat 6: yuzoyai (36383 in chips) 
Seat 7: junior_re612 (63301 in chips) 
Seat 8: Amandaraujo (46867 in chips) 
Katwoman0106: posts the ante 150
fAArid88: posts the ante 150
paulscot1: posts the ante 150
Naaarrrr: posts the ante 150
johnyguedes1: posts the ante 150
yuzoyai: posts the ante 150
junior_re612: posts the ante 150
Amandaraujo: posts the ante 150
junior_re612: posts small blind 600
Amandaraujo: posts big blind 1200
*** HOLE CARDS ***
Katwoman0106: folds 
fAArid88: folds 
paulscot1: raises 1980 to 3180
Naaarrrr: raises 14300 to 17480 and is all-in
johnyguedes1: folds 
yuzoyai: folds 
junior_re612: raises 45671 to 63151 and is all-in
Amandaraujo: folds 
paulscot1: folds 
Uncalled bet (45671) returned to junior_re612
*** FLOP *** [3d Qc Th]
*** TURN *** [3d Qc Th] [7h]
*** RIVER *** [3d Qc Th 7h] [3c]
*** SHOW DOWN ***
junior_re612: shows [Kh Ah] (a pair of Threes)
Naaarrrr: shows [Ks Ad] (a pair of Threes)
junior_re612 collected 20270 from pot
Naaarrrr collected 20270 from pot
*** SUMMARY ***
Total pot 40540 | Rake 0 
Board [3d Qc Th 7h 3c]
Seat 1: Katwoman0106 folded before Flop (didn't bet)
Seat 2: fAArid88 folded before Flop (didn't bet)
Seat 3: paulscot1 folded before Flop
Seat 4: Naaarrrr showed [Ks Ad] and won (20270) with a pair of Threes
Seat 5: johnyguedes1 folded before Flop (didn't bet)
Seat 6: yuzoyai (button) folded before Flop (didn't bet)
Seat 7: junior_re612 (small blind) showed [Kh Ah] and won (20270) with a pair of Threes
Seat 8: Amandaraujo (big blind) folded before Flop

PokerStars Hand #251205578140: Tournament #3767885527, $40+$10+$5 USD Hold'em No Limit - Level XI (600/1200) - 2024/06/26 19:05:21 UTC [2024/06/26 15:05:21 ET]
Table '3767885527 37' 8-max Seat #7 is the button
Seat 1: Katwoman0106 (63633 in chips) 
Seat 2: fAArid88 (10170 in chips) 
Seat 3: paulscot1 (35150 in chips) 
Seat 4: Naaarrrr (20270 in chips) 
Seat 5: johnyguedes1 (64291 in chips) 
Seat 6: yuzoyai (36233 in chips) 
Seat 7: junior_re612 (65941 in chips) 
Seat 8: Amandaraujo (45517 in chips) 
Katwoman0106: posts the ante 150
fAArid88: posts the ante 150
paulscot1: posts the ante 150
Naaarrrr: posts the ante 150
johnyguedes1: posts the ante 150
yuzoyai: posts the ante 150
junior_re612: posts the ante 150
Amandaraujo: posts the ante 150
Amandaraujo: posts small blind 600
Katwoman0106: posts big blind 1200
*** HOLE CARDS ***
fAArid88: folds 
paulscot1: folds 
Naaarrrr: folds 
johnyguedes1: folds 
yuzoyai: raises 1200 to 2400
junior_re612: folds 
Amandaraujo: calls 1800
Katwoman0106: folds 
*** FLOP *** [9c 2s 6d]
Amandaraujo: checks 
yuzoyai: checks 
*** TURN *** [9c 2s 6d] [Js]
Amandaraujo: checks 
yuzoyai: bets 3840
Amandaraujo: calls 3840
*** RIVER *** [9c 2s 6d Js] [6s]
Amandaraujo: checks 
yuzoyai: bets 11918
Amandaraujo: folds 
Uncalled bet (11918) returned to yuzoyai
yuzoyai collected 14880 from pot
yuzoyai: doesn't show hand 
*** SUMMARY ***
Total pot 14880 | Rake 0 
Board [9c 2s 6d Js 6s]
Seat 1: Katwoman0106 (big blind) folded before Flop
Seat 2: fAArid88 folded before Flop (didn't bet)
Seat 3: paulscot1 folded before Flop (didn't bet)
Seat 4: Naaarrrr folded before Flop (didn't bet)
Seat 5: johnyguedes1 folded before Flop (didn't bet)
Seat 6: yuzoyai collected (14880)
Seat 7: junior_re612 (button) folded before Flop (didn't bet)
Seat 8: Amandaraujo (small blind) folded on the River

PokerStars Hand #251205601413: Tournament #3767885527, $40+$10+$5 USD Hold'em No Limit - Level XI (600/1200) - 2024/06/26 19:06:49 UTC [2024/06/26 15:06:49 ET]
Table '3767885527 37' 8-max Seat #8 is the button
Seat 1: Katwoman0106 (62283 in chips) 
Seat 2: fAArid88 (10020 in chips) 
Seat 3: paulscot1 (35000 in chips) 
Seat 4: Naaarrrr (20120 in chips) 
Seat 5: johnyguedes1 (64141 in chips) 
Seat 6: yuzoyai (44723 in chips) 
Seat 7: junior_re612 (65791 in chips) 
Seat 8: Amandaraujo (39127 in chips) 
Katwoman0106: posts the ante 150
fAArid88: posts the ante 150
paulscot1: posts the ante 150
Naaarrrr: posts the ante 150
johnyguedes1: posts the ante 150
yuzoyai: posts the ante 150
junior_re612: posts the ante 150
Amandaraujo: posts the ante 150
Katwoman0106: posts small blind 600
fAArid88: posts big blind 1200
*** HOLE CARDS ***
paulscot1: raises 1440 to 2640
Naaarrrr: folds 
johnyguedes1: folds 
yuzoyai: raises 3960 to 6600
junior_re612: folds 
Amandaraujo: calls 6600
Katwoman0106: folds 
fAArid88: folds 
paulscot1: calls 3960
*** FLOP *** [8c Ts 2s]
paulscot1: checks 
yuzoyai: checks 
Amandaraujo: checks 
*** TURN *** [8c Ts 2s] [Kc]
paulscot1: checks 
yuzoyai: bets 11280
Amandaraujo: folds 
paulscot1: calls 11280
*** RIVER *** [8c Ts 2s Kc] [Jc]
paulscot1: checks 
yuzoyai: checks 
*** SHOW DOWN ***
paulscot1: shows [8s 9s] (a pair of Eights)
yuzoyai: shows [Kh Qs] (a pair of Kings)
yuzoyai collected 45360 from pot
*** SUMMARY ***
Total pot 45360 | Rake 0 
Board [8c Ts 2s Kc Jc]
Seat 1: Katwoman0106 (small blind) folded before Flop
Seat 2: fAArid88 (big blind) folded before Flop
Seat 3: paulscot1 showed [8s 9s] and lost with a pair of Eights
Seat 4: Naaarrrr folded before Flop (didn't bet)
Seat 5: johnyguedes1 folded before Flop (didn't bet)
Seat 6: yuzoyai showed [Kh Qs] and won (45360) with a pair of Kings
Seat 7: junior_re612 folded before Flop (didn't bet)
Seat 8: Amandaraujo (button) folded on the Turn

PokerStars Hand #251205627441: Tournament #3767885527, $40+$10+$5 USD Hold'em No Limit - Level XI (600/1200) - 2024/06/26 19:08:27 UTC [2024/06/26 15:08:27 ET]
Table '3767885527 37' 8-max Seat #1 is the button
Seat 1: Katwoman0106 (61533 in chips) 
Seat 2: fAArid88 (8670 in chips) 
Seat 3: paulscot1 (16970 in chips) 
Seat 4: Naaarrrr (19970 in chips) 
Seat 5: johnyguedes1 (63991 in chips) 
Seat 6: yuzoyai (72053 in chips) 
Seat 7: junior_re612 (65641 in chips) 
Seat 8: Amandaraujo (32377 in chips) 
Katwoman0106: posts the ante 150
fAArid88: posts the ante 150
paulscot1: posts the ante 150
Naaarrrr: posts the ante 150
johnyguedes1: posts the ante 150
yuzoyai: posts the ante 150
junior_re612: posts the ante 150
Amandaraujo: posts the ante 150
fAArid88: posts small blind 600
paulscot1: posts big blind 1200
*** HOLE CARDS ***
Naaarrrr: raises 1200 to 2400
johnyguedes1: folds 
yuzoyai: folds 
junior_re612: folds 
Amandaraujo: raises 2400 to 4800
Katwoman0106: folds 
fAArid88: folds 
paulscot1: folds 
Naaarrrr: raises 15020 to 19820 and is all-in
Amandaraujo: calls 15020
*** FLOP *** [3h Ks Kd]
*** TURN *** [3h Ks Kd] [5h]
*** RIVER *** [3h Ks Kd 5h] [6c]
*** SHOW DOWN ***
Naaarrrr: shows [8d 8s] (two pair, Kings and Eights)
Amandaraujo: shows [Kc Js] (three of a kind, Kings)
Amandaraujo collected 42640 from pot
Naaarrrr finished the tournament
*** SUMMARY ***
Total pot 42640 | Rake 0 
Board [3h Ks Kd 5h 6c]
Seat 1: Katwoman0106 (button) folded before Flop (didn't bet)
Seat 2: fAArid88 (small blind) folded before Flop
Seat 3: paulscot1 (big blind) folded before Flop
Seat 4: Naaarrrr showed [8d 8s] and lost with two pair, Kings and Eights
Seat 5: johnyguedes1 folded before Flop (didn't bet)
Seat 6: yuzoyai folded before Flop (didn't bet)
Seat 7: junior_re612 folded before Flop (didn't bet)
Seat 8: Amandaraujo showed [Kc Js] and won (42640) with three of a kind, Kings

PokerStars Hand #251205641324: Tournament #3767885527, $40+$10+$5 USD Hold'em No Limit - Level XII (700/1400) - 2024/06/26 19:09:19 UTC [2024/06/26 15:09:19 ET]
Table '3767885527 37' 8-max Seat #2 is the button
Seat 1: Katwoman0106 (61383 in chips) 
Seat 2: fAArid88 (7920 in chips) 
Seat 3: paulscot1 (15620 in chips) 
Seat 5: johnyguedes1 (63841 in chips) 
Seat 6: yuzoyai (71903 in chips) 
Seat 7: junior_re612 (65491 in chips) 
Seat 8: Amandaraujo (55047 in chips) 
Katwoman0106: posts the ante 175
fAArid88: posts the ante 175
paulscot1: posts the ante 175
johnyguedes1: posts the ante 175
yuzoyai: posts the ante 175
junior_re612: posts the ante 175
Amandaraujo: posts the ante 175
paulscot1: posts small blind 700
johnyguedes1: posts big blind 1400
*** HOLE CARDS ***
yuzoyai: folds 
SWE_CS is disconnected 
junior_re612: folds 
Amandaraujo: folds 
Katwoman0106: raises 1400 to 2800
fAArid88: raises 4945 to 7745 and is all-in
paulscot1: folds 
johnyguedes1: raises 9145 to 16890
Katwoman0106: folds 
Uncalled bet (9145) returned to johnyguedes1
*** FLOP *** [3d Tc Th]
*** TURN *** [3d Tc Th] [4s]
*** RIVER *** [3d Tc Th 4s] [2h]
*** SHOW DOWN ***
johnyguedes1: shows [Ad 9s] (a pair of Tens)
fAArid88: shows [4d Ah] (two pair, Tens and Fours)
fAArid88 collected 20215 from pot
*** SUMMARY ***
Total pot 20215 | Rake 0 
Board [3d Tc Th 4s 2h]
Seat 1: Katwoman0106 folded before Flop
Seat 2: fAArid88 (button) showed [4d Ah] and won (20215) with two pair, Tens and Fours
Seat 3: paulscot1 (small blind) folded before Flop
Seat 5: johnyguedes1 (big blind) showed [Ad 9s] and lost with a pair of Tens
Seat 6: yuzoyai folded before Flop (didn't bet)
Seat 7: junior_re612 folded before Flop (didn't bet)
Seat 8: Amandaraujo folded before Flop (didn't bet)

PokerStars Hand #251205651552: Tournament #3767885527, $40+$10+$5 USD Hold'em No Limit - Level XII (700/1400) - 2024/06/26 19:09:57 UTC [2024/06/26 15:09:57 ET]
Table '3767885527 37' 8-max Seat #3 is the button
Seat 1: Katwoman0106 (58408 in chips) 
Seat 2: fAArid88 (20215 in chips) 
Seat 3: paulscot1 (14745 in chips) 
Seat 4: SWE_CS (25000 in chips) out of hand (moved from another table into small blind)
Seat 5: johnyguedes1 (55921 in chips) 
Seat 6: yuzoyai (71728 in chips) 
Seat 7: junior_re612 (65316 in chips) 
Seat 8: Amandaraujo (54872 in chips) 
SWE_CS will be allowed to play after the button
Katwoman0106: posts the ante 175
fAArid88: posts the ante 175
paulscot1: posts the ante 175
johnyguedes1: posts the ante 175
yuzoyai: posts the ante 175
junior_re612: posts the ante 175
Amandaraujo: posts the ante 175
johnyguedes1: posts small blind 700
yuzoyai: posts big blind 1400
*** HOLE CARDS ***
junior_re612: folds 
Amandaraujo: folds 
Katwoman0106: folds 
fAArid88: folds 
paulscot1: folds 
johnyguedes1: calls 700
yuzoyai: checks 
*** FLOP *** [3c Ac Js]
johnyguedes1: bets 1400
yuzoyai: raises 2952 to 4352
johnyguedes1: calls 2952
*** TURN *** [3c Ac Js] [6h]
johnyguedes1: checks 
yuzoyai: checks 
*** RIVER *** [3c Ac Js 6h] [4s]
johnyguedes1: bets 10565
yuzoyai: folds 
Uncalled bet (10565) returned to johnyguedes1
johnyguedes1 collected 12729 from pot
johnyguedes1: doesn't show hand 
*** SUMMARY ***
Total pot 12729 | Rake 0 
Board [3c Ac Js 6h 4s]
Seat 1: Katwoman0106 folded before Flop (didn't bet)
Seat 2: fAArid88 folded before Flop (didn't bet)
Seat 3: paulscot1 (button) folded before Flop (didn't bet)
Seat 5: johnyguedes1 (small blind) collected (12729)
Seat 6: yuzoyai (big blind) folded on the River
Seat 7: junior_re612 folded before Flop (didn't bet)
Seat 8: Amandaraujo folded before Flop (didn't bet)

PokerStars Hand #251205673323: Tournament #3767885527, $40+$10+$5 USD Hold'em No Limit - Level XII (700/1400) - 2024/06/26 19:11:18 UTC [2024/06/26 15:11:18 ET]
Table '3767885527 37' 8-max Seat #5 is the button
Seat 1: Katwoman0106 (58233 in chips) 
Seat 2: fAArid88 (20040 in chips) 
Seat 3: paulscot1 (14570 in chips) 
Seat 4: SWE_CS (25000 in chips) 
Seat 5: johnyguedes1 (62723 in chips) 
Seat 6: yuzoyai (65801 in chips) 
Seat 7: junior_re612 (65141 in chips) 
Seat 8: Amandaraujo (54697 in chips) 
Katwoman0106: posts the ante 175
fAArid88: posts the ante 175
paulscot1: posts the ante 175
SWE_CS: posts the ante 175
johnyguedes1: posts the ante 175
yuzoyai: posts the ante 175
junior_re612: posts the ante 175
Amandaraujo: posts the ante 175
yuzoyai: posts small blind 700
junior_re612: posts big blind 1400
*** HOLE CARDS ***
Amandaraujo: folds 
Katwoman0106: folds 
fAArid88: folds 
paulscot1: folds 
SWE_CS: folds 
johnyguedes1: raises 1540 to 2940
yuzoyai: folds 
junior_re612: calls 1540
*** FLOP *** [Js 7d 4h]
junior_re612: checks 
johnyguedes1: bets 2633
junior_re612: folds 
Uncalled bet (2633) returned to johnyguedes1
johnyguedes1 collected 7980 from pot
johnyguedes1: doesn't show hand 
*** SUMMARY ***
Total pot 7980 | Rake 0 
Board [Js 7d 4h]
Seat 1: Katwoman0106 folded before Flop (didn't bet)
Seat 2: fAArid88 folded before Flop (didn't bet)
Seat 3: paulscot1 folded before Flop (didn't bet)
Seat 4: SWE_CS folded before Flop (didn't bet)
Seat 5: johnyguedes1 (button) collected (7980)
Seat 6: yuzoyai (small blind) folded before Flop
Seat 7: junior_re612 (big blind) folded on the Flop
Seat 8: Amandaraujo folded before Flop (didn't bet)

PokerStars Hand #251205684942: Tournament #3767885527, $40+$10+$5 USD Hold'em No Limit - Level XII (700/1400) - 2024/06/26 19:12:01 UTC [2024/06/26 15:12:01 ET]
Table '3767885527 37' 8-max Seat #6 is the button
Seat 1: Katwoman0106 (58058 in chips) 
Seat 2: fAArid88 (19865 in chips) 
Seat 3: paulscot1 (14395 in chips) 
Seat 4: SWE_CS (24825 in chips) 
Seat 5: johnyguedes1 (67588 in chips) 
Seat 6: yuzoyai (64926 in chips) 
Seat 7: junior_re612 (62026 in chips) 
Seat 8: Amandaraujo (54522 in chips) 
Katwoman0106: posts the ante 175
fAArid88: posts the ante 175
paulscot1: posts the ante 175
SWE_CS: posts the ante 175
johnyguedes1: posts the ante 175
yuzoyai: posts the ante 175
junior_re612: posts the ante 175
Amandaraujo: posts the ante 175
junior_re612: posts small blind 700
Amandaraujo: posts big blind 1400
*** HOLE CARDS ***
Katwoman0106: folds 
fAArid88: folds 
paulscot1: raises 12820 to 14220 and is all-in
SWE_CS: folds 
johnyguedes1: folds 
yuzoyai: folds 
junior_re612: folds 
Amandaraujo: folds 
Uncalled bet (12820) returned to paulscot1
paulscot1 collected 4900 from pot
paulscot1: doesn't show hand 
*** SUMMARY ***
Total pot 4900 | Rake 0 
Seat 1: Katwoman0106 folded before Flop (didn't bet)
Seat 2: fAArid88 folded before Flop (didn't bet)
Seat 3: paulscot1 collected (4900)
Seat 4: SWE_CS folded before Flop (didn't bet)
Seat 5: johnyguedes1 folded before Flop (didn't bet)
Seat 6: yuzoyai (button) folded before Flop (didn't bet)
Seat 7: junior_re612 (small blind) folded before Flop
Seat 8: Amandaraujo (big blind) folded before Flop

PokerStars Hand #251205694572: Tournament #3767885527, $40+$10+$5 USD Hold'em No Limit - Level XII (700/1400) - 2024/06/26 19:12:36 UTC [2024/06/26 15:12:36 ET]
Table '3767885527 37' 8-max Seat #7 is the button
Seat 1: Katwoman0106 (57883 in chips) 
Seat 2: fAArid88 (19690 in chips) 
Seat 3: paulscot1 (17720 in chips) 
Seat 4: SWE_CS (24650 in chips) 
Seat 5: johnyguedes1 (67413 in chips) 
Seat 6: yuzoyai (64751 in chips) 
Seat 7: junior_re612 (61151 in chips) 
Seat 8: Amandaraujo (52947 in chips) 
Katwoman0106: posts the ante 175
fAArid88: posts the ante 175
paulscot1: posts the ante 175
SWE_CS: posts the ante 175
johnyguedes1: posts the ante 175
yuzoyai: posts the ante 175
junior_re612: posts the ante 175
Amandaraujo: posts the ante 175
Amandaraujo: posts small blind 700
Katwoman0106: posts big blind 1400
*** HOLE CARDS ***
fAArid88: folds 
paulscot1: folds 
SWE_CS: folds 
johnyguedes1: raises 1540 to 2940
yuzoyai: folds 
junior_re612: calls 2940
Amandaraujo: calls 2240
Katwoman0106: calls 1540
*** FLOP *** [2h Jc 6s]
Amandaraujo: checks 
Katwoman0106: checks 
johnyguedes1: checks 
junior_re612: checks 
*** TURN *** [2h Jc 6s] [Jh]
Amandaraujo: checks 
Katwoman0106: bets 7373
johnyguedes1: folds 
junior_re612: folds 
Amandaraujo: folds 
Uncalled bet (7373) returned to Katwoman0106
Katwoman0106 collected 13160 from pot
Katwoman0106: doesn't show hand 
*** SUMMARY ***
Total pot 13160 | Rake 0 
Board [2h Jc 6s Jh]
Seat 1: Katwoman0106 (big blind) collected (13160)
Seat 2: fAArid88 folded before Flop (didn't bet)
Seat 3: paulscot1 folded before Flop (didn't bet)
Seat 4: SWE_CS folded before Flop (didn't bet)
Seat 5: johnyguedes1 folded on the Turn
Seat 6: yuzoyai folded before Flop (didn't bet)
Seat 7: junior_re612 (button) folded on the Turn
Seat 8: Amandaraujo (small blind) folded on the Turn

PokerStars Hand #251205711410: Tournament #3767885527, $40+$10+$5 USD Hold'em No Limit - Level XII (700/1400) - 2024/06/26 19:13:39 UTC [2024/06/26 15:13:39 ET]
Table '3767885527 37' 8-max Seat #8 is the button
Seat 1: Katwoman0106 (67928 in chips) 
Seat 2: fAArid88 (19515 in chips) 
Seat 3: paulscot1 (17545 in chips) 
Seat 4: SWE_CS (24475 in chips) 
Seat 5: johnyguedes1 (64298 in chips) 
Seat 6: yuzoyai (64576 in chips) 
Seat 7: junior_re612 (58036 in chips) 
Seat 8: Amandaraujo (49832 in chips) 
Katwoman0106: posts the ante 175
fAArid88: posts the ante 175
paulscot1: posts the ante 175
SWE_CS: posts the ante 175
johnyguedes1: posts the ante 175
yuzoyai: posts the ante 175
junior_re612: posts the ante 175
Amandaraujo: posts the ante 175
Katwoman0106: posts small blind 700
fAArid88: posts big blind 1400
*** HOLE CARDS ***
paulscot1: folds 
SWE_CS: folds 
johnyguedes1: folds 
yuzoyai: folds 
junior_re612: folds 
Amandaraujo: folds 
Katwoman0106: folds 
Uncalled bet (700) returned to fAArid88
fAArid88 collected 2800 from pot
fAArid88: doesn't show hand 
*** SUMMARY ***
Total pot 2800 | Rake 0 
Seat 1: Katwoman0106 (small blind) folded before Flop
Seat 2: fAArid88 (big blind) collected (2800)
Seat 3: paulscot1 folded before Flop (didn't bet)
Seat 4: SWE_CS folded before Flop (didn't bet)
Seat 5: johnyguedes1 folded before Flop (didn't bet)
Seat 6: yuzoyai folded before Flop (didn't bet)
Seat 7: junior_re612 folded before Flop (didn't bet)
Seat 8: Amandaraujo (button) folded before Flop (didn't bet)

PokerStars Hand #251205721838: Tournament #3767885527, $40+$10+$5 USD Hold'em No Limit - Level XII (700/1400) - 2024/06/26 19:14:17 UTC [2024/06/26 15:14:17 ET]
Table '3767885527 37' 8-max Seat #1 is the button
Seat 1: Katwoman0106 (67053 in chips) 
Seat 2: fAArid88 (21440 in chips) 
Seat 3: paulscot1 (17370 in chips) 
Seat 4: SWE_CS (24300 in chips) 
Seat 5: johnyguedes1 (64123 in chips) 
Seat 6: yuzoyai (64401 in chips) 
Seat 7: junior_re612 (57861 in chips) 
Seat 8: Amandaraujo (49657 in chips) 
Katwoman0106: posts the ante 175
fAArid88: posts the ante 175
paulscot1: posts the ante 175
SWE_CS: posts the ante 175
johnyguedes1: posts the ante 175
yuzoyai: posts the ante 175
junior_re612: posts the ante 175
Amandaraujo: posts the ante 175
fAArid88: posts small blind 700
paulscot1: posts big blind 1400
*** HOLE CARDS ***
SWE_CS: folds 
johnyguedes1: folds 
yuzoyai: folds 
junior_re612: folds 
Amandaraujo: raises 1400 to 2800
Katwoman0106: calls 2800
fAArid88: raises 18465 to 21265 and is all-in
paulscot1: folds 
Amandaraujo: folds 
Katwoman0106: calls 18465
*** FLOP *** [6d 3h 2h]
*** TURN *** [6d 3h 2h] [Qs]
*** RIVER *** [6d 3h 2h Qs] [5c]
*** SHOW DOWN ***
fAArid88: shows [Qd Ks] (a pair of Queens)
Katwoman0106: shows [Ac 9c] (high card Ace)
fAArid88 collected 48130 from pot
*** SUMMARY ***
Total pot 48130 | Rake 0 
Board [6d 3h 2h Qs 5c]
Seat 1: Katwoman0106 (button) showed [Ac 9c] and lost with high card Ace
Seat 2: fAArid88 (small blind) showed [Qd Ks] and won (48130) with a pair of Queens
Seat 3: paulscot1 (big blind) folded before Flop
Seat 4: SWE_CS folded before Flop (didn't bet)
Seat 5: johnyguedes1 folded before Flop (didn't bet)
Seat 6: yuzoyai folded before Flop (didn't bet)
Seat 7: junior_re612 folded before Flop (didn't bet)
Seat 8: Amandaraujo folded before Flop

PokerStars Hand #251205733111: Tournament #3767885527, $40+$10+$5 USD Hold'em No Limit - Level XII (700/1400) - 2024/06/26 19:14:59 UTC [2024/06/26 15:14:59 ET]
Table '3767885527 37' 8-max Seat #2 is the button
Seat 1: Katwoman0106 (45613 in chips) 
Seat 2: fAArid88 (48130 in chips) 
Seat 3: paulscot1 (15795 in chips) 
Seat 4: SWE_CS (24125 in chips) 
Seat 5: johnyguedes1 (63948 in chips) 
Seat 6: yuzoyai (64226 in chips) 
Seat 7: junior_re612 (57686 in chips) 
Seat 8: Amandaraujo (46682 in chips) 
Katwoman0106: posts the ante 175
fAArid88: posts the ante 175
paulscot1: posts the ante 175
SWE_CS: posts the ante 175
johnyguedes1: posts the ante 175
yuzoyai: posts the ante 175
junior_re612: posts the ante 175
Amandaraujo: posts the ante 175
paulscot1: posts small blind 700
SWE_CS: posts big blind 1400
*** HOLE CARDS ***
johnyguedes1: folds 
yuzoyai: folds 
junior_re612: folds 
Amandaraujo: raises 1400 to 2800
Katwoman0106: calls 2800
fAArid88: folds 
paulscot1: folds 
SWE_CS: folds 
*** FLOP *** [8s 3d 8h]
Amandaraujo: checks 
Katwoman0106: checks 
*** TURN *** [8s 3d 8h] [7s]
Amandaraujo: checks 
Katwoman0106: checks 
*** RIVER *** [8s 3d 8h 7s] [6s]
Amandaraujo: checks 
Katwoman0106: checks 
*** SHOW DOWN ***
Amandaraujo: shows [Qd Jd] (a pair of Eights)
Katwoman0106: shows [2c 2h] (two pair, Eights and Deuces)
Katwoman0106 collected 9100 from pot
*** SUMMARY ***
Total pot 9100 | Rake 0 
Board [8s 3d 8h 7s 6s]
Seat 1: Katwoman0106 showed [2c 2h] and won (9100) with two pair, Eights and Deuces
Seat 2: fAArid88 (button) folded before Flop (didn't bet)
Seat 3: paulscot1 (small blind) folded before Flop
Seat 4: SWE_CS (big blind) folded before Flop
Seat 5: johnyguedes1 folded before Flop (didn't bet)
Seat 6: yuzoyai folded before Flop (didn't bet)
Seat 7: junior_re612 folded before Flop (didn't bet)
Seat 8: Amandaraujo showed [Qd Jd] and lost with a pair of Eights

PokerStars Hand #251205743653: Tournament #3767885527, $40+$10+$5 USD Hold'em No Limit - Level XII (700/1400) - 2024/06/26 19:15:38 UTC [2024/06/26 15:15:38 ET]
Table '3767885527 37' 8-max Seat #3 is the button
Seat 1: Katwoman0106 (51738 in chips) 
Seat 2: fAArid88 (47955 in chips) 
Seat 3: paulscot1 (14920 in chips) 
Seat 4: SWE_CS (22550 in chips) 
Seat 5: johnyguedes1 (63773 in chips) 
Seat 6: yuzoyai (64051 in chips) 
Seat 7: junior_re612 (57511 in chips) 
Seat 8: Amandaraujo (43707 in chips) 
Katwoman0106: posts the ante 175
fAArid88: posts the ante 175
paulscot1: posts the ante 175
SWE_CS: posts the ante 175
johnyguedes1: posts the ante 175
yuzoyai: posts the ante 175
junior_re612: posts the ante 175
Amandaraujo: posts the ante 175
SWE_CS: posts small blind 700
johnyguedes1: posts big blind 1400
*** HOLE CARDS ***
yuzoyai: raises 1400 to 2800
junior_re612: folds 
Amandaraujo: calls 2800
Katwoman0106: folds 
fAArid88: raises 8400 to 11200
paulscot1: folds 
SWE_CS: folds 
johnyguedes1: folds 
yuzoyai: folds 
Amandaraujo: calls 8400
*** FLOP *** [Kc 5d 5s]
Amandaraujo: checks 
fAArid88: checks 
*** TURN *** [Kc 5d 5s] [2h]
Amandaraujo: checks 
fAArid88: checks 
*** RIVER *** [Kc 5d 5s 2h] [6d]
Amandaraujo: checks 
fAArid88: bets 8400
Amandaraujo: raises 8400 to 16800
fAArid88: raises 8400 to 25200
Amandaraujo: raises 7132 to 32332 and is all-in
fAArid88: calls 7132
*** SHOW DOWN ***
Amandaraujo: shows [2s 5c] (a full house, Fives full of Deuces)
fAArid88: shows [Kh Kd] (a full house, Kings full of Fives)
fAArid88 collected 93364 from pot
Amandaraujo finished the tournament
*** SUMMARY ***
Total pot 93364 | Rake 0 
Board [Kc 5d 5s 2h 6d]
Seat 1: Katwoman0106 folded before Flop (didn't bet)
Seat 2: fAArid88 showed [Kh Kd] and won (93364) with a full house, Kings full of Fives
Seat 3: paulscot1 (button) folded before Flop (didn't bet)
Seat 4: SWE_CS (small blind) folded before Flop
Seat 5: johnyguedes1 (big blind) folded before Flop
Seat 6: yuzoyai folded before Flop
Seat 7: junior_re612 folded before Flop (didn't bet)
Seat 8: Amandaraujo showed [2s 5c] and lost with a full house, Fives full of Deuces

PokerStars Hand #251205761850: Tournament #3767885527, $40+$10+$5 USD Hold'em No Limit - Level XII (700/1400) - 2024/06/26 19:16:45 UTC [2024/06/26 15:16:45 ET]
Table '3767885527 37' 8-max Seat #4 is the button
Seat 1: Katwoman0106 (51563 in chips) 
Seat 2: fAArid88 (97612 in chips) 
Seat 3: paulscot1 (14745 in chips) 
Seat 4: SWE_CS (21675 in chips) 
Seat 5: johnyguedes1 (62198 in chips) 
Seat 6: yuzoyai (61076 in chips) 
Seat 7: junior_re612 (57336 in chips) 
Katwoman0106: posts the ante 175
fAArid88: posts the ante 175
paulscot1: posts the ante 175
SWE_CS: posts the ante 175
johnyguedes1: posts the ante 175
yuzoyai: posts the ante 175
junior_re612: posts the ante 175
johnyguedes1: posts small blind 700
yuzoyai: posts big blind 1400
*** HOLE CARDS ***
junior_re612: folds 
Katwoman0106: folds 
fAArid88: folds 
paulscot1: raises 13170 to 14570 and is all-in
SWE_CS: folds 
johnyguedes1: folds 
yuzoyai: folds 
Uncalled bet (13170) returned to paulscot1
paulscot1 collected 4725 from pot
paulscot1: doesn't show hand 
*** SUMMARY ***
Total pot 4725 | Rake 0 
Seat 1: Katwoman0106 folded before Flop (didn't bet)
Seat 2: fAArid88 folded before Flop (didn't bet)
Seat 3: paulscot1 collected (4725)
Seat 4: SWE_CS (button) folded before Flop (didn't bet)
Seat 5: johnyguedes1 (small blind) folded before Flop
Seat 6: yuzoyai (big blind) folded before Flop
Seat 7: junior_re612 folded before Flop (didn't bet)

PokerStars Hand #251205771643: Tournament #3767885527, $40+$10+$5 USD Hold'em No Limit - Level XII (700/1400) - 2024/06/26 19:17:20 UTC [2024/06/26 15:17:20 ET]
Table '3767885527 37' 8-max Seat #5 is the button
Seat 1: Katwoman0106 (51388 in chips) 
Seat 2: fAArid88 (97437 in chips) 
Seat 3: paulscot1 (17895 in chips) 
Seat 4: SWE_CS (21500 in chips) 
Seat 5: johnyguedes1 (61323 in chips) 
Seat 6: yuzoyai (59501 in chips) 
Seat 7: junior_re612 (57161 in chips) 
Katwoman0106: posts the ante 175
fAArid88: posts the ante 175
paulscot1: posts the ante 175
SWE_CS: posts the ante 175
johnyguedes1: posts the ante 175
yuzoyai: posts the ante 175
junior_re612: posts the ante 175
yuzoyai: posts small blind 700
junior_re612: posts big blind 1400
*** HOLE CARDS ***
Katwoman0106: raises 1400 to 2800
fAArid88: folds 
paulscot1: folds 
SWE_CS: folds 
johnyguedes1: folds 
yuzoyai: folds 
junior_re612: folds 
Uncalled bet (1400) returned to Katwoman0106
Katwoman0106 collected 4725 from pot
*** SUMMARY ***
Total pot 4725 | Rake 0 
Seat 1: Katwoman0106 collected (4725)
Seat 2: fAArid88 folded before Flop (didn't bet)
Seat 3: paulscot1 folded before Flop (didn't bet)
Seat 4: SWE_CS folded before Flop (didn't bet)
Seat 5: johnyguedes1 (button) folded before Flop (didn't bet)
Seat 6: yuzoyai (small blind) folded before Flop
Seat 7: junior_re612 (big blind) folded before Flop

PokerStars Hand #251205782195: Tournament #3767885527, $40+$10+$5 USD Hold'em No Limit - Level XII (700/1400) - 2024/06/26 19:17:59 UTC [2024/06/26 15:17:59 ET]
Table '3767885527 37' 8-max Seat #6 is the button
Seat 1: Katwoman0106 (54538 in chips) 
Seat 2: fAArid88 (97262 in chips) 
Seat 3: paulscot1 (17720 in chips) 
Seat 4: SWE_CS (21325 in chips) 
Seat 5: johnyguedes1 (61148 in chips) 
Seat 6: yuzoyai (58626 in chips) 
Seat 7: junior_re612 (55586 in chips) 
Katwoman0106: posts the ante 175
fAArid88: posts the ante 175
paulscot1: posts the ante 175
SWE_CS: posts the ante 175
johnyguedes1: posts the ante 175
yuzoyai: posts the ante 175
junior_re612: posts the ante 175
junior_re612: posts small blind 700
Katwoman0106: posts big blind 1400
*** HOLE CARDS ***
fAArid88: folds 
bashfoc2 is disconnected 
paulscot1: folds 
SWE_CS: folds 
johnyguedes1: folds 
yuzoyai: folds 
junior_re612: folds 
Uncalled bet (700) returned to Katwoman0106
Katwoman0106 collected 2625 from pot
*** SUMMARY ***
Total pot 2625 | Rake 0 
Seat 1: Katwoman0106 (big blind) collected (2625)
Seat 2: fAArid88 folded before Flop (didn't bet)
Seat 3: paulscot1 folded before Flop (didn't bet)
Seat 4: SWE_CS folded before Flop (didn't bet)
Seat 5: johnyguedes1 folded before Flop (didn't bet)
Seat 6: yuzoyai (button) folded before Flop (didn't bet)
Seat 7: junior_re612 (small blind) folded before Flop

PokerStars Hand #251205788415: Tournament #3767885527, $40+$10+$5 USD Hold'em No Limit - Level XII (700/1400) - 2024/06/26 19:18:22 UTC [2024/06/26 15:18:22 ET]
Table '3767885527 37' 8-max Seat #7 is the button
Seat 1: Katwoman0106 (56288 in chips) 
Seat 2: fAArid88 (97087 in chips) 
Seat 3: paulscot1 (17545 in chips) 
Seat 4: SWE_CS (21150 in chips) 
Seat 5: johnyguedes1 (60973 in chips) 
Seat 6: yuzoyai (58451 in chips) 
Seat 7: junior_re612 (54711 in chips) 
Seat 8: bashfoc2 (25000 in chips) out of hand (moved from another table into small blind)
bashfoc2 will be allowed to play after the button
Katwoman0106: posts the ante 175
fAArid88: posts the ante 175
paulscot1: posts the ante 175
SWE_CS: posts the ante 175
johnyguedes1: posts the ante 175
yuzoyai: posts the ante 175
junior_re612: posts the ante 175
Katwoman0106: posts small blind 700
fAArid88: posts big blind 1400
*** HOLE CARDS ***
paulscot1: folds 
SWE_CS: folds 
johnyguedes1: raises 1540 to 2940
yuzoyai: folds 
junior_re612: folds 
Katwoman0106: folds 
fAArid88: calls 1540
*** FLOP *** [6s 2s 3s]
fAArid88: checks 
johnyguedes1: bets 1951
fAArid88: raises 7839 to 9790
johnyguedes1: calls 7839
*** TURN *** [6s 2s 3s] [8s]
fAArid88: bets 9800
johnyguedes1: calls 9800
*** RIVER *** [6s 2s 3s 8s] [9c]
fAArid88: bets 26600
johnyguedes1: calls 26600
*** SHOW DOWN ***
fAArid88: shows [4h As] (a flush, Ace high)
johnyguedes1: mucks hand 
fAArid88 collected 100185 from pot
*** SUMMARY ***
Total pot 100185 | Rake 0 
Board [6s 2s 3s 8s 9c]
Seat 1: Katwoman0106 (small blind) folded before Flop
Seat 2: fAArid88 (big blind) showed [4h As] and won (100185) with a flush, Ace high
Seat 3: paulscot1 folded before Flop (didn't bet)
Seat 4: SWE_CS folded before Flop (didn't bet)
Seat 5: johnyguedes1 mucked
Seat 6: yuzoyai folded before Flop (didn't bet)
Seat 7: junior_re612 (button) folded before Flop (didn't bet)

PokerStars Hand #251205813184: Tournament #3767885527, $40+$10+$5 USD Hold'em No Limit - Level XIII (800/1600) - 2024/06/26 19:19:52 UTC [2024/06/26 15:19:52 ET]
Table '3767885527 37' 8-max Seat #1 is the button
Seat 1: Katwoman0106 (55413 in chips) 
Seat 2: fAArid88 (147967 in chips) 
Seat 3: paulscot1 (17370 in chips) 
Seat 4: SWE_CS (20975 in chips) 
Seat 5: johnyguedes1 (11668 in chips) 
Seat 6: yuzoyai (58276 in chips) 
Seat 7: junior_re612 (54536 in chips) 
Seat 8: bashfoc2 (25000 in chips) 
Katwoman0106: posts the ante 200
fAArid88: posts the ante 200
paulscot1: posts the ante 200
SWE_CS: posts the ante 200
johnyguedes1: posts the ante 200
yuzoyai: posts the ante 200
junior_re612: posts the ante 200
bashfoc2: posts the ante 200
fAArid88: posts small blind 800
paulscot1: posts big blind 1600
*** HOLE CARDS ***
SWE_CS: folds 
johnyguedes1: folds 
yuzoyai: folds 
junior_re612: folds 
bashfoc2: raises 4800 to 6400
Katwoman0106: folds 
fAArid88: folds 
paulscot1: folds 
Uncalled bet (4800) returned to bashfoc2
bashfoc2 collected 5600 from pot
bashfoc2: doesn't show hand 
*** SUMMARY ***
Total pot 5600 | Rake 0 
Seat 1: Katwoman0106 (button) folded before Flop (didn't bet)
Seat 2: fAArid88 (small blind) folded before Flop
Seat 3: paulscot1 (big blind) folded before Flop
Seat 4: SWE_CS folded before Flop (didn't bet)
Seat 5: johnyguedes1 folded before Flop (didn't bet)
Seat 6: yuzoyai folded before Flop (didn't bet)
Seat 7: junior_re612 folded before Flop (didn't bet)
Seat 8: bashfoc2 collected (5600)

PokerStars Hand #251205819663: Tournament #3767885527, $40+$10+$5 USD Hold'em No Limit - Level XIII (800/1600) - 2024/06/26 19:20:16 UTC [2024/06/26 15:20:16 ET]
Table '3767885527 37' 8-max Seat #2 is the button
Seat 1: Katwoman0106 (55213 in chips) 
Seat 2: fAArid88 (146967 in chips) 
Seat 3: paulscot1 (15570 in chips) 
Seat 4: SWE_CS (20775 in chips) 
Seat 5: johnyguedes1 (11468 in chips) 
Seat 6: yuzoyai (58076 in chips) 
Seat 7: junior_re612 (54336 in chips) 
Seat 8: bashfoc2 (28800 in chips) 
Katwoman0106: posts the ante 200
fAArid88: posts the ante 200
paulscot1: posts the ante 200
SWE_CS: posts the ante 200
johnyguedes1: posts the ante 200
yuzoyai: posts the ante 200
junior_re612: posts the ante 200
bashfoc2: posts the ante 200
paulscot1: posts small blind 800
SWE_CS: posts big blind 1600
*** HOLE CARDS ***
johnyguedes1: folds 
yuzoyai: folds 
junior_re612: folds 
bashfoc2: folds 
Katwoman0106: raises 1600 to 3200
fAArid88: folds 
paulscot1: folds 
SWE_CS: calls 1600
*** FLOP *** [Jd Ad 3s]
SWE_CS: checks 
Katwoman0106: checks 
*** TURN *** [Jd Ad 3s] [Kd]
SWE_CS: checks 
Katwoman0106: checks 
*** RIVER *** [Jd Ad 3s Kd] [Qd]
SWE_CS: bets 4400
Katwoman0106: folds [Qs Ks]
Uncalled bet (4400) returned to SWE_CS
SWE_CS collected 8800 from pot
SWE_CS: doesn't show hand 
*** SUMMARY ***
Total pot 8800 | Rake 0 
Board [Jd Ad 3s Kd Qd]
Seat 1: Katwoman0106 folded on the River
Seat 2: fAArid88 (button) folded before Flop (didn't bet)
Seat 3: paulscot1 (small blind) folded before Flop
Seat 4: SWE_CS (big blind) collected (8800)
Seat 5: johnyguedes1 folded before Flop (didn't bet)
Seat 6: yuzoyai folded before Flop (didn't bet)
Seat 7: junior_re612 folded before Flop (didn't bet)
Seat 8: bashfoc2 folded before Flop (didn't bet)

PokerStars Hand #251205832214: Tournament #3767885527, $40+$10+$5 USD Hold'em No Limit - Level XIII (800/1600) - 2024/06/26 19:21:02 UTC [2024/06/26 15:21:02 ET]
Table '3767885527 37' 8-max Seat #3 is the button
Seat 1: Katwoman0106 (51813 in chips) 
Seat 2: fAArid88 (146767 in chips) 
Seat 3: paulscot1 (14570 in chips) 
Seat 4: SWE_CS (26175 in chips) 
Seat 5: johnyguedes1 (11268 in chips) 
Seat 6: yuzoyai (57876 in chips) 
Seat 7: junior_re612 (54136 in chips) 
Seat 8: bashfoc2 (28600 in chips) 
Katwoman0106: posts the ante 200
fAArid88: posts the ante 200
paulscot1: posts the ante 200
SWE_CS: posts the ante 200
johnyguedes1: posts the ante 200
yuzoyai: posts the ante 200
junior_re612: posts the ante 200
bashfoc2: posts the ante 200
SWE_CS: posts small blind 800
johnyguedes1: posts big blind 1600
*** HOLE CARDS ***
yuzoyai: raises 1600 to 3200
junior_re612: folds 
bashfoc2: raises 4800 to 8000
Katwoman0106: folds 
fAArid88: folds 
paulscot1: folds 
SWE_CS: raises 17975 to 25975 and is all-in
johnyguedes1: folds 
yuzoyai: raises 31701 to 57676 and is all-in
bashfoc2: calls 20400 and is all-in
Uncalled bet (29276) returned to yuzoyai
*** FLOP *** [4s 7s Ac]
*** TURN *** [4s 7s Ac] [3h]
*** RIVER *** [4s 7s Ac 3h] [Ad]
*** SHOW DOWN ***
yuzoyai: shows [Kh Kc] (two pair, Aces and Kings)
bashfoc2: shows [As Qd] (three of a kind, Aces)
bashfoc2 collected 4850 from side pot
SWE_CS: shows [Qs Qc] (two pair, Aces and Queens)
bashfoc2 collected 81125 from main pot
SWE_CS finished the tournament
*** SUMMARY ***
Total pot 85975 Main pot 81125. Side pot 4850. | Rake 0 
Board [4s 7s Ac 3h Ad]
Seat 1: Katwoman0106 folded before Flop (didn't bet)
Seat 2: fAArid88 folded before Flop (didn't bet)
Seat 3: paulscot1 (button) folded before Flop (didn't bet)
Seat 4: SWE_CS (small blind) showed [Qs Qc] and lost with two pair, Aces and Queens
Seat 5: johnyguedes1 (big blind) folded before Flop
Seat 6: yuzoyai showed [Kh Kc] and lost with two pair, Aces and Kings
Seat 7: junior_re612 folded before Flop (didn't bet)
Seat 8: bashfoc2 showed [As Qd] and won (85975) with three of a kind, Aces


PokerStars Hand #251205591253: Tournament #3767885527, $40+$10+$5 USD Hold'em No Limit - Level XI (600/1200) - 2024/06/26 19:06:11 UTC [2024/06/26 15:06:11 ET]
Table '3767885527 35' 8-max Seat #1 is the button
Seat 1: hiran bass (33141 in chips) 
Seat 2: Famazaja (33260 in chips) 
Seat 3: atg590 (72411 in chips) 
Seat 4: PhoenixGrind (96000 in chips) 
Seat 5: Johevera (49368 in chips) 
Seat 6: sQuezzeYoU!! (44387 in chips) 
Seat 7: jaimico00793 (8393 in chips) 
Seat 8: gwallgofddyn (102599 in chips) 
hiran bass: posts the ante 150
Famazaja: posts the ante 150
atg590: posts the ante 150
PhoenixGrind: posts the ante 150
Johevera: posts the ante 150
sQuezzeYoU!!: posts the ante 150
jaimico00793: posts the ante 150
gwallgofddyn: posts the ante 150
Famazaja: posts small blind 600
atg590: posts big blind 1200
*** HOLE CARDS ***
PhoenixGrind: folds 
Johevera: folds 
sQuezzeYoU!!: folds 
jaimico00793: folds 
gwallgofddyn: raises 1560 to 2760
hiran bass: calls 2760
Famazaja: folds 
atg590: calls 1560
*** FLOP *** [2d 4d Js]
atg590: checks 
gwallgofddyn: bets 4032
hiran bass: folds 
atg590: calls 4032
*** TURN *** [2d 4d Js] [9h]
atg590: checks 
gwallgofddyn: checks 
*** RIVER *** [2d 4d Js 9h] [5s]
atg590: bets 9072
gwallgofddyn: folds 
Uncalled bet (9072) returned to atg590
atg590 collected 18144 from pot
*** SUMMARY ***
Total pot 18144 | Rake 0 
Board [2d 4d Js 9h 5s]
Seat 1: hiran bass (button) folded on the Flop
Seat 2: Famazaja (small blind) folded before Flop
Seat 3: atg590 (big blind) collected (18144)
Seat 4: PhoenixGrind folded before Flop (didn't bet)
Seat 5: Johevera folded before Flop (didn't bet)
Seat 6: sQuezzeYoU!! folded before Flop (didn't bet)
Seat 7: jaimico00793 folded before Flop (didn't bet)
Seat 8: gwallgofddyn folded on the River

PokerStars Hand #251205606358: Tournament #3767885527, $40+$10+$5 USD Hold'em No Limit - Level XI (600/1200) - 2024/06/26 19:07:07 UTC [2024/06/26 15:07:07 ET]
Table '3767885527 35' 8-max Seat #2 is the button
Seat 1: hiran bass (30231 in chips) 
Seat 2: Famazaja (32510 in chips) 
Seat 3: atg590 (83613 in chips) 
Seat 4: PhoenixGrind (95850 in chips) 
Seat 5: Johevera (49218 in chips) 
Seat 6: sQuezzeYoU!! (44237 in chips) 
Seat 7: jaimico00793 (8243 in chips) 
Seat 8: gwallgofddyn (95657 in chips) 
hiran bass: posts the ante 150
Famazaja: posts the ante 150
atg590: posts the ante 150
PhoenixGrind: posts the ante 150
Johevera: posts the ante 150
sQuezzeYoU!!: posts the ante 150
jaimico00793: posts the ante 150
gwallgofddyn: posts the ante 150
atg590: posts small blind 600
PhoenixGrind: posts big blind 1200
*** HOLE CARDS ***
Johevera: folds 
sQuezzeYoU!!: folds 
jaimico00793: raises 6893 to 8093 and is all-in
gwallgofddyn: folds 
hiran bass: folds 
Famazaja: folds 
atg590: folds 
PhoenixGrind: calls 6893
*** FLOP *** [Qs 9h 5d]
*** TURN *** [Qs 9h 5d] [Ac]
*** RIVER *** [Qs 9h 5d Ac] [8d]
*** SHOW DOWN ***
PhoenixGrind: shows [Kd 3d] (high card Ace)
jaimico00793: shows [Qc Ad] (two pair, Aces and Queens)
jaimico00793 collected 17986 from pot
*** SUMMARY ***
Total pot 17986 | Rake 0 
Board [Qs 9h 5d Ac 8d]
Seat 1: hiran bass folded before Flop (didn't bet)
Seat 2: Famazaja (button) folded before Flop (didn't bet)
Seat 3: atg590 (small blind) folded before Flop
Seat 4: PhoenixGrind (big blind) showed [Kd 3d] and lost with high card Ace
Seat 5: Johevera folded before Flop (didn't bet)
Seat 6: sQuezzeYoU!! folded before Flop (didn't bet)
Seat 7: jaimico00793 showed [Qc Ad] and won (17986) with two pair, Aces and Queens
Seat 8: gwallgofddyn folded before Flop (didn't bet)

PokerStars Hand #251205612998: Tournament #3767885527, $40+$10+$5 USD Hold'em No Limit - Level XI (600/1200) - 2024/06/26 19:07:32 UTC [2024/06/26 15:07:32 ET]
Table '3767885527 35' 8-max Seat #3 is the button
Seat 1: hiran bass (30081 in chips) 
Seat 2: Famazaja (32360 in chips) 
Seat 3: atg590 (82863 in chips) 
Seat 4: PhoenixGrind (87607 in chips) 
Seat 5: Johevera (49068 in chips) 
Seat 6: sQuezzeYoU!! (44087 in chips) 
Seat 7: jaimico00793 (17986 in chips) 
Seat 8: gwallgofddyn (95507 in chips) 
hiran bass: posts the ante 150
Famazaja: posts the ante 150
atg590: posts the ante 150
PhoenixGrind: posts the ante 150
Johevera: posts the ante 150
sQuezzeYoU!!: posts the ante 150
jaimico00793: posts the ante 150
gwallgofddyn: posts the ante 150
PhoenixGrind: posts small blind 600
Johevera: posts big blind 1200
*** HOLE CARDS ***
sQuezzeYoU!!: folds 
jaimico00793: folds 
gwallgofddyn: raises 1560 to 2760
hiran bass: raises 3840 to 6600
Famazaja: folds 
atg590: folds 
PhoenixGrind: folds 
Johevera: folds 
gwallgofddyn: calls 3840
*** FLOP *** [7c Qc Kh]
gwallgofddyn: checks 
hiran bass: checks 
*** TURN *** [7c Qc Kh] [9h]
gwallgofddyn: checks 
hiran bass: checks 
*** RIVER *** [7c Qc Kh 9h] [5c]
gwallgofddyn: bets 6480
hiran bass: folds 
Uncalled bet (6480) returned to gwallgofddyn
gwallgofddyn collected 16200 from pot
gwallgofddyn: doesn't show hand 
*** SUMMARY ***
Total pot 16200 | Rake 0 
Board [7c Qc Kh 9h 5c]
Seat 1: hiran bass folded on the River
Seat 2: Famazaja folded before Flop (didn't bet)
Seat 3: atg590 (button) folded before Flop (didn't bet)
Seat 4: PhoenixGrind (small blind) folded before Flop
Seat 5: Johevera (big blind) folded before Flop
Seat 6: sQuezzeYoU!! folded before Flop (didn't bet)
Seat 7: jaimico00793 folded before Flop (didn't bet)
Seat 8: gwallgofddyn collected (16200)

PokerStars Hand #251205632476: Tournament #3767885527, $40+$10+$5 USD Hold'em No Limit - Level XI (600/1200) - 2024/06/26 19:08:46 UTC [2024/06/26 15:08:46 ET]
Table '3767885527 35' 8-max Seat #4 is the button
Seat 1: hiran bass (23331 in chips) 
Seat 2: Famazaja (32210 in chips) 
Seat 3: atg590 (82713 in chips) 
Seat 4: PhoenixGrind (86857 in chips) 
Seat 5: Johevera (47718 in chips) 
Seat 6: sQuezzeYoU!! (43937 in chips) 
Seat 7: jaimico00793 (17836 in chips) 
Seat 8: gwallgofddyn (104957 in chips) 
hiran bass: posts the ante 150
Famazaja: posts the ante 150
atg590: posts the ante 150
PhoenixGrind: posts the ante 150
Johevera: posts the ante 150
sQuezzeYoU!!: posts the ante 150
jaimico00793: posts the ante 150
gwallgofddyn: posts the ante 150
Johevera: posts small blind 600
sQuezzeYoU!!: posts big blind 1200
*** HOLE CARDS ***
jaimico00793: folds 
gwallgofddyn: folds 
hiran bass: folds 
Famazaja: folds 
atg590: folds 
PhoenixGrind: raises 1800 to 3000
Johevera: folds 
sQuezzeYoU!!: folds 
Uncalled bet (1800) returned to PhoenixGrind
PhoenixGrind collected 4200 from pot
PhoenixGrind: doesn't show hand 
*** SUMMARY ***
Total pot 4200 | Rake 0 
Seat 1: hiran bass folded before Flop (didn't bet)
Seat 2: Famazaja folded before Flop (didn't bet)
Seat 3: atg590 folded before Flop (didn't bet)
Seat 4: PhoenixGrind (button) collected (4200)
Seat 5: Johevera (small blind) folded before Flop
Seat 6: sQuezzeYoU!! (big blind) folded before Flop
Seat 7: jaimico00793 folded before Flop (didn't bet)
Seat 8: gwallgofddyn folded before Flop (didn't bet)

PokerStars Hand #251205637604: Tournament #3767885527, $40+$10+$5 USD Hold'em No Limit - Level XI (600/1200) - 2024/06/26 19:09:05 UTC [2024/06/26 15:09:05 ET]
Table '3767885527 35' 8-max Seat #5 is the button
Seat 1: hiran bass (23181 in chips) 
Seat 2: Famazaja (32060 in chips) 
Seat 3: atg590 (82563 in chips) 
Seat 4: PhoenixGrind (89707 in chips) 
Seat 5: Johevera (46968 in chips) 
Seat 6: sQuezzeYoU!! (42587 in chips) 
Seat 7: jaimico00793 (17686 in chips) 
Seat 8: gwallgofddyn (104807 in chips) 
hiran bass: posts the ante 150
Famazaja: posts the ante 150
atg590: posts the ante 150
PhoenixGrind: posts the ante 150
Johevera: posts the ante 150
sQuezzeYoU!!: posts the ante 150
jaimico00793: posts the ante 150
gwallgofddyn: posts the ante 150
sQuezzeYoU!!: posts small blind 600
jaimico00793: posts big blind 1200
*** HOLE CARDS ***
gwallgofddyn: folds 
hiran bass: folds 
Famazaja: raises 1200 to 2400
atg590: folds 
PhoenixGrind: folds 
Johevera: folds 
sQuezzeYoU!!: calls 1800
jaimico00793: folds 
*** FLOP *** [8c 7c Kh]
sQuezzeYoU!!: checks 
Famazaja: bets 3600
sQuezzeYoU!!: calls 3600
*** TURN *** [8c 7c Kh] [3d]
sQuezzeYoU!!: checks 
Famazaja: checks 
*** RIVER *** [8c 7c Kh 3d] [8h]
sQuezzeYoU!!: bets 8496
Famazaja: folds 
Uncalled bet (8496) returned to sQuezzeYoU!!
sQuezzeYoU!! collected 14400 from pot
sQuezzeYoU!!: doesn't show hand 
*** SUMMARY ***
Total pot 14400 | Rake 0 
Board [8c 7c Kh 3d 8h]
Seat 1: hiran bass folded before Flop (didn't bet)
Seat 2: Famazaja folded on the River
Seat 3: atg590 folded before Flop (didn't bet)
Seat 4: PhoenixGrind folded before Flop (didn't bet)
Seat 5: Johevera (button) folded before Flop (didn't bet)
Seat 6: sQuezzeYoU!! (small blind) collected (14400)
Seat 7: jaimico00793 (big blind) folded before Flop
Seat 8: gwallgofddyn folded before Flop (didn't bet)

PokerStars Hand #251205652966: Tournament #3767885527, $40+$10+$5 USD Hold'em No Limit - Level XII (700/1400) - 2024/06/26 19:10:02 UTC [2024/06/26 15:10:02 ET]
Table '3767885527 35' 8-max Seat #6 is the button
Seat 1: hiran bass (23031 in chips) 
Seat 2: Famazaja (25910 in chips) 
Seat 3: atg590 (82413 in chips) 
Seat 4: PhoenixGrind (89557 in chips) 
Seat 5: Johevera (46818 in chips) 
Seat 6: sQuezzeYoU!! (50837 in chips) 
Seat 7: jaimico00793 (16336 in chips) 
Seat 8: gwallgofddyn (104657 in chips) 
hiran bass: posts the ante 175
Famazaja: posts the ante 175
atg590: posts the ante 175
PhoenixGrind: posts the ante 175
Johevera: posts the ante 175
sQuezzeYoU!!: posts the ante 175
jaimico00793: posts the ante 175
gwallgofddyn: posts the ante 175
jaimico00793: posts small blind 700
gwallgofddyn: posts big blind 1400
*** HOLE CARDS ***
hiran bass: folds 
Famazaja: folds 
atg590: folds 
PhoenixGrind has timed out
PhoenixGrind: folds 
PhoenixGrind is sitting out
Johevera: raises 1540 to 2940
sQuezzeYoU!!: folds 
PhoenixGrind has returned
jaimico00793: folds 
gwallgofddyn: calls 1540
*** FLOP *** [Qd Kc Ts]
gwallgofddyn: checks 
Johevera: bets 5985
gwallgofddyn: calls 5985
*** TURN *** [Qd Kc Ts] [Qh]
gwallgofddyn: checks 
Johevera: checks 
*** RIVER *** [Qd Kc Ts Qh] [2s]
gwallgofddyn: bets 16100
Johevera: folds 
Uncalled bet (16100) returned to gwallgofddyn
gwallgofddyn collected 19950 from pot
gwallgofddyn: doesn't show hand 
*** SUMMARY ***
Total pot 19950 | Rake 0 
Board [Qd Kc Ts Qh 2s]
Seat 1: hiran bass folded before Flop (didn't bet)
Seat 2: Famazaja folded before Flop (didn't bet)
Seat 3: atg590 folded before Flop (didn't bet)
Seat 4: PhoenixGrind folded before Flop (didn't bet)
Seat 5: Johevera folded on the River
Seat 6: sQuezzeYoU!! (button) folded before Flop (didn't bet)
Seat 7: jaimico00793 (small blind) folded before Flop
Seat 8: gwallgofddyn (big blind) collected (19950)

PokerStars Hand #251205674037: Tournament #3767885527, $40+$10+$5 USD Hold'em No Limit - Level XII (700/1400) - 2024/06/26 19:11:21 UTC [2024/06/26 15:11:21 ET]
Table '3767885527 35' 8-max Seat #7 is the button
Seat 1: hiran bass (22856 in chips) 
Seat 2: Famazaja (25735 in chips) 
Seat 3: atg590 (82238 in chips) 
Seat 4: PhoenixGrind (89382 in chips) 
Seat 5: Johevera (37718 in chips) 
Seat 6: sQuezzeYoU!! (50662 in chips) 
Seat 7: jaimico00793 (15461 in chips) 
Seat 8: gwallgofddyn (115507 in chips) 
hiran bass: posts the ante 175
Famazaja: posts the ante 175
atg590: posts the ante 175
PhoenixGrind: posts the ante 175
Johevera: posts the ante 175
sQuezzeYoU!!: posts the ante 175
jaimico00793: posts the ante 175
gwallgofddyn: posts the ante 175
gwallgofddyn: posts small blind 700
hiran bass: posts big blind 1400
*** HOLE CARDS ***
Famazaja: raises 1400 to 2800
atg590: folds 
PhoenixGrind: folds 
Johevera: folds 
sQuezzeYoU!!: raises 5600 to 8400
jaimico00793: folds 
gwallgofddyn: folds 
hiran bass: folds 
Famazaja: folds 
Uncalled bet (5600) returned to sQuezzeYoU!!
sQuezzeYoU!! collected 9100 from pot
sQuezzeYoU!!: doesn't show hand 
*** SUMMARY ***
Total pot 9100 | Rake 0 
Seat 1: hiran bass (big blind) folded before Flop
Seat 2: Famazaja folded before Flop
Seat 3: atg590 folded before Flop (didn't bet)
Seat 4: PhoenixGrind folded before Flop (didn't bet)
Seat 5: Johevera folded before Flop (didn't bet)
Seat 6: sQuezzeYoU!! collected (9100)
Seat 7: jaimico00793 (button) folded before Flop (didn't bet)
Seat 8: gwallgofddyn (small blind) folded before Flop

PokerStars Hand #251205684914: Tournament #3767885527, $40+$10+$5 USD Hold'em No Limit - Level XII (700/1400) - 2024/06/26 19:12:01 UTC [2024/06/26 15:12:01 ET]
Table '3767885527 35' 8-max Seat #8 is the button
Seat 1: hiran bass (21281 in chips) 
Seat 2: Famazaja (22760 in chips) 
Seat 3: atg590 (82063 in chips) 
Seat 4: PhoenixGrind (89207 in chips) 
Seat 5: Johevera (37543 in chips) 
Seat 6: sQuezzeYoU!! (56787 in chips) 
Seat 7: jaimico00793 (15286 in chips) 
Seat 8: gwallgofddyn (114632 in chips) 
hiran bass: posts the ante 175
Famazaja: posts the ante 175
atg590: posts the ante 175
PhoenixGrind: posts the ante 175
Johevera: posts the ante 175
sQuezzeYoU!!: posts the ante 175
jaimico00793: posts the ante 175
gwallgofddyn: posts the ante 175
hiran bass: posts small blind 700
Famazaja: posts big blind 1400
*** HOLE CARDS ***
atg590: folds 
PhoenixGrind: folds 
Johevera: folds 
sQuezzeYoU!!: folds 
jaimico00793: folds 
gwallgofddyn: folds 
hiran bass: raises 19706 to 21106 and is all-in
Famazaja: folds 
Uncalled bet (19706) returned to hiran bass
hiran bass collected 4200 from pot
hiran bass: doesn't show hand 
*** SUMMARY ***
Total pot 4200 | Rake 0 
Seat 1: hiran bass (small blind) collected (4200)
Seat 2: Famazaja (big blind) folded before Flop
Seat 3: atg590 folded before Flop (didn't bet)
Seat 4: PhoenixGrind folded before Flop (didn't bet)
Seat 5: Johevera folded before Flop (didn't bet)
Seat 6: sQuezzeYoU!! folded before Flop (didn't bet)
Seat 7: jaimico00793 folded before Flop (didn't bet)
Seat 8: gwallgofddyn (button) folded before Flop (didn't bet)

PokerStars Hand #251205690421: Tournament #3767885527, $40+$10+$5 USD Hold'em No Limit - Level XII (700/1400) - 2024/06/26 19:12:21 UTC [2024/06/26 15:12:21 ET]
Table '3767885527 35' 8-max Seat #1 is the button
Seat 1: hiran bass (23906 in chips) 
Seat 2: Famazaja (21185 in chips) 
Seat 3: atg590 (81888 in chips) 
Seat 4: PhoenixGrind (89032 in chips) 
Seat 5: Johevera (37368 in chips) 
Seat 6: sQuezzeYoU!! (56612 in chips) 
Seat 7: jaimico00793 (15111 in chips) 
Seat 8: gwallgofddyn (114457 in chips) 
hiran bass: posts the ante 175
Famazaja: posts the ante 175
atg590: posts the ante 175
PhoenixGrind: posts the ante 175
Johevera: posts the ante 175
sQuezzeYoU!!: posts the ante 175
jaimico00793: posts the ante 175
gwallgofddyn: posts the ante 175
Famazaja: posts small blind 700
atg590: posts big blind 1400
*** HOLE CARDS ***
PhoenixGrind: folds 
Johevera: folds 
sQuezzeYoU!!: folds 
jaimico00793: folds 
gwallgofddyn: raises 1820 to 3220
hiran bass: folds 
Famazaja: folds 
atg590: folds 
Uncalled bet (1820) returned to gwallgofddyn
gwallgofddyn collected 4900 from pot
gwallgofddyn: doesn't show hand 
*** SUMMARY ***
Total pot 4900 | Rake 0 
Seat 1: hiran bass (button) folded before Flop (didn't bet)
Seat 2: Famazaja (small blind) folded before Flop
Seat 3: atg590 (big blind) folded before Flop
Seat 4: PhoenixGrind folded before Flop (didn't bet)
Seat 5: Johevera folded before Flop (didn't bet)
Seat 6: sQuezzeYoU!! folded before Flop (didn't bet)
Seat 7: jaimico00793 folded before Flop (didn't bet)
Seat 8: gwallgofddyn collected (4900)

PokerStars Hand #251205696633: Tournament #3767885527, $40+$10+$5 USD Hold'em No Limit - Level XII (700/1400) - 2024/06/26 19:12:44 UTC [2024/06/26 15:12:44 ET]
Table '3767885527 35' 8-max Seat #2 is the button
Seat 1: hiran bass (23731 in chips) 
Seat 2: Famazaja (20310 in chips) 
Seat 3: atg590 (80313 in chips) 
Seat 4: PhoenixGrind (88857 in chips) 
Seat 5: Johevera (37193 in chips) 
Seat 6: sQuezzeYoU!! (56437 in chips) 
Seat 7: jaimico00793 (14936 in chips) 
Seat 8: gwallgofddyn (117782 in chips) 
hiran bass: posts the ante 175
Famazaja: posts the ante 175
atg590: posts the ante 175
PhoenixGrind: posts the ante 175
Johevera: posts the ante 175
sQuezzeYoU!!: posts the ante 175
jaimico00793: posts the ante 175
gwallgofddyn: posts the ante 175
atg590: posts small blind 700
PhoenixGrind: posts big blind 1400
*** HOLE CARDS ***
Johevera: folds 
sQuezzeYoU!!: folds 
jaimico00793: folds 
gwallgofddyn: raises 1820 to 3220
hiran bass: folds 
Famazaja: calls 3220
atg590: folds 
PhoenixGrind: folds 
*** FLOP *** [Kh 6d 3d]
gwallgofddyn: bets 2800
Famazaja: raises 14115 to 16915 and is all-in
gwallgofddyn: calls 14115
*** TURN *** [Kh 6d 3d] [6s]
*** RIVER *** [Kh 6d 3d 6s] [Ac]
*** SHOW DOWN ***
gwallgofddyn: shows [Kc 8c] (two pair, Kings and Sixes)
Famazaja: shows [8d 9d] (a pair of Sixes)
gwallgofddyn collected 43770 from pot
Famazaja finished the tournament
*** SUMMARY ***
Total pot 43770 | Rake 0 
Board [Kh 6d 3d 6s Ac]
Seat 1: hiran bass folded before Flop (didn't bet)
Seat 2: Famazaja (button) showed [8d 9d] and lost with a pair of Sixes
Seat 3: atg590 (small blind) folded before Flop
Seat 4: PhoenixGrind (big blind) folded before Flop
Seat 5: Johevera folded before Flop (didn't bet)
Seat 6: sQuezzeYoU!! folded before Flop (didn't bet)
Seat 7: jaimico00793 folded before Flop (didn't bet)
Seat 8: gwallgofddyn showed [Kc 8c] and won (43770) with two pair, Kings and Sixes

PokerStars Hand #251205716395: Tournament #3767885527, $40+$10+$5 USD Hold'em No Limit - Level XII (700/1400) - 2024/06/26 19:13:57 UTC [2024/06/26 15:13:57 ET]
Table '3767885527 35' 8-max Seat #3 is the button
Seat 1: hiran bass (23556 in chips) 
Seat 3: atg590 (79438 in chips) 
Seat 4: PhoenixGrind (87282 in chips) 
Seat 5: Johevera (37018 in chips) 
Seat 6: sQuezzeYoU!! (56262 in chips) 
Seat 7: jaimico00793 (14761 in chips) 
Seat 8: gwallgofddyn (141242 in chips) 
hiran bass: posts the ante 175
atg590: posts the ante 175
PhoenixGrind: posts the ante 175
Johevera: posts the ante 175
sQuezzeYoU!!: posts the ante 175
jaimico00793: posts the ante 175
gwallgofddyn: posts the ante 175
PhoenixGrind: posts small blind 700
Johevera: posts big blind 1400
*** HOLE CARDS ***
sQuezzeYoU!!: folds 
jaimico00793: raises 13186 to 14586 and is all-in
gwallgofddyn: folds 
hiran bass: folds 
atg590: folds 
PhoenixGrind: folds 
StoraEss is disconnected 
Johevera: folds 
Uncalled bet (13186) returned to jaimico00793
jaimico00793 collected 4725 from pot
jaimico00793: doesn't show hand 
*** SUMMARY ***
Total pot 4725 | Rake 0 
Seat 1: hiran bass folded before Flop (didn't bet)
Seat 3: atg590 (button) folded before Flop (didn't bet)
Seat 4: PhoenixGrind (small blind) folded before Flop
Seat 5: Johevera (big blind) folded before Flop
Seat 6: sQuezzeYoU!! folded before Flop (didn't bet)
Seat 7: jaimico00793 collected (4725)
Seat 8: gwallgofddyn folded before Flop (didn't bet)

PokerStars Hand #251205723452: Tournament #3767885527, $40+$10+$5 USD Hold'em No Limit - Level XII (700/1400) - 2024/06/26 19:14:23 UTC [2024/06/26 15:14:23 ET]
Table '3767885527 35' 8-max Seat #4 is the button
Seat 1: hiran bass (23381 in chips) 
Seat 2: StoraEss (25000 in chips) 
Seat 3: atg590 (79263 in chips) 
Seat 4: PhoenixGrind (86407 in chips) 
Seat 5: Johevera (35443 in chips) 
Seat 6: sQuezzeYoU!! (56087 in chips) 
Seat 7: jaimico00793 (17911 in chips) 
Seat 8: gwallgofddyn (141067 in chips) 
hiran bass: posts the ante 175
StoraEss: posts the ante 175
atg590: posts the ante 175
PhoenixGrind: posts the ante 175
Johevera: posts the ante 175
sQuezzeYoU!!: posts the ante 175
jaimico00793: posts the ante 175
gwallgofddyn: posts the ante 175
Johevera: posts small blind 700
sQuezzeYoU!!: posts big blind 1400
*** HOLE CARDS ***
jaimico00793: folds 
gwallgofddyn: raises 1820 to 3220
hiran bass: folds 
StoraEss: folds 
atg590: calls 3220
PhoenixGrind: folds 
Johevera: folds 
sQuezzeYoU!!: folds 
*** FLOP *** [3d Qh Qc]
gwallgofddyn: checks 
atg590: checks 
*** TURN *** [3d Qh Qc] [Qd]
gwallgofddyn: checks 
atg590: bets 4200
gwallgofddyn: calls 4200
*** RIVER *** [3d Qh Qc Qd] [6d]
gwallgofddyn: checks 
atg590: bets 9170
gwallgofddyn: folds 
Uncalled bet (9170) returned to atg590
atg590 collected 18340 from pot
*** SUMMARY ***
Total pot 18340 | Rake 0 
Board [3d Qh Qc Qd 6d]
Seat 1: hiran bass folded before Flop (didn't bet)
Seat 2: StoraEss folded before Flop (didn't bet)
Seat 3: atg590 collected (18340)
Seat 4: PhoenixGrind (button) folded before Flop (didn't bet)
Seat 5: Johevera (small blind) folded before Flop
Seat 6: sQuezzeYoU!! (big blind) folded before Flop
Seat 7: jaimico00793 folded before Flop (didn't bet)
Seat 8: gwallgofddyn folded on the River

PokerStars Hand #251205738663: Tournament #3767885527, $40+$10+$5 USD Hold'em No Limit - Level XII (700/1400) - 2024/06/26 19:15:19 UTC [2024/06/26 15:15:19 ET]
Table '3767885527 35' 8-max Seat #5 is the button
Seat 1: hiran bass (23206 in chips) 
Seat 2: StoraEss (24825 in chips) 
Seat 3: atg590 (90008 in chips) 
Seat 4: PhoenixGrind (86232 in chips) 
Seat 5: Johevera (34568 in chips) 
Seat 6: sQuezzeYoU!! (54512 in chips) 
Seat 7: jaimico00793 (17736 in chips) 
Seat 8: gwallgofddyn (133472 in chips) 
hiran bass: posts the ante 175
StoraEss: posts the ante 175
atg590: posts the ante 175
PhoenixGrind: posts the ante 175
Johevera: posts the ante 175
sQuezzeYoU!!: posts the ante 175
jaimico00793: posts the ante 175
gwallgofddyn: posts the ante 175
sQuezzeYoU!!: posts small blind 700
jaimico00793: posts big blind 1400
*** HOLE CARDS ***
gwallgofddyn: folds 
hiran bass: folds 
StoraEss: folds 
atg590: folds 
PhoenixGrind: raises 2100 to 3500
Johevera: folds 
sQuezzeYoU!!: folds 
jaimico00793: folds 
Uncalled bet (2100) returned to PhoenixGrind
PhoenixGrind collected 4900 from pot
PhoenixGrind: doesn't show hand 
*** SUMMARY ***
Total pot 4900 | Rake 0 
Seat 1: hiran bass folded before Flop (didn't bet)
Seat 2: StoraEss folded before Flop (didn't bet)
Seat 3: atg590 folded before Flop (didn't bet)
Seat 4: PhoenixGrind collected (4900)
Seat 5: Johevera (button) folded before Flop (didn't bet)
Seat 6: sQuezzeYoU!! (small blind) folded before Flop
Seat 7: jaimico00793 (big blind) folded before Flop
Seat 8: gwallgofddyn folded before Flop (didn't bet)

PokerStars Hand #251205745892: Tournament #3767885527, $40+$10+$5 USD Hold'em No Limit - Level XII (700/1400) - 2024/06/26 19:15:46 UTC [2024/06/26 15:15:46 ET]
Table '3767885527 35' 8-max Seat #6 is the button
Seat 1: hiran bass (23031 in chips) 
Seat 2: StoraEss (24650 in chips) 
Seat 3: atg590 (89833 in chips) 
Seat 4: PhoenixGrind (89557 in chips) 
Seat 5: Johevera (34393 in chips) 
Seat 6: sQuezzeYoU!! (53637 in chips) 
Seat 7: jaimico00793 (16161 in chips) 
Seat 8: gwallgofddyn (133297 in chips) 
hiran bass: posts the ante 175
StoraEss: posts the ante 175
atg590: posts the ante 175
PhoenixGrind: posts the ante 175
Johevera: posts the ante 175
sQuezzeYoU!!: posts the ante 175
jaimico00793: posts the ante 175
gwallgofddyn: posts the ante 175
jaimico00793: posts small blind 700
gwallgofddyn: posts big blind 1400
*** HOLE CARDS ***
hiran bass: raises 1400 to 2800
StoraEss: folds 
atg590: folds 
PhoenixGrind: folds 
Johevera: folds 
sQuezzeYoU!!: folds 
jaimico00793: folds 
gwallgofddyn: calls 1400
*** FLOP *** [6s 6h 3s]
gwallgofddyn: checks 
hiran bass: bets 2541
gwallgofddyn: raises 5159 to 7700
hiran bass: folds 
Uncalled bet (5159) returned to gwallgofddyn
gwallgofddyn collected 12782 from pot
gwallgofddyn: doesn't show hand 
*** SUMMARY ***
Total pot 12782 | Rake 0 
Board [6s 6h 3s]
Seat 1: hiran bass folded on the Flop
Seat 2: StoraEss folded before Flop (didn't bet)
Seat 3: atg590 folded before Flop (didn't bet)
Seat 4: PhoenixGrind folded before Flop (didn't bet)
Seat 5: Johevera folded before Flop (didn't bet)
Seat 6: sQuezzeYoU!! (button) folded before Flop (didn't bet)
Seat 7: jaimico00793 (small blind) folded before Flop
Seat 8: gwallgofddyn (big blind) collected (12782)

PokerStars Hand #251205759420: Tournament #3767885527, $40+$10+$5 USD Hold'em No Limit - Level XII (700/1400) - 2024/06/26 19:16:35 UTC [2024/06/26 15:16:35 ET]
Table '3767885527 35' 8-max Seat #7 is the button
Seat 1: hiran bass (17515 in chips) 
Seat 2: StoraEss (24475 in chips) 
Seat 3: atg590 (89658 in chips) 
Seat 4: PhoenixGrind (89382 in chips) 
Seat 5: Johevera (34218 in chips) 
Seat 6: sQuezzeYoU!! (53462 in chips) 
Seat 7: jaimico00793 (15286 in chips) 
Seat 8: gwallgofddyn (140563 in chips) 
hiran bass: posts the ante 175
StoraEss: posts the ante 175
atg590: posts the ante 175
PhoenixGrind: posts the ante 175
Johevera: posts the ante 175
sQuezzeYoU!!: posts the ante 175
jaimico00793: posts the ante 175
gwallgofddyn: posts the ante 175
gwallgofddyn: posts small blind 700
hiran bass: posts big blind 1400
*** HOLE CARDS ***
StoraEss: folds 
atg590: folds 
PhoenixGrind: folds 
Johevera: folds 
sQuezzeYoU!!: folds 
jaimico00793: folds 
gwallgofddyn: raises 138988 to 140388 and is all-in
hiran bass: folds 
Uncalled bet (138988) returned to gwallgofddyn
gwallgofddyn collected 4200 from pot
gwallgofddyn: doesn't show hand 
*** SUMMARY ***
Total pot 4200 | Rake 0 
Seat 1: hiran bass (big blind) folded before Flop
Seat 2: StoraEss folded before Flop (didn't bet)
Seat 3: atg590 folded before Flop (didn't bet)
Seat 4: PhoenixGrind folded before Flop (didn't bet)
Seat 5: Johevera folded before Flop (didn't bet)
Seat 6: sQuezzeYoU!! folded before Flop (didn't bet)
Seat 7: jaimico00793 (button) folded before Flop (didn't bet)
Seat 8: gwallgofddyn (small blind) collected (4200)

PokerStars Hand #251205770206: Tournament #3767885527, $40+$10+$5 USD Hold'em No Limit - Level XII (700/1400) - 2024/06/26 19:17:15 UTC [2024/06/26 15:17:15 ET]
Table '3767885527 35' 8-max Seat #8 is the button
Seat 1: hiran bass (15940 in chips) 
Seat 2: StoraEss (24300 in chips) 
Seat 3: atg590 (89483 in chips) 
Seat 4: PhoenixGrind (89207 in chips) 
Seat 5: Johevera (34043 in chips) 
Seat 6: sQuezzeYoU!! (53287 in chips) 
Seat 7: jaimico00793 (15111 in chips) 
Seat 8: gwallgofddyn (143188 in chips) 
hiran bass: posts the ante 175
StoraEss: posts the ante 175
atg590: posts the ante 175
PhoenixGrind: posts the ante 175
Johevera: posts the ante 175
sQuezzeYoU!!: posts the ante 175
jaimico00793: posts the ante 175
gwallgofddyn: posts the ante 175
hiran bass: posts small blind 700
StoraEss: posts big blind 1400
*** HOLE CARDS ***
atg590: folds 
PhoenixGrind: folds 
Johevera: folds 
sQuezzeYoU!!: folds 
jaimico00793: raises 13536 to 14936 and is all-in
gwallgofddyn: folds 
hiran bass: folds 
StoraEss: folds 
Uncalled bet (13536) returned to jaimico00793
jaimico00793 collected 4900 from pot
jaimico00793: doesn't show hand 
*** SUMMARY ***
Total pot 4900 | Rake 0 
Seat 1: hiran bass (small blind) folded before Flop
Seat 2: StoraEss (big blind) folded before Flop
Seat 3: atg590 folded before Flop (didn't bet)
Seat 4: PhoenixGrind folded before Flop (didn't bet)
Seat 5: Johevera folded before Flop (didn't bet)
Seat 6: sQuezzeYoU!! folded before Flop (didn't bet)
Seat 7: jaimico00793 collected (4900)
Seat 8: gwallgofddyn (button) folded before Flop (didn't bet)

PokerStars Hand #251205775902: Tournament #3767885527, $40+$10+$5 USD Hold'em No Limit - Level XII (700/1400) - 2024/06/26 19:17:36 UTC [2024/06/26 15:17:36 ET]
Table '3767885527 35' 8-max Seat #1 is the button
Seat 1: hiran bass (15065 in chips) 
Seat 2: StoraEss (22725 in chips) 
Seat 3: atg590 (89308 in chips) 
Seat 4: PhoenixGrind (89032 in chips) 
Seat 5: Johevera (33868 in chips) 
Seat 6: sQuezzeYoU!! (53112 in chips) 
Seat 7: jaimico00793 (18436 in chips) 
Seat 8: gwallgofddyn (143013 in chips) 
hiran bass: posts the ante 175
StoraEss: posts the ante 175
atg590: posts the ante 175
PhoenixGrind: posts the ante 175
Johevera: posts the ante 175
sQuezzeYoU!!: posts the ante 175
jaimico00793: posts the ante 175
gwallgofddyn: posts the ante 175
StoraEss: posts small blind 700
atg590: posts big blind 1400
*** HOLE CARDS ***
PhoenixGrind: folds 
Johevera: folds 
sQuezzeYoU!!: folds 
jaimico00793: folds 
gwallgofddyn: raises 1820 to 3220
hiran bass: folds 
StoraEss: raises 19330 to 22550 and is all-in
atg590: folds 
gwallgofddyn: folds 
Uncalled bet (19330) returned to StoraEss
StoraEss collected 9240 from pot
StoraEss: doesn't show hand 
*** SUMMARY ***
Total pot 9240 | Rake 0 
Seat 1: hiran bass (button) folded before Flop (didn't bet)
Seat 2: StoraEss (small blind) collected (9240)
Seat 3: atg590 (big blind) folded before Flop
Seat 4: PhoenixGrind folded before Flop (didn't bet)
Seat 5: Johevera folded before Flop (didn't bet)
Seat 6: sQuezzeYoU!! folded before Flop (didn't bet)
Seat 7: jaimico00793 folded before Flop (didn't bet)
Seat 8: gwallgofddyn folded before Flop

PokerStars Hand #251205782081: Tournament #3767885527, $40+$10+$5 USD Hold'em No Limit - Level XII (700/1400) - 2024/06/26 19:17:59 UTC [2024/06/26 15:17:59 ET]
Table '3767885527 35' 8-max Seat #2 is the button
Seat 1: hiran bass (14890 in chips) 
Seat 2: StoraEss (28570 in chips) 
Seat 3: atg590 (87733 in chips) 
Seat 4: PhoenixGrind (88857 in chips) 
Seat 5: Johevera (33693 in chips) 
Seat 6: sQuezzeYoU!! (52937 in chips) 
Seat 7: jaimico00793 (18261 in chips) 
Seat 8: gwallgofddyn (139618 in chips) 
hiran bass: posts the ante 175
StoraEss: posts the ante 175
atg590: posts the ante 175
PhoenixGrind: posts the ante 175
Johevera: posts the ante 175
sQuezzeYoU!!: posts the ante 175
jaimico00793: posts the ante 175
gwallgofddyn: posts the ante 175
atg590: posts small blind 700
PhoenixGrind: posts big blind 1400
*** HOLE CARDS ***
Johevera: raises 1400 to 2800
sQuezzeYoU!!: folds 
jaimico00793: calls 2800
gwallgofddyn: folds 
hiran bass: folds 
StoraEss: folds 
atg590: folds 
PhoenixGrind: calls 1400
*** FLOP *** [6s Ac 5h]
PhoenixGrind: checks 
Johevera: checks 
jaimico00793: checks 
*** TURN *** [6s Ac 5h] [Kd]
PhoenixGrind: checks 
Johevera: bets 4900
jaimico00793: calls 4900
PhoenixGrind: folds 
*** RIVER *** [6s Ac 5h Kd] [7d]
Johevera: bets 25818 and is all-in
jaimico00793: calls 10386 and is all-in
Uncalled bet (15432) returned to Johevera
*** SHOW DOWN ***
Johevera: shows [As Kc] (two pair, Aces and Kings)
jaimico00793: shows [Ad Ah] (three of a kind, Aces)
jaimico00793 collected 41072 from pot
*** SUMMARY ***
Total pot 41072 | Rake 0 
Board [6s Ac 5h Kd 7d]
Seat 1: hiran bass folded before Flop (didn't bet)
Seat 2: StoraEss (button) folded before Flop (didn't bet)
Seat 3: atg590 (small blind) folded before Flop
Seat 4: PhoenixGrind (big blind) folded on the Turn
Seat 5: Johevera showed [As Kc] and lost with two pair, Aces and Kings
Seat 6: sQuezzeYoU!! folded before Flop (didn't bet)
Seat 7: jaimico00793 showed [Ad Ah] and won (41072) with three of a kind, Aces
Seat 8: gwallgofddyn folded before Flop (didn't bet)

PokerStars Hand #251205812123: Tournament #3767885527, $40+$10+$5 USD Hold'em No Limit - Level XIII (800/1600) - 2024/06/26 19:19:48 UTC [2024/06/26 15:19:48 ET]
Table '3767885527 35' 8-max Seat #3 is the button
Seat 1: hiran bass (14715 in chips) 
Seat 2: StoraEss (28395 in chips) 
Seat 3: atg590 (86858 in chips) 
Seat 4: PhoenixGrind (85882 in chips) 
Seat 5: Johevera (15432 in chips) 
Seat 6: sQuezzeYoU!! (52762 in chips) 
Seat 7: jaimico00793 (41072 in chips) 
Seat 8: gwallgofddyn (139443 in chips) 
hiran bass: posts the ante 200
StoraEss: posts the ante 200
atg590: posts the ante 200
PhoenixGrind: posts the ante 200
Johevera: posts the ante 200
sQuezzeYoU!!: posts the ante 200
jaimico00793: posts the ante 200
gwallgofddyn: posts the ante 200
PhoenixGrind: posts small blind 800
Johevera: posts big blind 1600
*** HOLE CARDS ***
sQuezzeYoU!!: raises 1875 to 3475
jaimico00793: folds 
gwallgofddyn: folds 
hiran bass: folds 
StoraEss: folds 
atg590: folds 
PhoenixGrind: folds 
Johevera: calls 1875
*** FLOP *** [Kh Ts 9d]
Johevera: checks 
sQuezzeYoU!!: bets 2805
Johevera: folds 
Uncalled bet (2805) returned to sQuezzeYoU!!
sQuezzeYoU!! collected 9350 from pot
sQuezzeYoU!!: doesn't show hand 
*** SUMMARY ***
Total pot 9350 | Rake 0 
Board [Kh Ts 9d]
Seat 1: hiran bass folded before Flop (didn't bet)
Seat 2: StoraEss folded before Flop (didn't bet)
Seat 3: atg590 (button) folded before Flop (didn't bet)
Seat 4: PhoenixGrind (small blind) folded before Flop
Seat 5: Johevera (big blind) folded on the Flop
Seat 6: sQuezzeYoU!! collected (9350)
Seat 7: jaimico00793 folded before Flop (didn't bet)
Seat 8: gwallgofddyn folded before Flop (didn't bet)

PokerStars Hand #251205822373: Tournament #3767885527, $40+$10+$5 USD Hold'em No Limit - Level XIII (800/1600) - 2024/06/26 19:20:26 UTC [2024/06/26 15:20:26 ET]
Table '3767885527 35' 8-max Seat #4 is the button
Seat 1: hiran bass (14515 in chips) 
Seat 2: StoraEss (28195 in chips) 
Seat 3: atg590 (86658 in chips) 
Seat 4: PhoenixGrind (84882 in chips) 
Seat 5: Johevera (11757 in chips) 
Seat 6: sQuezzeYoU!! (58437 in chips) 
Seat 7: jaimico00793 (40872 in chips) 
Seat 8: gwallgofddyn (139243 in chips) 
hiran bass: posts the ante 200
StoraEss: posts the ante 200
atg590: posts the ante 200
PhoenixGrind: posts the ante 200
Johevera: posts the ante 200
sQuezzeYoU!!: posts the ante 200
jaimico00793: posts the ante 200
gwallgofddyn: posts the ante 200
Johevera: posts small blind 800
sQuezzeYoU!!: posts big blind 1600
*** HOLE CARDS ***
jaimico00793: folds 
gwallgofddyn: raises 2080 to 3680
hiran bass: raises 10635 to 14315 and is all-in
StoraEss: folds 
atg590: folds 
PhoenixGrind: folds 
Johevera: folds 
sQuezzeYoU!!: folds 
gwallgofddyn: calls 10635
*** FLOP *** [Jc 9c 2c]
*** TURN *** [Jc 9c 2c] [4c]
*** RIVER *** [Jc 9c 2c 4c] [3c]
*** SHOW DOWN ***
gwallgofddyn: shows [Qh Js] (a flush, Jack high)
hiran bass: shows [Ts Tc] (a flush, Jack high - Ten higher)
hiran bass collected 32630 from pot
*** SUMMARY ***
Total pot 32630 | Rake 0 
Board [Jc 9c 2c 4c 3c]
Seat 1: hiran bass showed [Ts Tc] and won (32630) with a flush, Jack high
Seat 2: StoraEss folded before Flop (didn't bet)
Seat 3: atg590 folded before Flop (didn't bet)
Seat 4: PhoenixGrind (button) folded before Flop (didn't bet)
Seat 5: Johevera (small blind) folded before Flop
Seat 6: sQuezzeYoU!! (big blind) folded before Flop
Seat 7: jaimico00793 folded before Flop (didn't bet)
Seat 8: gwallgofddyn showed [Qh Js] and lost with a flush, Jack high

PokerStars Hand #251205830432: Tournament #3767885527, $40+$10+$5 USD Hold'em No Limit - Level XIII (800/1600) - 2024/06/26 19:20:56 UTC [2024/06/26 15:20:56 ET]
Table '3767885527 35' 8-max Seat #5 is the button
Seat 1: hiran bass (32630 in chips) 
Seat 2: StoraEss (27995 in chips) 
Seat 3: atg590 (86458 in chips) 
Seat 4: PhoenixGrind (84682 in chips) 
Seat 5: Johevera (10757 in chips) 
Seat 6: sQuezzeYoU!! (56637 in chips) 
Seat 7: jaimico00793 (40672 in chips) 
Seat 8: gwallgofddyn (124728 in chips) 
hiran bass: posts the ante 200
StoraEss: posts the ante 200
atg590: posts the ante 200
PhoenixGrind: posts the ante 200
Johevera: posts the ante 200
sQuezzeYoU!!: posts the ante 200
jaimico00793: posts the ante 200
gwallgofddyn: posts the ante 200
sQuezzeYoU!!: posts small blind 800
jaimico00793: posts big blind 1600
*** HOLE CARDS ***
gwallgofddyn: folds 
hiran bass: folds 
StoraEss: folds 
atg590: folds 
PhoenixGrind: folds 
Johevera: folds 
sQuezzeYoU!!: raises 3712 to 5312
jaimico00793: folds 
Uncalled bet (3712) returned to sQuezzeYoU!!
sQuezzeYoU!! collected 4800 from pot
sQuezzeYoU!!: doesn't show hand 
*** SUMMARY ***
Total pot 4800 | Rake 0 
Seat 1: hiran bass folded before Flop (didn't bet)
Seat 2: StoraEss folded before Flop (didn't bet)
Seat 3: atg590 folded before Flop (didn't bet)
Seat 4: PhoenixGrind folded before Flop (didn't bet)
Seat 5: Johevera (button) folded before Flop (didn't bet)
Seat 6: sQuezzeYoU!! (small blind) collected (4800)
Seat 7: jaimico00793 (big blind) folded before Flop
Seat 8: gwallgofddyn folded before Flop (didn't bet)

PokerStars Hand #251205839279: Tournament #3767885527, $40+$10+$5 USD Hold'em No Limit - Level XIII (800/1600) - 2024/06/26 19:21:29 UTC [2024/06/26 15:21:29 ET]
Table '3767885527 35' 8-max Seat #6 is the button
Seat 1: hiran bass (32430 in chips) 
Seat 2: StoraEss (27795 in chips) 
Seat 3: atg590 (86258 in chips) 
Seat 4: PhoenixGrind (84482 in chips) 
Seat 5: Johevera (10557 in chips) 
Seat 6: sQuezzeYoU!! (59637 in chips) 
Seat 7: jaimico00793 (38872 in chips) 
Seat 8: gwallgofddyn (124528 in chips) 
hiran bass: posts the ante 200
StoraEss: posts the ante 200
atg590: posts the ante 200
PhoenixGrind: posts the ante 200
Johevera: posts the ante 200
sQuezzeYoU!!: posts the ante 200
jaimico00793: posts the ante 200
gwallgofddyn: posts the ante 200
jaimico00793: posts small blind 800
gwallgofddyn: posts big blind 1600
*** HOLE CARDS ***
hiran bass: folds 
StoraEss: raises 1600 to 3200
atg590: folds 
PhoenixGrind: folds 
Johevera: raises 7157 to 10357 and is all-in
sQuezzeYoU!!: folds 
jaimico00793: folds 
gwallgofddyn: folds 
StoraEss: calls 7157
*** FLOP *** [Ts Ad 5d]
*** TURN *** [Ts Ad 5d] [2h]
*** RIVER *** [Ts Ad 5d 2h] [Jd]
*** SHOW DOWN ***
StoraEss: shows [Js Qs] (a pair of Jacks)
Johevera: shows [8d 9c] (high card Ace)
StoraEss collected 24714 from pot
Johevera finished the tournament
*** SUMMARY ***
Total pot 24714 | Rake 0 
Board [Ts Ad 5d 2h Jd]
Seat 1: hiran bass folded before Flop (didn't bet)
Seat 2: StoraEss showed [Js Qs] and won (24714) with a pair of Jacks
Seat 3: atg590 folded before Flop (didn't bet)
Seat 4: PhoenixGrind folded before Flop (didn't bet)
Seat 5: Johevera showed [8d 9c] and lost with high card Ace
Seat 6: sQuezzeYoU!! (button) folded before Flop (didn't bet)
Seat 7: jaimico00793 (small blind) folded before Flop
Seat 8: gwallgofddyn (big blind) folded before Flop

PokerStars Hand #251205851429: Tournament #3767885527, $40+$10+$5 USD Hold'em No Limit - Level XIII (800/1600) - 2024/06/26 19:22:13 UTC [2024/06/26 15:22:13 ET]
Table '3767885527 35' 8-max Seat #7 is the button
Seat 1: hiran bass (32230 in chips) 
Seat 2: StoraEss (41952 in chips) 
Seat 3: atg590 (86058 in chips) 
Seat 4: PhoenixGrind (84282 in chips) 
Seat 6: sQuezzeYoU!! (59437 in chips) 
Seat 7: jaimico00793 (37872 in chips) 
Seat 8: gwallgofddyn (122728 in chips) 
hiran bass: posts the ante 200
StoraEss: posts the ante 200
atg590: posts the ante 200
PhoenixGrind: posts the ante 200
sQuezzeYoU!!: posts the ante 200
jaimico00793: posts the ante 200
gwallgofddyn: posts the ante 200
gwallgofddyn: posts small blind 800
hiran bass: posts big blind 1600
*** HOLE CARDS ***
StoraEss: raises 1600 to 3200
atg590: folds 
PhoenixGrind: folds 
sQuezzeYoU!!: folds 
jaimico00793: folds 
gwallgofddyn: folds 
hiran bass: calls 1600
*** FLOP *** [7d 5h 9d]
hiran bass: checks 
StoraEss: bets 4800
hiran bass: folds 
Uncalled bet (4800) returned to StoraEss
StoraEss collected 8600 from pot
StoraEss: doesn't show hand 
*** SUMMARY ***
Total pot 8600 | Rake 0 
Board [7d 5h 9d]
Seat 1: hiran bass (big blind) folded on the Flop
Seat 2: StoraEss collected (8600)
Seat 3: atg590 folded before Flop (didn't bet)
Seat 4: PhoenixGrind folded before Flop (didn't bet)
Seat 6: sQuezzeYoU!! folded before Flop (didn't bet)
Seat 7: jaimico00793 (button) folded before Flop (didn't bet)
Seat 8: gwallgofddyn (small blind) folded before Flop

PokerStars Hand #251205865562: Tournament #3767885527, $40+$10+$5 USD Hold'em No Limit - Level XIII (800/1600) - 2024/06/26 19:23:04 UTC [2024/06/26 15:23:04 ET]
Table '3767885527 35' 8-max Seat #8 is the button
Seat 1: hiran bass (28830 in chips) 
Seat 2: StoraEss (47152 in chips) 
Seat 3: atg590 (85858 in chips) 
Seat 4: PhoenixGrind (84082 in chips) 
Seat 6: sQuezzeYoU!! (59237 in chips) 
Seat 7: jaimico00793 (37672 in chips) 
Seat 8: gwallgofddyn (121728 in chips) 
hiran bass: posts the ante 200
StoraEss: posts the ante 200
atg590: posts the ante 200
PhoenixGrind: posts the ante 200
sQuezzeYoU!!: posts the ante 200
jaimico00793: posts the ante 200
gwallgofddyn: posts the ante 200
hiran bass: posts small blind 800
StoraEss: posts big blind 1600
*** HOLE CARDS ***
atg590: folds 
PhoenixGrind: folds 
sQuezzeYoU!!: folds 
jaimico00793: raises 1920 to 3520
gwallgofddyn: folds 
hiran bass: folds 
StoraEss: calls 1920
*** FLOP *** [Ac 7c 5s]
StoraEss: checks 
jaimico00793: bets 2310
StoraEss: folds 
Uncalled bet (2310) returned to jaimico00793
jaimico00793 collected 9240 from pot
jaimico00793: doesn't show hand 
*** SUMMARY ***
Total pot 9240 | Rake 0 
Board [Ac 7c 5s]
Seat 1: hiran bass (small blind) folded before Flop
Seat 2: StoraEss (big blind) folded on the Flop
Seat 3: atg590 folded before Flop (didn't bet)
Seat 4: PhoenixGrind folded before Flop (didn't bet)
Seat 6: sQuezzeYoU!! folded before Flop (didn't bet)
Seat 7: jaimico00793 collected (9240)
Seat 8: gwallgofddyn (button) folded before Flop (didn't bet)

PokerStars Hand #251205874205: Tournament #3767885527, $40+$10+$5 USD Hold'em No Limit - Level XIII (800/1600) - 2024/06/26 19:23:36 UTC [2024/06/26 15:23:36 ET]
Table '3767885527 35' 8-max Seat #1 is the button
Seat 1: hiran bass (27830 in chips) 
Seat 2: StoraEss (43432 in chips) 
Seat 3: atg590 (85658 in chips) 
Seat 4: PhoenixGrind (83882 in chips) 
Seat 5: Khanuman Men (40468 in chips) 
Seat 6: sQuezzeYoU!! (59037 in chips) 
Seat 7: jaimico00793 (43192 in chips) 
Seat 8: gwallgofddyn (121528 in chips) 
hiran bass: posts the ante 200
StoraEss: posts the ante 200
atg590: posts the ante 200
PhoenixGrind: posts the ante 200
Khanuman Men: posts the ante 200
sQuezzeYoU!!: posts the ante 200
jaimico00793: posts the ante 200
gwallgofddyn: posts the ante 200
StoraEss: posts small blind 800
atg590: posts big blind 1600
*** HOLE CARDS ***
PhoenixGrind: folds 
Khanuman Men: folds 
sQuezzeYoU!!: folds 
jaimico00793: raises 1600 to 3200
gwallgofddyn: folds 
hiran bass: folds 
StoraEss: folds 
atg590: raises 4800 to 8000
jaimico00793: folds 
Uncalled bet (4800) returned to atg590
atg590 collected 8800 from pot
*** SUMMARY ***
Total pot 8800 | Rake 0 
Seat 1: hiran bass (button) folded before Flop (didn't bet)
Seat 2: StoraEss (small blind) folded before Flop
Seat 3: atg590 (big blind) collected (8800)
Seat 4: PhoenixGrind folded before Flop (didn't bet)
Seat 5: Khanuman Men folded before Flop (didn't bet)
Seat 6: sQuezzeYoU!! folded before Flop (didn't bet)
Seat 7: jaimico00793 folded before Flop
Seat 8: gwallgofddyn folded before Flop (didn't bet)

PokerStars Hand #251205882429: Tournament #3767885527, $40+$10+$5 USD Hold'em No Limit - Level XIII (800/1600) - 2024/06/26 19:24:06 UTC [2024/06/26 15:24:06 ET]
Table '3767885527 35' 8-max Seat #2 is the button
Seat 1: hiran bass (27630 in chips) 
Seat 2: StoraEss (42432 in chips) 
Seat 3: atg590 (91058 in chips) 
Seat 4: PhoenixGrind (83682 in chips) 
Seat 5: Khanuman Men (40268 in chips) 
Seat 6: sQuezzeYoU!! (58837 in chips) 
Seat 7: jaimico00793 (39792 in chips) 
Seat 8: gwallgofddyn (121328 in chips) 
hiran bass: posts the ante 200
StoraEss: posts the ante 200
atg590: posts the ante 200
PhoenixGrind: posts the ante 200
Khanuman Men: posts the ante 200
sQuezzeYoU!!: posts the ante 200
jaimico00793: posts the ante 200
gwallgofddyn: posts the ante 200
atg590: posts small blind 800
PhoenixGrind: posts big blind 1600
*** HOLE CARDS ***
Khanuman Men: folds 
sQuezzeYoU!!: folds 
jaimico00793: folds 
gwallgofddyn: raises 2080 to 3680
hiran bass: folds 
StoraEss: folds 
atg590: raises 5280 to 8960
PhoenixGrind: folds 
gwallgofddyn: folds 
Uncalled bet (5280) returned to atg590
atg590 collected 10560 from pot
*** SUMMARY ***
Total pot 10560 | Rake 0 
Seat 1: hiran bass folded before Flop (didn't bet)
Seat 2: StoraEss (button) folded before Flop (didn't bet)
Seat 3: atg590 (small blind) collected (10560)
Seat 4: PhoenixGrind (big blind) folded before Flop
Seat 5: Khanuman Men folded before Flop (didn't bet)
Seat 6: sQuezzeYoU!! folded before Flop (didn't bet)
Seat 7: jaimico00793 folded before Flop (didn't bet)
Seat 8: gwallgofddyn folded before Flop

PokerStars Hand #251205889792: Tournament #3767885527, $40+$10+$5 USD Hold'em No Limit - Level XIII (800/1600) - 2024/06/26 19:24:33 UTC [2024/06/26 15:24:33 ET]
Table '3767885527 35' 8-max Seat #3 is the button
Seat 1: hiran bass (27430 in chips) 
Seat 2: StoraEss (42232 in chips) 
Seat 3: atg590 (97738 in chips) 
Seat 4: PhoenixGrind (81882 in chips) 
Seat 5: Khanuman Men (40068 in chips) 
Seat 6: sQuezzeYoU!! (58637 in chips) 
Seat 7: jaimico00793 (39592 in chips) 
Seat 8: gwallgofddyn (117448 in chips) 
hiran bass: posts the ante 200
StoraEss: posts the ante 200
atg590: posts the ante 200
PhoenixGrind: posts the ante 200
Khanuman Men: posts the ante 200
sQuezzeYoU!!: posts the ante 200
jaimico00793: posts the ante 200
gwallgofddyn: posts the ante 200
PhoenixGrind: posts small blind 800
Khanuman Men: posts big blind 1600
*** HOLE CARDS ***
sQuezzeYoU!!: folds 
jaimico00793: folds 
gwallgofddyn: folds 
hiran bass: folds 
StoraEss: folds 
atg590: folds 
PhoenixGrind: calls 800
Khanuman Men: raises 4800 to 6400
PhoenixGrind: calls 4800
*** FLOP *** [3s Ad Ah]
PhoenixGrind: checks 
Khanuman Men: checks 
*** TURN *** [3s Ad Ah] [8c]
PhoenixGrind: checks 
Khanuman Men: bets 4800
PhoenixGrind: calls 4800
*** RIVER *** [3s Ad Ah 8c] [5s]
PhoenixGrind: checks 
Khanuman Men: checks 
*** SHOW DOWN ***
PhoenixGrind: shows [3c Tc] (two pair, Aces and Threes)
Khanuman Men: mucks hand 
PhoenixGrind collected 24000 from pot
*** SUMMARY ***
Total pot 24000 | Rake 0 
Board [3s Ad Ah 8c 5s]
Seat 1: hiran bass folded before Flop (didn't bet)
Seat 2: StoraEss folded before Flop (didn't bet)
Seat 3: atg590 (button) folded before Flop (didn't bet)
Seat 4: PhoenixGrind (small blind) showed [3c Tc] and won (24000) with two pair, Aces and Threes
Seat 5: Khanuman Men (big blind) mucked
Seat 6: sQuezzeYoU!! folded before Flop (didn't bet)
Seat 7: jaimico00793 folded before Flop (didn't bet)
Seat 8: gwallgofddyn folded before Flop (didn't bet)

PokerStars Hand #251205909564: Tournament #3767885527, $40+$10+$5 USD Hold'em No Limit - Level XIII (800/1600) - 2024/06/26 19:25:44 UTC [2024/06/26 15:25:44 ET]
Table '3767885527 35' 8-max Seat #4 is the button
Seat 1: hiran bass (27230 in chips) 
Seat 2: StoraEss (42032 in chips) 
Seat 3: atg590 (97538 in chips) 
Seat 4: PhoenixGrind (94482 in chips) 
Seat 5: Khanuman Men (28668 in chips) 
Seat 6: sQuezzeYoU!! (58437 in chips) 
Seat 7: jaimico00793 (39392 in chips) 
Seat 8: gwallgofddyn (117248 in chips) 
hiran bass: posts the ante 200
StoraEss: posts the ante 200
atg590: posts the ante 200
PhoenixGrind: posts the ante 200
Khanuman Men: posts the ante 200
sQuezzeYoU!!: posts the ante 200
jaimico00793: posts the ante 200
gwallgofddyn: posts the ante 200
Khanuman Men: posts small blind 800
sQuezzeYoU!!: posts big blind 1600
*** HOLE CARDS ***
jaimico00793: folds 
gwallgofddyn: raises 2080 to 3680
hiran bass: raises 23350 to 27030 and is all-in
StoraEss: folds 
atg590: folds 
PhoenixGrind: folds 
Khanuman Men: folds 
sQuezzeYoU!!: folds 
gwallgofddyn: folds 
Uncalled bet (23350) returned to hiran bass
hiran bass collected 11360 from pot
hiran bass: doesn't show hand 
*** SUMMARY ***
Total pot 11360 | Rake 0 
Seat 1: hiran bass collected (11360)
Seat 2: StoraEss folded before Flop (didn't bet)
Seat 3: atg590 folded before Flop (didn't bet)
Seat 4: PhoenixGrind (button) folded before Flop (didn't bet)
Seat 5: Khanuman Men (small blind) folded before Flop
Seat 6: sQuezzeYoU!! (big blind) folded before Flop
Seat 7: jaimico00793 folded before Flop (didn't bet)
Seat 8: gwallgofddyn folded before Flop

PokerStars Hand #251205920011: Tournament #3767885527, $40+$10+$5 USD Hold'em No Limit - Level XIII (800/1600) - 2024/06/26 19:26:22 UTC [2024/06/26 15:26:22 ET]
Table '3767885527 35' 8-max Seat #5 is the button
Seat 1: hiran bass (34710 in chips) 
Seat 2: StoraEss (41832 in chips) 
Seat 3: atg590 (97338 in chips) 
Seat 4: PhoenixGrind (94282 in chips) 
Seat 5: Khanuman Men (27668 in chips) 
Seat 6: sQuezzeYoU!! (56637 in chips) 
Seat 7: jaimico00793 (39192 in chips) 
Seat 8: gwallgofddyn (113368 in chips) 
hiran bass: posts the ante 200
StoraEss: posts the ante 200
atg590: posts the ante 200
PhoenixGrind: posts the ante 200
Khanuman Men: posts the ante 200
sQuezzeYoU!!: posts the ante 200
jaimico00793: posts the ante 200
gwallgofddyn: posts the ante 200
sQuezzeYoU!!: posts small blind 800
jaimico00793: posts big blind 1600
*** HOLE CARDS ***
gwallgofddyn: folds 
hiran bass: folds 
StoraEss: folds 
atg590: folds 
PhoenixGrind: folds 
Khanuman Men: raises 1600 to 3200
sQuezzeYoU!!: folds 
jaimico00793: calls 1600
*** FLOP *** [Jc Js Ac]
jaimico00793: checks 
Khanuman Men: bets 3200
jaimico00793: folds 
Uncalled bet (3200) returned to Khanuman Men
Khanuman Men collected 8800 from pot
*** SUMMARY ***
Total pot 8800 | Rake 0 
Board [Jc Js Ac]
Seat 1: hiran bass folded before Flop (didn't bet)
Seat 2: StoraEss folded before Flop (didn't bet)
Seat 3: atg590 folded before Flop (didn't bet)
Seat 4: PhoenixGrind folded before Flop (didn't bet)
Seat 5: Khanuman Men (button) collected (8800)
Seat 6: sQuezzeYoU!! (small blind) folded before Flop
Seat 7: jaimico00793 (big blind) folded on the Flop
Seat 8: gwallgofddyn folded before Flop (didn't bet)

PokerStars Hand #251205930914: Tournament #3767885527, $40+$10+$5 USD Hold'em No Limit - Level XIII (800/1600) - 2024/06/26 19:27:02 UTC [2024/06/26 15:27:02 ET]
Table '3767885527 35' 8-max Seat #6 is the button
Seat 1: hiran bass (34510 in chips) 
Seat 2: StoraEss (41632 in chips) 
Seat 3: atg590 (97138 in chips) 
Seat 4: PhoenixGrind (94082 in chips) 
Seat 5: Khanuman Men (33068 in chips) 
Seat 6: sQuezzeYoU!! (55637 in chips) 
Seat 7: jaimico00793 (35792 in chips) 
Seat 8: gwallgofddyn (113168 in chips) 
hiran bass: posts the ante 200
StoraEss: posts the ante 200
atg590: posts the ante 200
PhoenixGrind: posts the ante 200
Khanuman Men: posts the ante 200
sQuezzeYoU!!: posts the ante 200
jaimico00793: posts the ante 200
gwallgofddyn: posts the ante 200
jaimico00793: posts small blind 800
gwallgofddyn: posts big blind 1600
*** HOLE CARDS ***
hiran bass: folds 
StoraEss: raises 1600 to 3200
atg590: folds 
PhoenixGrind: folds 
Khanuman Men: folds 
sQuezzeYoU!!: folds 
jaimico00793: folds 
gwallgofddyn: folds 
Uncalled bet (1600) returned to StoraEss
StoraEss collected 5600 from pot
StoraEss: doesn't show hand 
*** SUMMARY ***
Total pot 5600 | Rake 0 
Seat 1: hiran bass folded before Flop (didn't bet)
Seat 2: StoraEss collected (5600)
Seat 3: atg590 folded before Flop (didn't bet)
Seat 4: PhoenixGrind folded before Flop (didn't bet)
Seat 5: Khanuman Men folded before Flop (didn't bet)
Seat 6: sQuezzeYoU!! (button) folded before Flop (didn't bet)
Seat 7: jaimico00793 (small blind) folded before Flop
Seat 8: gwallgofddyn (big blind) folded before Flop

PokerStars Hand #251205943397: Tournament #3767885527, $40+$10+$5 USD Hold'em No Limit - Level XIII (800/1600) - 2024/06/26 19:27:49 UTC [2024/06/26 15:27:49 ET]
Table '3767885527 35' 8-max Seat #7 is the button
Seat 1: hiran bass (34310 in chips) 
Seat 2: StoraEss (45432 in chips) 
Seat 3: atg590 (96938 in chips) 
Seat 4: PhoenixGrind (93882 in chips) 
Seat 5: Khanuman Men (32868 in chips) 
Seat 6: sQuezzeYoU!! (55437 in chips) 
Seat 7: jaimico00793 (34792 in chips) 
Seat 8: gwallgofddyn (111368 in chips) 
hiran bass: posts the ante 200
StoraEss: posts the ante 200
atg590: posts the ante 200
PhoenixGrind: posts the ante 200
Khanuman Men: posts the ante 200
sQuezzeYoU!!: posts the ante 200
jaimico00793: posts the ante 200
gwallgofddyn: posts the ante 200
gwallgofddyn: posts small blind 800
hiran bass: posts big blind 1600
*** HOLE CARDS ***
StoraEss: folds 
atg590: folds 
PhoenixGrind: folds 
Khanuman Men: folds 
sQuezzeYoU!!: folds 
jaimico00793: raises 1600 to 3200
gwallgofddyn: folds 
hiran bass: calls 1600
*** FLOP *** [8s 7c Jd]
hiran bass: checks 
jaimico00793: bets 2200
hiran bass: calls 2200
*** TURN *** [8s 7c Jd] [5d]
hiran bass: checks 
jaimico00793: bets 6960
hiran bass: calls 6960
*** RIVER *** [8s 7c Jd 5d] [As]
hiran bass: checks 
jaimico00793: checks 
*** SHOW DOWN ***
hiran bass: shows [6d 8c] (a pair of Eights)
jaimico00793: shows [7d Ad] (two pair, Aces and Sevens)
jaimico00793 collected 27120 from pot
*** SUMMARY ***
Total pot 27120 | Rake 0 
Board [8s 7c Jd 5d As]
Seat 1: hiran bass (big blind) showed [6d 8c] and lost with a pair of Eights
Seat 2: StoraEss folded before Flop (didn't bet)
Seat 3: atg590 folded before Flop (didn't bet)
Seat 4: PhoenixGrind folded before Flop (didn't bet)
Seat 5: Khanuman Men folded before Flop (didn't bet)
Seat 6: sQuezzeYoU!! folded before Flop (didn't bet)
Seat 7: jaimico00793 (button) showed [7d Ad] and won (27120) with two pair, Aces and Sevens
Seat 8: gwallgofddyn (small blind) folded before Flop

PokerStars Hand #251205967644: Tournament #3767885527, $40+$10+$5 USD Hold'em No Limit - Level XIV (1000/2000) - 2024/06/26 19:29:20 UTC [2024/06/26 15:29:20 ET]
Table '3767885527 35' 8-max Seat #8 is the button
Seat 1: hiran bass (21750 in chips) 
Seat 2: StoraEss (45232 in chips) 
Seat 3: atg590 (96738 in chips) 
Seat 4: PhoenixGrind (93682 in chips) 
Seat 5: Khanuman Men (32668 in chips) 
Seat 6: sQuezzeYoU!! (55237 in chips) 
Seat 7: jaimico00793 (49352 in chips) 
Seat 8: gwallgofddyn (110368 in chips) 
hiran bass: posts the ante 250
StoraEss: posts the ante 250
atg590: posts the ante 250
PhoenixGrind: posts the ante 250
Khanuman Men: posts the ante 250
sQuezzeYoU!!: posts the ante 250
jaimico00793: posts the ante 250
gwallgofddyn: posts the ante 250
hiran bass: posts small blind 1000
StoraEss: posts big blind 2000
*** HOLE CARDS ***
atg590: folds 
PhoenixGrind: folds 
Khanuman Men: raises 30418 to 32418 and is all-in
sQuezzeYoU!!: folds 
jaimico00793: folds 
gwallgofddyn: folds 
hiran bass: folds 
StoraEss: folds 
Uncalled bet (30418) returned to Khanuman Men
Khanuman Men collected 7000 from pot
*** SUMMARY ***
Total pot 7000 | Rake 0 
Seat 1: hiran bass (small blind) folded before Flop
Seat 2: StoraEss (big blind) folded before Flop
Seat 3: atg590 folded before Flop (didn't bet)
Seat 4: PhoenixGrind folded before Flop (didn't bet)
Seat 5: Khanuman Men collected (7000)
Seat 6: sQuezzeYoU!! folded before Flop (didn't bet)
Seat 7: jaimico00793 folded before Flop (didn't bet)
Seat 8: gwallgofddyn (button) folded before Flop (didn't bet)

PokerStars Hand #251205972493: Tournament #3767885527, $40+$10+$5 USD Hold'em No Limit - Level XIV (1000/2000) - 2024/06/26 19:29:37 UTC [2024/06/26 15:29:37 ET]
Table '3767885527 35' 8-max Seat #1 is the button
Seat 1: hiran bass (20500 in chips) 
Seat 2: StoraEss (42982 in chips) 
Seat 3: atg590 (96488 in chips) 
Seat 4: PhoenixGrind (93432 in chips) 
Seat 5: Khanuman Men (37418 in chips) 
Seat 6: sQuezzeYoU!! (54987 in chips) 
Seat 7: jaimico00793 (49102 in chips) 
Seat 8: gwallgofddyn (110118 in chips) 
hiran bass: posts the ante 250
StoraEss: posts the ante 250
atg590: posts the ante 250
PhoenixGrind: posts the ante 250
Khanuman Men: posts the ante 250
sQuezzeYoU!!: posts the ante 250
jaimico00793: posts the ante 250
gwallgofddyn: posts the ante 250
StoraEss: posts small blind 1000
atg590: posts big blind 2000
*** HOLE CARDS ***
PhoenixGrind: raises 3000 to 5000
Khanuman Men: folds 
sQuezzeYoU!!: raises 8000 to 13000
jaimico00793: folds 
gwallgofddyn: folds 
hiran bass: folds 
StoraEss: folds 
atg590: folds 
PhoenixGrind: raises 80182 to 93182 and is all-in
sQuezzeYoU!!: calls 41737 and is all-in
Uncalled bet (38445) returned to PhoenixGrind
*** FLOP *** [2s 5h Js]
*** TURN *** [2s 5h Js] [Qc]
*** RIVER *** [2s 5h Js Qc] [8c]
*** SHOW DOWN ***
PhoenixGrind: shows [Kd Kh] (a pair of Kings)
sQuezzeYoU!!: shows [Ac As] (a pair of Aces)
sQuezzeYoU!! collected 114474 from pot
*** SUMMARY ***
Total pot 114474 | Rake 0 
Board [2s 5h Js Qc 8c]
Seat 1: hiran bass (button) folded before Flop (didn't bet)
Seat 2: StoraEss (small blind) folded before Flop
Seat 3: atg590 (big blind) folded before Flop
Seat 4: PhoenixGrind showed [Kd Kh] and lost with a pair of Kings
Seat 5: Khanuman Men folded before Flop (didn't bet)
Seat 6: sQuezzeYoU!! showed [Ac As] and won (114474) with a pair of Aces
Seat 7: jaimico00793 folded before Flop (didn't bet)
Seat 8: gwallgofddyn folded before Flop (didn't bet)

PokerStars Hand #251205985418: Tournament #3767885527, $40+$10+$5 USD Hold'em No Limit - Level XIV (1000/2000) - 2024/06/26 19:30:24 UTC [2024/06/26 15:30:24 ET]
Table '3767885527 35' 8-max Seat #2 is the button
Seat 1: hiran bass (20250 in chips) 
Seat 2: StoraEss (41732 in chips) 
Seat 3: atg590 (94238 in chips) 
Seat 4: PhoenixGrind (38445 in chips) 
Seat 5: Khanuman Men (37168 in chips) 
Seat 6: sQuezzeYoU!! (114474 in chips) 
Seat 7: jaimico00793 (48852 in chips) 
Seat 8: gwallgofddyn (109868 in chips) 
hiran bass: posts the ante 250
StoraEss: posts the ante 250
atg590: posts the ante 250
PhoenixGrind: posts the ante 250
Khanuman Men: posts the ante 250
sQuezzeYoU!!: posts the ante 250
jaimico00793: posts the ante 250
gwallgofddyn: posts the ante 250
atg590: posts small blind 1000
PhoenixGrind: posts big blind 2000
*** HOLE CARDS ***
Khanuman Men: folds 
sQuezzeYoU!!: folds 
jaimico00793: folds 
gwallgofddyn: raises 2200 to 4200
hiran bass: folds 
StoraEss: calls 4200
atg590: calls 3200
PhoenixGrind: folds 
*** FLOP *** [6s 5h 2d]
atg590: checks 
gwallgofddyn: checks 
StoraEss: checks 
*** TURN *** [6s 5h 2d] [9s]
atg590: checks 
gwallgofddyn: bets 6640
StoraEss: calls 6640
atg590: folds 
*** RIVER *** [6s 5h 2d 9s] [8d]
gwallgofddyn: checks 
StoraEss: checks 
*** SHOW DOWN ***
gwallgofddyn: shows [9c Kc] (a pair of Nines)
StoraEss: mucks hand 
gwallgofddyn collected 29880 from pot
*** SUMMARY ***
Total pot 29880 | Rake 0 
Board [6s 5h 2d 9s 8d]
Seat 1: hiran bass folded before Flop (didn't bet)
Seat 2: StoraEss (button) mucked
Seat 3: atg590 (small blind) folded on the Turn
Seat 4: PhoenixGrind (big blind) folded before Flop
Seat 5: Khanuman Men folded before Flop (didn't bet)
Seat 6: sQuezzeYoU!! folded before Flop (didn't bet)
Seat 7: jaimico00793 folded before Flop (didn't bet)
Seat 8: gwallgofddyn showed [9c Kc] and won (29880) with a pair of Nines

PokerStars Hand #251206002315: Tournament #3767885527, $40+$10+$5 USD Hold'em No Limit - Level XIV (1000/2000) - 2024/06/26 19:31:26 UTC [2024/06/26 15:31:26 ET]
Table '3767885527 35' 8-max Seat #3 is the button
Seat 1: hiran bass (20000 in chips) 
Seat 2: StoraEss (30642 in chips) 
Seat 3: atg590 (89788 in chips) 
Seat 4: PhoenixGrind (36195 in chips) 
Seat 5: Khanuman Men (36918 in chips) 
Seat 6: sQuezzeYoU!! (114224 in chips) 
Seat 7: jaimico00793 (48602 in chips) 
Seat 8: gwallgofddyn (128658 in chips) 
hiran bass: posts the ante 250
StoraEss: posts the ante 250
atg590: posts the ante 250
PhoenixGrind: posts the ante 250
Khanuman Men: posts the ante 250
sQuezzeYoU!!: posts the ante 250
jaimico00793: posts the ante 250
gwallgofddyn: posts the ante 250
PhoenixGrind: posts small blind 1000
Khanuman Men: posts big blind 2000
*** HOLE CARDS ***
sQuezzeYoU!!: folds 
jaimico00793: folds 
gwallgofddyn: folds 
hiran bass: folds 
StoraEss: folds 
atg590: folds 
PhoenixGrind: raises 3000 to 5000
Khanuman Men: raises 31668 to 36668 and is all-in
PhoenixGrind: calls 30945 and is all-in
Uncalled bet (723) returned to Khanuman Men
*** FLOP *** [Ks Ac 3c]
*** TURN *** [Ks Ac 3c] [3s]
*** RIVER *** [Ks Ac 3c 3s] [8s]
*** SHOW DOWN ***
PhoenixGrind: shows [Tc Ts] (two pair, Tens and Threes)
Khanuman Men: shows [Jh Js] (two pair, Jacks and Threes)
Khanuman Men collected 73890 from pot
PhoenixGrind finished the tournament
*** SUMMARY ***
Total pot 73890 | Rake 0 
Board [Ks Ac 3c 3s 8s]
Seat 1: hiran bass folded before Flop (didn't bet)
Seat 2: StoraEss folded before Flop (didn't bet)
Seat 3: atg590 (button) folded before Flop (didn't bet)
Seat 4: PhoenixGrind (small blind) showed [Tc Ts] and lost with two pair, Tens and Threes
Seat 5: Khanuman Men (big blind) showed [Jh Js] and won (73890) with two pair, Jacks and Threes
Seat 6: sQuezzeYoU!! folded before Flop (didn't bet)
Seat 7: jaimico00793 folded before Flop (didn't bet)
Seat 8: gwallgofddyn folded before Flop (didn't bet)

PokerStars Hand #251206010011: Tournament #3767885527, $40+$10+$5 USD Hold'em No Limit - Level XIV (1000/2000) - 2024/06/26 19:31:54 UTC [2024/06/26 15:31:54 ET]
Table '3767885527 35' 8-max Seat #5 is the button
Seat 1: hiran bass (19750 in chips) 
Seat 2: StoraEss (30392 in chips) 
Seat 3: atg590 (89538 in chips) 
Seat 5: Khanuman Men (74613 in chips) 
Seat 6: sQuezzeYoU!! (113974 in chips) 
Seat 7: jaimico00793 (48352 in chips) 
Seat 8: gwallgofddyn (128408 in chips) 
hiran bass: posts the ante 250
StoraEss: posts the ante 250
atg590: posts the ante 250
Khanuman Men: posts the ante 250
sQuezzeYoU!!: posts the ante 250
jaimico00793: posts the ante 250
gwallgofddyn: posts the ante 250
sQuezzeYoU!!: posts small blind 1000
jaimico00793: posts big blind 2000
*** HOLE CARDS ***
gwallgofddyn: folds 
hiran bass: folds 
StoraEss: folds 
atg590: folds 
Khanuman Men: folds 
sQuezzeYoU!!: calls 1000
jaimico00793: checks 
*** FLOP *** [Kh 4s Js]
sQuezzeYoU!!: bets 2121
Dih21 is disconnected 
jaimico00793: folds 
Uncalled bet (2121) returned to sQuezzeYoU!!
sQuezzeYoU!! collected 5750 from pot
sQuezzeYoU!!: doesn't show hand 
*** SUMMARY ***
Total pot 5750 | Rake 0 
Board [Kh 4s Js]
Seat 1: hiran bass folded before Flop (didn't bet)
Seat 2: StoraEss folded before Flop (didn't bet)
Seat 3: atg590 folded before Flop (didn't bet)
Seat 5: Khanuman Men (button) folded before Flop (didn't bet)
Seat 6: sQuezzeYoU!! (small blind) collected (5750)
Seat 7: jaimico00793 (big blind) folded on the Flop
Seat 8: gwallgofddyn folded before Flop (didn't bet)

PokerStars Hand #251206020088: Tournament #3767885527, $40+$10+$5 USD Hold'em No Limit - Level XIV (1000/2000) - 2024/06/26 19:32:30 UTC [2024/06/26 15:32:30 ET]
Table '3767885527 35' 8-max Seat #6 is the button
Seat 1: hiran bass (19500 in chips) 
Seat 2: StoraEss (30142 in chips) 
Seat 3: atg590 (89288 in chips) 
Seat 4: Dih21 (25000 in chips) 
Seat 5: Khanuman Men (74363 in chips) 
Seat 6: sQuezzeYoU!! (117474 in chips) 
Seat 7: jaimico00793 (46102 in chips) 
Seat 8: gwallgofddyn (128158 in chips) 
hiran bass: posts the ante 250
StoraEss: posts the ante 250
atg590: posts the ante 250
Dih21: posts the ante 250
Khanuman Men: posts the ante 250
sQuezzeYoU!!: posts the ante 250
jaimico00793: posts the ante 250
gwallgofddyn: posts the ante 250
jaimico00793: posts small blind 1000
gwallgofddyn: posts big blind 2000
*** HOLE CARDS ***
hiran bass: raises 17250 to 19250 and is all-in
StoraEss: folds 
atg590: folds 
Dih21: folds 
Khanuman Men: folds 
sQuezzeYoU!!: folds 
jaimico00793: folds 
gwallgofddyn: folds 
Uncalled bet (17250) returned to hiran bass
hiran bass collected 7000 from pot
hiran bass: doesn't show hand 
*** SUMMARY ***
Total pot 7000 | Rake 0 
Seat 1: hiran bass collected (7000)
Seat 2: StoraEss folded before Flop (didn't bet)
Seat 3: atg590 folded before Flop (didn't bet)
Seat 4: Dih21 folded before Flop (didn't bet)
Seat 5: Khanuman Men folded before Flop (didn't bet)
Seat 6: sQuezzeYoU!! (button) folded before Flop (didn't bet)
Seat 7: jaimico00793 (small blind) folded before Flop
Seat 8: gwallgofddyn (big blind) folded before Flop

PokerStars Hand #251206027954: Tournament #3767885527, $40+$10+$5 USD Hold'em No Limit - Level XIV (1000/2000) - 2024/06/26 19:32:59 UTC [2024/06/26 15:32:59 ET]
Table '3767885527 35' 8-max Seat #7 is the button
Seat 1: hiran bass (24250 in chips) 
Seat 2: StoraEss (29892 in chips) 
Seat 3: atg590 (89038 in chips) 
Seat 4: Dih21 (24750 in chips) 
Seat 5: Khanuman Men (74113 in chips) 
Seat 6: sQuezzeYoU!! (117224 in chips) 
Seat 7: jaimico00793 (44852 in chips) 
Seat 8: gwallgofddyn (125908 in chips) 
hiran bass: posts the ante 250
StoraEss: posts the ante 250
atg590: posts the ante 250
Dih21: posts the ante 250
Khanuman Men: posts the ante 250
sQuezzeYoU!!: posts the ante 250
jaimico00793: posts the ante 250
gwallgofddyn: posts the ante 250
gwallgofddyn: posts small blind 1000
hiran bass: posts big blind 2000
*** HOLE CARDS ***
StoraEss: folds 
atg590: folds 
Dih21: raises 22500 to 24500 and is all-in
Khanuman Men: folds 
sQuezzeYoU!!: folds 
jaimico00793: folds 
gwallgofddyn: folds 
hiran bass: folds 
Uncalled bet (22500) returned to Dih21
Dih21 collected 7000 from pot
Dih21: doesn't show hand 
*** SUMMARY ***
Total pot 7000 | Rake 0 
Seat 1: hiran bass (big blind) folded before Flop
Seat 2: StoraEss folded before Flop (didn't bet)
Seat 3: atg590 folded before Flop (didn't bet)
Seat 4: Dih21 collected (7000)
Seat 5: Khanuman Men folded before Flop (didn't bet)
Seat 6: sQuezzeYoU!! folded before Flop (didn't bet)
Seat 7: jaimico00793 (button) folded before Flop (didn't bet)
Seat 8: gwallgofddyn (small blind) folded before Flop

PokerStars Hand #251206034295: Tournament #3767885527, $40+$10+$5 USD Hold'em No Limit - Level XIV (1000/2000) - 2024/06/26 19:33:22 UTC [2024/06/26 15:33:22 ET]
Table '3767885527 35' 8-max Seat #8 is the button
Seat 1: hiran bass (22000 in chips) 
Seat 2: StoraEss (29642 in chips) 
Seat 3: atg590 (88788 in chips) 
Seat 4: Dih21 (29500 in chips) 
Seat 5: Khanuman Men (73863 in chips) 
Seat 6: sQuezzeYoU!! (116974 in chips) 
Seat 7: jaimico00793 (44602 in chips) 
Seat 8: gwallgofddyn (124658 in chips) 
hiran bass: posts the ante 250
StoraEss: posts the ante 250
atg590: posts the ante 250
Dih21: posts the ante 250
Khanuman Men: posts the ante 250
sQuezzeYoU!!: posts the ante 250
jaimico00793: posts the ante 250
gwallgofddyn: posts the ante 250
hiran bass: posts small blind 1000
StoraEss: posts big blind 2000
*** HOLE CARDS ***
atg590: folds 
Dih21: folds 
Khanuman Men: raises 2000 to 4000
sQuezzeYoU!!: folds 
jaimico00793: folds 
gwallgofddyn: calls 4000
hiran bass: folds 
StoraEss: raises 25392 to 29392 and is all-in
Khanuman Men: calls 25392
gwallgofddyn: calls 25392
*** FLOP *** [Ad 2h Kd]
Khanuman Men: checks 
gwallgofddyn: checks 
*** TURN *** [Ad 2h Kd] [2c]
Khanuman Men: bets 12000
gwallgofddyn: folds 
Uncalled bet (12000) returned to Khanuman Men
*** RIVER *** [Ad 2h Kd 2c] [8c]
*** SHOW DOWN ***
StoraEss: shows [7h Td] (a pair of Deuces)
Khanuman Men: shows [As Ac] (a full house, Aces full of Deuces)
Khanuman Men collected 91176 from pot
StoraEss finished the tournament
*** SUMMARY ***
Total pot 91176 | Rake 0 
Board [Ad 2h Kd 2c 8c]
Seat 1: hiran bass (small blind) folded before Flop
Seat 2: StoraEss (big blind) showed [7h Td] and lost with a pair of Deuces
Seat 3: atg590 folded before Flop (didn't bet)
Seat 4: Dih21 folded before Flop (didn't bet)
Seat 5: Khanuman Men showed [As Ac] and won (91176) with a full house, Aces full of Deuces
Seat 6: sQuezzeYoU!! folded before Flop (didn't bet)
Seat 7: jaimico00793 folded before Flop (didn't bet)
Seat 8: gwallgofddyn (button) folded on the Turn

PokerStars Hand #251206053476: Tournament #3767885527, $40+$10+$5 USD Hold'em No Limit - Level XIV (1000/2000) - 2024/06/26 19:34:32 UTC [2024/06/26 15:34:32 ET]
Table '3767885527 35' 8-max Seat #1 is the button
Seat 1: hiran bass (20750 in chips) 
Seat 3: atg590 (88538 in chips) 
Seat 4: Dih21 (29250 in chips) 
Seat 5: Khanuman Men (135397 in chips) 
Seat 6: sQuezzeYoU!! (116724 in chips) 
Seat 7: jaimico00793 (44352 in chips) 
Seat 8: gwallgofddyn (95016 in chips) 
hiran bass: posts the ante 250
atg590: posts the ante 250
Dih21: posts the ante 250
Khanuman Men: posts the ante 250
sQuezzeYoU!!: posts the ante 250
jaimico00793: posts the ante 250
gwallgofddyn: posts the ante 250
atg590: posts small blind 1000
Dih21: posts big blind 2000
*** HOLE CARDS ***
Khanuman Men: folds 
sQuezzeYoU!!: folds 
jaimico00793: folds 
gwallgofddyn: folds 
hiran bass: raises 18500 to 20500 and is all-in
atg590: folds 
Dih21: folds 
Uncalled bet (18500) returned to hiran bass
hiran bass collected 6750 from pot
hiran bass: doesn't show hand 
*** SUMMARY ***
Total pot 6750 | Rake 0 
Seat 1: hiran bass (button) collected (6750)
Seat 3: atg590 (small blind) folded before Flop
Seat 4: Dih21 (big blind) folded before Flop
Seat 5: Khanuman Men folded before Flop (didn't bet)
Seat 6: sQuezzeYoU!! folded before Flop (didn't bet)
Seat 7: jaimico00793 folded before Flop (didn't bet)
Seat 8: gwallgofddyn folded before Flop (didn't bet)

PokerStars Hand #251206059007: Tournament #3767885527, $40+$10+$5 USD Hold'em No Limit - Level XIV (1000/2000) - 2024/06/26 19:34:52 UTC [2024/06/26 15:34:52 ET]
Table '3767885527 35' 8-max Seat #3 is the button
Seat 1: hiran bass (25250 in chips) 
Seat 3: atg590 (87288 in chips) 
Seat 4: Dih21 (27000 in chips) 
Seat 5: Khanuman Men (135147 in chips) 
Seat 6: sQuezzeYoU!! (116474 in chips) 
Seat 7: jaimico00793 (44102 in chips) 
Seat 8: gwallgofddyn (94766 in chips) 
hiran bass: posts the ante 250
atg590: posts the ante 250
Dih21: posts the ante 250
Khanuman Men: posts the ante 250
sQuezzeYoU!!: posts the ante 250
jaimico00793: posts the ante 250
gwallgofddyn: posts the ante 250
Dih21: posts small blind 1000
Khanuman Men: posts big blind 2000
*** HOLE CARDS ***
sQuezzeYoU!!: folds 
jaimico00793: raises 2000 to 4000
gwallgofddyn: folds 
hiran bass: folds 
atg590: folds 
Dih21: raises 22750 to 26750 and is all-in
Khanuman Men: folds 
jaimico00793: calls 22750
*** FLOP *** [5c 8d 9s]
*** TURN *** [5c 8d 9s] [Jd]
*** RIVER *** [5c 8d 9s Jd] [6h]
EugeneShev is disconnected 
*** SHOW DOWN ***
Dih21: shows [As Qh] (high card Ace)
jaimico00793: shows [Qs Qc] (a pair of Queens)
jaimico00793 collected 57250 from pot
Dih21 finished the tournament
*** SUMMARY ***
Total pot 57250 | Rake 0 
Board [5c 8d 9s Jd 6h]
Seat 1: hiran bass folded before Flop (didn't bet)
Seat 3: atg590 (button) folded before Flop (didn't bet)
Seat 4: Dih21 (small blind) showed [As Qh] and lost with high card Ace
Seat 5: Khanuman Men (big blind) folded before Flop
Seat 6: sQuezzeYoU!! folded before Flop (didn't bet)
Seat 7: jaimico00793 showed [Qs Qc] and won (57250) with a pair of Queens
Seat 8: gwallgofddyn folded before Flop (didn't bet)

PokerStars Hand #251206066186: Tournament #3767885527, $40+$10+$5 USD Hold'em No Limit - Level XIV (1000/2000) - 2024/06/26 19:35:19 UTC [2024/06/26 15:35:19 ET]
Table '3767885527 35' 8-max Seat #5 is the button
Seat 1: hiran bass (25000 in chips) 
Seat 2: EugeneShev (25000 in chips) 
Seat 3: atg590 (87038 in chips) 
Seat 5: Khanuman Men (132897 in chips) 
Seat 6: sQuezzeYoU!! (116224 in chips) 
Seat 7: jaimico00793 (74352 in chips) 
Seat 8: gwallgofddyn (94516 in chips) 
hiran bass: posts the ante 250
EugeneShev: posts the ante 250
atg590: posts the ante 250
Khanuman Men: posts the ante 250
sQuezzeYoU!!: posts the ante 250
jaimico00793: posts the ante 250
gwallgofddyn: posts the ante 250
sQuezzeYoU!!: posts small blind 1000
jaimico00793: posts big blind 2000
*** HOLE CARDS ***
gwallgofddyn: folds 
hiran bass: folds 
XARANDROS is disconnected 
EugeneShev: raises 22750 to 24750 and is all-in
atg590: folds 
Khanuman Men: folds 
sQuezzeYoU!!: folds 
jaimico00793: calls 22750
*** FLOP *** [Td Js 6d]
*** TURN *** [Td Js 6d] [2h]
*** RIVER *** [Td Js 6d 2h] [8c]
*** SHOW DOWN ***
jaimico00793: shows [Ks Ac] (high card Ace)
EugeneShev: shows [Kc Qc] (high card King)
jaimico00793 collected 52250 from pot
EugeneShev finished the tournament
*** SUMMARY ***
Total pot 52250 | Rake 0 
Board [Td Js 6d 2h 8c]
Seat 1: hiran bass folded before Flop (didn't bet)
Seat 2: EugeneShev showed [Kc Qc] and lost with high card King
Seat 3: atg590 folded before Flop (didn't bet)
Seat 5: Khanuman Men (button) folded before Flop (didn't bet)
Seat 6: sQuezzeYoU!! (small blind) folded before Flop
Seat 7: jaimico00793 (big blind) showed [Ks Ac] and won (52250) with high card Ace
Seat 8: gwallgofddyn folded before Flop (didn't bet)

PokerStars Hand #251206087350: Tournament #3767885527, $40+$10+$5 USD Hold'em No Limit - Level XIV (1000/2000) - 2024/06/26 19:36:36 UTC [2024/06/26 15:36:36 ET]
Table '3767885527 35' 8-max Seat #6 is the button
Seat 1: hiran bass (24750 in chips) 
Seat 3: atg590 (86788 in chips) 
Seat 4: XARANDROS (21750 in chips) 
Seat 5: Khanuman Men (132647 in chips) 
Seat 6: sQuezzeYoU!! (114974 in chips) 
Seat 7: jaimico00793 (101602 in chips) 
Seat 8: gwallgofddyn (94266 in chips) 
hiran bass: posts the ante 250
atg590: posts the ante 250
XARANDROS: posts the ante 250
Khanuman Men: posts the ante 250
sQuezzeYoU!!: posts the ante 250
jaimico00793: posts the ante 250
gwallgofddyn: posts the ante 250
jaimico00793: posts small blind 1000
gwallgofddyn: posts big blind 2000
*** HOLE CARDS ***
hiran bass: folds 
atg590: raises 4000 to 6000
XARANDROS: folds 
sprase1999 is disconnected 
Khanuman Men: folds 
sQuezzeYoU!!: folds 
jaimico00793: folds 
gwallgofddyn: folds 
Uncalled bet (4000) returned to atg590
atg590 collected 6750 from pot
*** SUMMARY ***
Total pot 6750 | Rake 0 
Seat 1: hiran bass folded before Flop (didn't bet)
Seat 3: atg590 collected (6750)
Seat 4: XARANDROS folded before Flop (didn't bet)
Seat 5: Khanuman Men folded before Flop (didn't bet)
Seat 6: sQuezzeYoU!! (button) folded before Flop (didn't bet)
Seat 7: jaimico00793 (small blind) folded before Flop
Seat 8: gwallgofddyn (big blind) folded before Flop

PokerStars Hand #251206096179: Tournament #3767885527, $40+$10+$5 USD Hold'em No Limit - Level XIV (1000/2000) - 2024/06/26 19:37:08 UTC [2024/06/26 15:37:08 ET]
Table '3767885527 35' 8-max Seat #7 is the button
Seat 1: hiran bass (24500 in chips) 
Seat 2: sprase1999 (44428 in chips) 
Seat 3: atg590 (91288 in chips) 
Seat 4: XARANDROS (21500 in chips) 
Seat 5: Khanuman Men (132397 in chips) 
Seat 6: sQuezzeYoU!! (114724 in chips) 
Seat 7: jaimico00793 (100352 in chips) 
Seat 8: gwallgofddyn (92016 in chips) 
hiran bass: posts the ante 250
sprase1999: posts the ante 250
atg590: posts the ante 250
XARANDROS: posts the ante 250
Khanuman Men: posts the ante 250
sQuezzeYoU!!: posts the ante 250
jaimico00793: posts the ante 250
gwallgofddyn: posts the ante 250
gwallgofddyn: posts small blind 1000
hiran bass: posts big blind 2000
*** HOLE CARDS ***
sprase1999: folds 
atg590: raises 4000 to 6000
XARANDROS: folds 
Khanuman Men: folds 
sQuezzeYoU!!: folds 
jaimico00793: folds 
gwallgofddyn: folds 
hiran bass: folds 
Uncalled bet (4000) returned to atg590
atg590 collected 7000 from pot
*** SUMMARY ***
Total pot 7000 | Rake 0 
Seat 1: hiran bass (big blind) folded before Flop
Seat 2: sprase1999 folded before Flop (didn't bet)
Seat 3: atg590 collected (7000)
Seat 4: XARANDROS folded before Flop (didn't bet)
Seat 5: Khanuman Men folded before Flop (didn't bet)
Seat 6: sQuezzeYoU!! folded before Flop (didn't bet)
Seat 7: jaimico00793 (button) folded before Flop (didn't bet)
Seat 8: gwallgofddyn (small blind) folded before Flop

PokerStars Hand #251206102087: Tournament #3767885527, $40+$10+$5 USD Hold'em No Limit - Level XIV (1000/2000) - 2024/06/26 19:37:29 UTC [2024/06/26 15:37:29 ET]
Table '3767885527 35' 8-max Seat #8 is the button
Seat 1: hiran bass (22250 in chips) 
Seat 2: sprase1999 (44178 in chips) 
Seat 3: atg590 (96038 in chips) 
Seat 4: XARANDROS (21250 in chips) 
Seat 5: Khanuman Men (132147 in chips) 
Seat 6: sQuezzeYoU!! (114474 in chips) 
Seat 7: jaimico00793 (100102 in chips) 
Seat 8: gwallgofddyn (90766 in chips) 
hiran bass: posts the ante 250
sprase1999: posts the ante 250
atg590: posts the ante 250
XARANDROS: posts the ante 250
Khanuman Men: posts the ante 250
sQuezzeYoU!!: posts the ante 250
jaimico00793: posts the ante 250
gwallgofddyn: posts the ante 250
hiran bass: posts small blind 1000
sprase1999: posts big blind 2000
*** HOLE CARDS ***
atg590: folds 
XARANDROS: folds 
Khanuman Men: folds 
sQuezzeYoU!!: folds 
jaimico00793: folds 
gwallgofddyn: folds 
hiran bass: calls 1000
sprase1999: checks 
*** FLOP *** [Qs Qd Jh]
hiran bass: checks 
sprase1999: checks 
*** TURN *** [Qs Qd Jh] [Ts]
hiran bass: bets 2000
sprase1999: calls 2000
*** RIVER *** [Qs Qd Jh Ts] [3d]
hiran bass: bets 8000
sprase1999: folds 
Uncalled bet (8000) returned to hiran bass
hiran bass collected 10000 from pot
hiran bass: doesn't show hand 
*** SUMMARY ***
Total pot 10000 | Rake 0 
Board [Qs Qd Jh Ts 3d]
Seat 1: hiran bass (small blind) collected (10000)
Seat 2: sprase1999 (big blind) folded on the River
Seat 3: atg590 folded before Flop (didn't bet)
Seat 4: XARANDROS folded before Flop (didn't bet)
Seat 5: Khanuman Men folded before Flop (didn't bet)
Seat 6: sQuezzeYoU!! folded before Flop (didn't bet)
Seat 7: jaimico00793 folded before Flop (didn't bet)
Seat 8: gwallgofddyn (button) folded before Flop (didn't bet)

PokerStars Hand #251206116655: Tournament #3767885527, $40+$10+$5 USD Hold'em No Limit - Level XIV (1000/2000) - 2024/06/26 19:38:24 UTC [2024/06/26 15:38:24 ET]
Table '3767885527 35' 8-max Seat #1 is the button
Seat 1: hiran bass (28000 in chips) 
Seat 2: sprase1999 (39928 in chips) 
Seat 3: atg590 (95788 in chips) 
Seat 4: XARANDROS (21000 in chips) 
Seat 5: Khanuman Men (131897 in chips) 
Seat 6: sQuezzeYoU!! (114224 in chips) 
Seat 7: jaimico00793 (99852 in chips) 
Seat 8: gwallgofddyn (90516 in chips) 
hiran bass: posts the ante 250
sprase1999: posts the ante 250
atg590: posts the ante 250
XARANDROS: posts the ante 250
Khanuman Men: posts the ante 250
sQuezzeYoU!!: posts the ante 250
jaimico00793: posts the ante 250
gwallgofddyn: posts the ante 250
sprase1999: posts small blind 1000
atg590: posts big blind 2000
*** HOLE CARDS ***
XARANDROS: folds 
Khanuman Men: folds 
sQuezzeYoU!!: raises 2260 to 4260
jaimico00793: folds 
gwallgofddyn: folds 
hiran bass: folds 
sprase1999: folds 
atg590: calls 2260
*** FLOP *** [3c 5h Kh]
atg590: checks 
sQuezzeYoU!!: bets 3608
atg590: calls 3608
*** TURN *** [3c 5h Kh] [7h]
atg590: checks 
sQuezzeYoU!!: bets 15054
atg590: folds 
Uncalled bet (15054) returned to sQuezzeYoU!!
sQuezzeYoU!! collected 18736 from pot
sQuezzeYoU!!: doesn't show hand 
*** SUMMARY ***
Total pot 18736 | Rake 0 
Board [3c 5h Kh 7h]
Seat 1: hiran bass (button) folded before Flop (didn't bet)
Seat 2: sprase1999 (small blind) folded before Flop
Seat 3: atg590 (big blind) folded on the Turn
Seat 4: XARANDROS folded before Flop (didn't bet)
Seat 5: Khanuman Men folded before Flop (didn't bet)
Seat 6: sQuezzeYoU!! collected (18736)
Seat 7: jaimico00793 folded before Flop (didn't bet)
Seat 8: gwallgofddyn folded before Flop (didn't bet)

PokerStars Hand #251206137234: Tournament #3767885527, $40+$10+$5 USD Hold'em No Limit - Level XV (1250/2500) - 2024/06/26 19:39:39 UTC [2024/06/26 15:39:39 ET]
Table '3767885527 35' 8-max Seat #2 is the button
Seat 1: hiran bass (27750 in chips) 
Seat 2: sprase1999 (38678 in chips) 
Seat 3: atg590 (87670 in chips) 
Seat 4: XARANDROS (20750 in chips) 
Seat 5: Khanuman Men (131647 in chips) 
Seat 6: sQuezzeYoU!! (124842 in chips) 
Seat 7: jaimico00793 (99602 in chips) 
Seat 8: gwallgofddyn (90266 in chips) 
hiran bass: posts the ante 325
sprase1999: posts the ante 325
atg590: posts the ante 325
XARANDROS: posts the ante 325
Khanuman Men: posts the ante 325
sQuezzeYoU!!: posts the ante 325
jaimico00793: posts the ante 325
gwallgofddyn: posts the ante 325
atg590: posts small blind 1250
XARANDROS: posts big blind 2500
*** HOLE CARDS ***
Khanuman Men: folds 
sQuezzeYoU!!: folds 
jaimico00793: folds 
gwallgofddyn: folds 
hiran bass: folds 
sprase1999: raises 2500 to 5000
atg590: calls 3750
XARANDROS: calls 2500
*** FLOP *** [3s 2s As]
atg590: checks 
XARANDROS: checks 
sprase1999: checks 
*** TURN *** [3s 2s As] [2h]
atg590: bets 11300
XARANDROS: folds 
sprase1999: folds 
Uncalled bet (11300) returned to atg590
atg590 collected 17600 from pot
*** SUMMARY ***
Total pot 17600 | Rake 0 
Board [3s 2s As 2h]
Seat 1: hiran bass folded before Flop (didn't bet)
Seat 2: sprase1999 (button) folded on the Turn
Seat 3: atg590 (small blind) collected (17600)
Seat 4: XARANDROS (big blind) folded on the Turn
Seat 5: Khanuman Men folded before Flop (didn't bet)
Seat 6: sQuezzeYoU!! folded before Flop (didn't bet)
Seat 7: jaimico00793 folded before Flop (didn't bet)
Seat 8: gwallgofddyn folded before Flop (didn't bet)

PokerStars Hand #251206155113: Tournament #3767885527, $40+$10+$5 USD Hold'em No Limit - Level XV (1250/2500) - 2024/06/26 19:40:44 UTC [2024/06/26 15:40:44 ET]
Table '3767885527 35' 8-max Seat #3 is the button
Seat 1: hiran bass (27425 in chips) 
Seat 2: sprase1999 (33353 in chips) 
Seat 3: atg590 (99945 in chips) 
Seat 4: XARANDROS (15425 in chips) 
Seat 5: Khanuman Men (131322 in chips) 
Seat 6: sQuezzeYoU!! (124517 in chips) 
Seat 7: jaimico00793 (99277 in chips) 
Seat 8: gwallgofddyn (89941 in chips) 
hiran bass: posts the ante 325
sprase1999: posts the ante 325
atg590: posts the ante 325
XARANDROS: posts the ante 325
Khanuman Men: posts the ante 325
sQuezzeYoU!!: posts the ante 325
jaimico00793: posts the ante 325
gwallgofddyn: posts the ante 325
XARANDROS: posts small blind 1250
Khanuman Men: posts big blind 2500
*** HOLE CARDS ***
sQuezzeYoU!!: folds 
jaimico00793: folds 
gwallgofddyn: folds 
hiran bass: raises 24600 to 27100 and is all-in
sprase1999: raises 5928 to 33028 and is all-in
atg590: folds 
XARANDROS: calls 13850 and is all-in
Khanuman Men: folds 
Uncalled bet (5928) returned to sprase1999
*** FLOP *** [2d Ad 5s]
*** TURN *** [2d Ad 5s] [7h]
*** RIVER *** [2d Ad 5s 7h] [6h]
*** SHOW DOWN ***
hiran bass: shows [2s 2c] (three of a kind, Deuces)
sprase1999: shows [Js Qs] (high card Ace)
hiran bass collected 24000 from side pot
XARANDROS: shows [Kc As] (a pair of Aces)
hiran bass collected 50400 from main pot
XARANDROS finished the tournament in 585th place
*** SUMMARY ***
Total pot 74400 Main pot 50400. Side pot 24000. | Rake 0 
Board [2d Ad 5s 7h 6h]
Seat 1: hiran bass showed [2s 2c] and won (74400) with three of a kind, Deuces
Seat 2: sprase1999 showed [Js Qs] and lost with high card Ace
Seat 3: atg590 (button) folded before Flop (didn't bet)
Seat 4: XARANDROS (small blind) showed [Kc As] and lost with a pair of Aces
Seat 5: Khanuman Men (big blind) folded before Flop
Seat 6: sQuezzeYoU!! folded before Flop (didn't bet)
Seat 7: jaimico00793 folded before Flop (didn't bet)
Seat 8: gwallgofddyn folded before Flop (didn't bet)


PokerStars Hand #251206619955: Tournament #3767885527, $40+$10+$5 USD Hold'em No Limit - Level XVII (1750/3500) - 2024/06/26 20:09:49 UTC [2024/06/26 16:09:49 ET]
Table '3767885527 34' 8-max Seat #5 is the button
Seat 1: Bigprad (46872 in chips) 
Seat 2: martincho186 (79240 in chips) 
Seat 3: kuenne71 (152521 in chips) 
Seat 4: Equinox616 (176866 in chips) 
Seat 5: gladiatore99 (81128 in chips) 
Seat 6: SolidYerna (203657 in chips) 
Seat 7: Dominosu (145930 in chips) 
Seat 8: mazzy4629 (17725 in chips) 
Bigprad: posts the ante 450
martincho186: posts the ante 450
kuenne71: posts the ante 450
Equinox616: posts the ante 450
gladiatore99: posts the ante 450
SolidYerna: posts the ante 450
Dominosu: posts the ante 450
mazzy4629: posts the ante 450
SolidYerna: posts small blind 1750
Dominosu: posts big blind 3500
*** HOLE CARDS ***
mazzy4629: folds 
Bigprad: folds 
martincho186: folds 
kuenne71: folds 
Equinox616: folds 
gladiatore99: raises 3500 to 7000
SolidYerna: raises 196207 to 203207 and is all-in
Dominosu: folds 
gladiatore99: folds 
Uncalled bet (196207) returned to SolidYerna
SolidYerna collected 21100 from pot
SolidYerna: doesn't show hand 
*** SUMMARY ***
Total pot 21100 | Rake 0 
Seat 1: Bigprad folded before Flop (didn't bet)
Seat 2: martincho186 folded before Flop (didn't bet)
Seat 3: kuenne71 folded before Flop (didn't bet)
Seat 4: Equinox616 folded before Flop (didn't bet)
Seat 5: gladiatore99 (button) folded before Flop
Seat 6: SolidYerna (small blind) collected (21100)
Seat 7: Dominosu (big blind) folded before Flop
Seat 8: mazzy4629 folded before Flop (didn't bet)

PokerStars Hand #251206630683: Tournament #3767885527, $40+$10+$5 USD Hold'em No Limit - Level XVII (1750/3500) - 2024/06/26 20:10:26 UTC [2024/06/26 16:10:26 ET]
Table '3767885527 34' 8-max Seat #6 is the button
Seat 1: Bigprad (46422 in chips) 
Seat 2: martincho186 (78790 in chips) 
Seat 3: kuenne71 (152071 in chips) 
Seat 4: Equinox616 (176416 in chips) 
Seat 5: gladiatore99 (73678 in chips) 
Seat 6: SolidYerna (217307 in chips) 
Seat 7: Dominosu (141980 in chips) 
Seat 8: mazzy4629 (17275 in chips) 
Bigprad: posts the ante 450
martincho186: posts the ante 450
kuenne71: posts the ante 450
Equinox616: posts the ante 450
gladiatore99: posts the ante 450
SolidYerna: posts the ante 450
Dominosu: posts the ante 450
mazzy4629: posts the ante 450
Dominosu: posts small blind 1750
mazzy4629: posts big blind 3500
*** HOLE CARDS ***
Bigprad: folds 
martincho186: folds 
kuenne71: folds 
Equinox616: folds 
gladiatore99: folds 
SolidYerna: folds 
Dominosu: folds 
Uncalled bet (1750) returned to mazzy4629
mazzy4629 collected 7100 from pot
*** SUMMARY ***
Total pot 7100 | Rake 0 
Seat 1: Bigprad folded before Flop (didn't bet)
Seat 2: martincho186 folded before Flop (didn't bet)
Seat 3: kuenne71 folded before Flop (didn't bet)
Seat 4: Equinox616 folded before Flop (didn't bet)
Seat 5: gladiatore99 folded before Flop (didn't bet)
Seat 6: SolidYerna (button) folded before Flop (didn't bet)
Seat 7: Dominosu (small blind) folded before Flop
Seat 8: mazzy4629 (big blind) collected (7100)

PokerStars Hand #251206636906: Tournament #3767885527, $40+$10+$5 USD Hold'em No Limit - Level XVII (1750/3500) - 2024/06/26 20:10:48 UTC [2024/06/26 16:10:48 ET]
Table '3767885527 34' 8-max Seat #7 is the button
Seat 1: Bigprad (45972 in chips) 
Seat 2: martincho186 (78340 in chips) 
Seat 3: kuenne71 (151621 in chips) 
Seat 4: Equinox616 (175966 in chips) 
Seat 5: gladiatore99 (73228 in chips) 
Seat 6: SolidYerna (216857 in chips) 
Seat 7: Dominosu (139780 in chips) 
Seat 8: mazzy4629 (22175 in chips) 
Bigprad: posts the ante 450
martincho186: posts the ante 450
kuenne71: posts the ante 450
Equinox616: posts the ante 450
gladiatore99: posts the ante 450
SolidYerna: posts the ante 450
Dominosu: posts the ante 450
mazzy4629: posts the ante 450
mazzy4629: posts small blind 1750
Bigprad: posts big blind 3500
*** HOLE CARDS ***
martincho186: folds 
kuenne71: raises 3500 to 7000
Equinox616: folds 
gladiatore99: folds 
SolidYerna: folds 
Dominosu: folds 
mazzy4629: folds 
Bigprad: calls 3500
*** FLOP *** [2c Js 2h]
Bigprad: checks 
kuenne71: bets 9675
Bigprad: calls 9675
*** TURN *** [2c Js 2h] [5d]
Bigprad: checks 
kuenne71: bets 38700
Bigprad: folds 
Uncalled bet (38700) returned to kuenne71
kuenne71 collected 38700 from pot
kuenne71: doesn't show hand 
*** SUMMARY ***
Total pot 38700 | Rake 0 
Board [2c Js 2h 5d]
Seat 1: Bigprad (big blind) folded on the Turn
Seat 2: martincho186 folded before Flop (didn't bet)
Seat 3: kuenne71 collected (38700)
Seat 4: Equinox616 folded before Flop (didn't bet)
Seat 5: gladiatore99 folded before Flop (didn't bet)
Seat 6: SolidYerna folded before Flop (didn't bet)
Seat 7: Dominosu (button) folded before Flop (didn't bet)
Seat 8: mazzy4629 (small blind) folded before Flop

PokerStars Hand #251206644673: Tournament #3767885527, $40+$10+$5 USD Hold'em No Limit - Level XVII (1750/3500) - 2024/06/26 20:11:15 UTC [2024/06/26 16:11:15 ET]
Table '3767885527 34' 8-max Seat #8 is the button
Seat 1: Bigprad (28847 in chips) 
Seat 2: martincho186 (77890 in chips) 
Seat 3: kuenne71 (173196 in chips) 
Seat 4: Equinox616 (175516 in chips) 
Seat 5: gladiatore99 (72778 in chips) 
Seat 6: SolidYerna (216407 in chips) 
Seat 7: Dominosu (139330 in chips) 
Seat 8: mazzy4629 (19975 in chips) 
Bigprad: posts the ante 450
martincho186: posts the ante 450
kuenne71: posts the ante 450
Equinox616: posts the ante 450
gladiatore99: posts the ante 450
SolidYerna: posts the ante 450
Dominosu: posts the ante 450
mazzy4629: posts the ante 450
Bigprad: posts small blind 1750
martincho186: posts big blind 3500
*** HOLE CARDS ***
kuenne71: folds 
Equinox616: folds 
gladiatore99: folds 
SolidYerna: folds 
Dominosu: raises 3500 to 7000
mazzy4629: folds 
Bigprad: folds 
martincho186: calls 3500
*** FLOP *** [7s 8h 5s]
martincho186: checks 
Dominosu: checks 
*** TURN *** [7s 8h 5s] [4s]
martincho186: checks 
Dominosu: checks 
*** RIVER *** [7s 8h 5s 4s] [Ah]
martincho186: checks 
Dominosu: checks 
*** SHOW DOWN ***
martincho186: shows [Kd 9d] (high card Ace)
Dominosu: shows [7h Kh] (a pair of Sevens)
Dominosu collected 19350 from pot
*** SUMMARY ***
Total pot 19350 | Rake 0 
Board [7s 8h 5s 4s Ah]
Seat 1: Bigprad (small blind) folded before Flop
Seat 2: martincho186 (big blind) showed [Kd 9d] and lost with high card Ace
Seat 3: kuenne71 folded before Flop (didn't bet)
Seat 4: Equinox616 folded before Flop (didn't bet)
Seat 5: gladiatore99 folded before Flop (didn't bet)
Seat 6: SolidYerna folded before Flop (didn't bet)
Seat 7: Dominosu showed [7h Kh] and won (19350) with a pair of Sevens
Seat 8: mazzy4629 (button) folded before Flop (didn't bet)

PokerStars Hand #251206658680: Tournament #3767885527, $40+$10+$5 USD Hold'em No Limit - Level XVII (1750/3500) - 2024/06/26 20:12:05 UTC [2024/06/26 16:12:05 ET]
Table '3767885527 34' 8-max Seat #1 is the button
Seat 1: Bigprad (26647 in chips) 
Seat 2: martincho186 (70440 in chips) 
Seat 3: kuenne71 (172746 in chips) 
Seat 4: Equinox616 (175066 in chips) 
Seat 5: gladiatore99 (72328 in chips) 
Seat 6: SolidYerna (215957 in chips) 
Seat 7: Dominosu (151230 in chips) 
Seat 8: mazzy4629 (19525 in chips) 
Bigprad: posts the ante 450
martincho186: posts the ante 450
kuenne71: posts the ante 450
Equinox616: posts the ante 450
gladiatore99: posts the ante 450
SolidYerna: posts the ante 450
Dominosu: posts the ante 450
mazzy4629: posts the ante 450
martincho186: posts small blind 1750
kuenne71: posts big blind 3500
*** HOLE CARDS ***
Equinox616: folds 
gladiatore99: folds 
SolidYerna: raises 3850 to 7350
Dominosu: folds 
mazzy4629: folds 
Bigprad: raises 18847 to 26197 and is all-in
martincho186: folds 
kuenne71: folds 
SolidYerna: calls 18847
*** FLOP *** [4c 3s 6h]
*** TURN *** [4c 3s 6h] [7s]
*** RIVER *** [4c 3s 6h 7s] [8c]
*** SHOW DOWN ***
SolidYerna: shows [Ac Tc] (high card Ace)
Bigprad: shows [2c 2d] (a pair of Deuces)
Bigprad collected 61244 from pot
*** SUMMARY ***
Total pot 61244 | Rake 0 
Board [4c 3s 6h 7s 8c]
Seat 1: Bigprad (button) showed [2c 2d] and won (61244) with a pair of Deuces
Seat 2: martincho186 (small blind) folded before Flop
Seat 3: kuenne71 (big blind) folded before Flop
Seat 4: Equinox616 folded before Flop (didn't bet)
Seat 5: gladiatore99 folded before Flop (didn't bet)
Seat 6: SolidYerna showed [Ac Tc] and lost with high card Ace
Seat 7: Dominosu folded before Flop (didn't bet)
Seat 8: mazzy4629 folded before Flop (didn't bet)

PokerStars Hand #251206671507: Tournament #3767885527, $40+$10+$5 USD Hold'em No Limit - Level XVII (1750/3500) - 2024/06/26 20:12:50 UTC [2024/06/26 16:12:50 ET]
Table '3767885527 34' 8-max Seat #2 is the button
Seat 1: Bigprad (61244 in chips) 
Seat 2: martincho186 (68240 in chips) 
Seat 3: kuenne71 (168796 in chips) 
Seat 4: Equinox616 (174616 in chips) 
Seat 5: gladiatore99 (71878 in chips) 
Seat 6: SolidYerna (189310 in chips) 
Seat 7: Dominosu (150780 in chips) 
Seat 8: mazzy4629 (19075 in chips) 
Bigprad: posts the ante 450
martincho186: posts the ante 450
kuenne71: posts the ante 450
Equinox616: posts the ante 450
gladiatore99: posts the ante 450
SolidYerna: posts the ante 450
Dominosu: posts the ante 450
mazzy4629: posts the ante 450
kuenne71: posts small blind 1750
Equinox616: posts big blind 3500
*** HOLE CARDS ***
gladiatore99: raises 3500 to 7000
SolidYerna: folds 
Dominosu: folds 
mazzy4629: folds 
Bigprad: folds 
martincho186: folds 
kuenne71: folds 
Equinox616: calls 3500
*** FLOP *** [4s Jh Ts]
Equinox616: checks 
gladiatore99: checks 
*** TURN *** [4s Jh Ts] [4h]
Equinox616: bets 7000
gladiatore99: calls 7000
*** RIVER *** [4s Jh Ts 4h] [8c]
Equinox616: bets 17500
gladiatore99: folds 
Uncalled bet (17500) returned to Equinox616
Equinox616 collected 33350 from pot
Equinox616: doesn't show hand 
*** SUMMARY ***
Total pot 33350 | Rake 0 
Board [4s Jh Ts 4h 8c]
Seat 1: Bigprad folded before Flop (didn't bet)
Seat 2: martincho186 (button) folded before Flop (didn't bet)
Seat 3: kuenne71 (small blind) folded before Flop
Seat 4: Equinox616 (big blind) collected (33350)
Seat 5: gladiatore99 folded on the River
Seat 6: SolidYerna folded before Flop (didn't bet)
Seat 7: Dominosu folded before Flop (didn't bet)
Seat 8: mazzy4629 folded before Flop (didn't bet)

PokerStars Hand #251206692239: Tournament #3767885527, $40+$10+$5 USD Hold'em No Limit - Level XVII (1750/3500) - 2024/06/26 20:14:05 UTC [2024/06/26 16:14:05 ET]
Table '3767885527 34' 8-max Seat #3 is the button
Seat 1: Bigprad (60794 in chips) 
Seat 2: martincho186 (67790 in chips) 
Seat 3: kuenne71 (166596 in chips) 
Seat 4: Equinox616 (193516 in chips) 
Seat 5: gladiatore99 (57428 in chips) 
Seat 6: SolidYerna (188860 in chips) 
Seat 7: Dominosu (150330 in chips) 
Seat 8: mazzy4629 (18625 in chips) 
Bigprad: posts the ante 450
martincho186: posts the ante 450
kuenne71: posts the ante 450
Equinox616: posts the ante 450
gladiatore99: posts the ante 450
SolidYerna: posts the ante 450
Dominosu: posts the ante 450
mazzy4629: posts the ante 450
Equinox616: posts small blind 1750
gladiatore99: posts big blind 3500
*** HOLE CARDS ***
SolidYerna: folds 
Dominosu: raises 4200 to 7700
mazzy4629: folds 
Bigprad: folds 
martincho186: folds 
kuenne71: folds 
Equinox616: folds 
gladiatore99: folds 
Uncalled bet (4200) returned to Dominosu
Dominosu collected 12350 from pot
Dominosu: doesn't show hand 
*** SUMMARY ***
Total pot 12350 | Rake 0 
Seat 1: Bigprad folded before Flop (didn't bet)
Seat 2: martincho186 folded before Flop (didn't bet)
Seat 3: kuenne71 (button) folded before Flop (didn't bet)
Seat 4: Equinox616 (small blind) folded before Flop
Seat 5: gladiatore99 (big blind) folded before Flop
Seat 6: SolidYerna folded before Flop (didn't bet)
Seat 7: Dominosu collected (12350)
Seat 8: mazzy4629 folded before Flop (didn't bet)

PokerStars Hand #251206697297: Tournament #3767885527, $40+$10+$5 USD Hold'em No Limit - Level XVII (1750/3500) - 2024/06/26 20:14:23 UTC [2024/06/26 16:14:23 ET]
Table '3767885527 34' 8-max Seat #4 is the button
Seat 1: Bigprad (60344 in chips) 
Seat 2: martincho186 (67340 in chips) 
Seat 3: kuenne71 (166146 in chips) 
Seat 4: Equinox616 (191316 in chips) 
Seat 5: gladiatore99 (53478 in chips) 
Seat 6: SolidYerna (188410 in chips) 
Seat 7: Dominosu (158730 in chips) 
Seat 8: mazzy4629 (18175 in chips) 
Bigprad: posts the ante 450
martincho186: posts the ante 450
kuenne71: posts the ante 450
Equinox616: posts the ante 450
gladiatore99: posts the ante 450
SolidYerna: posts the ante 450
Dominosu: posts the ante 450
mazzy4629: posts the ante 450
gladiatore99: posts small blind 1750
SolidYerna: posts big blind 3500
*** HOLE CARDS ***
Dominosu: folds 
mazzy4629: folds 
Bigprad: folds 
martincho186: folds 
kuenne71: raises 3500 to 7000
Equinox616: calls 7000
gladiatore99: folds 
SolidYerna: folds 
*** FLOP *** [9s 2h 6d]
kuenne71: checks 
Equinox616: checks 
*** TURN *** [9s 2h 6d] [5s]
kuenne71: checks 
Equinox616: bets 11425
kuenne71: calls 11425
*** RIVER *** [9s 2h 6d 5s] [Kc]
kuenne71: checks 
Equinox616: checks 
*** SHOW DOWN ***
kuenne71: shows [Ac 7s] (high card Ace)
Equinox616: shows [9c Jh] (a pair of Nines)
Equinox616 collected 45700 from pot
*** SUMMARY ***
Total pot 45700 | Rake 0 
Board [9s 2h 6d 5s Kc]
Seat 1: Bigprad folded before Flop (didn't bet)
Seat 2: martincho186 folded before Flop (didn't bet)
Seat 3: kuenne71 showed [Ac 7s] and lost with high card Ace
Seat 4: Equinox616 (button) showed [9c Jh] and won (45700) with a pair of Nines
Seat 5: gladiatore99 (small blind) folded before Flop
Seat 6: SolidYerna (big blind) folded before Flop
Seat 7: Dominosu folded before Flop (didn't bet)
Seat 8: mazzy4629 folded before Flop (didn't bet)

PokerStars Hand #251206715787: Tournament #3767885527, $40+$10+$5 USD Hold'em No Limit - Level XVII (1750/3500) - 2024/06/26 20:15:28 UTC [2024/06/26 16:15:28 ET]
Table '3767885527 34' 8-max Seat #5 is the button
Seat 1: Bigprad (59894 in chips) 
Seat 2: martincho186 (66890 in chips) 
Seat 3: kuenne71 (147271 in chips) 
Seat 4: Equinox616 (218141 in chips) 
Seat 5: gladiatore99 (51278 in chips) 
Seat 6: SolidYerna (184460 in chips) 
Seat 7: Dominosu (158280 in chips) 
Seat 8: mazzy4629 (17725 in chips) 
Bigprad: posts the ante 450
martincho186: posts the ante 450
kuenne71: posts the ante 450
Equinox616: posts the ante 450
gladiatore99: posts the ante 450
SolidYerna: posts the ante 450
Dominosu: posts the ante 450
mazzy4629: posts the ante 450
SolidYerna: posts small blind 1750
Dominosu: posts big blind 3500
*** HOLE CARDS ***
mazzy4629: raises 13775 to 17275 and is all-in
Bigprad: folds 
martincho186: folds 
kuenne71: folds 
Equinox616: folds 
gladiatore99: folds 
SolidYerna: folds 
Dominosu: folds 
Uncalled bet (13775) returned to mazzy4629
mazzy4629 collected 12350 from pot
*** SUMMARY ***
Total pot 12350 | Rake 0 
Seat 1: Bigprad folded before Flop (didn't bet)
Seat 2: martincho186 folded before Flop (didn't bet)
Seat 3: kuenne71 folded before Flop (didn't bet)
Seat 4: Equinox616 folded before Flop (didn't bet)
Seat 5: gladiatore99 (button) folded before Flop (didn't bet)
Seat 6: SolidYerna (small blind) folded before Flop
Seat 7: Dominosu (big blind) folded before Flop
Seat 8: mazzy4629 collected (12350)

PokerStars Hand #251206723933: Tournament #3767885527, $40+$10+$5 USD Hold'em No Limit - Level XVIII (2000/4000) - 2024/06/26 20:15:57 UTC [2024/06/26 16:15:57 ET]
Table '3767885527 34' 8-max Seat #6 is the button
Seat 1: Bigprad (59444 in chips) 
Seat 2: martincho186 (66440 in chips) 
Seat 3: kuenne71 (146821 in chips) 
Seat 4: Equinox616 (217691 in chips) 
Seat 5: gladiatore99 (50828 in chips) 
Seat 6: SolidYerna (182260 in chips) 
Seat 7: Dominosu (154330 in chips) 
Seat 8: mazzy4629 (26125 in chips) 
Bigprad: posts the ante 500
martincho186: posts the ante 500
kuenne71: posts the ante 500
Equinox616: posts the ante 500
gladiatore99: posts the ante 500
SolidYerna: posts the ante 500
Dominosu: posts the ante 500
mazzy4629: posts the ante 500
Dominosu: posts small blind 2000
mazzy4629: posts big blind 4000
*** HOLE CARDS ***
Bigprad: folds 
martincho186: raises 4000 to 8000
kuenne71: folds 
Equinox616: folds 
gladiatore99: folds 
SolidYerna: folds 
Dominosu: folds 
mazzy4629: folds 
Uncalled bet (4000) returned to martincho186
martincho186 collected 14000 from pot
*** SUMMARY ***
Total pot 14000 | Rake 0 
Seat 1: Bigprad folded before Flop (didn't bet)
Seat 2: martincho186 collected (14000)
Seat 3: kuenne71 folded before Flop (didn't bet)
Seat 4: Equinox616 folded before Flop (didn't bet)
Seat 5: gladiatore99 folded before Flop (didn't bet)
Seat 6: SolidYerna (button) folded before Flop (didn't bet)
Seat 7: Dominosu (small blind) folded before Flop
Seat 8: mazzy4629 (big blind) folded before Flop

PokerStars Hand #251206730587: Tournament #3767885527, $40+$10+$5 USD Hold'em No Limit - Level XVIII (2000/4000) - 2024/06/26 20:16:20 UTC [2024/06/26 16:16:20 ET]
Table '3767885527 34' 8-max Seat #7 is the button
Seat 1: Bigprad (58944 in chips) 
Seat 2: martincho186 (75940 in chips) 
Seat 3: kuenne71 (146321 in chips) 
Seat 4: Equinox616 (217191 in chips) 
Seat 5: gladiatore99 (50328 in chips) 
Seat 6: SolidYerna (181760 in chips) 
Seat 7: Dominosu (151830 in chips) 
Seat 8: mazzy4629 (21625 in chips) 
Bigprad: posts the ante 500
martincho186: posts the ante 500
kuenne71: posts the ante 500
Equinox616: posts the ante 500
gladiatore99: posts the ante 500
SolidYerna: posts the ante 500
Dominosu: posts the ante 500
mazzy4629: posts the ante 500
mazzy4629: posts small blind 2000
Bigprad: posts big blind 4000
*** HOLE CARDS ***
martincho186: folds 
kuenne71: folds 
Equinox616: raises 6000 to 10000
gladiatore99: folds 
SolidYerna: folds 
Dominosu: folds 
mazzy4629: folds 
Bigprad: folds 
Uncalled bet (6000) returned to Equinox616
Equinox616 collected 14000 from pot
Equinox616: doesn't show hand 
*** SUMMARY ***
Total pot 14000 | Rake 0 
Seat 1: Bigprad (big blind) folded before Flop
Seat 2: martincho186 folded before Flop (didn't bet)
Seat 3: kuenne71 folded before Flop (didn't bet)
Seat 4: Equinox616 collected (14000)
Seat 5: gladiatore99 folded before Flop (didn't bet)
Seat 6: SolidYerna folded before Flop (didn't bet)
Seat 7: Dominosu (button) folded before Flop (didn't bet)
Seat 8: mazzy4629 (small blind) folded before Flop

PokerStars Hand #251206747254: Tournament #3767885527, $40+$10+$5 USD Hold'em No Limit - Level XVIII (2000/4000) - 2024/06/26 20:17:20 UTC [2024/06/26 16:17:20 ET]
Table '3767885527 34' 8-max Seat #8 is the button
Seat 1: Bigprad (54444 in chips) 
Seat 2: martincho186 (75440 in chips) 
Seat 3: kuenne71 (145821 in chips) 
Seat 4: Equinox616 (226691 in chips) 
Seat 5: gladiatore99 (49828 in chips) 
Seat 6: SolidYerna (181260 in chips) 
Seat 7: Dominosu (151330 in chips) 
Seat 8: mazzy4629 (19125 in chips) 
Bigprad: posts the ante 500
martincho186: posts the ante 500
kuenne71: posts the ante 500
Equinox616: posts the ante 500
gladiatore99: posts the ante 500
SolidYerna: posts the ante 500
Dominosu: posts the ante 500
mazzy4629: posts the ante 500
Bigprad: posts small blind 2000
martincho186: posts big blind 4000
*** HOLE CARDS ***
kuenne71: folds 
Equinox616: folds 
gladiatore99: folds 
SolidYerna: folds 
Dominosu: raises 4800 to 8800
mazzy4629: folds 
Bigprad: folds 
martincho186: folds 
Uncalled bet (4800) returned to Dominosu
Dominosu collected 14000 from pot
Dominosu: doesn't show hand 
*** SUMMARY ***
Total pot 14000 | Rake 0 
Seat 1: Bigprad (small blind) folded before Flop
Seat 2: martincho186 (big blind) folded before Flop
Seat 3: kuenne71 folded before Flop (didn't bet)
Seat 4: Equinox616 folded before Flop (didn't bet)
Seat 5: gladiatore99 folded before Flop (didn't bet)
Seat 6: SolidYerna folded before Flop (didn't bet)
Seat 7: Dominosu collected (14000)
Seat 8: mazzy4629 (button) folded before Flop (didn't bet)

PokerStars Hand #251206752472: Tournament #3767885527, $40+$10+$5 USD Hold'em No Limit - Level XVIII (2000/4000) - 2024/06/26 20:17:39 UTC [2024/06/26 16:17:39 ET]
Table '3767885527 34' 8-max Seat #1 is the button
Seat 1: Bigprad (51944 in chips) 
Seat 2: martincho186 (70940 in chips) 
Seat 3: kuenne71 (145321 in chips) 
Seat 4: Equinox616 (226191 in chips) 
Seat 5: gladiatore99 (49328 in chips) 
Seat 6: SolidYerna (180760 in chips) 
Seat 7: Dominosu (160830 in chips) 
Seat 8: mazzy4629 (18625 in chips) 
Bigprad: posts the ante 500
martincho186: posts the ante 500
kuenne71: posts the ante 500
Equinox616: posts the ante 500
gladiatore99: posts the ante 500
SolidYerna: posts the ante 500
Dominosu: posts the ante 500
mazzy4629: posts the ante 500
martincho186: posts small blind 2000
kuenne71: posts big blind 4000
*** HOLE CARDS ***
Equinox616: raises 4000 to 8000
gladiatore99: folds 
SolidYerna: folds 
Dominosu: raises 14000 to 22000
mazzy4629: folds 
Bigprad: folds 
martincho186: folds 
kuenne71: folds 
Equinox616: calls 14000
*** FLOP *** [6s 6h Qc]
Equinox616: bets 31000
Dominosu: calls 31000
*** TURN *** [6s 6h Qc] [6d]
Equinox616: checks 
Dominosu: checks 
*** RIVER *** [6s 6h Qc 6d] [8s]
Equinox616: bets 32000
Dominosu: raises 75330 to 107330 and is all-in
Equinox616: calls 75330
*** SHOW DOWN ***
Dominosu: shows [Kc Ks] (a full house, Sixes full of Kings)
Equinox616: shows [Qh Kd] (a full house, Sixes full of Queens)
Dominosu collected 330660 from pot
*** SUMMARY ***
Total pot 330660 | Rake 0 
Board [6s 6h Qc 6d 8s]
Seat 1: Bigprad (button) folded before Flop (didn't bet)
Seat 2: martincho186 (small blind) folded before Flop
Seat 3: kuenne71 (big blind) folded before Flop
Seat 4: Equinox616 showed [Qh Kd] and lost with a full house, Sixes full of Queens
Seat 5: gladiatore99 folded before Flop (didn't bet)
Seat 6: SolidYerna folded before Flop (didn't bet)
Seat 7: Dominosu showed [Kc Ks] and won (330660) with a full house, Sixes full of Kings
Seat 8: mazzy4629 folded before Flop (didn't bet)

PokerStars Hand #251206804174: Tournament #3767885527, $40+$10+$5 USD Hold'em No Limit - Level XVIII (2000/4000) - 2024/06/26 20:20:42 UTC [2024/06/26 16:20:42 ET]
Table '3767885527 34' 8-max Seat #2 is the button
Seat 1: Bigprad (51444 in chips) 
Seat 2: martincho186 (68440 in chips) 
Seat 3: kuenne71 (140821 in chips) 
Seat 4: Equinox616 (65361 in chips) 
Seat 5: gladiatore99 (48828 in chips) 
Seat 6: SolidYerna (180260 in chips) 
Seat 7: Dominosu (330660 in chips) 
Seat 8: mazzy4629 (18125 in chips) 
Bigprad: posts the ante 500
martincho186: posts the ante 500
kuenne71: posts the ante 500
Equinox616: posts the ante 500
gladiatore99: posts the ante 500
SolidYerna: posts the ante 500
Dominosu: posts the ante 500
mazzy4629: posts the ante 500
kuenne71: posts small blind 2000
Equinox616: posts big blind 4000
*** HOLE CARDS ***
gladiatore99: folds 
SolidYerna: folds 
Dominosu: raises 4800 to 8800
mazzy4629: folds 
Bigprad: folds 
martincho186: folds 
kuenne71: calls 6800
Equinox616: folds 
*** FLOP *** [Kh 2c Qs]
kuenne71: checks 
Dominosu: checks 
*** TURN *** [Kh 2c Qs] [7s]
kuenne71: checks 
Dominosu: bets 8448
kuenne71: folds 
Uncalled bet (8448) returned to Dominosu
Dominosu collected 25600 from pot
Dominosu: doesn't show hand 
*** SUMMARY ***
Total pot 25600 | Rake 0 
Board [Kh 2c Qs 7s]
Seat 1: Bigprad folded before Flop (didn't bet)
Seat 2: martincho186 (button) folded before Flop (didn't bet)
Seat 3: kuenne71 (small blind) folded on the Turn
Seat 4: Equinox616 (big blind) folded before Flop
Seat 5: gladiatore99 folded before Flop (didn't bet)
Seat 6: SolidYerna folded before Flop (didn't bet)
Seat 7: Dominosu collected (25600)
Seat 8: mazzy4629 folded before Flop (didn't bet)

PokerStars Hand #251206822533: Tournament #3767885527, $40+$10+$5 USD Hold'em No Limit - Level XVIII (2000/4000) - 2024/06/26 20:21:47 UTC [2024/06/26 16:21:47 ET]
Table '3767885527 34' 8-max Seat #3 is the button
Seat 1: Bigprad (50944 in chips) 
Seat 2: martincho186 (67940 in chips) 
Seat 3: kuenne71 (131521 in chips) 
Seat 4: Equinox616 (60861 in chips) 
Seat 5: gladiatore99 (48328 in chips) 
Seat 6: SolidYerna (179760 in chips) 
Seat 7: Dominosu (346960 in chips) 
Seat 8: mazzy4629 (17625 in chips) 
Bigprad: posts the ante 500
martincho186: posts the ante 500
kuenne71: posts the ante 500
Equinox616: posts the ante 500
gladiatore99: posts the ante 500
SolidYerna: posts the ante 500
Dominosu: posts the ante 500
mazzy4629: posts the ante 500
Equinox616: posts small blind 2000
gladiatore99: posts big blind 4000
*** HOLE CARDS ***
SolidYerna: folds 
Dominosu: folds 
mazzy4629: folds 
Bigprad: raises 46444 to 50444 and is all-in
martincho186: folds 
kuenne71: folds 
Equinox616: raises 9917 to 60361 and is all-in
gladiatore99: folds 
Uncalled bet (9917) returned to Equinox616
*** FLOP *** [4h 5d As]
*** TURN *** [4h 5d As] [Qc]
*** RIVER *** [4h 5d As Qc] [5s]
*** SHOW DOWN ***
Equinox616: shows [9h Ac] (two pair, Aces and Fives)
Bigprad: shows [Qh Ah] (two pair, Aces and Queens)
Bigprad collected 108888 from pot
*** SUMMARY ***
Total pot 108888 | Rake 0 
Board [4h 5d As Qc 5s]
Seat 1: Bigprad showed [Qh Ah] and won (108888) with two pair, Aces and Queens
Seat 2: martincho186 folded before Flop (didn't bet)
Seat 3: kuenne71 (button) folded before Flop (didn't bet)
Seat 4: Equinox616 (small blind) showed [9h Ac] and lost with two pair, Aces and Fives
Seat 5: gladiatore99 (big blind) folded before Flop
Seat 6: SolidYerna folded before Flop (didn't bet)
Seat 7: Dominosu folded before Flop (didn't bet)
Seat 8: mazzy4629 folded before Flop (didn't bet)

PokerStars Hand #251206836302: Tournament #3767885527, $40+$10+$5 USD Hold'em No Limit - Level XVIII (2000/4000) - 2024/06/26 20:22:36 UTC [2024/06/26 16:22:36 ET]
Table '3767885527 34' 8-max Seat #4 is the button
Seat 1: Bigprad (108888 in chips) 
Seat 2: martincho186 (67440 in chips) 
Seat 3: kuenne71 (131021 in chips) 
Seat 4: Equinox616 (9917 in chips) 
Seat 5: gladiatore99 (43828 in chips) 
Seat 6: SolidYerna (179260 in chips) 
Seat 7: Dominosu (346460 in chips) 
Seat 8: mazzy4629 (17125 in chips) 
Bigprad: posts the ante 500
martincho186: posts the ante 500
kuenne71: posts the ante 500
Equinox616: posts the ante 500
gladiatore99: posts the ante 500
SolidYerna: posts the ante 500
Dominosu: posts the ante 500
mazzy4629: posts the ante 500
gladiatore99: posts small blind 2000
SolidYerna: posts big blind 4000
*** HOLE CARDS ***
Dominosu: folds 
mazzy4629: folds 
Bigprad: folds 
martincho186: folds 
kuenne71: folds 
Equinox616: raises 5417 to 9417 and is all-in
gladiatore99: calls 7417
SolidYerna: folds 
*** FLOP *** [Qd 4h 9d]
*** TURN *** [Qd 4h 9d] [Qh]
*** RIVER *** [Qd 4h 9d Qh] [8h]
*** SHOW DOWN ***
gladiatore99: shows [Ah Ac] (two pair, Aces and Queens)
Equinox616: shows [6h 7h] (a flush, Queen high)
Equinox616 collected 26834 from pot
*** SUMMARY ***
Total pot 26834 | Rake 0 
Board [Qd 4h 9d Qh 8h]
Seat 1: Bigprad folded before Flop (didn't bet)
Seat 2: martincho186 folded before Flop (didn't bet)
Seat 3: kuenne71 folded before Flop (didn't bet)
Seat 4: Equinox616 (button) showed [6h 7h] and won (26834) with a flush, Queen high
Seat 5: gladiatore99 (small blind) showed [Ah Ac] and lost with two pair, Aces and Queens
Seat 6: SolidYerna (big blind) folded before Flop
Seat 7: Dominosu folded before Flop (didn't bet)
Seat 8: mazzy4629 folded before Flop (didn't bet)

PokerStars Hand #251206847393: Tournament #3767885527, $40+$10+$5 USD Hold'em No Limit - Level XVIII (2000/4000) - 2024/06/26 20:23:16 UTC [2024/06/26 16:23:16 ET]
Table '3767885527 34' 8-max Seat #5 is the button
Seat 1: Bigprad (108388 in chips) 
Seat 2: martincho186 (66940 in chips) 
Seat 3: kuenne71 (130521 in chips) 
Seat 4: Equinox616 (26834 in chips) 
Seat 5: gladiatore99 (33911 in chips) 
Seat 6: SolidYerna (174760 in chips) 
Seat 7: Dominosu (345960 in chips) 
Seat 8: mazzy4629 (16625 in chips) 
Bigprad: posts the ante 500
martincho186: posts the ante 500
kuenne71: posts the ante 500
Equinox616: posts the ante 500
gladiatore99: posts the ante 500
SolidYerna: posts the ante 500
Dominosu: posts the ante 500
mazzy4629: posts the ante 500
SolidYerna: posts small blind 2000
Dominosu: posts big blind 4000
*** HOLE CARDS ***
mazzy4629: raises 12125 to 16125 and is all-in
Bigprad: folds 
martincho186: folds 
kuenne71: folds 
Equinox616: folds 
gladiatore99: folds 
SolidYerna: folds 
Dominosu has timed out
Dominosu: folds 
Dominosu is sitting out
Uncalled bet (12125) returned to mazzy4629
Dominosu has returned
mazzy4629 collected 14000 from pot
*** SUMMARY ***
Total pot 14000 | Rake 0 
Seat 1: Bigprad folded before Flop (didn't bet)
Seat 2: martincho186 folded before Flop (didn't bet)
Seat 3: kuenne71 folded before Flop (didn't bet)
Seat 4: Equinox616 folded before Flop (didn't bet)
Seat 5: gladiatore99 (button) folded before Flop (didn't bet)
Seat 6: SolidYerna (small blind) folded before Flop
Seat 7: Dominosu (big blind) folded before Flop
Seat 8: mazzy4629 collected (14000)

PokerStars Hand #251206856352: Tournament #3767885527, $40+$10+$5 USD Hold'em No Limit - Level XVIII (2000/4000) - 2024/06/26 20:23:48 UTC [2024/06/26 16:23:48 ET]
Table '3767885527 34' 8-max Seat #6 is the button
Seat 1: Bigprad (107888 in chips) 
Seat 2: martincho186 (66440 in chips) 
Seat 3: kuenne71 (130021 in chips) 
Seat 4: Equinox616 (26334 in chips) 
Seat 5: gladiatore99 (33411 in chips) 
Seat 6: SolidYerna (172260 in chips) 
Seat 7: Dominosu (341460 in chips) 
Seat 8: mazzy4629 (26125 in chips) 
Bigprad: posts the ante 500
martincho186: posts the ante 500
kuenne71: posts the ante 500
Equinox616: posts the ante 500
gladiatore99: posts the ante 500
SolidYerna: posts the ante 500
Dominosu: posts the ante 500
mazzy4629: posts the ante 500
Dominosu: posts small blind 2000
mazzy4629: posts big blind 4000
*** HOLE CARDS ***
Bigprad: raises 4000 to 8000
martincho186: folds 
kuenne71: calls 8000
Equinox616: folds 
gladiatore99: folds 
SolidYerna: folds 
Dominosu: folds 
mazzy4629: calls 4000
*** FLOP *** [5d 8c Ah]
mazzy4629: checks 
Bigprad: bets 30000
kuenne71: calls 30000
mazzy4629: folds 
*** TURN *** [5d 8c Ah] [2d]
Bigprad: bets 69388 and is all-in
kuenne71: calls 69388
*** RIVER *** [5d 8c Ah 2d] [Jc]
*** SHOW DOWN ***
Bigprad: shows [5c Ac] (two pair, Aces and Fives)
kuenne71: shows [Td Ad] (a pair of Aces)
Bigprad collected 228776 from pot
*** SUMMARY ***
Total pot 228776 | Rake 0 
Board [5d 8c Ah 2d Jc]
Seat 1: Bigprad showed [5c Ac] and won (228776) with two pair, Aces and Fives
Seat 2: martincho186 folded before Flop (didn't bet)
Seat 3: kuenne71 showed [Td Ad] and lost with a pair of Aces
Seat 4: Equinox616 folded before Flop (didn't bet)
Seat 5: gladiatore99 folded before Flop (didn't bet)
Seat 6: SolidYerna (button) folded before Flop (didn't bet)
Seat 7: Dominosu (small blind) folded before Flop
Seat 8: mazzy4629 (big blind) folded on the Flop

PokerStars Hand #251206868087: Tournament #3767885527, $40+$10+$5 USD Hold'em No Limit - Level XVIII (2000/4000) - 2024/06/26 20:24:29 UTC [2024/06/26 16:24:29 ET]
Table '3767885527 34' 8-max Seat #7 is the button
Seat 1: Bigprad (228776 in chips) 
Seat 2: martincho186 (65940 in chips) 
Seat 3: kuenne71 (22133 in chips) 
Seat 4: Equinox616 (25834 in chips) 
Seat 5: gladiatore99 (32911 in chips) 
Seat 6: SolidYerna (171760 in chips) 
Seat 7: Dominosu (338960 in chips) 
Seat 8: mazzy4629 (17625 in chips) 
Bigprad: posts the ante 500
martincho186: posts the ante 500
kuenne71: posts the ante 500
Equinox616: posts the ante 500
gladiatore99: posts the ante 500
SolidYerna: posts the ante 500
Dominosu: posts the ante 500
mazzy4629: posts the ante 500
mazzy4629: posts small blind 2000
Bigprad: posts big blind 4000
*** HOLE CARDS ***
martincho186: folds 
kuenne71: raises 17633 to 21633 and is all-in
Equinox616: folds 
gladiatore99: folds 
SolidYerna: folds 
Dominosu: folds 
mazzy4629: folds 
Bigprad: calls 17633
*** FLOP *** [Kd 8h 5c]
*** TURN *** [Kd 8h 5c] [6h]
*** RIVER *** [Kd 8h 5c 6h] [9d]
*** SHOW DOWN ***
Bigprad: shows [Ts Td] (a pair of Tens)
kuenne71: shows [Tc Kc] (a pair of Kings)
kuenne71 collected 49266 from pot
*** SUMMARY ***
Total pot 49266 | Rake 0 
Board [Kd 8h 5c 6h 9d]
Seat 1: Bigprad (big blind) showed [Ts Td] and lost with a pair of Tens
Seat 2: martincho186 folded before Flop (didn't bet)
Seat 3: kuenne71 showed [Tc Kc] and won (49266) with a pair of Kings
Seat 4: Equinox616 folded before Flop (didn't bet)
Seat 5: gladiatore99 folded before Flop (didn't bet)
Seat 6: SolidYerna folded before Flop (didn't bet)
Seat 7: Dominosu (button) folded before Flop (didn't bet)
Seat 8: mazzy4629 (small blind) folded before Flop

PokerStars Hand #251206875512: Tournament #3767885527, $40+$10+$5 USD Hold'em No Limit - Level XVIII (2000/4000) - 2024/06/26 20:24:56 UTC [2024/06/26 16:24:56 ET]
Table '3767885527 34' 8-max Seat #8 is the button
Seat 1: Bigprad (206643 in chips) 
Seat 2: martincho186 (65440 in chips) 
Seat 3: kuenne71 (49266 in chips) 
Seat 4: Equinox616 (25334 in chips) 
Seat 5: gladiatore99 (32411 in chips) 
Seat 6: SolidYerna (171260 in chips) 
Seat 7: Dominosu (338460 in chips) 
Seat 8: mazzy4629 (15125 in chips) 
Bigprad: posts the ante 500
martincho186: posts the ante 500
kuenne71: posts the ante 500
Equinox616: posts the ante 500
gladiatore99: posts the ante 500
SolidYerna: posts the ante 500
Dominosu: posts the ante 500
mazzy4629: posts the ante 500
Bigprad: posts small blind 2000
martincho186: posts big blind 4000
*** HOLE CARDS ***
kuenne71: folds 
Equinox616: folds 
gladiatore99: folds 
SolidYerna: folds 
Dominosu: raises 4800 to 8800
mazzy4629: folds 
Bigprad: folds 
martincho186: calls 4800
*** FLOP *** [7s 8d 4h]
martincho186: checks 
Dominosu: bets 7788
martincho186: raises 48352 to 56140 and is all-in
Dominosu: folds 
Uncalled bet (48352) returned to martincho186
martincho186 collected 39176 from pot
*** SUMMARY ***
Total pot 39176 | Rake 0 
Board [7s 8d 4h]
Seat 1: Bigprad (small blind) folded before Flop
Seat 2: martincho186 (big blind) collected (39176)
Seat 3: kuenne71 folded before Flop (didn't bet)
Seat 4: Equinox616 folded before Flop (didn't bet)
Seat 5: gladiatore99 folded before Flop (didn't bet)
Seat 6: SolidYerna folded before Flop (didn't bet)
Seat 7: Dominosu folded on the Flop
Seat 8: mazzy4629 (button) folded before Flop (didn't bet)

PokerStars Hand #251206889937: Tournament #3767885527, $40+$10+$5 USD Hold'em No Limit - Level XVIII (2000/4000) - 2024/06/26 20:25:48 UTC [2024/06/26 16:25:48 ET]
Table '3767885527 34' 8-max Seat #1 is the button
Seat 1: Bigprad (204143 in chips) 
Seat 2: martincho186 (87528 in chips) 
Seat 3: kuenne71 (48766 in chips) 
Seat 4: Equinox616 (24834 in chips) 
Seat 5: gladiatore99 (31911 in chips) 
Seat 6: SolidYerna (170760 in chips) 
Seat 7: Dominosu (321372 in chips) 
Seat 8: mazzy4629 (14625 in chips) 
Bigprad: posts the ante 500
martincho186: posts the ante 500
kuenne71: posts the ante 500
Equinox616: posts the ante 500
gladiatore99: posts the ante 500
SolidYerna: posts the ante 500
Dominosu: posts the ante 500
mazzy4629: posts the ante 500
martincho186: posts small blind 2000
kuenne71: posts big blind 4000
*** HOLE CARDS ***
Equinox616: folds 
gladiatore99: folds 
SolidYerna: raises 4400 to 8400
Dominosu: folds 
mazzy4629: folds 
Bigprad: folds 
martincho186: folds 
kuenne71: calls 4400
*** FLOP *** [6c 4c Jd]
kuenne71: checks 
SolidYerna: checks 
*** TURN *** [6c 4c Jd] [Ad]
kuenne71: checks 
SolidYerna: bets 4000
kuenne71: folds 
Uncalled bet (4000) returned to SolidYerna
SolidYerna collected 22800 from pot
SolidYerna: doesn't show hand 
*** SUMMARY ***
Total pot 22800 | Rake 0 
Board [6c 4c Jd Ad]
Seat 1: Bigprad (button) folded before Flop (didn't bet)
Seat 2: martincho186 (small blind) folded before Flop
Seat 3: kuenne71 (big blind) folded on the Turn
Seat 4: Equinox616 folded before Flop (didn't bet)
Seat 5: gladiatore99 folded before Flop (didn't bet)
Seat 6: SolidYerna collected (22800)
Seat 7: Dominosu folded before Flop (didn't bet)
Seat 8: mazzy4629 folded before Flop (didn't bet)

PokerStars Hand #251206902688: Tournament #3767885527, $40+$10+$5 USD Hold'em No Limit - Level XIX (2500/5000) - 2024/06/26 20:26:33 UTC [2024/06/26 16:26:33 ET]
Table '3767885527 34' 8-max Seat #2 is the button
Seat 1: Bigprad (203643 in chips) 
Seat 2: martincho186 (85028 in chips) 
Seat 3: kuenne71 (39866 in chips) 
Seat 4: Equinox616 (24334 in chips) 
Seat 5: gladiatore99 (31411 in chips) 
Seat 6: SolidYerna (184660 in chips) 
Seat 7: Dominosu (320872 in chips) 
Seat 8: mazzy4629 (14125 in chips) 
Bigprad: posts the ante 625
martincho186: posts the ante 625
kuenne71: posts the ante 625
Equinox616: posts the ante 625
gladiatore99: posts the ante 625
SolidYerna: posts the ante 625
Dominosu: posts the ante 625
mazzy4629: posts the ante 625
kuenne71: posts small blind 2500
Equinox616: posts big blind 5000
*** HOLE CARDS ***
gladiatore99: folds 
SolidYerna: raises 5500 to 10500
Dominosu: folds 
mazzy4629: folds 
Bigprad: folds 
martincho186: folds 
kuenne71: folds 
Equinox616: folds 
Uncalled bet (5500) returned to SolidYerna
SolidYerna collected 17500 from pot
SolidYerna: doesn't show hand 
*** SUMMARY ***
Total pot 17500 | Rake 0 
Seat 1: Bigprad folded before Flop (didn't bet)
Seat 2: martincho186 (button) folded before Flop (didn't bet)
Seat 3: kuenne71 (small blind) folded before Flop
Seat 4: Equinox616 (big blind) folded before Flop
Seat 5: gladiatore99 folded before Flop (didn't bet)
Seat 6: SolidYerna collected (17500)
Seat 7: Dominosu folded before Flop (didn't bet)
Seat 8: mazzy4629 folded before Flop (didn't bet)

PokerStars Hand #251206909304: Tournament #3767885527, $40+$10+$5 USD Hold'em No Limit - Level XIX (2500/5000) - 2024/06/26 20:26:57 UTC [2024/06/26 16:26:57 ET]
Table '3767885527 34' 8-max Seat #3 is the button
Seat 1: Bigprad (203018 in chips) 
Seat 2: martincho186 (84403 in chips) 
Seat 3: kuenne71 (36741 in chips) 
Seat 4: Equinox616 (18709 in chips) 
Seat 5: gladiatore99 (30786 in chips) 
Seat 6: SolidYerna (196535 in chips) 
Seat 7: Dominosu (320247 in chips) 
Seat 8: mazzy4629 (13500 in chips) 
Bigprad: posts the ante 625
martincho186: posts the ante 625
kuenne71: posts the ante 625
Equinox616: posts the ante 625
gladiatore99: posts the ante 625
SolidYerna: posts the ante 625
Dominosu: posts the ante 625
mazzy4629: posts the ante 625
Equinox616: posts small blind 2500
gladiatore99: posts big blind 5000
*** HOLE CARDS ***
SolidYerna: raises 5500 to 10500
Dominosu: folds 
mazzy4629: folds 
Bigprad: folds 
martincho186: folds 
kuenne71: folds 
Equinox616: folds 
gladiatore99: raises 19661 to 30161 and is all-in
SolidYerna: calls 19661
*** FLOP *** [Jc Qd 2s]
*** TURN *** [Jc Qd 2s] [Td]
*** RIVER *** [Jc Qd 2s Td] [5s]
*** SHOW DOWN ***
gladiatore99: shows [As Jh] (a pair of Jacks)
SolidYerna: shows [Ac 5c] (a pair of Fives)
gladiatore99 collected 67822 from pot
*** SUMMARY ***
Total pot 67822 | Rake 0 
Board [Jc Qd 2s Td 5s]
Seat 1: Bigprad folded before Flop (didn't bet)
Seat 2: martincho186 folded before Flop (didn't bet)
Seat 3: kuenne71 (button) folded before Flop (didn't bet)
Seat 4: Equinox616 (small blind) folded before Flop
Seat 5: gladiatore99 (big blind) showed [As Jh] and won (67822) with a pair of Jacks
Seat 6: SolidYerna showed [Ac 5c] and lost with a pair of Fives
Seat 7: Dominosu folded before Flop (didn't bet)
Seat 8: mazzy4629 folded before Flop (didn't bet)

PokerStars Hand #251206922196: Tournament #3767885527, $40+$10+$5 USD Hold'em No Limit - Level XIX (2500/5000) - 2024/06/26 20:27:43 UTC [2024/06/26 16:27:43 ET]
Table '3767885527 34' 8-max Seat #4 is the button
Seat 1: Bigprad (202393 in chips) 
Seat 2: martincho186 (83778 in chips) 
Seat 3: kuenne71 (36116 in chips) 
Seat 4: Equinox616 (15584 in chips) 
Seat 5: gladiatore99 (67822 in chips) 
Seat 6: SolidYerna (165749 in chips) 
Seat 7: Dominosu (319622 in chips) 
Seat 8: mazzy4629 (12875 in chips) 
Bigprad: posts the ante 625
martincho186: posts the ante 625
kuenne71: posts the ante 625
Equinox616: posts the ante 625
gladiatore99: posts the ante 625
SolidYerna: posts the ante 625
Dominosu: posts the ante 625
mazzy4629: posts the ante 625
gladiatore99: posts small blind 2500
SolidYerna: posts big blind 5000
*** HOLE CARDS ***
Dominosu: folds 
mazzy4629: raises 7250 to 12250 and is all-in
Bigprad: folds 
martincho186: folds 
kuenne71: folds 
Equinox616: folds 
gladiatore99: raises 54947 to 67197 and is all-in
SolidYerna: folds 
Uncalled bet (54947) returned to gladiatore99
*** FLOP *** [Qs 6h Tc]
*** TURN *** [Qs 6h Tc] [Qc]
*** RIVER *** [Qs 6h Tc Qc] [Ts]
*** SHOW DOWN ***
gladiatore99: shows [5d Ad] (two pair, Queens and Tens)
mazzy4629: shows [Js Qd] (a full house, Queens full of Tens)
mazzy4629 collected 34500 from pot
*** SUMMARY ***
Total pot 34500 | Rake 0 
Board [Qs 6h Tc Qc Ts]
Seat 1: Bigprad folded before Flop (didn't bet)
Seat 2: martincho186 folded before Flop (didn't bet)
Seat 3: kuenne71 folded before Flop (didn't bet)
Seat 4: Equinox616 (button) folded before Flop (didn't bet)
Seat 5: gladiatore99 (small blind) showed [5d Ad] and lost with two pair, Queens and Tens
Seat 6: SolidYerna (big blind) folded before Flop
Seat 7: Dominosu folded before Flop (didn't bet)
Seat 8: mazzy4629 showed [Js Qd] and won (34500) with a full house, Queens full of Tens

PokerStars Hand #251206930046: Tournament #3767885527, $40+$10+$5 USD Hold'em No Limit - Level XIX (2500/5000) - 2024/06/26 20:28:11 UTC [2024/06/26 16:28:11 ET]
Table '3767885527 34' 8-max Seat #5 is the button
Seat 1: Bigprad (201768 in chips) 
Seat 2: martincho186 (83153 in chips) 
Seat 3: kuenne71 (35491 in chips) 
Seat 4: Equinox616 (14959 in chips) 
Seat 5: gladiatore99 (54947 in chips) 
Seat 6: SolidYerna (160124 in chips) 
Seat 7: Dominosu (318997 in chips) 
Seat 8: mazzy4629 (34500 in chips) 
Bigprad: posts the ante 625
martincho186: posts the ante 625
kuenne71: posts the ante 625
Equinox616: posts the ante 625
gladiatore99: posts the ante 625
SolidYerna: posts the ante 625
Dominosu: posts the ante 625
mazzy4629: posts the ante 625
SolidYerna: posts small blind 2500
Dominosu: posts big blind 5000
*** HOLE CARDS ***
mazzy4629: folds 
Bigprad: raises 5000 to 10000
martincho186: folds 
kuenne71: folds 
Equinox616: folds 
gladiatore99: folds 
SolidYerna: folds 
Dominosu: calls 5000
*** FLOP *** [Kd 3h 8c]
Dominosu: checks 
Bigprad: bets 10000
Dominosu: folds 
Uncalled bet (10000) returned to Bigprad
Bigprad collected 27500 from pot
*** SUMMARY ***
Total pot 27500 | Rake 0 
Board [Kd 3h 8c]
Seat 1: Bigprad collected (27500)
Seat 2: martincho186 folded before Flop (didn't bet)
Seat 3: kuenne71 folded before Flop (didn't bet)
Seat 4: Equinox616 folded before Flop (didn't bet)
Seat 5: gladiatore99 (button) folded before Flop (didn't bet)
Seat 6: SolidYerna (small blind) folded before Flop
Seat 7: Dominosu (big blind) folded on the Flop
Seat 8: mazzy4629 folded before Flop (didn't bet)

PokerStars Hand #251206937030: Tournament #3767885527, $40+$10+$5 USD Hold'em No Limit - Level XIX (2500/5000) - 2024/06/26 20:28:36 UTC [2024/06/26 16:28:36 ET]
Table '3767885527 34' 8-max Seat #6 is the button
Seat 1: Bigprad (218643 in chips) 
Seat 2: martincho186 (82528 in chips) 
Seat 3: kuenne71 (34866 in chips) 
Seat 4: Equinox616 (14334 in chips) 
Seat 5: gladiatore99 (54322 in chips) 
Seat 6: SolidYerna (156999 in chips) 
Seat 7: Dominosu (308372 in chips) 
Seat 8: mazzy4629 (33875 in chips) 
Bigprad: posts the ante 625
martincho186: posts the ante 625
kuenne71: posts the ante 625
Equinox616: posts the ante 625
gladiatore99: posts the ante 625
SolidYerna: posts the ante 625
Dominosu: posts the ante 625
mazzy4629: posts the ante 625
Dominosu: posts small blind 2500
mazzy4629: posts big blind 5000
*** HOLE CARDS ***
Bigprad: folds 
martincho186: folds 
kuenne71: folds 
Equinox616: folds 
gladiatore99: folds 
SolidYerna: raises 7500 to 12500
Dominosu: folds 
mazzy4629: folds 
Uncalled bet (7500) returned to SolidYerna
SolidYerna collected 17500 from pot
SolidYerna: doesn't show hand 
*** SUMMARY ***
Total pot 17500 | Rake 0 
Seat 1: Bigprad folded before Flop (didn't bet)
Seat 2: martincho186 folded before Flop (didn't bet)
Seat 3: kuenne71 folded before Flop (didn't bet)
Seat 4: Equinox616 folded before Flop (didn't bet)
Seat 5: gladiatore99 folded before Flop (didn't bet)
Seat 6: SolidYerna (button) collected (17500)
Seat 7: Dominosu (small blind) folded before Flop
Seat 8: mazzy4629 (big blind) folded before Flop

PokerStars Hand #251206947613: Tournament #3767885527, $40+$10+$5 USD Hold'em No Limit - Level XIX (2500/5000) - 2024/06/26 20:29:15 UTC [2024/06/26 16:29:15 ET]
Table '3767885527 34' 8-max Seat #7 is the button
Seat 1: Bigprad (218018 in chips) 
Seat 2: martincho186 (81903 in chips) 
Seat 3: kuenne71 (34241 in chips) 
Seat 4: Equinox616 (13709 in chips) 
Seat 5: gladiatore99 (53697 in chips) 
Seat 6: SolidYerna (168874 in chips) 
Seat 7: Dominosu (305247 in chips) 
Seat 8: mazzy4629 (28250 in chips) 
Bigprad: posts the ante 625
martincho186: posts the ante 625
kuenne71: posts the ante 625
Equinox616: posts the ante 625
gladiatore99: posts the ante 625
SolidYerna: posts the ante 625
Dominosu: posts the ante 625
mazzy4629: posts the ante 625
mazzy4629: posts small blind 2500
Bigprad: posts big blind 5000
*** HOLE CARDS ***
martincho186: folds 
kuenne71: folds 
Equinox616: folds 
gladiatore99: folds 
SolidYerna: raises 5500 to 10500
Dominosu: folds 
mazzy4629: folds 
Bigprad: folds 
Uncalled bet (5500) returned to SolidYerna
SolidYerna collected 17500 from pot
SolidYerna: doesn't show hand 
*** SUMMARY ***
Total pot 17500 | Rake 0 
Seat 1: Bigprad (big blind) folded before Flop
Seat 2: martincho186 folded before Flop (didn't bet)
Seat 3: kuenne71 folded before Flop (didn't bet)
Seat 4: Equinox616 folded before Flop (didn't bet)
Seat 5: gladiatore99 folded before Flop (didn't bet)
Seat 6: SolidYerna collected (17500)
Seat 7: Dominosu (button) folded before Flop (didn't bet)
Seat 8: mazzy4629 (small blind) folded before Flop

PokerStars Hand #251206952447: Tournament #3767885527, $40+$10+$5 USD Hold'em No Limit - Level XIX (2500/5000) - 2024/06/26 20:29:33 UTC [2024/06/26 16:29:33 ET]
Table '3767885527 34' 8-max Seat #8 is the button
Seat 1: Bigprad (212393 in chips) 
Seat 2: martincho186 (81278 in chips) 
Seat 3: kuenne71 (33616 in chips) 
Seat 4: Equinox616 (13084 in chips) 
Seat 5: gladiatore99 (53072 in chips) 
Seat 6: SolidYerna (180749 in chips) 
Seat 7: Dominosu (304622 in chips) 
Seat 8: mazzy4629 (25125 in chips) 
Bigprad: posts the ante 625
martincho186: posts the ante 625
kuenne71: posts the ante 625
Equinox616: posts the ante 625
gladiatore99: posts the ante 625
SolidYerna: posts the ante 625
Dominosu: posts the ante 625
mazzy4629: posts the ante 625
Bigprad: posts small blind 2500
martincho186: posts big blind 5000
*** HOLE CARDS ***
kuenne71: folds 
Equinox616 has timed out
Equinox616: folds 
Equinox616 is sitting out
gladiatore99: folds 
Equinox616 has returned
SolidYerna: folds 
Dominosu: raises 6000 to 11000
mazzy4629: folds 
Bigprad: folds 
martincho186: folds 
Uncalled bet (6000) returned to Dominosu
Dominosu collected 17500 from pot
Dominosu: doesn't show hand 
*** SUMMARY ***
Total pot 17500 | Rake 0 
Seat 1: Bigprad (small blind) folded before Flop
Seat 2: martincho186 (big blind) folded before Flop
Seat 3: kuenne71 folded before Flop (didn't bet)
Seat 4: Equinox616 folded before Flop (didn't bet)
Seat 5: gladiatore99 folded before Flop (didn't bet)
Seat 6: SolidYerna folded before Flop (didn't bet)
Seat 7: Dominosu collected (17500)
Seat 8: mazzy4629 (button) folded before Flop (didn't bet)

PokerStars Hand #251206974574: Tournament #3767885527, $40+$10+$5 USD Hold'em No Limit - Level XIX (2500/5000) - 2024/06/26 20:30:53 UTC [2024/06/26 16:30:53 ET]
Table '3767885527 34' 8-max Seat #1 is the button
Seat 1: Bigprad (209268 in chips) 
Seat 2: martincho186 (75653 in chips) 
Seat 3: kuenne71 (32991 in chips) 
Seat 4: Equinox616 (12459 in chips) 
Seat 5: gladiatore99 (52447 in chips) 
Seat 6: SolidYerna (180124 in chips) 
Seat 7: Dominosu (316497 in chips) 
Seat 8: mazzy4629 (24500 in chips) 
Bigprad: posts the ante 625
martincho186: posts the ante 625
kuenne71: posts the ante 625
Equinox616: posts the ante 625
gladiatore99: posts the ante 625
SolidYerna: posts the ante 625
Dominosu: posts the ante 625
mazzy4629: posts the ante 625
martincho186: posts small blind 2500
kuenne71: posts big blind 5000
*** HOLE CARDS ***
Equinox616 has timed out
Equinox616: folds 
Equinox616 is sitting out
gladiatore99: folds 
SolidYerna: raises 5500 to 10500
Dominosu: folds 
mazzy4629: folds 
Bigprad: calls 10500
martincho186: folds 
kuenne71: calls 5500
*** FLOP *** [Jd 7d Kc]
kuenne71: checks 
SolidYerna: checks 
Bigprad: checks 
*** TURN *** [Jd 7d Kc] [5c]
kuenne71: checks 
SolidYerna: checks 
Bigprad: checks 
*** RIVER *** [Jd 7d Kc 5c] [2c]
kuenne71: checks 
Equinox616 has returned
SolidYerna: checks 
Bigprad: checks 
*** SHOW DOWN ***
kuenne71: shows [7h 8s] (a pair of Sevens)
SolidYerna: mucks hand 
Bigprad: mucks hand 
kuenne71 collected 39000 from pot
*** SUMMARY ***
Total pot 39000 | Rake 0 
Board [Jd 7d Kc 5c 2c]
Seat 1: Bigprad (button) mucked
Seat 2: martincho186 (small blind) folded before Flop
Seat 3: kuenne71 (big blind) showed [7h 8s] and won (39000) with a pair of Sevens
Seat 4: Equinox616 folded before Flop (didn't bet)
Seat 5: gladiatore99 folded before Flop (didn't bet)
Seat 6: SolidYerna mucked
Seat 7: Dominosu folded before Flop (didn't bet)
Seat 8: mazzy4629 folded before Flop (didn't bet)

PokerStars Hand #251206990927: Tournament #3767885527, $40+$10+$5 USD Hold'em No Limit - Level XIX (2500/5000) - 2024/06/26 20:31:51 UTC [2024/06/26 16:31:51 ET]
Table '3767885527 34' 8-max Seat #2 is the button
Seat 1: Bigprad (198143 in chips) 
Seat 2: martincho186 (72528 in chips) 
Seat 3: kuenne71 (60866 in chips) 
Seat 4: Equinox616 (11834 in chips) 
Seat 5: gladiatore99 (51822 in chips) 
Seat 6: SolidYerna (168999 in chips) 
Seat 7: Dominosu (315872 in chips) 
Seat 8: mazzy4629 (23875 in chips) 
Bigprad: posts the ante 625
martincho186: posts the ante 625
kuenne71: posts the ante 625
Equinox616: posts the ante 625
gladiatore99: posts the ante 625
SolidYerna: posts the ante 625
Dominosu: posts the ante 625
mazzy4629: posts the ante 625
kuenne71: posts small blind 2500
Equinox616: posts big blind 5000
*** HOLE CARDS ***
gladiatore99: folds 
SolidYerna: folds 
Dominosu: folds 
mazzy4629: folds 
Bigprad: folds 
martincho186: folds 
kuenne71: raises 10000 to 15000
Equinox616: calls 6209 and is all-in
Uncalled bet (3791) returned to kuenne71
*** FLOP *** [2h Jc 8s]
*** TURN *** [2h Jc 8s] [Js]
*** RIVER *** [2h Jc 8s Js] [8c]
*** SHOW DOWN ***
kuenne71: shows [Jh Qc] (a full house, Jacks full of Eights)
Equinox616: shows [9c Ac] (two pair, Jacks and Eights)
kuenne71 collected 27418 from pot
Equinox616 finished the tournament in 305th place
*** SUMMARY ***
Total pot 27418 | Rake 0 
Board [2h Jc 8s Js 8c]
Seat 1: Bigprad folded before Flop (didn't bet)
Seat 2: martincho186 (button) folded before Flop (didn't bet)
Seat 3: kuenne71 (small blind) showed [Jh Qc] and won (27418) with a full house, Jacks full of Eights
Seat 4: Equinox616 (big blind) showed [9c Ac] and lost with two pair, Jacks and Eights
Seat 5: gladiatore99 folded before Flop (didn't bet)
Seat 6: SolidYerna folded before Flop (didn't bet)
Seat 7: Dominosu folded before Flop (didn't bet)
Seat 8: mazzy4629 folded before Flop (didn't bet)


PokerStars Hand #251205349458: Tournament #3767885527, $40+$10+$5 USD Hold'em No Limit - Level X (500/1000) - 2024/06/26 18:49:06 UTC [2024/06/26 14:49:06 ET]
Table '3767885527 33' 8-max Seat #8 is the button
Seat 1: IgorHKR (22577 in chips) 
Seat 2: trigobrien (39296 in chips) 
Seat 3: markyLP (40629 in chips) 
Seat 4: AllanEM (33357 in chips) 
Seat 5: handsfull69 (35869 in chips) 
Seat 6: IceFire12338 (38991 in chips) 
Seat 7: ENG.Brito (45891 in chips) 
Seat 8: BorIska1993 (66204 in chips) 
IgorHKR: posts the ante 125
trigobrien: posts the ante 125
markyLP: posts the ante 125
AllanEM: posts the ante 125
handsfull69: posts the ante 125
IceFire12338: posts the ante 125
ENG.Brito: posts the ante 125
BorIska1993: posts the ante 125
IgorHKR: posts small blind 500
trigobrien: posts big blind 1000
*** HOLE CARDS ***
markyLP: folds 
AllanEM: folds 
handsfull69: folds 
IceFire12338: folds 
ENG.Brito: folds 
BorIska1993: folds 
IgorHKR: calls 500
trigobrien: checks 
*** FLOP *** [Ah 2s 6h]
IgorHKR: checks 
trigobrien: checks 
*** TURN *** [Ah 2s 6h] [8d]
IgorHKR: bets 5000
trigobrien: folds 
Uncalled bet (5000) returned to IgorHKR
IgorHKR collected 3000 from pot
IgorHKR: doesn't show hand 
*** SUMMARY ***
Total pot 3000 | Rake 0 
Board [Ah 2s 6h 8d]
Seat 1: IgorHKR (small blind) collected (3000)
Seat 2: trigobrien (big blind) folded on the Turn
Seat 3: markyLP folded before Flop (didn't bet)
Seat 4: AllanEM folded before Flop (didn't bet)
Seat 5: handsfull69 folded before Flop (didn't bet)
Seat 6: IceFire12338 folded before Flop (didn't bet)
Seat 7: ENG.Brito folded before Flop (didn't bet)
Seat 8: BorIska1993 (button) folded before Flop (didn't bet)

PokerStars Hand #251205361019: Tournament #3767885527, $40+$10+$5 USD Hold'em No Limit - Level X (500/1000) - 2024/06/26 18:49:50 UTC [2024/06/26 14:49:50 ET]
Table '3767885527 33' 8-max Seat #1 is the button
Seat 1: IgorHKR (24452 in chips) 
Seat 2: trigobrien (38171 in chips) 
Seat 3: markyLP (40504 in chips) 
Seat 4: AllanEM (33232 in chips) 
Seat 5: handsfull69 (35744 in chips) 
Seat 6: IceFire12338 (38866 in chips) 
Seat 7: ENG.Brito (45766 in chips) 
Seat 8: BorIska1993 (66079 in chips) 
IgorHKR: posts the ante 125
trigobrien: posts the ante 125
markyLP: posts the ante 125
AllanEM: posts the ante 125
handsfull69: posts the ante 125
IceFire12338: posts the ante 125
ENG.Brito: posts the ante 125
BorIska1993: posts the ante 125
trigobrien: posts small blind 500
markyLP: posts big blind 1000
*** HOLE CARDS ***
AllanEM: folds 
handsfull69: folds 
IceFire12338: folds 
ENG.Brito: folds 
BorIska1993: folds 
IgorHKR: folds 
trigobrien: calls 500
markyLP: raises 2500 to 3500
trigobrien: calls 2500
*** FLOP *** [7c Qd 7h]
trigobrien: checks 
markyLP: bets 2400
trigobrien: folds 
Uncalled bet (2400) returned to markyLP
markyLP collected 8000 from pot
markyLP: doesn't show hand 
*** SUMMARY ***
Total pot 8000 | Rake 0 
Board [7c Qd 7h]
Seat 1: IgorHKR (button) folded before Flop (didn't bet)
Seat 2: trigobrien (small blind) folded on the Flop
Seat 3: markyLP (big blind) collected (8000)
Seat 4: AllanEM folded before Flop (didn't bet)
Seat 5: handsfull69 folded before Flop (didn't bet)
Seat 6: IceFire12338 folded before Flop (didn't bet)
Seat 7: ENG.Brito folded before Flop (didn't bet)
Seat 8: BorIska1993 folded before Flop (didn't bet)

PokerStars Hand #251205373685: Tournament #3767885527, $40+$10+$5 USD Hold'em No Limit - Level X (500/1000) - 2024/06/26 18:50:38 UTC [2024/06/26 14:50:38 ET]
Table '3767885527 33' 8-max Seat #2 is the button
Seat 1: IgorHKR (24327 in chips) 
Seat 2: trigobrien (34546 in chips) 
Seat 3: markyLP (44879 in chips) 
Seat 4: AllanEM (33107 in chips) 
Seat 5: handsfull69 (35619 in chips) 
Seat 6: IceFire12338 (38741 in chips) 
Seat 7: ENG.Brito (45641 in chips) 
Seat 8: BorIska1993 (65954 in chips) 
IgorHKR: posts the ante 125
trigobrien: posts the ante 125
markyLP: posts the ante 125
AllanEM: posts the ante 125
handsfull69: posts the ante 125
IceFire12338: posts the ante 125
ENG.Brito: posts the ante 125
BorIska1993: posts the ante 125
markyLP: posts small blind 500
AllanEM: posts big blind 1000
*** HOLE CARDS ***
handsfull69: folds 
IceFire12338: folds 
ENG.Brito: folds 
BorIska1993: raises 1100 to 2100
IgorHKR: folds 
trigobrien: folds 
markyLP: calls 1600
AllanEM: folds 
*** FLOP *** [Tc Jc 9d]
markyLP: checks 
BorIska1993: bets 3162
markyLP: folds 
Uncalled bet (3162) returned to BorIska1993
BorIska1993 collected 6200 from pot
BorIska1993: doesn't show hand 
*** SUMMARY ***
Total pot 6200 | Rake 0 
Board [Tc Jc 9d]
Seat 1: IgorHKR folded before Flop (didn't bet)
Seat 2: trigobrien (button) folded before Flop (didn't bet)
Seat 3: markyLP (small blind) folded on the Flop
Seat 4: AllanEM (big blind) folded before Flop
Seat 5: handsfull69 folded before Flop (didn't bet)
Seat 6: IceFire12338 folded before Flop (didn't bet)
Seat 7: ENG.Brito folded before Flop (didn't bet)
Seat 8: BorIska1993 collected (6200)

PokerStars Hand #251205385936: Tournament #3767885527, $40+$10+$5 USD Hold'em No Limit - Level X (500/1000) - 2024/06/26 18:51:25 UTC [2024/06/26 14:51:25 ET]
Table '3767885527 33' 8-max Seat #3 is the button
Seat 1: IgorHKR (24202 in chips) 
Seat 2: trigobrien (34421 in chips) 
Seat 3: markyLP (42654 in chips) 
Seat 4: AllanEM (31982 in chips) 
Seat 5: handsfull69 (35494 in chips) 
Seat 6: IceFire12338 (38616 in chips) 
Seat 7: ENG.Brito (45516 in chips) 
Seat 8: BorIska1993 (69929 in chips) 
IgorHKR: posts the ante 125
trigobrien: posts the ante 125
markyLP: posts the ante 125
AllanEM: posts the ante 125
handsfull69: posts the ante 125
IceFire12338: posts the ante 125
ENG.Brito: posts the ante 125
BorIska1993: posts the ante 125
AllanEM: posts small blind 500
handsfull69: posts big blind 1000
*** HOLE CARDS ***
IceFire12338: folds 
ENG.Brito: folds 
BorIska1993: folds 
IgorHKR: folds 
trigobrien: folds 
markyLP: folds 
AllanEM: calls 500
handsfull69: raises 34369 to 35369 and is all-in
AllanEM: folds 
Uncalled bet (34369) returned to handsfull69
handsfull69 collected 3000 from pot
*** SUMMARY ***
Total pot 3000 | Rake 0 
Seat 1: IgorHKR folded before Flop (didn't bet)
Seat 2: trigobrien folded before Flop (didn't bet)
Seat 3: markyLP (button) folded before Flop (didn't bet)
Seat 4: AllanEM (small blind) folded before Flop
Seat 5: handsfull69 (big blind) collected (3000)
Seat 6: IceFire12338 folded before Flop (didn't bet)
Seat 7: ENG.Brito folded before Flop (didn't bet)
Seat 8: BorIska1993 folded before Flop (didn't bet)

PokerStars Hand #251205394739: Tournament #3767885527, $40+$10+$5 USD Hold'em No Limit - Level X (500/1000) - 2024/06/26 18:51:58 UTC [2024/06/26 14:51:58 ET]
Table '3767885527 33' 8-max Seat #4 is the button
Seat 1: IgorHKR (24077 in chips) 
Seat 2: trigobrien (34296 in chips) 
Seat 3: markyLP (42529 in chips) 
Seat 4: AllanEM (30857 in chips) 
Seat 5: handsfull69 (37369 in chips) 
Seat 6: IceFire12338 (38491 in chips) 
Seat 7: ENG.Brito (45391 in chips) 
Seat 8: BorIska1993 (69804 in chips) 
IgorHKR: posts the ante 125
trigobrien: posts the ante 125
markyLP: posts the ante 125
AllanEM: posts the ante 125
handsfull69: posts the ante 125
IceFire12338: posts the ante 125
ENG.Brito: posts the ante 125
BorIska1993: posts the ante 125
handsfull69: posts small blind 500
IceFire12338: posts big blind 1000
*** HOLE CARDS ***
ENG.Brito: raises 1000 to 2000
BorIska1993: folds 
IgorHKR: folds 
trigobrien: folds 
markyLP: folds 
AllanEM: folds 
handsfull69: calls 1500
IceFire12338: calls 1000
*** FLOP *** [5c Qs Ac]
handsfull69: bets 3500
IceFire12338: calls 3500
ENG.Brito: folds 
*** TURN *** [5c Qs Ac] [Tc]
handsfull69: bets 6000
IceFire12338: calls 6000
*** RIVER *** [5c Qs Ac Tc] [2s]
handsfull69: bets 11000
IceFire12338: calls 11000
*** SHOW DOWN ***
handsfull69: shows [6c 7c] (a flush, Ace high)
IceFire12338: mucks hand 
handsfull69 collected 48000 from pot
*** SUMMARY ***
Total pot 48000 | Rake 0 
Board [5c Qs Ac Tc 2s]
Seat 1: IgorHKR folded before Flop (didn't bet)
Seat 2: trigobrien folded before Flop (didn't bet)
Seat 3: markyLP folded before Flop (didn't bet)
Seat 4: AllanEM (button) folded before Flop (didn't bet)
Seat 5: handsfull69 (small blind) showed [6c 7c] and won (48000) with a flush, Ace high
Seat 6: IceFire12338 (big blind) mucked
Seat 7: ENG.Brito folded on the Flop
Seat 8: BorIska1993 folded before Flop (didn't bet)

PokerStars Hand #251205416211: Tournament #3767885527, $40+$10+$5 USD Hold'em No Limit - Level XI (600/1200) - 2024/06/26 18:53:20 UTC [2024/06/26 14:53:20 ET]
Table '3767885527 33' 8-max Seat #5 is the button
Seat 1: IgorHKR (23952 in chips) 
Seat 2: trigobrien (34171 in chips) 
Seat 3: markyLP (42404 in chips) 
Seat 4: AllanEM (30732 in chips) 
Seat 5: handsfull69 (62744 in chips) 
Seat 6: IceFire12338 (15866 in chips) 
Seat 7: ENG.Brito (43266 in chips) 
Seat 8: BorIska1993 (69679 in chips) 
IgorHKR: posts the ante 150
trigobrien: posts the ante 150
markyLP: posts the ante 150
AllanEM: posts the ante 150
handsfull69: posts the ante 150
IceFire12338: posts the ante 150
ENG.Brito: posts the ante 150
BorIska1993: posts the ante 150
IceFire12338: posts small blind 600
ENG.Brito: posts big blind 1200
*** HOLE CARDS ***
BorIska1993: raises 1320 to 2520
IgorHKR: folds 
trigobrien: folds 
markyLP: folds 
AllanEM: folds 
handsfull69: folds 
IceFire12338: calls 1920
ENG.Brito: folds 
*** FLOP *** [7d Kh Ad]
IceFire12338: checks 
BorIska1993: bets 2232
IceFire12338: calls 2232
*** TURN *** [7d Kh Ad] [5d]
IceFire12338: checks 
BorIska1993: checks 
*** RIVER *** [7d Kh Ad 5d] [4h]
IceFire12338: checks 
BorIska1993: checks 
*** SHOW DOWN ***
IceFire12338: shows [Ks Js] (a pair of Kings)
BorIska1993: shows [Ah 2h] (a pair of Aces)
BorIska1993 collected 11904 from pot
*** SUMMARY ***
Total pot 11904 | Rake 0 
Board [7d Kh Ad 5d 4h]
Seat 1: IgorHKR folded before Flop (didn't bet)
Seat 2: trigobrien folded before Flop (didn't bet)
Seat 3: markyLP folded before Flop (didn't bet)
Seat 4: AllanEM folded before Flop (didn't bet)
Seat 5: handsfull69 (button) folded before Flop (didn't bet)
Seat 6: IceFire12338 (small blind) showed [Ks Js] and lost with a pair of Kings
Seat 7: ENG.Brito (big blind) folded before Flop
Seat 8: BorIska1993 showed [Ah 2h] and won (11904) with a pair of Aces

PokerStars Hand #251205431445: Tournament #3767885527, $40+$10+$5 USD Hold'em No Limit - Level XI (600/1200) - 2024/06/26 18:54:18 UTC [2024/06/26 14:54:18 ET]
Table '3767885527 33' 8-max Seat #6 is the button
Seat 1: IgorHKR (23802 in chips) 
Seat 2: trigobrien (34021 in chips) 
Seat 3: markyLP (42254 in chips) 
Seat 4: AllanEM (30582 in chips) 
Seat 5: handsfull69 (62594 in chips) 
Seat 6: IceFire12338 (10964 in chips) 
Seat 7: ENG.Brito (41916 in chips) 
Seat 8: BorIska1993 (76681 in chips) 
IgorHKR: posts the ante 150
trigobrien: posts the ante 150
markyLP: posts the ante 150
AllanEM: posts the ante 150
handsfull69: posts the ante 150
IceFire12338: posts the ante 150
ENG.Brito: posts the ante 150
BorIska1993: posts the ante 150
ENG.Brito: posts small blind 600
BorIska1993: posts big blind 1200
*** HOLE CARDS ***
IgorHKR: folds 
trigobrien: folds 
markyLP: folds 
AllanEM: folds 
handsfull69: folds 
IceFire12338: raises 9614 to 10814 and is all-in
ENG.Brito: folds 
BorIska1993: calls 9614
*** FLOP *** [7c Qh Jh]
*** TURN *** [7c Qh Jh] [9d]
*** RIVER *** [7c Qh Jh 9d] [3d]
*** SHOW DOWN ***
BorIska1993: shows [Ad 9s] (a pair of Nines)
IceFire12338: shows [Td Qs] (a pair of Queens)
IceFire12338 collected 23428 from pot
*** SUMMARY ***
Total pot 23428 | Rake 0 
Board [7c Qh Jh 9d 3d]
Seat 1: IgorHKR folded before Flop (didn't bet)
Seat 2: trigobrien folded before Flop (didn't bet)
Seat 3: markyLP folded before Flop (didn't bet)
Seat 4: AllanEM folded before Flop (didn't bet)
Seat 5: handsfull69 folded before Flop (didn't bet)
Seat 6: IceFire12338 (button) showed [Td Qs] and won (23428) with a pair of Queens
Seat 7: ENG.Brito (small blind) folded before Flop
Seat 8: BorIska1993 (big blind) showed [Ad 9s] and lost with a pair of Nines

PokerStars Hand #251205440094: Tournament #3767885527, $40+$10+$5 USD Hold'em No Limit - Level XI (600/1200) - 2024/06/26 18:54:51 UTC [2024/06/26 14:54:51 ET]
Table '3767885527 33' 8-max Seat #7 is the button
Seat 1: IgorHKR (23652 in chips) 
Seat 2: trigobrien (33871 in chips) 
Seat 3: markyLP (42104 in chips) 
Seat 4: AllanEM (30432 in chips) 
Seat 5: handsfull69 (62444 in chips) 
Seat 6: IceFire12338 (23428 in chips) 
Seat 7: ENG.Brito (41166 in chips) 
Seat 8: BorIska1993 (65717 in chips) 
IgorHKR: posts the ante 150
trigobrien: posts the ante 150
markyLP: posts the ante 150
AllanEM: posts the ante 150
handsfull69: posts the ante 150
IceFire12338: posts the ante 150
ENG.Brito: posts the ante 150
BorIska1993: posts the ante 150
BorIska1993: posts small blind 600
IgorHKR: posts big blind 1200
*** HOLE CARDS ***
trigobrien: folds 
markyLP: folds 
AllanEM: folds 
handsfull69: raises 1200 to 2400
IceFire12338: folds 
ENG.Brito: folds 
BorIska1993: folds 
IgorHKR: folds 
Uncalled bet (1200) returned to handsfull69
handsfull69 collected 4200 from pot
*** SUMMARY ***
Total pot 4200 | Rake 0 
Seat 1: IgorHKR (big blind) folded before Flop
Seat 2: trigobrien folded before Flop (didn't bet)
Seat 3: markyLP folded before Flop (didn't bet)
Seat 4: AllanEM folded before Flop (didn't bet)
Seat 5: handsfull69 collected (4200)
Seat 6: IceFire12338 folded before Flop (didn't bet)
Seat 7: ENG.Brito (button) folded before Flop (didn't bet)
Seat 8: BorIska1993 (small blind) folded before Flop

PokerStars Hand #251205528169: Tournament #3767885527, $40+$10+$5 USD Hold'em No Limit - Level XI (600/1200) - 2024/06/26 19:02:04 UTC [2024/06/26 15:02:04 ET]
Table '3767885527 33' 8-max Seat #8 is the button
Seat 1: IgorHKR (22302 in chips) 
Seat 2: trigobrien (33721 in chips) 
Seat 3: markyLP (41954 in chips) 
Seat 4: AllanEM (30282 in chips) 
Seat 5: handsfull69 (65294 in chips) 
Seat 6: IceFire12338 (23278 in chips) 
Seat 7: ENG.Brito (41016 in chips) 
Seat 8: BorIska1993 (64967 in chips) 
IgorHKR: posts the ante 150
trigobrien: posts the ante 150
markyLP: posts the ante 150
AllanEM: posts the ante 150
handsfull69: posts the ante 150
IceFire12338: posts the ante 150
ENG.Brito: posts the ante 150
BorIska1993: posts the ante 150
IgorHKR: posts small blind 600
trigobrien: posts big blind 1200
*** HOLE CARDS ***
markyLP: folds 
AllanEM: folds 
handsfull69: folds 
IceFire12338: folds 
ENG.Brito: folds 
BorIska1993: raises 1200 to 2400
IgorHKR: folds 
trigobrien: calls 1200
*** FLOP *** [Jd Ts 5h]
trigobrien: checks 
BorIska1993: bets 1980
trigobrien: calls 1980
*** TURN *** [Jd Ts 5h] [Td]
trigobrien: checks 
BorIska1993: checks 
*** RIVER *** [Jd Ts 5h Td] [Ac]
trigobrien: bets 5280
BorIska1993: folds 
Uncalled bet (5280) returned to trigobrien
trigobrien collected 10560 from pot
*** SUMMARY ***
Total pot 10560 | Rake 0 
Board [Jd Ts 5h Td Ac]
Seat 1: IgorHKR (small blind) folded before Flop
Seat 2: trigobrien (big blind) collected (10560)
Seat 3: markyLP folded before Flop (didn't bet)
Seat 4: AllanEM folded before Flop (didn't bet)
Seat 5: handsfull69 folded before Flop (didn't bet)
Seat 6: IceFire12338 folded before Flop (didn't bet)
Seat 7: ENG.Brito folded before Flop (didn't bet)
Seat 8: BorIska1993 (button) folded on the River



PokerStars Hand #251205614352: Tournament #3767885527, $40+$10+$5 USD Hold'em No Limit - Level XI (600/1200) - 2024/06/26 19:07:37 UTC [2024/06/26 15:07:37 ET]
Table '3767885527 96' 8-max Seat #1 is the button
Seat 1: MKL1010 (37531 in chips) 
Seat 2: DontCryClumsy88 (24246 in chips) 
Seat 3: Eux1986 (89833 in chips) 
Seat 4: moratto1992 (28490 in chips) 
Seat 5: 4fast2u (33091 in chips) 
Seat 6: Dizzydarts (24186 in chips) 
Seat 7: ivan limeira (52552 in chips) 
Seat 8: Mike.fontova (10582 in chips) 
MKL1010: posts the ante 150
DontCryClumsy88: posts the ante 150
Eux1986: posts the ante 150
moratto1992: posts the ante 150
4fast2u: posts the ante 150
Dizzydarts: posts the ante 150
ivan limeira: posts the ante 150
Mike.fontova: posts the ante 150
DontCryClumsy88: posts small blind 600
Eux1986: posts big blind 1200
*** HOLE CARDS ***
moratto1992: raises 1200 to 2400
4fast2u: folds 
Dizzydarts: folds 
ivan limeira: folds 
Mike.fontova: calls 2400
MKL1010: folds 
DontCryClumsy88: calls 1800
Eux1986: calls 1200
*** FLOP *** [2h Kh 8s]
DontCryClumsy88: checks 
Eux1986: checks 
moratto1992: checks 
Mike.fontova: bets 8032 and is all-in
DontCryClumsy88: raises 13664 to 21696 and is all-in
Eux1986: folds 
moratto1992: folds 
Uncalled bet (13664) returned to DontCryClumsy88
*** TURN *** [2h Kh 8s] [Td]
*** RIVER *** [2h Kh 8s Td] [8d]
*** SHOW DOWN ***
DontCryClumsy88: shows [Kd Jc] (two pair, Kings and Eights)
Mike.fontova: shows [Js Jd] (two pair, Jacks and Eights)
DontCryClumsy88 collected 26864 from pot
Mike.fontova finished the tournament
*** SUMMARY ***
Total pot 26864 | Rake 0 
Board [2h Kh 8s Td 8d]
Seat 1: MKL1010 (button) folded before Flop (didn't bet)
Seat 2: DontCryClumsy88 (small blind) showed [Kd Jc] and won (26864) with two pair, Kings and Eights
Seat 3: Eux1986 (big blind) folded on the Flop
Seat 4: moratto1992 folded on the Flop
Seat 5: 4fast2u folded before Flop (didn't bet)
Seat 6: Dizzydarts folded before Flop (didn't bet)
Seat 7: ivan limeira folded before Flop (didn't bet)
Seat 8: Mike.fontova showed [Js Jd] and lost with two pair, Jacks and Eights

PokerStars Hand #251205627968: Tournament #3767885527, $40+$10+$5 USD Hold'em No Limit - Level XI (600/1200) - 2024/06/26 19:08:29 UTC [2024/06/26 15:08:29 ET]
Table '3767885527 96' 8-max Seat #2 is the button
Seat 1: MKL1010 (37381 in chips) 
Seat 2: DontCryClumsy88 (40528 in chips) 
Seat 3: Eux1986 (87283 in chips) 
Seat 4: moratto1992 (25940 in chips) 
Seat 5: 4fast2u (32941 in chips) 
Seat 6: Dizzydarts (24036 in chips) 
Seat 7: ivan limeira (52402 in chips) 
MKL1010: posts the ante 150
DontCryClumsy88: posts the ante 150
Eux1986: posts the ante 150
moratto1992: posts the ante 150
4fast2u: posts the ante 150
Dizzydarts: posts the ante 150
ivan limeira: posts the ante 150
Eux1986: posts small blind 600
moratto1992: posts big blind 1200
*** HOLE CARDS ***
4fast2u: folds 
Dizzydarts: folds 
ivan limeira: folds 
MKL1010: raises 1200 to 2400
DontCryClumsy88: calls 2400
Eux1986: folds 
moratto1992: raises 23390 to 25790 and is all-in
MKL1010: folds 
DontCryClumsy88: folds 
Uncalled bet (23390) returned to moratto1992
moratto1992 collected 8850 from pot
moratto1992: doesn't show hand 
*** SUMMARY ***
Total pot 8850 | Rake 0 
Seat 1: MKL1010 folded before Flop
Seat 2: DontCryClumsy88 (button) folded before Flop
Seat 3: Eux1986 (small blind) folded before Flop
Seat 4: moratto1992 (big blind) collected (8850)
Seat 5: 4fast2u folded before Flop (didn't bet)
Seat 6: Dizzydarts folded before Flop (didn't bet)
Seat 7: ivan limeira folded before Flop (didn't bet)

PokerStars Hand #251205637815: Tournament #3767885527, $40+$10+$5 USD Hold'em No Limit - Level XI (600/1200) - 2024/06/26 19:09:06 UTC [2024/06/26 15:09:06 ET]
Table '3767885527 96' 8-max Seat #3 is the button
Seat 1: MKL1010 (34831 in chips) 
Seat 2: DontCryClumsy88 (37978 in chips) 
Seat 3: Eux1986 (86533 in chips) 
Seat 4: moratto1992 (32240 in chips) 
Seat 5: 4fast2u (32791 in chips) 
Seat 6: Dizzydarts (23886 in chips) 
Seat 7: ivan limeira (52252 in chips) 
MKL1010: posts the ante 150
DontCryClumsy88: posts the ante 150
Eux1986: posts the ante 150
moratto1992: posts the ante 150
4fast2u: posts the ante 150
Dizzydarts: posts the ante 150
ivan limeira: posts the ante 150
moratto1992: posts small blind 600
4fast2u: posts big blind 1200
*** HOLE CARDS ***
Dizzydarts: folds 
ivan limeira: folds 
MKL1010: folds 
DontCryClumsy88: folds 
Eux1986: folds 
moratto1992: calls 600
DontCryClumsy88 is disconnected 
4fast2u: checks 
*** FLOP *** [6d 9s Kh]
moratto1992: checks 
DontCryClumsy88 is disconnected 
4fast2u: checks 
*** TURN *** [6d 9s Kh] [6c]
moratto1992: bets 1200
4fast2u: calls 1200
*** RIVER *** [6d 9s Kh 6c] [6h]
moratto1992: bets 1200
4fast2u: calls 1200
*** SHOW DOWN ***
moratto1992: shows [2s 2c] (a full house, Sixes full of Deuces)
4fast2u: mucks hand 
moratto1992 collected 8250 from pot
*** SUMMARY ***
Total pot 8250 | Rake 0 
Board [6d 9s Kh 6c 6h]
Seat 1: MKL1010 folded before Flop (didn't bet)
Seat 2: DontCryClumsy88 folded before Flop (didn't bet)
Seat 3: Eux1986 (button) folded before Flop (didn't bet)
Seat 4: moratto1992 (small blind) showed [2s 2c] and won (8250) with a full house, Sixes full of Deuces
Seat 5: 4fast2u (big blind) mucked
Seat 6: Dizzydarts folded before Flop (didn't bet)
Seat 7: ivan limeira folded before Flop (didn't bet)

PokerStars Hand #251205649992: Tournament #3767885527, $40+$10+$5 USD Hold'em No Limit - Level XII (700/1400) - 2024/06/26 19:09:51 UTC [2024/06/26 15:09:51 ET]
Table '3767885527 96' 8-max Seat #4 is the button
Seat 1: MKL1010 (34681 in chips) 
Seat 2: DontCryClumsy88 (37828 in chips) 
Seat 3: Eux1986 (86383 in chips) 
Seat 4: moratto1992 (36740 in chips) 
Seat 5: 4fast2u (29041 in chips) 
Seat 6: Dizzydarts (23736 in chips) 
Seat 7: ivan limeira (52102 in chips) 
MKL1010: posts the ante 175
DontCryClumsy88: posts the ante 175
Eux1986: posts the ante 175
moratto1992: posts the ante 175
4fast2u: posts the ante 175
Dizzydarts: posts the ante 175
ivan limeira: posts the ante 175
4fast2u: posts small blind 700
Dizzydarts: posts big blind 1400
*** HOLE CARDS ***
ivan limeira: folds 
MKL1010: folds 
DontCryClumsy88: folds 
Eux1986: raises 2800 to 4200
moratto1992: folds 
4fast2u: raises 8225 to 12425
Dizzydarts: folds 
Eux1986: raises 73783 to 86208 and is all-in
4fast2u: calls 16441 and is all-in
Uncalled bet (57342) returned to Eux1986
*** FLOP *** [Ts 6h Qs]
*** TURN *** [Ts 6h Qs] [4d]
*** RIVER *** [Ts 6h Qs 4d] [6s]
*** SHOW DOWN ***
4fast2u: shows [As Ah] (two pair, Aces and Sixes)
Eux1986: shows [4c 4h] (a full house, Fours full of Sixes)
Eux1986 collected 60357 from pot
4fast2u finished the tournament
*** SUMMARY ***
Total pot 60357 | Rake 0 
Board [Ts 6h Qs 4d 6s]
Seat 1: MKL1010 folded before Flop (didn't bet)
Seat 2: DontCryClumsy88 folded before Flop (didn't bet)
Seat 3: Eux1986 showed [4c 4h] and won (60357) with a full house, Fours full of Sixes
Seat 4: moratto1992 (button) folded before Flop (didn't bet)
Seat 5: 4fast2u (small blind) showed [As Ah] and lost with two pair, Aces and Sixes
Seat 6: Dizzydarts (big blind) folded before Flop
Seat 7: ivan limeira folded before Flop (didn't bet)

PokerStars Hand #251205661495: Tournament #3767885527, $40+$10+$5 USD Hold'em No Limit - Level XII (700/1400) - 2024/06/26 19:10:34 UTC [2024/06/26 15:10:34 ET]
Table '3767885527 96' 8-max Seat #6 is the button
Seat 1: MKL1010 (34506 in chips) 
Seat 2: DontCryClumsy88 (37653 in chips) 
Seat 3: Eux1986 (117699 in chips) 
Seat 4: moratto1992 (36565 in chips) 
Seat 6: Dizzydarts (22161 in chips) 
Seat 7: ivan limeira (51927 in chips) 
Seat 8: diabo656 (78175 in chips) 
MKL1010: posts the ante 175
DontCryClumsy88: posts the ante 175
Eux1986: posts the ante 175
moratto1992: posts the ante 175
Dizzydarts: posts the ante 175
ivan limeira: posts the ante 175
diabo656: posts the ante 175
ivan limeira: posts small blind 700
diabo656: posts big blind 1400
*** HOLE CARDS ***
MKL1010: folds 
DontCryClumsy88: folds 
Eux1986: folds 
moratto1992: folds 
Dizzydarts: raises 1400 to 2800
ivan limeira: folds 
diabo656 has timed out
diabo656: folds 
diabo656 is sitting out
Uncalled bet (1400) returned to Dizzydarts
Dizzydarts collected 4725 from pot
Dizzydarts: doesn't show hand 
*** SUMMARY ***
Total pot 4725 | Rake 0 
Seat 1: MKL1010 folded before Flop (didn't bet)
Seat 2: DontCryClumsy88 folded before Flop (didn't bet)
Seat 3: Eux1986 folded before Flop (didn't bet)
Seat 4: moratto1992 folded before Flop (didn't bet)
Seat 6: Dizzydarts (button) collected (4725)
Seat 7: ivan limeira (small blind) folded before Flop
Seat 8: diabo656 (big blind) folded before Flop

PokerStars Hand #251205669658: Tournament #3767885527, $40+$10+$5 USD Hold'em No Limit - Level XII (700/1400) - 2024/06/26 19:11:04 UTC [2024/06/26 15:11:04 ET]
Table '3767885527 96' 8-max Seat #7 is the button
Seat 1: MKL1010 (34331 in chips) 
Seat 2: DontCryClumsy88 (37478 in chips) 
Seat 3: Eux1986 (117524 in chips) 
Seat 4: moratto1992 (36390 in chips) 
Seat 6: Dizzydarts (25311 in chips) 
Seat 7: ivan limeira (51052 in chips) 
Seat 8: diabo656 (76600 in chips) is sitting out
MKL1010: posts the ante 175
DontCryClumsy88: posts the ante 175
Eux1986: posts the ante 175
moratto1992: posts the ante 175
Dizzydarts: posts the ante 175
ivan limeira: posts the ante 175
diabo656: posts the ante 175
diabo656: posts small blind 700
MKL1010: posts big blind 1400
*** HOLE CARDS ***
DontCryClumsy88: folds 
Eux1986: folds 
moratto1992: folds 
Dizzydarts: calls 1400
ivan limeira: folds 
diabo656: folds 
MKL1010: checks 
*** FLOP *** [Ah 8s 9h]
diabo656 has returned
MKL1010: checks 
Dizzydarts: bets 2363
MKL1010: folds 
Uncalled bet (2363) returned to Dizzydarts
Dizzydarts collected 4725 from pot
Dizzydarts: doesn't show hand 
*** SUMMARY ***
Total pot 4725 | Rake 0 
Board [Ah 8s 9h]
Seat 1: MKL1010 (big blind) folded on the Flop
Seat 2: DontCryClumsy88 folded before Flop (didn't bet)
Seat 3: Eux1986 folded before Flop (didn't bet)
Seat 4: moratto1992 folded before Flop (didn't bet)
Seat 6: Dizzydarts collected (4725)
Seat 7: ivan limeira (button) folded before Flop (didn't bet)
Seat 8: diabo656 (small blind) folded before Flop

PokerStars Hand #251205677346: Tournament #3767885527, $40+$10+$5 USD Hold'em No Limit - Level XII (700/1400) - 2024/06/26 19:11:33 UTC [2024/06/26 15:11:33 ET]
Table '3767885527 96' 8-max Seat #8 is the button
Seat 1: MKL1010 (32756 in chips) 
Seat 2: DontCryClumsy88 (37303 in chips) 
Seat 3: Eux1986 (117349 in chips) 
Seat 4: moratto1992 (36215 in chips) 
Seat 6: Dizzydarts (28461 in chips) 
Seat 7: ivan limeira (50877 in chips) 
Seat 8: diabo656 (75725 in chips) 
MKL1010: posts the ante 175
DontCryClumsy88: posts the ante 175
Eux1986: posts the ante 175
moratto1992: posts the ante 175
Dizzydarts: posts the ante 175
ivan limeira: posts the ante 175
diabo656: posts the ante 175
MKL1010: posts small blind 700
DontCryClumsy88: posts big blind 1400
*** HOLE CARDS ***
Eux1986: folds 
moratto1992: raises 1400 to 2800
Dizzydarts: folds 
ivan limeira: raises 4900 to 7700
diabo656 has timed out
diabo656: folds 
diabo656 is sitting out
diabo656 has returned
MKL1010: folds 
DontCryClumsy88: folds 
moratto1992: calls 4900
*** FLOP *** [As 5d 6c]
moratto1992: checks 
ivan limeira: bets 4200
UnterMauern is disconnected 
moratto1992: folds 
Uncalled bet (4200) returned to ivan limeira
ivan limeira collected 18725 from pot
ivan limeira: doesn't show hand 
*** SUMMARY ***
Total pot 18725 | Rake 0 
Board [As 5d 6c]
Seat 1: MKL1010 (small blind) folded before Flop
Seat 2: DontCryClumsy88 (big blind) folded before Flop
Seat 3: Eux1986 folded before Flop (didn't bet)
Seat 4: moratto1992 folded on the Flop
Seat 6: Dizzydarts folded before Flop (didn't bet)
Seat 7: ivan limeira collected (18725)
Seat 8: diabo656 (button) folded before Flop (didn't bet)

PokerStars Hand #251205698735: Tournament #3767885527, $40+$10+$5 USD Hold'em No Limit - Level XII (700/1400) - 2024/06/26 19:12:52 UTC [2024/06/26 15:12:52 ET]
Table '3767885527 96' 8-max Seat #1 is the button
Seat 1: MKL1010 (31881 in chips) 
Seat 2: DontCryClumsy88 (35728 in chips) 
Seat 3: Eux1986 (117174 in chips) 
Seat 4: moratto1992 (28340 in chips) 
Seat 5: UnterMauern (25000 in chips) 
Seat 6: Dizzydarts (28286 in chips) 
Seat 7: ivan limeira (61727 in chips) 
Seat 8: diabo656 (75550 in chips) 
MKL1010: posts the ante 175
DontCryClumsy88: posts the ante 175
Eux1986: posts the ante 175
moratto1992: posts the ante 175
UnterMauern: posts the ante 175
Dizzydarts: posts the ante 175
ivan limeira: posts the ante 175
diabo656: posts the ante 175
DontCryClumsy88: posts small blind 700
Eux1986: posts big blind 1400
*** HOLE CARDS ***
moratto1992: folds 
UnterMauern: folds 
Dizzydarts: raises 1400 to 2800
ivan limeira: folds 
diabo656: folds 
MKL1010: folds 
DontCryClumsy88: calls 2100
Eux1986: calls 1400
*** FLOP *** [Ks As 9d]
DontCryClumsy88: checks 
Eux1986: bets 1400
Dizzydarts: calls 1400
DontCryClumsy88: calls 1400
*** TURN *** [Ks As 9d] [4d]
DontCryClumsy88: checks 
Eux1986: checks 
Dizzydarts: bets 2100
DontCryClumsy88: calls 2100
Eux1986: folds 
*** RIVER *** [Ks As 9d 4d] [Tc]
DontCryClumsy88: checks 
Dizzydarts: checks 
*** SHOW DOWN ***
DontCryClumsy88: shows [8d Ad] (a pair of Aces)
Dizzydarts: mucks hand 
DontCryClumsy88 collected 18200 from pot
*** SUMMARY ***
Total pot 18200 | Rake 0 
Board [Ks As 9d 4d Tc]
Seat 1: MKL1010 (button) folded before Flop (didn't bet)
Seat 2: DontCryClumsy88 (small blind) showed [8d Ad] and won (18200) with a pair of Aces
Seat 3: Eux1986 (big blind) folded on the Turn
Seat 4: moratto1992 folded before Flop (didn't bet)
Seat 5: UnterMauern folded before Flop (didn't bet)
Seat 6: Dizzydarts mucked
Seat 7: ivan limeira folded before Flop (didn't bet)
Seat 8: diabo656 folded before Flop (didn't bet)

PokerStars Hand #251205717395: Tournament #3767885527, $40+$10+$5 USD Hold'em No Limit - Level XII (700/1400) - 2024/06/26 19:14:01 UTC [2024/06/26 15:14:01 ET]
Table '3767885527 96' 8-max Seat #2 is the button
Seat 1: MKL1010 (31706 in chips) 
Seat 2: DontCryClumsy88 (47453 in chips) 
Seat 3: Eux1986 (112799 in chips) 
Seat 4: moratto1992 (28165 in chips) 
Seat 5: UnterMauern (24825 in chips) 
Seat 6: Dizzydarts (21811 in chips) 
Seat 7: ivan limeira (61552 in chips) 
Seat 8: diabo656 (75375 in chips) 
MKL1010: posts the ante 175
DontCryClumsy88: posts the ante 175
Eux1986: posts the ante 175
moratto1992: posts the ante 175
UnterMauern: posts the ante 175
Dizzydarts: posts the ante 175
ivan limeira: posts the ante 175
diabo656: posts the ante 175
Eux1986: posts small blind 700
moratto1992: posts big blind 1400
*** HOLE CARDS ***
UnterMauern: folds 
Dizzydarts: raises 1400 to 2800
ivan limeira: folds 
diabo656: folds 
MKL1010: folds 
DontCryClumsy88: calls 2800
Eux1986: folds 
moratto1992: folds 
*** FLOP *** [3d 6c 8d]
Dizzydarts: checks 
DontCryClumsy88: checks 
*** TURN *** [3d 6c 8d] [5c]
Dizzydarts: checks 
DontCryClumsy88: checks 
*** RIVER *** [3d 6c 8d 5c] [Td]
Dizzydarts: checks 
DontCryClumsy88: checks 
*** SHOW DOWN ***
Dizzydarts: shows [Qs Ah] (high card Ace)
DontCryClumsy88: shows [Qc Ad] (high card Ace)
Dizzydarts collected 4550 from pot
DontCryClumsy88 collected 4550 from pot
*** SUMMARY ***
Total pot 9100 | Rake 0 
Board [3d 6c 8d 5c Td]
Seat 1: MKL1010 folded before Flop (didn't bet)
Seat 2: DontCryClumsy88 (button) showed [Qc Ad] and won (4550) with high card Ace
Seat 3: Eux1986 (small blind) folded before Flop
Seat 4: moratto1992 (big blind) folded before Flop
Seat 5: UnterMauern folded before Flop (didn't bet)
Seat 6: Dizzydarts showed [Qs Ah] and won (4550) with high card Ace
Seat 7: ivan limeira folded before Flop (didn't bet)
Seat 8: diabo656 folded before Flop (didn't bet)

PokerStars Hand #251205729421: Tournament #3767885527, $40+$10+$5 USD Hold'em No Limit - Level XII (700/1400) - 2024/06/26 19:14:45 UTC [2024/06/26 15:14:45 ET]
Table '3767885527 96' 8-max Seat #3 is the button
Seat 1: MKL1010 (31531 in chips) 
Seat 2: DontCryClumsy88 (49028 in chips) 
Seat 3: Eux1986 (111924 in chips) 
Seat 4: moratto1992 (26590 in chips) 
Seat 5: UnterMauern (24650 in chips) 
Seat 6: Dizzydarts (23386 in chips) 
Seat 7: ivan limeira (61377 in chips) 
Seat 8: diabo656 (75200 in chips) 
MKL1010: posts the ante 175
DontCryClumsy88: posts the ante 175
Eux1986: posts the ante 175
moratto1992: posts the ante 175
UnterMauern: posts the ante 175
Dizzydarts: posts the ante 175
ivan limeira: posts the ante 175
diabo656: posts the ante 175
moratto1992: posts small blind 700
UnterMauern: posts big blind 1400
*** HOLE CARDS ***
Dizzydarts: folds 
ivan limeira: folds 
diabo656 has timed out
diabo656: folds 
diabo656 is sitting out
MKL1010: folds 
DontCryClumsy88: folds 
Eux1986: calls 1400
moratto1992: calls 700
diabo656 has returned
UnterMauern: checks 
*** FLOP *** [Th 4d 3h]
moratto1992: checks 
UnterMauern: checks 
Eux1986: bets 2800
moratto1992: calls 2800
UnterMauern: folds 
*** TURN *** [Th 4d 3h] [8s]
moratto1992: bets 22215 and is all-in
Eux1986: folds 
Uncalled bet (22215) returned to moratto1992
moratto1992 collected 11200 from pot
moratto1992: doesn't show hand 
*** SUMMARY ***
Total pot 11200 | Rake 0 
Board [Th 4d 3h 8s]
Seat 1: MKL1010 folded before Flop (didn't bet)
Seat 2: DontCryClumsy88 folded before Flop (didn't bet)
Seat 3: Eux1986 (button) folded on the Turn
Seat 4: moratto1992 (small blind) collected (11200)
Seat 5: UnterMauern (big blind) folded on the Flop
Seat 6: Dizzydarts folded before Flop (didn't bet)
Seat 7: ivan limeira folded before Flop (didn't bet)
Seat 8: diabo656 folded before Flop (didn't bet)

PokerStars Hand #251205757480: Tournament #3767885527, $40+$10+$5 USD Hold'em No Limit - Level XII (700/1400) - 2024/06/26 19:16:28 UTC [2024/06/26 15:16:28 ET]
Table '3767885527 96' 8-max Seat #4 is the button
Seat 1: MKL1010 (31356 in chips) 
Seat 2: DontCryClumsy88 (48853 in chips) 
Seat 3: Eux1986 (107549 in chips) 
Seat 4: moratto1992 (33415 in chips) 
Seat 5: UnterMauern (23075 in chips) 
Seat 6: Dizzydarts (23211 in chips) 
Seat 7: ivan limeira (61202 in chips) 
Seat 8: diabo656 (75025 in chips) 
MKL1010: posts the ante 175
DontCryClumsy88: posts the ante 175
Eux1986: posts the ante 175
moratto1992: posts the ante 175
UnterMauern: posts the ante 175
Dizzydarts: posts the ante 175
ivan limeira: posts the ante 175
diabo656: posts the ante 175
UnterMauern: posts small blind 700
Dizzydarts: posts big blind 1400
*** HOLE CARDS ***
MKL1010 is disconnected 
ivan limeira: folds 
diabo656: folds 
MKL1010 is connected 
MKL1010 is connected 
MKL1010: folds 
DontCryClumsy88: folds 
Eux1986: calls 1400
moratto1992: folds 
UnterMauern: folds 
Dizzydarts: checks 
*** FLOP *** [Tc 5d 5s]
Dizzydarts: checks 
Eux1986: checks 
*** TURN *** [Tc 5d 5s] [6h]
Dizzydarts: checks 
Eux1986: bets 2800
Dizzydarts: folds 
Uncalled bet (2800) returned to Eux1986
Eux1986 collected 4900 from pot
Eux1986: doesn't show hand 
*** SUMMARY ***
Total pot 4900 | Rake 0 
Board [Tc 5d 5s 6h]
Seat 1: MKL1010 folded before Flop (didn't bet)
Seat 2: DontCryClumsy88 folded before Flop (didn't bet)
Seat 3: Eux1986 collected (4900)
Seat 4: moratto1992 (button) folded before Flop (didn't bet)
Seat 5: UnterMauern (small blind) folded before Flop
Seat 6: Dizzydarts (big blind) folded on the Turn
Seat 7: ivan limeira folded before Flop (didn't bet)
Seat 8: diabo656 folded before Flop (didn't bet)

PokerStars Hand #251205771625: Tournament #3767885527, $40+$10+$5 USD Hold'em No Limit - Level XII (700/1400) - 2024/06/26 19:17:20 UTC [2024/06/26 15:17:20 ET]
Table '3767885527 96' 8-max Seat #5 is the button
Seat 1: MKL1010 (31181 in chips) 
Seat 2: DontCryClumsy88 (48678 in chips) 
Seat 3: Eux1986 (110874 in chips) 
Seat 4: moratto1992 (33240 in chips) 
Seat 5: UnterMauern (22200 in chips) 
Seat 6: Dizzydarts (21636 in chips) 
Seat 7: ivan limeira (61027 in chips) 
Seat 8: diabo656 (74850 in chips) 
MKL1010: posts the ante 175
DontCryClumsy88: posts the ante 175
Eux1986: posts the ante 175
moratto1992: posts the ante 175
UnterMauern: posts the ante 175
Dizzydarts: posts the ante 175
ivan limeira: posts the ante 175
diabo656: posts the ante 175
Dizzydarts: posts small blind 700
ivan limeira: posts big blind 1400
*** HOLE CARDS ***
diabo656 has timed out
diabo656: folds 
diabo656 is sitting out
MKL1010: folds 
diabo656 has returned
DontCryClumsy88: folds 
Eux1986: folds 
moratto1992: folds 
UnterMauern: folds 
Dizzydarts: calls 700
ivan limeira: raises 59452 to 60852 and is all-in
Dizzydarts: folds 
Uncalled bet (59452) returned to ivan limeira
ivan limeira collected 4200 from pot
ivan limeira: doesn't show hand 
*** SUMMARY ***
Total pot 4200 | Rake 0 
Seat 1: MKL1010 folded before Flop (didn't bet)
Seat 2: DontCryClumsy88 folded before Flop (didn't bet)
Seat 3: Eux1986 folded before Flop (didn't bet)
Seat 4: moratto1992 folded before Flop (didn't bet)
Seat 5: UnterMauern (button) folded before Flop (didn't bet)
Seat 6: Dizzydarts (small blind) folded before Flop
Seat 7: ivan limeira (big blind) collected (4200)
Seat 8: diabo656 folded before Flop (didn't bet)

PokerStars Hand #251205783980: Tournament #3767885527, $40+$10+$5 USD Hold'em No Limit - Level XII (700/1400) - 2024/06/26 19:18:05 UTC [2024/06/26 15:18:05 ET]
Table '3767885527 96' 8-max Seat #6 is the button
Seat 1: MKL1010 (31006 in chips) 
Seat 2: DontCryClumsy88 (48503 in chips) 
Seat 3: Eux1986 (110699 in chips) 
Seat 4: moratto1992 (33065 in chips) 
Seat 5: UnterMauern (22025 in chips) 
Seat 6: Dizzydarts (20061 in chips) 
Seat 7: ivan limeira (63652 in chips) 
Seat 8: diabo656 (74675 in chips) 
MKL1010: posts the ante 175
DontCryClumsy88: posts the ante 175
Eux1986: posts the ante 175
moratto1992: posts the ante 175
UnterMauern: posts the ante 175
Dizzydarts: posts the ante 175
ivan limeira: posts the ante 175
diabo656: posts the ante 175
ivan limeira: posts small blind 700
diabo656: posts big blind 1400
*** HOLE CARDS ***
MKL1010: folds 
DontCryClumsy88: folds 
Eux1986: folds 
moratto1992: folds 
UnterMauern: folds 
Dizzydarts: raises 1400 to 2800
ivan limeira: folds 
diabo656: calls 1400
*** FLOP *** [9d Ah Ks]
diabo656: checks 
Dizzydarts: checks 
*** TURN *** [9d Ah Ks] [Qc]
diabo656: bets 3850
Dizzydarts: folds 
Uncalled bet (3850) returned to diabo656
diabo656 collected 7700 from pot
*** SUMMARY ***
Total pot 7700 | Rake 0 
Board [9d Ah Ks Qc]
Seat 1: MKL1010 folded before Flop (didn't bet)
Seat 2: DontCryClumsy88 folded before Flop (didn't bet)
Seat 3: Eux1986 folded before Flop (didn't bet)
Seat 4: moratto1992 folded before Flop (didn't bet)
Seat 5: UnterMauern folded before Flop (didn't bet)
Seat 6: Dizzydarts (button) folded on the Turn
Seat 7: ivan limeira (small blind) folded before Flop
Seat 8: diabo656 (big blind) collected (7700)

PokerStars Hand #251205796194: Tournament #3767885527, $40+$10+$5 USD Hold'em No Limit - Level XII (700/1400) - 2024/06/26 19:18:50 UTC [2024/06/26 15:18:50 ET]
Table '3767885527 96' 8-max Seat #7 is the button
Seat 1: MKL1010 (30831 in chips) 
Seat 2: DontCryClumsy88 (48328 in chips) 
Seat 3: Eux1986 (110524 in chips) 
Seat 4: moratto1992 (32890 in chips) 
Seat 5: UnterMauern (21850 in chips) 
Seat 6: Dizzydarts (17086 in chips) 
Seat 7: ivan limeira (62777 in chips) 
Seat 8: diabo656 (79400 in chips) 
MKL1010: posts the ante 175
DontCryClumsy88: posts the ante 175
Eux1986: posts the ante 175
moratto1992: posts the ante 175
UnterMauern: posts the ante 175
Dizzydarts: posts the ante 175
ivan limeira: posts the ante 175
diabo656: posts the ante 175
diabo656: posts small blind 700
MKL1010: posts big blind 1400
*** HOLE CARDS ***
DontCryClumsy88: calls 1400
Eux1986: folds 
moratto1992: folds 
UnterMauern: folds 
Dizzydarts: calls 1400
ivan limeira: folds 
diabo656: folds 
MKL1010: checks 
*** FLOP *** [3d Qd Kh]
MKL1010: checks 
DontCryClumsy88: checks 
Dizzydarts: checks 
*** TURN *** [3d Qd Kh] [5c]
MKL1010: bets 2800
DontCryClumsy88: calls 2800
Dizzydarts: folds 
*** RIVER *** [3d Qd Kh 5c] [Ac]
MKL1010: checks 
DontCryClumsy88: bets 3927
MKL1010: calls 3927
*** SHOW DOWN ***
DontCryClumsy88: shows [Jc Td] (a straight, Ten to Ace)
MKL1010: mucks hand 
DontCryClumsy88 collected 19754 from pot
*** SUMMARY ***
Total pot 19754 | Rake 0 
Board [3d Qd Kh 5c Ac]
Seat 1: MKL1010 (big blind) mucked
Seat 2: DontCryClumsy88 showed [Jc Td] and won (19754) with a straight, Ten to Ace
Seat 3: Eux1986 folded before Flop (didn't bet)
Seat 4: moratto1992 folded before Flop (didn't bet)
Seat 5: UnterMauern folded before Flop (didn't bet)
Seat 6: Dizzydarts folded on the Turn
Seat 7: ivan limeira (button) folded before Flop (didn't bet)
Seat 8: diabo656 (small blind) folded before Flop

PokerStars Hand #251205810694: Tournament #3767885527, $40+$10+$5 USD Hold'em No Limit - Level XIII (800/1600) - 2024/06/26 19:19:43 UTC [2024/06/26 15:19:43 ET]
Table '3767885527 96' 8-max Seat #8 is the button
Seat 1: MKL1010 (22529 in chips) 
Seat 2: DontCryClumsy88 (59780 in chips) 
Seat 3: Eux1986 (110349 in chips) 
Seat 4: moratto1992 (32715 in chips) 
Seat 5: UnterMauern (21675 in chips) 
Seat 6: Dizzydarts (15511 in chips) 
Seat 7: ivan limeira (62602 in chips) 
Seat 8: diabo656 (78525 in chips) 
MKL1010: posts the ante 200
DontCryClumsy88: posts the ante 200
Eux1986: posts the ante 200
moratto1992: posts the ante 200
UnterMauern: posts the ante 200
Dizzydarts: posts the ante 200
ivan limeira: posts the ante 200
diabo656: posts the ante 200
MKL1010: posts small blind 800
DontCryClumsy88: posts big blind 1600
*** HOLE CARDS ***
Eux1986: folds 
moratto1992: folds 
UnterMauern: folds 
Dizzydarts: folds 
ivan limeira: folds 
diabo656: folds 
MKL1010: calls 800
DontCryClumsy88: checks 
*** FLOP *** [5h 9s Jc]
MKL1010: checks 
DontCryClumsy88: checks 
*** TURN *** [5h 9s Jc] [Ad]
MKL1010: checks 
DontCryClumsy88: bets 2640
MKL1010: folds 
Uncalled bet (2640) returned to DontCryClumsy88
DontCryClumsy88 collected 4800 from pot
*** SUMMARY ***
Total pot 4800 | Rake 0 
Board [5h 9s Jc Ad]
Seat 1: MKL1010 (small blind) folded on the Turn
Seat 2: DontCryClumsy88 (big blind) collected (4800)
Seat 3: Eux1986 folded before Flop (didn't bet)
Seat 4: moratto1992 folded before Flop (didn't bet)
Seat 5: UnterMauern folded before Flop (didn't bet)
Seat 6: Dizzydarts folded before Flop (didn't bet)
Seat 7: ivan limeira folded before Flop (didn't bet)
Seat 8: diabo656 (button) folded before Flop (didn't bet)

PokerStars Hand #251205820329: Tournament #3767885527, $40+$10+$5 USD Hold'em No Limit - Level XIII (800/1600) - 2024/06/26 19:20:18 UTC [2024/06/26 15:20:18 ET]
Table '3767885527 96' 8-max Seat #1 is the button
Seat 1: MKL1010 (20729 in chips) 
Seat 2: DontCryClumsy88 (62780 in chips) 
Seat 3: Eux1986 (110149 in chips) 
Seat 4: moratto1992 (32515 in chips) 
Seat 5: UnterMauern (21475 in chips) 
Seat 6: Dizzydarts (15311 in chips) 
Seat 7: ivan limeira (62402 in chips) 
Seat 8: diabo656 (78325 in chips) 
MKL1010: posts the ante 200
DontCryClumsy88: posts the ante 200
Eux1986: posts the ante 200
moratto1992: posts the ante 200
UnterMauern: posts the ante 200
Dizzydarts: posts the ante 200
ivan limeira: posts the ante 200
diabo656: posts the ante 200
DontCryClumsy88: posts small blind 800
Eux1986: posts big blind 1600
*** HOLE CARDS ***
moratto1992: folds 
UnterMauern: folds 
Dizzydarts: raises 1600 to 3200
ivan limeira: folds 
diabo656: folds 
MKL1010: folds 
DontCryClumsy88: folds 
Eux1986: calls 1600
*** FLOP *** [6d Jd 2c]
Eux1986: checks 
Dizzydarts: bets 11911 and is all-in
Eux1986: folds 
Uncalled bet (11911) returned to Dizzydarts
Dizzydarts collected 8800 from pot
Dizzydarts: doesn't show hand 
*** SUMMARY ***
Total pot 8800 | Rake 0 
Board [6d Jd 2c]
Seat 1: MKL1010 (button) folded before Flop (didn't bet)
Seat 2: DontCryClumsy88 (small blind) folded before Flop
Seat 3: Eux1986 (big blind) folded on the Flop
Seat 4: moratto1992 folded before Flop (didn't bet)
Seat 5: UnterMauern folded before Flop (didn't bet)
Seat 6: Dizzydarts collected (8800)
Seat 7: ivan limeira folded before Flop (didn't bet)
Seat 8: diabo656 folded before Flop (didn't bet)

PokerStars Hand #251205830398: Tournament #3767885527, $40+$10+$5 USD Hold'em No Limit - Level XIII (800/1600) - 2024/06/26 19:20:56 UTC [2024/06/26 15:20:56 ET]
Table '3767885527 96' 8-max Seat #2 is the button
Seat 1: MKL1010 (20529 in chips) 
Seat 2: DontCryClumsy88 (61780 in chips) 
Seat 3: Eux1986 (106749 in chips) 
Seat 4: moratto1992 (32315 in chips) 
Seat 5: UnterMauern (21275 in chips) 
Seat 6: Dizzydarts (20711 in chips) 
Seat 7: ivan limeira (62202 in chips) 
Seat 8: diabo656 (78125 in chips) 
MKL1010: posts the ante 200
DontCryClumsy88: posts the ante 200
Eux1986: posts the ante 200
moratto1992: posts the ante 200
UnterMauern: posts the ante 200
Dizzydarts: posts the ante 200
ivan limeira: posts the ante 200
diabo656: posts the ante 200
Eux1986: posts small blind 800
moratto1992: posts big blind 1600
*** HOLE CARDS ***
UnterMauern: raises 19200 to 20800
Dizzydarts: folds 
ivan limeira: folds 
diabo656: folds 
MKL1010: folds 
DontCryClumsy88: folds 
Eux1986: folds 
moratto1992: folds 
Uncalled bet (19200) returned to UnterMauern
UnterMauern collected 5600 from pot
UnterMauern: doesn't show hand 
*** SUMMARY ***
Total pot 5600 | Rake 0 
Seat 1: MKL1010 folded before Flop (didn't bet)
Seat 2: DontCryClumsy88 (button) folded before Flop (didn't bet)
Seat 3: Eux1986 (small blind) folded before Flop
Seat 4: moratto1992 (big blind) folded before Flop
Seat 5: UnterMauern collected (5600)
Seat 6: Dizzydarts folded before Flop (didn't bet)
Seat 7: ivan limeira folded before Flop (didn't bet)
Seat 8: diabo656 folded before Flop (didn't bet)

PokerStars Hand #251205840255: Tournament #3767885527, $40+$10+$5 USD Hold'em No Limit - Level XIII (800/1600) - 2024/06/26 19:21:32 UTC [2024/06/26 15:21:32 ET]
Table '3767885527 96' 8-max Seat #3 is the button
Seat 1: MKL1010 (20329 in chips) 
Seat 2: DontCryClumsy88 (61580 in chips) 
Seat 3: Eux1986 (105749 in chips) 
Seat 4: moratto1992 (30515 in chips) 
Seat 5: UnterMauern (25075 in chips) 
Seat 6: Dizzydarts (20511 in chips) 
Seat 7: ivan limeira (62002 in chips) 
Seat 8: diabo656 (77925 in chips) 
MKL1010: posts the ante 200
DontCryClumsy88: posts the ante 200
Eux1986: posts the ante 200
moratto1992: posts the ante 200
UnterMauern: posts the ante 200
Dizzydarts: posts the ante 200
ivan limeira: posts the ante 200
diabo656: posts the ante 200
moratto1992: posts small blind 800
UnterMauern: posts big blind 1600
*** HOLE CARDS ***
Dizzydarts: folds 
ivan limeira: folds 
diabo656: folds 
MKL1010: folds 
DontCryClumsy88: folds 
Eux1986: folds 
moratto1992: raises 28715 to 30315 and is all-in
UnterMauern: folds 
Uncalled bet (28715) returned to moratto1992
moratto1992 collected 4800 from pot
moratto1992: doesn't show hand 
*** SUMMARY ***
Total pot 4800 | Rake 0 
Seat 1: MKL1010 folded before Flop (didn't bet)
Seat 2: DontCryClumsy88 folded before Flop (didn't bet)
Seat 3: Eux1986 (button) folded before Flop (didn't bet)
Seat 4: moratto1992 (small blind) collected (4800)
Seat 5: UnterMauern (big blind) folded before Flop
Seat 6: Dizzydarts folded before Flop (didn't bet)
Seat 7: ivan limeira folded before Flop (didn't bet)
Seat 8: diabo656 folded before Flop (didn't bet)

PokerStars Hand #251205848401: Tournament #3767885527, $40+$10+$5 USD Hold'em No Limit - Level XIII (800/1600) - 2024/06/26 19:22:02 UTC [2024/06/26 15:22:02 ET]
Table '3767885527 96' 8-max Seat #4 is the button
Seat 1: MKL1010 (20129 in chips) 
Seat 2: DontCryClumsy88 (61380 in chips) 
Seat 3: Eux1986 (105549 in chips) 
Seat 4: moratto1992 (33515 in chips) 
Seat 5: UnterMauern (23275 in chips) 
Seat 6: Dizzydarts (20311 in chips) 
Seat 7: ivan limeira (61802 in chips) 
Seat 8: diabo656 (77725 in chips) 
MKL1010: posts the ante 200
DontCryClumsy88: posts the ante 200
Eux1986: posts the ante 200
moratto1992: posts the ante 200
UnterMauern: posts the ante 200
Dizzydarts: posts the ante 200
ivan limeira: posts the ante 200
diabo656: posts the ante 200
UnterMauern: posts small blind 800
Dizzydarts: posts big blind 1600
*** HOLE CARDS ***
ivan limeira: folds 
diabo656: calls 1600
MKL1010: folds 
DontCryClumsy88: folds 
Eux1986: folds 
moratto1992: folds 
UnterMauern: folds 
Dizzydarts: checks 
*** FLOP *** [3h 5s 9c]
Dizzydarts: checks 
diabo656: bets 5600
Dizzydarts: folds 
Uncalled bet (5600) returned to diabo656
diabo656 collected 5600 from pot
*** SUMMARY ***
Total pot 5600 | Rake 0 
Board [3h 5s 9c]
Seat 1: MKL1010 folded before Flop (didn't bet)
Seat 2: DontCryClumsy88 folded before Flop (didn't bet)
Seat 3: Eux1986 folded before Flop (didn't bet)
Seat 4: moratto1992 (button) folded before Flop (didn't bet)
Seat 5: UnterMauern (small blind) folded before Flop
Seat 6: Dizzydarts (big blind) folded on the Flop
Seat 7: ivan limeira folded before Flop (didn't bet)
Seat 8: diabo656 collected (5600)

PokerStars Hand #251205860002: Tournament #3767885527, $40+$10+$5 USD Hold'em No Limit - Level XIII (800/1600) - 2024/06/26 19:22:44 UTC [2024/06/26 15:22:44 ET]
Table '3767885527 96' 8-max Seat #5 is the button
Seat 1: MKL1010 (19929 in chips) 
Seat 2: DontCryClumsy88 (61180 in chips) 
Seat 3: Eux1986 (105349 in chips) 
Seat 4: moratto1992 (33315 in chips) 
Seat 5: UnterMauern (22275 in chips) 
Seat 6: Dizzydarts (18511 in chips) 
Seat 7: ivan limeira (61602 in chips) 
Seat 8: diabo656 (81525 in chips) 
MKL1010: posts the ante 200
DontCryClumsy88: posts the ante 200
Eux1986: posts the ante 200
moratto1992: posts the ante 200
UnterMauern: posts the ante 200
Dizzydarts: posts the ante 200
ivan limeira: posts the ante 200
diabo656: posts the ante 200
Dizzydarts: posts small blind 800
ivan limeira: posts big blind 1600
*** HOLE CARDS ***
diabo656: folds 
MKL1010: folds 
DontCryClumsy88: folds 
Eux1986: calls 1600
moratto1992: calls 1600
UnterMauern: calls 1600
Dizzydarts: raises 16711 to 18311 and is all-in
ivan limeira: folds 
Eux1986: folds 
moratto1992: folds 
UnterMauern: folds 
Uncalled bet (16711) returned to Dizzydarts
Dizzydarts collected 9600 from pot
Dizzydarts: doesn't show hand 
*** SUMMARY ***
Total pot 9600 | Rake 0 
Seat 1: MKL1010 folded before Flop (didn't bet)
Seat 2: DontCryClumsy88 folded before Flop (didn't bet)
Seat 3: Eux1986 folded before Flop
Seat 4: moratto1992 folded before Flop
Seat 5: UnterMauern (button) folded before Flop
Seat 6: Dizzydarts (small blind) collected (9600)
Seat 7: ivan limeira (big blind) folded before Flop
Seat 8: diabo656 folded before Flop (didn't bet)

PokerStars Hand #251205876143: Tournament #3767885527, $40+$10+$5 USD Hold'em No Limit - Level XIII (800/1600) - 2024/06/26 19:23:43 UTC [2024/06/26 15:23:43 ET]
Table '3767885527 96' 8-max Seat #6 is the button
Seat 1: MKL1010 (19729 in chips) 
Seat 2: DontCryClumsy88 (60980 in chips) 
Seat 3: Eux1986 (103549 in chips) 
Seat 4: moratto1992 (31515 in chips) 
Seat 5: UnterMauern (20475 in chips) 
Seat 6: Dizzydarts (26311 in chips) 
Seat 7: ivan limeira (59802 in chips) 
Seat 8: diabo656 (81325 in chips) 
MKL1010: posts the ante 200
DontCryClumsy88: posts the ante 200
Eux1986: posts the ante 200
moratto1992: posts the ante 200
UnterMauern: posts the ante 200
Dizzydarts: posts the ante 200
ivan limeira: posts the ante 200
diabo656: posts the ante 200
ivan limeira: posts small blind 800
diabo656: posts big blind 1600
*** HOLE CARDS ***
MKL1010: raises 17929 to 19529 and is all-in
DontCryClumsy88: folds 
Eux1986: folds 
moratto1992: folds 
UnterMauern: folds 
Dizzydarts: folds 
ivan limeira: folds 
diabo656 is disconnected 
diabo656 is connected 
diabo656 is connected 
diabo656: folds 
Uncalled bet (17929) returned to MKL1010
MKL1010 collected 5600 from pot
MKL1010: doesn't show hand 
*** SUMMARY ***
Total pot 5600 | Rake 0 
Seat 1: MKL1010 collected (5600)
Seat 2: DontCryClumsy88 folded before Flop (didn't bet)
Seat 3: Eux1986 folded before Flop (didn't bet)
Seat 4: moratto1992 folded before Flop (didn't bet)
Seat 5: UnterMauern folded before Flop (didn't bet)
Seat 6: Dizzydarts (button) folded before Flop (didn't bet)
Seat 7: ivan limeira (small blind) folded before Flop
Seat 8: diabo656 (big blind) folded before Flop

PokerStars Hand #251205887405: Tournament #3767885527, $40+$10+$5 USD Hold'em No Limit - Level XIII (800/1600) - 2024/06/26 19:24:24 UTC [2024/06/26 15:24:24 ET]
Table '3767885527 96' 8-max Seat #7 is the button
Seat 1: MKL1010 (23529 in chips) 
Seat 2: DontCryClumsy88 (60780 in chips) 
Seat 3: Eux1986 (103349 in chips) 
Seat 4: moratto1992 (31315 in chips) 
Seat 5: UnterMauern (20275 in chips) 
Seat 6: Dizzydarts (26111 in chips) 
Seat 7: ivan limeira (58802 in chips) 
Seat 8: diabo656 (79525 in chips) 
MKL1010: posts the ante 200
DontCryClumsy88: posts the ante 200
Eux1986: posts the ante 200
moratto1992: posts the ante 200
UnterMauern: posts the ante 200
Dizzydarts: posts the ante 200
ivan limeira: posts the ante 200
diabo656: posts the ante 200
diabo656: posts small blind 800
MKL1010: posts big blind 1600
*** HOLE CARDS ***
DontCryClumsy88: folds 
Eux1986: raises 1600 to 3200
moratto1992: raises 4160 to 7360
UnterMauern: folds 
Dizzydarts: folds 
ivan limeira: folds 
diabo656 is connected 
diabo656 is connected 
diabo656: folds 
MKL1010: folds 
Eux1986: raises 95789 to 103149 and is all-in
moratto1992: folds 
Uncalled bet (95789) returned to Eux1986
Eux1986 collected 18720 from pot
Eux1986: doesn't show hand 
*** SUMMARY ***
Total pot 18720 | Rake 0 
Seat 1: MKL1010 (big blind) folded before Flop
Seat 2: DontCryClumsy88 folded before Flop (didn't bet)
Seat 3: Eux1986 collected (18720)
Seat 4: moratto1992 folded before Flop
Seat 5: UnterMauern folded before Flop (didn't bet)
Seat 6: Dizzydarts folded before Flop (didn't bet)
Seat 7: ivan limeira (button) folded before Flop (didn't bet)
Seat 8: diabo656 (small blind) folded before Flop

PokerStars Hand #251205907060: Tournament #3767885527, $40+$10+$5 USD Hold'em No Limit - Level XIII (800/1600) - 2024/06/26 19:25:35 UTC [2024/06/26 15:25:35 ET]
Table '3767885527 96' 8-max Seat #8 is the button
Seat 1: MKL1010 (21729 in chips) 
Seat 2: DontCryClumsy88 (60580 in chips) 
Seat 3: Eux1986 (114509 in chips) 
Seat 4: moratto1992 (23755 in chips) 
Seat 5: UnterMauern (20075 in chips) 
Seat 6: Dizzydarts (25911 in chips) 
Seat 7: ivan limeira (58602 in chips) 
Seat 8: diabo656 (78525 in chips) 
MKL1010: posts the ante 200
DontCryClumsy88: posts the ante 200
Eux1986: posts the ante 200
moratto1992: posts the ante 200
UnterMauern: posts the ante 200
Dizzydarts: posts the ante 200
ivan limeira: posts the ante 200
diabo656: posts the ante 200
MKL1010: posts small blind 800
DontCryClumsy88: posts big blind 1600
*** HOLE CARDS ***
Eux1986: folds 
moratto1992: raises 1600 to 3200
UnterMauern: folds 
Dizzydarts: folds 
ivan limeira: folds 
diabo656: folds 
MKL1010: folds 
DontCryClumsy88: folds 
Uncalled bet (1600) returned to moratto1992
moratto1992 collected 5600 from pot
moratto1992: doesn't show hand 
*** SUMMARY ***
Total pot 5600 | Rake 0 
Seat 1: MKL1010 (small blind) folded before Flop
Seat 2: DontCryClumsy88 (big blind) folded before Flop
Seat 3: Eux1986 folded before Flop (didn't bet)
Seat 4: moratto1992 collected (5600)
Seat 5: UnterMauern folded before Flop (didn't bet)
Seat 6: Dizzydarts folded before Flop (didn't bet)
Seat 7: ivan limeira folded before Flop (didn't bet)
Seat 8: diabo656 (button) folded before Flop (didn't bet)

PokerStars Hand #251205914078: Tournament #3767885527, $40+$10+$5 USD Hold'em No Limit - Level XIII (800/1600) - 2024/06/26 19:26:01 UTC [2024/06/26 15:26:01 ET]
Table '3767885527 96' 8-max Seat #1 is the button
Seat 1: MKL1010 (20729 in chips) 
Seat 2: DontCryClumsy88 (58780 in chips) 
Seat 3: Eux1986 (114309 in chips) 
Seat 4: moratto1992 (27555 in chips) 
Seat 5: UnterMauern (19875 in chips) 
Seat 6: Dizzydarts (25711 in chips) 
Seat 7: ivan limeira (58402 in chips) 
Seat 8: diabo656 (78325 in chips) 
MKL1010: posts the ante 200
DontCryClumsy88: posts the ante 200
Eux1986: posts the ante 200
moratto1992: posts the ante 200
UnterMauern: posts the ante 200
Dizzydarts: posts the ante 200
ivan limeira: posts the ante 200
diabo656: posts the ante 200
DontCryClumsy88: posts small blind 800
Eux1986: posts big blind 1600
*** HOLE CARDS ***
moratto1992: folds 
UnterMauern: raises 18075 to 19675 and is all-in
Dizzydarts: folds 
ivan limeira: folds 
diabo656: calls 19675
MKL1010: folds 
DontCryClumsy88: folds 
Eux1986: folds 
*** FLOP *** [6s 5c 3s]
*** TURN *** [6s 5c 3s] [Jh]
*** RIVER *** [6s 5c 3s Jh] [Th]
*** SHOW DOWN ***
UnterMauern: shows [6d Ah] (a pair of Sixes)
diabo656: shows [8s 8c] (a pair of Eights)
diabo656 collected 43350 from pot
UnterMauern finished the tournament
*** SUMMARY ***
Total pot 43350 | Rake 0 
Board [6s 5c 3s Jh Th]
Seat 1: MKL1010 (button) folded before Flop (didn't bet)
Seat 2: DontCryClumsy88 (small blind) folded before Flop
Seat 3: Eux1986 (big blind) folded before Flop
Seat 4: moratto1992 folded before Flop (didn't bet)
Seat 5: UnterMauern showed [6d Ah] and lost with a pair of Sixes
Seat 6: Dizzydarts folded before Flop (didn't bet)
Seat 7: ivan limeira folded before Flop (didn't bet)
Seat 8: diabo656 showed [8s 8c] and won (43350) with a pair of Eights

PokerStars Hand #251205922433: Tournament #3767885527, $40+$10+$5 USD Hold'em No Limit - Level XIII (800/1600) - 2024/06/26 19:26:31 UTC [2024/06/26 15:26:31 ET]
Table '3767885527 96' 8-max Seat #2 is the button
Seat 1: MKL1010 (20529 in chips) 
Seat 2: DontCryClumsy88 (57780 in chips) 
Seat 3: Eux1986 (112509 in chips) 
Seat 4: moratto1992 (27355 in chips) 
Seat 6: Dizzydarts (25511 in chips) 
Seat 7: ivan limeira (58202 in chips) 
Seat 8: diabo656 (101800 in chips) 
MKL1010: posts the ante 200
DontCryClumsy88: posts the ante 200
Eux1986: posts the ante 200
moratto1992: posts the ante 200
Dizzydarts: posts the ante 200
ivan limeira: posts the ante 200
diabo656: posts the ante 200
Eux1986: posts small blind 800
moratto1992: posts big blind 1600
*** HOLE CARDS ***
Dizzydarts: folds 
ivan limeira: folds 
diabo656: folds 
MKL1010: folds 
DontCryClumsy88: folds 
Eux1986: calls 800
moratto1992: checks 
*** FLOP *** [3c Jh 6c]
Eux1986: checks 
moratto1992: checks 
*** TURN *** [3c Jh 6c] [Qd]
Ace-hai is disconnected 
Eux1986: checks 
moratto1992: bets 1600
Eux1986: folds 
Uncalled bet (1600) returned to moratto1992
moratto1992 collected 4600 from pot
moratto1992: doesn't show hand 
*** SUMMARY ***
Total pot 4600 | Rake 0 
Board [3c Jh 6c Qd]
Seat 1: MKL1010 folded before Flop (didn't bet)
Seat 2: DontCryClumsy88 (button) folded before Flop (didn't bet)
Seat 3: Eux1986 (small blind) folded on the Turn
Seat 4: moratto1992 (big blind) collected (4600)
Seat 6: Dizzydarts folded before Flop (didn't bet)
Seat 7: ivan limeira folded before Flop (didn't bet)
Seat 8: diabo656 folded before Flop (didn't bet)

PokerStars Hand #251205940461: Tournament #3767885527, $40+$10+$5 USD Hold'em No Limit - Level XIII (800/1600) - 2024/06/26 19:27:38 UTC [2024/06/26 15:27:38 ET]
Table '3767885527 96' 8-max Seat #3 is the button
Seat 1: MKL1010 (20329 in chips) 
Seat 2: DontCryClumsy88 (57580 in chips) 
Seat 3: Eux1986 (110709 in chips) 
Seat 4: moratto1992 (30155 in chips) 
Seat 5: Ace-hai (25000 in chips) 
Seat 6: Dizzydarts (25311 in chips) 
Seat 7: ivan limeira (58002 in chips) 
Seat 8: diabo656 (101600 in chips) 
MKL1010: posts the ante 200
DontCryClumsy88: posts the ante 200
Eux1986: posts the ante 200
moratto1992: posts the ante 200
Ace-hai: posts the ante 200
Dizzydarts: posts the ante 200
ivan limeira: posts the ante 200
diabo656: posts the ante 200
moratto1992: posts small blind 800
Ace-hai: posts big blind 1600
*** HOLE CARDS ***
Dizzydarts: folds 
ivan limeira: folds 
diabo656: folds 
MKL1010: raises 18529 to 20129 and is all-in
DontCryClumsy88: folds 
Eux1986: raises 18529 to 38658
moratto1992: folds 
Ace-hai: calls 23200 and is all-in
Uncalled bet (13858) returned to Eux1986
*** FLOP *** [5c 9s 3d]
*** TURN *** [5c 9s 3d] [6s]
*** RIVER *** [5c 9s 3d 6s] [Js]
*** SHOW DOWN ***
Ace-hai: shows [Td Ts] (a pair of Tens)
Eux1986: shows [Kh Jh] (a pair of Jacks)
Eux1986 collected 9342 from side pot
MKL1010: shows [As 3s] (a flush, Ace high)
MKL1010 collected 62787 from main pot
Ace-hai finished the tournament
*** SUMMARY ***
Total pot 72129 Main pot 62787. Side pot 9342. | Rake 0 
Board [5c 9s 3d 6s Js]
Seat 1: MKL1010 showed [As 3s] and won (62787) with a flush, Ace high
Seat 2: DontCryClumsy88 folded before Flop (didn't bet)
Seat 3: Eux1986 (button) showed [Kh Jh] and won (9342) with a pair of Jacks
Seat 4: moratto1992 (small blind) folded before Flop
Seat 5: Ace-hai (big blind) showed [Td Ts] and lost with a pair of Tens
Seat 6: Dizzydarts folded before Flop (didn't bet)
Seat 7: ivan limeira folded before Flop (didn't bet)
Seat 8: diabo656 folded before Flop (didn't bet)

PokerStars Hand #251205952611: Tournament #3767885527, $40+$10+$5 USD Hold'em No Limit - Level XIII (800/1600) - 2024/06/26 19:28:24 UTC [2024/06/26 15:28:24 ET]
Table '3767885527 96' 8-max Seat #4 is the button
Seat 1: MKL1010 (62787 in chips) 
Seat 2: DontCryClumsy88 (57380 in chips) 
Seat 3: Eux1986 (95051 in chips) 
Seat 4: moratto1992 (29155 in chips) 
Seat 6: Dizzydarts (25111 in chips) 
Seat 7: ivan limeira (57802 in chips) 
Seat 8: diabo656 (101400 in chips) 
MKL1010: posts the ante 200
DontCryClumsy88: posts the ante 200
Eux1986: posts the ante 200
moratto1992: posts the ante 200
Dizzydarts: posts the ante 200
ivan limeira: posts the ante 200
diabo656: posts the ante 200
Dizzydarts: posts small blind 800
ivan limeira: posts big blind 1600
*** HOLE CARDS ***
diabo656: calls 1600
MKL1010: folds 
DontCryClumsy88: calls 1600
Eux1986: folds 
moratto1992: folds 
Dizzydarts: calls 800
ivan limeira: raises 56002 to 57602 and is all-in
diabo656: folds 
DontCryClumsy88: folds 
Dizzydarts: folds 
Uncalled bet (56002) returned to ivan limeira
ivan limeira collected 7800 from pot
ivan limeira: doesn't show hand 
*** SUMMARY ***
Total pot 7800 | Rake 0 
Seat 1: MKL1010 folded before Flop (didn't bet)
Seat 2: DontCryClumsy88 folded before Flop
Seat 3: Eux1986 folded before Flop (didn't bet)
Seat 4: moratto1992 (button) folded before Flop (didn't bet)
Seat 6: Dizzydarts (small blind) folded before Flop
Seat 7: ivan limeira (big blind) collected (7800)
Seat 8: diabo656 folded before Flop

PokerStars Hand #251205962072: Tournament #3767885527, $40+$10+$5 USD Hold'em No Limit - Level XIII (800/1600) - 2024/06/26 19:28:59 UTC [2024/06/26 15:28:59 ET]
Table '3767885527 96' 8-max Seat #6 is the button
Seat 1: MKL1010 (62587 in chips) 
Seat 2: DontCryClumsy88 (55580 in chips) 
Seat 3: Eux1986 (94851 in chips) 
Seat 4: moratto1992 (28955 in chips) 
Seat 6: Dizzydarts (23311 in chips) 
Seat 7: ivan limeira (63802 in chips) 
Seat 8: diabo656 (99600 in chips) 
MKL1010: posts the ante 200
DontCryClumsy88: posts the ante 200
Eux1986: posts the ante 200
moratto1992: posts the ante 200
Dizzydarts: posts the ante 200
ivan limeira: posts the ante 200
diabo656: posts the ante 200
ivan limeira: posts small blind 800
diabo656: posts big blind 1600
*** HOLE CARDS ***
MKL1010: folds 
DontCryClumsy88: calls 1600
Eux1986: folds 
moratto1992: folds 
Dizzydarts: folds 
ivan limeira: calls 800
diabo656: checks 
*** FLOP *** [Jh 3d Qd]
ivan limeira: checks 
cardinals970 is disconnected 
diabo656: checks 
DontCryClumsy88: bets 2046
ivan limeira: folds 
diabo656: folds 
Uncalled bet (2046) returned to DontCryClumsy88
DontCryClumsy88 collected 6200 from pot
*** SUMMARY ***
Total pot 6200 | Rake 0 
Board [Jh 3d Qd]
Seat 1: MKL1010 folded before Flop (didn't bet)
Seat 2: DontCryClumsy88 collected (6200)
Seat 3: Eux1986 folded before Flop (didn't bet)
Seat 4: moratto1992 folded before Flop (didn't bet)
Seat 6: Dizzydarts (button) folded before Flop (didn't bet)
Seat 7: ivan limeira (small blind) folded on the Flop
Seat 8: diabo656 (big blind) folded on the Flop

PokerStars Hand #251205977881: Tournament #3767885527, $40+$10+$5 USD Hold'em No Limit - Level XIV (1000/2000) - 2024/06/26 19:29:57 UTC [2024/06/26 15:29:57 ET]
Table '3767885527 96' 8-max Seat #7 is the button
Seat 1: MKL1010 (62387 in chips) 
Seat 2: DontCryClumsy88 (59980 in chips) 
Seat 3: Eux1986 (94651 in chips) 
Seat 4: moratto1992 (28755 in chips) 
Seat 5: cardinals970 (25000 in chips) 
Seat 6: Dizzydarts (23111 in chips) 
Seat 7: ivan limeira (62002 in chips) 
Seat 8: diabo656 (97800 in chips) 
MKL1010: posts the ante 250
DontCryClumsy88: posts the ante 250
Eux1986: posts the ante 250
moratto1992: posts the ante 250
cardinals970: posts the ante 250
Dizzydarts: posts the ante 250
ivan limeira: posts the ante 250
diabo656: posts the ante 250
diabo656: posts small blind 1000
MKL1010: posts big blind 2000
*** HOLE CARDS ***
DontCryClumsy88: folds 
Eux1986: folds 
moratto1992: folds 
cardinals970: folds 
Dizzydarts: folds 
ivan limeira: raises 2000 to 4000
diabo656: folds 
MKL1010: calls 2000
*** FLOP *** [8d Kh 7c]
MKL1010: checks 
ivan limeira: bets 2750
MKL1010: calls 2750
*** TURN *** [8d Kh 7c] [3h]
MKL1010: checks 
ivan limeira: checks 
*** RIVER *** [8d Kh 7c 3h] [8h]
MKL1010: bets 8250
ivan limeira: calls 8250
*** SHOW DOWN ***
MKL1010: shows [Kc Qh] (two pair, Kings and Eights)
ivan limeira: mucks hand 
MKL1010 collected 33000 from pot
*** SUMMARY ***
Total pot 33000 | Rake 0 
Board [8d Kh 7c 3h 8h]
Seat 1: MKL1010 (big blind) showed [Kc Qh] and won (33000) with two pair, Kings and Eights
Seat 2: DontCryClumsy88 folded before Flop (didn't bet)
Seat 3: Eux1986 folded before Flop (didn't bet)
Seat 4: moratto1992 folded before Flop (didn't bet)
Seat 5: cardinals970 folded before Flop (didn't bet)
Seat 6: Dizzydarts folded before Flop (didn't bet)
Seat 7: ivan limeira (button) mucked
Seat 8: diabo656 (small blind) folded before Flop

PokerStars Hand #251205994012: Tournament #3767885527, $40+$10+$5 USD Hold'em No Limit - Level XIV (1000/2000) - 2024/06/26 19:30:56 UTC [2024/06/26 15:30:56 ET]
Table '3767885527 96' 8-max Seat #8 is the button
Seat 1: MKL1010 (80137 in chips) 
Seat 2: DontCryClumsy88 (59730 in chips) 
Seat 3: Eux1986 (94401 in chips) 
Seat 4: moratto1992 (28505 in chips) 
Seat 5: cardinals970 (24750 in chips) 
Seat 6: Dizzydarts (22861 in chips) 
Seat 7: ivan limeira (46752 in chips) 
Seat 8: diabo656 (96550 in chips) 
MKL1010: posts the ante 250
DontCryClumsy88: posts the ante 250
Eux1986: posts the ante 250
moratto1992: posts the ante 250
cardinals970: posts the ante 250
Dizzydarts: posts the ante 250
ivan limeira: posts the ante 250
diabo656: posts the ante 250
MKL1010: posts small blind 1000
DontCryClumsy88: posts big blind 2000
*** HOLE CARDS ***
Eux1986: folds 
moratto1992: folds 
cardinals970: folds 
Dizzydarts: folds 
ivan limeira: raises 2000 to 4000
diabo656: calls 4000
MKL1010: folds 
DontCryClumsy88: calls 2000
*** FLOP *** [4d 3s Ac]
DontCryClumsy88: checks 
ivan limeira: bets 3750
diabo656: raises 3750 to 7500
DontCryClumsy88: folds 
ivan limeira: calls 3750
*** TURN *** [4d 3s Ac] [3h]
ivan limeira: checks 
diabo656: bets 84800 and is all-in
ivan limeira: folds 
Uncalled bet (84800) returned to diabo656
diabo656 collected 30000 from pot
*** SUMMARY ***
Total pot 30000 | Rake 0 
Board [4d 3s Ac 3h]
Seat 1: MKL1010 (small blind) folded before Flop
Seat 2: DontCryClumsy88 (big blind) folded on the Flop
Seat 3: Eux1986 folded before Flop (didn't bet)
Seat 4: moratto1992 folded before Flop (didn't bet)
Seat 5: cardinals970 folded before Flop (didn't bet)
Seat 6: Dizzydarts folded before Flop (didn't bet)
Seat 7: ivan limeira folded on the Turn
Seat 8: diabo656 (button) collected (30000)

PokerStars Hand #251206012118: Tournament #3767885527, $40+$10+$5 USD Hold'em No Limit - Level XIV (1000/2000) - 2024/06/26 19:32:01 UTC [2024/06/26 15:32:01 ET]
Table '3767885527 96' 8-max Seat #1 is the button
Seat 1: MKL1010 (78887 in chips) 
Seat 2: DontCryClumsy88 (55480 in chips) 
Seat 3: Eux1986 (94151 in chips) 
Seat 4: moratto1992 (28255 in chips) 
Seat 5: cardinals970 (24500 in chips) 
Seat 6: Dizzydarts (22611 in chips) 
Seat 7: ivan limeira (35002 in chips) 
Seat 8: diabo656 (114800 in chips) 
MKL1010: posts the ante 250
DontCryClumsy88: posts the ante 250
Eux1986: posts the ante 250
moratto1992: posts the ante 250
cardinals970: posts the ante 250
Dizzydarts: posts the ante 250
ivan limeira: posts the ante 250
diabo656: posts the ante 250
DontCryClumsy88: posts small blind 1000
Eux1986: posts big blind 2000
*** HOLE CARDS ***
moratto1992: folds 
cardinals970: folds 
Dizzydarts: folds 
ivan limeira: raises 2000 to 4000
diabo656: folds 
MKL1010: folds 
DontCryClumsy88: folds 
Eux1986: folds 
Uncalled bet (2000) returned to ivan limeira
ivan limeira collected 7000 from pot
ivan limeira: doesn't show hand 
*** SUMMARY ***
Total pot 7000 | Rake 0 
Seat 1: MKL1010 (button) folded before Flop (didn't bet)
Seat 2: DontCryClumsy88 (small blind) folded before Flop
Seat 3: Eux1986 (big blind) folded before Flop
Seat 4: moratto1992 folded before Flop (didn't bet)
Seat 5: cardinals970 folded before Flop (didn't bet)
Seat 6: Dizzydarts folded before Flop (didn't bet)
Seat 7: ivan limeira collected (7000)
Seat 8: diabo656 folded before Flop (didn't bet)

PokerStars Hand #251206023652: Tournament #3767885527, $40+$10+$5 USD Hold'em No Limit - Level XIV (1000/2000) - 2024/06/26 19:32:43 UTC [2024/06/26 15:32:43 ET]
Table '3767885527 96' 8-max Seat #2 is the button
Seat 1: MKL1010 (78637 in chips) 
Seat 2: DontCryClumsy88 (54230 in chips) 
Seat 3: Eux1986 (91901 in chips) 
Seat 4: moratto1992 (28005 in chips) 
Seat 5: cardinals970 (24250 in chips) 
Seat 6: Dizzydarts (22361 in chips) 
Seat 7: ivan limeira (39752 in chips) 
Seat 8: diabo656 (114550 in chips) 
MKL1010: posts the ante 250
DontCryClumsy88: posts the ante 250
Eux1986: posts the ante 250
moratto1992: posts the ante 250
cardinals970: posts the ante 250
Dizzydarts: posts the ante 250
ivan limeira: posts the ante 250
diabo656: posts the ante 250
Eux1986: posts small blind 1000
moratto1992: posts big blind 2000
*** HOLE CARDS ***
cardinals970: folds 
Dizzydarts: folds 
ivan limeira: raises 2000 to 4000
diabo656: folds 
MKL1010: folds 
DontCryClumsy88: folds 
Eux1986: calls 3000
moratto1992: folds 
*** FLOP *** [7s 4d Qd]
Eux1986: checks 
ivan limeira: bets 3000
Eux1986: calls 3000
*** TURN *** [7s 4d Qd] [3h]
Eux1986: checks 
ivan limeira: bets 9000
Eux1986: folds 
Uncalled bet (9000) returned to ivan limeira
ivan limeira collected 18000 from pot
ivan limeira: doesn't show hand 
*** SUMMARY ***
Total pot 18000 | Rake 0 
Board [7s 4d Qd 3h]
Seat 1: MKL1010 folded before Flop (didn't bet)
Seat 2: DontCryClumsy88 (button) folded before Flop (didn't bet)
Seat 3: Eux1986 (small blind) folded on the Turn
Seat 4: moratto1992 (big blind) folded before Flop
Seat 5: cardinals970 folded before Flop (didn't bet)
Seat 6: Dizzydarts folded before Flop (didn't bet)
Seat 7: ivan limeira collected (18000)
Seat 8: diabo656 folded before Flop (didn't bet)

PokerStars Hand #251206039056: Tournament #3767885527, $40+$10+$5 USD Hold'em No Limit - Level XIV (1000/2000) - 2024/06/26 19:33:40 UTC [2024/06/26 15:33:40 ET]
Table '3767885527 96' 8-max Seat #3 is the button
Seat 1: MKL1010 (78387 in chips) 
Seat 2: DontCryClumsy88 (53980 in chips) 
Seat 3: Eux1986 (84651 in chips) 
Seat 4: moratto1992 (25755 in chips) 
Seat 5: cardinals970 (24000 in chips) 
Seat 6: Dizzydarts (22111 in chips) 
Seat 7: ivan limeira (50502 in chips) 
Seat 8: diabo656 (114300 in chips) 
MKL1010: posts the ante 250
DontCryClumsy88: posts the ante 250
Eux1986: posts the ante 250
moratto1992: posts the ante 250
cardinals970: posts the ante 250
Dizzydarts: posts the ante 250
ivan limeira: posts the ante 250
diabo656: posts the ante 250
moratto1992: posts small blind 1000
cardinals970: posts big blind 2000
*** HOLE CARDS ***
Dizzydarts: folds 
ivan limeira: raises 2000 to 4000
diabo656: calls 4000
MKL1010: folds 
DontCryClumsy88: calls 4000
Eux1986: raises 6000 to 10000
moratto1992: folds 
cardinals970: folds 
ivan limeira: folds 
diabo656: calls 6000
DontCryClumsy88: calls 6000
*** FLOP *** [8s 7c Ks]
diabo656: checks 
DontCryClumsy88: checks 
Eux1986: bets 26000
diabo656: folds 
DontCryClumsy88: raises 17730 to 43730 and is all-in
Eux1986: calls 17730
*** TURN *** [8s 7c Ks] [6d]
*** RIVER *** [8s 7c Ks 6d] [3c]
*** SHOW DOWN ***
DontCryClumsy88: shows [7d 7s] (three of a kind, Sevens)
Eux1986: shows [As Ad] (a pair of Aces)
DontCryClumsy88 collected 126460 from pot
*** SUMMARY ***
Total pot 126460 | Rake 0 
Board [8s 7c Ks 6d 3c]
Seat 1: MKL1010 folded before Flop (didn't bet)
Seat 2: DontCryClumsy88 showed [7d 7s] and won (126460) with three of a kind, Sevens
Seat 3: Eux1986 (button) showed [As Ad] and lost with a pair of Aces
Seat 4: moratto1992 (small blind) folded before Flop
Seat 5: cardinals970 (big blind) folded before Flop
Seat 6: Dizzydarts folded before Flop (didn't bet)
Seat 7: ivan limeira folded before Flop
Seat 8: diabo656 folded on the Flop

PokerStars Hand #251206056776: Tournament #3767885527, $40+$10+$5 USD Hold'em No Limit - Level XIV (1000/2000) - 2024/06/26 19:34:45 UTC [2024/06/26 15:34:45 ET]
Table '3767885527 96' 8-max Seat #4 is the button
Seat 1: MKL1010 (78137 in chips) 
Seat 2: DontCryClumsy88 (126460 in chips) 
Seat 3: Eux1986 (30671 in chips) 
Seat 4: moratto1992 (24505 in chips) 
Seat 5: cardinals970 (21750 in chips) 
Seat 6: Dizzydarts (21861 in chips) 
Seat 7: ivan limeira (46252 in chips) 
Seat 8: diabo656 (104050 in chips) 
MKL1010: posts the ante 250
DontCryClumsy88: posts the ante 250
Eux1986: posts the ante 250
moratto1992: posts the ante 250
cardinals970: posts the ante 250
Dizzydarts: posts the ante 250
ivan limeira: posts the ante 250
diabo656: posts the ante 250
cardinals970: posts small blind 1000
Dizzydarts: posts big blind 2000
*** HOLE CARDS ***
ivan limeira: folds 
diabo656: folds 
MKL1010: folds 
DontCryClumsy88: raises 2000 to 4000
Eux1986: folds 
moratto1992: raises 20255 to 24255 and is all-in
cardinals970: folds 
Dizzydarts: folds 
DontCryClumsy88: calls 20255
*** FLOP *** [Js 4h Kc]
*** TURN *** [Js 4h Kc] [7s]
*** RIVER *** [Js 4h Kc 7s] [Jc]
*** SHOW DOWN ***
DontCryClumsy88: shows [Ks Ac] (two pair, Kings and Jacks)
moratto1992: shows [8h Kh] (two pair, Kings and Jacks - lower kicker)
DontCryClumsy88 collected 53510 from pot
moratto1992 finished the tournament
*** SUMMARY ***
Total pot 53510 | Rake 0 
Board [Js 4h Kc 7s Jc]
Seat 1: MKL1010 folded before Flop (didn't bet)
Seat 2: DontCryClumsy88 showed [Ks Ac] and won (53510) with two pair, Kings and Jacks
Seat 3: Eux1986 folded before Flop (didn't bet)
Seat 4: moratto1992 (button) showed [8h Kh] and lost with two pair, Kings and Jacks
Seat 5: cardinals970 (small blind) folded before Flop
Seat 6: Dizzydarts (big blind) folded before Flop
Seat 7: ivan limeira folded before Flop (didn't bet)
Seat 8: diabo656 folded before Flop (didn't bet)

PokerStars Hand #251206064993: Tournament #3767885527, $40+$10+$5 USD Hold'em No Limit - Level XIV (1000/2000) - 2024/06/26 19:35:15 UTC [2024/06/26 15:35:15 ET]
Table '3767885527 96' 8-max Seat #5 is the button
Seat 1: MKL1010 (77887 in chips) 
Seat 2: DontCryClumsy88 (155465 in chips) 
Seat 3: Eux1986 (30421 in chips) 
Seat 5: cardinals970 (20500 in chips) 
Seat 6: Dizzydarts (19611 in chips) 
Seat 7: ivan limeira (46002 in chips) 
Seat 8: diabo656 (103800 in chips) 
MKL1010: posts the ante 250
DontCryClumsy88: posts the ante 250
Eux1986: posts the ante 250
cardinals970: posts the ante 250
Dizzydarts: posts the ante 250
ivan limeira: posts the ante 250
diabo656: posts the ante 250
Dizzydarts: posts small blind 1000
ivan limeira: posts big blind 2000
*** HOLE CARDS ***
diabo656: folds 
MKL1010: folds 
DontCryClumsy88: folds 
Eux1986: folds 
cardinals970: raises 18250 to 20250 and is all-in
Dizzydarts: calls 18361 and is all-in
ivan limeira: folds 
Uncalled bet (889) returned to cardinals970
*** FLOP *** [5c 2s 5d]
*** TURN *** [5c 2s 5d] [4c]
*** RIVER *** [5c 2s 5d 4c] [4h]
*** SHOW DOWN ***
Dizzydarts: shows [6d 6s] (two pair, Sixes and Fives)
cardinals970: shows [Kc Kh] (two pair, Kings and Fives)
cardinals970 collected 42472 from pot
Dizzydarts finished the tournament
*** SUMMARY ***
Total pot 42472 | Rake 0 
Board [5c 2s 5d 4c 4h]
Seat 1: MKL1010 folded before Flop (didn't bet)
Seat 2: DontCryClumsy88 folded before Flop (didn't bet)
Seat 3: Eux1986 folded before Flop (didn't bet)
Seat 5: cardinals970 (button) showed [Kc Kh] and won (42472) with two pair, Kings and Fives
Seat 6: Dizzydarts (small blind) showed [6d 6s] and lost with two pair, Sixes and Fives
Seat 7: ivan limeira (big blind) folded before Flop
Seat 8: diabo656 folded before Flop (didn't bet)

PokerStars Hand #251206077467: Tournament #3767885527, $40+$10+$5 USD Hold'em No Limit - Level XIV (1000/2000) - 2024/06/26 19:36:00 UTC [2024/06/26 15:36:00 ET]
Table '3767885527 96' 8-max Seat #7 is the button
Seat 1: MKL1010 (77637 in chips) 
Seat 2: DontCryClumsy88 (155215 in chips) 
Seat 3: Eux1986 (30171 in chips) 
Seat 4: Bigprad (89372 in chips) 
Seat 5: cardinals970 (43361 in chips) 
Seat 7: ivan limeira (43752 in chips) 
Seat 8: diabo656 (103550 in chips) 
MKL1010: posts the ante 250
DontCryClumsy88: posts the ante 250
Eux1986: posts the ante 250
Bigprad: posts the ante 250
cardinals970: posts the ante 250
ivan limeira: posts the ante 250
diabo656: posts the ante 250
diabo656: posts small blind 1000
MKL1010: posts big blind 2000
*** HOLE CARDS ***
DontCryClumsy88: raises 2000 to 4000
Eux1986: folds 
Bigprad: folds 
cardinals970: folds 
ivan limeira: raises 6000 to 10000
diabo656: calls 9000
MKL1010: folds 
DontCryClumsy88: folds 
*** FLOP *** [9s 6s 5d]
diabo656: checks 
ivan limeira: bets 9158
diabo656: calls 9158
*** TURN *** [9s 6s 5d] [6c]
Dueces4Days is disconnected 
diabo656: checks 
ivan limeira: checks 
*** RIVER *** [9s 6s 5d 6c] [Ad]
diabo656: checks 
ivan limeira: checks 
*** SHOW DOWN ***
diabo656: shows [Qd As] (two pair, Aces and Sixes)
ivan limeira: mucks hand 
diabo656 collected 46066 from pot
*** SUMMARY ***
Total pot 46066 | Rake 0 
Board [9s 6s 5d 6c Ad]
Seat 1: MKL1010 (big blind) folded before Flop
Seat 2: DontCryClumsy88 folded before Flop
Seat 3: Eux1986 folded before Flop (didn't bet)
Seat 4: Bigprad folded before Flop (didn't bet)
Seat 5: cardinals970 folded before Flop (didn't bet)
Seat 7: ivan limeira (button) mucked
Seat 8: diabo656 (small blind) showed [Qd As] and won (46066) with two pair, Aces and Sixes

PokerStars Hand #251206096899: Tournament #3767885527, $40+$10+$5 USD Hold'em No Limit - Level XIV (1000/2000) - 2024/06/26 19:37:11 UTC [2024/06/26 15:37:11 ET]
Table '3767885527 96' 8-max Seat #8 is the button
Seat 1: MKL1010 (75387 in chips) 
Seat 2: DontCryClumsy88 (150965 in chips) 
Seat 3: Eux1986 (29921 in chips) 
Seat 4: Bigprad (89122 in chips) 
Seat 5: cardinals970 (43111 in chips) 
Seat 6: Dueces4Days (141708 in chips) 
Seat 7: ivan limeira (24344 in chips) 
Seat 8: diabo656 (130208 in chips) 
MKL1010: posts the ante 250
DontCryClumsy88: posts the ante 250
Eux1986: posts the ante 250
Bigprad: posts the ante 250
cardinals970: posts the ante 250
Dueces4Days: posts the ante 250
ivan limeira: posts the ante 250
diabo656: posts the ante 250
MKL1010: posts small blind 1000
DontCryClumsy88: posts big blind 2000
*** HOLE CARDS ***
Eux1986: folds 
Bigprad: folds 
cardinals970: folds 
Dueces4Days: folds 
ivan limeira: folds 
diabo656: raises 7000 to 9000
MKL1010: folds 
DontCryClumsy88: folds 
Uncalled bet (7000) returned to diabo656
diabo656 collected 7000 from pot
*** SUMMARY ***
Total pot 7000 | Rake 0 
Seat 1: MKL1010 (small blind) folded before Flop
Seat 2: DontCryClumsy88 (big blind) folded before Flop
Seat 3: Eux1986 folded before Flop (didn't bet)
Seat 4: Bigprad folded before Flop (didn't bet)
Seat 5: cardinals970 folded before Flop (didn't bet)
Seat 6: Dueces4Days folded before Flop (didn't bet)
Seat 7: ivan limeira folded before Flop (didn't bet)
Seat 8: diabo656 (button) collected (7000)

PokerStars Hand #251206104233: Tournament #3767885527, $40+$10+$5 USD Hold'em No Limit - Level XIV (1000/2000) - 2024/06/26 19:37:37 UTC [2024/06/26 15:37:37 ET]
Table '3767885527 96' 8-max Seat #1 is the button
Seat 1: MKL1010 (74137 in chips) 
Seat 2: DontCryClumsy88 (148715 in chips) 
Seat 3: Eux1986 (29671 in chips) 
Seat 4: Bigprad (88872 in chips) 
Seat 5: cardinals970 (42861 in chips) 
Seat 6: Dueces4Days (141458 in chips) 
Seat 7: ivan limeira (24094 in chips) 
Seat 8: diabo656 (134958 in chips) 
MKL1010: posts the ante 250
DontCryClumsy88: posts the ante 250
Eux1986: posts the ante 250
Bigprad: posts the ante 250
cardinals970: posts the ante 250
Dueces4Days: posts the ante 250
ivan limeira: posts the ante 250
diabo656: posts the ante 250
DontCryClumsy88: posts small blind 1000
Eux1986: posts big blind 2000
*** HOLE CARDS ***
Bigprad: folds 
cardinals970: folds 
Dueces4Days: raises 2000 to 4000
ivan limeira: folds 
diabo656: folds 
MKL1010: folds 
DontCryClumsy88: folds 
Eux1986: calls 2000
*** FLOP *** [5d Ad 7c]
Eux1986: checks 
Dueces4Days: bets 2750
Eux1986: folds 
Uncalled bet (2750) returned to Dueces4Days
Dueces4Days collected 11000 from pot
Dueces4Days: doesn't show hand 
*** SUMMARY ***
Total pot 11000 | Rake 0 
Board [5d Ad 7c]
Seat 1: MKL1010 (button) folded before Flop (didn't bet)
Seat 2: DontCryClumsy88 (small blind) folded before Flop
Seat 3: Eux1986 (big blind) folded on the Flop
Seat 4: Bigprad folded before Flop (didn't bet)
Seat 5: cardinals970 folded before Flop (didn't bet)
Seat 6: Dueces4Days collected (11000)
Seat 7: ivan limeira folded before Flop (didn't bet)
Seat 8: diabo656 folded before Flop (didn't bet)

PokerStars Hand #251206112187: Tournament #3767885527, $40+$10+$5 USD Hold'em No Limit - Level XIV (1000/2000) - 2024/06/26 19:38:07 UTC [2024/06/26 15:38:07 ET]
Table '3767885527 96' 8-max Seat #2 is the button
Seat 1: MKL1010 (73887 in chips) 
Seat 2: DontCryClumsy88 (147465 in chips) 
Seat 3: Eux1986 (25421 in chips) 
Seat 4: Bigprad (88622 in chips) 
Seat 5: cardinals970 (42611 in chips) 
Seat 6: Dueces4Days (148208 in chips) 
Seat 7: ivan limeira (23844 in chips) 
Seat 8: diabo656 (134708 in chips) 
MKL1010: posts the ante 250
DontCryClumsy88: posts the ante 250
Eux1986: posts the ante 250
Bigprad: posts the ante 250
cardinals970: posts the ante 250
Dueces4Days: posts the ante 250
ivan limeira: posts the ante 250
diabo656: posts the ante 250
Eux1986: posts small blind 1000
Bigprad: posts big blind 2000
*** HOLE CARDS ***
cardinals970: folds 
Dueces4Days: raises 2000 to 4000
ivan limeira: folds 
diabo656: folds 
MKL1010: folds 
DontCryClumsy88: folds 
Eux1986: folds 
Bigprad: folds 
Uncalled bet (2000) returned to Dueces4Days
Dueces4Days collected 7000 from pot
Dueces4Days: doesn't show hand 
*** SUMMARY ***
Total pot 7000 | Rake 0 
Seat 1: MKL1010 folded before Flop (didn't bet)
Seat 2: DontCryClumsy88 (button) folded before Flop (didn't bet)
Seat 3: Eux1986 (small blind) folded before Flop
Seat 4: Bigprad (big blind) folded before Flop
Seat 5: cardinals970 folded before Flop (didn't bet)
Seat 6: Dueces4Days collected (7000)
Seat 7: ivan limeira folded before Flop (didn't bet)
Seat 8: diabo656 folded before Flop (didn't bet)

PokerStars Hand #251206118379: Tournament #3767885527, $40+$10+$5 USD Hold'em No Limit - Level XIV (1000/2000) - 2024/06/26 19:38:30 UTC [2024/06/26 15:38:30 ET]
Table '3767885527 96' 8-max Seat #3 is the button
Seat 1: MKL1010 (73637 in chips) 
Seat 2: DontCryClumsy88 (147215 in chips) 
Seat 3: Eux1986 (24171 in chips) 
Seat 4: Bigprad (86372 in chips) 
Seat 5: cardinals970 (42361 in chips) 
Seat 6: Dueces4Days (152958 in chips) 
Seat 7: ivan limeira (23594 in chips) 
Seat 8: diabo656 (134458 in chips) 
MKL1010: posts the ante 250
DontCryClumsy88: posts the ante 250
Eux1986: posts the ante 250
Bigprad: posts the ante 250
cardinals970: posts the ante 250
Dueces4Days: posts the ante 250
ivan limeira: posts the ante 250
diabo656: posts the ante 250
Bigprad: posts small blind 1000
cardinals970: posts big blind 2000
*** HOLE CARDS ***
Dueces4Days: raises 2000 to 4000
ivan limeira: folds 
diabo656: folds 
MKL1010: calls 4000
DontCryClumsy88: calls 4000
Eux1986: folds 
Bigprad: calls 3000
cardinals970: folds 
*** FLOP *** [Th 9s 4h]
Bigprad: checks 
Dueces4Days: checks 
MKL1010: bets 6000
DontCryClumsy88: folds 
Bigprad: calls 6000
Dueces4Days: calls 6000
*** TURN *** [Th 9s 4h] [Jd]
Bigprad: checks 
Dueces4Days: checks 
MKL1010: bets 19000
Bigprad: calls 19000
Dueces4Days: raises 123708 to 142708 and is all-in
MKL1010: calls 44387 and is all-in
Bigprad: folds 
Uncalled bet (79321) returned to Dueces4Days
*** RIVER *** [Th 9s 4h Jd] [6d]
*** SHOW DOWN ***
Dueces4Days: shows [Kc Qs] (a straight, Nine to King)
MKL1010: shows [Td Tc] (three of a kind, Tens)
Dueces4Days collected 183774 from pot
MKL1010 finished the tournament in 610th place
*** SUMMARY ***
Total pot 183774 | Rake 0 
Board [Th 9s 4h Jd 6d]
Seat 1: MKL1010 showed [Td Tc] and lost with three of a kind, Tens
Seat 2: DontCryClumsy88 folded on the Flop
Seat 3: Eux1986 (button) folded before Flop (didn't bet)
Seat 4: Bigprad (small blind) folded on the Turn
Seat 5: cardinals970 (big blind) folded before Flop
Seat 6: Dueces4Days showed [Kc Qs] and won (183774) with a straight, Nine to King
Seat 7: ivan limeira folded before Flop (didn't bet)
Seat 8: diabo656 folded before Flop (didn't bet)

PokerStars Hand #251206139227: Tournament #3767885527, $40+$10+$5 USD Hold'em No Limit - Level XV (1250/2500) - 2024/06/26 19:39:46 UTC [2024/06/26 15:39:46 ET]
Table '3767885527 96' 8-max Seat #4 is the button
Seat 2: DontCryClumsy88 (142965 in chips) 
Seat 3: Eux1986 (23921 in chips) 
Seat 4: Bigprad (57122 in chips) 
Seat 5: cardinals970 (40111 in chips) 
Seat 6: Dueces4Days (263095 in chips) 
Seat 7: ivan limeira (23344 in chips) 
Seat 8: diabo656 (134208 in chips) 
DontCryClumsy88: posts the ante 325
Eux1986: posts the ante 325
Bigprad: posts the ante 325
cardinals970: posts the ante 325
Dueces4Days: posts the ante 325
ivan limeira: posts the ante 325
diabo656: posts the ante 325
cardinals970: posts small blind 1250
Dueces4Days: posts big blind 2500
*** HOLE CARDS ***
ivan limeira: raises 2500 to 5000
diabo656: calls 5000
DontCryClumsy88: folds 
Eux1986: folds 
Bigprad: folds 
cardinals970: folds 
Dueces4Days: calls 2500
*** FLOP *** [9s Js 2h]
Dueces4Days: checks 
ivan limeira: checks 
diabo656: bets 18525
Dueces4Days: raises 31025 to 49550
ivan limeira: folds 
diabo656: calls 31025
*** TURN *** [9s Js 2h] [Qd]
Dueces4Days: bets 176438
diabo656: calls 79333 and is all-in
Uncalled bet (97105) returned to Dueces4Days
*** RIVER *** [9s Js 2h Qd] [4d]
*** SHOW DOWN ***
Dueces4Days: shows [Ts 7s] (high card Queen)
diabo656: shows [Jc Qc] (two pair, Queens and Jacks)
diabo656 collected 276291 from pot
*** SUMMARY ***
Total pot 276291 | Rake 0 
Board [9s Js 2h Qd 4d]
Seat 2: DontCryClumsy88 folded before Flop (didn't bet)
Seat 3: Eux1986 folded before Flop (didn't bet)
Seat 4: Bigprad (button) folded before Flop (didn't bet)
Seat 5: cardinals970 (small blind) folded before Flop
Seat 6: Dueces4Days (big blind) showed [Ts 7s] and lost with high card Queen
Seat 7: ivan limeira folded on the Flop
Seat 8: diabo656 showed [Jc Qc] and won (276291) with two pair, Queens and Jacks

PokerStars Hand #251206164105: Tournament #3767885527, $40+$10+$5 USD Hold'em No Limit - Level XV (1250/2500) - 2024/06/26 19:41:16 UTC [2024/06/26 15:41:16 ET]
Table '3767885527 96' 8-max Seat #5 is the button
Seat 1: Scairone (30771 in chips) 
Seat 2: DontCryClumsy88 (142640 in chips) 
Seat 3: Eux1986 (23596 in chips) 
Seat 4: Bigprad (56797 in chips) 
Seat 5: cardinals970 (38536 in chips) 
Seat 6: Dueces4Days (128887 in chips) 
Seat 7: ivan limeira (18019 in chips) 
Seat 8: diabo656 (276291 in chips) 
Scairone: posts the ante 325
DontCryClumsy88: posts the ante 325
Eux1986: posts the ante 325
Bigprad: posts the ante 325
cardinals970: posts the ante 325
Dueces4Days: posts the ante 325
ivan limeira: posts the ante 325
diabo656: posts the ante 325
Dueces4Days: posts small blind 1250
ivan limeira: posts big blind 2500
*** HOLE CARDS ***
diabo656: folds 
Scairone: folds 
DontCryClumsy88: folds 
Eux1986: folds 
Bigprad: folds 
cardinals970: folds 
Dueces4Days: raises 126062 to 128562 and is all-in
ivan limeira: calls 15194 and is all-in
Uncalled bet (110868) returned to Dueces4Days
*** FLOP *** [7c 8c 4d]
*** TURN *** [7c 8c 4d] [7s]
*** RIVER *** [7c 8c 4d 7s] [7h]
*** SHOW DOWN ***
Dueces4Days: shows [8h 5d] (a full house, Sevens full of Eights)
ivan limeira: shows [As Tc] (three of a kind, Sevens)
Dueces4Days collected 37988 from pot
ivan limeira finished the tournament in 577th place
*** SUMMARY ***
Total pot 37988 | Rake 0 
Board [7c 8c 4d 7s 7h]
Seat 1: Scairone folded before Flop (didn't bet)
Seat 2: DontCryClumsy88 folded before Flop (didn't bet)
Seat 3: Eux1986 folded before Flop (didn't bet)
Seat 4: Bigprad folded before Flop (didn't bet)
Seat 5: cardinals970 (button) folded before Flop (didn't bet)
Seat 6: Dueces4Days (small blind) showed [8h 5d] and won (37988) with a full house, Sevens full of Eights
Seat 7: ivan limeira (big blind) showed [As Tc] and lost with three of a kind, Sevens
Seat 8: diabo656 folded before Flop (didn't bet)


PokerStars Hand #251205799339: Tournament #3767885527, $40+$10+$5 USD Hold'em No Limit - Level XII (700/1400) - 2024/06/26 19:19:02 UTC [2024/06/26 15:19:02 ET]
Table '3767885527 94' 8-max Seat #5 is the button
Seat 1: pazipro (66633 in chips) 
Seat 2: 010101777 (43448 in chips) 
Seat 3: Parrafelipe (15667 in chips) 
Seat 4: PIUlimeira (52085 in chips) 
Seat 5: Ale7anderr77 (71117 in chips) 
Seat 6: Hookz (24007 in chips) 
Seat 7: esdeathonlol (26575 in chips) 
Seat 8: Thrumbo (76020 in chips) 
pazipro: posts the ante 175
010101777: posts the ante 175
Parrafelipe: posts the ante 175
PIUlimeira: posts the ante 175
Ale7anderr77: posts the ante 175
Hookz: posts the ante 175
esdeathonlol: posts the ante 175
Thrumbo: posts the ante 175
Hookz: posts small blind 700
esdeathonlol: posts big blind 1400
*** HOLE CARDS ***
Thrumbo: raises 1540 to 2940
pazipro: folds 
010101777: calls 2940
Parrafelipe: folds 
PIUlimeira: folds 
Ale7anderr77: raises 7840 to 10780
Hookz: folds 
esdeathonlol: folds 
Thrumbo: folds 
010101777: raises 32493 to 43273 and is all-in
Ale7anderr77: calls 32493
*** FLOP *** [6c Ts Tc]
*** TURN *** [6c Ts Tc] [Qs]
*** RIVER *** [6c Ts Tc Qs] [Jc]
*** SHOW DOWN ***
010101777: shows [9h 9s] (two pair, Tens and Nines)
Ale7anderr77: shows [Qd Kh] (two pair, Queens and Tens)
Ale7anderr77 collected 92986 from pot
010101777 finished the tournament
*** SUMMARY ***
Total pot 92986 | Rake 0 
Board [6c Ts Tc Qs Jc]
Seat 1: pazipro folded before Flop (didn't bet)
Seat 2: 010101777 showed [9h 9s] and lost with two pair, Tens and Nines
Seat 3: Parrafelipe folded before Flop (didn't bet)
Seat 4: PIUlimeira folded before Flop (didn't bet)
Seat 5: Ale7anderr77 (button) showed [Qd Kh] and won (92986) with two pair, Queens and Tens
Seat 6: Hookz (small blind) folded before Flop
Seat 7: esdeathonlol (big blind) folded before Flop
Seat 8: Thrumbo folded before Flop

PokerStars Hand #251205823612: Tournament #3767885527, $40+$10+$5 USD Hold'em No Limit - Level XIII (800/1600) - 2024/06/26 19:20:30 UTC [2024/06/26 15:20:30 ET]
Table '3767885527 94' 8-max Seat #6 is the button
Seat 1: pazipro (66458 in chips) 
Seat 3: Parrafelipe (15492 in chips) 
Seat 4: PIUlimeira (51910 in chips) 
Seat 5: Ale7anderr77 (120655 in chips) 
Seat 6: Hookz (23132 in chips) 
Seat 7: esdeathonlol (25000 in chips) 
Seat 8: Thrumbo (72905 in chips) 
pazipro: posts the ante 200
Parrafelipe: posts the ante 200
PIUlimeira: posts the ante 200
Ale7anderr77: posts the ante 200
Hookz: posts the ante 200
esdeathonlol: posts the ante 200
Thrumbo: posts the ante 200
esdeathonlol: posts small blind 800
Thrumbo: posts big blind 1600
*** HOLE CARDS ***
pazipro: folds 
Parrafelipe: folds 
PIUlimeira: folds 
Ale7anderr77: raises 1600 to 3200
Hookz: folds 
esdeathonlol: folds 
saupra506 is disconnected 
Thrumbo: calls 1600
*** FLOP *** [Ts Tc 4s]
Thrumbo: checks 
Ale7anderr77: bets 2924
Thrumbo: raises 4334 to 7258
Ale7anderr77: calls 4334
*** TURN *** [Ts Tc 4s] [Kh]
Thrumbo: bets 10402
Ale7anderr77: calls 10402
*** RIVER *** [Ts Tc 4s Kh] [7s]
Thrumbo: bets 13176
Ale7anderr77: raises 22292 to 35468
Thrumbo: raises 16377 to 51845 and is all-in
Ale7anderr77: calls 16377
*** SHOW DOWN ***
Thrumbo: shows [Kd Td] (a full house, Tens full of Kings)
Ale7anderr77: shows [Ks 5s] (a flush, King high)
Thrumbo collected 147610 from pot
*** SUMMARY ***
Total pot 147610 | Rake 0 
Board [Ts Tc 4s Kh 7s]
Seat 1: pazipro folded before Flop (didn't bet)
Seat 3: Parrafelipe folded before Flop (didn't bet)
Seat 4: PIUlimeira folded before Flop (didn't bet)
Seat 5: Ale7anderr77 showed [Ks 5s] and lost with a flush, King high
Seat 6: Hookz (button) folded before Flop (didn't bet)
Seat 7: esdeathonlol (small blind) folded before Flop
Seat 8: Thrumbo (big blind) showed [Kd Td] and won (147610) with a full house, Tens full of Kings

PokerStars Hand #251205857723: Tournament #3767885527, $40+$10+$5 USD Hold'em No Limit - Level XIII (800/1600) - 2024/06/26 19:22:36 UTC [2024/06/26 15:22:36 ET]
Table '3767885527 94' 8-max Seat #7 is the button
Seat 1: pazipro (66258 in chips) 
Seat 2: saupra506 (25000 in chips) 
Seat 3: Parrafelipe (15292 in chips) 
Seat 4: PIUlimeira (51710 in chips) 
Seat 5: Ale7anderr77 (47750 in chips) 
Seat 6: Hookz (22932 in chips) 
Seat 7: esdeathonlol (24000 in chips) 
Seat 8: Thrumbo (147610 in chips) 
pazipro: posts the ante 200
saupra506: posts the ante 200
Parrafelipe: posts the ante 200
PIUlimeira: posts the ante 200
Ale7anderr77: posts the ante 200
Hookz: posts the ante 200
esdeathonlol: posts the ante 200
Thrumbo: posts the ante 200
Thrumbo: posts small blind 800
pazipro: posts big blind 1600
*** HOLE CARDS ***
saupra506: folds 
Parrafelipe: folds 
PIUlimeira: raises 1600 to 3200
Ale7anderr77: calls 3200
Hookz: folds 
esdeathonlol: folds 
Thrumbo: folds 
pazipro: folds 
*** FLOP *** [8c 7d Th]
PIUlimeira: checks 
Ale7anderr77: checks 
*** TURN *** [8c 7d Th] [5d]
PIUlimeira: bets 5920
Ale7anderr77: calls 5920
*** RIVER *** [8c 7d Th 5d] [Jc]
PIUlimeira: checks 
Ale7anderr77: bets 17125
PIUlimeira: folds 
Uncalled bet (17125) returned to Ale7anderr77
Ale7anderr77 collected 22240 from pot
*** SUMMARY ***
Total pot 22240 | Rake 0 
Board [8c 7d Th 5d Jc]
Seat 1: pazipro (big blind) folded before Flop
Seat 2: saupra506 folded before Flop (didn't bet)
Seat 3: Parrafelipe folded before Flop (didn't bet)
Seat 4: PIUlimeira folded on the River
Seat 5: Ale7anderr77 collected (22240)
Seat 6: Hookz folded before Flop (didn't bet)
Seat 7: esdeathonlol (button) folded before Flop (didn't bet)
Seat 8: Thrumbo (small blind) folded before Flop

PokerStars Hand #251205890730: Tournament #3767885527, $40+$10+$5 USD Hold'em No Limit - Level XIII (800/1600) - 2024/06/26 19:24:36 UTC [2024/06/26 15:24:36 ET]
Table '3767885527 94' 8-max Seat #8 is the button
Seat 1: pazipro (64458 in chips) 
Seat 2: saupra506 (24800 in chips) 
Seat 3: Parrafelipe (15092 in chips) 
Seat 4: PIUlimeira (42390 in chips) 
Seat 5: Ale7anderr77 (60670 in chips) 
Seat 6: Hookz (22732 in chips) 
Seat 7: esdeathonlol (23800 in chips) 
Seat 8: Thrumbo (146610 in chips) 
pazipro: posts the ante 200
saupra506: posts the ante 200
Parrafelipe: posts the ante 200
PIUlimeira: posts the ante 200
Ale7anderr77: posts the ante 200
Hookz: posts the ante 200
esdeathonlol: posts the ante 200
Thrumbo: posts the ante 200
pazipro: posts small blind 800
saupra506: posts big blind 1600
*** HOLE CARDS ***
Parrafelipe: folds 
PIUlimeira: folds 
Ale7anderr77: folds 
Hookz: folds 
esdeathonlol: raises 1600 to 3200
Thrumbo: folds 
pazipro: folds 
saupra506: calls 1600
*** FLOP *** [Js 2c 6s]
saupra506: checks 
esdeathonlol: bets 6400
saupra506: folds [Td]
Uncalled bet (6400) returned to esdeathonlol
esdeathonlol collected 8800 from pot
*** SUMMARY ***
Total pot 8800 | Rake 0 
Board [Js 2c 6s]
Seat 1: pazipro (small blind) folded before Flop
Seat 2: saupra506 (big blind) folded on the Flop
Seat 3: Parrafelipe folded before Flop (didn't bet)
Seat 4: PIUlimeira folded before Flop (didn't bet)
Seat 5: Ale7anderr77 folded before Flop (didn't bet)
Seat 6: Hookz folded before Flop (didn't bet)
Seat 7: esdeathonlol collected (8800)
Seat 8: Thrumbo (button) folded before Flop (didn't bet)

PokerStars Hand #251205906340: Tournament #3767885527, $40+$10+$5 USD Hold'em No Limit - Level XIII (800/1600) - 2024/06/26 19:25:33 UTC [2024/06/26 15:25:33 ET]
Table '3767885527 94' 8-max Seat #1 is the button
Seat 1: pazipro (63458 in chips) 
Seat 2: saupra506 (21400 in chips) 
Seat 3: Parrafelipe (14892 in chips) 
Seat 4: PIUlimeira (42190 in chips) 
Seat 5: Ale7anderr77 (60470 in chips) 
Seat 6: Hookz (22532 in chips) 
Seat 7: esdeathonlol (29200 in chips) 
Seat 8: Thrumbo (146410 in chips) 
pazipro: posts the ante 200
saupra506: posts the ante 200
Parrafelipe: posts the ante 200
PIUlimeira: posts the ante 200
Ale7anderr77: posts the ante 200
Hookz: posts the ante 200
esdeathonlol: posts the ante 200
Thrumbo: posts the ante 200
saupra506: posts small blind 800
Parrafelipe: posts big blind 1600
*** HOLE CARDS ***
PIUlimeira: raises 1600 to 3200
Ale7anderr77: folds 
Hookz: folds 
esdeathonlol: folds 
Thrumbo: folds 
pazipro: raises 4800 to 8000
saupra506: folds 
Parrafelipe: folds 
PIUlimeira: folds 
Uncalled bet (4800) returned to pazipro
pazipro collected 10400 from pot
pazipro: doesn't show hand 
*** SUMMARY ***
Total pot 10400 | Rake 0 
Seat 1: pazipro (button) collected (10400)
Seat 2: saupra506 (small blind) folded before Flop
Seat 3: Parrafelipe (big blind) folded before Flop
Seat 4: PIUlimeira folded before Flop
Seat 5: Ale7anderr77 folded before Flop (didn't bet)
Seat 6: Hookz folded before Flop (didn't bet)
Seat 7: esdeathonlol folded before Flop (didn't bet)
Seat 8: Thrumbo folded before Flop (didn't bet)

PokerStars Hand #251205918304: Tournament #3767885527, $40+$10+$5 USD Hold'em No Limit - Level XIII (800/1600) - 2024/06/26 19:26:16 UTC [2024/06/26 15:26:16 ET]
Table '3767885527 94' 8-max Seat #2 is the button
Seat 1: pazipro (70458 in chips) 
Seat 2: saupra506 (20400 in chips) 
Seat 3: Parrafelipe (13092 in chips) 
Seat 4: PIUlimeira (38790 in chips) 
Seat 5: Ale7anderr77 (60270 in chips) 
Seat 6: Hookz (22332 in chips) 
Seat 7: esdeathonlol (29000 in chips) 
Seat 8: Thrumbo (146210 in chips) 
pazipro: posts the ante 200
saupra506: posts the ante 200
Parrafelipe: posts the ante 200
PIUlimeira: posts the ante 200
Ale7anderr77: posts the ante 200
Hookz: posts the ante 200
esdeathonlol: posts the ante 200
Thrumbo: posts the ante 200
Parrafelipe: posts small blind 800
PIUlimeira: posts big blind 1600
*** HOLE CARDS ***
Ale7anderr77: raises 1600 to 3200
Hookz: raises 18932 to 22132 and is all-in
esdeathonlol: folds 
Thrumbo: folds 
pazipro: folds 
saupra506: folds 
Parrafelipe: folds 
PIUlimeira: folds 
Ale7anderr77: folds 
Uncalled bet (18932) returned to Hookz
Hookz collected 10400 from pot
Hookz: doesn't show hand 
*** SUMMARY ***
Total pot 10400 | Rake 0 
Seat 1: pazipro folded before Flop (didn't bet)
Seat 2: saupra506 (button) folded before Flop (didn't bet)
Seat 3: Parrafelipe (small blind) folded before Flop
Seat 4: PIUlimeira (big blind) folded before Flop
Seat 5: Ale7anderr77 folded before Flop
Seat 6: Hookz collected (10400)
Seat 7: esdeathonlol folded before Flop (didn't bet)
Seat 8: Thrumbo folded before Flop (didn't bet)

PokerStars Hand #251205932095: Tournament #3767885527, $40+$10+$5 USD Hold'em No Limit - Level XIII (800/1600) - 2024/06/26 19:27:07 UTC [2024/06/26 15:27:07 ET]
Table '3767885527 94' 8-max Seat #3 is the button
Seat 1: pazipro (70258 in chips) 
Seat 2: saupra506 (20200 in chips) 
Seat 3: Parrafelipe (12092 in chips) 
Seat 4: PIUlimeira (36990 in chips) 
Seat 5: Ale7anderr77 (56870 in chips) 
Seat 6: Hookz (29332 in chips) 
Seat 7: esdeathonlol (28800 in chips) 
Seat 8: Thrumbo (146010 in chips) 
pazipro: posts the ante 200
saupra506: posts the ante 200
Parrafelipe: posts the ante 200
PIUlimeira: posts the ante 200
Ale7anderr77: posts the ante 200
Hookz: posts the ante 200
esdeathonlol: posts the ante 200
Thrumbo: posts the ante 200
PIUlimeira: posts small blind 800
Ale7anderr77: posts big blind 1600
*** HOLE CARDS ***
Hookz: folds 
esdeathonlol: folds 
Thrumbo: folds 
pazipro: raises 1600 to 3200
saupra506: folds 
Parrafelipe: folds 
PIUlimeira: folds 
Ale7anderr77: calls 1600
*** FLOP *** [5s 3h 2d]
Ale7anderr77: checks 
pazipro: bets 2640
Ale7anderr77: raises 6387 to 9027
pazipro: folds 
Uncalled bet (6387) returned to Ale7anderr77
Ale7anderr77 collected 14080 from pot
*** SUMMARY ***
Total pot 14080 | Rake 0 
Board [5s 3h 2d]
Seat 1: pazipro folded on the Flop
Seat 2: saupra506 folded before Flop (didn't bet)
Seat 3: Parrafelipe (button) folded before Flop (didn't bet)
Seat 4: PIUlimeira (small blind) folded before Flop
Seat 5: Ale7anderr77 (big blind) collected (14080)
Seat 6: Hookz folded before Flop (didn't bet)
Seat 7: esdeathonlol folded before Flop (didn't bet)
Seat 8: Thrumbo folded before Flop (didn't bet)

PokerStars Hand #251205947468: Tournament #3767885527, $40+$10+$5 USD Hold'em No Limit - Level XIII (800/1600) - 2024/06/26 19:28:04 UTC [2024/06/26 15:28:04 ET]
Table '3767885527 94' 8-max Seat #4 is the button
Seat 1: pazipro (64218 in chips) 
Seat 2: saupra506 (20000 in chips) 
Seat 3: Parrafelipe (11892 in chips) 
Seat 4: PIUlimeira (35990 in chips) 
Seat 5: Ale7anderr77 (64910 in chips) 
Seat 6: Hookz (29132 in chips) 
Seat 7: esdeathonlol (28600 in chips) 
Seat 8: Thrumbo (145810 in chips) 
pazipro: posts the ante 200
saupra506: posts the ante 200
Parrafelipe: posts the ante 200
PIUlimeira: posts the ante 200
Ale7anderr77: posts the ante 200
Hookz: posts the ante 200
esdeathonlol: posts the ante 200
Thrumbo: posts the ante 200
Ale7anderr77: posts small blind 800
Hookz: posts big blind 1600
*** HOLE CARDS ***
esdeathonlol: folds 
Thrumbo: folds 
pazipro: folds 
saupra506: raises 1920 to 3520
Parrafelipe: folds 
PIUlimeira: folds 
Ale7anderr77: folds 
Hookz: folds 
Uncalled bet (1920) returned to saupra506
saupra506 collected 5600 from pot
*** SUMMARY ***
Total pot 5600 | Rake 0 
Seat 1: pazipro folded before Flop (didn't bet)
Seat 2: saupra506 collected (5600)
Seat 3: Parrafelipe folded before Flop (didn't bet)
Seat 4: PIUlimeira (button) folded before Flop (didn't bet)
Seat 5: Ale7anderr77 (small blind) folded before Flop
Seat 6: Hookz (big blind) folded before Flop
Seat 7: esdeathonlol folded before Flop (didn't bet)
Seat 8: Thrumbo folded before Flop (didn't bet)

PokerStars Hand #251205954400: Tournament #3767885527, $40+$10+$5 USD Hold'em No Limit - Level XIII (800/1600) - 2024/06/26 19:28:30 UTC [2024/06/26 15:28:30 ET]
Table '3767885527 94' 8-max Seat #5 is the button
Seat 1: pazipro (64018 in chips) 
Seat 2: saupra506 (23800 in chips) 
Seat 3: Parrafelipe (11692 in chips) 
Seat 4: PIUlimeira (35790 in chips) 
Seat 5: Ale7anderr77 (63910 in chips) 
Seat 6: Hookz (27332 in chips) 
Seat 7: esdeathonlol (28400 in chips) 
Seat 8: Thrumbo (145610 in chips) 
pazipro: posts the ante 200
saupra506: posts the ante 200
Parrafelipe: posts the ante 200
PIUlimeira: posts the ante 200
Ale7anderr77: posts the ante 200
Hookz: posts the ante 200
esdeathonlol: posts the ante 200
Thrumbo: posts the ante 200
Hookz: posts small blind 800
esdeathonlol: posts big blind 1600
*** HOLE CARDS ***
Thrumbo: folds 
pazipro: folds 
saupra506: folds 
Parrafelipe: folds 
PIUlimeira: folds 
Ale7anderr77: raises 1600 to 3200
Hookz: raises 23932 to 27132 and is all-in
esdeathonlol: folds 
Ale7anderr77: folds 
Uncalled bet (23932) returned to Hookz
Hookz collected 9600 from pot
Hookz: doesn't show hand 
*** SUMMARY ***
Total pot 9600 | Rake 0 
Seat 1: pazipro folded before Flop (didn't bet)
Seat 2: saupra506 folded before Flop (didn't bet)
Seat 3: Parrafelipe folded before Flop (didn't bet)
Seat 4: PIUlimeira folded before Flop (didn't bet)
Seat 5: Ale7anderr77 (button) folded before Flop
Seat 6: Hookz (small blind) collected (9600)
Seat 7: esdeathonlol (big blind) folded before Flop
Seat 8: Thrumbo folded before Flop (didn't bet)

PokerStars Hand #251205970421: Tournament #3767885527, $40+$10+$5 USD Hold'em No Limit - Level XIV (1000/2000) - 2024/06/26 19:29:30 UTC [2024/06/26 15:29:30 ET]
Table '3767885527 94' 8-max Seat #6 is the button
Seat 1: pazipro (63818 in chips) 
Seat 2: saupra506 (23600 in chips) 
Seat 3: Parrafelipe (11492 in chips) 
Seat 4: PIUlimeira (35590 in chips) 
Seat 5: Ale7anderr77 (60510 in chips) 
Seat 6: Hookz (33532 in chips) 
Seat 7: esdeathonlol (26600 in chips) 
Seat 8: Thrumbo (145410 in chips) 
pazipro: posts the ante 250
saupra506: posts the ante 250
Parrafelipe: posts the ante 250
PIUlimeira: posts the ante 250
Ale7anderr77: posts the ante 250
Hookz: posts the ante 250
esdeathonlol: posts the ante 250
Thrumbo: posts the ante 250
esdeathonlol: posts small blind 1000
Thrumbo: posts big blind 2000
*** HOLE CARDS ***
pazipro: raises 2000 to 4000
saupra506: folds 
Parrafelipe: folds 
PIUlimeira: folds 
Ale7anderr77: folds 
Hookz: folds 
esdeathonlol: folds 
Thrumbo: calls 2000
*** FLOP *** [5h 4s 9h]
Thrumbo: checks 
pazipro: checks 
*** TURN *** [5h 4s 9h] [Kh]
Thrumbo: checks 
pazipro: checks 
*** RIVER *** [5h 4s 9h Kh] [Ah]
Thrumbo: checks 
pazipro: checks 
*** SHOW DOWN ***
Thrumbo: shows [7c 5c] (a pair of Fives)
pazipro: shows [Qs Ad] (a pair of Aces)
pazipro collected 11000 from pot
*** SUMMARY ***
Total pot 11000 | Rake 0 
Board [5h 4s 9h Kh Ah]
Seat 1: pazipro showed [Qs Ad] and won (11000) with a pair of Aces
Seat 2: saupra506 folded before Flop (didn't bet)
Seat 3: Parrafelipe folded before Flop (didn't bet)
Seat 4: PIUlimeira folded before Flop (didn't bet)
Seat 5: Ale7anderr77 folded before Flop (didn't bet)
Seat 6: Hookz (button) folded before Flop (didn't bet)
Seat 7: esdeathonlol (small blind) folded before Flop
Seat 8: Thrumbo (big blind) showed [7c 5c] and lost with a pair of Fives

PokerStars Hand #251205987450: Tournament #3767885527, $40+$10+$5 USD Hold'em No Limit - Level XIV (1000/2000) - 2024/06/26 19:30:32 UTC [2024/06/26 15:30:32 ET]
Table '3767885527 94' 8-max Seat #7 is the button
Seat 1: pazipro (70568 in chips) 
Seat 2: saupra506 (23350 in chips) 
Seat 3: Parrafelipe (11242 in chips) 
Seat 4: PIUlimeira (35340 in chips) 
Seat 5: Ale7anderr77 (60260 in chips) 
Seat 6: Hookz (33282 in chips) 
Seat 7: esdeathonlol (25350 in chips) 
Seat 8: Thrumbo (141160 in chips) 
pazipro: posts the ante 250
saupra506: posts the ante 250
Parrafelipe: posts the ante 250
PIUlimeira: posts the ante 250
Ale7anderr77: posts the ante 250
Hookz: posts the ante 250
esdeathonlol: posts the ante 250
Thrumbo: posts the ante 250
Thrumbo: posts small blind 1000
pazipro: posts big blind 2000
*** HOLE CARDS ***
saupra506: folds 
Parrafelipe: folds 
PIUlimeira: folds 
Ale7anderr77: folds 
Hookz: folds 
esdeathonlol: raises 2000 to 4000
Thrumbo: folds 
pazipro: calls 2000
*** FLOP *** [Jc Qh 3d]
pazipro: checks 
esdeathonlol: bets 6000
pazipro: raises 23000 to 29000
esdeathonlol: folds 
Uncalled bet (23000) returned to pazipro
pazipro collected 23000 from pot
pazipro: doesn't show hand 
*** SUMMARY ***
Total pot 23000 | Rake 0 
Board [Jc Qh 3d]
Seat 1: pazipro (big blind) collected (23000)
Seat 2: saupra506 folded before Flop (didn't bet)
Seat 3: Parrafelipe folded before Flop (didn't bet)
Seat 4: PIUlimeira folded before Flop (didn't bet)
Seat 5: Ale7anderr77 folded before Flop (didn't bet)
Seat 6: Hookz folded before Flop (didn't bet)
Seat 7: esdeathonlol (button) folded on the Flop
Seat 8: Thrumbo (small blind) folded before Flop

PokerStars Hand #251206000911: Tournament #3767885527, $40+$10+$5 USD Hold'em No Limit - Level XIV (1000/2000) - 2024/06/26 19:31:21 UTC [2024/06/26 15:31:21 ET]
Table '3767885527 94' 8-max Seat #8 is the button
Seat 1: pazipro (83318 in chips) 
Seat 2: saupra506 (23100 in chips) 
Seat 3: Parrafelipe (10992 in chips) 
Seat 4: PIUlimeira (35090 in chips) 
Seat 5: Ale7anderr77 (60010 in chips) 
Seat 6: Hookz (33032 in chips) 
Seat 7: esdeathonlol (15100 in chips) 
Seat 8: Thrumbo (139910 in chips) 
pazipro: posts the ante 250
saupra506: posts the ante 250
Parrafelipe: posts the ante 250
PIUlimeira: posts the ante 250
Ale7anderr77: posts the ante 250
Hookz: posts the ante 250
esdeathonlol: posts the ante 250
Thrumbo: posts the ante 250
pazipro: posts small blind 1000
saupra506: posts big blind 2000
*** HOLE CARDS ***
Parrafelipe: folds 
PIUlimeira: folds 
Ale7anderr77: folds 
Hookz: folds 
esdeathonlol: folds 
Thrumbo: folds 
pazipro: raises 81068 to 83068 and is all-in
saupra506: folds 
Uncalled bet (81068) returned to pazipro
pazipro collected 6000 from pot
pazipro: doesn't show hand 
*** SUMMARY ***
Total pot 6000 | Rake 0 
Seat 1: pazipro (small blind) collected (6000)
Seat 2: saupra506 (big blind) folded before Flop
Seat 3: Parrafelipe folded before Flop (didn't bet)
Seat 4: PIUlimeira folded before Flop (didn't bet)
Seat 5: Ale7anderr77 folded before Flop (didn't bet)
Seat 6: Hookz folded before Flop (didn't bet)
Seat 7: esdeathonlol folded before Flop (didn't bet)
Seat 8: Thrumbo (button) folded before Flop (didn't bet)

PokerStars Hand #251206008118: Tournament #3767885527, $40+$10+$5 USD Hold'em No Limit - Level XIV (1000/2000) - 2024/06/26 19:31:47 UTC [2024/06/26 15:31:47 ET]
Table '3767885527 94' 8-max Seat #1 is the button
Seat 1: pazipro (87068 in chips) 
Seat 2: saupra506 (20850 in chips) 
Seat 3: Parrafelipe (10742 in chips) 
Seat 4: PIUlimeira (34840 in chips) 
Seat 5: Ale7anderr77 (59760 in chips) 
Seat 6: Hookz (32782 in chips) 
Seat 7: esdeathonlol (14850 in chips) 
Seat 8: Thrumbo (139660 in chips) 
pazipro: posts the ante 250
saupra506: posts the ante 250
Parrafelipe: posts the ante 250
PIUlimeira: posts the ante 250
Ale7anderr77: posts the ante 250
Hookz: posts the ante 250
esdeathonlol: posts the ante 250
Thrumbo: posts the ante 250
saupra506: posts small blind 1000
Parrafelipe: posts big blind 2000
*** HOLE CARDS ***
PIUlimeira: raises 2000 to 4000
Ale7anderr77: folds 
Hookz: folds 
esdeathonlol: folds 
Thrumbo: folds 
pazipro: folds 
saupra506: folds 
Parrafelipe: raises 6492 to 10492 and is all-in
PIUlimeira: calls 6492
*** FLOP *** [5d 8s 5s]
*** TURN *** [5d 8s 5s] [2h]
*** RIVER *** [5d 8s 5s 2h] [Kc]
*** SHOW DOWN ***
Parrafelipe: shows [Ks Qc] (two pair, Kings and Fives)
PIUlimeira: shows [Ad 6d] (a pair of Fives)
Parrafelipe collected 23984 from pot
*** SUMMARY ***
Total pot 23984 | Rake 0 
Board [5d 8s 5s 2h Kc]
Seat 1: pazipro (button) folded before Flop (didn't bet)
Seat 2: saupra506 (small blind) folded before Flop
Seat 3: Parrafelipe (big blind) showed [Ks Qc] and won (23984) with two pair, Kings and Fives
Seat 4: PIUlimeira showed [Ad 6d] and lost with a pair of Fives
Seat 5: Ale7anderr77 folded before Flop (didn't bet)
Seat 6: Hookz folded before Flop (didn't bet)
Seat 7: esdeathonlol folded before Flop (didn't bet)
Seat 8: Thrumbo folded before Flop (didn't bet)

PokerStars Hand #251206017394: Tournament #3767885527, $40+$10+$5 USD Hold'em No Limit - Level XIV (1000/2000) - 2024/06/26 19:32:20 UTC [2024/06/26 15:32:20 ET]
Table '3767885527 94' 8-max Seat #2 is the button
Seat 1: pazipro (86818 in chips) 
Seat 2: saupra506 (19600 in chips) 
Seat 3: Parrafelipe (23984 in chips) 
Seat 4: PIUlimeira (24098 in chips) 
Seat 5: Ale7anderr77 (59510 in chips) 
Seat 6: Hookz (32532 in chips) 
Seat 7: esdeathonlol (14600 in chips) 
Seat 8: Thrumbo (139410 in chips) 
pazipro: posts the ante 250
saupra506: posts the ante 250
Parrafelipe: posts the ante 250
PIUlimeira: posts the ante 250
Ale7anderr77: posts the ante 250
Hookz: posts the ante 250
esdeathonlol: posts the ante 250
Thrumbo: posts the ante 250
Parrafelipe: posts small blind 1000
PIUlimeira: posts big blind 2000
*** HOLE CARDS ***
Ale7anderr77: folds 
Hookz: folds 
esdeathonlol: folds 
Thrumbo: folds 
pazipro: raises 2000 to 4000
saupra506: folds 
Parrafelipe: folds 
PIUlimeira: calls 2000
*** FLOP *** [4s Ah 5h]
PIUlimeira: checks 
pazipro: bets 3300
PIUlimeira: calls 3300
*** TURN *** [4s Ah 5h] [9h]
PIUlimeira: checks 
pazipro: bets 5280
PIUlimeira: raises 11268 to 16548 and is all-in
pazipro: calls 11268
*** RIVER *** [4s Ah 5h 9h] [Th]
*** SHOW DOWN ***
PIUlimeira: shows [As Ac] (three of a kind, Aces)
pazipro: shows [Kh Kd] (a flush, Ace high)
pazipro collected 50696 from pot
PIUlimeira finished the tournament
*** SUMMARY ***
Total pot 50696 | Rake 0 
Board [4s Ah 5h 9h Th]
Seat 1: pazipro showed [Kh Kd] and won (50696) with a flush, Ace high
Seat 2: saupra506 (button) folded before Flop (didn't bet)
Seat 3: Parrafelipe (small blind) folded before Flop
Seat 4: PIUlimeira (big blind) showed [As Ac] and lost with three of a kind, Aces
Seat 5: Ale7anderr77 folded before Flop (didn't bet)
Seat 6: Hookz folded before Flop (didn't bet)
Seat 7: esdeathonlol folded before Flop (didn't bet)
Seat 8: Thrumbo folded before Flop (didn't bet)


PokerStars Hand #251206793997: Tournament #3767885527, $40+$10+$5 USD Hold'em No Limit - Level XVIII (2000/4000) - 2024/06/26 20:20:06 UTC [2024/06/26 16:20:06 ET]
Table '3767885527 93' 8-max Seat #7 is the button
Seat 1: lucaromanoo1 (161854 in chips) 
Seat 2: mobky (72000 in chips) 
Seat 3: supervaganj (155290 in chips) 
Seat 4: Vamoclan (70599 in chips) 
Seat 5: pj0901 (232619 in chips) 
Seat 6: Proosty2 (70728 in chips) 
Seat 7: gibbo888 (234866 in chips) 
Seat 8: DR. ELDAR (101766 in chips) 
lucaromanoo1: posts the ante 500
mobky: posts the ante 500
supervaganj: posts the ante 500
Vamoclan: posts the ante 500
pj0901: posts the ante 500
Proosty2: posts the ante 500
gibbo888: posts the ante 500
DR. ELDAR: posts the ante 500
DR. ELDAR: posts small blind 2000
lucaromanoo1: posts big blind 4000
*** HOLE CARDS ***
mobky: calls 4000
supervaganj: folds 
Vamoclan: folds 
pj0901: folds 
Proosty2: folds 
gibbo888: folds 
DR. ELDAR: folds 
lucaromanoo1: checks 
*** FLOP *** [4h Kd 3s]
lucaromanoo1: checks 
mobky: bets 4000
lucaromanoo1: calls 4000
*** TURN *** [4h Kd 3s] [8d]
lucaromanoo1: checks 
mobky: bets 11000
lucaromanoo1: calls 11000
*** RIVER *** [4h Kd 3s 8d] [5s]
lucaromanoo1: checks 
mobky: checks 
*** SHOW DOWN ***
lucaromanoo1: shows [Ks 7h] (a pair of Kings)
mobky: mucks hand 
lucaromanoo1 collected 44000 from pot
*** SUMMARY ***
Total pot 44000 | Rake 0 
Board [4h Kd 3s 8d 5s]
Seat 1: lucaromanoo1 (big blind) showed [Ks 7h] and won (44000) with a pair of Kings
Seat 2: mobky mucked
Seat 3: supervaganj folded before Flop (didn't bet)
Seat 4: Vamoclan folded before Flop (didn't bet)
Seat 5: pj0901 folded before Flop (didn't bet)
Seat 6: Proosty2 folded before Flop (didn't bet)
Seat 7: gibbo888 (button) folded before Flop (didn't bet)
Seat 8: DR. ELDAR (small blind) folded before Flop

PokerStars Hand #251206807867: Tournament #3767885527, $40+$10+$5 USD Hold'em No Limit - Level XVIII (2000/4000) - 2024/06/26 20:20:55 UTC [2024/06/26 16:20:55 ET]
Table '3767885527 93' 8-max Seat #8 is the button
Seat 1: lucaromanoo1 (186354 in chips) 
Seat 2: mobky (52500 in chips) 
Seat 3: supervaganj (154790 in chips) 
Seat 4: Vamoclan (70099 in chips) 
Seat 5: pj0901 (232119 in chips) 
Seat 6: Proosty2 (70228 in chips) 
Seat 7: gibbo888 (234366 in chips) 
Seat 8: DR. ELDAR (99266 in chips) 
lucaromanoo1: posts the ante 500
mobky: posts the ante 500
supervaganj: posts the ante 500
Vamoclan: posts the ante 500
pj0901: posts the ante 500
Proosty2: posts the ante 500
gibbo888: posts the ante 500
DR. ELDAR: posts the ante 500
lucaromanoo1: posts small blind 2000
mobky: posts big blind 4000
*** HOLE CARDS ***
supervaganj: folds 
Vamoclan: folds 
pj0901: folds 
Proosty2: folds 
gibbo888: folds 
DR. ELDAR: folds 
lucaromanoo1: raises 181854 to 185854 and is all-in
mobky: folds 
Uncalled bet (181854) returned to lucaromanoo1
lucaromanoo1 collected 12000 from pot
lucaromanoo1: doesn't show hand 
*** SUMMARY ***
Total pot 12000 | Rake 0 
Seat 1: lucaromanoo1 (small blind) collected (12000)
Seat 2: mobky (big blind) folded before Flop
Seat 3: supervaganj folded before Flop (didn't bet)
Seat 4: Vamoclan folded before Flop (didn't bet)
Seat 5: pj0901 folded before Flop (didn't bet)
Seat 6: Proosty2 folded before Flop (didn't bet)
Seat 7: gibbo888 folded before Flop (didn't bet)
Seat 8: DR. ELDAR (button) folded before Flop (didn't bet)

PokerStars Hand #251206820274: Tournament #3767885527, $40+$10+$5 USD Hold'em No Limit - Level XVIII (2000/4000) - 2024/06/26 20:21:39 UTC [2024/06/26 16:21:39 ET]
Table '3767885527 93' 8-max Seat #1 is the button
Seat 1: lucaromanoo1 (193854 in chips) 
Seat 2: mobky (48000 in chips) 
Seat 3: supervaganj (154290 in chips) 
Seat 4: Vamoclan (69599 in chips) 
Seat 5: pj0901 (231619 in chips) 
Seat 6: Proosty2 (69728 in chips) 
Seat 7: gibbo888 (233866 in chips) 
Seat 8: DR. ELDAR (98766 in chips) 
lucaromanoo1: posts the ante 500
mobky: posts the ante 500
supervaganj: posts the ante 500
Vamoclan: posts the ante 500
pj0901: posts the ante 500
Proosty2: posts the ante 500
gibbo888: posts the ante 500
DR. ELDAR: posts the ante 500
mobky: posts small blind 2000
supervaganj: posts big blind 4000
*** HOLE CARDS ***
Vamoclan: folds 
pj0901: folds 
Proosty2: raises 4000 to 8000
gibbo888: folds 
DR. ELDAR: folds 
lucaromanoo1: folds 
mobky: folds 
supervaganj: calls 4000
*** FLOP *** [Kd 2c 5d]
supervaganj: checks 
Proosty2: bets 5520
supervaganj: folds 
Uncalled bet (5520) returned to Proosty2
Proosty2 collected 22000 from pot
Proosty2: doesn't show hand 
*** SUMMARY ***
Total pot 22000 | Rake 0 
Board [Kd 2c 5d]
Seat 1: lucaromanoo1 (button) folded before Flop (didn't bet)
Seat 2: mobky (small blind) folded before Flop
Seat 3: supervaganj (big blind) folded on the Flop
Seat 4: Vamoclan folded before Flop (didn't bet)
Seat 5: pj0901 folded before Flop (didn't bet)
Seat 6: Proosty2 collected (22000)
Seat 7: gibbo888 folded before Flop (didn't bet)
Seat 8: DR. ELDAR folded before Flop (didn't bet)

PokerStars Hand #251206830724: Tournament #3767885527, $40+$10+$5 USD Hold'em No Limit - Level XVIII (2000/4000) - 2024/06/26 20:22:16 UTC [2024/06/26 16:22:16 ET]
Table '3767885527 93' 8-max Seat #2 is the button
Seat 1: lucaromanoo1 (193354 in chips) 
Seat 2: mobky (45500 in chips) 
Seat 3: supervaganj (145790 in chips) 
Seat 4: Vamoclan (69099 in chips) 
Seat 5: pj0901 (231119 in chips) 
Seat 6: Proosty2 (83228 in chips) 
Seat 7: gibbo888 (233366 in chips) 
Seat 8: DR. ELDAR (98266 in chips) 
lucaromanoo1: posts the ante 500
mobky: posts the ante 500
supervaganj: posts the ante 500
Vamoclan: posts the ante 500
pj0901: posts the ante 500
Proosty2: posts the ante 500
gibbo888: posts the ante 500
DR. ELDAR: posts the ante 500
supervaganj: posts small blind 2000
Vamoclan: posts big blind 4000
*** HOLE CARDS ***
pj0901 has timed out
pj0901: folds 
pj0901 is sitting out
Proosty2: raises 4000 to 8000
pj0901 has returned
gibbo888: folds 
DR. ELDAR: folds 
lucaromanoo1: folds 
mobky: calls 8000
supervaganj: folds 
Vamoclan: folds 
*** FLOP *** [2h Ts 9c]
Proosty2: checks 
mobky: checks 
*** TURN *** [2h Ts 9c] [8d]
Proosty2: checks 
mobky: bets 26000
Proosty2: folds 
Uncalled bet (26000) returned to mobky
mobky collected 26000 from pot
*** SUMMARY ***
Total pot 26000 | Rake 0 
Board [2h Ts 9c 8d]
Seat 1: lucaromanoo1 folded before Flop (didn't bet)
Seat 2: mobky (button) collected (26000)
Seat 3: supervaganj (small blind) folded before Flop
Seat 4: Vamoclan (big blind) folded before Flop
Seat 5: pj0901 folded before Flop (didn't bet)
Seat 6: Proosty2 folded on the Turn
Seat 7: gibbo888 folded before Flop (didn't bet)
Seat 8: DR. ELDAR folded before Flop (didn't bet)

PokerStars Hand #251206854632: Tournament #3767885527, $40+$10+$5 USD Hold'em No Limit - Level XVIII (2000/4000) - 2024/06/26 20:23:41 UTC [2024/06/26 16:23:41 ET]
Table '3767885527 93' 8-max Seat #3 is the button
Seat 1: lucaromanoo1 (192854 in chips) 
Seat 2: mobky (63000 in chips) 
Seat 3: supervaganj (143290 in chips) 
Seat 4: Vamoclan (64599 in chips) 
Seat 5: pj0901 (230619 in chips) 
Seat 6: Proosty2 (74728 in chips) 
Seat 7: gibbo888 (232866 in chips) 
Seat 8: DR. ELDAR (97766 in chips) 
lucaromanoo1: posts the ante 500
mobky: posts the ante 500
supervaganj: posts the ante 500
Vamoclan: posts the ante 500
pj0901: posts the ante 500
Proosty2: posts the ante 500
gibbo888: posts the ante 500
DR. ELDAR: posts the ante 500
Vamoclan: posts small blind 2000
pj0901: posts big blind 4000
*** HOLE CARDS ***
Proosty2: folds 
gibbo888: folds 
DR. ELDAR: folds 
lucaromanoo1: folds 
mobky: raises 4123 to 8123
supervaganj: folds 
Vamoclan: folds 
pj0901: raises 221996 to 230119 and is all-in
mobky: folds 
Uncalled bet (221996) returned to pj0901
pj0901 collected 22246 from pot
pj0901: doesn't show hand 
*** SUMMARY ***
Total pot 22246 | Rake 0 
Seat 1: lucaromanoo1 folded before Flop (didn't bet)
Seat 2: mobky folded before Flop
Seat 3: supervaganj (button) folded before Flop (didn't bet)
Seat 4: Vamoclan (small blind) folded before Flop
Seat 5: pj0901 (big blind) collected (22246)
Seat 6: Proosty2 folded before Flop (didn't bet)
Seat 7: gibbo888 folded before Flop (didn't bet)
Seat 8: DR. ELDAR folded before Flop (didn't bet)

PokerStars Hand #251206871845: Tournament #3767885527, $40+$10+$5 USD Hold'em No Limit - Level XVIII (2000/4000) - 2024/06/26 20:24:43 UTC [2024/06/26 16:24:43 ET]
Table '3767885527 93' 8-max Seat #4 is the button
Seat 1: lucaromanoo1 (192354 in chips) 
Seat 2: mobky (54377 in chips) 
Seat 3: supervaganj (142790 in chips) 
Seat 4: Vamoclan (62099 in chips) 
Seat 5: pj0901 (244242 in chips) 
Seat 6: Proosty2 (74228 in chips) 
Seat 7: gibbo888 (232366 in chips) 
Seat 8: DR. ELDAR (97266 in chips) 
lucaromanoo1: posts the ante 500
mobky: posts the ante 500
supervaganj: posts the ante 500
Vamoclan: posts the ante 500
pj0901: posts the ante 500
Proosty2: posts the ante 500
gibbo888: posts the ante 500
DR. ELDAR: posts the ante 500
pj0901: posts small blind 2000
Proosty2: posts big blind 4000
*** HOLE CARDS ***
gibbo888: folds 
DR. ELDAR: folds 
lucaromanoo1: folds 
mobky: folds 
supervaganj: folds 
Vamoclan: folds 
pj0901: raises 239742 to 243742 and is all-in
Proosty2: folds 
Uncalled bet (239742) returned to pj0901
pj0901 collected 12000 from pot
pj0901: doesn't show hand 
*** SUMMARY ***
Total pot 12000 | Rake 0 
Seat 1: lucaromanoo1 folded before Flop (didn't bet)
Seat 2: mobky folded before Flop (didn't bet)
Seat 3: supervaganj folded before Flop (didn't bet)
Seat 4: Vamoclan (button) folded before Flop (didn't bet)
Seat 5: pj0901 (small blind) collected (12000)
Seat 6: Proosty2 (big blind) folded before Flop
Seat 7: gibbo888 folded before Flop (didn't bet)
Seat 8: DR. ELDAR folded before Flop (didn't bet)

PokerStars Hand #251206877625: Tournament #3767885527, $40+$10+$5 USD Hold'em No Limit - Level XVIII (2000/4000) - 2024/06/26 20:25:04 UTC [2024/06/26 16:25:04 ET]
Table '3767885527 93' 8-max Seat #5 is the button
Seat 1: lucaromanoo1 (191854 in chips) 
Seat 2: mobky (53877 in chips) 
Seat 3: supervaganj (142290 in chips) 
Seat 4: Vamoclan (61599 in chips) 
Seat 5: pj0901 (251742 in chips) 
Seat 6: Proosty2 (69728 in chips) 
Seat 7: gibbo888 (231866 in chips) 
Seat 8: DR. ELDAR (96766 in chips) 
lucaromanoo1: posts the ante 500
mobky: posts the ante 500
supervaganj: posts the ante 500
Vamoclan: posts the ante 500
pj0901: posts the ante 500
Proosty2: posts the ante 500
gibbo888: posts the ante 500
DR. ELDAR: posts the ante 500
Proosty2: posts small blind 2000
gibbo888: posts big blind 4000
*** HOLE CARDS ***
DR. ELDAR: folds 
lucaromanoo1: folds 
mobky: folds 
supervaganj: folds 
Vamoclan: folds 
pj0901: folds 
Proosty2: calls 2000
gibbo888: raises 227366 to 231366 and is all-in
Proosty2: folds 
Uncalled bet (227366) returned to gibbo888
gibbo888 collected 12000 from pot
gibbo888: doesn't show hand 
*** SUMMARY ***
Total pot 12000 | Rake 0 
Seat 1: lucaromanoo1 folded before Flop (didn't bet)
Seat 2: mobky folded before Flop (didn't bet)
Seat 3: supervaganj folded before Flop (didn't bet)
Seat 4: Vamoclan folded before Flop (didn't bet)
Seat 5: pj0901 (button) folded before Flop (didn't bet)
Seat 6: Proosty2 (small blind) folded before Flop
Seat 7: gibbo888 (big blind) collected (12000)
Seat 8: DR. ELDAR folded before Flop (didn't bet)

PokerStars Hand #251206888352: Tournament #3767885527, $40+$10+$5 USD Hold'em No Limit - Level XVIII (2000/4000) - 2024/06/26 20:25:42 UTC [2024/06/26 16:25:42 ET]
Table '3767885527 93' 8-max Seat #6 is the button
Seat 1: lucaromanoo1 (191354 in chips) 
Seat 2: mobky (53377 in chips) 
Seat 3: supervaganj (141790 in chips) 
Seat 4: Vamoclan (61099 in chips) 
Seat 5: pj0901 (251242 in chips) 
Seat 6: Proosty2 (65228 in chips) 
Seat 7: gibbo888 (239366 in chips) 
Seat 8: DR. ELDAR (96266 in chips) 
lucaromanoo1: posts the ante 500
mobky: posts the ante 500
supervaganj: posts the ante 500
Vamoclan: posts the ante 500
pj0901: posts the ante 500
Proosty2: posts the ante 500
gibbo888: posts the ante 500
DR. ELDAR: posts the ante 500
gibbo888: posts small blind 2000
DR. ELDAR: posts big blind 4000
*** HOLE CARDS ***
lucaromanoo1: raises 4000 to 8000
mobky: calls 8000
supervaganj: folds 
Vamoclan: folds 
pj0901: folds 
Proosty2: folds 
gibbo888: calls 6000
DR. ELDAR: calls 4000
*** FLOP *** [2d Ad 9d]
gibbo888: checks 
DR. ELDAR: checks 
lucaromanoo1: checks 
mobky: checks 
*** TURN *** [2d Ad 9d] [Ks]
gibbo888: bets 15840
DR. ELDAR: folds 
lucaromanoo1: folds 
mobky: folds 
Uncalled bet (15840) returned to gibbo888
gibbo888 collected 36000 from pot
gibbo888: doesn't show hand 
*** SUMMARY ***
Total pot 36000 | Rake 0 
Board [2d Ad 9d Ks]
Seat 1: lucaromanoo1 folded on the Turn
Seat 2: mobky folded on the Turn
Seat 3: supervaganj folded before Flop (didn't bet)
Seat 4: Vamoclan folded before Flop (didn't bet)
Seat 5: pj0901 folded before Flop (didn't bet)
Seat 6: Proosty2 (button) folded before Flop (didn't bet)
Seat 7: gibbo888 (small blind) collected (36000)
Seat 8: DR. ELDAR (big blind) folded on the Turn

PokerStars Hand #251206903318: Tournament #3767885527, $40+$10+$5 USD Hold'em No Limit - Level XIX (2500/5000) - 2024/06/26 20:26:36 UTC [2024/06/26 16:26:36 ET]
Table '3767885527 93' 8-max Seat #7 is the button
Seat 1: lucaromanoo1 (182854 in chips) 
Seat 2: mobky (44877 in chips) 
Seat 3: supervaganj (141290 in chips) 
Seat 4: Vamoclan (60599 in chips) 
Seat 5: pj0901 (250742 in chips) 
Seat 6: Proosty2 (64728 in chips) 
Seat 7: gibbo888 (266866 in chips) 
Seat 8: DR. ELDAR (87766 in chips) 
lucaromanoo1: posts the ante 625
mobky: posts the ante 625
supervaganj: posts the ante 625
Vamoclan: posts the ante 625
pj0901: posts the ante 625
Proosty2: posts the ante 625
gibbo888: posts the ante 625
DR. ELDAR: posts the ante 625
DR. ELDAR: posts small blind 2500
lucaromanoo1: posts big blind 5000
*** HOLE CARDS ***
mobky: folds 
supervaganj: raises 5000 to 10000
Vamoclan: folds 
pj0901: folds 
Proosty2: folds 
gibbo888: folds 
DR. ELDAR: folds 
lucaromanoo1: calls 5000
*** FLOP *** [3c Qd Qs]
lucaromanoo1: checks 
supervaganj: bets 6900
lucaromanoo1: raises 15600 to 22500
supervaganj: folds 
Uncalled bet (15600) returned to lucaromanoo1
lucaromanoo1 collected 41300 from pot
lucaromanoo1: doesn't show hand 
*** SUMMARY ***
Total pot 41300 | Rake 0 
Board [3c Qd Qs]
Seat 1: lucaromanoo1 (big blind) collected (41300)
Seat 2: mobky folded before Flop (didn't bet)
Seat 3: supervaganj folded on the Flop
Seat 4: Vamoclan folded before Flop (didn't bet)
Seat 5: pj0901 folded before Flop (didn't bet)
Seat 6: Proosty2 folded before Flop (didn't bet)
Seat 7: gibbo888 (button) folded before Flop (didn't bet)
Seat 8: DR. ELDAR (small blind) folded before Flop

PokerStars Hand #251206918858: Tournament #3767885527, $40+$10+$5 USD Hold'em No Limit - Level XIX (2500/5000) - 2024/06/26 20:27:32 UTC [2024/06/26 16:27:32 ET]
Table '3767885527 93' 8-max Seat #8 is the button
Seat 1: lucaromanoo1 (206629 in chips) 
Seat 2: mobky (44252 in chips) 
Seat 3: supervaganj (123765 in chips) 
Seat 4: Vamoclan (59974 in chips) 
Seat 5: pj0901 (250117 in chips) 
Seat 6: Proosty2 (64103 in chips) 
Seat 7: gibbo888 (266241 in chips) 
Seat 8: DR. ELDAR (84641 in chips) 
lucaromanoo1: posts the ante 625
mobky: posts the ante 625
supervaganj: posts the ante 625
Vamoclan: posts the ante 625
pj0901: posts the ante 625
Proosty2: posts the ante 625
gibbo888: posts the ante 625
DR. ELDAR: posts the ante 625
lucaromanoo1: posts small blind 2500
mobky: posts big blind 5000
*** HOLE CARDS ***
supervaganj: folds 
Vamoclan: folds 
pj0901: raises 5000 to 10000
Proosty2: folds 
gibbo888: folds 
DR. ELDAR: folds 
lucaromanoo1: calls 7500
mobky: folds 
*** FLOP *** [8s 9s 8h]
lucaromanoo1: checks 
pj0901: checks 
*** TURN *** [8s 9s 8h] [2h]
lucaromanoo1: checks 
pj0901: checks 
*** RIVER *** [8s 9s 8h 2h] [Kd]
lucaromanoo1: checks 
pj0901: checks 
*** SHOW DOWN ***
lucaromanoo1: shows [7h 7s] (two pair, Eights and Sevens)
pj0901: mucks hand 
lucaromanoo1 collected 30000 from pot
*** SUMMARY ***
Total pot 30000 | Rake 0 
Board [8s 9s 8h 2h Kd]
Seat 1: lucaromanoo1 (small blind) showed [7h 7s] and won (30000) with two pair, Eights and Sevens
Seat 2: mobky (big blind) folded before Flop
Seat 3: supervaganj folded before Flop (didn't bet)
Seat 4: Vamoclan folded before Flop (didn't bet)
Seat 5: pj0901 mucked
Seat 6: Proosty2 folded before Flop (didn't bet)
Seat 7: gibbo888 folded before Flop (didn't bet)
Seat 8: DR. ELDAR (button) folded before Flop (didn't bet)

PokerStars Hand #251206944723: Tournament #3767885527, $40+$10+$5 USD Hold'em No Limit - Level XIX (2500/5000) - 2024/06/26 20:29:05 UTC [2024/06/26 16:29:05 ET]
Table '3767885527 93' 8-max Seat #1 is the button
Seat 1: lucaromanoo1 (226004 in chips) 
Seat 2: mobky (38627 in chips) 
Seat 3: supervaganj (123140 in chips) 
Seat 4: Vamoclan (59349 in chips) 
Seat 5: pj0901 (239492 in chips) 
Seat 6: Proosty2 (63478 in chips) 
Seat 7: gibbo888 (265616 in chips) 
Seat 8: DR. ELDAR (84016 in chips) 
lucaromanoo1: posts the ante 625
mobky: posts the ante 625
supervaganj: posts the ante 625
Vamoclan: posts the ante 625
pj0901: posts the ante 625
Proosty2: posts the ante 625
gibbo888: posts the ante 625
DR. ELDAR: posts the ante 625
mobky: posts small blind 2500
supervaganj: posts big blind 5000
*** HOLE CARDS ***
Vamoclan: folds 
pj0901: folds 
Proosty2: folds 
gibbo888: raises 5000 to 10000
DR. ELDAR: folds 
lucaromanoo1: folds 
mobky: folds 
supervaganj: calls 5000
*** FLOP *** [Ah 5d 2h]
supervaganj: checks 
gibbo888: bets 12100
supervaganj: folds 
Uncalled bet (12100) returned to gibbo888
gibbo888 collected 27500 from pot
gibbo888: doesn't show hand 
*** SUMMARY ***
Total pot 27500 | Rake 0 
Board [Ah 5d 2h]
Seat 1: lucaromanoo1 (button) folded before Flop (didn't bet)
Seat 2: mobky (small blind) folded before Flop
Seat 3: supervaganj (big blind) folded on the Flop
Seat 4: Vamoclan folded before Flop (didn't bet)
Seat 5: pj0901 folded before Flop (didn't bet)
Seat 6: Proosty2 folded before Flop (didn't bet)
Seat 7: gibbo888 collected (27500)
Seat 8: DR. ELDAR folded before Flop (didn't bet)

PokerStars Hand #251206960344: Tournament #3767885527, $40+$10+$5 USD Hold'em No Limit - Level XIX (2500/5000) - 2024/06/26 20:30:01 UTC [2024/06/26 16:30:01 ET]
Table '3767885527 93' 8-max Seat #2 is the button
Seat 1: lucaromanoo1 (225379 in chips) 
Seat 2: mobky (35502 in chips) 
Seat 3: supervaganj (112515 in chips) 
Seat 4: Vamoclan (58724 in chips) 
Seat 5: pj0901 (238867 in chips) 
Seat 6: Proosty2 (62853 in chips) 
Seat 7: gibbo888 (282491 in chips) 
Seat 8: DR. ELDAR (83391 in chips) 
lucaromanoo1: posts the ante 625
mobky: posts the ante 625
supervaganj: posts the ante 625
Vamoclan: posts the ante 625
pj0901: posts the ante 625
Proosty2: posts the ante 625
gibbo888: posts the ante 625
DR. ELDAR: posts the ante 625
supervaganj: posts small blind 2500
Vamoclan: posts big blind 5000
*** HOLE CARDS ***
pj0901: folds 
Proosty2: folds 
gibbo888: folds 
DR. ELDAR: folds 
lucaromanoo1: folds 
mobky: folds 
supervaganj: raises 106890 to 111890 and is all-in
Vamoclan: folds 
Uncalled bet (106890) returned to supervaganj
supervaganj collected 15000 from pot
supervaganj: doesn't show hand 
*** SUMMARY ***
Total pot 15000 | Rake 0 
Seat 1: lucaromanoo1 folded before Flop (didn't bet)
Seat 2: mobky (button) folded before Flop (didn't bet)
Seat 3: supervaganj (small blind) collected (15000)
Seat 4: Vamoclan (big blind) folded before Flop
Seat 5: pj0901 folded before Flop (didn't bet)
Seat 6: Proosty2 folded before Flop (didn't bet)
Seat 7: gibbo888 folded before Flop (didn't bet)
Seat 8: DR. ELDAR folded before Flop (didn't bet)

PokerStars Hand #251206971586: Tournament #3767885527, $40+$10+$5 USD Hold'em No Limit - Level XIX (2500/5000) - 2024/06/26 20:30:42 UTC [2024/06/26 16:30:42 ET]
Table '3767885527 93' 8-max Seat #3 is the button
Seat 1: lucaromanoo1 (224754 in chips) 
Seat 2: mobky (34877 in chips) 
Seat 3: supervaganj (121890 in chips) 
Seat 4: Vamoclan (53099 in chips) 
Seat 5: pj0901 (238242 in chips) 
Seat 6: Proosty2 (62228 in chips) 
Seat 7: gibbo888 (281866 in chips) 
Seat 8: DR. ELDAR (82766 in chips) 
lucaromanoo1: posts the ante 625
mobky: posts the ante 625
supervaganj: posts the ante 625
Vamoclan: posts the ante 625
pj0901: posts the ante 625
Proosty2: posts the ante 625
gibbo888: posts the ante 625
DR. ELDAR: posts the ante 625
Vamoclan: posts small blind 2500
pj0901: posts big blind 5000
*** HOLE CARDS ***
Proosty2: folds 
gibbo888: folds 
DR. ELDAR: folds 
lucaromanoo1: folds 
mobky: folds 
supervaganj: folds 
Vamoclan: folds 
Uncalled bet (2500) returned to pj0901
pj0901 collected 10000 from pot
pj0901: doesn't show hand 
*** SUMMARY ***
Total pot 10000 | Rake 0 
Seat 1: lucaromanoo1 folded before Flop (didn't bet)
Seat 2: mobky folded before Flop (didn't bet)
Seat 3: supervaganj (button) folded before Flop (didn't bet)
Seat 4: Vamoclan (small blind) folded before Flop
Seat 5: pj0901 (big blind) collected (10000)
Seat 6: Proosty2 folded before Flop (didn't bet)
Seat 7: gibbo888 folded before Flop (didn't bet)
Seat 8: DR. ELDAR folded before Flop (didn't bet)

PokerStars Hand #251206984975: Tournament #3767885527, $40+$10+$5 USD Hold'em No Limit - Level XIX (2500/5000) - 2024/06/26 20:31:30 UTC [2024/06/26 16:31:30 ET]
Table '3767885527 93' 8-max Seat #4 is the button
Seat 1: lucaromanoo1 (224129 in chips) 
Seat 2: mobky (34252 in chips) 
Seat 3: supervaganj (121265 in chips) 
Seat 4: Vamoclan (49974 in chips) 
Seat 5: pj0901 (245117 in chips) 
Seat 6: Proosty2 (61603 in chips) 
Seat 7: gibbo888 (281241 in chips) 
Seat 8: DR. ELDAR (82141 in chips) 
lucaromanoo1: posts the ante 625
mobky: posts the ante 625
supervaganj: posts the ante 625
Vamoclan: posts the ante 625
pj0901: posts the ante 625
Proosty2: posts the ante 625
gibbo888: posts the ante 625
DR. ELDAR: posts the ante 625
pj0901: posts small blind 2500
Proosty2: posts big blind 5000
*** HOLE CARDS ***
gibbo888: folds 
DR. ELDAR: folds 
lucaromanoo1: folds 
mobky has timed out
mobky: folds 
mobky is sitting out
mobky has returned
supervaganj: folds 
Vamoclan: folds 
pj0901: raises 239492 to 244492 and is all-in
Proosty2: folds 
Uncalled bet (239492) returned to pj0901
pj0901 collected 15000 from pot
pj0901: doesn't show hand 
*** SUMMARY ***
Total pot 15000 | Rake 0 
Seat 1: lucaromanoo1 folded before Flop (didn't bet)
Seat 2: mobky folded before Flop (didn't bet)
Seat 3: supervaganj folded before Flop (didn't bet)
Seat 4: Vamoclan (button) folded before Flop (didn't bet)
Seat 5: pj0901 (small blind) collected (15000)
Seat 6: Proosty2 (big blind) folded before Flop
Seat 7: gibbo888 folded before Flop (didn't bet)
Seat 8: DR. ELDAR folded before Flop (didn't bet)

PokerStars Hand #251206999200: Tournament #3767885527, $40+$10+$5 USD Hold'em No Limit - Level XIX (2500/5000) - 2024/06/26 20:32:20 UTC [2024/06/26 16:32:20 ET]
Table '3767885527 93' 8-max Seat #5 is the button
Seat 1: lucaromanoo1 (223504 in chips) 
Seat 2: mobky (33627 in chips) 
Seat 3: supervaganj (120640 in chips) 
Seat 4: Vamoclan (49349 in chips) 
Seat 5: pj0901 (254492 in chips) 
Seat 6: Proosty2 (55978 in chips) 
Seat 7: gibbo888 (280616 in chips) 
Seat 8: DR. ELDAR (81516 in chips) 
lucaromanoo1: posts the ante 625
mobky: posts the ante 625
supervaganj: posts the ante 625
Vamoclan: posts the ante 625
pj0901: posts the ante 625
Proosty2: posts the ante 625
gibbo888: posts the ante 625
DR. ELDAR: posts the ante 625
Proosty2: posts small blind 2500
gibbo888: posts big blind 5000
*** HOLE CARDS ***
DR. ELDAR: folds 
lucaromanoo1: folds 
mobky: folds 
supervaganj: raises 5000 to 10000
Vamoclan: folds 
pj0901: raises 15000 to 25000
Proosty2: folds 
gibbo888: raises 250000 to 275000
supervaganj: folds 
pj0901: folds 
Uncalled bet (250000) returned to gibbo888
gibbo888 collected 67500 from pot
gibbo888: doesn't show hand 
*** SUMMARY ***
Total pot 67500 | Rake 0 
Seat 1: lucaromanoo1 folded before Flop (didn't bet)
Seat 2: mobky folded before Flop (didn't bet)
Seat 3: supervaganj folded before Flop
Seat 4: Vamoclan folded before Flop (didn't bet)
Seat 5: pj0901 (button) folded before Flop
Seat 6: Proosty2 (small blind) folded before Flop
Seat 7: gibbo888 (big blind) collected (67500)
Seat 8: DR. ELDAR folded before Flop (didn't bet)

PokerStars Hand #251207031999: Tournament #3767885527, $40+$10+$5 USD Hold'em No Limit - Level XIX (2500/5000) - 2024/06/26 20:34:17 UTC [2024/06/26 16:34:17 ET]
Table '3767885527 93' 8-max Seat #6 is the button
Seat 1: lucaromanoo1 (222879 in chips) 
Seat 2: mobky (33002 in chips) 
Seat 3: supervaganj (110015 in chips) 
Seat 4: Vamoclan (48724 in chips) 
Seat 5: pj0901 (228867 in chips) 
Seat 6: Proosty2 (52853 in chips) 
Seat 7: gibbo888 (322491 in chips) 
Seat 8: DR. ELDAR (80891 in chips) 
lucaromanoo1: posts the ante 625
mobky: posts the ante 625
supervaganj: posts the ante 625
Vamoclan: posts the ante 625
pj0901: posts the ante 625
Proosty2: posts the ante 625
gibbo888: posts the ante 625
DR. ELDAR: posts the ante 625
gibbo888: posts small blind 2500
DR. ELDAR: posts big blind 5000
*** HOLE CARDS ***
lucaromanoo1: raises 5000 to 10000
mobky: folds 
supervaganj: folds 
Vamoclan: folds 
pj0901: folds 
Proosty2: folds 
gibbo888: folds 
DR. ELDAR: folds 
Uncalled bet (5000) returned to lucaromanoo1
lucaromanoo1 collected 17500 from pot
lucaromanoo1: doesn't show hand 
*** SUMMARY ***
Total pot 17500 | Rake 0 
Seat 1: lucaromanoo1 collected (17500)
Seat 2: mobky folded before Flop (didn't bet)
Seat 3: supervaganj folded before Flop (didn't bet)
Seat 4: Vamoclan folded before Flop (didn't bet)
Seat 5: pj0901 folded before Flop (didn't bet)
Seat 6: Proosty2 (button) folded before Flop (didn't bet)
Seat 7: gibbo888 (small blind) folded before Flop
Seat 8: DR. ELDAR (big blind) folded before Flop

PokerStars Hand #251207037505: Tournament #3767885527, $40+$10+$5 USD Hold'em No Limit - Level XIX (2500/5000) - 2024/06/26 20:34:36 UTC [2024/06/26 16:34:36 ET]
Table '3767885527 93' 8-max Seat #7 is the button
Seat 1: lucaromanoo1 (234754 in chips) 
Seat 2: mobky (32377 in chips) 
Seat 3: supervaganj (109390 in chips) 
Seat 4: Vamoclan (48099 in chips) 
Seat 5: pj0901 (228242 in chips) 
Seat 6: Proosty2 (52228 in chips) 
Seat 7: gibbo888 (319366 in chips) 
Seat 8: DR. ELDAR (75266 in chips) 
lucaromanoo1: posts the ante 625
mobky: posts the ante 625
supervaganj: posts the ante 625
Vamoclan: posts the ante 625
pj0901: posts the ante 625
Proosty2: posts the ante 625
gibbo888: posts the ante 625
DR. ELDAR: posts the ante 625
DR. ELDAR: posts small blind 2500
lucaromanoo1: posts big blind 5000
*** HOLE CARDS ***
mobky: folds 
supervaganj: folds 
Vamoclan: folds 
pj0901: raises 5000 to 10000
Proosty2: folds 
gibbo888: folds 
DR. ELDAR: folds 
lucaromanoo1: calls 5000
*** FLOP *** [Kh 3h 5h]
lucaromanoo1: checks 
pj0901: checks 
*** TURN *** [Kh 3h 5h] [3d]
lucaromanoo1: bets 21175
pj0901: calls 21175
*** RIVER *** [Kh 3h 5h 3d] [2c]
lucaromanoo1: bets 70000
pj0901: calls 70000
*** SHOW DOWN ***
lucaromanoo1: shows [Jh 4h] (a flush, King high)
pj0901: mucks hand 
lucaromanoo1 collected 209850 from pot
*** SUMMARY ***
Total pot 209850 | Rake 0 
Board [Kh 3h 5h 3d 2c]
Seat 1: lucaromanoo1 (big blind) showed [Jh 4h] and won (209850) with a flush, King high
Seat 2: mobky folded before Flop (didn't bet)
Seat 3: supervaganj folded before Flop (didn't bet)
Seat 4: Vamoclan folded before Flop (didn't bet)
Seat 5: pj0901 mucked
Seat 6: Proosty2 folded before Flop (didn't bet)
Seat 7: gibbo888 (button) folded before Flop (didn't bet)
Seat 8: DR. ELDAR (small blind) folded before Flop

PokerStars Hand #251207057855: Tournament #3767885527, $40+$10+$5 USD Hold'em No Limit - Level XIX (2500/5000) - 2024/06/26 20:35:48 UTC [2024/06/26 16:35:48 ET]
Table '3767885527 93' 8-max Seat #8 is the button
Seat 1: lucaromanoo1 (342804 in chips) 
Seat 2: mobky (31752 in chips) 
Seat 3: supervaganj (108765 in chips) 
Seat 4: Vamoclan (47474 in chips) 
Seat 5: pj0901 (126442 in chips) 
Seat 6: Proosty2 (51603 in chips) 
Seat 7: gibbo888 (318741 in chips) 
Seat 8: DR. ELDAR (72141 in chips) 
lucaromanoo1: posts the ante 625
mobky: posts the ante 625
supervaganj: posts the ante 625
Vamoclan: posts the ante 625
pj0901: posts the ante 625
Proosty2: posts the ante 625
gibbo888: posts the ante 625
DR. ELDAR: posts the ante 625
lucaromanoo1: posts small blind 2500
mobky: posts big blind 5000
*** HOLE CARDS ***
supervaganj: folds 
Vamoclan: folds 
pj0901: folds 
Proosty2: folds 
gibbo888: folds 
DR. ELDAR: folds 
lucaromanoo1: raises 337179 to 342179 and is all-in
mobky: calls 26127 and is all-in
Uncalled bet (311052) returned to lucaromanoo1
*** FLOP *** [Td 3c 3s]
*** TURN *** [Td 3c 3s] [Th]
*** RIVER *** [Td 3c 3s Th] [Ks]
*** SHOW DOWN ***
lucaromanoo1: shows [8h Ah] (two pair, Tens and Threes)
mobky: shows [Kh 5h] (two pair, Kings and Tens)
mobky collected 67254 from pot
*** SUMMARY ***
Total pot 67254 | Rake 0 
Board [Td 3c 3s Th Ks]
Seat 1: lucaromanoo1 (small blind) showed [8h Ah] and lost with two pair, Tens and Threes
Seat 2: mobky (big blind) showed [Kh 5h] and won (67254) with two pair, Kings and Tens
Seat 3: supervaganj folded before Flop (didn't bet)
Seat 4: Vamoclan folded before Flop (didn't bet)
Seat 5: pj0901 folded before Flop (didn't bet)
Seat 6: Proosty2 folded before Flop (didn't bet)
Seat 7: gibbo888 folded before Flop (didn't bet)
Seat 8: DR. ELDAR (button) folded before Flop (didn't bet)

PokerStars Hand #251207066741: Tournament #3767885527, $40+$10+$5 USD Hold'em No Limit - Level XX (3000/6000) - 2024/06/26 20:36:19 UTC [2024/06/26 16:36:19 ET]
Table '3767885527 93' 8-max Seat #1 is the button
Seat 1: lucaromanoo1 (311052 in chips) 
Seat 2: mobky (67254 in chips) 
Seat 3: supervaganj (108140 in chips) 
Seat 4: Vamoclan (46849 in chips) 
Seat 5: pj0901 (125817 in chips) 
Seat 6: Proosty2 (50978 in chips) 
Seat 7: gibbo888 (318116 in chips) 
Seat 8: DR. ELDAR (71516 in chips) 
lucaromanoo1: posts the ante 750
mobky: posts the ante 750
supervaganj: posts the ante 750
Vamoclan: posts the ante 750
pj0901: posts the ante 750
Proosty2: posts the ante 750
gibbo888: posts the ante 750
DR. ELDAR: posts the ante 750
mobky: posts small blind 3000
supervaganj: posts big blind 6000
*** HOLE CARDS ***
Vamoclan: folds 
pj0901: folds 
Proosty2: folds 
gibbo888: folds 
DR. ELDAR: folds 
lucaromanoo1: raises 304302 to 310302 and is all-in
mobky: calls 63504 and is all-in
supervaganj: folds 
Uncalled bet (243798) returned to lucaromanoo1
*** FLOP *** [2h Ad 7s]
*** TURN *** [2h Ad 7s] [5s]
*** RIVER *** [2h Ad 7s 5s] [Jh]
*** SHOW DOWN ***
mobky: shows [Kc Ks] (a pair of Kings)
lucaromanoo1: shows [Ah 5c] (two pair, Aces and Fives)
lucaromanoo1 collected 145008 from pot
mobky finished the tournament in 283rd place and received $104.64.
*** SUMMARY ***
Total pot 145008 | Rake 0 
Board [2h Ad 7s 5s Jh]
Seat 1: lucaromanoo1 (button) showed [Ah 5c] and won (145008) with two pair, Aces and Fives
Seat 2: mobky (small blind) showed [Kc Ks] and lost with a pair of Kings
Seat 3: supervaganj (big blind) folded before Flop
Seat 4: Vamoclan folded before Flop (didn't bet)
Seat 5: pj0901 folded before Flop (didn't bet)
Seat 6: Proosty2 folded before Flop (didn't bet)
Seat 7: gibbo888 folded before Flop (didn't bet)
Seat 8: DR. ELDAR folded before Flop (didn't bet)

PokerStars Hand #251207074223: Tournament #3767885527, $40+$10+$5 USD Hold'em No Limit - Level XX (3000/6000) - 2024/06/26 20:36:46 UTC [2024/06/26 16:36:46 ET]
Table '3767885527 93' 8-max Seat #3 is the button
Seat 1: lucaromanoo1 (388806 in chips) 
Seat 3: supervaganj (101390 in chips) 
Seat 4: Vamoclan (46099 in chips) 
Seat 5: pj0901 (125067 in chips) 
Seat 6: Proosty2 (50228 in chips) 
Seat 7: gibbo888 (317366 in chips) 
Seat 8: DR. ELDAR (70766 in chips) 
lucaromanoo1: posts the ante 750
supervaganj: posts the ante 750
Vamoclan: posts the ante 750
pj0901: posts the ante 750
Proosty2: posts the ante 750
gibbo888: posts the ante 750
DR. ELDAR: posts the ante 750
Vamoclan: posts small blind 3000
pj0901: posts big blind 6000
*** HOLE CARDS ***
GUIDAASCANIO is disconnected 
Proosty2: folds 
gibbo888: folds 
DR. ELDAR: raises 64016 to 70016 and is all-in
lucaromanoo1: folds 
supervaganj: folds 
Vamoclan: folds 
pj0901: folds 
Uncalled bet (64016) returned to DR. ELDAR
DR. ELDAR collected 20250 from pot
DR. ELDAR: doesn't show hand 
*** SUMMARY ***
Total pot 20250 | Rake 0 
Seat 1: lucaromanoo1 folded before Flop (didn't bet)
Seat 3: supervaganj (button) folded before Flop (didn't bet)
Seat 4: Vamoclan (small blind) folded before Flop
Seat 5: pj0901 (big blind) folded before Flop
Seat 6: Proosty2 folded before Flop (didn't bet)
Seat 7: gibbo888 folded before Flop (didn't bet)
Seat 8: DR. ELDAR collected (20250)

PokerStars Hand #251207085166: Tournament #3767885527, $40+$10+$5 USD Hold'em No Limit - Level XX (3000/6000) - 2024/06/26 20:37:24 UTC [2024/06/26 16:37:24 ET]
Table '3767885527 93' 8-max Seat #4 is the button
Seat 1: lucaromanoo1 (388056 in chips) 
Seat 2: GUIDAASCANIO (100980 in chips) 
Seat 3: supervaganj (100640 in chips) 
Seat 4: Vamoclan (42349 in chips) 
Seat 5: pj0901 (118317 in chips) 
Seat 6: Proosty2 (49478 in chips) 
Seat 7: gibbo888 (316616 in chips) 
Seat 8: DR. ELDAR (84266 in chips) 
lucaromanoo1: posts the ante 750
GUIDAASCANIO: posts the ante 750
supervaganj: posts the ante 750
Vamoclan: posts the ante 750
pj0901: posts the ante 750
Proosty2: posts the ante 750
gibbo888: posts the ante 750
DR. ELDAR: posts the ante 750
pj0901: posts small blind 3000
Proosty2: posts big blind 6000
*** HOLE CARDS ***
gibbo888: folds 
DR. ELDAR: folds 
lucaromanoo1: folds 
GUIDAASCANIO: folds 
supervaganj: folds 
Vamoclan: raises 35599 to 41599 and is all-in
pj0901: folds 
Proosty2: folds 
Uncalled bet (35599) returned to Vamoclan
Vamoclan collected 21000 from pot
Vamoclan: doesn't show hand 
*** SUMMARY ***
Total pot 21000 | Rake 0 
Seat 1: lucaromanoo1 folded before Flop (didn't bet)
Seat 2: GUIDAASCANIO folded before Flop (didn't bet)
Seat 3: supervaganj folded before Flop (didn't bet)
Seat 4: Vamoclan (button) collected (21000)
Seat 5: pj0901 (small blind) folded before Flop
Seat 6: Proosty2 (big blind) folded before Flop
Seat 7: gibbo888 folded before Flop (didn't bet)
Seat 8: DR. ELDAR folded before Flop (didn't bet)

PokerStars Hand #251207090923: Tournament #3767885527, $40+$10+$5 USD Hold'em No Limit - Level XX (3000/6000) - 2024/06/26 20:37:45 UTC [2024/06/26 16:37:45 ET]
Table '3767885527 93' 8-max Seat #5 is the button
Seat 1: lucaromanoo1 (387306 in chips) 
Seat 2: GUIDAASCANIO (100230 in chips) 
Seat 3: supervaganj (99890 in chips) 
Seat 4: Vamoclan (56599 in chips) 
Seat 5: pj0901 (114567 in chips) 
Seat 6: Proosty2 (42728 in chips) 
Seat 7: gibbo888 (315866 in chips) 
Seat 8: DR. ELDAR (83516 in chips) 
lucaromanoo1: posts the ante 750
GUIDAASCANIO: posts the ante 750
supervaganj: posts the ante 750
Vamoclan: posts the ante 750
pj0901: posts the ante 750
Proosty2: posts the ante 750
gibbo888: posts the ante 750
DR. ELDAR: posts the ante 750
Proosty2: posts small blind 3000
gibbo888: posts big blind 6000
*** HOLE CARDS ***
DR. ELDAR: raises 6600 to 12600
lucaromanoo1: folds 
GUIDAASCANIO: folds 
supervaganj: folds 
Vamoclan: folds 
pj0901: raises 11400 to 24000
Proosty2: folds 
gibbo888: folds 
DR. ELDAR: calls 11400
*** FLOP *** [2d Jc 7h]
DR. ELDAR: checks 
pj0901: bets 6000
DR. ELDAR: calls 6000
*** TURN *** [2d Jc 7h] [7c]
DR. ELDAR: checks 
pj0901: bets 12750
DR. ELDAR: raises 40016 to 52766 and is all-in
pj0901: calls 40016
*** RIVER *** [2d Jc 7h 7c] [3s]
*** SHOW DOWN ***
DR. ELDAR: shows [As 5s] (a pair of Sevens)
pj0901: shows [8c 8s] (two pair, Eights and Sevens)
pj0901 collected 180532 from pot
DR. ELDAR finished the tournament in 267th place and received $104.64.
*** SUMMARY ***
Total pot 180532 | Rake 0 
Board [2d Jc 7h 7c 3s]
Seat 1: lucaromanoo1 folded before Flop (didn't bet)
Seat 2: GUIDAASCANIO folded before Flop (didn't bet)
Seat 3: supervaganj folded before Flop (didn't bet)
Seat 4: Vamoclan folded before Flop (didn't bet)
Seat 5: pj0901 (button) showed [8c 8s] and won (180532) with two pair, Eights and Sevens
Seat 6: Proosty2 (small blind) folded before Flop
Seat 7: gibbo888 (big blind) folded before Flop
Seat 8: DR. ELDAR showed [As 5s] and lost with a pair of Sevens

PokerStars Hand #251207105841: Tournament #3767885527, $40+$10+$5 USD Hold'em No Limit - Level XX (3000/6000) - 2024/06/26 20:38:38 UTC [2024/06/26 16:38:38 ET]
Table '3767885527 93' 8-max Seat #6 is the button
Seat 1: lucaromanoo1 (386556 in chips) 
Seat 2: GUIDAASCANIO (99480 in chips) 
Seat 3: supervaganj (99140 in chips) 
Seat 4: Vamoclan (55849 in chips) 
Seat 5: pj0901 (211583 in chips) 
Seat 6: Proosty2 (38978 in chips) 
Seat 7: gibbo888 (309116 in chips) 
lucaromanoo1: posts the ante 750
GUIDAASCANIO: posts the ante 750
supervaganj: posts the ante 750
Vamoclan: posts the ante 750
pj0901: posts the ante 750
Proosty2: posts the ante 750
gibbo888: posts the ante 750
gibbo888: posts small blind 3000
lucaromanoo1: posts big blind 6000
*** HOLE CARDS ***
GUIDAASCANIO: folds 
supervaganj: folds 
Vamoclan: folds 
pj0901: raises 6000 to 12000
mp5610 is disconnected 
Proosty2: folds 
gibbo888: folds 
lucaromanoo1: calls 6000
*** FLOP *** [Jd 4c 2s]
lucaromanoo1: checks 
pj0901: bets 8063
lucaromanoo1: calls 8063
*** TURN *** [Jd 4c 2s] [4s]
lucaromanoo1: bets 15480
pj0901: calls 15480
*** RIVER *** [Jd 4c 2s 4s] [6c]
lucaromanoo1: checks 
pj0901: checks 
*** SHOW DOWN ***
lucaromanoo1: shows [7c 7d] (two pair, Sevens and Fours)
pj0901: mucks hand 
lucaromanoo1 collected 79336 from pot
*** SUMMARY ***
Total pot 79336 | Rake 0 
Board [Jd 4c 2s 4s 6c]
Seat 1: lucaromanoo1 (big blind) showed [7c 7d] and won (79336) with two pair, Sevens and Fours
Seat 2: GUIDAASCANIO folded before Flop (didn't bet)
Seat 3: supervaganj folded before Flop (didn't bet)
Seat 4: Vamoclan folded before Flop (didn't bet)
Seat 5: pj0901 mucked
Seat 6: Proosty2 (button) folded before Flop (didn't bet)
Seat 7: gibbo888 (small blind) folded before Flop

PokerStars Hand #251207125161: Tournament #3767885527, $40+$10+$5 USD Hold'em No Limit - Level XX (3000/6000) - 2024/06/26 20:39:46 UTC [2024/06/26 16:39:46 ET]
Table '3767885527 93' 8-max Seat #7 is the button
Seat 1: lucaromanoo1 (429599 in chips) 
Seat 2: GUIDAASCANIO (98730 in chips) 
Seat 3: supervaganj (98390 in chips) 
Seat 4: Vamoclan (55099 in chips) 
Seat 5: pj0901 (175290 in chips) 
Seat 6: Proosty2 (38228 in chips) 
Seat 7: gibbo888 (305366 in chips) 
Seat 8: mp5610 (121000 in chips) out of hand (moved from another table into small blind)
mp5610 will be allowed to play after the button
lucaromanoo1: posts the ante 750
GUIDAASCANIO: posts the ante 750
supervaganj: posts the ante 750
Vamoclan: posts the ante 750
pj0901: posts the ante 750
Proosty2: posts the ante 750
gibbo888: posts the ante 750
lucaromanoo1: posts small blind 3000
GUIDAASCANIO: posts big blind 6000
*** HOLE CARDS ***
supervaganj: raises 6000 to 12000
Vamoclan: folds 
pj0901: folds 
Proosty2: folds 
gibbo888: folds 
lucaromanoo1: folds 
GUIDAASCANIO: calls 6000
*** FLOP *** [5d 2s Td]
GUIDAASCANIO: checks 
supervaganj: bets 10643
GUIDAASCANIO: folds 
Uncalled bet (10643) returned to supervaganj
supervaganj collected 32250 from pot
supervaganj: doesn't show hand 
*** SUMMARY ***
Total pot 32250 | Rake 0 
Board [5d 2s Td]
Seat 1: lucaromanoo1 (small blind) folded before Flop
Seat 2: GUIDAASCANIO (big blind) folded on the Flop
Seat 3: supervaganj collected (32250)
Seat 4: Vamoclan folded before Flop (didn't bet)
Seat 5: pj0901 folded before Flop (didn't bet)
Seat 6: Proosty2 folded before Flop (didn't bet)
Seat 7: gibbo888 (button) folded before Flop (didn't bet)

PokerStars Hand #251207133875: Tournament #3767885527, $40+$10+$5 USD Hold'em No Limit - Level XX (3000/6000) - 2024/06/26 20:40:17 UTC [2024/06/26 16:40:17 ET]
Table '3767885527 93' 8-max Seat #1 is the button
Seat 1: lucaromanoo1 (425849 in chips) 
Seat 2: GUIDAASCANIO (85980 in chips) 
Seat 3: supervaganj (117890 in chips) 
Seat 4: Vamoclan (54349 in chips) 
Seat 5: pj0901 (174540 in chips) 
Seat 6: Proosty2 (37478 in chips) 
Seat 7: gibbo888 (304616 in chips) 
Seat 8: mp5610 (121000 in chips) 
lucaromanoo1: posts the ante 750
GUIDAASCANIO: posts the ante 750
supervaganj: posts the ante 750
Vamoclan: posts the ante 750
pj0901: posts the ante 750
Proosty2: posts the ante 750
gibbo888: posts the ante 750
mp5610: posts the ante 750
GUIDAASCANIO: posts small blind 3000
supervaganj: posts big blind 6000
*** HOLE CARDS ***
Vamoclan: folds 
pj0901: raises 6000 to 12000
Proosty2: folds 
gibbo888: folds 
mp5610: folds 
lucaromanoo1: folds 
GUIDAASCANIO: folds 
supervaganj: calls 6000
*** FLOP *** [Th 7s 6h]
supervaganj: checks 
pj0901: bets 8250
supervaganj: calls 8250
*** TURN *** [Th 7s 6h] [Qh]
supervaganj: checks 
pj0901: bets 25800
supervaganj: folds 
Uncalled bet (25800) returned to pj0901
pj0901 collected 49500 from pot
pj0901: doesn't show hand 
*** SUMMARY ***
Total pot 49500 | Rake 0 
Board [Th 7s 6h Qh]
Seat 1: lucaromanoo1 (button) folded before Flop (didn't bet)
Seat 2: GUIDAASCANIO (small blind) folded before Flop
Seat 3: supervaganj (big blind) folded on the Turn
Seat 4: Vamoclan folded before Flop (didn't bet)
Seat 5: pj0901 collected (49500)
Seat 6: Proosty2 folded before Flop (didn't bet)
Seat 7: gibbo888 folded before Flop (didn't bet)
Seat 8: mp5610 folded before Flop (didn't bet)

PokerStars Hand #251207150019: Tournament #3767885527, $40+$10+$5 USD Hold'em No Limit - Level XX (3000/6000) - 2024/06/26 20:41:15 UTC [2024/06/26 16:41:15 ET]
Table '3767885527 93' 8-max Seat #2 is the button
Seat 1: lucaromanoo1 (425099 in chips) 
Seat 2: GUIDAASCANIO (82230 in chips) 
Seat 3: supervaganj (96890 in chips) 
Seat 4: Vamoclan (53599 in chips) 
Seat 5: pj0901 (203040 in chips) 
Seat 6: Proosty2 (36728 in chips) 
Seat 7: gibbo888 (303866 in chips) 
Seat 8: mp5610 (120250 in chips) 
lucaromanoo1: posts the ante 750
GUIDAASCANIO: posts the ante 750
supervaganj: posts the ante 750
Vamoclan: posts the ante 750
pj0901: posts the ante 750
Proosty2: posts the ante 750
gibbo888: posts the ante 750
mp5610: posts the ante 750
supervaganj: posts small blind 3000
Vamoclan: posts big blind 6000
*** HOLE CARDS ***
pj0901 has timed out
pj0901: folds 
pj0901 is sitting out
Proosty2: folds 
gibbo888: raises 6000 to 12000
mp5610: folds 
pj0901 has returned
lucaromanoo1: calls 12000
GUIDAASCANIO: folds 
supervaganj: folds 
Vamoclan: folds 
*** FLOP *** [7d 5d 4d]
gibbo888: bets 26130
lucaromanoo1: calls 26130
*** TURN *** [7d 5d 4d] [Ad]
gibbo888: checks 
lucaromanoo1: checks 
*** RIVER *** [7d 5d 4d Ad] [Kh]
gibbo888: checks 
lucaromanoo1: bets 50193
gibbo888: calls 50193
*** SHOW DOWN ***
lucaromanoo1: shows [Ah Jd] (a flush, Ace high)
gibbo888: mucks hand 
lucaromanoo1 collected 191646 from pot
*** SUMMARY ***
Total pot 191646 | Rake 0 
Board [7d 5d 4d Ad Kh]
Seat 1: lucaromanoo1 showed [Ah Jd] and won (191646) with a flush, Ace high
Seat 2: GUIDAASCANIO (button) folded before Flop (didn't bet)
Seat 3: supervaganj (small blind) folded before Flop
Seat 4: Vamoclan (big blind) folded before Flop
Seat 5: pj0901 folded before Flop (didn't bet)
Seat 6: Proosty2 folded before Flop (didn't bet)
Seat 7: gibbo888 mucked
Seat 8: mp5610 folded before Flop (didn't bet)

PokerStars Hand #251207173831: Tournament #3767885527, $40+$10+$5 USD Hold'em No Limit - Level XX (3000/6000) - 2024/06/26 20:42:41 UTC [2024/06/26 16:42:41 ET]
Table '3767885527 93' 8-max Seat #3 is the button
Seat 1: lucaromanoo1 (527672 in chips) 
Seat 2: GUIDAASCANIO (81480 in chips) 
Seat 3: supervaganj (93140 in chips) 
Seat 4: Vamoclan (46849 in chips) 
Seat 5: pj0901 (202290 in chips) 
Seat 6: Proosty2 (35978 in chips) 
Seat 7: gibbo888 (214793 in chips) 
Seat 8: mp5610 (119500 in chips) 
lucaromanoo1: posts the ante 750
GUIDAASCANIO: posts the ante 750
supervaganj: posts the ante 750
Vamoclan: posts the ante 750
pj0901: posts the ante 750
Proosty2: posts the ante 750
gibbo888: posts the ante 750
mp5610: posts the ante 750
Vamoclan: posts small blind 3000
pj0901: posts big blind 6000
*** HOLE CARDS ***
Proosty2: folds 
gibbo888: folds 
mp5610: folds 
lucaromanoo1: folds 
GUIDAASCANIO: folds 
supervaganj: raises 6000 to 12000
Vamoclan: folds 
pj0901: raises 189540 to 201540 and is all-in
supervaganj: folds 
Uncalled bet (189540) returned to pj0901
pj0901 collected 33000 from pot
pj0901: doesn't show hand 
*** SUMMARY ***
Total pot 33000 | Rake 0 
Seat 1: lucaromanoo1 folded before Flop (didn't bet)
Seat 2: GUIDAASCANIO folded before Flop (didn't bet)
Seat 3: supervaganj (button) folded before Flop
Seat 4: Vamoclan (small blind) folded before Flop
Seat 5: pj0901 (big blind) collected (33000)
Seat 6: Proosty2 folded before Flop (didn't bet)
Seat 7: gibbo888 folded before Flop (didn't bet)
Seat 8: mp5610 folded before Flop (didn't bet)

PokerStars Hand #251207185765: Tournament #3767885527, $40+$10+$5 USD Hold'em No Limit - Level XX (3000/6000) - 2024/06/26 20:43:24 UTC [2024/06/26 16:43:24 ET]
Table '3767885527 93' 8-max Seat #4 is the button
Seat 1: lucaromanoo1 (526922 in chips) 
Seat 2: GUIDAASCANIO (80730 in chips) 
Seat 3: supervaganj (80390 in chips) 
Seat 4: Vamoclan (43099 in chips) 
Seat 5: pj0901 (222540 in chips) 
Seat 6: Proosty2 (35228 in chips) 
Seat 7: gibbo888 (214043 in chips) 
Seat 8: mp5610 (118750 in chips) 
lucaromanoo1: posts the ante 750
GUIDAASCANIO: posts the ante 750
supervaganj: posts the ante 750
Vamoclan: posts the ante 750
pj0901: posts the ante 750
Proosty2: posts the ante 750
gibbo888: posts the ante 750
mp5610: posts the ante 750
pj0901: posts small blind 3000
Proosty2: posts big blind 6000
*** HOLE CARDS ***
gibbo888: folds 
mp5610: folds 
lucaromanoo1: folds 
GUIDAASCANIO: folds 
supervaganj: folds 
Vamoclan: folds 
pj0901: raises 36000 to 42000
Proosty2: calls 28478 and is all-in
Uncalled bet (7522) returned to pj0901
*** FLOP *** [6h Jd 9c]
*** TURN *** [6h Jd 9c] [7c]
*** RIVER *** [6h Jd 9c 7c] [Jh]
*** SHOW DOWN ***
pj0901: shows [3h Kh] (a pair of Jacks)
Proosty2: shows [Qd Qh] (two pair, Queens and Jacks)
Proosty2 collected 74956 from pot
*** SUMMARY ***
Total pot 74956 | Rake 0 
Board [6h Jd 9c 7c Jh]
Seat 1: lucaromanoo1 folded before Flop (didn't bet)
Seat 2: GUIDAASCANIO folded before Flop (didn't bet)
Seat 3: supervaganj folded before Flop (didn't bet)
Seat 4: Vamoclan (button) folded before Flop (didn't bet)
Seat 5: pj0901 (small blind) showed [3h Kh] and lost with a pair of Jacks
Seat 6: Proosty2 (big blind) showed [Qd Qh] and won (74956) with two pair, Queens and Jacks
Seat 7: gibbo888 folded before Flop (didn't bet)
Seat 8: mp5610 folded before Flop (didn't bet)

PokerStars Hand #251207195393: Tournament #3767885527, $40+$10+$5 USD Hold'em No Limit - Level XX (3000/6000) - 2024/06/26 20:44:00 UTC [2024/06/26 16:44:00 ET]
Table '3767885527 93' 8-max Seat #5 is the button
Seat 1: lucaromanoo1 (526172 in chips) 
Seat 2: GUIDAASCANIO (79980 in chips) 
Seat 3: supervaganj (79640 in chips) 
Seat 4: Vamoclan (42349 in chips) 
Seat 5: pj0901 (187312 in chips) 
Seat 6: Proosty2 (74956 in chips) 
Seat 7: gibbo888 (213293 in chips) 
Seat 8: mp5610 (118000 in chips) 
lucaromanoo1: posts the ante 750
GUIDAASCANIO: posts the ante 750
supervaganj: posts the ante 750
Vamoclan: posts the ante 750
pj0901: posts the ante 750
Proosty2: posts the ante 750
gibbo888: posts the ante 750
mp5610: posts the ante 750
Proosty2: posts small blind 3000
gibbo888: posts big blind 6000
*** HOLE CARDS ***
mp5610: folds 
lucaromanoo1: folds 
GUIDAASCANIO: folds 
supervaganj: folds 
Vamoclan: folds 
pj0901: folds 
Proosty2: raises 68206 to 74206 and is all-in
gibbo888: calls 68206
*** FLOP *** [2s Js 9c]
*** TURN *** [2s Js 9c] [Ah]
*** RIVER *** [2s Js 9c Ah] [Jh]
*** SHOW DOWN ***
Proosty2: shows [4c Kd] (a pair of Jacks)
gibbo888: shows [Ac Jc] (a full house, Jacks full of Aces)
gibbo888 collected 154412 from pot
Proosty2 finished the tournament in 226th place and received $115.10.
*** SUMMARY ***
Total pot 154412 | Rake 0 
Board [2s Js 9c Ah Jh]
Seat 1: lucaromanoo1 folded before Flop (didn't bet)
Seat 2: GUIDAASCANIO folded before Flop (didn't bet)
Seat 3: supervaganj folded before Flop (didn't bet)
Seat 4: Vamoclan folded before Flop (didn't bet)
Seat 5: pj0901 (button) folded before Flop (didn't bet)
Seat 6: Proosty2 (small blind) showed [4c Kd] and lost with a pair of Jacks
Seat 7: gibbo888 (big blind) showed [Ac Jc] and won (154412) with a full house, Jacks full of Aces
Seat 8: mp5610 folded before Flop (didn't bet)

PokerStars Hand #251207203599: Tournament #3767885527, $40+$10+$5 USD Hold'em No Limit - Level XX (3000/6000) - 2024/06/26 20:44:30 UTC [2024/06/26 16:44:30 ET]
Table '3767885527 93' 8-max Seat #7 is the button
Seat 1: lucaromanoo1 (525422 in chips) 
Seat 2: GUIDAASCANIO (79230 in chips) 
Seat 3: supervaganj (78890 in chips) 
Seat 4: Vamoclan (41599 in chips) 
Seat 5: pj0901 (186562 in chips) 
Seat 7: gibbo888 (292749 in chips) 
Seat 8: mp5610 (117250 in chips) 
lucaromanoo1: posts the ante 750
GUIDAASCANIO: posts the ante 750
supervaganj: posts the ante 750
Vamoclan: posts the ante 750
pj0901: posts the ante 750
gibbo888: posts the ante 750
mp5610: posts the ante 750
mp5610: posts small blind 3000
lucaromanoo1: posts big blind 6000
*** HOLE CARDS ***
GUIDAASCANIO: folds 
supervaganj: folds 
Vamoclan: raises 34849 to 40849 and is all-in
pj0901: folds 
gibbo888: folds 
Biguethi339 is disconnected 
mp5610: folds 
lucaromanoo1: folds 
Uncalled bet (34849) returned to Vamoclan
Vamoclan collected 20250 from pot
Vamoclan: doesn't show hand 
*** SUMMARY ***
Total pot 20250 | Rake 0 
Seat 1: lucaromanoo1 (big blind) folded before Flop
Seat 2: GUIDAASCANIO folded before Flop (didn't bet)
Seat 3: supervaganj folded before Flop (didn't bet)
Seat 4: Vamoclan collected (20250)
Seat 5: pj0901 folded before Flop (didn't bet)
Seat 7: gibbo888 (button) folded before Flop (didn't bet)
Seat 8: mp5610 (small blind) folded before Flop

PokerStars Hand #251207210628: Tournament #3767885527, $40+$10+$5 USD Hold'em No Limit - Level XX (3000/6000) - 2024/06/26 20:44:56 UTC [2024/06/26 16:44:56 ET]
Table '3767885527 93' 8-max Seat #8 is the button
Seat 1: lucaromanoo1 (518672 in chips) 
Seat 2: GUIDAASCANIO (78480 in chips) 
Seat 3: supervaganj (78140 in chips) 
Seat 4: Vamoclan (55099 in chips) 
Seat 5: pj0901 (185812 in chips) 
Seat 6: Biguethi339 (231272 in chips) 
Seat 7: gibbo888 (291999 in chips) 
Seat 8: mp5610 (113500 in chips) 
lucaromanoo1: posts the ante 750
GUIDAASCANIO: posts the ante 750
supervaganj: posts the ante 750
Vamoclan: posts the ante 750
pj0901: posts the ante 750
Biguethi339: posts the ante 750
gibbo888: posts the ante 750
mp5610: posts the ante 750
lucaromanoo1: posts small blind 3000
GUIDAASCANIO: posts big blind 6000
*** HOLE CARDS ***
supervaganj: folds 
Vamoclan: raises 48349 to 54349 and is all-in
pj0901: folds 
Biguethi339: folds 
gibbo888: folds 
mp5610 has timed out
mp5610: folds 
mp5610 is sitting out
lucaromanoo1: folds 
mp5610 has returned
GUIDAASCANIO: folds 
Uncalled bet (48349) returned to Vamoclan
Vamoclan collected 21000 from pot
Vamoclan: doesn't show hand 
*** SUMMARY ***
Total pot 21000 | Rake 0 
Seat 1: lucaromanoo1 (small blind) folded before Flop
Seat 2: GUIDAASCANIO (big blind) folded before Flop
Seat 3: supervaganj folded before Flop (didn't bet)
Seat 4: Vamoclan collected (21000)
Seat 5: pj0901 folded before Flop (didn't bet)
Seat 6: Biguethi339 folded before Flop (didn't bet)
Seat 7: gibbo888 folded before Flop (didn't bet)
Seat 8: mp5610 (button) folded before Flop (didn't bet)

PokerStars Hand #251207225080: Tournament #3767885527, $40+$10+$5 USD Hold'em No Limit - Level XX (3000/6000) - 2024/06/26 20:45:48 UTC [2024/06/26 16:45:48 ET]
Table '3767885527 93' 8-max Seat #1 is the button
Seat 1: lucaromanoo1 (514922 in chips) 
Seat 2: GUIDAASCANIO (71730 in chips) 
Seat 3: supervaganj (77390 in chips) 
Seat 4: Vamoclan (69349 in chips) 
Seat 5: pj0901 (185062 in chips) 
Seat 6: Biguethi339 (230522 in chips) 
Seat 7: gibbo888 (291249 in chips) 
Seat 8: mp5610 (112750 in chips) 
lucaromanoo1: posts the ante 750
GUIDAASCANIO: posts the ante 750
supervaganj: posts the ante 750
Vamoclan: posts the ante 750
pj0901: posts the ante 750
Biguethi339: posts the ante 750
gibbo888: posts the ante 750
mp5610: posts the ante 750
GUIDAASCANIO: posts small blind 3000
supervaganj: posts big blind 6000
*** HOLE CARDS ***
Vamoclan: folds 
pj0901: folds 
Biguethi339: folds 
gibbo888: folds 
mp5610: raises 6000 to 12000
lucaromanoo1: raises 502172 to 514172 and is all-in
GUIDAASCANIO: folds 
supervaganj: folds 
mp5610: folds 
Uncalled bet (502172) returned to lucaromanoo1
lucaromanoo1 collected 39000 from pot
lucaromanoo1: doesn't show hand 
*** SUMMARY ***
Total pot 39000 | Rake 0 
Seat 1: lucaromanoo1 (button) collected (39000)
Seat 2: GUIDAASCANIO (small blind) folded before Flop
Seat 3: supervaganj (big blind) folded before Flop
Seat 4: Vamoclan folded before Flop (didn't bet)
Seat 5: pj0901 folded before Flop (didn't bet)
Seat 6: Biguethi339 folded before Flop (didn't bet)
Seat 7: gibbo888 folded before Flop (didn't bet)
Seat 8: mp5610 folded before Flop

PokerStars Hand #251207233575: Tournament #3767885527, $40+$10+$5 USD Hold'em No Limit - Level XXI (3500/7000) - 2024/06/26 20:46:19 UTC [2024/06/26 16:46:19 ET]
Table '3767885527 93' 8-max Seat #2 is the button
Seat 1: lucaromanoo1 (541172 in chips) 
Seat 2: GUIDAASCANIO (67980 in chips) 
Seat 3: supervaganj (70640 in chips) 
Seat 4: Vamoclan (68599 in chips) 
Seat 5: pj0901 (184312 in chips) 
Seat 6: Biguethi339 (229772 in chips) 
Seat 7: gibbo888 (290499 in chips) 
Seat 8: mp5610 (100000 in chips) 
lucaromanoo1: posts the ante 875
GUIDAASCANIO: posts the ante 875
supervaganj: posts the ante 875
Vamoclan: posts the ante 875
pj0901: posts the ante 875
Biguethi339: posts the ante 875
gibbo888: posts the ante 875
mp5610: posts the ante 875
supervaganj: posts small blind 3500
Vamoclan: posts big blind 7000
*** HOLE CARDS ***
pj0901: folds 
Biguethi339: raises 7000 to 14000
gibbo888: folds 
mp5610: folds 
lucaromanoo1: folds 
GUIDAASCANIO: folds 
supervaganj: raises 55765 to 69765 and is all-in
Vamoclan: folds 
Biguethi339: calls 55765
*** FLOP *** [9s 6h Tc]
*** TURN *** [9s 6h Tc] [Ac]
*** RIVER *** [9s 6h Tc Ac] [4s]
*** SHOW DOWN ***
supervaganj: shows [Kc Qd] (high card Ace)
Biguethi339: shows [9d Td] (two pair, Tens and Nines)
Biguethi339 collected 153530 from pot
supervaganj finished the tournament in 211th place and received $115.10.
*** SUMMARY ***
Total pot 153530 | Rake 0 
Board [9s 6h Tc Ac 4s]
Seat 1: lucaromanoo1 folded before Flop (didn't bet)
Seat 2: GUIDAASCANIO (button) folded before Flop (didn't bet)
Seat 3: supervaganj (small blind) showed [Kc Qd] and lost with high card Ace
Seat 4: Vamoclan (big blind) folded before Flop
Seat 5: pj0901 folded before Flop (didn't bet)
Seat 6: Biguethi339 showed [9d Td] and won (153530) with two pair, Tens and Nines
Seat 7: gibbo888 folded before Flop (didn't bet)
Seat 8: mp5610 folded before Flop (didn't bet)

PokerStars Hand #251207250235: Tournament #3767885527, $40+$10+$5 USD Hold'em No Limit - Level XXI (3500/7000) - 2024/06/26 20:47:19 UTC [2024/06/26 16:47:19 ET]
Table '3767885527 93' 8-max Seat #4 is the button
Seat 1: lucaromanoo1 (540297 in chips) 
Seat 2: GUIDAASCANIO (67105 in chips) 
Seat 4: Vamoclan (60724 in chips) 
Seat 5: pj0901 (183437 in chips) 
Seat 6: Biguethi339 (312662 in chips) 
Seat 7: gibbo888 (289624 in chips) 
Seat 8: mp5610 (99125 in chips) 
lucaromanoo1: posts the ante 875
GUIDAASCANIO: posts the ante 875
Vamoclan: posts the ante 875
pj0901: posts the ante 875
Biguethi339: posts the ante 875
gibbo888: posts the ante 875
mp5610: posts the ante 875
pj0901: posts small blind 3500
Biguethi339: posts big blind 7000
*** HOLE CARDS ***
gibbo888: folds 
mp5610: folds 
lucaromanoo1: folds 
GUIDAASCANIO: folds 
Vamoclan: folds 
pj0901: raises 16100 to 23100
Biguethi339: calls 16100
*** FLOP *** [4h 7d 4d]
pj0901: bets 10500
Biguethi339: calls 10500
*** TURN *** [4h 7d 4d] [Ts]
pj0901: checks 
Biguethi339: checks 
*** RIVER *** [4h 7d 4d Ts] [9d]
pj0901: bets 17500
Biguethi339: folds 
Uncalled bet (17500) returned to pj0901
pj0901 collected 73325 from pot
pj0901: doesn't show hand 
*** SUMMARY ***
Total pot 73325 | Rake 0 
Board [4h 7d 4d Ts 9d]
Seat 1: lucaromanoo1 folded before Flop (didn't bet)
Seat 2: GUIDAASCANIO folded before Flop (didn't bet)
Seat 4: Vamoclan (button) folded before Flop (didn't bet)
Seat 5: pj0901 (small blind) collected (73325)
Seat 6: Biguethi339 (big blind) folded on the River
Seat 7: gibbo888 folded before Flop (didn't bet)
Seat 8: mp5610 folded before Flop (didn't bet)

PokerStars Hand #251207275179: Tournament #3767885527, $40+$10+$5 USD Hold'em No Limit - Level XXI (3500/7000) - 2024/06/26 20:48:50 UTC [2024/06/26 16:48:50 ET]
Table '3767885527 93' 8-max Seat #5 is the button
Seat 1: lucaromanoo1 (539422 in chips) 
Seat 2: GUIDAASCANIO (66230 in chips) 
Seat 4: Vamoclan (59849 in chips) 
Seat 5: pj0901 (222287 in chips) 
Seat 6: Biguethi339 (278187 in chips) 
Seat 7: gibbo888 (288749 in chips) 
Seat 8: mp5610 (98250 in chips) 
lucaromanoo1: posts the ante 875
GUIDAASCANIO: posts the ante 875
Vamoclan: posts the ante 875
pj0901: posts the ante 875
Biguethi339: posts the ante 875
gibbo888: posts the ante 875
mp5610: posts the ante 875
Biguethi339: posts small blind 3500
gibbo888: posts big blind 7000
*** HOLE CARDS ***
mp5610: folds 
lucaromanoo1: folds 
GUIDAASCANIO: raises 49000 to 56000
Lenon318 is disconnected 
Vamoclan: folds 
pj0901: folds 
Biguethi339: folds 
gibbo888: folds 
Uncalled bet (49000) returned to GUIDAASCANIO
GUIDAASCANIO collected 23625 from pot
GUIDAASCANIO: doesn't show hand 
*** SUMMARY ***
Total pot 23625 | Rake 0 
Seat 1: lucaromanoo1 folded before Flop (didn't bet)
Seat 2: GUIDAASCANIO collected (23625)
Seat 4: Vamoclan folded before Flop (didn't bet)
Seat 5: pj0901 (button) folded before Flop (didn't bet)
Seat 6: Biguethi339 (small blind) folded before Flop
Seat 7: gibbo888 (big blind) folded before Flop
Seat 8: mp5610 folded before Flop (didn't bet)

PokerStars Hand #251207281379: Tournament #3767885527, $40+$10+$5 USD Hold'em No Limit - Level XXI (3500/7000) - 2024/06/26 20:49:13 UTC [2024/06/26 16:49:13 ET]
Table '3767885527 93' 8-max Seat #6 is the button
Seat 1: lucaromanoo1 (538547 in chips) 
Seat 2: GUIDAASCANIO (81980 in chips) 
Seat 3: Lenon318 (58738 in chips) 
Seat 4: Vamoclan (58974 in chips) 
Seat 5: pj0901 (221412 in chips) 
Seat 6: Biguethi339 (273812 in chips) 
Seat 7: gibbo888 (280874 in chips) 
Seat 8: mp5610 (97375 in chips) 
lucaromanoo1: posts the ante 875
GUIDAASCANIO: posts the ante 875
Lenon318: posts the ante 875
Vamoclan: posts the ante 875
pj0901: posts the ante 875
Biguethi339: posts the ante 875
gibbo888: posts the ante 875
mp5610: posts the ante 875
gibbo888: posts small blind 3500
mp5610: posts big blind 7000
*** HOLE CARDS ***
lucaromanoo1: folds 
GUIDAASCANIO: folds 
Lenon318: folds 
Vamoclan: folds 
pj0901: raises 7000 to 14000
Biguethi339: folds 
gibbo888: folds 
mp5610: raises 82500 to 96500 and is all-in
pj0901: folds 
Uncalled bet (82500) returned to mp5610
mp5610 collected 38500 from pot
*** SUMMARY ***
Total pot 38500 | Rake 0 
Seat 1: lucaromanoo1 folded before Flop (didn't bet)
Seat 2: GUIDAASCANIO folded before Flop (didn't bet)
Seat 3: Lenon318 folded before Flop (didn't bet)
Seat 4: Vamoclan folded before Flop (didn't bet)
Seat 5: pj0901 folded before Flop
Seat 6: Biguethi339 (button) folded before Flop (didn't bet)
Seat 7: gibbo888 (small blind) folded before Flop
Seat 8: mp5610 (big blind) collected (38500)

PokerStars Hand #251207289474: Tournament #3767885527, $40+$10+$5 USD Hold'em No Limit - Level XXI (3500/7000) - 2024/06/26 20:49:42 UTC [2024/06/26 16:49:42 ET]
Table '3767885527 93' 8-max Seat #7 is the button
Seat 1: lucaromanoo1 (537672 in chips) 
Seat 2: GUIDAASCANIO (81105 in chips) 
Seat 3: Lenon318 (57863 in chips) 
Seat 4: Vamoclan (58099 in chips) 
Seat 5: pj0901 (206537 in chips) 
Seat 6: Biguethi339 (272937 in chips) 
Seat 7: gibbo888 (276499 in chips) 
Seat 8: mp5610 (121000 in chips) 
lucaromanoo1: posts the ante 875
GUIDAASCANIO: posts the ante 875
Lenon318: posts the ante 875
Vamoclan: posts the ante 875
pj0901: posts the ante 875
Biguethi339: posts the ante 875
gibbo888: posts the ante 875
mp5610: posts the ante 875
mp5610: posts small blind 3500
lucaromanoo1: posts big blind 7000
*** HOLE CARDS ***
GUIDAASCANIO: folds 
Lenon318: folds 
Vamoclan: folds 
pj0901: raises 7000 to 14000
Biguethi339: raises 24500 to 38500
gibbo888: folds 
mp5610: folds 
lucaromanoo1: folds 
pj0901: raises 167162 to 205662 and is all-in
Biguethi339: calls 167162
*** FLOP *** [4h 6c 3s]
*** TURN *** [4h 6c 3s] [Tc]
*** RIVER *** [4h 6c 3s Tc] [8h]
*** SHOW DOWN ***
pj0901: shows [As Qh] (high card Ace)
Biguethi339: shows [Ks Kh] (a pair of Kings)
Biguethi339 collected 428824 from pot
pj0901 finished the tournament in 203rd place and received $115.10.
*** SUMMARY ***
Total pot 428824 | Rake 0 
Board [4h 6c 3s Tc 8h]
Seat 1: lucaromanoo1 (big blind) folded before Flop
Seat 2: GUIDAASCANIO folded before Flop (didn't bet)
Seat 3: Lenon318 folded before Flop (didn't bet)
Seat 4: Vamoclan folded before Flop (didn't bet)
Seat 5: pj0901 showed [As Qh] and lost with high card Ace
Seat 6: Biguethi339 showed [Ks Kh] and won (428824) with a pair of Kings
Seat 7: gibbo888 (button) folded before Flop (didn't bet)
Seat 8: mp5610 (small blind) folded before Flop

PokerStars Hand #251207302695: Tournament #3767885527, $40+$10+$5 USD Hold'em No Limit - Level XXI (3500/7000) - 2024/06/26 20:50:32 UTC [2024/06/26 16:50:32 ET]
Table '3767885527 93' 8-max Seat #8 is the button
Seat 1: lucaromanoo1 (529797 in chips) 
Seat 2: GUIDAASCANIO (80230 in chips) 
Seat 3: Lenon318 (56988 in chips) 
Seat 4: Vamoclan (57224 in chips) 
Seat 6: Biguethi339 (495224 in chips) 
Seat 7: gibbo888 (275624 in chips) 
Seat 8: mp5610 (116625 in chips) 
lucaromanoo1: posts the ante 875
GUIDAASCANIO: posts the ante 875
Lenon318: posts the ante 875
Vamoclan: posts the ante 875
Biguethi339: posts the ante 875
gibbo888: posts the ante 875
mp5610: posts the ante 875
lucaromanoo1: posts small blind 3500
GUIDAASCANIO: posts big blind 7000
*** HOLE CARDS ***
Lenon318: folds 
Vamoclan: raises 49349 to 56349 and is all-in
Biguethi339: folds 
gibbo888: folds 
mp5610: folds 
lucaromanoo1: raises 49349 to 105698
GUIDAASCANIO: folds 
Uncalled bet (49349) returned to lucaromanoo1
*** FLOP *** [5c As Th]
*** TURN *** [5c As Th] [7c]
*** RIVER *** [5c As Th 7c] [Kc]
*** SHOW DOWN ***
lucaromanoo1: shows [8d Ad] (a pair of Aces)
Vamoclan: shows [Kh Qs] (a pair of Kings)
lucaromanoo1 collected 125823 from pot
Vamoclan finished the tournament in 201st place and received $115.10.
*** SUMMARY ***
Total pot 125823 | Rake 0 
Board [5c As Th 7c Kc]
Seat 1: lucaromanoo1 (small blind) showed [8d Ad] and won (125823) with a pair of Aces
Seat 2: GUIDAASCANIO (big blind) folded before Flop
Seat 3: Lenon318 folded before Flop (didn't bet)
Seat 4: Vamoclan showed [Kh Qs] and lost with a pair of Kings
Seat 6: Biguethi339 folded before Flop (didn't bet)
Seat 7: gibbo888 folded before Flop (didn't bet)
Seat 8: mp5610 (button) folded before Flop (didn't bet)


PokerStars Hand #251205833491: Tournament #3767885527, $40+$10+$5 USD Hold'em No Limit - Level XIII (800/1600) - 2024/06/26 19:21:07 UTC [2024/06/26 15:21:07 ET]
Table '3767885527 92' 8-max Seat #7 is the button
Seat 1: SOUFODAMS (112349 in chips) 
Seat 2: Mr Pay Shent (39982 in chips) 
Seat 3: Pseudo Fruto (57997 in chips) 
Seat 4: RenanToniolo (132439 in chips) 
Seat 5: milkytravis (43402 in chips) 
Seat 6: sunn¥m4nn (44950 in chips) 
Seat 7: podiiii (48875 in chips) 
Seat 8: EDY R44 (36817 in chips) 
SOUFODAMS: posts the ante 200
Mr Pay Shent: posts the ante 200
Pseudo Fruto: posts the ante 200
RenanToniolo: posts the ante 200
milkytravis: posts the ante 200
sunn¥m4nn: posts the ante 200
podiiii: posts the ante 200
EDY R44: posts the ante 200
EDY R44: posts small blind 800
SOUFODAMS: posts big blind 1600
*** HOLE CARDS ***
Mr Pay Shent: folds 
Pseudo Fruto: raises 1600 to 3200
RenanToniolo: folds 
milkytravis: folds 
sunn¥m4nn: folds 
podiiii: folds 
EDY R44: calls 2400
SOUFODAMS: calls 1600
*** FLOP *** [2h Ac Ah]
EDY R44: checks 
SOUFODAMS: checks 
Pseudo Fruto: bets 3024
EDY R44: raises 3024 to 6048
SOUFODAMS: folds 
Pseudo Fruto: raises 5152 to 11200
EDY R44: raises 22217 to 33417 and is all-in
Pseudo Fruto: calls 22217
*** TURN *** [2h Ac Ah] [7d]
*** RIVER *** [2h Ac Ah 7d] [8s]
*** SHOW DOWN ***
EDY R44: shows [6s 7s] (two pair, Aces and Sevens)
Pseudo Fruto: shows [Jc As] (three of a kind, Aces)
Pseudo Fruto collected 78034 from pot
EDY R44 finished the tournament
*** SUMMARY ***
Total pot 78034 | Rake 0 
Board [2h Ac Ah 7d 8s]
Seat 1: SOUFODAMS (big blind) folded on the Flop
Seat 2: Mr Pay Shent folded before Flop (didn't bet)
Seat 3: Pseudo Fruto showed [Jc As] and won (78034) with three of a kind, Aces
Seat 4: RenanToniolo folded before Flop (didn't bet)
Seat 5: milkytravis folded before Flop (didn't bet)
Seat 6: sunn¥m4nn folded before Flop (didn't bet)
Seat 7: podiiii (button) folded before Flop (didn't bet)
Seat 8: EDY R44 (small blind) showed [6s 7s] and lost with two pair, Aces and Sevens

PokerStars Hand #251205863449: Tournament #3767885527, $40+$10+$5 USD Hold'em No Limit - Level XIII (800/1600) - 2024/06/26 19:22:57 UTC [2024/06/26 15:22:57 ET]
Table '3767885527 92' 8-max Seat #1 is the button
Seat 1: SOUFODAMS (108949 in chips) 
Seat 2: Mr Pay Shent (39782 in chips) 
Seat 3: Pseudo Fruto (99214 in chips) 
Seat 4: RenanToniolo (132239 in chips) 
Seat 5: milkytravis (43202 in chips) 
Seat 6: sunn¥m4nn (44750 in chips) 
Seat 7: podiiii (48675 in chips) 
SOUFODAMS: posts the ante 200
Mr Pay Shent: posts the ante 200
Pseudo Fruto: posts the ante 200
RenanToniolo: posts the ante 200
milkytravis: posts the ante 200
sunn¥m4nn: posts the ante 200
podiiii: posts the ante 200
Mr Pay Shent: posts small blind 800
Pseudo Fruto: posts big blind 1600
*** HOLE CARDS ***
RenanToniolo: folds 
milkytravis: folds 
sunn¥m4nn: folds 
podiiii: raises 1600 to 3200
SOUFODAMS: raises 6400 to 9600
Mr Pay Shent: folds 
Pseudo Fruto: folds 
podiiii: folds 
Uncalled bet (6400) returned to SOUFODAMS
SOUFODAMS collected 10200 from pot
SOUFODAMS: doesn't show hand 
*** SUMMARY ***
Total pot 10200 | Rake 0 
Seat 1: SOUFODAMS (button) collected (10200)
Seat 2: Mr Pay Shent (small blind) folded before Flop
Seat 3: Pseudo Fruto (big blind) folded before Flop
Seat 4: RenanToniolo folded before Flop (didn't bet)
Seat 5: milkytravis folded before Flop (didn't bet)
Seat 6: sunn¥m4nn folded before Flop (didn't bet)
Seat 7: podiiii folded before Flop

PokerStars Hand #251205877007: Tournament #3767885527, $40+$10+$5 USD Hold'em No Limit - Level XIII (800/1600) - 2024/06/26 19:23:46 UTC [2024/06/26 15:23:46 ET]
Table '3767885527 92' 8-max Seat #2 is the button
Seat 1: SOUFODAMS (115749 in chips) 
Seat 2: Mr Pay Shent (38782 in chips) 
Seat 3: Pseudo Fruto (97414 in chips) 
Seat 4: RenanToniolo (132039 in chips) 
Seat 5: milkytravis (43002 in chips) 
Seat 6: sunn¥m4nn (44550 in chips) 
Seat 7: podiiii (45275 in chips) 
Seat 8: robertzrc (25000 in chips) 
SOUFODAMS: posts the ante 200
Mr Pay Shent: posts the ante 200
Pseudo Fruto: posts the ante 200
RenanToniolo: posts the ante 200
milkytravis: posts the ante 200
sunn¥m4nn: posts the ante 200
podiiii: posts the ante 200
robertzrc: posts the ante 200
Pseudo Fruto: posts small blind 800
RenanToniolo: posts big blind 1600
*** HOLE CARDS ***
milkytravis: folds 
sunn¥m4nn: raises 1600 to 3200
podiiii: folds 
robertzrc: folds 
SOUFODAMS: folds 
Mr Pay Shent: folds 
Pseudo Fruto: folds 
RenanToniolo: calls 1600
*** FLOP *** [4h As 9h]
RenanToniolo: checks 
sunn¥m4nn: bets 2904
RenanToniolo: calls 2904
*** TURN *** [4h As 9h] [Kh]
RenanToniolo: checks 
sunn¥m4nn: bets 7304
RenanToniolo: calls 7304
*** RIVER *** [4h As 9h Kh] [8c]
RenanToniolo: checks 
sunn¥m4nn: bets 30942 and is all-in
RenanToniolo: calls 30942
*** SHOW DOWN ***
sunn¥m4nn: shows [Th Jh] (a flush, King high)
RenanToniolo: shows [Ah Ad] (three of a kind, Aces)
sunn¥m4nn collected 91100 from pot
*** SUMMARY ***
Total pot 91100 | Rake 0 
Board [4h As 9h Kh 8c]
Seat 1: SOUFODAMS folded before Flop (didn't bet)
Seat 2: Mr Pay Shent (button) folded before Flop (didn't bet)
Seat 3: Pseudo Fruto (small blind) folded before Flop
Seat 4: RenanToniolo (big blind) showed [Ah Ad] and lost with three of a kind, Aces
Seat 5: milkytravis folded before Flop (didn't bet)
Seat 6: sunn¥m4nn showed [Th Jh] and won (91100) with a flush, King high
Seat 7: podiiii folded before Flop (didn't bet)
Seat 8: robertzrc folded before Flop (didn't bet)

PokerStars Hand #251205905698: Tournament #3767885527, $40+$10+$5 USD Hold'em No Limit - Level XIII (800/1600) - 2024/06/26 19:25:30 UTC [2024/06/26 15:25:30 ET]
Table '3767885527 92' 8-max Seat #3 is the button
Seat 1: SOUFODAMS (115549 in chips) 
Seat 2: Mr Pay Shent (38582 in chips) 
Seat 3: Pseudo Fruto (96414 in chips) 
Seat 4: RenanToniolo (87489 in chips) 
Seat 5: milkytravis (42802 in chips) 
Seat 6: sunn¥m4nn (91100 in chips) 
Seat 7: podiiii (45075 in chips) 
Seat 8: robertzrc (24800 in chips) 
SOUFODAMS: posts the ante 200
Mr Pay Shent: posts the ante 200
Pseudo Fruto: posts the ante 200
RenanToniolo: posts the ante 200
milkytravis: posts the ante 200
sunn¥m4nn: posts the ante 200
podiiii: posts the ante 200
robertzrc: posts the ante 200
RenanToniolo: posts small blind 800
milkytravis: posts big blind 1600
*** HOLE CARDS ***
sunn¥m4nn: folds 
podiiii: folds 
robertzrc: folds 
SOUFODAMS: folds 
Mr Pay Shent: folds 
Pseudo Fruto: raises 1600 to 3200
RenanToniolo: folds 
milkytravis: calls 1600
*** FLOP *** [2s Kc 5d]
milkytravis: checks 
Pseudo Fruto: bets 2376
milkytravis: folds 
Uncalled bet (2376) returned to Pseudo Fruto
Pseudo Fruto collected 8800 from pot
Pseudo Fruto: doesn't show hand 
*** SUMMARY ***
Total pot 8800 | Rake 0 
Board [2s Kc 5d]
Seat 1: SOUFODAMS folded before Flop (didn't bet)
Seat 2: Mr Pay Shent folded before Flop (didn't bet)
Seat 3: Pseudo Fruto (button) collected (8800)
Seat 4: RenanToniolo (small blind) folded before Flop
Seat 5: milkytravis (big blind) folded on the Flop
Seat 6: sunn¥m4nn folded before Flop (didn't bet)
Seat 7: podiiii folded before Flop (didn't bet)
Seat 8: robertzrc folded before Flop (didn't bet)

PokerStars Hand #251205915217: Tournament #3767885527, $40+$10+$5 USD Hold'em No Limit - Level XIII (800/1600) - 2024/06/26 19:26:05 UTC [2024/06/26 15:26:05 ET]
Table '3767885527 92' 8-max Seat #4 is the button
Seat 1: SOUFODAMS (115349 in chips) 
Seat 2: Mr Pay Shent (38382 in chips) 
Seat 3: Pseudo Fruto (101814 in chips) 
Seat 4: RenanToniolo (86489 in chips) 
Seat 5: milkytravis (39402 in chips) 
Seat 6: sunn¥m4nn (90900 in chips) 
Seat 7: podiiii (44875 in chips) 
Seat 8: robertzrc (24600 in chips) 
SOUFODAMS: posts the ante 200
Mr Pay Shent: posts the ante 200
Pseudo Fruto: posts the ante 200
RenanToniolo: posts the ante 200
milkytravis: posts the ante 200
sunn¥m4nn: posts the ante 200
podiiii: posts the ante 200
robertzrc: posts the ante 200
milkytravis: posts small blind 800
sunn¥m4nn: posts big blind 1600
*** HOLE CARDS ***
podiiii: folds 
robertzrc: folds 
SOUFODAMS: folds 
Mr Pay Shent: folds 
Pseudo Fruto: folds 
RenanToniolo: raises 1600 to 3200
milkytravis: folds 
sunn¥m4nn: calls 1600
*** FLOP *** [7h 9s 9c]
sunn¥m4nn: checks 
RenanToniolo: checks 
*** TURN *** [7h 9s 9c] [2h]
sunn¥m4nn: checks 
RenanToniolo: bets 2200
sunn¥m4nn: folds 
Uncalled bet (2200) returned to RenanToniolo
RenanToniolo collected 8800 from pot
*** SUMMARY ***
Total pot 8800 | Rake 0 
Board [7h 9s 9c 2h]
Seat 1: SOUFODAMS folded before Flop (didn't bet)
Seat 2: Mr Pay Shent folded before Flop (didn't bet)
Seat 3: Pseudo Fruto folded before Flop (didn't bet)
Seat 4: RenanToniolo (button) collected (8800)
Seat 5: milkytravis (small blind) folded before Flop
Seat 6: sunn¥m4nn (big blind) folded on the Turn
Seat 7: podiiii folded before Flop (didn't bet)
Seat 8: robertzrc folded before Flop (didn't bet)

PokerStars Hand #251205933091: Tournament #3767885527, $40+$10+$5 USD Hold'em No Limit - Level XIII (800/1600) - 2024/06/26 19:27:10 UTC [2024/06/26 15:27:10 ET]
Table '3767885527 92' 8-max Seat #5 is the button
Seat 1: SOUFODAMS (115149 in chips) 
Seat 2: Mr Pay Shent (38182 in chips) 
Seat 3: Pseudo Fruto (101614 in chips) 
Seat 4: RenanToniolo (91889 in chips) 
Seat 5: milkytravis (38402 in chips) 
Seat 6: sunn¥m4nn (87500 in chips) 
Seat 7: podiiii (44675 in chips) 
Seat 8: robertzrc (24400 in chips) 
SOUFODAMS: posts the ante 200
Mr Pay Shent: posts the ante 200
Pseudo Fruto: posts the ante 200
RenanToniolo: posts the ante 200
milkytravis: posts the ante 200
sunn¥m4nn: posts the ante 200
podiiii: posts the ante 200
robertzrc: posts the ante 200
sunn¥m4nn: posts small blind 800
podiiii: posts big blind 1600
*** HOLE CARDS ***
robertzrc: calls 1600
SOUFODAMS: folds 
Mr Pay Shent: folds 
Pseudo Fruto: raises 1600 to 3200
RenanToniolo: folds 
milkytravis: folds 
sunn¥m4nn: folds 
podiiii: folds 
robertzrc: calls 1600
*** FLOP *** [As 8d 3d]
robertzrc: checks 
Pseudo Fruto: bets 2808
robertzrc: folds 
Uncalled bet (2808) returned to Pseudo Fruto
Pseudo Fruto collected 10400 from pot
Pseudo Fruto: doesn't show hand 
*** SUMMARY ***
Total pot 10400 | Rake 0 
Board [As 8d 3d]
Seat 1: SOUFODAMS folded before Flop (didn't bet)
Seat 2: Mr Pay Shent folded before Flop (didn't bet)
Seat 3: Pseudo Fruto collected (10400)
Seat 4: RenanToniolo folded before Flop (didn't bet)
Seat 5: milkytravis (button) folded before Flop (didn't bet)
Seat 6: sunn¥m4nn (small blind) folded before Flop
Seat 7: podiiii (big blind) folded before Flop
Seat 8: robertzrc folded on the Flop

PokerStars Hand #251205948757: Tournament #3767885527, $40+$10+$5 USD Hold'em No Limit - Level XIII (800/1600) - 2024/06/26 19:28:09 UTC [2024/06/26 15:28:09 ET]
Table '3767885527 92' 8-max Seat #6 is the button
Seat 1: SOUFODAMS (114949 in chips) 
Seat 2: Mr Pay Shent (37982 in chips) 
Seat 3: Pseudo Fruto (108614 in chips) 
Seat 4: RenanToniolo (91689 in chips) 
Seat 5: milkytravis (38202 in chips) 
Seat 6: sunn¥m4nn (86500 in chips) 
Seat 7: podiiii (42875 in chips) 
Seat 8: robertzrc (21000 in chips) 
SOUFODAMS: posts the ante 200
Mr Pay Shent: posts the ante 200
Pseudo Fruto: posts the ante 200
RenanToniolo: posts the ante 200
milkytravis: posts the ante 200
sunn¥m4nn: posts the ante 200
podiiii: posts the ante 200
robertzrc: posts the ante 200
podiiii: posts small blind 800
robertzrc: posts big blind 1600
*** HOLE CARDS ***
SOUFODAMS: folds 
Mr Pay Shent: folds 
Pseudo Fruto: folds 
RenanToniolo: raises 1600 to 3200
milkytravis: folds 
sunn¥m4nn: calls 3200
podiiii: folds 
robertzrc: calls 1600
*** FLOP *** [Th 4h 9d]
robertzrc: bets 3200
RenanToniolo: folds 
sunn¥m4nn: calls 3200
*** TURN *** [Th 4h 9d] [Ac]
robertzrc: checks 
sunn¥m4nn: checks 
*** RIVER *** [Th 4h 9d Ac] [8h]
robertzrc: checks 
sunn¥m4nn: checks 
*** SHOW DOWN ***
robertzrc: shows [7c 4c] (a pair of Fours)
sunn¥m4nn: shows [9s Ks] (a pair of Nines)
sunn¥m4nn collected 18400 from pot
*** SUMMARY ***
Total pot 18400 | Rake 0 
Board [Th 4h 9d Ac 8h]
Seat 1: SOUFODAMS folded before Flop (didn't bet)
Seat 2: Mr Pay Shent folded before Flop (didn't bet)
Seat 3: Pseudo Fruto folded before Flop (didn't bet)
Seat 4: RenanToniolo folded on the Flop
Seat 5: milkytravis folded before Flop (didn't bet)
Seat 6: sunn¥m4nn (button) showed [9s Ks] and won (18400) with a pair of Nines
Seat 7: podiiii (small blind) folded before Flop
Seat 8: robertzrc (big blind) showed [7c 4c] and lost with a pair of Fours

PokerStars Hand #251205969714: Tournament #3767885527, $40+$10+$5 USD Hold'em No Limit - Level XIV (1000/2000) - 2024/06/26 19:29:27 UTC [2024/06/26 15:29:27 ET]
Table '3767885527 92' 8-max Seat #7 is the button
Seat 1: SOUFODAMS (114749 in chips) 
Seat 2: Mr Pay Shent (37782 in chips) 
Seat 3: Pseudo Fruto (108414 in chips) 
Seat 4: RenanToniolo (88289 in chips) 
Seat 5: milkytravis (38002 in chips) 
Seat 6: sunn¥m4nn (98300 in chips) 
Seat 7: podiiii (41875 in chips) 
Seat 8: robertzrc (14400 in chips) 
SOUFODAMS: posts the ante 250
Mr Pay Shent: posts the ante 250
Pseudo Fruto: posts the ante 250
RenanToniolo: posts the ante 250
milkytravis: posts the ante 250
sunn¥m4nn: posts the ante 250
podiiii: posts the ante 250
robertzrc: posts the ante 250
robertzrc: posts small blind 1000
SOUFODAMS: posts big blind 2000
*** HOLE CARDS ***
Mr Pay Shent: folds 
Pseudo Fruto: folds 
RenanToniolo: folds 
milkytravis: raises 2000 to 4000
sunn¥m4nn: raises 5000 to 9000
podiiii: folds 
robertzrc: raises 5150 to 14150 and is all-in
SOUFODAMS: folds 
milkytravis: folds 
sunn¥m4nn: calls 5150
*** FLOP *** [7h Qc 5h]
*** TURN *** [7h Qc 5h] [9c]
*** RIVER *** [7h Qc 5h 9c] [7s]
*** SHOW DOWN ***
robertzrc: shows [3s Js] (a pair of Sevens)
sunn¥m4nn: shows [Td As] (a pair of Sevens - Ace kicker)
sunn¥m4nn collected 36300 from pot
robertzrc finished the tournament
*** SUMMARY ***
Total pot 36300 | Rake 0 
Board [7h Qc 5h 9c 7s]
Seat 1: SOUFODAMS (big blind) folded before Flop
Seat 2: Mr Pay Shent folded before Flop (didn't bet)
Seat 3: Pseudo Fruto folded before Flop (didn't bet)
Seat 4: RenanToniolo folded before Flop (didn't bet)
Seat 5: milkytravis folded before Flop
Seat 6: sunn¥m4nn showed [Td As] and won (36300) with a pair of Sevens
Seat 7: podiiii (button) folded before Flop (didn't bet)
Seat 8: robertzrc (small blind) showed [3s Js] and lost with a pair of Sevens

PokerStars Hand #251205985301: Tournament #3767885527, $40+$10+$5 USD Hold'em No Limit - Level XIV (1000/2000) - 2024/06/26 19:30:24 UTC [2024/06/26 15:30:24 ET]
Table '3767885527 92' 8-max Seat #1 is the button
Seat 1: SOUFODAMS (112499 in chips) 
Seat 2: Mr Pay Shent (37532 in chips) 
Seat 3: Pseudo Fruto (108164 in chips) 
Seat 4: RenanToniolo (88039 in chips) 
Seat 5: milkytravis (33752 in chips) 
Seat 6: sunn¥m4nn (120200 in chips) 
Seat 7: podiiii (41625 in chips) 
SOUFODAMS: posts the ante 250
Mr Pay Shent: posts the ante 250
Pseudo Fruto: posts the ante 250
RenanToniolo: posts the ante 250
milkytravis: posts the ante 250
sunn¥m4nn: posts the ante 250
podiiii: posts the ante 250
Mr Pay Shent: posts small blind 1000
Pseudo Fruto: posts big blind 2000
*** HOLE CARDS ***
RenanToniolo: folds 
milkytravis: folds 
sunn¥m4nn: folds 
podiiii: folds 
SOUFODAMS: folds 
drmentrop is disconnected 
Mr Pay Shent: calls 1000
Pseudo Fruto: raises 105914 to 107914 and is all-in
Mr Pay Shent: folds 
Uncalled bet (105914) returned to Pseudo Fruto
Pseudo Fruto collected 5750 from pot
Pseudo Fruto: doesn't show hand 
*** SUMMARY ***
Total pot 5750 | Rake 0 
Seat 1: SOUFODAMS (button) folded before Flop (didn't bet)
Seat 2: Mr Pay Shent (small blind) folded before Flop
Seat 3: Pseudo Fruto (big blind) collected (5750)
Seat 4: RenanToniolo folded before Flop (didn't bet)
Seat 5: milkytravis folded before Flop (didn't bet)
Seat 6: sunn¥m4nn folded before Flop (didn't bet)
Seat 7: podiiii folded before Flop (didn't bet)

PokerStars Hand #251205995437: Tournament #3767885527, $40+$10+$5 USD Hold'em No Limit - Level XIV (1000/2000) - 2024/06/26 19:31:01 UTC [2024/06/26 15:31:01 ET]
Table '3767885527 92' 8-max Seat #2 is the button
Seat 1: SOUFODAMS (112249 in chips) 
Seat 2: Mr Pay Shent (35282 in chips) 
Seat 3: Pseudo Fruto (111664 in chips) 
Seat 4: RenanToniolo (87789 in chips) 
Seat 5: milkytravis (33502 in chips) 
Seat 6: sunn¥m4nn (119950 in chips) 
Seat 7: podiiii (41375 in chips) 
Seat 8: drmentrop (25000 in chips) 
SOUFODAMS: posts the ante 250
Mr Pay Shent: posts the ante 250
Pseudo Fruto: posts the ante 250
RenanToniolo: posts the ante 250
milkytravis: posts the ante 250
sunn¥m4nn: posts the ante 250
podiiii: posts the ante 250
drmentrop: posts the ante 250
Pseudo Fruto: posts small blind 1000
RenanToniolo: posts big blind 2000
*** HOLE CARDS ***
milkytravis: folds 
sunn¥m4nn: folds 
podiiii: folds 
drmentrop: folds 
SOUFODAMS: folds 
Mr Pay Shent: folds 
Pseudo Fruto: folds 
Uncalled bet (1000) returned to RenanToniolo
RenanToniolo collected 4000 from pot
*** SUMMARY ***
Total pot 4000 | Rake 0 
Seat 1: SOUFODAMS folded before Flop (didn't bet)
Seat 2: Mr Pay Shent (button) folded before Flop (didn't bet)
Seat 3: Pseudo Fruto (small blind) folded before Flop
Seat 4: RenanToniolo (big blind) collected (4000)
Seat 5: milkytravis folded before Flop (didn't bet)
Seat 6: sunn¥m4nn folded before Flop (didn't bet)
Seat 7: podiiii folded before Flop (didn't bet)
Seat 8: drmentrop folded before Flop (didn't bet)

PokerStars Hand #251206001748: Tournament #3767885527, $40+$10+$5 USD Hold'em No Limit - Level XIV (1000/2000) - 2024/06/26 19:31:24 UTC [2024/06/26 15:31:24 ET]
Table '3767885527 92' 8-max Seat #3 is the button
Seat 1: SOUFODAMS (111999 in chips) 
Seat 2: Mr Pay Shent (35032 in chips) 
Seat 3: Pseudo Fruto (110414 in chips) 
Seat 4: RenanToniolo (90539 in chips) 
Seat 5: milkytravis (33252 in chips) 
Seat 6: sunn¥m4nn (119700 in chips) 
Seat 7: podiiii (41125 in chips) 
Seat 8: drmentrop (24750 in chips) 
SOUFODAMS: posts the ante 250
Mr Pay Shent: posts the ante 250
Pseudo Fruto: posts the ante 250
RenanToniolo: posts the ante 250
milkytravis: posts the ante 250
sunn¥m4nn: posts the ante 250
podiiii: posts the ante 250
drmentrop: posts the ante 250
RenanToniolo: posts small blind 1000
milkytravis: posts big blind 2000
*** HOLE CARDS ***
sunn¥m4nn: folds 
podiiii: folds 
drmentrop: folds 
SOUFODAMS: folds 
Mr Pay Shent: folds 
Pseudo Fruto: folds 
RenanToniolo: raises 4000 to 6000
milkytravis: raises 27002 to 33002 and is all-in
RenanToniolo: folds 
Uncalled bet (27002) returned to milkytravis
milkytravis collected 14000 from pot
milkytravis: doesn't show hand 
*** SUMMARY ***
Total pot 14000 | Rake 0 
Seat 1: SOUFODAMS folded before Flop (didn't bet)
Seat 2: Mr Pay Shent folded before Flop (didn't bet)
Seat 3: Pseudo Fruto (button) folded before Flop (didn't bet)
Seat 4: RenanToniolo (small blind) folded before Flop
Seat 5: milkytravis (big blind) collected (14000)
Seat 6: sunn¥m4nn folded before Flop (didn't bet)
Seat 7: podiiii folded before Flop (didn't bet)
Seat 8: drmentrop folded before Flop (didn't bet)

PokerStars Hand #251206012555: Tournament #3767885527, $40+$10+$5 USD Hold'em No Limit - Level XIV (1000/2000) - 2024/06/26 19:32:03 UTC [2024/06/26 15:32:03 ET]
Table '3767885527 92' 8-max Seat #4 is the button
Seat 1: SOUFODAMS (111749 in chips) 
Seat 2: Mr Pay Shent (34782 in chips) 
Seat 3: Pseudo Fruto (110164 in chips) 
Seat 4: RenanToniolo (84289 in chips) 
Seat 5: milkytravis (41002 in chips) 
Seat 6: sunn¥m4nn (119450 in chips) 
Seat 7: podiiii (40875 in chips) 
Seat 8: drmentrop (24500 in chips) 
SOUFODAMS: posts the ante 250
Mr Pay Shent: posts the ante 250
Pseudo Fruto: posts the ante 250
RenanToniolo: posts the ante 250
milkytravis: posts the ante 250
sunn¥m4nn: posts the ante 250
podiiii: posts the ante 250
drmentrop: posts the ante 250
milkytravis: posts small blind 1000
sunn¥m4nn: posts big blind 2000
*** HOLE CARDS ***
podiiii: folds 
drmentrop: raises 22250 to 24250 and is all-in
SOUFODAMS: folds 
Mr Pay Shent: folds 
Pseudo Fruto: calls 24250
RenanToniolo: folds 
milkytravis: folds 
sunn¥m4nn: folds 
*** FLOP *** [Jd Th 8c]
*** TURN *** [Jd Th 8c] [As]
*** RIVER *** [Jd Th 8c As] [3s]
*** SHOW DOWN ***
drmentrop: shows [Ah 7c] (a pair of Aces)
Pseudo Fruto: shows [Qc Qh] (a pair of Queens)
drmentrop collected 53500 from pot
*** SUMMARY ***
Total pot 53500 | Rake 0 
Board [Jd Th 8c As 3s]
Seat 1: SOUFODAMS folded before Flop (didn't bet)
Seat 2: Mr Pay Shent folded before Flop (didn't bet)
Seat 3: Pseudo Fruto showed [Qc Qh] and lost with a pair of Queens
Seat 4: RenanToniolo (button) folded before Flop (didn't bet)
Seat 5: milkytravis (small blind) folded before Flop
Seat 6: sunn¥m4nn (big blind) folded before Flop
Seat 7: podiiii folded before Flop (didn't bet)
Seat 8: drmentrop showed [Ah 7c] and won (53500) with a pair of Aces

PokerStars Hand #251206021497: Tournament #3767885527, $40+$10+$5 USD Hold'em No Limit - Level XIV (1000/2000) - 2024/06/26 19:32:35 UTC [2024/06/26 15:32:35 ET]
Table '3767885527 92' 8-max Seat #5 is the button
Seat 2: Mr Pay Shent (34532 in chips) 
Seat 3: Pseudo Fruto (85664 in chips) 
Seat 4: RenanToniolo (84039 in chips) 
Seat 5: milkytravis (39752 in chips) 
Seat 6: sunn¥m4nn (117200 in chips) 
Seat 7: podiiii (40625 in chips) 
Seat 8: drmentrop (53500 in chips) 
Mr Pay Shent: posts the ante 250
Pseudo Fruto: posts the ante 250
RenanToniolo: posts the ante 250
milkytravis: posts the ante 250
sunn¥m4nn: posts the ante 250
podiiii: posts the ante 250
drmentrop: posts the ante 250
sunn¥m4nn: posts small blind 1000
podiiii: posts big blind 2000
*** HOLE CARDS ***
drmentrop: folds 
Mr Pay Shent: folds 
Pseudo Fruto: folds 
RenanToniolo: folds 
milkytravis: folds 
sunn¥m4nn: folds 
Uncalled bet (1000) returned to podiiii
podiiii collected 3750 from pot
*** SUMMARY ***
Total pot 3750 | Rake 0 
Seat 2: Mr Pay Shent folded before Flop (didn't bet)
Seat 3: Pseudo Fruto folded before Flop (didn't bet)
Seat 4: RenanToniolo folded before Flop (didn't bet)
Seat 5: milkytravis (button) folded before Flop (didn't bet)
Seat 6: sunn¥m4nn (small blind) folded before Flop
Seat 7: podiiii (big blind) collected (3750)
Seat 8: drmentrop folded before Flop (didn't bet)

PokerStars Hand #251206026968: Tournament #3767885527, $40+$10+$5 USD Hold'em No Limit - Level XIV (1000/2000) - 2024/06/26 19:32:56 UTC [2024/06/26 15:32:56 ET]
Table '3767885527 92' 8-max Seat #6 is the button
Seat 2: Mr Pay Shent (34282 in chips) 
Seat 3: Pseudo Fruto (85414 in chips) 
Seat 4: RenanToniolo (83789 in chips) 
Seat 5: milkytravis (39502 in chips) 
Seat 6: sunn¥m4nn (115950 in chips) 
Seat 7: podiiii (43125 in chips) 
Seat 8: drmentrop (53250 in chips) 
Mr Pay Shent: posts the ante 250
Pseudo Fruto: posts the ante 250
RenanToniolo: posts the ante 250
milkytravis: posts the ante 250
sunn¥m4nn: posts the ante 250
podiiii: posts the ante 250
drmentrop: posts the ante 250
podiiii: posts small blind 1000
drmentrop: posts big blind 2000
*** HOLE CARDS ***
Mr Pay Shent: raises 2000 to 4000
Pseudo Fruto: raises 6000 to 10000
RenanToniolo: folds 
milkytravis: folds 
sunn¥m4nn: folds 
podiiii: raises 32875 to 42875 and is all-in
drmentrop: folds 
Mr Pay Shent: folds 
Pseudo Fruto: folds 
Uncalled bet (32875) returned to podiiii
podiiii collected 27750 from pot
kbção535 is disconnected 
*** SUMMARY ***
Total pot 27750 | Rake 0 
Seat 2: Mr Pay Shent folded before Flop
Seat 3: Pseudo Fruto folded before Flop
Seat 4: RenanToniolo folded before Flop (didn't bet)
Seat 5: milkytravis folded before Flop (didn't bet)
Seat 6: sunn¥m4nn (button) folded before Flop (didn't bet)
Seat 7: podiiii (small blind) collected (27750)
Seat 8: drmentrop (big blind) folded before Flop

PokerStars Hand #251206039921: Tournament #3767885527, $40+$10+$5 USD Hold'em No Limit - Level XIV (1000/2000) - 2024/06/26 19:33:43 UTC [2024/06/26 15:33:43 ET]
Table '3767885527 92' 8-max Seat #7 is the button
Seat 1: kbção535 (25000 in chips) 
Seat 2: Mr Pay Shent (30032 in chips) 
Seat 3: Pseudo Fruto (75164 in chips) 
Seat 4: RenanToniolo (83539 in chips) 
Seat 5: milkytravis (39252 in chips) 
Seat 6: sunn¥m4nn (115700 in chips) 
Seat 7: podiiii (60625 in chips) 
Seat 8: drmentrop (51000 in chips) 
kbção535: posts the ante 250
Mr Pay Shent: posts the ante 250
Pseudo Fruto: posts the ante 250
RenanToniolo: posts the ante 250
milkytravis: posts the ante 250
sunn¥m4nn: posts the ante 250
podiiii: posts the ante 250
drmentrop: posts the ante 250
drmentrop: posts small blind 1000
kbção535: posts big blind 2000
*** HOLE CARDS ***
Mr Pay Shent: folds 
Pseudo Fruto: folds 
RenanToniolo: raises 2000 to 4000
milkytravis: folds 
sunn¥m4nn: folds 
podiiii: folds 
drmentrop: folds 
kbção535: calls 2000
*** FLOP *** [4c Th Jh]
kbção535: bets 11000
RenanToniolo: folds 
Uncalled bet (11000) returned to kbção535
kbção535 collected 11000 from pot
kbção535: doesn't show hand 
*** SUMMARY ***
Total pot 11000 | Rake 0 
Board [4c Th Jh]
Seat 1: kbção535 (big blind) collected (11000)
Seat 2: Mr Pay Shent folded before Flop (didn't bet)
Seat 3: Pseudo Fruto folded before Flop (didn't bet)
Seat 4: RenanToniolo folded on the Flop
Seat 5: milkytravis folded before Flop (didn't bet)
Seat 6: sunn¥m4nn folded before Flop (didn't bet)
Seat 7: podiiii (button) folded before Flop (didn't bet)
Seat 8: drmentrop (small blind) folded before Flop

PokerStars Hand #251206049415: Tournament #3767885527, $40+$10+$5 USD Hold'em No Limit - Level XIV (1000/2000) - 2024/06/26 19:34:18 UTC [2024/06/26 15:34:18 ET]
Table '3767885527 92' 8-max Seat #8 is the button
Seat 1: kbção535 (31750 in chips) 
Seat 2: Mr Pay Shent (29782 in chips) 
Seat 3: Pseudo Fruto (74914 in chips) 
Seat 4: RenanToniolo (79289 in chips) 
Seat 5: milkytravis (39002 in chips) 
Seat 6: sunn¥m4nn (115450 in chips) 
Seat 7: podiiii (60375 in chips) 
Seat 8: drmentrop (49750 in chips) 
kbção535: posts the ante 250
Mr Pay Shent: posts the ante 250
Pseudo Fruto: posts the ante 250
RenanToniolo: posts the ante 250
milkytravis: posts the ante 250
sunn¥m4nn: posts the ante 250
podiiii: posts the ante 250
drmentrop: posts the ante 250
kbção535: posts small blind 1000
Mr Pay Shent: posts big blind 2000
*** HOLE CARDS ***
Pseudo Fruto: folds 
RenanToniolo: raises 2000 to 4000
milkytravis: raises 34752 to 38752 and is all-in
sunn¥m4nn: folds 
podiiii: folds 
drmentrop: folds 
kbção535: calls 30500 and is all-in
Mr Pay Shent: folds 
RenanToniolo: calls 34752
*** FLOP *** [3h Qs 6s]
*** TURN *** [3h Qs 6s] [7d]
*** RIVER *** [3h Qs 6s 7d] [5d]
*** SHOW DOWN ***
RenanToniolo: shows [Jd Jh] (a pair of Jacks)
milkytravis: shows [9c 9h] (a pair of Nines)
RenanToniolo collected 14504 from side pot
kbção535: shows [Ah 7h] (a pair of Sevens)
RenanToniolo collected 98500 from main pot
milkytravis finished the tournament
kbção535 finished the tournament
caio_pimenta is disconnected 
*** SUMMARY ***
Total pot 113004 Main pot 98500. Side pot 14504. | Rake 0 
Board [3h Qs 6s 7d 5d]
Seat 1: kbção535 (small blind) showed [Ah 7h] and lost with a pair of Sevens
Seat 2: Mr Pay Shent (big blind) folded before Flop
Seat 3: Pseudo Fruto folded before Flop (didn't bet)
Seat 4: RenanToniolo showed [Jd Jh] and won (113004) with a pair of Jacks
Seat 5: milkytravis showed [9c 9h] and lost with a pair of Nines
Seat 6: sunn¥m4nn folded before Flop (didn't bet)
Seat 7: podiiii folded before Flop (didn't bet)
Seat 8: drmentrop (button) folded before Flop (didn't bet)

PokerStars Hand #251206066777: Tournament #3767885527, $40+$10+$5 USD Hold'em No Limit - Level XIV (1000/2000) - 2024/06/26 19:35:21 UTC [2024/06/26 15:35:21 ET]
Table '3767885527 92' 8-max Seat #2 is the button
Seat 2: Mr Pay Shent (27532 in chips) 
Seat 3: Pseudo Fruto (74664 in chips) 
Seat 4: RenanToniolo (153291 in chips) 
Seat 5: caio_pimenta (49407 in chips) 
Seat 6: sunn¥m4nn (115200 in chips) 
Seat 7: podiiii (60125 in chips) 
Seat 8: drmentrop (49500 in chips) 
Mr Pay Shent: posts the ante 250
Pseudo Fruto: posts the ante 250
RenanToniolo: posts the ante 250
caio_pimenta: posts the ante 250
sunn¥m4nn: posts the ante 250
podiiii: posts the ante 250
drmentrop: posts the ante 250
Pseudo Fruto: posts small blind 1000
RenanToniolo: posts big blind 2000
*** HOLE CARDS ***
caio_pimenta: folds 
sunn¥m4nn: folds 
podiiii: raises 2000 to 4000
drmentrop: folds 
Mr Pay Shent: folds 
Pseudo Fruto: folds 
RenanToniolo: calls 2000
*** FLOP *** [9c Kc 8h]
RenanToniolo: checks 
podiiii: bets 6600
RenanToniolo: calls 6600
*** TURN *** [9c Kc 8h] [6c]
RenanToniolo: checks 
podiiii: checks 
*** RIVER *** [9c Kc 8h 6c] [5d]
RenanToniolo: checks 
podiiii: checks 
*** SHOW DOWN ***
RenanToniolo: shows [4d 8d] (a pair of Eights)
podiiii: mucks hand 
RenanToniolo collected 23950 from pot
*** SUMMARY ***
Total pot 23950 | Rake 0 
Board [9c Kc 8h 6c 5d]
Seat 2: Mr Pay Shent (button) folded before Flop (didn't bet)
Seat 3: Pseudo Fruto (small blind) folded before Flop
Seat 4: RenanToniolo (big blind) showed [4d 8d] and won (23950) with a pair of Eights
Seat 5: caio_pimenta folded before Flop (didn't bet)
Seat 6: sunn¥m4nn folded before Flop (didn't bet)
Seat 7: podiiii mucked
Seat 8: drmentrop folded before Flop (didn't bet)

PokerStars Hand #251206092033: Tournament #3767885527, $40+$10+$5 USD Hold'em No Limit - Level XIV (1000/2000) - 2024/06/26 19:36:53 UTC [2024/06/26 15:36:53 ET]
Table '3767885527 92' 8-max Seat #3 is the button
Seat 2: Mr Pay Shent (27282 in chips) 
Seat 3: Pseudo Fruto (73414 in chips) 
Seat 4: RenanToniolo (166391 in chips) 
Seat 5: caio_pimenta (49157 in chips) 
Seat 6: sunn¥m4nn (114950 in chips) 
Seat 7: podiiii (49275 in chips) 
Seat 8: drmentrop (49250 in chips) 
Mr Pay Shent: posts the ante 250
Pseudo Fruto: posts the ante 250
RenanToniolo: posts the ante 250
caio_pimenta: posts the ante 250
sunn¥m4nn: posts the ante 250
podiiii: posts the ante 250
drmentrop: posts the ante 250
RenanToniolo: posts small blind 1000
caio_pimenta: posts big blind 2000
*** HOLE CARDS ***
sunn¥m4nn: folds 
podiiii: folds 
drmentrop: folds 
Mr Pay Shent: raises 6750 to 8750
rabwallace1993 is disconnected 
Pseudo Fruto: folds 
RenanToniolo: folds 
caio_pimenta: calls 6750
*** FLOP *** [Ac 6h 2s]
caio_pimenta: checks 
Mr Pay Shent: bets 18282 and is all-in
caio_pimenta: folds 
Uncalled bet (18282) returned to Mr Pay Shent
Mr Pay Shent collected 20250 from pot
Mr Pay Shent: doesn't show hand 
*** SUMMARY ***
Total pot 20250 | Rake 0 
Board [Ac 6h 2s]
Seat 2: Mr Pay Shent collected (20250)
Seat 3: Pseudo Fruto (button) folded before Flop (didn't bet)
Seat 4: RenanToniolo (small blind) folded before Flop
Seat 5: caio_pimenta (big blind) folded on the Flop
Seat 6: sunn¥m4nn folded before Flop (didn't bet)
Seat 7: podiiii folded before Flop (didn't bet)
Seat 8: drmentrop folded before Flop (didn't bet)

PokerStars Hand #251206102801: Tournament #3767885527, $40+$10+$5 USD Hold'em No Limit - Level XIV (1000/2000) - 2024/06/26 19:37:32 UTC [2024/06/26 15:37:32 ET]
Table '3767885527 92' 8-max Seat #4 is the button
Seat 1: rabwallace1993 (84066 in chips) 
Seat 2: Mr Pay Shent (38532 in chips) 
Seat 3: Pseudo Fruto (73164 in chips) 
Seat 4: RenanToniolo (165141 in chips) 
Seat 5: caio_pimenta (40157 in chips) 
Seat 6: sunn¥m4nn (114700 in chips) 
Seat 7: podiiii (49025 in chips) 
Seat 8: drmentrop (49000 in chips) 
rabwallace1993: posts the ante 250
Mr Pay Shent: posts the ante 250
Pseudo Fruto: posts the ante 250
RenanToniolo: posts the ante 250
caio_pimenta: posts the ante 250
sunn¥m4nn: posts the ante 250
podiiii: posts the ante 250
drmentrop: posts the ante 250
caio_pimenta: posts small blind 1000
sunn¥m4nn: posts big blind 2000
*** HOLE CARDS ***
podiiii: folds 
drmentrop: folds 
rabwallace1993: raises 2000 to 4000
Mr Pay Shent: folds 
Pseudo Fruto: folds 
RenanToniolo: folds 
caio_pimenta: calls 3000
sunn¥m4nn: folds 
*** FLOP *** [Ac 4h 7s]
caio_pimenta: checks 
rabwallace1993: bets 6000
caio_pimenta: folds 
Uncalled bet (6000) returned to rabwallace1993
rabwallace1993 collected 12000 from pot
rabwallace1993: doesn't show hand 
*** SUMMARY ***
Total pot 12000 | Rake 0 
Board [Ac 4h 7s]
Seat 1: rabwallace1993 collected (12000)
Seat 2: Mr Pay Shent folded before Flop (didn't bet)
Seat 3: Pseudo Fruto folded before Flop (didn't bet)
Seat 4: RenanToniolo (button) folded before Flop (didn't bet)
Seat 5: caio_pimenta (small blind) folded on the Flop
Seat 6: sunn¥m4nn (big blind) folded before Flop
Seat 7: podiiii folded before Flop (didn't bet)
Seat 8: drmentrop folded before Flop (didn't bet)

PokerStars Hand #251206114055: Tournament #3767885527, $40+$10+$5 USD Hold'em No Limit - Level XIV (1000/2000) - 2024/06/26 19:38:14 UTC [2024/06/26 15:38:14 ET]
Table '3767885527 92' 8-max Seat #5 is the button
Seat 1: rabwallace1993 (91816 in chips) 
Seat 2: Mr Pay Shent (38282 in chips) 
Seat 3: Pseudo Fruto (72914 in chips) 
Seat 4: RenanToniolo (164891 in chips) 
Seat 5: caio_pimenta (35907 in chips) 
Seat 6: sunn¥m4nn (112450 in chips) 
Seat 7: podiiii (48775 in chips) 
Seat 8: drmentrop (48750 in chips) 
rabwallace1993: posts the ante 250
Mr Pay Shent: posts the ante 250
Pseudo Fruto: posts the ante 250
RenanToniolo: posts the ante 250
caio_pimenta: posts the ante 250
sunn¥m4nn: posts the ante 250
podiiii: posts the ante 250
drmentrop: posts the ante 250
sunn¥m4nn: posts small blind 1000
podiiii: posts big blind 2000
*** HOLE CARDS ***
drmentrop: folds 
rabwallace1993: raises 2000 to 4000
Mr Pay Shent: folds 
Pseudo Fruto: folds 
RenanToniolo: folds 
caio_pimenta: folds 
sunn¥m4nn: calls 3000
podiiii: calls 2000
*** FLOP *** [3h 7c 2d]
sunn¥m4nn: checks 
podiiii: bets 3500
rabwallace1993: calls 3500
sunn¥m4nn: calls 3500
*** TURN *** [3h 7c 2d] [Jh]
sunn¥m4nn: checks 
podiiii: bets 8085
rabwallace1993: raises 10085 to 18170
sunn¥m4nn: folds 
podiiii: raises 22855 to 41025 and is all-in
rabwallace1993: folds 
Uncalled bet (22855) returned to podiiii
podiiii collected 60840 from pot
*** SUMMARY ***
Total pot 60840 | Rake 0 
Board [3h 7c 2d Jh]
Seat 1: rabwallace1993 folded on the Turn
Seat 2: Mr Pay Shent folded before Flop (didn't bet)
Seat 3: Pseudo Fruto folded before Flop (didn't bet)
Seat 4: RenanToniolo folded before Flop (didn't bet)
Seat 5: caio_pimenta (button) folded before Flop (didn't bet)
Seat 6: sunn¥m4nn (small blind) folded on the Turn
Seat 7: podiiii (big blind) collected (60840)
Seat 8: drmentrop folded before Flop (didn't bet)

PokerStars Hand #251206152482: Tournament #3767885527, $40+$10+$5 USD Hold'em No Limit - Level XV (1250/2500) - 2024/06/26 19:40:34 UTC [2024/06/26 15:40:34 ET]
Table '3767885527 92' 8-max Seat #6 is the button
Seat 1: rabwallace1993 (65896 in chips) 
Seat 2: Mr Pay Shent (38032 in chips) 
Seat 3: Pseudo Fruto (72664 in chips) 
Seat 4: RenanToniolo (164641 in chips) 
Seat 5: caio_pimenta (35657 in chips) 
Seat 6: sunn¥m4nn (104700 in chips) 
Seat 7: podiiii (83695 in chips) 
Seat 8: drmentrop (48500 in chips) 
rabwallace1993: posts the ante 325
Mr Pay Shent: posts the ante 325
Pseudo Fruto: posts the ante 325
RenanToniolo: posts the ante 325
caio_pimenta: posts the ante 325
sunn¥m4nn: posts the ante 325
podiiii: posts the ante 325
drmentrop: posts the ante 325
podiiii: posts small blind 1250
drmentrop: posts big blind 2500
*** HOLE CARDS ***
rabwallace1993: folds 
Mr Pay Shent: folds 
Pseudo Fruto: folds 
RenanToniolo: raises 2500 to 5000
caio_pimenta: folds 
sunn¥m4nn: folds 
podiiii: folds 
drmentrop: calls 2500
*** FLOP *** [Kd Js 8h]
drmentrop: checks 
RenanToniolo: bets 3463
drmentrop: calls 3463
*** TURN *** [Kd Js 8h] [Ac]
drmentrop: checks 
RenanToniolo: bets 11856
drmentrop: folds 
Uncalled bet (11856) returned to RenanToniolo
RenanToniolo collected 20776 from pot
*** SUMMARY ***
Total pot 20776 | Rake 0 
Board [Kd Js 8h Ac]
Seat 1: rabwallace1993 folded before Flop (didn't bet)
Seat 2: Mr Pay Shent folded before Flop (didn't bet)
Seat 3: Pseudo Fruto folded before Flop (didn't bet)
Seat 4: RenanToniolo collected (20776)
Seat 5: caio_pimenta folded before Flop (didn't bet)
Seat 6: sunn¥m4nn (button) folded before Flop (didn't bet)
Seat 7: podiiii (small blind) folded before Flop
Seat 8: drmentrop (big blind) folded on the Turn

PokerStars Hand #251206164781: Tournament #3767885527, $40+$10+$5 USD Hold'em No Limit - Level XV (1250/2500) - 2024/06/26 19:41:18 UTC [2024/06/26 15:41:18 ET]
Table '3767885527 92' 8-max Seat #7 is the button
Seat 1: rabwallace1993 (65571 in chips) 
Seat 2: Mr Pay Shent (37707 in chips) 
Seat 3: Pseudo Fruto (72339 in chips) 
Seat 4: RenanToniolo (176629 in chips) 
Seat 5: caio_pimenta (35332 in chips) 
Seat 6: sunn¥m4nn (104375 in chips) 
Seat 7: podiiii (82120 in chips) 
Seat 8: drmentrop (39712 in chips) 
rabwallace1993: posts the ante 325
Mr Pay Shent: posts the ante 325
Pseudo Fruto: posts the ante 325
RenanToniolo: posts the ante 325
caio_pimenta: posts the ante 325
sunn¥m4nn: posts the ante 325
podiiii: posts the ante 325
drmentrop: posts the ante 325
drmentrop: posts small blind 1250
rabwallace1993: posts big blind 2500
*** HOLE CARDS ***
Mr Pay Shent: folds 
Pseudo Fruto: folds 
RenanToniolo: folds 
caio_pimenta: folds 
sunn¥m4nn: folds 
podiiii: raises 2500 to 5000
drmentrop: folds 
rabwallace1993: calls 2500
*** FLOP *** [Qh 7s 2h]
rabwallace1993: checks 
podiiii: bets 4571
rabwallace1993: calls 4571
*** TURN *** [Qh 7s 2h] [2s]
rabwallace1993: checks 
podiiii: checks 
*** RIVER *** [Qh 7s 2h 2s] [As]
rabwallace1993: bets 11496
podiiii: folds 
Uncalled bet (11496) returned to rabwallace1993
rabwallace1993 collected 22992 from pot
rabwallace1993: doesn't show hand 
*** SUMMARY ***
Total pot 22992 | Rake 0 
Board [Qh 7s 2h 2s As]
Seat 1: rabwallace1993 (big blind) collected (22992)
Seat 2: Mr Pay Shent folded before Flop (didn't bet)
Seat 3: Pseudo Fruto folded before Flop (didn't bet)
Seat 4: RenanToniolo folded before Flop (didn't bet)
Seat 5: caio_pimenta folded before Flop (didn't bet)
Seat 6: sunn¥m4nn folded before Flop (didn't bet)
Seat 7: podiiii (button) folded on the River
Seat 8: drmentrop (small blind) folded before Flop

PokerStars Hand #251206187661: Tournament #3767885527, $40+$10+$5 USD Hold'em No Limit - Level XV (1250/2500) - 2024/06/26 19:42:41 UTC [2024/06/26 15:42:41 ET]
Table '3767885527 92' 8-max Seat #8 is the button
Seat 1: rabwallace1993 (78667 in chips) 
Seat 2: Mr Pay Shent (37382 in chips) 
Seat 3: Pseudo Fruto (72014 in chips) 
Seat 4: RenanToniolo (176304 in chips) 
Seat 5: caio_pimenta (35007 in chips) 
Seat 6: sunn¥m4nn (104050 in chips) 
Seat 7: podiiii (72224 in chips) 
Seat 8: drmentrop (38137 in chips) 
rabwallace1993: posts the ante 325
Mr Pay Shent: posts the ante 325
Pseudo Fruto: posts the ante 325
RenanToniolo: posts the ante 325
caio_pimenta: posts the ante 325
sunn¥m4nn: posts the ante 325
podiiii: posts the ante 325
drmentrop: posts the ante 325
rabwallace1993: posts small blind 1250
Mr Pay Shent: posts big blind 2500
*** HOLE CARDS ***
Pseudo Fruto: folds 
RenanToniolo: folds 
caio_pimenta: folds 
sunn¥m4nn: folds 
podiiii: raises 2500 to 5000
drmentrop: folds 
rabwallace1993: calls 3750
Mr Pay Shent: folds 
*** FLOP *** [8c 8d 5h]
rabwallace1993: checks 
podiiii: bets 4750
rabwallace1993: calls 4750
*** TURN *** [8c 8d 5h] [2d]
rabwallace1993: checks 
podiiii: bets 12500
rabwallace1993: calls 12500
*** RIVER *** [8c 8d 5h 2d] [Th]
rabwallace1993: checks 
podiiii: checks 
*** SHOW DOWN ***
rabwallace1993: shows [As 4h] (a pair of Eights)
podiiii: mucks hand 
rabwallace1993 collected 49600 from pot
*** SUMMARY ***
Total pot 49600 | Rake 0 
Board [8c 8d 5h 2d Th]
Seat 1: rabwallace1993 (small blind) showed [As 4h] and won (49600) with a pair of Eights
Seat 2: Mr Pay Shent (big blind) folded before Flop
Seat 3: Pseudo Fruto folded before Flop (didn't bet)
Seat 4: RenanToniolo folded before Flop (didn't bet)
Seat 5: caio_pimenta folded before Flop (didn't bet)
Seat 6: sunn¥m4nn folded before Flop (didn't bet)
Seat 7: podiiii mucked
Seat 8: drmentrop (button) folded before Flop (didn't bet)

PokerStars Hand #251206218987: Tournament #3767885527, $40+$10+$5 USD Hold'em No Limit - Level XV (1250/2500) - 2024/06/26 19:44:36 UTC [2024/06/26 15:44:36 ET]
Table '3767885527 92' 8-max Seat #1 is the button
Seat 1: rabwallace1993 (105692 in chips) 
Seat 2: Mr Pay Shent (34557 in chips) 
Seat 3: Pseudo Fruto (71689 in chips) 
Seat 4: RenanToniolo (175979 in chips) 
Seat 5: caio_pimenta (34682 in chips) 
Seat 6: sunn¥m4nn (103725 in chips) 
Seat 7: podiiii (49649 in chips) 
Seat 8: drmentrop (37812 in chips) 
rabwallace1993: posts the ante 325
Mr Pay Shent: posts the ante 325
Pseudo Fruto: posts the ante 325
RenanToniolo: posts the ante 325
caio_pimenta: posts the ante 325
sunn¥m4nn: posts the ante 325
podiiii: posts the ante 325
drmentrop: posts the ante 325
Mr Pay Shent: posts small blind 1250
Pseudo Fruto: posts big blind 2500
*** HOLE CARDS ***
RenanToniolo: folds 
caio_pimenta: folds 
sunn¥m4nn: folds 
podiiii: folds 
drmentrop: folds 
rabwallace1993: raises 5000 to 7500
Mr Pay Shent: folds 
Pseudo Fruto: folds 
Uncalled bet (5000) returned to rabwallace1993
rabwallace1993 collected 8850 from pot
rabwallace1993: doesn't show hand 
*** SUMMARY ***
Total pot 8850 | Rake 0 
Seat 1: rabwallace1993 (button) collected (8850)
Seat 2: Mr Pay Shent (small blind) folded before Flop
Seat 3: Pseudo Fruto (big blind) folded before Flop
Seat 4: RenanToniolo folded before Flop (didn't bet)
Seat 5: caio_pimenta folded before Flop (didn't bet)
Seat 6: sunn¥m4nn folded before Flop (didn't bet)
Seat 7: podiiii folded before Flop (didn't bet)
Seat 8: drmentrop folded before Flop (didn't bet)

PokerStars Hand #251206227216: Tournament #3767885527, $40+$10+$5 USD Hold'em No Limit - Level XV (1250/2500) - 2024/06/26 19:45:05 UTC [2024/06/26 15:45:05 ET]
Table '3767885527 92' 8-max Seat #2 is the button
Seat 1: rabwallace1993 (111717 in chips) 
Seat 2: Mr Pay Shent (32982 in chips) 
Seat 3: Pseudo Fruto (68864 in chips) 
Seat 4: RenanToniolo (175654 in chips) 
Seat 5: caio_pimenta (34357 in chips) 
Seat 6: sunn¥m4nn (103400 in chips) 
Seat 7: podiiii (49324 in chips) 
Seat 8: drmentrop (37487 in chips) 
rabwallace1993: posts the ante 325
Mr Pay Shent: posts the ante 325
Pseudo Fruto: posts the ante 325
RenanToniolo: posts the ante 325
caio_pimenta: posts the ante 325
sunn¥m4nn: posts the ante 325
podiiii: posts the ante 325
drmentrop: posts the ante 325
Pseudo Fruto: posts small blind 1250
RenanToniolo: posts big blind 2500
*** HOLE CARDS ***
caio_pimenta: folds 
sunn¥m4nn: folds 
podiiii: raises 2500 to 5000
drmentrop: folds 
rabwallace1993: folds 
Mr Pay Shent: folds 
Pseudo Fruto: folds 
RenanToniolo: calls 2500
*** FLOP *** [Qd Th 9d]
RenanToniolo: checks 
podiiii: bets 4571
RenanToniolo: calls 4571
*** TURN *** [Qd Th 9d] [Jd]
RenanToniolo: checks 
podiiii: bets 7587
RenanToniolo: calls 7587
*** RIVER *** [Qd Th 9d Jd] [2s]
RenanToniolo: checks 
podiiii: bets 31841 and is all-in
RenanToniolo: folds 
Uncalled bet (31841) returned to podiiii
podiiii collected 38166 from pot
*** SUMMARY ***
Total pot 38166 | Rake 0 
Board [Qd Th 9d Jd 2s]
Seat 1: rabwallace1993 folded before Flop (didn't bet)
Seat 2: Mr Pay Shent (button) folded before Flop (didn't bet)
Seat 3: Pseudo Fruto (small blind) folded before Flop
Seat 4: RenanToniolo (big blind) folded on the River
Seat 5: caio_pimenta folded before Flop (didn't bet)
Seat 6: sunn¥m4nn folded before Flop (didn't bet)
Seat 7: podiiii collected (38166)
Seat 8: drmentrop folded before Flop (didn't bet)

PokerStars Hand #251206255670: Tournament #3767885527, $40+$10+$5 USD Hold'em No Limit - Level XV (1250/2500) - 2024/06/26 19:46:48 UTC [2024/06/26 15:46:48 ET]
Table '3767885527 92' 8-max Seat #3 is the button
Seat 1: rabwallace1993 (111392 in chips) 
Seat 2: Mr Pay Shent (32657 in chips) 
Seat 3: Pseudo Fruto (67289 in chips) 
Seat 4: RenanToniolo (158171 in chips) 
Seat 5: caio_pimenta (34032 in chips) 
Seat 6: sunn¥m4nn (103075 in chips) 
Seat 7: podiiii (70007 in chips) 
Seat 8: drmentrop (37162 in chips) 
rabwallace1993: posts the ante 325
Mr Pay Shent: posts the ante 325
Pseudo Fruto: posts the ante 325
RenanToniolo: posts the ante 325
caio_pimenta: posts the ante 325
sunn¥m4nn: posts the ante 325
podiiii: posts the ante 325
drmentrop: posts the ante 325
RenanToniolo: posts small blind 1250
caio_pimenta: posts big blind 2500
*** HOLE CARDS ***
sunn¥m4nn: folds 
podiiii: folds 
drmentrop: folds 
rabwallace1993: folds 
Mr Pay Shent: folds 
Pseudo Fruto: raises 2500 to 5000
RenanToniolo: folds 
caio_pimenta: folds 
Uncalled bet (2500) returned to Pseudo Fruto
Pseudo Fruto collected 8850 from pot
Pseudo Fruto: doesn't show hand 
*** SUMMARY ***
Total pot 8850 | Rake 0 
Seat 1: rabwallace1993 folded before Flop (didn't bet)
Seat 2: Mr Pay Shent folded before Flop (didn't bet)
Seat 3: Pseudo Fruto (button) collected (8850)
Seat 4: RenanToniolo (small blind) folded before Flop
Seat 5: caio_pimenta (big blind) folded before Flop
Seat 6: sunn¥m4nn folded before Flop (didn't bet)
Seat 7: podiiii folded before Flop (didn't bet)
Seat 8: drmentrop folded before Flop (didn't bet)

PokerStars Hand #251206262206: Tournament #3767885527, $40+$10+$5 USD Hold'em No Limit - Level XV (1250/2500) - 2024/06/26 19:47:12 UTC [2024/06/26 15:47:12 ET]
Table '3767885527 92' 8-max Seat #4 is the button
Seat 1: rabwallace1993 (111067 in chips) 
Seat 2: Mr Pay Shent (32332 in chips) 
Seat 3: Pseudo Fruto (73314 in chips) 
Seat 4: RenanToniolo (156596 in chips) 
Seat 5: caio_pimenta (31207 in chips) 
Seat 6: sunn¥m4nn (102750 in chips) 
Seat 7: podiiii (69682 in chips) 
Seat 8: drmentrop (36837 in chips) 
rabwallace1993: posts the ante 325
Mr Pay Shent: posts the ante 325
Pseudo Fruto: posts the ante 325
RenanToniolo: posts the ante 325
caio_pimenta: posts the ante 325
sunn¥m4nn: posts the ante 325
podiiii: posts the ante 325
drmentrop: posts the ante 325
caio_pimenta: posts small blind 1250
sunn¥m4nn: posts big blind 2500
*** HOLE CARDS ***
podiiii: folds 
drmentrop: folds 
rabwallace1993: folds 
Mr Pay Shent: folds 
Pseudo Fruto: raises 2500 to 5000
RenanToniolo: folds 
caio_pimenta: raises 25882 to 30882 and is all-in
sunn¥m4nn: folds 
Pseudo Fruto: calls 25882
*** FLOP *** [2h Tc 9s]
*** TURN *** [2h Tc 9s] [5c]
*** RIVER *** [2h Tc 9s 5c] [Td]
*** SHOW DOWN ***
caio_pimenta: shows [Ks Qs] (a pair of Tens)
Pseudo Fruto: shows [4s 4h] (two pair, Tens and Fours)
Pseudo Fruto collected 66864 from pot
caio_pimenta finished the tournament in 504th place
*** SUMMARY ***
Total pot 66864 | Rake 0 
Board [2h Tc 9s 5c Td]
Seat 1: rabwallace1993 folded before Flop (didn't bet)
Seat 2: Mr Pay Shent folded before Flop (didn't bet)
Seat 3: Pseudo Fruto showed [4s 4h] and won (66864) with two pair, Tens and Fours
Seat 4: RenanToniolo (button) folded before Flop (didn't bet)
Seat 5: caio_pimenta (small blind) showed [Ks Qs] and lost with a pair of Tens
Seat 6: sunn¥m4nn (big blind) folded before Flop
Seat 7: podiiii folded before Flop (didn't bet)
Seat 8: drmentrop folded before Flop (didn't bet)

PokerStars Hand #251206274828: Tournament #3767885527, $40+$10+$5 USD Hold'em No Limit - Level XV (1250/2500) - 2024/06/26 19:47:58 UTC [2024/06/26 15:47:58 ET]
Table '3767885527 92' 8-max Seat #6 is the button
Seat 1: rabwallace1993 (110742 in chips) 
Seat 2: Mr Pay Shent (32007 in chips) 
Seat 3: Pseudo Fruto (108971 in chips) 
Seat 4: RenanToniolo (156271 in chips) 
Seat 6: sunn¥m4nn (99925 in chips) 
Seat 7: podiiii (69357 in chips) 
Seat 8: drmentrop (36512 in chips) 
rabwallace1993: posts the ante 325
Mr Pay Shent: posts the ante 325
Pseudo Fruto: posts the ante 325
RenanToniolo: posts the ante 325
sunn¥m4nn: posts the ante 325
podiiii: posts the ante 325
drmentrop: posts the ante 325
podiiii: posts small blind 1250
drmentrop: posts big blind 2500
*** HOLE CARDS ***
rabwallace1993: folds 
Mr Pay Shent: raises 2500 to 5000
Pseudo Fruto: folds 
RenanToniolo: folds 
sunn¥m4nn: folds 
podiiii: folds 
drmentrop: calls 2500
*** FLOP *** [8d Ad Ts]
drmentrop: checks 
Mr Pay Shent: bets 6763
drmentrop: folds 
Uncalled bet (6763) returned to Mr Pay Shent
Mr Pay Shent collected 13525 from pot
Mr Pay Shent: doesn't show hand 
*** SUMMARY ***
Total pot 13525 | Rake 0 
Board [8d Ad Ts]
Seat 1: rabwallace1993 folded before Flop (didn't bet)
Seat 2: Mr Pay Shent collected (13525)
Seat 3: Pseudo Fruto folded before Flop (didn't bet)
Seat 4: RenanToniolo folded before Flop (didn't bet)
Seat 6: sunn¥m4nn (button) folded before Flop (didn't bet)
Seat 7: podiiii (small blind) folded before Flop
Seat 8: drmentrop (big blind) folded on the Flop

PokerStars Hand #251206283465: Tournament #3767885527, $40+$10+$5 USD Hold'em No Limit - Level XV (1250/2500) - 2024/06/26 19:48:30 UTC [2024/06/26 15:48:30 ET]
Table '3767885527 92' 8-max Seat #7 is the button
Seat 1: rabwallace1993 (110417 in chips) 
Seat 2: Mr Pay Shent (40207 in chips) 
Seat 3: Pseudo Fruto (108646 in chips) 
Seat 4: RenanToniolo (155946 in chips) 
Seat 6: sunn¥m4nn (99600 in chips) 
Seat 7: podiiii (67782 in chips) 
Seat 8: drmentrop (31187 in chips) 
rabwallace1993: posts the ante 325
Mr Pay Shent: posts the ante 325
Pseudo Fruto: posts the ante 325
RenanToniolo: posts the ante 325
sunn¥m4nn: posts the ante 325
podiiii: posts the ante 325
drmentrop: posts the ante 325
drmentrop: posts small blind 1250
rabwallace1993: posts big blind 2500
*** HOLE CARDS ***
Mr Pay Shent: folds 
Pseudo Fruto: raises 2500 to 5000
RenanToniolo: folds 
sunn¥m4nn: folds 
podiiii: folds 
S3d3m2 is disconnected 
drmentrop: raises 25862 to 30862 and is all-in
rabwallace1993: folds 
Pseudo Fruto: folds 
Uncalled bet (25862) returned to drmentrop
drmentrop collected 14775 from pot
*** SUMMARY ***
Total pot 14775 | Rake 0 
Seat 1: rabwallace1993 (big blind) folded before Flop
Seat 2: Mr Pay Shent folded before Flop (didn't bet)
Seat 3: Pseudo Fruto folded before Flop
Seat 4: RenanToniolo folded before Flop (didn't bet)
Seat 6: sunn¥m4nn folded before Flop (didn't bet)
Seat 7: podiiii (button) folded before Flop (didn't bet)
Seat 8: drmentrop (small blind) collected (14775)

PokerStars Hand #251206297124: Tournament #3767885527, $40+$10+$5 USD Hold'em No Limit - Level XVI (1500/3000) - 2024/06/26 19:49:19 UTC [2024/06/26 15:49:19 ET]
Table '3767885527 92' 8-max Seat #8 is the button
Seat 1: rabwallace1993 (107592 in chips) 
Seat 2: Mr Pay Shent (39882 in chips) 
Seat 3: Pseudo Fruto (103321 in chips) 
Seat 4: RenanToniolo (155621 in chips) 
Seat 5: S3d3m2 (104819 in chips) 
Seat 6: sunn¥m4nn (99275 in chips) 
Seat 7: podiiii (67457 in chips) 
Seat 8: drmentrop (40637 in chips) 
rabwallace1993: posts the ante 375
Mr Pay Shent: posts the ante 375
Pseudo Fruto: posts the ante 375
RenanToniolo: posts the ante 375
S3d3m2: posts the ante 375
sunn¥m4nn: posts the ante 375
podiiii: posts the ante 375
drmentrop: posts the ante 375
rabwallace1993: posts small blind 1500
Mr Pay Shent: posts big blind 3000
*** HOLE CARDS ***
Pseudo Fruto: raises 3000 to 6000
RenanToniolo: folds 
S3d3m2: folds 
sunn¥m4nn: folds 
podiiii: folds 
drmentrop: raises 34262 to 40262 and is all-in
rabwallace1993: folds 
Mr Pay Shent: folds 
Pseudo Fruto: calls 34262
*** FLOP *** [Ks Tc 9s]
*** TURN *** [Ks Tc 9s] [3d]
*** RIVER *** [Ks Tc 9s 3d] [2d]
*** SHOW DOWN ***
Pseudo Fruto: shows [Ac Jh] (high card Ace)
drmentrop: shows [As 6c] (high card Ace - lower kicker)
Pseudo Fruto collected 88024 from pot
drmentrop finished the tournament in 491st place
*** SUMMARY ***
Total pot 88024 | Rake 0 
Board [Ks Tc 9s 3d 2d]
Seat 1: rabwallace1993 (small blind) folded before Flop
Seat 2: Mr Pay Shent (big blind) folded before Flop
Seat 3: Pseudo Fruto showed [Ac Jh] and won (88024) with high card Ace
Seat 4: RenanToniolo folded before Flop (didn't bet)
Seat 5: S3d3m2 folded before Flop (didn't bet)
Seat 6: sunn¥m4nn folded before Flop (didn't bet)
Seat 7: podiiii folded before Flop (didn't bet)
Seat 8: drmentrop (button) showed [As 6c] and lost with high card Ace

PokerStars Hand #251206308628: Tournament #3767885527, $40+$10+$5 USD Hold'em No Limit - Level XVI (1500/3000) - 2024/06/26 19:50:00 UTC [2024/06/26 15:50:00 ET]
Table '3767885527 92' 8-max Seat #1 is the button
Seat 1: rabwallace1993 (105717 in chips) 
Seat 2: Mr Pay Shent (36507 in chips) 
Seat 3: Pseudo Fruto (150708 in chips) 
Seat 4: RenanToniolo (155246 in chips) 
Seat 5: S3d3m2 (104444 in chips) 
Seat 6: sunn¥m4nn (98900 in chips) 
Seat 7: podiiii (67082 in chips) 
rabwallace1993: posts the ante 375
Mr Pay Shent: posts the ante 375
Pseudo Fruto: posts the ante 375
RenanToniolo: posts the ante 375
S3d3m2: posts the ante 375
sunn¥m4nn: posts the ante 375
podiiii: posts the ante 375
Mr Pay Shent: posts small blind 1500
Pseudo Fruto: posts big blind 3000
*** HOLE CARDS ***
RenanToniolo: folds 
S3d3m2: folds 
sunn¥m4nn: raises 3000 to 6000
BorIska1993 is disconnected 
podiiii: raises 60707 to 66707 and is all-in
rabwallace1993: folds 
Mr Pay Shent: calls 34632 and is all-in
Pseudo Fruto: folds 
sunn¥m4nn: folds 
Uncalled bet (30575) returned to podiiii
*** FLOP *** [Kc 9h Ad]
*** TURN *** [Kc 9h Ad] [8c]
*** RIVER *** [Kc 9h Ad 8c] [As]
*** SHOW DOWN ***
Mr Pay Shent: shows [Qh Ac] (three of a kind, Aces)
podiiii: shows [5d 5c] (two pair, Aces and Fives)
Mr Pay Shent collected 83889 from pot
*** SUMMARY ***
Total pot 83889 | Rake 0 
Board [Kc 9h Ad 8c As]
Seat 1: rabwallace1993 (button) folded before Flop (didn't bet)
Seat 2: Mr Pay Shent (small blind) showed [Qh Ac] and won (83889) with three of a kind, Aces
Seat 3: Pseudo Fruto (big blind) folded before Flop
Seat 4: RenanToniolo folded before Flop (didn't bet)
Seat 5: S3d3m2 folded before Flop (didn't bet)
Seat 6: sunn¥m4nn folded before Flop
Seat 7: podiiii showed [5d 5c] and lost with two pair, Aces and Fives

PokerStars Hand #251206322383: Tournament #3767885527, $40+$10+$5 USD Hold'em No Limit - Level XVI (1500/3000) - 2024/06/26 19:50:49 UTC [2024/06/26 15:50:49 ET]
Table '3767885527 92' 8-max Seat #2 is the button
Seat 1: rabwallace1993 (105342 in chips) 
Seat 2: Mr Pay Shent (83889 in chips) 
Seat 3: Pseudo Fruto (147333 in chips) 
Seat 4: RenanToniolo (154871 in chips) 
Seat 5: S3d3m2 (104069 in chips) 
Seat 6: sunn¥m4nn (92525 in chips) 
Seat 7: podiiii (30575 in chips) 
Seat 8: BorIska1993 (181649 in chips) 
rabwallace1993: posts the ante 375
Mr Pay Shent: posts the ante 375
Pseudo Fruto: posts the ante 375
RenanToniolo: posts the ante 375
S3d3m2: posts the ante 375
sunn¥m4nn: posts the ante 375
podiiii: posts the ante 375
BorIska1993: posts the ante 375
Pseudo Fruto: posts small blind 1500
RenanToniolo: posts big blind 3000
*** HOLE CARDS ***
S3d3m2: raises 3000 to 6000
sunn¥m4nn: folds 
podiiii: folds 
BorIska1993: folds 
rabwallace1993 has timed out
rabwallace1993: folds 
rabwallace1993 is sitting out
Mr Pay Shent: folds 
rabwallace1993 has returned
Pseudo Fruto: raises 16500 to 22500
RenanToniolo: folds 
S3d3m2: raises 81194 to 103694 and is all-in
Pseudo Fruto: calls 81194
*** FLOP *** [5d 8d 7d]
*** TURN *** [5d 8d 7d] [2s]
*** RIVER *** [5d 8d 7d 2s] [Td]
*** SHOW DOWN ***
Pseudo Fruto: shows [Qd Ad] (a flush, Ace high)
S3d3m2: shows [Ah Kd] (a flush, King high)
Pseudo Fruto collected 213388 from pot
S3d3m2 finished the tournament in 467th place
*** SUMMARY ***
Total pot 213388 | Rake 0 
Board [5d 8d 7d 2s Td]
Seat 1: rabwallace1993 folded before Flop (didn't bet)
Seat 2: Mr Pay Shent (button) folded before Flop (didn't bet)
Seat 3: Pseudo Fruto (small blind) showed [Qd Ad] and won (213388) with a flush, Ace high
Seat 4: RenanToniolo (big blind) folded before Flop
Seat 5: S3d3m2 showed [Ah Kd] and lost with a flush, King high
Seat 6: sunn¥m4nn folded before Flop (didn't bet)
Seat 7: podiiii folded before Flop (didn't bet)
Seat 8: BorIska1993 folded before Flop (didn't bet)

PokerStars Hand #251206342528: Tournament #3767885527, $40+$10+$5 USD Hold'em No Limit - Level XVI (1500/3000) - 2024/06/26 19:52:01 UTC [2024/06/26 15:52:01 ET]
Table '3767885527 92' 8-max Seat #3 is the button
Seat 1: rabwallace1993 (104967 in chips) 
Seat 2: Mr Pay Shent (83514 in chips) 
Seat 3: Pseudo Fruto (256652 in chips) 
Seat 4: RenanToniolo (151496 in chips) 
Seat 6: sunn¥m4nn (92150 in chips) 
Seat 7: podiiii (30200 in chips) 
Seat 8: BorIska1993 (181274 in chips) 
rabwallace1993: posts the ante 375
Mr Pay Shent: posts the ante 375
Pseudo Fruto: posts the ante 375
RenanToniolo: posts the ante 375
sunn¥m4nn: posts the ante 375
podiiii: posts the ante 375
BorIska1993: posts the ante 375
RenanToniolo: posts small blind 1500
sunn¥m4nn: posts big blind 3000
*** HOLE CARDS ***
podiiii: folds 
BorIska1993: folds 
rabwallace1993: folds 
Mr Pay Shent: folds 
Pseudo Fruto: raises 3000 to 6000
RenanToniolo: folds 
mv14 is disconnected 
sunn¥m4nn: folds 
Uncalled bet (3000) returned to Pseudo Fruto
Pseudo Fruto collected 10125 from pot
Pseudo Fruto: doesn't show hand 
*** SUMMARY ***
Total pot 10125 | Rake 0 
Seat 1: rabwallace1993 folded before Flop (didn't bet)
Seat 2: Mr Pay Shent folded before Flop (didn't bet)
Seat 3: Pseudo Fruto (button) collected (10125)
Seat 4: RenanToniolo (small blind) folded before Flop
Seat 6: sunn¥m4nn (big blind) folded before Flop
Seat 7: podiiii folded before Flop (didn't bet)
Seat 8: BorIska1993 folded before Flop (didn't bet)

PokerStars Hand #251206348712: Tournament #3767885527, $40+$10+$5 USD Hold'em No Limit - Level XVI (1500/3000) - 2024/06/26 19:52:23 UTC [2024/06/26 15:52:23 ET]
Table '3767885527 92' 8-max Seat #4 is the button
Seat 1: rabwallace1993 (104592 in chips) 
Seat 2: Mr Pay Shent (83139 in chips) 
Seat 3: Pseudo Fruto (263402 in chips) 
Seat 4: RenanToniolo (149621 in chips) 
Seat 5: mv14 (32777 in chips) out of hand (moved from another table into small blind)
Seat 6: sunn¥m4nn (88775 in chips) 
Seat 7: podiiii (29825 in chips) 
Seat 8: BorIska1993 (180899 in chips) 
mv14 will be allowed to play after the button
rabwallace1993: posts the ante 375
Mr Pay Shent: posts the ante 375
Pseudo Fruto: posts the ante 375
RenanToniolo: posts the ante 375
sunn¥m4nn: posts the ante 375
podiiii: posts the ante 375
BorIska1993: posts the ante 375
sunn¥m4nn: posts small blind 1500
podiiii: posts big blind 3000
*** HOLE CARDS ***
BorIska1993: raises 3000 to 6000
rabwallace1993: raises 6000 to 12000
Mr Pay Shent: folds 
Pseudo Fruto: folds 
RenanToniolo: folds 
sunn¥m4nn: folds 
podiiii: folds 
BorIska1993: calls 6000
*** FLOP *** [Qs 6c Tc]
BorIska1993: checks 
rabwallace1993: checks 
*** TURN *** [Qs 6c Tc] [5d]
BorIska1993: bets 21900
rabwallace1993: calls 21900
*** RIVER *** [Qs 6c Tc 5d] [Js]
BorIska1993: checks 
rabwallace1993: bets 40463
BorIska1993: calls 40463
*** SHOW DOWN ***
rabwallace1993: shows [Ks Ah] (a straight, Ten to Ace)
BorIska1993: mucks hand 
rabwallace1993 collected 155851 from pot
*** SUMMARY ***
Total pot 155851 | Rake 0 
Board [Qs 6c Tc 5d Js]
Seat 1: rabwallace1993 showed [Ks Ah] and won (155851) with a straight, Ten to Ace
Seat 2: Mr Pay Shent folded before Flop (didn't bet)
Seat 3: Pseudo Fruto folded before Flop (didn't bet)
Seat 4: RenanToniolo (button) folded before Flop (didn't bet)
Seat 6: sunn¥m4nn (small blind) folded before Flop
Seat 7: podiiii (big blind) folded before Flop
Seat 8: BorIska1993 mucked

PokerStars Hand #251206385232: Tournament #3767885527, $40+$10+$5 USD Hold'em No Limit - Level XVI (1500/3000) - 2024/06/26 19:54:32 UTC [2024/06/26 15:54:32 ET]
Table '3767885527 92' 8-max Seat #6 is the button
Seat 1: rabwallace1993 (185705 in chips) 
Seat 2: Mr Pay Shent (82764 in chips) 
Seat 3: Pseudo Fruto (263027 in chips) 
Seat 4: RenanToniolo (149246 in chips) 
Seat 5: mv14 (32777 in chips) 
Seat 6: sunn¥m4nn (86900 in chips) 
Seat 7: podiiii (26450 in chips) 
Seat 8: BorIska1993 (106161 in chips) 
rabwallace1993: posts the ante 375
Mr Pay Shent: posts the ante 375
Pseudo Fruto: posts the ante 375
RenanToniolo: posts the ante 375
mv14: posts the ante 375
sunn¥m4nn: posts the ante 375
podiiii: posts the ante 375
BorIska1993: posts the ante 375
podiiii: posts small blind 1500
BorIska1993: posts big blind 3000
*** HOLE CARDS ***
rabwallace1993: folds 
Mr Pay Shent: folds 
Pseudo Fruto: raises 3000 to 6000
RenanToniolo: folds 
mv14: folds 
sunn¥m4nn: folds 
podiiii: folds 
BorIska1993: folds 
Uncalled bet (3000) returned to Pseudo Fruto
Pseudo Fruto collected 10500 from pot
Pseudo Fruto: doesn't show hand 
*** SUMMARY ***
Total pot 10500 | Rake 0 
Seat 1: rabwallace1993 folded before Flop (didn't bet)
Seat 2: Mr Pay Shent folded before Flop (didn't bet)
Seat 3: Pseudo Fruto collected (10500)
Seat 4: RenanToniolo folded before Flop (didn't bet)
Seat 5: mv14 folded before Flop (didn't bet)
Seat 6: sunn¥m4nn (button) folded before Flop (didn't bet)
Seat 7: podiiii (small blind) folded before Flop
Seat 8: BorIska1993 (big blind) folded before Flop

PokerStars Hand #251206482751: Tournament #3767885527, $40+$10+$5 USD Hold'em No Limit - Level XVI (1500/3000) - 2024/06/26 20:01:47 UTC [2024/06/26 16:01:47 ET]
Table '3767885527 92' 8-max Seat #7 is the button
Seat 1: rabwallace1993 (185330 in chips) 
Seat 2: Mr Pay Shent (82389 in chips) 
Seat 3: Pseudo Fruto (270152 in chips) 
Seat 4: RenanToniolo (148871 in chips) 
Seat 5: mv14 (32402 in chips) 
Seat 6: sunn¥m4nn (86525 in chips) 
Seat 7: podiiii (24575 in chips) 
Seat 8: BorIska1993 (102786 in chips) 
rabwallace1993: posts the ante 375
Mr Pay Shent: posts the ante 375
Pseudo Fruto: posts the ante 375
RenanToniolo: posts the ante 375
mv14: posts the ante 375
sunn¥m4nn: posts the ante 375
podiiii: posts the ante 375
BorIska1993: posts the ante 375
BorIska1993: posts small blind 1500
rabwallace1993: posts big blind 3000
*** HOLE CARDS ***
Mr Pay Shent: folds 
Pseudo Fruto: folds 
RenanToniolo: folds 
mv14: folds 
sunn¥m4nn: raises 3000 to 6000
podiiii: folds 
BorIska1993: calls 4500
rabwallace1993: calls 3000
*** FLOP *** [5d 7c 2d]
BorIska1993: checks 
rabwallace1993: checks 
sunn¥m4nn: checks 
*** TURN *** [5d 7c 2d] [Jh]
BorIska1993: checks 
rabwallace1993: checks 
sunn¥m4nn: bets 15000
BorIska1993: folds 
rabwallace1993: calls 15000
*** RIVER *** [5d 7c 2d Jh] [Qh]
rabwallace1993: checks 
sunn¥m4nn: checks 
*** SHOW DOWN ***
rabwallace1993: shows [Kh 5s] (a pair of Fives)
sunn¥m4nn: shows [Jd Ks] (a pair of Jacks)
sunn¥m4nn collected 51000 from pot
*** SUMMARY ***
Total pot 51000 | Rake 0 
Board [5d 7c 2d Jh Qh]
Seat 1: rabwallace1993 (big blind) showed [Kh 5s] and lost with a pair of Fives
Seat 2: Mr Pay Shent folded before Flop (didn't bet)
Seat 3: Pseudo Fruto folded before Flop (didn't bet)
Seat 4: RenanToniolo folded before Flop (didn't bet)
Seat 5: mv14 folded before Flop (didn't bet)
Seat 6: sunn¥m4nn showed [Jd Ks] and won (51000) with a pair of Jacks
Seat 7: podiiii (button) folded before Flop (didn't bet)
Seat 8: BorIska1993 (small blind) folded on the Turn

PokerStars Hand #251206518088: Tournament #3767885527, $40+$10+$5 USD Hold'em No Limit - Level XVI (1500/3000) - 2024/06/26 20:03:52 UTC [2024/06/26 16:03:52 ET]
Table '3767885527 92' 8-max Seat #8 is the button
Seat 1: rabwallace1993 (163955 in chips) 
Seat 2: Mr Pay Shent (82014 in chips) 
Seat 3: Pseudo Fruto (269777 in chips) 
Seat 4: RenanToniolo (148496 in chips) 
Seat 5: mv14 (32027 in chips) 
Seat 6: sunn¥m4nn (116150 in chips) 
Seat 7: podiiii (24200 in chips) 
Seat 8: BorIska1993 (96411 in chips) 
rabwallace1993: posts the ante 375
Mr Pay Shent: posts the ante 375
Pseudo Fruto: posts the ante 375
RenanToniolo: posts the ante 375
mv14: posts the ante 375
sunn¥m4nn: posts the ante 375
podiiii: posts the ante 375
BorIska1993: posts the ante 375
rabwallace1993: posts small blind 1500
Mr Pay Shent: posts big blind 3000
*** HOLE CARDS ***
Pseudo Fruto: folds 
RenanToniolo: folds 
mv14: raises 3000 to 6000
sunn¥m4nn: folds 
podiiii: folds 
BorIska1993: folds 
rabwallace1993: folds 
Mr Pay Shent: calls 3000
*** FLOP *** [9d 6h Ac]
Mr Pay Shent: checks 
mv14: bets 5670
Mr Pay Shent: raises 5670 to 11340
mv14: calls 5670
*** TURN *** [9d 6h Ac] [7s]
Mr Pay Shent: bets 39180
mv14: folds 
Uncalled bet (39180) returned to Mr Pay Shent
Mr Pay Shent collected 39180 from pot
Mr Pay Shent: doesn't show hand 
*** SUMMARY ***
Total pot 39180 | Rake 0 
Board [9d 6h Ac 7s]
Seat 1: rabwallace1993 (small blind) folded before Flop
Seat 2: Mr Pay Shent (big blind) collected (39180)
Seat 3: Pseudo Fruto folded before Flop (didn't bet)
Seat 4: RenanToniolo folded before Flop (didn't bet)
Seat 5: mv14 folded on the Turn
Seat 6: sunn¥m4nn folded before Flop (didn't bet)
Seat 7: podiiii folded before Flop (didn't bet)
Seat 8: BorIska1993 (button) folded before Flop (didn't bet)

PokerStars Hand #251206536329: Tournament #3767885527, $40+$10+$5 USD Hold'em No Limit - Level XVI (1500/3000) - 2024/06/26 20:04:56 UTC [2024/06/26 16:04:56 ET]
Table '3767885527 92' 8-max Seat #1 is the button
Seat 1: rabwallace1993 (162080 in chips) 
Seat 2: Mr Pay Shent (103479 in chips) 
Seat 3: Pseudo Fruto (269402 in chips) 
Seat 4: RenanToniolo (148121 in chips) 
Seat 5: mv14 (14312 in chips) 
Seat 6: sunn¥m4nn (115775 in chips) 
Seat 7: podiiii (23825 in chips) 
Seat 8: BorIska1993 (96036 in chips) 
rabwallace1993: posts the ante 375
Mr Pay Shent: posts the ante 375
Pseudo Fruto: posts the ante 375
RenanToniolo: posts the ante 375
mv14: posts the ante 375
sunn¥m4nn: posts the ante 375
podiiii: posts the ante 375
BorIska1993: posts the ante 375
Mr Pay Shent: posts small blind 1500
Pseudo Fruto: posts big blind 3000
*** HOLE CARDS ***
RenanToniolo: raises 3000 to 6000
mv14: folds 
sunn¥m4nn: folds 
podiiii: folds 
BorIska1993: folds 
rabwallace1993: folds 
Mr Pay Shent: folds 
Pseudo Fruto: folds 
Uncalled bet (3000) returned to RenanToniolo
RenanToniolo collected 10500 from pot
*** SUMMARY ***
Total pot 10500 | Rake 0 
Seat 1: rabwallace1993 (button) folded before Flop (didn't bet)
Seat 2: Mr Pay Shent (small blind) folded before Flop
Seat 3: Pseudo Fruto (big blind) folded before Flop
Seat 4: RenanToniolo collected (10500)
Seat 5: mv14 folded before Flop (didn't bet)
Seat 6: sunn¥m4nn folded before Flop (didn't bet)
Seat 7: podiiii folded before Flop (didn't bet)
Seat 8: BorIska1993 folded before Flop (didn't bet)

PokerStars Hand #251206550249: Tournament #3767885527, $40+$10+$5 USD Hold'em No Limit - Level XVI (1500/3000) - 2024/06/26 20:05:44 UTC [2024/06/26 16:05:44 ET]
Table '3767885527 92' 8-max Seat #2 is the button
Seat 1: rabwallace1993 (161705 in chips) 
Seat 2: Mr Pay Shent (101604 in chips) 
Seat 3: Pseudo Fruto (266027 in chips) 
Seat 4: RenanToniolo (155246 in chips) 
Seat 5: mv14 (13937 in chips) 
Seat 6: sunn¥m4nn (115400 in chips) 
Seat 7: podiiii (23450 in chips) 
Seat 8: BorIska1993 (95661 in chips) 
rabwallace1993: posts the ante 375
Mr Pay Shent: posts the ante 375
Pseudo Fruto: posts the ante 375
RenanToniolo: posts the ante 375
mv14: posts the ante 375
sunn¥m4nn: posts the ante 375
podiiii: posts the ante 375
BorIska1993: posts the ante 375
Pseudo Fruto: posts small blind 1500
RenanToniolo: posts big blind 3000
*** HOLE CARDS ***
mv14: folds 
sunn¥m4nn: folds 
podiiii: folds 
BorIska1993: folds 
rabwallace1993: folds 
Mr Pay Shent: folds 
Pseudo Fruto: raises 7500 to 10500
RenanToniolo: calls 7500
*** FLOP *** [Th Ac 8h]
Pseudo Fruto has timed out
Pseudo Fruto: checks 
RenanToniolo: bets 16000
Pseudo Fruto: raises 26000 to 42000
RenanToniolo: folds 
Uncalled bet (26000) returned to Pseudo Fruto
Pseudo Fruto collected 56000 from pot
Pseudo Fruto: doesn't show hand 
*** SUMMARY ***
Total pot 56000 | Rake 0 
Board [Th Ac 8h]
Seat 1: rabwallace1993 folded before Flop (didn't bet)
Seat 2: Mr Pay Shent (button) folded before Flop (didn't bet)
Seat 3: Pseudo Fruto (small blind) collected (56000)
Seat 4: RenanToniolo (big blind) folded on the Flop
Seat 5: mv14 folded before Flop (didn't bet)
Seat 6: sunn¥m4nn folded before Flop (didn't bet)
Seat 7: podiiii folded before Flop (didn't bet)
Seat 8: BorIska1993 folded before Flop (didn't bet)

PokerStars Hand #251206577141: Tournament #3767885527, $40+$10+$5 USD Hold'em No Limit - Level XVII (1750/3500) - 2024/06/26 20:07:18 UTC [2024/06/26 16:07:18 ET]
Table '3767885527 92' 8-max Seat #3 is the button
Seat 1: rabwallace1993 (161330 in chips) 
Seat 2: Mr Pay Shent (101229 in chips) 
Seat 3: Pseudo Fruto (295152 in chips) 
Seat 4: RenanToniolo (128371 in chips) 
Seat 5: mv14 (13562 in chips) 
Seat 6: sunn¥m4nn (115025 in chips) 
Seat 7: podiiii (23075 in chips) 
Seat 8: BorIska1993 (95286 in chips) 
rabwallace1993: posts the ante 450
Mr Pay Shent: posts the ante 450
Pseudo Fruto: posts the ante 450
RenanToniolo: posts the ante 450
mv14: posts the ante 450
sunn¥m4nn: posts the ante 450
podiiii: posts the ante 450
BorIska1993: posts the ante 450
RenanToniolo: posts small blind 1750
mv14: posts big blind 3500
*** HOLE CARDS ***
sunn¥m4nn: folds 
podiiii: folds 
BorIska1993: folds 
rabwallace1993: folds 
Mr Pay Shent: folds 
Pseudo Fruto: folds 
RenanToniolo: raises 12250 to 15750
mv14: calls 9612 and is all-in
Uncalled bet (2638) returned to RenanToniolo
*** FLOP *** [Qd Js 7s]
*** TURN *** [Qd Js 7s] [9h]
*** RIVER *** [Qd Js 7s 9h] [Jh]
*** SHOW DOWN ***
RenanToniolo: shows [6c 5d] (a pair of Jacks)
mv14: shows [4c Jc] (three of a kind, Jacks)
mv14 collected 29824 from pot
*** SUMMARY ***
Total pot 29824 | Rake 0 
Board [Qd Js 7s 9h Jh]
Seat 1: rabwallace1993 folded before Flop (didn't bet)
Seat 2: Mr Pay Shent folded before Flop (didn't bet)
Seat 3: Pseudo Fruto (button) folded before Flop (didn't bet)
Seat 4: RenanToniolo (small blind) showed [6c 5d] and lost with a pair of Jacks
Seat 5: mv14 (big blind) showed [4c Jc] and won (29824) with three of a kind, Jacks
Seat 6: sunn¥m4nn folded before Flop (didn't bet)
Seat 7: podiiii folded before Flop (didn't bet)
Seat 8: BorIska1993 folded before Flop (didn't bet)

PokerStars Hand #251206586348: Tournament #3767885527, $40+$10+$5 USD Hold'em No Limit - Level XVII (1750/3500) - 2024/06/26 20:07:51 UTC [2024/06/26 16:07:51 ET]
Table '3767885527 92' 8-max Seat #4 is the button
Seat 1: rabwallace1993 (160880 in chips) 
Seat 2: Mr Pay Shent (100779 in chips) 
Seat 3: Pseudo Fruto (294702 in chips) 
Seat 4: RenanToniolo (114809 in chips) 
Seat 5: mv14 (29824 in chips) 
Seat 6: sunn¥m4nn (114575 in chips) 
Seat 7: podiiii (22625 in chips) 
Seat 8: BorIska1993 (94836 in chips) 
rabwallace1993: posts the ante 450
Mr Pay Shent: posts the ante 450
Pseudo Fruto: posts the ante 450
RenanToniolo: posts the ante 450
mv14: posts the ante 450
sunn¥m4nn: posts the ante 450
podiiii: posts the ante 450
BorIska1993: posts the ante 450
mv14: posts small blind 1750
sunn¥m4nn: posts big blind 3500
*** HOLE CARDS ***
podiiii: raises 18675 to 22175 and is all-in
BorIska1993: folds 
rabwallace1993: folds 
Mr Pay Shent: folds 
Pseudo Fruto: folds 
RenanToniolo: folds 
mv14: folds 
sunn¥m4nn: calls 18675
*** FLOP *** [4s Ks 7s]
*** TURN *** [4s Ks 7s] [3h]
*** RIVER *** [4s Ks 7s 3h] [7h]
*** SHOW DOWN ***
sunn¥m4nn: shows [Ad Kh] (two pair, Kings and Sevens)
podiiii: shows [9d 9c] (two pair, Nines and Sevens)
sunn¥m4nn collected 49700 from pot
podiiii finished the tournament in 394th place
*** SUMMARY ***
Total pot 49700 | Rake 0 
Board [4s Ks 7s 3h 7h]
Seat 1: rabwallace1993 folded before Flop (didn't bet)
Seat 2: Mr Pay Shent folded before Flop (didn't bet)
Seat 3: Pseudo Fruto folded before Flop (didn't bet)
Seat 4: RenanToniolo (button) folded before Flop (didn't bet)
Seat 5: mv14 (small blind) folded before Flop
Seat 6: sunn¥m4nn (big blind) showed [Ad Kh] and won (49700) with two pair, Kings and Sevens
Seat 7: podiiii showed [9d 9c] and lost with two pair, Nines and Sevens
Seat 8: BorIska1993 folded before Flop (didn't bet)

PokerStars Hand #251206594589: Tournament #3767885527, $40+$10+$5 USD Hold'em No Limit - Level XVII (1750/3500) - 2024/06/26 20:08:20 UTC [2024/06/26 16:08:20 ET]
Table '3767885527 92' 8-max Seat #5 is the button
Seat 1: rabwallace1993 (160430 in chips) 
Seat 2: Mr Pay Shent (100329 in chips) 
Seat 3: Pseudo Fruto (294252 in chips) 
Seat 4: RenanToniolo (114359 in chips) 
Seat 5: mv14 (27624 in chips) 
Seat 6: sunn¥m4nn (141650 in chips) 
Seat 8: BorIska1993 (94386 in chips) 
rabwallace1993: posts the ante 450
Mr Pay Shent: posts the ante 450
Pseudo Fruto: posts the ante 450
RenanToniolo: posts the ante 450
mv14: posts the ante 450
sunn¥m4nn: posts the ante 450
BorIska1993: posts the ante 450
sunn¥m4nn: posts small blind 1750
BorIska1993: posts big blind 3500
*** HOLE CARDS ***
rabwallace1993: folds 
Mr Pay Shent: raises 3500 to 7000
Pseudo Fruto: folds 
RenanToniolo: folds 
mv14: folds 
sunn¥m4nn: folds 
BorIska1993: calls 3500
*** FLOP *** [6c Jd 5s]
BorIska1993: checks 
Mr Pay Shent: checks 
*** TURN *** [6c Jd 5s] [7s]
BorIska1993: bets 6237
Mr Pay Shent: calls 6237
*** RIVER *** [6c Jd 5s 7s] [5d]
BorIska1993: bets 16001
Mr Pay Shent: calls 16001
*** SHOW DOWN ***
BorIska1993: shows [Ad 7d] (two pair, Sevens and Fives)
Mr Pay Shent: mucks hand 
BorIska1993 collected 63376 from pot
*** SUMMARY ***
Total pot 63376 | Rake 0 
Board [6c Jd 5s 7s 5d]
Seat 1: rabwallace1993 folded before Flop (didn't bet)
Seat 2: Mr Pay Shent mucked
Seat 3: Pseudo Fruto folded before Flop (didn't bet)
Seat 4: RenanToniolo folded before Flop (didn't bet)
Seat 5: mv14 (button) folded before Flop (didn't bet)
Seat 6: sunn¥m4nn (small blind) folded before Flop
Seat 8: BorIska1993 (big blind) showed [Ad 7d] and won (63376) with two pair, Sevens and Fives

PokerStars Hand #251206607239: Tournament #3767885527, $40+$10+$5 USD Hold'em No Limit - Level XVII (1750/3500) - 2024/06/26 20:09:04 UTC [2024/06/26 16:09:04 ET]
Table '3767885527 92' 8-max Seat #6 is the button
Seat 1: rabwallace1993 (159980 in chips) 
Seat 2: Mr Pay Shent (70641 in chips) 
Seat 3: Pseudo Fruto (293802 in chips) 
Seat 4: RenanToniolo (113909 in chips) 
Seat 5: mv14 (27174 in chips) 
Seat 6: sunn¥m4nn (139450 in chips) 
Seat 7: esdeathonlol (28675 in chips) out of hand (moved from another table into small blind)
Seat 8: BorIska1993 (128074 in chips) 
esdeathonlol will be allowed to play after the button
rabwallace1993: posts the ante 450
Mr Pay Shent: posts the ante 450
Pseudo Fruto: posts the ante 450
RenanToniolo: posts the ante 450
mv14: posts the ante 450
sunn¥m4nn: posts the ante 450
BorIska1993: posts the ante 450
BorIska1993: posts small blind 1750
rabwallace1993: posts big blind 3500
*** HOLE CARDS ***
Mr Pay Shent: folds 
Pseudo Fruto: folds 
RenanToniolo: folds 
mv14: folds 
sunn¥m4nn: raises 3500 to 7000
BorIska1993: folds 
rabwallace1993: folds 
Uncalled bet (3500) returned to sunn¥m4nn
sunn¥m4nn collected 11900 from pot
sunn¥m4nn: doesn't show hand 
*** SUMMARY ***
Total pot 11900 | Rake 0 
Seat 1: rabwallace1993 (big blind) folded before Flop
Seat 2: Mr Pay Shent folded before Flop (didn't bet)
Seat 3: Pseudo Fruto folded before Flop (didn't bet)
Seat 4: RenanToniolo folded before Flop (didn't bet)
Seat 5: mv14 folded before Flop (didn't bet)
Seat 6: sunn¥m4nn (button) collected (11900)
Seat 8: BorIska1993 (small blind) folded before Flop

PokerStars Hand #251206618581: Tournament #3767885527, $40+$10+$5 USD Hold'em No Limit - Level XVII (1750/3500) - 2024/06/26 20:09:44 UTC [2024/06/26 16:09:44 ET]
Table '3767885527 92' 8-max Seat #8 is the button
Seat 1: rabwallace1993 (156030 in chips) 
Seat 2: Mr Pay Shent (70191 in chips) 
Seat 3: Pseudo Fruto (293352 in chips) 
Seat 4: RenanToniolo (113459 in chips) 
Seat 5: mv14 (26724 in chips) 
Seat 6: sunn¥m4nn (147400 in chips) 
Seat 7: esdeathonlol (28675 in chips) 
Seat 8: BorIska1993 (125874 in chips) 
rabwallace1993: posts the ante 450
Mr Pay Shent: posts the ante 450
Pseudo Fruto: posts the ante 450
RenanToniolo: posts the ante 450
mv14: posts the ante 450
sunn¥m4nn: posts the ante 450
esdeathonlol: posts the ante 450
BorIska1993: posts the ante 450
rabwallace1993: posts small blind 1750
Mr Pay Shent: posts big blind 3500
*** HOLE CARDS ***
Pseudo Fruto: folds 
RenanToniolo: folds 
mv14: folds 
sunn¥m4nn: folds 
esdeathonlol: folds 
BorIska1993: raises 3500 to 7000
rabwallace1993: calls 5250
Mr Pay Shent: calls 3500
*** FLOP *** [2h 6c 6h]
rabwallace1993: checks 
Mr Pay Shent: checks 
BorIska1993: bets 7350
rabwallace1993: calls 7350
Mr Pay Shent: folds 
*** TURN *** [2h 6c 6h] [Ts]
rabwallace1993: checks 
BorIska1993: checks 
*** RIVER *** [2h 6c 6h Ts] [8s]
rabwallace1993: checks 
BorIska1993: checks 
*** SHOW DOWN ***
rabwallace1993: shows [3s As] (a pair of Sixes)
BorIska1993: shows [7s 7h] (two pair, Sevens and Sixes)
BorIska1993 collected 39300 from pot
*** SUMMARY ***
Total pot 39300 | Rake 0 
Board [2h 6c 6h Ts 8s]
Seat 1: rabwallace1993 (small blind) showed [3s As] and lost with a pair of Sixes
Seat 2: Mr Pay Shent (big blind) folded on the Flop
Seat 3: Pseudo Fruto folded before Flop (didn't bet)
Seat 4: RenanToniolo folded before Flop (didn't bet)
Seat 5: mv14 folded before Flop (didn't bet)
Seat 6: sunn¥m4nn folded before Flop (didn't bet)
Seat 7: esdeathonlol folded before Flop (didn't bet)
Seat 8: BorIska1993 (button) showed [7s 7h] and won (39300) with two pair, Sevens and Sixes

PokerStars Hand #251206643533: Tournament #3767885527, $40+$10+$5 USD Hold'em No Limit - Level XVII (1750/3500) - 2024/06/26 20:11:11 UTC [2024/06/26 16:11:11 ET]
Table '3767885527 92' 8-max Seat #1 is the button
Seat 1: rabwallace1993 (141230 in chips) 
Seat 2: Mr Pay Shent (62741 in chips) 
Seat 3: Pseudo Fruto (292902 in chips) 
Seat 4: RenanToniolo (113009 in chips) 
Seat 5: mv14 (26274 in chips) 
Seat 6: sunn¥m4nn (146950 in chips) 
Seat 7: esdeathonlol (28225 in chips) 
Seat 8: BorIska1993 (150374 in chips) 
rabwallace1993: posts the ante 450
Mr Pay Shent: posts the ante 450
Pseudo Fruto: posts the ante 450
RenanToniolo: posts the ante 450
mv14: posts the ante 450
sunn¥m4nn: posts the ante 450
esdeathonlol: posts the ante 450
BorIska1993: posts the ante 450
Mr Pay Shent: posts small blind 1750
Pseudo Fruto: posts big blind 3500
*** HOLE CARDS ***
RenanToniolo: folds 
mv14: folds 
sunn¥m4nn: folds 
esdeathonlol: folds 
BorIska1993: folds 
rabwallace1993: folds 
Mr Pay Shent: folds 
Uncalled bet (1750) returned to Pseudo Fruto
Pseudo Fruto collected 7100 from pot
Pseudo Fruto: doesn't show hand 
*** SUMMARY ***
Total pot 7100 | Rake 0 
Seat 1: rabwallace1993 (button) folded before Flop (didn't bet)
Seat 2: Mr Pay Shent (small blind) folded before Flop
Seat 3: Pseudo Fruto (big blind) collected (7100)
Seat 4: RenanToniolo folded before Flop (didn't bet)
Seat 5: mv14 folded before Flop (didn't bet)
Seat 6: sunn¥m4nn folded before Flop (didn't bet)
Seat 7: esdeathonlol folded before Flop (didn't bet)
Seat 8: BorIska1993 folded before Flop (didn't bet)

PokerStars Hand #251206648845: Tournament #3767885527, $40+$10+$5 USD Hold'em No Limit - Level XVII (1750/3500) - 2024/06/26 20:11:30 UTC [2024/06/26 16:11:30 ET]
Table '3767885527 92' 8-max Seat #2 is the button
Seat 1: rabwallace1993 (140780 in chips) 
Seat 2: Mr Pay Shent (60541 in chips) 
Seat 3: Pseudo Fruto (297802 in chips) 
Seat 4: RenanToniolo (112559 in chips) 
Seat 5: mv14 (25824 in chips) 
Seat 6: sunn¥m4nn (146500 in chips) 
Seat 7: esdeathonlol (27775 in chips) 
Seat 8: BorIska1993 (149924 in chips) 
rabwallace1993: posts the ante 450
Mr Pay Shent: posts the ante 450
Pseudo Fruto: posts the ante 450
RenanToniolo: posts the ante 450
mv14: posts the ante 450
sunn¥m4nn: posts the ante 450
esdeathonlol: posts the ante 450
BorIska1993: posts the ante 450
Pseudo Fruto: posts small blind 1750
RenanToniolo: posts big blind 3500
*** HOLE CARDS ***
mv14: folds 
sunn¥m4nn: folds 
esdeathonlol: folds 
BorIska1993: folds 
rabwallace1993: folds 
Mr Pay Shent: raises 56591 to 60091 and is all-in
Pseudo Fruto: raises 56591 to 116682
RenanToniolo: folds 
Uncalled bet (56591) returned to Pseudo Fruto
*** FLOP *** [Kh 6h 7h]
*** TURN *** [Kh 6h 7h] [3c]
*** RIVER *** [Kh 6h 7h 3c] [Qh]
*** SHOW DOWN ***
Pseudo Fruto: shows [As Kc] (a pair of Kings)
Mr Pay Shent: shows [2d Ac] (high card Ace)
Pseudo Fruto collected 127282 from pot
Mr Pay Shent finished the tournament in 377th place
*** SUMMARY ***
Total pot 127282 | Rake 0 
Board [Kh 6h 7h 3c Qh]
Seat 1: rabwallace1993 folded before Flop (didn't bet)
Seat 2: Mr Pay Shent (button) showed [2d Ac] and lost with high card Ace
Seat 3: Pseudo Fruto (small blind) showed [As Kc] and won (127282) with a pair of Kings
Seat 4: RenanToniolo (big blind) folded before Flop
Seat 5: mv14 folded before Flop (didn't bet)
Seat 6: sunn¥m4nn folded before Flop (didn't bet)
Seat 7: esdeathonlol folded before Flop (didn't bet)
Seat 8: BorIska1993 folded before Flop (didn't bet)


PokerStars Hand #251206987410: Tournament #3767885527, $40+$10+$5 USD Hold'em No Limit - Level XIX (2500/5000) - 2024/06/26 20:31:39 UTC [2024/06/26 16:31:39 ET]
Table '3767885527 63' 8-max Seat #5 is the button
Seat 1: T3RSS1 (51554 in chips) 
Seat 2: Giginis (280251 in chips) 
Seat 3: Antanavinis (74238 in chips) 
Seat 4: BorIska1993 (132514 in chips) 
Seat 5: haitzi1 (30414 in chips) 
Seat 6: Varle84 (86978 in chips) 
Seat 7: RRoleto (39827 in chips) 
Seat 8: Snoopy95_2.0 (135824 in chips) 
T3RSS1: posts the ante 625
Giginis: posts the ante 625
Antanavinis: posts the ante 625
BorIska1993: posts the ante 625
haitzi1: posts the ante 625
Varle84: posts the ante 625
RRoleto: posts the ante 625
Snoopy95_2.0: posts the ante 625
Varle84: posts small blind 2500
RRoleto: posts big blind 5000
*** HOLE CARDS ***
Snoopy95_2.0: folds 
T3RSS1: folds 
Giginis: folds 
Antanavinis: folds 
BorIska1993: folds 
haitzi1: folds 
Varle84: raises 81353 to 86353 and is all-in
RRoleto: folds 
Uncalled bet (81353) returned to Varle84
Varle84 collected 15000 from pot
*** SUMMARY ***
Total pot 15000 | Rake 0 
Seat 1: T3RSS1 folded before Flop (didn't bet)
Seat 2: Giginis folded before Flop (didn't bet)
Seat 3: Antanavinis folded before Flop (didn't bet)
Seat 4: BorIska1993 folded before Flop (didn't bet)
Seat 5: haitzi1 (button) folded before Flop (didn't bet)
Seat 6: Varle84 (small blind) collected (15000)
Seat 7: RRoleto (big blind) folded before Flop
Seat 8: Snoopy95_2.0 folded before Flop (didn't bet)

PokerStars Hand #251206997044: Tournament #3767885527, $40+$10+$5 USD Hold'em No Limit - Level XIX (2500/5000) - 2024/06/26 20:32:13 UTC [2024/06/26 16:32:13 ET]
Table '3767885527 63' 8-max Seat #6 is the button
Seat 1: T3RSS1 (50929 in chips) 
Seat 2: Giginis (279626 in chips) 
Seat 3: Antanavinis (73613 in chips) 
Seat 4: BorIska1993 (131889 in chips) 
Seat 5: haitzi1 (29789 in chips) 
Seat 6: Varle84 (96353 in chips) 
Seat 7: RRoleto (34202 in chips) 
Seat 8: Snoopy95_2.0 (135199 in chips) 
T3RSS1: posts the ante 625
Giginis: posts the ante 625
Antanavinis: posts the ante 625
BorIska1993: posts the ante 625
haitzi1: posts the ante 625
Varle84: posts the ante 625
RRoleto: posts the ante 625
Snoopy95_2.0: posts the ante 625
RRoleto: posts small blind 2500
Snoopy95_2.0: posts big blind 5000
*** HOLE CARDS ***
T3RSS1: folds 
Giginis: raises 5000 to 10000
Antanavinis: raises 62500 to 72500
BorIska1993: folds 
haitzi1: folds 
Varle84: folds 
RRoleto: folds 
Snoopy95_2.0: folds 
Giginis: folds 
Uncalled bet (62500) returned to Antanavinis
Antanavinis collected 32500 from pot
Antanavinis: doesn't show hand 
*** SUMMARY ***
Total pot 32500 | Rake 0 
Seat 1: T3RSS1 folded before Flop (didn't bet)
Seat 2: Giginis folded before Flop
Seat 3: Antanavinis collected (32500)
Seat 4: BorIska1993 folded before Flop (didn't bet)
Seat 5: haitzi1 folded before Flop (didn't bet)
Seat 6: Varle84 (button) folded before Flop (didn't bet)
Seat 7: RRoleto (small blind) folded before Flop
Seat 8: Snoopy95_2.0 (big blind) folded before Flop

PokerStars Hand #251207031980: Tournament #3767885527, $40+$10+$5 USD Hold'em No Limit - Level XIX (2500/5000) - 2024/06/26 20:34:17 UTC [2024/06/26 16:34:17 ET]
Table '3767885527 63' 8-max Seat #7 is the button
Seat 1: T3RSS1 (50304 in chips) 
Seat 2: Giginis (269001 in chips) 
Seat 3: Antanavinis (95488 in chips) 
Seat 4: BorIska1993 (131264 in chips) 
Seat 5: haitzi1 (29164 in chips) 
Seat 6: Varle84 (95728 in chips) 
Seat 7: RRoleto (31077 in chips) 
Seat 8: Snoopy95_2.0 (129574 in chips) 
T3RSS1: posts the ante 625
Giginis: posts the ante 625
Antanavinis: posts the ante 625
BorIska1993: posts the ante 625
haitzi1: posts the ante 625
Varle84: posts the ante 625
RRoleto: posts the ante 625
Snoopy95_2.0: posts the ante 625
Snoopy95_2.0: posts small blind 2500
T3RSS1: posts big blind 5000
*** HOLE CARDS ***
Giginis: folds 
Antanavinis: folds 
BorIska1993: folds 
haitzi1: folds 
Varle84: folds 
RRoleto: folds 
Snoopy95_2.0: raises 123949 to 128949 and is all-in
T3RSS1: folds 
Uncalled bet (123949) returned to Snoopy95_2.0
Snoopy95_2.0 collected 15000 from pot
Snoopy95_2.0: doesn't show hand 
*** SUMMARY ***
Total pot 15000 | Rake 0 
Seat 1: T3RSS1 (big blind) folded before Flop
Seat 2: Giginis folded before Flop (didn't bet)
Seat 3: Antanavinis folded before Flop (didn't bet)
Seat 4: BorIska1993 folded before Flop (didn't bet)
Seat 5: haitzi1 folded before Flop (didn't bet)
Seat 6: Varle84 folded before Flop (didn't bet)
Seat 7: RRoleto (button) folded before Flop (didn't bet)
Seat 8: Snoopy95_2.0 (small blind) collected (15000)

PokerStars Hand #251207041341: Tournament #3767885527, $40+$10+$5 USD Hold'em No Limit - Level XIX (2500/5000) - 2024/06/26 20:34:50 UTC [2024/06/26 16:34:50 ET]
Table '3767885527 63' 8-max Seat #8 is the button
Seat 1: T3RSS1 (44679 in chips) 
Seat 2: Giginis (268376 in chips) 
Seat 3: Antanavinis (94863 in chips) 
Seat 4: BorIska1993 (130639 in chips) 
Seat 5: haitzi1 (28539 in chips) 
Seat 6: Varle84 (95103 in chips) 
Seat 7: RRoleto (30452 in chips) 
Seat 8: Snoopy95_2.0 (138949 in chips) 
T3RSS1: posts the ante 625
Giginis: posts the ante 625
Antanavinis: posts the ante 625
BorIska1993: posts the ante 625
haitzi1: posts the ante 625
Varle84: posts the ante 625
RRoleto: posts the ante 625
Snoopy95_2.0: posts the ante 625
T3RSS1: posts small blind 2500
Giginis: posts big blind 5000
*** HOLE CARDS ***
Antanavinis: folds 
BorIska1993: folds 
haitzi1: folds 
Varle84: folds 
RRoleto: folds 
Snoopy95_2.0: calls 5000
T3RSS1: folds 
Giginis: raises 18000 to 23000
Snoopy95_2.0: folds 
Uncalled bet (18000) returned to Giginis
Giginis collected 17500 from pot
*** SUMMARY ***
Total pot 17500 | Rake 0 
Seat 1: T3RSS1 (small blind) folded before Flop
Seat 2: Giginis (big blind) collected (17500)
Seat 3: Antanavinis folded before Flop (didn't bet)
Seat 4: BorIska1993 folded before Flop (didn't bet)
Seat 5: haitzi1 folded before Flop (didn't bet)
Seat 6: Varle84 folded before Flop (didn't bet)
Seat 7: RRoleto folded before Flop (didn't bet)
Seat 8: Snoopy95_2.0 (button) folded before Flop

PokerStars Hand #251207053943: Tournament #3767885527, $40+$10+$5 USD Hold'em No Limit - Level XIX (2500/5000) - 2024/06/26 20:35:34 UTC [2024/06/26 16:35:34 ET]
Table '3767885527 63' 8-max Seat #1 is the button
Seat 1: T3RSS1 (41554 in chips) 
Seat 2: Giginis (280251 in chips) 
Seat 3: Antanavinis (94238 in chips) 
Seat 4: BorIska1993 (130014 in chips) 
Seat 5: haitzi1 (27914 in chips) 
Seat 6: Varle84 (94478 in chips) 
Seat 7: RRoleto (29827 in chips) 
Seat 8: Snoopy95_2.0 (133324 in chips) 
T3RSS1: posts the ante 625
Giginis: posts the ante 625
Antanavinis: posts the ante 625
BorIska1993: posts the ante 625
haitzi1: posts the ante 625
Varle84: posts the ante 625
RRoleto: posts the ante 625
Snoopy95_2.0: posts the ante 625
Giginis: posts small blind 2500
Antanavinis: posts big blind 5000
*** HOLE CARDS ***
BorIska1993: folds 
haitzi1: raises 22289 to 27289 and is all-in
Varle84: folds 
RRoleto: folds 
Snoopy95_2.0: folds 
T3RSS1: folds 
Giginis: folds 
Antanavinis: folds 
Uncalled bet (22289) returned to haitzi1
haitzi1 collected 17500 from pot
*** SUMMARY ***
Total pot 17500 | Rake 0 
Seat 1: T3RSS1 (button) folded before Flop (didn't bet)
Seat 2: Giginis (small blind) folded before Flop
Seat 3: Antanavinis (big blind) folded before Flop
Seat 4: BorIska1993 folded before Flop (didn't bet)
Seat 5: haitzi1 collected (17500)
Seat 6: Varle84 folded before Flop (didn't bet)
Seat 7: RRoleto folded before Flop (didn't bet)
Seat 8: Snoopy95_2.0 folded before Flop (didn't bet)

PokerStars Hand #251207061403: Tournament #3767885527, $40+$10+$5 USD Hold'em No Limit - Level XX (3000/6000) - 2024/06/26 20:36:01 UTC [2024/06/26 16:36:01 ET]
Table '3767885527 63' 8-max Seat #2 is the button
Seat 1: T3RSS1 (40929 in chips) 
Seat 2: Giginis (277126 in chips) 
Seat 3: Antanavinis (88613 in chips) 
Seat 4: BorIska1993 (129389 in chips) 
Seat 5: haitzi1 (39789 in chips) 
Seat 6: Varle84 (93853 in chips) 
Seat 7: RRoleto (29202 in chips) 
Seat 8: Snoopy95_2.0 (132699 in chips) 
T3RSS1: posts the ante 750
Giginis: posts the ante 750
Antanavinis: posts the ante 750
BorIska1993: posts the ante 750
haitzi1: posts the ante 750
Varle84: posts the ante 750
RRoleto: posts the ante 750
Snoopy95_2.0: posts the ante 750
Antanavinis: posts small blind 3000
BorIska1993: posts big blind 6000
*** HOLE CARDS ***
haitzi1: folds 
Varle84: folds 
RRoleto: folds 
Snoopy95_2.0: folds 
T3RSS1: folds 
Giginis: folds 
Antanavinis: calls 3000
BorIska1993: checks 
*** FLOP *** [Td 6s Tc]
Antanavinis: checks 
BorIska1993: checks 
*** TURN *** [Td 6s Tc] [Th]
Antanavinis: bets 13500
BorIska1993: folds 
Uncalled bet (13500) returned to Antanavinis
Antanavinis collected 18000 from pot
Antanavinis: doesn't show hand 
*** SUMMARY ***
Total pot 18000 | Rake 0 
Board [Td 6s Tc Th]
Seat 1: T3RSS1 folded before Flop (didn't bet)
Seat 2: Giginis (button) folded before Flop (didn't bet)
Seat 3: Antanavinis (small blind) collected (18000)
Seat 4: BorIska1993 (big blind) folded on the Turn
Seat 5: haitzi1 folded before Flop (didn't bet)
Seat 6: Varle84 folded before Flop (didn't bet)
Seat 7: RRoleto folded before Flop (didn't bet)
Seat 8: Snoopy95_2.0 folded before Flop (didn't bet)

PokerStars Hand #251207075694: Tournament #3767885527, $40+$10+$5 USD Hold'em No Limit - Level XX (3000/6000) - 2024/06/26 20:36:51 UTC [2024/06/26 16:36:51 ET]
Table '3767885527 63' 8-max Seat #3 is the button
Seat 1: T3RSS1 (40179 in chips) 
Seat 2: Giginis (276376 in chips) 
Seat 3: Antanavinis (99863 in chips) 
Seat 4: BorIska1993 (122639 in chips) 
Seat 5: haitzi1 (39039 in chips) 
Seat 6: Varle84 (93103 in chips) 
Seat 7: RRoleto (28452 in chips) 
Seat 8: Snoopy95_2.0 (131949 in chips) 
T3RSS1: posts the ante 750
Giginis: posts the ante 750
Antanavinis: posts the ante 750
BorIska1993: posts the ante 750
haitzi1: posts the ante 750
Varle84: posts the ante 750
RRoleto: posts the ante 750
Snoopy95_2.0: posts the ante 750
BorIska1993: posts small blind 3000
haitzi1: posts big blind 6000
*** HOLE CARDS ***
Varle84: folds 
RRoleto: folds 
Snoopy95_2.0: calls 6000
T3RSS1: folds 
Giginis: folds 
Antanavinis: folds 
BorIska1993: calls 3000
haitzi1: checks 
*** FLOP *** [Ad 6h 3h]
BorIska1993: checks 
haitzi1: checks 
Snoopy95_2.0: bets 6000
BorIska1993: folds 
haitzi1: folds 
Uncalled bet (6000) returned to Snoopy95_2.0
Snoopy95_2.0 collected 24000 from pot
Snoopy95_2.0: doesn't show hand 
*** SUMMARY ***
Total pot 24000 | Rake 0 
Board [Ad 6h 3h]
Seat 1: T3RSS1 folded before Flop (didn't bet)
Seat 2: Giginis folded before Flop (didn't bet)
Seat 3: Antanavinis (button) folded before Flop (didn't bet)
Seat 4: BorIska1993 (small blind) folded on the Flop
Seat 5: haitzi1 (big blind) folded on the Flop
Seat 6: Varle84 folded before Flop (didn't bet)
Seat 7: RRoleto folded before Flop (didn't bet)
Seat 8: Snoopy95_2.0 collected (24000)

PokerStars Hand #251207085336: Tournament #3767885527, $40+$10+$5 USD Hold'em No Limit - Level XX (3000/6000) - 2024/06/26 20:37:25 UTC [2024/06/26 16:37:25 ET]
Table '3767885527 63' 8-max Seat #4 is the button
Seat 1: T3RSS1 (39429 in chips) 
Seat 2: Giginis (275626 in chips) 
Seat 3: Antanavinis (99113 in chips) 
Seat 4: BorIska1993 (115889 in chips) 
Seat 5: haitzi1 (32289 in chips) 
Seat 6: Varle84 (92353 in chips) 
Seat 7: RRoleto (27702 in chips) 
Seat 8: Snoopy95_2.0 (149199 in chips) 
T3RSS1: posts the ante 750
Giginis: posts the ante 750
Antanavinis: posts the ante 750
BorIska1993: posts the ante 750
haitzi1: posts the ante 750
Varle84: posts the ante 750
RRoleto: posts the ante 750
Snoopy95_2.0: posts the ante 750
haitzi1: posts small blind 3000
Varle84: posts big blind 6000
*** HOLE CARDS ***
RRoleto: folds 
Snoopy95_2.0: folds 
T3RSS1: folds 
Giginis: folds 
Antanavinis: folds 
BorIska1993: raises 6000 to 12000
haitzi1: folds 
Varle84: raises 79603 to 91603 and is all-in
BorIska1993: folds 
Uncalled bet (79603) returned to Varle84
Varle84 collected 33000 from pot
*** SUMMARY ***
Total pot 33000 | Rake 0 
Seat 1: T3RSS1 folded before Flop (didn't bet)
Seat 2: Giginis folded before Flop (didn't bet)
Seat 3: Antanavinis folded before Flop (didn't bet)
Seat 4: BorIska1993 (button) folded before Flop
Seat 5: haitzi1 (small blind) folded before Flop
Seat 6: Varle84 (big blind) collected (33000)
Seat 7: RRoleto folded before Flop (didn't bet)
Seat 8: Snoopy95_2.0 folded before Flop (didn't bet)

PokerStars Hand #251207100786: Tournament #3767885527, $40+$10+$5 USD Hold'em No Limit - Level XX (3000/6000) - 2024/06/26 20:38:20 UTC [2024/06/26 16:38:20 ET]
Table '3767885527 63' 8-max Seat #5 is the button
Seat 1: T3RSS1 (38679 in chips) 
Seat 2: Giginis (274876 in chips) 
Seat 3: Antanavinis (98363 in chips) 
Seat 4: BorIska1993 (103139 in chips) 
Seat 5: haitzi1 (28539 in chips) 
Seat 6: Varle84 (112603 in chips) 
Seat 7: RRoleto (26952 in chips) 
Seat 8: Snoopy95_2.0 (148449 in chips) 
T3RSS1: posts the ante 750
Giginis: posts the ante 750
Antanavinis: posts the ante 750
BorIska1993: posts the ante 750
haitzi1: posts the ante 750
Varle84: posts the ante 750
RRoleto: posts the ante 750
Snoopy95_2.0: posts the ante 750
Varle84: posts small blind 3000
RRoleto: posts big blind 6000
*** HOLE CARDS ***
Snoopy95_2.0: calls 6000
T3RSS1: raises 31929 to 37929 and is all-in
Giginis: folds 
Antanavinis: folds 
BorIska1993: folds 
haitzi1: folds 
Varle84: folds 
RRoleto: calls 20202 and is all-in
Snoopy95_2.0: calls 31929
*** FLOP *** [2s Ts 9d]
*** TURN *** [2s Ts 9d] [Ah]
*** RIVER *** [2s Ts 9d Ah] [9h]
*** SHOW DOWN ***
Snoopy95_2.0: shows [Tc Jc] (two pair, Tens and Nines)
T3RSS1: shows [Ad Qs] (two pair, Aces and Nines)
T3RSS1 collected 23454 from side pot
RRoleto: shows [2c As] (two pair, Aces and Nines - lower kicker)
T3RSS1 collected 87606 from main pot
RRoleto finished the tournament in 263rd place and received $104.64.
*** SUMMARY ***
Total pot 111060 Main pot 87606. Side pot 23454. | Rake 0 
Board [2s Ts 9d Ah 9h]
Seat 1: T3RSS1 showed [Ad Qs] and won (111060) with two pair, Aces and Nines
Seat 2: Giginis folded before Flop (didn't bet)
Seat 3: Antanavinis folded before Flop (didn't bet)
Seat 4: BorIska1993 folded before Flop (didn't bet)
Seat 5: haitzi1 (button) folded before Flop (didn't bet)
Seat 6: Varle84 (small blind) folded before Flop
Seat 7: RRoleto (big blind) showed [2c As] and lost with two pair, Aces and Nines
Seat 8: Snoopy95_2.0 showed [Tc Jc] and lost with two pair, Tens and Nines

PokerStars Hand #251207113713: Tournament #3767885527, $40+$10+$5 USD Hold'em No Limit - Level XX (3000/6000) - 2024/06/26 20:39:05 UTC [2024/06/26 16:39:05 ET]
Table '3767885527 63' 8-max Seat #6 is the button
Seat 1: T3RSS1 (111060 in chips) 
Seat 2: Giginis (274126 in chips) 
Seat 3: Antanavinis (97613 in chips) 
Seat 4: BorIska1993 (102389 in chips) 
Seat 5: haitzi1 (27789 in chips) 
Seat 6: Varle84 (108853 in chips) 
Seat 8: Snoopy95_2.0 (109770 in chips) 
T3RSS1: posts the ante 750
Giginis: posts the ante 750
Antanavinis: posts the ante 750
BorIska1993: posts the ante 750
haitzi1: posts the ante 750
Varle84: posts the ante 750
Snoopy95_2.0: posts the ante 750
Snoopy95_2.0: posts small blind 3000
T3RSS1: posts big blind 6000
*** HOLE CARDS ***
Giginis: folds 
Antanavinis: folds 
BorIska1993: folds 
VICTOR TXR1 is disconnected 
haitzi1: folds 
Varle84: raises 6000 to 12000
Snoopy95_2.0: calls 9000
T3RSS1: calls 6000
*** FLOP *** [Js 4c 3h]
Snoopy95_2.0: checks 
T3RSS1: checks 
Varle84: bets 12780
Snoopy95_2.0: folds 
T3RSS1: raises 85530 to 98310 and is all-in
Varle84: folds 
Uncalled bet (85530) returned to T3RSS1
T3RSS1 collected 66810 from pot
*** SUMMARY ***
Total pot 66810 | Rake 0 
Board [Js 4c 3h]
Seat 1: T3RSS1 (big blind) collected (66810)
Seat 2: Giginis folded before Flop (didn't bet)
Seat 3: Antanavinis folded before Flop (didn't bet)
Seat 4: BorIska1993 folded before Flop (didn't bet)
Seat 5: haitzi1 folded before Flop (didn't bet)
Seat 6: Varle84 (button) folded on the Flop
Seat 8: Snoopy95_2.0 (small blind) folded on the Flop

PokerStars Hand #251207136075: Tournament #3767885527, $40+$10+$5 USD Hold'em No Limit - Level XX (3000/6000) - 2024/06/26 20:40:25 UTC [2024/06/26 16:40:25 ET]
Table '3767885527 63' 8-max Seat #8 is the button
Seat 1: T3RSS1 (152340 in chips) 
Seat 2: Giginis (273376 in chips) 
Seat 3: Antanavinis (96863 in chips) 
Seat 4: BorIska1993 (101639 in chips) 
Seat 5: haitzi1 (27039 in chips) 
Seat 6: Varle84 (83323 in chips) 
Seat 7: VICTOR TXR1 (122957 in chips) 
Seat 8: Snoopy95_2.0 (97020 in chips) 
T3RSS1: posts the ante 750
Giginis: posts the ante 750
Antanavinis: posts the ante 750
BorIska1993: posts the ante 750
haitzi1: posts the ante 750
Varle84: posts the ante 750
VICTOR TXR1: posts the ante 750
Snoopy95_2.0: posts the ante 750
T3RSS1: posts small blind 3000
Giginis: posts big blind 6000
*** HOLE CARDS ***
Antanavinis: raises 6000 to 12000
BorIska1993: folds 
haitzi1: folds 
Varle84: folds 
VICTOR TXR1: folds 
Snoopy95_2.0: folds 
T3RSS1: folds 
Giginis: calls 6000
*** FLOP *** [7s 6s Qc]
Giginis: checks 
Antanavinis: bets 10890
Giginis: calls 10890
*** TURN *** [7s 6s Qc] [9h]
Giginis: checks 
Antanavinis: bets 25080
Giginis: raises 64920 to 90000
Antanavinis: calls 48143 and is all-in
Uncalled bet (16777) returned to Giginis
*** RIVER *** [7s 6s Qc 9h] [8s]
*** SHOW DOWN ***
Giginis: shows [6h 9s] (two pair, Nines and Sixes)
Antanavinis: shows [Ks Kc] (a pair of Kings)
Giginis collected 201226 from pot
Antanavinis finished the tournament in 240th place and received $115.10.
*** SUMMARY ***
Total pot 201226 | Rake 0 
Board [7s 6s Qc 9h 8s]
Seat 1: T3RSS1 (small blind) folded before Flop
Seat 2: Giginis (big blind) showed [6h 9s] and won (201226) with two pair, Nines and Sixes
Seat 3: Antanavinis showed [Ks Kc] and lost with a pair of Kings
Seat 4: BorIska1993 folded before Flop (didn't bet)
Seat 5: haitzi1 folded before Flop (didn't bet)
Seat 6: Varle84 folded before Flop (didn't bet)
Seat 7: VICTOR TXR1 folded before Flop (didn't bet)
Seat 8: Snoopy95_2.0 (button) folded before Flop (didn't bet)

PokerStars Hand #251207156206: Tournament #3767885527, $40+$10+$5 USD Hold'em No Limit - Level XX (3000/6000) - 2024/06/26 20:41:37 UTC [2024/06/26 16:41:37 ET]
Table '3767885527 63' 8-max Seat #1 is the button
Seat 1: T3RSS1 (148590 in chips) 
Seat 2: Giginis (377739 in chips) 
Seat 4: BorIska1993 (100889 in chips) 
Seat 5: haitzi1 (26289 in chips) 
Seat 6: Varle84 (82573 in chips) 
Seat 7: VICTOR TXR1 (122207 in chips) 
Seat 8: Snoopy95_2.0 (96270 in chips) 
T3RSS1: posts the ante 750
Giginis: posts the ante 750
BorIska1993: posts the ante 750
haitzi1: posts the ante 750
Varle84: posts the ante 750
VICTOR TXR1: posts the ante 750
Snoopy95_2.0: posts the ante 750
Giginis: posts small blind 3000
BorIska1993: posts big blind 6000
*** HOLE CARDS ***
haitzi1: folds 
Varle84: folds 
VICTOR TXR1: raises 6960 to 12960
Snoopy95_2.0: folds 
T3RSS1: folds 
Giginis: folds 
BorIska1993: raises 87179 to 100139 and is all-in
VICTOR TXR1: folds 
Uncalled bet (87179) returned to BorIska1993
BorIska1993 collected 34170 from pot
BorIska1993: doesn't show hand 
*** SUMMARY ***
Total pot 34170 | Rake 0 
Seat 1: T3RSS1 (button) folded before Flop (didn't bet)
Seat 2: Giginis (small blind) folded before Flop
Seat 4: BorIska1993 (big blind) collected (34170)
Seat 5: haitzi1 folded before Flop (didn't bet)
Seat 6: Varle84 folded before Flop (didn't bet)
Seat 7: VICTOR TXR1 folded before Flop
Seat 8: Snoopy95_2.0 folded before Flop (didn't bet)

PokerStars Hand #251207163344: Tournament #3767885527, $40+$10+$5 USD Hold'em No Limit - Level XX (3000/6000) - 2024/06/26 20:42:03 UTC [2024/06/26 16:42:03 ET]
Table '3767885527 63' 8-max Seat #2 is the button
Seat 1: T3RSS1 (147840 in chips) 
Seat 2: Giginis (373989 in chips) 
Seat 4: BorIska1993 (121349 in chips) 
Seat 5: haitzi1 (25539 in chips) 
Seat 6: Varle84 (81823 in chips) 
Seat 7: VICTOR TXR1 (108497 in chips) 
Seat 8: Snoopy95_2.0 (95520 in chips) 
T3RSS1: posts the ante 750
Giginis: posts the ante 750
BorIska1993: posts the ante 750
haitzi1: posts the ante 750
Varle84: posts the ante 750
VICTOR TXR1: posts the ante 750
Snoopy95_2.0: posts the ante 750
BorIska1993: posts small blind 3000
haitzi1: posts big blind 6000
*** HOLE CARDS ***
Varle84: raises 75073 to 81073 and is all-in
VICTOR TXR1: folds 
Snoopy95_2.0: folds 
T3RSS1: folds 
Giginis: folds 
BorIska1993: raises 39526 to 120599 and is all-in
haitzi1: folds 
Uncalled bet (39526) returned to BorIska1993
*** FLOP *** [3s 2s Kc]
*** TURN *** [3s 2s Kc] [4s]
*** RIVER *** [3s 2s Kc 4s] [5s]
*** SHOW DOWN ***
BorIska1993: shows [Tc Ah] (a straight, Ace to Five)
Varle84: shows [Jc Ac] (a straight, Ace to Five)
BorIska1993 collected 86698 from pot
Varle84 collected 86698 from pot
*** SUMMARY ***
Total pot 173396 | Rake 0 
Board [3s 2s Kc 4s 5s]
Seat 1: T3RSS1 folded before Flop (didn't bet)
Seat 2: Giginis (button) folded before Flop (didn't bet)
Seat 4: BorIska1993 (small blind) showed [Tc Ah] and won (86698) with a straight, Ace to Five
Seat 5: haitzi1 (big blind) folded before Flop
Seat 6: Varle84 showed [Jc Ac] and won (86698) with a straight, Ace to Five
Seat 7: VICTOR TXR1 folded before Flop (didn't bet)
Seat 8: Snoopy95_2.0 folded before Flop (didn't bet)

PokerStars Hand #251207172961: Tournament #3767885527, $40+$10+$5 USD Hold'em No Limit - Level XX (3000/6000) - 2024/06/26 20:42:38 UTC [2024/06/26 16:42:38 ET]
Table '3767885527 63' 8-max Seat #4 is the button
Seat 1: T3RSS1 (147090 in chips) 
Seat 2: Giginis (373239 in chips) 
Seat 4: BorIska1993 (126224 in chips) 
Seat 5: haitzi1 (18789 in chips) 
Seat 6: Varle84 (86698 in chips) 
Seat 7: VICTOR TXR1 (107747 in chips) 
Seat 8: Snoopy95_2.0 (94770 in chips) 
T3RSS1: posts the ante 750
Giginis: posts the ante 750
BorIska1993: posts the ante 750
haitzi1: posts the ante 750
Varle84: posts the ante 750
VICTOR TXR1: posts the ante 750
Snoopy95_2.0: posts the ante 750
haitzi1: posts small blind 3000
Varle84: posts big blind 6000
*** HOLE CARDS ***
VICTOR TXR1: folds 
Snoopy95_2.0: calls 6000
T3RSS1: folds 
Giginis: folds 
BorIska1993: folds 
haitzi1: raises 12039 to 18039 and is all-in
Varle84: folds 
Snoopy95_2.0: calls 12039
*** FLOP *** [9h 9d Jd]
*** TURN *** [9h 9d Jd] [5h]
MaCheCazzoFai is disconnected 
*** RIVER *** [9h 9d Jd 5h] [9s]
*** SHOW DOWN ***
haitzi1: shows [8h Qs] (three of a kind, Nines)
Snoopy95_2.0: shows [Ac 7s] (three of a kind, Nines - Ace kicker)
Snoopy95_2.0 collected 47328 from pot
haitzi1 finished the tournament in 231st place and received $115.10.
*** SUMMARY ***
Total pot 47328 | Rake 0 
Board [9h 9d Jd 5h 9s]
Seat 1: T3RSS1 folded before Flop (didn't bet)
Seat 2: Giginis folded before Flop (didn't bet)
Seat 4: BorIska1993 (button) folded before Flop (didn't bet)
Seat 5: haitzi1 (small blind) showed [8h Qs] and lost with three of a kind, Nines
Seat 6: Varle84 (big blind) folded before Flop
Seat 7: VICTOR TXR1 folded before Flop (didn't bet)
Seat 8: Snoopy95_2.0 showed [Ac 7s] and won (47328) with three of a kind, Nines

PokerStars Hand #251207182610: Tournament #3767885527, $40+$10+$5 USD Hold'em No Limit - Level XX (3000/6000) - 2024/06/26 20:43:13 UTC [2024/06/26 16:43:13 ET]
Table '3767885527 63' 8-max Seat #6 is the button
Seat 1: T3RSS1 (146340 in chips) 
Seat 2: Giginis (372489 in chips) 
Seat 3: MaCheCazzoFai (117831 in chips) 
Seat 4: BorIska1993 (125474 in chips) 
Seat 6: Varle84 (79948 in chips) 
Seat 7: VICTOR TXR1 (106997 in chips) 
Seat 8: Snoopy95_2.0 (123309 in chips) 
T3RSS1: posts the ante 750
Giginis: posts the ante 750
MaCheCazzoFai: posts the ante 750
BorIska1993: posts the ante 750
Varle84: posts the ante 750
VICTOR TXR1: posts the ante 750
Snoopy95_2.0: posts the ante 750
VICTOR TXR1: posts small blind 3000
Snoopy95_2.0: posts big blind 6000
*** HOLE CARDS ***
T3RSS1: folds 
Giginis: folds 
MaCheCazzoFai: folds 
BorIska1993: folds 
Varle84: raises 73198 to 79198 and is all-in
VICTOR TXR1: folds 
Snoopy95_2.0: folds 
Uncalled bet (73198) returned to Varle84
Varle84 collected 20250 from pot
*** SUMMARY ***
Total pot 20250 | Rake 0 
Seat 1: T3RSS1 folded before Flop (didn't bet)
Seat 2: Giginis folded before Flop (didn't bet)
Seat 3: MaCheCazzoFai folded before Flop (didn't bet)
Seat 4: BorIska1993 folded before Flop (didn't bet)
Seat 6: Varle84 (button) collected (20250)
Seat 7: VICTOR TXR1 (small blind) folded before Flop
Seat 8: Snoopy95_2.0 (big blind) folded before Flop

PokerStars Hand #251207190264: Tournament #3767885527, $40+$10+$5 USD Hold'em No Limit - Level XX (3000/6000) - 2024/06/26 20:43:41 UTC [2024/06/26 16:43:41 ET]
Table '3767885527 63' 8-max Seat #7 is the button
Seat 1: T3RSS1 (145590 in chips) 
Seat 2: Giginis (371739 in chips) 
Seat 3: MaCheCazzoFai (117081 in chips) 
Seat 4: BorIska1993 (124724 in chips) 
Seat 6: Varle84 (93448 in chips) 
Seat 7: VICTOR TXR1 (103247 in chips) 
Seat 8: Snoopy95_2.0 (116559 in chips) 
T3RSS1: posts the ante 750
Giginis: posts the ante 750
MaCheCazzoFai: posts the ante 750
BorIska1993: posts the ante 750
Varle84: posts the ante 750
VICTOR TXR1: posts the ante 750
Snoopy95_2.0: posts the ante 750
Snoopy95_2.0: posts small blind 3000
T3RSS1: posts big blind 6000
*** HOLE CARDS ***
Giginis: folds 
MaCheCazzoFai: raises 6000 to 12000
BorIska1993: folds 
Varle84: folds 
VICTOR TXR1: folds 
Snoopy95_2.0: folds 
T3RSS1: folds 
Uncalled bet (6000) returned to MaCheCazzoFai
MaCheCazzoFai collected 20250 from pot
MaCheCazzoFai: doesn't show hand 
*** SUMMARY ***
Total pot 20250 | Rake 0 
Seat 1: T3RSS1 (big blind) folded before Flop
Seat 2: Giginis folded before Flop (didn't bet)
Seat 3: MaCheCazzoFai collected (20250)
Seat 4: BorIska1993 folded before Flop (didn't bet)
Seat 6: Varle84 folded before Flop (didn't bet)
Seat 7: VICTOR TXR1 (button) folded before Flop (didn't bet)
Seat 8: Snoopy95_2.0 (small blind) folded before Flop

PokerStars Hand #251207196620: Tournament #3767885527, $40+$10+$5 USD Hold'em No Limit - Level XX (3000/6000) - 2024/06/26 20:44:04 UTC [2024/06/26 16:44:04 ET]
Table '3767885527 63' 8-max Seat #8 is the button
Seat 1: T3RSS1 (138840 in chips) 
Seat 2: Giginis (370989 in chips) 
Seat 3: MaCheCazzoFai (130581 in chips) 
Seat 4: BorIska1993 (123974 in chips) 
Seat 6: Varle84 (92698 in chips) 
Seat 7: VICTOR TXR1 (102497 in chips) 
Seat 8: Snoopy95_2.0 (112809 in chips) 
T3RSS1: posts the ante 750
Giginis: posts the ante 750
MaCheCazzoFai: posts the ante 750
BorIska1993: posts the ante 750
Varle84: posts the ante 750
VICTOR TXR1: posts the ante 750
Snoopy95_2.0: posts the ante 750
T3RSS1: posts small blind 3000
Giginis: posts big blind 6000
*** HOLE CARDS ***
MaCheCazzoFai: folds 
BorIska1993: folds 
Varle84: folds 
VICTOR TXR1: raises 6000 to 12000
Snoopy95_2.0: folds 
T3RSS1: folds 
Giginis: calls 6000
*** FLOP *** [5s 7d Ah]
Giginis: checks 
VICTOR TXR1: bets 9998
Giginis: folds 
Uncalled bet (9998) returned to VICTOR TXR1
VICTOR TXR1 collected 32250 from pot
VICTOR TXR1: doesn't show hand 
*** SUMMARY ***
Total pot 32250 | Rake 0 
Board [5s 7d Ah]
Seat 1: T3RSS1 (small blind) folded before Flop
Seat 2: Giginis (big blind) folded on the Flop
Seat 3: MaCheCazzoFai folded before Flop (didn't bet)
Seat 4: BorIska1993 folded before Flop (didn't bet)
Seat 6: Varle84 folded before Flop (didn't bet)
Seat 7: VICTOR TXR1 collected (32250)
Seat 8: Snoopy95_2.0 (button) folded before Flop (didn't bet)

PokerStars Hand #251207208319: Tournament #3767885527, $40+$10+$5 USD Hold'em No Limit - Level XX (3000/6000) - 2024/06/26 20:44:47 UTC [2024/06/26 16:44:47 ET]
Table '3767885527 63' 8-max Seat #1 is the button
Seat 1: T3RSS1 (135090 in chips) 
Seat 2: Giginis (358239 in chips) 
Seat 3: MaCheCazzoFai (129831 in chips) 
Seat 4: BorIska1993 (123224 in chips) 
Seat 6: Varle84 (91948 in chips) 
Seat 7: VICTOR TXR1 (121997 in chips) 
Seat 8: Snoopy95_2.0 (112059 in chips) 
T3RSS1: posts the ante 750
Giginis: posts the ante 750
MaCheCazzoFai: posts the ante 750
BorIska1993: posts the ante 750
Varle84: posts the ante 750
VICTOR TXR1: posts the ante 750
Snoopy95_2.0: posts the ante 750
Giginis: posts small blind 3000
MaCheCazzoFai: posts big blind 6000
*** HOLE CARDS ***
BorIska1993: folds 
Varle84: folds 
NOEXITNO is disconnected 
VICTOR TXR1: folds 
Snoopy95_2.0: raises 6000 to 12000
T3RSS1: folds 
Giginis: folds 
MaCheCazzoFai: raises 117081 to 129081 and is all-in
Snoopy95_2.0: folds 
Uncalled bet (117081) returned to MaCheCazzoFai
MaCheCazzoFai collected 32250 from pot
MaCheCazzoFai: doesn't show hand 
*** SUMMARY ***
Total pot 32250 | Rake 0 
Seat 1: T3RSS1 (button) folded before Flop (didn't bet)
Seat 2: Giginis (small blind) folded before Flop
Seat 3: MaCheCazzoFai (big blind) collected (32250)
Seat 4: BorIska1993 folded before Flop (didn't bet)
Seat 6: Varle84 folded before Flop (didn't bet)
Seat 7: VICTOR TXR1 folded before Flop (didn't bet)
Seat 8: Snoopy95_2.0 folded before Flop

PokerStars Hand #251207216266: Tournament #3767885527, $40+$10+$5 USD Hold'em No Limit - Level XX (3000/6000) - 2024/06/26 20:45:16 UTC [2024/06/26 16:45:16 ET]
Table '3767885527 63' 8-max Seat #2 is the button
Seat 1: T3RSS1 (134340 in chips) 
Seat 2: Giginis (354489 in chips) 
Seat 3: MaCheCazzoFai (149331 in chips) 
Seat 4: BorIska1993 (122474 in chips) 
Seat 5: NOEXITNO (69770 in chips) 
Seat 6: Varle84 (91198 in chips) 
Seat 7: VICTOR TXR1 (121247 in chips) 
Seat 8: Snoopy95_2.0 (99309 in chips) 
T3RSS1: posts the ante 750
Giginis: posts the ante 750
MaCheCazzoFai: posts the ante 750
BorIska1993: posts the ante 750
NOEXITNO: posts the ante 750
Varle84: posts the ante 750
VICTOR TXR1: posts the ante 750
Snoopy95_2.0: posts the ante 750
MaCheCazzoFai: posts small blind 3000
BorIska1993: posts big blind 6000
*** HOLE CARDS ***
NOEXITNO: folds 
Varle84: raises 6000 to 12000
VICTOR TXR1: folds 
Snoopy95_2.0: folds 
T3RSS1: folds 
Giginis: folds 
MaCheCazzoFai: folds 
BorIska1993: calls 6000
*** FLOP *** [5c 2d 7s]
BorIska1993: checks 
Varle84: bets 17160
BorIska1993: folds 
Uncalled bet (17160) returned to Varle84
Varle84 collected 33000 from pot
*** SUMMARY ***
Total pot 33000 | Rake 0 
Board [5c 2d 7s]
Seat 1: T3RSS1 folded before Flop (didn't bet)
Seat 2: Giginis (button) folded before Flop (didn't bet)
Seat 3: MaCheCazzoFai (small blind) folded before Flop
Seat 4: BorIska1993 (big blind) folded on the Flop
Seat 5: NOEXITNO folded before Flop (didn't bet)
Seat 6: Varle84 collected (33000)
Seat 7: VICTOR TXR1 folded before Flop (didn't bet)
Seat 8: Snoopy95_2.0 folded before Flop (didn't bet)

PokerStars Hand #251207230533: Tournament #3767885527, $40+$10+$5 USD Hold'em No Limit - Level XXI (3500/7000) - 2024/06/26 20:46:08 UTC [2024/06/26 16:46:08 ET]
Table '3767885527 63' 8-max Seat #3 is the button
Seat 1: T3RSS1 (133590 in chips) 
Seat 2: Giginis (353739 in chips) 
Seat 3: MaCheCazzoFai (145581 in chips) 
Seat 4: BorIska1993 (109724 in chips) 
Seat 5: NOEXITNO (69020 in chips) 
Seat 6: Varle84 (111448 in chips) 
Seat 7: VICTOR TXR1 (120497 in chips) 
Seat 8: Snoopy95_2.0 (98559 in chips) 
T3RSS1: posts the ante 875
Giginis: posts the ante 875
MaCheCazzoFai: posts the ante 875
BorIska1993: posts the ante 875
NOEXITNO: posts the ante 875
Varle84: posts the ante 875
VICTOR TXR1: posts the ante 875
Snoopy95_2.0: posts the ante 875
BorIska1993: posts small blind 3500
NOEXITNO: posts big blind 7000
*** HOLE CARDS ***
Varle84: folds 
VICTOR TXR1: folds 
Snoopy95_2.0: folds 
T3RSS1: raises 125715 to 132715 and is all-in
Giginis: folds 
MaCheCazzoFai: folds 
BorIska1993: calls 105349 and is all-in
NOEXITNO: calls 61145 and is all-in
Uncalled bet (23866) returned to T3RSS1
*** FLOP *** [Kh 3c 6c]
*** TURN *** [Kh 3c 6c] [3h]
*** RIVER *** [Kh 3c 6c 3h] [Ts]
*** SHOW DOWN ***
BorIska1993: shows [8c 8d] (two pair, Eights and Threes)
T3RSS1: shows [Ad Kc] (two pair, Kings and Threes)
T3RSS1 collected 81408 from side pot
NOEXITNO: shows [Jd Jc] (two pair, Jacks and Threes)
T3RSS1 collected 211435 from main pot
BorIska1993 finished the tournament in 213th place and received $115.10.
NOEXITNO finished the tournament in 214th place and received $115.10.
*** SUMMARY ***
Total pot 292843 Main pot 211435. Side pot 81408. | Rake 0 
Board [Kh 3c 6c 3h Ts]
Seat 1: T3RSS1 showed [Ad Kc] and won (292843) with two pair, Kings and Threes
Seat 2: Giginis folded before Flop (didn't bet)
Seat 3: MaCheCazzoFai (button) folded before Flop (didn't bet)
Seat 4: BorIska1993 (small blind) showed [8c 8d] and lost with two pair, Eights and Threes
Seat 5: NOEXITNO (big blind) showed [Jd Jc] and lost with two pair, Jacks and Threes
Seat 6: Varle84 folded before Flop (didn't bet)
Seat 7: VICTOR TXR1 folded before Flop (didn't bet)
Seat 8: Snoopy95_2.0 folded before Flop (didn't bet)

PokerStars Hand #251207242317: Tournament #3767885527, $40+$10+$5 USD Hold'em No Limit - Level XXI (3500/7000) - 2024/06/26 20:46:51 UTC [2024/06/26 16:46:51 ET]
Table '3767885527 63' 8-max Seat #6 is the button
Seat 1: T3RSS1 (316709 in chips) 
Seat 2: Giginis (352864 in chips) 
Seat 3: MaCheCazzoFai (144706 in chips) 
Seat 6: Varle84 (110573 in chips) 
Seat 7: VICTOR TXR1 (119622 in chips) 
Seat 8: Snoopy95_2.0 (97684 in chips) 
T3RSS1: posts the ante 875
Giginis: posts the ante 875
MaCheCazzoFai: posts the ante 875
Varle84: posts the ante 875
VICTOR TXR1: posts the ante 875
Snoopy95_2.0: posts the ante 875
VICTOR TXR1: posts small blind 3500
Snoopy95_2.0: posts big blind 7000
*** HOLE CARDS ***
T3RSS1: folds 
Billionai8 is disconnected 
Giginis: raises 7000 to 14000
MaCheCazzoFai: folds 
Varle84: folds 
VICTOR TXR1: folds 
Snoopy95_2.0: folds 
Uncalled bet (7000) returned to Giginis
Giginis collected 22750 from pot
*** SUMMARY ***
Total pot 22750 | Rake 0 
Seat 1: T3RSS1 folded before Flop (didn't bet)
Seat 2: Giginis collected (22750)
Seat 3: MaCheCazzoFai folded before Flop (didn't bet)
Seat 6: Varle84 (button) folded before Flop (didn't bet)
Seat 7: VICTOR TXR1 (small blind) folded before Flop
Seat 8: Snoopy95_2.0 (big blind) folded before Flop

PokerStars Hand #251207250608: Tournament #3767885527, $40+$10+$5 USD Hold'em No Limit - Level XXI (3500/7000) - 2024/06/26 20:47:21 UTC [2024/06/26 16:47:21 ET]
Table '3767885527 63' 8-max Seat #7 is the button
Seat 1: T3RSS1 (315834 in chips) 
Seat 2: Giginis (367739 in chips) 
Seat 3: MaCheCazzoFai (143831 in chips) 
Seat 4: Billionai8 (474062 in chips) 
Seat 6: Varle84 (109698 in chips) 
Seat 7: VICTOR TXR1 (115247 in chips) 
Seat 8: Snoopy95_2.0 (89809 in chips) 
T3RSS1: posts the ante 875
Giginis: posts the ante 875
MaCheCazzoFai: posts the ante 875
Billionai8: posts the ante 875
Varle84: posts the ante 875
VICTOR TXR1: posts the ante 875
Snoopy95_2.0: posts the ante 875
Snoopy95_2.0: posts small blind 3500
T3RSS1: posts big blind 7000
*** HOLE CARDS ***
Giginis: folds 
MaCheCazzoFai: folds 
Billionai8: raises 7000 to 14000
Varle84: raises 94823 to 108823 and is all-in
VICTOR TXR1: folds 
Snoopy95_2.0: folds 
T3RSS1: folds 
Billionai8: folds 
Uncalled bet (94823) returned to Varle84
Varle84 collected 44625 from pot
*** SUMMARY ***
Total pot 44625 | Rake 0 
Seat 1: T3RSS1 (big blind) folded before Flop
Seat 2: Giginis folded before Flop (didn't bet)
Seat 3: MaCheCazzoFai folded before Flop (didn't bet)
Seat 4: Billionai8 folded before Flop
Seat 6: Varle84 collected (44625)
Seat 7: VICTOR TXR1 (button) folded before Flop (didn't bet)
Seat 8: Snoopy95_2.0 (small blind) folded before Flop

PokerStars Hand #251207258684: Tournament #3767885527, $40+$10+$5 USD Hold'em No Limit - Level XXI (3500/7000) - 2024/06/26 20:47:50 UTC [2024/06/26 16:47:50 ET]
Table '3767885527 63' 8-max Seat #8 is the button
Seat 1: T3RSS1 (307959 in chips) 
Seat 2: Giginis (366864 in chips) 
Seat 3: MaCheCazzoFai (142956 in chips) 
Seat 4: Billionai8 (459187 in chips) 
Seat 6: Varle84 (139448 in chips) 
Seat 7: VICTOR TXR1 (114372 in chips) 
Seat 8: Snoopy95_2.0 (85434 in chips) 
T3RSS1: posts the ante 875
Giginis: posts the ante 875
MaCheCazzoFai: posts the ante 875
Billionai8: posts the ante 875
Varle84: posts the ante 875
VICTOR TXR1: posts the ante 875
Snoopy95_2.0: posts the ante 875
T3RSS1: posts small blind 3500
Giginis: posts big blind 7000
*** HOLE CARDS ***
MaCheCazzoFai: folds 
Billionai8: folds 
Varle84: raises 7000 to 14000
VICTOR TXR1: folds 
Snoopy95_2.0: folds 
T3RSS1: folds 
Giginis: calls 7000
*** FLOP *** [8s 7d 6h]
Giginis: checks 
Varle84: bets 25200
Giginis: folds 
Uncalled bet (25200) returned to Varle84
Varle84 collected 37625 from pot
*** SUMMARY ***
Total pot 37625 | Rake 0 
Board [8s 7d 6h]
Seat 1: T3RSS1 (small blind) folded before Flop
Seat 2: Giginis (big blind) folded on the Flop
Seat 3: MaCheCazzoFai folded before Flop (didn't bet)
Seat 4: Billionai8 folded before Flop (didn't bet)
Seat 6: Varle84 collected (37625)
Seat 7: VICTOR TXR1 folded before Flop (didn't bet)
Seat 8: Snoopy95_2.0 (button) folded before Flop (didn't bet)

PokerStars Hand #251207277085: Tournament #3767885527, $40+$10+$5 USD Hold'em No Limit - Level XXI (3500/7000) - 2024/06/26 20:48:57 UTC [2024/06/26 16:48:57 ET]
Table '3767885527 63' 8-max Seat #1 is the button
Seat 1: T3RSS1 (303584 in chips) 
Seat 2: Giginis (351989 in chips) 
Seat 3: MaCheCazzoFai (142081 in chips) 
Seat 4: Billionai8 (458312 in chips) 
Seat 6: Varle84 (162198 in chips) 
Seat 7: VICTOR TXR1 (113497 in chips) 
Seat 8: Snoopy95_2.0 (84559 in chips) 
T3RSS1: posts the ante 875
Giginis: posts the ante 875
MaCheCazzoFai: posts the ante 875
Billionai8: posts the ante 875
Varle84: posts the ante 875
VICTOR TXR1: posts the ante 875
Snoopy95_2.0: posts the ante 875
Giginis: posts small blind 3500
MaCheCazzoFai: posts big blind 7000
*** HOLE CARDS ***
Billionai8: raises 7000 to 14000
Varle84: folds 
VICTOR TXR1: folds 
Snoopy95_2.0: folds 
T3RSS1: folds 
Giginis: folds 
MaCheCazzoFai: raises 127206 to 141206 and is all-in
Billionai8: calls 127206
*** FLOP *** [4h Ks Qh]
*** TURN *** [4h Ks Qh] [2s]
*** RIVER *** [4h Ks Qh 2s] [7h]
*** SHOW DOWN ***
MaCheCazzoFai: shows [Kd Ah] (a pair of Kings)
Billionai8: shows [3d 3s] (a pair of Threes)
MaCheCazzoFai collected 292037 from pot
*** SUMMARY ***
Total pot 292037 | Rake 0 
Board [4h Ks Qh 2s 7h]
Seat 1: T3RSS1 (button) folded before Flop (didn't bet)
Seat 2: Giginis (small blind) folded before Flop
Seat 3: MaCheCazzoFai (big blind) showed [Kd Ah] and won (292037) with a pair of Kings
Seat 4: Billionai8 showed [3d 3s] and lost with a pair of Threes
Seat 6: Varle84 folded before Flop (didn't bet)
Seat 7: VICTOR TXR1 folded before Flop (didn't bet)
Seat 8: Snoopy95_2.0 folded before Flop (didn't bet)

PokerStars Hand #251207286056: Tournament #3767885527, $40+$10+$5 USD Hold'em No Limit - Level XXI (3500/7000) - 2024/06/26 20:49:30 UTC [2024/06/26 16:49:30 ET]
Table '3767885527 63' 8-max Seat #2 is the button
Seat 1: T3RSS1 (302709 in chips) 
Seat 2: Giginis (347614 in chips) 
Seat 3: MaCheCazzoFai (292037 in chips) 
Seat 4: Billionai8 (316231 in chips) 
Seat 5: Joes38 (228746 in chips) 
Seat 6: Varle84 (161323 in chips) 
Seat 7: VICTOR TXR1 (112622 in chips) 
Seat 8: Snoopy95_2.0 (83684 in chips) 
T3RSS1: posts the ante 875
Giginis: posts the ante 875
MaCheCazzoFai: posts the ante 875
Billionai8: posts the ante 875
Joes38: posts the ante 875
Varle84: posts the ante 875
VICTOR TXR1: posts the ante 875
Snoopy95_2.0: posts the ante 875
MaCheCazzoFai: posts small blind 3500
Billionai8: posts big blind 7000
*** HOLE CARDS ***
Joes38: folds 
Varle84: folds 
VICTOR TXR1: folds 
Snoopy95_2.0: folds 
T3RSS1: folds 
Giginis: raises 7000 to 14000
MaCheCazzoFai: raises 42000 to 56000
Billionai8: folds 
Giginis: folds 
Uncalled bet (42000) returned to MaCheCazzoFai
MaCheCazzoFai collected 42000 from pot
MaCheCazzoFai: doesn't show hand 
*** SUMMARY ***
Total pot 42000 | Rake 0 
Seat 1: T3RSS1 folded before Flop (didn't bet)
Seat 2: Giginis (button) folded before Flop
Seat 3: MaCheCazzoFai (small blind) collected (42000)
Seat 4: Billionai8 (big blind) folded before Flop
Seat 5: Joes38 folded before Flop (didn't bet)
Seat 6: Varle84 folded before Flop (didn't bet)
Seat 7: VICTOR TXR1 folded before Flop (didn't bet)
Seat 8: Snoopy95_2.0 folded before Flop (didn't bet)

PokerStars Hand #251207294998: Tournament #3767885527, $40+$10+$5 USD Hold'em No Limit - Level XXI (3500/7000) - 2024/06/26 20:50:03 UTC [2024/06/26 16:50:03 ET]
Table '3767885527 63' 8-max Seat #3 is the button
Seat 1: T3RSS1 (301834 in chips) 
Seat 2: Giginis (332739 in chips) 
Seat 3: MaCheCazzoFai (319162 in chips) 
Seat 4: Billionai8 (308356 in chips) 
Seat 5: Joes38 (227871 in chips) 
Seat 6: Varle84 (160448 in chips) 
Seat 7: VICTOR TXR1 (111747 in chips) 
Seat 8: Snoopy95_2.0 (82809 in chips) 
T3RSS1: posts the ante 875
Giginis: posts the ante 875
MaCheCazzoFai: posts the ante 875
Billionai8: posts the ante 875
Joes38: posts the ante 875
Varle84: posts the ante 875
VICTOR TXR1: posts the ante 875
Snoopy95_2.0: posts the ante 875
Billionai8: posts small blind 3500
Joes38: posts big blind 7000
*** HOLE CARDS ***
Varle84: folds 
VICTOR TXR1: folds 
Snoopy95_2.0: folds 
T3RSS1: raises 7000 to 14000
Giginis: folds 
MaCheCazzoFai: folds 
Billionai8: folds 
Joes38: folds 
Uncalled bet (7000) returned to T3RSS1
T3RSS1 collected 24500 from pot
*** SUMMARY ***
Total pot 24500 | Rake 0 
Seat 1: T3RSS1 collected (24500)
Seat 2: Giginis folded before Flop (didn't bet)
Seat 3: MaCheCazzoFai (button) folded before Flop (didn't bet)
Seat 4: Billionai8 (small blind) folded before Flop
Seat 5: Joes38 (big blind) folded before Flop
Seat 6: Varle84 folded before Flop (didn't bet)
Seat 7: VICTOR TXR1 folded before Flop (didn't bet)
Seat 8: Snoopy95_2.0 folded before Flop (didn't bet)

PokerStars Hand #251207302119: Tournament #3767885527, $40+$10+$5 USD Hold'em No Limit - Level XXI (3500/7000) - 2024/06/26 20:50:29 UTC [2024/06/26 16:50:29 ET]
Table '3767885527 63' 8-max Seat #4 is the button
Seat 1: T3RSS1 (318459 in chips) 
Seat 3: MaCheCazzoFai (318287 in chips) 
Seat 4: Billionai8 (303981 in chips) 
Seat 5: Joes38 (219996 in chips) 
Seat 6: Varle84 (159573 in chips) 
Seat 7: VICTOR TXR1 (110872 in chips) 
Seat 8: Snoopy95_2.0 (81934 in chips) 
T3RSS1: posts the ante 875
MaCheCazzoFai: posts the ante 875
Billionai8: posts the ante 875
Joes38: posts the ante 875
Varle84: posts the ante 875
VICTOR TXR1: posts the ante 875
Snoopy95_2.0: posts the ante 875
Joes38: posts small blind 3500
Varle84: posts big blind 7000
*** HOLE CARDS ***
VICTOR TXR1: folds 
Snoopy95_2.0: folds 
T3RSS1: folds 
MaCheCazzoFai: folds 
Billionai8: folds 
Joes38: folds 
Uncalled bet (3500) returned to Varle84
Varle84 collected 13125 from pot
*** SUMMARY ***
Total pot 13125 | Rake 0 
Seat 1: T3RSS1 folded before Flop (didn't bet)
Seat 3: MaCheCazzoFai folded before Flop (didn't bet)
Seat 4: Billionai8 (button) folded before Flop (didn't bet)
Seat 5: Joes38 (small blind) folded before Flop
Seat 6: Varle84 (big blind) collected (13125)
Seat 7: VICTOR TXR1 folded before Flop (didn't bet)
Seat 8: Snoopy95_2.0 folded before Flop (didn't bet)

PokerStars Hand #251207305894: Tournament #3767885527, $40+$10+$5 USD Hold'em No Limit - Level XXI (3500/7000) - 2024/06/26 20:50:43 UTC [2024/06/26 16:50:43 ET]
Table '3767885527 63' 8-max Seat #5 is the button
Seat 1: T3RSS1 (317584 in chips) 
Seat 3: MaCheCazzoFai (317412 in chips) 
Seat 4: Billionai8 (303106 in chips) 
Seat 5: Joes38 (215621 in chips) 
Seat 6: Varle84 (168323 in chips) 
Seat 7: VICTOR TXR1 (109997 in chips) 
Seat 8: Snoopy95_2.0 (81059 in chips) 
T3RSS1: posts the ante 875
MaCheCazzoFai: posts the ante 875
Billionai8: posts the ante 875
Joes38: posts the ante 875
Varle84: posts the ante 875
VICTOR TXR1: posts the ante 875
Snoopy95_2.0: posts the ante 875
Varle84: posts small blind 3500
VICTOR TXR1: posts big blind 7000
*** HOLE CARDS ***
Snoopy95_2.0: folds 
T3RSS1: raises 7000 to 14000
MaCheCazzoFai: raises 28000 to 42000
Billionai8: folds 
Joes38: folds 
Varle84: folds 
VICTOR TXR1: folds 
T3RSS1: folds 
Uncalled bet (28000) returned to MaCheCazzoFai
gibbo888 is disconnected 
MaCheCazzoFai collected 44625 from pot
MaCheCazzoFai: doesn't show hand 
*** SUMMARY ***
Total pot 44625 | Rake 0 
Seat 1: T3RSS1 folded before Flop
Seat 3: MaCheCazzoFai collected (44625)
Seat 4: Billionai8 folded before Flop (didn't bet)
Seat 5: Joes38 (button) folded before Flop (didn't bet)
Seat 6: Varle84 (small blind) folded before Flop
Seat 7: VICTOR TXR1 (big blind) folded before Flop
Seat 8: Snoopy95_2.0 folded before Flop (didn't bet)

PokerStars Hand #251207311364: Tournament #3767885527, $40+$10+$5 USD Hold'em No Limit - Level XXI (3500/7000) - 2024/06/26 20:51:03 UTC [2024/06/26 16:51:03 ET]
Table '3767885527 63' 8-max Seat #6 is the button
Seat 1: T3RSS1 (302709 in chips) 
Seat 2: gibbo888 (274749 in chips) 
Seat 3: MaCheCazzoFai (347162 in chips) 
Seat 4: Billionai8 (302231 in chips) 
Seat 5: Joes38 (214746 in chips) 
Seat 6: Varle84 (163948 in chips) 
Seat 7: VICTOR TXR1 (102122 in chips) 
Seat 8: Snoopy95_2.0 (80184 in chips) 
T3RSS1: posts the ante 875
gibbo888: posts the ante 875
MaCheCazzoFai: posts the ante 875
Billionai8: posts the ante 875
Joes38: posts the ante 875
Varle84: posts the ante 875
VICTOR TXR1: posts the ante 875
Snoopy95_2.0: posts the ante 875
VICTOR TXR1: posts small blind 3500
Snoopy95_2.0: posts big blind 7000
*** HOLE CARDS ***
T3RSS1 is disconnected 
T3RSS1 is connected 
T3RSS1 is disconnected 
T3RSS1 is connected 
T3RSS1: raises 7700 to 14700
gibbo888: folds 
MaCheCazzoFai: folds 
Billionai8: folds 
Joes38: folds 
Varle84: folds 
VICTOR TXR1: folds 
Snoopy95_2.0: calls 7700
*** FLOP *** [3h Ac 5h]
Snoopy95_2.0: checks 
T3RSS1: bets 20349
Snoopy95_2.0: raises 44260 to 64609 and is all-in
T3RSS1: calls 44260
*** TURN *** [3h Ac 5h] [9c]
*** RIVER *** [3h Ac 5h 9c] [7h]
*** SHOW DOWN ***
Snoopy95_2.0: shows [4c 5d] (a pair of Fives)
T3RSS1: shows [Ad Qc] (a pair of Aces)
T3RSS1 collected 169118 from pot
Snoopy95_2.0 finished the tournament in 196th place and received $115.10.
*** SUMMARY ***
Total pot 169118 | Rake 0 
Board [3h Ac 5h 9c 7h]
Seat 1: T3RSS1 showed [Ad Qc] and won (169118) with a pair of Aces
Seat 2: gibbo888 folded before Flop (didn't bet)
Seat 3: MaCheCazzoFai folded before Flop (didn't bet)
Seat 4: Billionai8 folded before Flop (didn't bet)
Seat 5: Joes38 folded before Flop (didn't bet)
Seat 6: Varle84 (button) folded before Flop (didn't bet)
Seat 7: VICTOR TXR1 (small blind) folded before Flop
Seat 8: Snoopy95_2.0 (big blind) showed [4c 5d] and lost with a pair of Fives

PokerStars Hand #251207323587: Tournament #3767885527, $40+$10+$5 USD Hold'em No Limit - Level XXI (3500/7000) - 2024/06/26 20:51:48 UTC [2024/06/26 16:51:48 ET]
Table '3767885527 63' 8-max Seat #7 is the button
Seat 1: T3RSS1 (391643 in chips) 
Seat 2: gibbo888 (273874 in chips) 
Seat 3: MaCheCazzoFai (346287 in chips) 
Seat 4: Billionai8 (301356 in chips) 
Seat 5: Joes38 (213871 in chips) 
Seat 6: Varle84 (163073 in chips) 
Seat 7: VICTOR TXR1 (97747 in chips) 
T3RSS1: posts the ante 875
gibbo888: posts the ante 875
MaCheCazzoFai: posts the ante 875
Billionai8: posts the ante 875
Joes38: posts the ante 875
Varle84: posts the ante 875
VICTOR TXR1: posts the ante 875
T3RSS1: posts small blind 3500
gibbo888: posts big blind 7000
*** HOLE CARDS ***
MaCheCazzoFai: folds 
Billionai8: folds 
Joes38: folds 
Varle84: raises 7000 to 14000
VICTOR TXR1: folds 
T3RSS1: folds 
gibbo888: calls 7000
*** FLOP *** [8h 2c Qd]
gibbo888: checks 
Varle84: bets 11620
GuyFromGipsy is disconnected 
gibbo888: raises 19880 to 31500
Varle84: calls 19880
*** TURN *** [8h 2c Qd] [8s]
gibbo888: checks 
Varle84: bets 22680
gibbo888: folds 
Uncalled bet (22680) returned to Varle84
Varle84 collected 100625 from pot
*** SUMMARY ***
Total pot 100625 | Rake 0 
Board [8h 2c Qd 8s]
Seat 1: T3RSS1 (small blind) folded before Flop
Seat 2: gibbo888 (big blind) folded on the Turn
Seat 3: MaCheCazzoFai folded before Flop (didn't bet)
Seat 4: Billionai8 folded before Flop (didn't bet)
Seat 5: Joes38 folded before Flop (didn't bet)
Seat 6: Varle84 collected (100625)
Seat 7: VICTOR TXR1 (button) folded before Flop (didn't bet)

PokerStars Hand #251207343174: Tournament #3767885527, $40+$10+$5 USD Hold'em No Limit - Level XXI (3500/7000) - 2024/06/26 20:53:01 UTC [2024/06/26 16:53:01 ET]
Table '3767885527 63' 8-max Seat #1 is the button
Seat 1: T3RSS1 (387268 in chips) 
Seat 2: gibbo888 (227499 in chips) 
Seat 3: MaCheCazzoFai (345412 in chips) 
Seat 4: Billionai8 (300481 in chips) 
Seat 5: Joes38 (212996 in chips) 
Seat 6: Varle84 (217323 in chips) 
Seat 7: VICTOR TXR1 (96872 in chips) 
Seat 8: GuyFromGipsy (228893 in chips) 
T3RSS1: posts the ante 875
gibbo888: posts the ante 875
MaCheCazzoFai: posts the ante 875
Billionai8: posts the ante 875
Joes38: posts the ante 875
Varle84: posts the ante 875
VICTOR TXR1: posts the ante 875
GuyFromGipsy: posts the ante 875
gibbo888: posts small blind 3500
MaCheCazzoFai: posts big blind 7000
*** HOLE CARDS ***
Billionai8: folds 
Joes38: folds 
Varle84: folds 
VICTOR TXR1: folds 
GuyFromGipsy: folds 
T3RSS1: raises 7700 to 14700
gibbo888: folds 
MaCheCazzoFai: calls 7700
*** FLOP *** [Qc 5c Ac]
MaCheCazzoFai: checks 
T3RSS1: bets 13167
MaCheCazzoFai: raises 16559 to 29726
T3RSS1: calls 16559
*** TURN *** [Qc 5c Ac] [Jc]
MaCheCazzoFai: checks 
T3RSS1: checks 
*** RIVER *** [Qc 5c Ac Jc] [Td]
MaCheCazzoFai: checks 
T3RSS1: checks 
*** SHOW DOWN ***
MaCheCazzoFai: shows [Kc 6c] (a flush, Ace high)
T3RSS1: mucks hand 
MaCheCazzoFai collected 99352 from pot
*** SUMMARY ***
Total pot 99352 | Rake 0 
Board [Qc 5c Ac Jc Td]
Seat 1: T3RSS1 (button) mucked
Seat 2: gibbo888 (small blind) folded before Flop
Seat 3: MaCheCazzoFai (big blind) showed [Kc 6c] and won (99352) with a flush, Ace high
Seat 4: Billionai8 folded before Flop (didn't bet)
Seat 5: Joes38 folded before Flop (didn't bet)
Seat 6: Varle84 folded before Flop (didn't bet)
Seat 7: VICTOR TXR1 folded before Flop (didn't bet)
Seat 8: GuyFromGipsy folded before Flop (didn't bet)

PokerStars Hand #251207361275: Tournament #3767885527, $40+$10+$5 USD Hold'em No Limit - Level XXI (3500/7000) - 2024/06/26 20:54:09 UTC [2024/06/26 16:54:09 ET]
Table '3767885527 63' 8-max Seat #2 is the button
Seat 1: T3RSS1 (341967 in chips) 
Seat 2: gibbo888 (223124 in chips) 
Seat 3: MaCheCazzoFai (399463 in chips) 
Seat 4: Billionai8 (299606 in chips) 
Seat 5: Joes38 (212121 in chips) 
Seat 6: Varle84 (216448 in chips) 
Seat 7: VICTOR TXR1 (95997 in chips) 
Seat 8: GuyFromGipsy (228018 in chips) 
T3RSS1: posts the ante 875
gibbo888: posts the ante 875
MaCheCazzoFai: posts the ante 875
Billionai8: posts the ante 875
Joes38: posts the ante 875
Varle84: posts the ante 875
VICTOR TXR1: posts the ante 875
GuyFromGipsy: posts the ante 875
MaCheCazzoFai: posts small blind 3500
Billionai8: posts big blind 7000
*** HOLE CARDS ***
Joes38: raises 8400 to 15400
Varle84: folds 
VICTOR TXR1: folds 
GuyFromGipsy: folds 
T3RSS1: folds 
gibbo888: folds 
MaCheCazzoFai: folds 
Billionai8: folds 
Uncalled bet (8400) returned to Joes38
Joes38 collected 24500 from pot
*** SUMMARY ***
Total pot 24500 | Rake 0 
Seat 1: T3RSS1 folded before Flop (didn't bet)
Seat 2: gibbo888 (button) folded before Flop (didn't bet)
Seat 3: MaCheCazzoFai (small blind) folded before Flop
Seat 4: Billionai8 (big blind) folded before Flop
Seat 5: Joes38 collected (24500)
Seat 6: Varle84 folded before Flop (didn't bet)
Seat 7: VICTOR TXR1 folded before Flop (didn't bet)
Seat 8: GuyFromGipsy folded before Flop (didn't bet)

PokerStars Hand #251207367304: Tournament #3767885527, $40+$10+$5 USD Hold'em No Limit - Level XXI (3500/7000) - 2024/06/26 20:54:32 UTC [2024/06/26 16:54:32 ET]
Table '3767885527 63' 8-max Seat #3 is the button
Seat 1: T3RSS1 (341092 in chips) 
Seat 2: gibbo888 (222249 in chips) 
Seat 3: MaCheCazzoFai (395088 in chips) 
Seat 4: Billionai8 (291731 in chips) 
Seat 5: Joes38 (228746 in chips) 
Seat 6: Varle84 (215573 in chips) 
Seat 7: VICTOR TXR1 (95122 in chips) 
Seat 8: GuyFromGipsy (227143 in chips) 
T3RSS1: posts the ante 875
gibbo888: posts the ante 875
MaCheCazzoFai: posts the ante 875
Billionai8: posts the ante 875
Joes38: posts the ante 875
Varle84: posts the ante 875
VICTOR TXR1: posts the ante 875
GuyFromGipsy: posts the ante 875
Billionai8: posts small blind 3500
Joes38: posts big blind 7000
*** HOLE CARDS ***
Varle84: raises 7000 to 14000
VICTOR TXR1: folds 
GuyFromGipsy: folds 
T3RSS1: folds 
gibbo888: folds 
MaCheCazzoFai: folds 
Billionai8: folds 
Joes38: folds 
Uncalled bet (7000) returned to Varle84
Varle84 collected 24500 from pot
*** SUMMARY ***
Total pot 24500 | Rake 0 
Seat 1: T3RSS1 folded before Flop (didn't bet)
Seat 2: gibbo888 folded before Flop (didn't bet)
Seat 3: MaCheCazzoFai (button) folded before Flop (didn't bet)
Seat 4: Billionai8 (small blind) folded before Flop
Seat 5: Joes38 (big blind) folded before Flop
Seat 6: Varle84 collected (24500)
Seat 7: VICTOR TXR1 folded before Flop (didn't bet)
Seat 8: GuyFromGipsy folded before Flop (didn't bet)

PokerStars Hand #251207373646: Tournament #3767885527, $40+$10+$5 USD Hold'em No Limit - Level XXI (3500/7000) - 2024/06/26 20:54:55 UTC [2024/06/26 16:54:55 ET]
Table '3767885527 63' 8-max Seat #4 is the button
Seat 1: T3RSS1 (340217 in chips) 
Seat 2: gibbo888 (221374 in chips) 
Seat 3: MaCheCazzoFai (394213 in chips) 
Seat 4: Billionai8 (287356 in chips) 
Seat 5: Joes38 (220871 in chips) 
Seat 6: Varle84 (232198 in chips) 
Seat 7: VICTOR TXR1 (94247 in chips) 
Seat 8: GuyFromGipsy (226268 in chips) 
T3RSS1: posts the ante 875
gibbo888: posts the ante 875
MaCheCazzoFai: posts the ante 875
Billionai8: posts the ante 875
Joes38: posts the ante 875
Varle84: posts the ante 875
VICTOR TXR1: posts the ante 875
GuyFromGipsy: posts the ante 875
Joes38: posts small blind 3500
Varle84: posts big blind 7000
*** HOLE CARDS ***
VICTOR TXR1: folds 
GuyFromGipsy: folds 
T3RSS1: folds 
gibbo888: raises 7000 to 14000
MaCheCazzoFai: folds 
Billionai8: raises 28000 to 42000
Joes38: folds 
Varle84: folds 
gibbo888: calls 28000
*** FLOP *** [5d 8s 4d]
gibbo888: checks 
Billionai8: checks 
*** TURN *** [5d 8s 4d] [Td]
gibbo888: checks 
Billionai8: checks 
*** RIVER *** [5d 8s 4d Td] [Js]
gibbo888: checks 
Billionai8: checks 
*** SHOW DOWN ***
gibbo888: shows [Qd Kc] (high card King)
Billionai8: shows [4h Kh] (a pair of Fours)
Billionai8 collected 101500 from pot
*** SUMMARY ***
Total pot 101500 | Rake 0 
Board [5d 8s 4d Td Js]
Seat 1: T3RSS1 folded before Flop (didn't bet)
Seat 2: gibbo888 showed [Qd Kc] and lost with high card King
Seat 3: MaCheCazzoFai folded before Flop (didn't bet)
Seat 4: Billionai8 (button) showed [4h Kh] and won (101500) with a pair of Fours
Seat 5: Joes38 (small blind) folded before Flop
Seat 6: Varle84 (big blind) folded before Flop
Seat 7: VICTOR TXR1 folded before Flop (didn't bet)
Seat 8: GuyFromGipsy folded before Flop (didn't bet)

PokerStars Hand #251207474919: Tournament #3767885527, $40+$10+$5 USD Hold'em No Limit - Level XXI (3500/7000) - 2024/06/26 21:02:48 UTC [2024/06/26 17:02:48 ET]
Table '3767885527 63' 8-max Seat #5 is the button
Seat 1: T3RSS1 (339342 in chips) 
Seat 2: gibbo888 (178499 in chips) 
Seat 3: MaCheCazzoFai (393338 in chips) 
Seat 4: Billionai8 (345981 in chips) 
Seat 5: Joes38 (216496 in chips) 
Seat 6: Varle84 (224323 in chips) 
Seat 7: VICTOR TXR1 (93372 in chips) 
Seat 8: GuyFromGipsy (225393 in chips) 
T3RSS1: posts the ante 875
gibbo888: posts the ante 875
MaCheCazzoFai: posts the ante 875
Billionai8: posts the ante 875
Joes38: posts the ante 875
Varle84: posts the ante 875
VICTOR TXR1: posts the ante 875
GuyFromGipsy: posts the ante 875
Varle84: posts small blind 3500
VICTOR TXR1: posts big blind 7000
*** HOLE CARDS ***
GuyFromGipsy: folds 
T3RSS1: folds 
gibbo888: raises 7000 to 14000
MaCheCazzoFai: folds 
Billionai8: folds 
Joes38: folds 
Varle84: folds 
VICTOR TXR1: folds 
Uncalled bet (7000) returned to gibbo888
gibbo888 collected 24500 from pot
*** SUMMARY ***
Total pot 24500 | Rake 0 
Seat 1: T3RSS1 folded before Flop (didn't bet)
Seat 2: gibbo888 collected (24500)
Seat 3: MaCheCazzoFai folded before Flop (didn't bet)
Seat 4: Billionai8 folded before Flop (didn't bet)
Seat 5: Joes38 (button) folded before Flop (didn't bet)
Seat 6: Varle84 (small blind) folded before Flop
Seat 7: VICTOR TXR1 (big blind) folded before Flop
Seat 8: GuyFromGipsy folded before Flop (didn't bet)

PokerStars Hand #251207480591: Tournament #3767885527, $40+$10+$5 USD Hold'em No Limit - Level XXI (3500/7000) - 2024/06/26 21:03:09 UTC [2024/06/26 17:03:09 ET]
Table '3767885527 63' 8-max Seat #6 is the button
Seat 1: T3RSS1 (338467 in chips) 
Seat 2: gibbo888 (195124 in chips) 
Seat 3: MaCheCazzoFai (392463 in chips) 
Seat 4: Billionai8 (345106 in chips) 
Seat 5: Joes38 (215621 in chips) 
Seat 6: Varle84 (219948 in chips) 
Seat 7: VICTOR TXR1 (85497 in chips) 
Seat 8: GuyFromGipsy (224518 in chips) 
T3RSS1: posts the ante 875
gibbo888: posts the ante 875
MaCheCazzoFai: posts the ante 875
Billionai8: posts the ante 875
Joes38: posts the ante 875
Varle84: posts the ante 875
VICTOR TXR1: posts the ante 875
GuyFromGipsy: posts the ante 875
VICTOR TXR1: posts small blind 3500
GuyFromGipsy: posts big blind 7000
*** HOLE CARDS ***
T3RSS1: folds 
gibbo888: folds 
MaCheCazzoFai: folds 
Billionai8: folds 
Joes38: folds 
Varle84: folds 
VICTOR TXR1: calls 3500
GuyFromGipsy: raises 216643 to 223643 and is all-in
VICTOR TXR1: folds 
Uncalled bet (216643) returned to GuyFromGipsy
GuyFromGipsy collected 21000 from pot
GuyFromGipsy: doesn't show hand 
*** SUMMARY ***
Total pot 21000 | Rake 0 
Seat 1: T3RSS1 folded before Flop (didn't bet)
Seat 2: gibbo888 folded before Flop (didn't bet)
Seat 3: MaCheCazzoFai folded before Flop (didn't bet)
Seat 4: Billionai8 folded before Flop (didn't bet)
Seat 5: Joes38 folded before Flop (didn't bet)
Seat 6: Varle84 (button) folded before Flop (didn't bet)
Seat 7: VICTOR TXR1 (small blind) folded before Flop
Seat 8: GuyFromGipsy (big blind) collected (21000)

PokerStars Hand #251207500261: Tournament #3767885527, $40+$10+$5 USD Hold'em No Limit - Level XXII (4000/8000) - 2024/06/26 21:04:21 UTC [2024/06/26 17:04:21 ET]
Table '3767885527 63' 8-max Seat #7 is the button
Seat 1: T3RSS1 (337592 in chips) 
Seat 2: gibbo888 (194249 in chips) 
Seat 3: MaCheCazzoFai (391588 in chips) 
Seat 4: Billionai8 (344231 in chips) 
Seat 5: Joes38 (214746 in chips) 
Seat 6: Varle84 (219073 in chips) 
Seat 7: VICTOR TXR1 (77622 in chips) 
Seat 8: GuyFromGipsy (237643 in chips) 
T3RSS1: posts the ante 1000
gibbo888: posts the ante 1000
MaCheCazzoFai: posts the ante 1000
Billionai8: posts the ante 1000
Joes38: posts the ante 1000
Varle84: posts the ante 1000
VICTOR TXR1: posts the ante 1000
GuyFromGipsy: posts the ante 1000
GuyFromGipsy: posts small blind 4000
T3RSS1: posts big blind 8000
*** HOLE CARDS ***
gibbo888: folds 
MaCheCazzoFai: folds 
Billionai8: folds 
Joes38: folds 
Varle84: raises 8000 to 16000
VICTOR TXR1: folds 
GuyFromGipsy: raises 32000 to 48000
T3RSS1: folds 
Varle84: folds 
Uncalled bet (32000) returned to GuyFromGipsy
GuyFromGipsy collected 48000 from pot
GuyFromGipsy: doesn't show hand 
*** SUMMARY ***
Total pot 48000 | Rake 0 
Seat 1: T3RSS1 (big blind) folded before Flop
Seat 2: gibbo888 folded before Flop (didn't bet)
Seat 3: MaCheCazzoFai folded before Flop (didn't bet)
Seat 4: Billionai8 folded before Flop (didn't bet)
Seat 5: Joes38 folded before Flop (didn't bet)
Seat 6: Varle84 folded before Flop
Seat 7: VICTOR TXR1 (button) folded before Flop (didn't bet)
Seat 8: GuyFromGipsy (small blind) collected (48000)

PokerStars Hand #251207512232: Tournament #3767885527, $40+$10+$5 USD Hold'em No Limit - Level XXII (4000/8000) - 2024/06/26 21:05:06 UTC [2024/06/26 17:05:06 ET]
Table '3767885527 63' 8-max Seat #8 is the button
Seat 1: T3RSS1 (328592 in chips) 
Seat 2: gibbo888 (193249 in chips) 
Seat 3: MaCheCazzoFai (390588 in chips) 
Seat 4: Billionai8 (343231 in chips) 
Seat 5: Joes38 (213746 in chips) 
Seat 6: Varle84 (202073 in chips) 
Seat 7: VICTOR TXR1 (76622 in chips) 
Seat 8: GuyFromGipsy (268643 in chips) 
T3RSS1: posts the ante 1000
gibbo888: posts the ante 1000
MaCheCazzoFai: posts the ante 1000
Billionai8: posts the ante 1000
Joes38: posts the ante 1000
Varle84: posts the ante 1000
VICTOR TXR1: posts the ante 1000
GuyFromGipsy: posts the ante 1000
T3RSS1: posts small blind 4000
gibbo888: posts big blind 8000
*** HOLE CARDS ***
MaCheCazzoFai: raises 8000 to 16000
Billionai8: folds 
Joes38: folds 
Varle84: folds 
VICTOR TXR1: folds 
GuyFromGipsy: folds 
T3RSS1: folds 
gibbo888: folds 
Uncalled bet (8000) returned to MaCheCazzoFai
MaCheCazzoFai collected 28000 from pot
MaCheCazzoFai: doesn't show hand 
*** SUMMARY ***
Total pot 28000 | Rake 0 
Seat 1: T3RSS1 (small blind) folded before Flop
Seat 2: gibbo888 (big blind) folded before Flop
Seat 3: MaCheCazzoFai collected (28000)
Seat 4: Billionai8 folded before Flop (didn't bet)
Seat 5: Joes38 folded before Flop (didn't bet)
Seat 6: Varle84 folded before Flop (didn't bet)
Seat 7: VICTOR TXR1 folded before Flop (didn't bet)
Seat 8: GuyFromGipsy (button) folded before Flop (didn't bet)

PokerStars Hand #251207523520: Tournament #3767885527, $40+$10+$5 USD Hold'em No Limit - Level XXII (4000/8000) - 2024/06/26 21:05:43 UTC [2024/06/26 17:05:43 ET]
Table '3767885527 63' 8-max Seat #1 is the button
Seat 1: T3RSS1 (323592 in chips) 
Seat 2: gibbo888 (184249 in chips) 
Seat 3: MaCheCazzoFai (409588 in chips) 
Seat 4: Billionai8 (342231 in chips) 
Seat 6: Varle84 (201073 in chips) 
Seat 7: VICTOR TXR1 (75622 in chips) 
Seat 8: GuyFromGipsy (267643 in chips) 
T3RSS1: posts the ante 1000
gibbo888: posts the ante 1000
MaCheCazzoFai: posts the ante 1000
Billionai8: posts the ante 1000
Varle84: posts the ante 1000
VICTOR TXR1: posts the ante 1000
GuyFromGipsy: posts the ante 1000
gibbo888: posts small blind 4000
MaCheCazzoFai: posts big blind 8000
*** HOLE CARDS ***
Billionai8: folds 
Varle84: folds 
Juicy_J_93 is disconnected 
VICTOR TXR1: folds 
GuyFromGipsy: folds 
T3RSS1: folds 
gibbo888: folds 
Uncalled bet (4000) returned to MaCheCazzoFai
MaCheCazzoFai collected 15000 from pot
MaCheCazzoFai: doesn't show hand 
*** SUMMARY ***
Total pot 15000 | Rake 0 
Seat 1: T3RSS1 (button) folded before Flop (didn't bet)
Seat 2: gibbo888 (small blind) folded before Flop
Seat 3: MaCheCazzoFai (big blind) collected (15000)
Seat 4: Billionai8 folded before Flop (didn't bet)
Seat 6: Varle84 folded before Flop (didn't bet)
Seat 7: VICTOR TXR1 folded before Flop (didn't bet)
Seat 8: GuyFromGipsy folded before Flop (didn't bet)

PokerStars Hand #251207530156: Tournament #3767885527, $40+$10+$5 USD Hold'em No Limit - Level XXII (4000/8000) - 2024/06/26 21:06:05 UTC [2024/06/26 17:06:05 ET]
Table '3767885527 63' 8-max Seat #2 is the button
Seat 1: T3RSS1 (322592 in chips) 
Seat 2: gibbo888 (179249 in chips) 
Seat 3: MaCheCazzoFai (419588 in chips) 
Seat 4: Billionai8 (341231 in chips) 
Seat 5: Juicy_J_93 (166051 in chips) 
Seat 6: Varle84 (200073 in chips) 
Seat 7: VICTOR TXR1 (74622 in chips) 
Seat 8: GuyFromGipsy (266643 in chips) 
T3RSS1: posts the ante 1000
gibbo888: posts the ante 1000
MaCheCazzoFai: posts the ante 1000
Billionai8: posts the ante 1000
Juicy_J_93: posts the ante 1000
Varle84: posts the ante 1000
VICTOR TXR1: posts the ante 1000
GuyFromGipsy: posts the ante 1000
MaCheCazzoFai: posts small blind 4000
Billionai8: posts big blind 8000
*** HOLE CARDS ***
Juicy_J_93: folds 
Varle84: folds 
VICTOR TXR1: folds 
GuyFromGipsy: folds 
T3RSS1: folds 
gibbo888: folds 
MaCheCazzoFai: calls 4000
Billionai8: checks 
*** FLOP *** [8d 9h 5h]
MaCheCazzoFai: checks 
Billionai8: checks 
*** TURN *** [8d 9h 5h] [Qh]
MaCheCazzoFai: bets 16000
Billionai8: folds 
Uncalled bet (16000) returned to MaCheCazzoFai
MaCheCazzoFai collected 24000 from pot
MaCheCazzoFai: doesn't show hand 
*** SUMMARY ***
Total pot 24000 | Rake 0 
Board [8d 9h 5h Qh]
Seat 1: T3RSS1 folded before Flop (didn't bet)
Seat 2: gibbo888 (button) folded before Flop (didn't bet)
Seat 3: MaCheCazzoFai (small blind) collected (24000)
Seat 4: Billionai8 (big blind) folded on the Turn
Seat 5: Juicy_J_93 folded before Flop (didn't bet)
Seat 6: Varle84 folded before Flop (didn't bet)
Seat 7: VICTOR TXR1 folded before Flop (didn't bet)
Seat 8: GuyFromGipsy folded before Flop (didn't bet)

PokerStars Hand #251207543368: Tournament #3767885527, $40+$10+$5 USD Hold'em No Limit - Level XXII (4000/8000) - 2024/06/26 21:06:49 UTC [2024/06/26 17:06:49 ET]
Table '3767885527 63' 8-max Seat #3 is the button
Seat 1: T3RSS1 (321592 in chips) 
Seat 2: gibbo888 (178249 in chips) 
Seat 3: MaCheCazzoFai (434588 in chips) 
Seat 4: Billionai8 (332231 in chips) 
Seat 5: Juicy_J_93 (165051 in chips) 
Seat 6: Varle84 (199073 in chips) 
Seat 7: VICTOR TXR1 (73622 in chips) 
Seat 8: GuyFromGipsy (265643 in chips) 
T3RSS1: posts the ante 1000
gibbo888: posts the ante 1000
MaCheCazzoFai: posts the ante 1000
Billionai8: posts the ante 1000
Juicy_J_93: posts the ante 1000
Varle84: posts the ante 1000
VICTOR TXR1: posts the ante 1000
GuyFromGipsy: posts the ante 1000
Billionai8: posts small blind 4000
Juicy_J_93: posts big blind 8000
*** HOLE CARDS ***
Varle84: folds 
VICTOR TXR1: folds 
GuyFromGipsy: folds 
T3RSS1: folds 
gibbo888: folds 
MaCheCazzoFai: folds 
Billionai8: raises 323231 to 331231 and is all-in
Juicy_J_93: folds 
Uncalled bet (323231) returned to Billionai8
Billionai8 collected 24000 from pot
Billionai8: doesn't show hand 
*** SUMMARY ***
Total pot 24000 | Rake 0 
Seat 1: T3RSS1 folded before Flop (didn't bet)
Seat 2: gibbo888 folded before Flop (didn't bet)
Seat 3: MaCheCazzoFai (button) folded before Flop (didn't bet)
Seat 4: Billionai8 (small blind) collected (24000)
Seat 5: Juicy_J_93 (big blind) folded before Flop
Seat 6: Varle84 folded before Flop (didn't bet)
Seat 7: VICTOR TXR1 folded before Flop (didn't bet)
Seat 8: GuyFromGipsy folded before Flop (didn't bet)

PokerStars Hand #251207552217: Tournament #3767885527, $40+$10+$5 USD Hold'em No Limit - Level XXII (4000/8000) - 2024/06/26 21:07:19 UTC [2024/06/26 17:07:19 ET]
Table '3767885527 63' 8-max Seat #4 is the button
Seat 1: T3RSS1 (320592 in chips) 
Seat 2: gibbo888 (177249 in chips) 
Seat 3: MaCheCazzoFai (433588 in chips) 
Seat 4: Billionai8 (347231 in chips) 
Seat 5: Juicy_J_93 (156051 in chips) 
Seat 6: Varle84 (198073 in chips) 
Seat 7: VICTOR TXR1 (72622 in chips) 
Seat 8: GuyFromGipsy (264643 in chips) 
T3RSS1: posts the ante 1000
gibbo888: posts the ante 1000
MaCheCazzoFai: posts the ante 1000
Billionai8: posts the ante 1000
Juicy_J_93: posts the ante 1000
Varle84: posts the ante 1000
VICTOR TXR1: posts the ante 1000
GuyFromGipsy: posts the ante 1000
Juicy_J_93: posts small blind 4000
Varle84: posts big blind 8000
*** HOLE CARDS ***
VICTOR TXR1: raises 63622 to 71622 and is all-in
GuyFromGipsy: folds 
T3RSS1: folds 
gibbo888: folds 
MaCheCazzoFai: folds 
Billionai8: folds 
Juicy_J_93: folds 
Varle84: folds 
Uncalled bet (63622) returned to VICTOR TXR1
VICTOR TXR1 collected 28000 from pot
VICTOR TXR1: doesn't show hand 
*** SUMMARY ***
Total pot 28000 | Rake 0 
Seat 1: T3RSS1 folded before Flop (didn't bet)
Seat 2: gibbo888 folded before Flop (didn't bet)
Seat 3: MaCheCazzoFai folded before Flop (didn't bet)
Seat 4: Billionai8 (button) folded before Flop (didn't bet)
Seat 5: Juicy_J_93 (small blind) folded before Flop
Seat 6: Varle84 (big blind) folded before Flop
Seat 7: VICTOR TXR1 collected (28000)
Seat 8: GuyFromGipsy folded before Flop (didn't bet)

PokerStars Hand #251207562158: Tournament #3767885527, $40+$10+$5 USD Hold'em No Limit - Level XXII (4000/8000) - 2024/06/26 21:07:52 UTC [2024/06/26 17:07:52 ET]
Table '3767885527 63' 8-max Seat #5 is the button
Seat 1: T3RSS1 (319592 in chips) 
Seat 2: gibbo888 (176249 in chips) 
Seat 3: MaCheCazzoFai (432588 in chips) 
Seat 4: Billionai8 (346231 in chips) 
Seat 5: Juicy_J_93 (151051 in chips) 
Seat 6: Varle84 (189073 in chips) 
Seat 7: VICTOR TXR1 (91622 in chips) 
Seat 8: GuyFromGipsy (263643 in chips) 
T3RSS1: posts the ante 1000
gibbo888: posts the ante 1000
MaCheCazzoFai: posts the ante 1000
Billionai8: posts the ante 1000
Juicy_J_93: posts the ante 1000
Varle84: posts the ante 1000
VICTOR TXR1: posts the ante 1000
GuyFromGipsy: posts the ante 1000
Varle84: posts small blind 4000
VICTOR TXR1: posts big blind 8000
*** HOLE CARDS ***
GuyFromGipsy: folds 
T3RSS1: folds 
gibbo888: folds 
MaCheCazzoFai: folds 
Billionai8: folds 
Juicy_J_93: raises 8000 to 16000
Varle84: folds 
VICTOR TXR1: folds 
Uncalled bet (8000) returned to Juicy_J_93
Juicy_J_93 collected 28000 from pot
Juicy_J_93: doesn't show hand 
*** SUMMARY ***
Total pot 28000 | Rake 0 
Seat 1: T3RSS1 folded before Flop (didn't bet)
Seat 2: gibbo888 folded before Flop (didn't bet)
Seat 3: MaCheCazzoFai folded before Flop (didn't bet)
Seat 4: Billionai8 folded before Flop (didn't bet)
Seat 5: Juicy_J_93 (button) collected (28000)
Seat 6: Varle84 (small blind) folded before Flop
Seat 7: VICTOR TXR1 (big blind) folded before Flop
Seat 8: GuyFromGipsy folded before Flop (didn't bet)

PokerStars Hand #251207571153: Tournament #3767885527, $40+$10+$5 USD Hold'em No Limit - Level XXII (4000/8000) - 2024/06/26 21:08:21 UTC [2024/06/26 17:08:21 ET]
Table '3767885527 63' 8-max Seat #6 is the button
Seat 1: T3RSS1 (318592 in chips) 
Seat 2: gibbo888 (175249 in chips) 
Seat 3: MaCheCazzoFai (431588 in chips) 
Seat 4: Billionai8 (345231 in chips) 
Seat 5: Juicy_J_93 (170051 in chips) 
Seat 6: Varle84 (184073 in chips) 
Seat 7: VICTOR TXR1 (82622 in chips) 
Seat 8: GuyFromGipsy (262643 in chips) 
T3RSS1: posts the ante 1000
gibbo888: posts the ante 1000
MaCheCazzoFai: posts the ante 1000
Billionai8: posts the ante 1000
Juicy_J_93: posts the ante 1000
Varle84: posts the ante 1000
VICTOR TXR1: posts the ante 1000
GuyFromGipsy: posts the ante 1000
VICTOR TXR1: posts small blind 4000
GuyFromGipsy: posts big blind 8000
*** HOLE CARDS ***
T3RSS1: folds 
gibbo888: folds 
MaCheCazzoFai: folds 
Billionai8: folds 
Juicy_J_93: folds 
Varle84: folds 
VICTOR TXR1: folds 
Uncalled bet (4000) returned to GuyFromGipsy
GuyFromGipsy collected 16000 from pot
GuyFromGipsy: doesn't show hand 
*** SUMMARY ***
Total pot 16000 | Rake 0 
Seat 1: T3RSS1 folded before Flop (didn't bet)
Seat 2: gibbo888 folded before Flop (didn't bet)
Seat 3: MaCheCazzoFai folded before Flop (didn't bet)
Seat 4: Billionai8 folded before Flop (didn't bet)
Seat 5: Juicy_J_93 folded before Flop (didn't bet)
Seat 6: Varle84 (button) folded before Flop (didn't bet)
Seat 7: VICTOR TXR1 (small blind) folded before Flop
Seat 8: GuyFromGipsy (big blind) collected (16000)

PokerStars Hand #251207576231: Tournament #3767885527, $40+$10+$5 USD Hold'em No Limit - Level XXII (4000/8000) - 2024/06/26 21:08:38 UTC [2024/06/26 17:08:38 ET]
Table '3767885527 63' 8-max Seat #7 is the button
Seat 1: T3RSS1 (317592 in chips) 
Seat 2: gibbo888 (174249 in chips) 
Seat 3: MaCheCazzoFai (430588 in chips) 
Seat 4: Billionai8 (344231 in chips) 
Seat 5: Juicy_J_93 (169051 in chips) 
Seat 6: Varle84 (183073 in chips) 
Seat 7: VICTOR TXR1 (77622 in chips) 
Seat 8: GuyFromGipsy (273643 in chips) 
T3RSS1: posts the ante 1000
gibbo888: posts the ante 1000
MaCheCazzoFai: posts the ante 1000
Billionai8: posts the ante 1000
Juicy_J_93: posts the ante 1000
Varle84: posts the ante 1000
VICTOR TXR1: posts the ante 1000
GuyFromGipsy: posts the ante 1000
GuyFromGipsy: posts small blind 4000
T3RSS1: posts big blind 8000
*** HOLE CARDS ***
gibbo888: folds 
MaCheCazzoFai: folds 
Billionai8: raises 8000 to 16000
Juicy_J_93: folds 
Varle84: raises 166073 to 182073 and is all-in
VICTOR TXR1: folds 
GuyFromGipsy: folds 
T3RSS1: folds 
Billionai8: folds 
Uncalled bet (166073) returned to Varle84
Varle84 collected 52000 from pot
*** SUMMARY ***
Total pot 52000 | Rake 0 
Seat 1: T3RSS1 (big blind) folded before Flop
Seat 2: gibbo888 folded before Flop (didn't bet)
Seat 3: MaCheCazzoFai folded before Flop (didn't bet)
Seat 4: Billionai8 folded before Flop
Seat 5: Juicy_J_93 folded before Flop (didn't bet)
Seat 6: Varle84 collected (52000)
Seat 7: VICTOR TXR1 (button) folded before Flop (didn't bet)
Seat 8: GuyFromGipsy (small blind) folded before Flop

PokerStars Hand #251207591755: Tournament #3767885527, $40+$10+$5 USD Hold'em No Limit - Level XXII (4000/8000) - 2024/06/26 21:09:29 UTC [2024/06/26 17:09:29 ET]
Table '3767885527 63' 8-max Seat #8 is the button
Seat 1: T3RSS1 (308592 in chips) 
Seat 2: gibbo888 (173249 in chips) 
Seat 3: MaCheCazzoFai (429588 in chips) 
Seat 4: Billionai8 (327231 in chips) 
Seat 5: Juicy_J_93 (168051 in chips) 
Seat 6: Varle84 (218073 in chips) 
Seat 7: VICTOR TXR1 (76622 in chips) 
Seat 8: GuyFromGipsy (268643 in chips) 
T3RSS1: posts the ante 1000
gibbo888: posts the ante 1000
MaCheCazzoFai: posts the ante 1000
Billionai8: posts the ante 1000
Juicy_J_93: posts the ante 1000
Varle84: posts the ante 1000
VICTOR TXR1: posts the ante 1000
GuyFromGipsy: posts the ante 1000
T3RSS1: posts small blind 4000
gibbo888: posts big blind 8000
*** HOLE CARDS ***
MaCheCazzoFai: folds 
Billionai8: folds 
Juicy_J_93: folds 
Varle84: folds 
VICTOR TXR1: raises 67622 to 75622 and is all-in
GuyFromGipsy has timed out
GuyFromGipsy: folds 
GuyFromGipsy is sitting out
T3RSS1: raises 231970 to 307592 and is all-in
gibbo888: folds 
Uncalled bet (231970) returned to T3RSS1
*** FLOP *** [6d Kd Qd]
GuyFromGipsy has returned
*** TURN *** [6d Kd Qd] [Qs]
*** RIVER *** [6d Kd Qd Qs] [6s]
*** SHOW DOWN ***
T3RSS1: shows [Ks Ad] (two pair, Kings and Queens)
VICTOR TXR1: shows [As 4d] (two pair, Queens and Sixes)
T3RSS1 collected 167244 from pot
VICTOR TXR1 finished the tournament in 160th place and received $126.61.
*** SUMMARY ***
Total pot 167244 | Rake 0 
Board [6d Kd Qd Qs 6s]
Seat 1: T3RSS1 (small blind) showed [Ks Ad] and won (167244) with two pair, Kings and Queens
Seat 2: gibbo888 (big blind) folded before Flop
Seat 3: MaCheCazzoFai folded before Flop (didn't bet)
Seat 4: Billionai8 folded before Flop (didn't bet)
Seat 5: Juicy_J_93 folded before Flop (didn't bet)
Seat 6: Varle84 folded before Flop (didn't bet)
Seat 7: VICTOR TXR1 showed [As 4d] and lost with two pair, Queens and Sixes
Seat 8: GuyFromGipsy (button) folded before Flop (didn't bet)

PokerStars Hand #251207602298: Tournament #3767885527, $40+$10+$5 USD Hold'em No Limit - Level XXII (4000/8000) - 2024/06/26 21:10:03 UTC [2024/06/26 17:10:03 ET]
Table '3767885527 63' 8-max Seat #1 is the button
Seat 1: T3RSS1 (399214 in chips) 
Seat 2: gibbo888 (164249 in chips) 
Seat 3: MaCheCazzoFai (428588 in chips) 
Seat 4: Billionai8 (326231 in chips) 
Seat 5: Juicy_J_93 (167051 in chips) 
Seat 6: Varle84 (217073 in chips) 
Seat 8: GuyFromGipsy (267643 in chips) 
T3RSS1: posts the ante 1000
gibbo888: posts the ante 1000
MaCheCazzoFai: posts the ante 1000
Billionai8: posts the ante 1000
Juicy_J_93: posts the ante 1000
Varle84: posts the ante 1000
GuyFromGipsy: posts the ante 1000
gibbo888: posts small blind 4000
MaCheCazzoFai: posts big blind 8000
*** HOLE CARDS ***
Billionai8: folds 
Juicy_J_93: folds 
Varle84: folds 
GuyFromGipsy: raises 8000 to 16000
T3RSS1: folds 
gibbo888: folds 
MaCheCazzoFai: raises 40000 to 56000
GuyFromGipsy: raises 210643 to 266643 and is all-in
MaCheCazzoFai: folds 
Uncalled bet (210643) returned to GuyFromGipsy
GuyFromGipsy collected 123000 from pot
GuyFromGipsy: doesn't show hand 
*** SUMMARY ***
Total pot 123000 | Rake 0 
Seat 1: T3RSS1 (button) folded before Flop (didn't bet)
Seat 2: gibbo888 (small blind) folded before Flop
Seat 3: MaCheCazzoFai (big blind) folded before Flop
Seat 4: Billionai8 folded before Flop (didn't bet)
Seat 5: Juicy_J_93 folded before Flop (didn't bet)
Seat 6: Varle84 folded before Flop (didn't bet)
Seat 8: GuyFromGipsy collected (123000)

PokerStars Hand #251207612875: Tournament #3767885527, $40+$10+$5 USD Hold'em No Limit - Level XXII (4000/8000) - 2024/06/26 21:10:38 UTC [2024/06/26 17:10:38 ET]
Table '3767885527 63' 8-max Seat #2 is the button
Seat 1: T3RSS1 (398214 in chips) 
Seat 2: gibbo888 (159249 in chips) 
Seat 3: MaCheCazzoFai (371588 in chips) 
Seat 4: Billionai8 (325231 in chips) 
Seat 5: Juicy_J_93 (166051 in chips) 
Seat 6: Varle84 (216073 in chips) 
Seat 8: GuyFromGipsy (333643 in chips) 
T3RSS1: posts the ante 1000
gibbo888: posts the ante 1000
MaCheCazzoFai: posts the ante 1000
Billionai8: posts the ante 1000
Juicy_J_93: posts the ante 1000
Varle84: posts the ante 1000
GuyFromGipsy: posts the ante 1000
MaCheCazzoFai: posts small blind 4000
Billionai8: posts big blind 8000
*** HOLE CARDS ***
Juicy_J_93: folds 
Varle84: folds 
GuyFromGipsy: folds 
T3RSS1: folds 
gibbo888: folds 
MaCheCazzoFai: calls 4000
Billionai8: raises 20000 to 28000
MaCheCazzoFai: folds 
Uncalled bet (20000) returned to Billionai8
Billionai8 collected 23000 from pot
Billionai8: doesn't show hand 
*** SUMMARY ***
Total pot 23000 | Rake 0 
Seat 1: T3RSS1 folded before Flop (didn't bet)
Seat 2: gibbo888 (button) folded before Flop (didn't bet)
Seat 3: MaCheCazzoFai (small blind) folded before Flop
Seat 4: Billionai8 (big blind) collected (23000)
Seat 5: Juicy_J_93 folded before Flop (didn't bet)
Seat 6: Varle84 folded before Flop (didn't bet)
Seat 8: GuyFromGipsy folded before Flop (didn't bet)

PokerStars Hand #251207624603: Tournament #3767885527, $40+$10+$5 USD Hold'em No Limit - Level XXII (4000/8000) - 2024/06/26 21:11:16 UTC [2024/06/26 17:11:16 ET]
Table '3767885527 63' 8-max Seat #3 is the button
Seat 1: T3RSS1 (397214 in chips) 
Seat 2: gibbo888 (158249 in chips) 
Seat 3: MaCheCazzoFai (362588 in chips) 
Seat 4: Billionai8 (339231 in chips) 
Seat 5: Juicy_J_93 (165051 in chips) 
Seat 6: Varle84 (215073 in chips) 
Seat 8: GuyFromGipsy (332643 in chips) 
T3RSS1: posts the ante 1000
gibbo888: posts the ante 1000
MaCheCazzoFai: posts the ante 1000
Billionai8: posts the ante 1000
Juicy_J_93: posts the ante 1000
Varle84: posts the ante 1000
GuyFromGipsy: posts the ante 1000
Billionai8: posts small blind 4000
Juicy_J_93: posts big blind 8000
*** HOLE CARDS ***
Varle84: folds 
GuyFromGipsy: folds 
T3RSS1: raises 8800 to 16800
gibbo888: folds 
MaCheCazzoFai: calls 16800
Billionai8: calls 12800
JAYJOEEEEE is disconnected 
Juicy_J_93: calls 8800
*** FLOP *** [6h 4c 6s]
Billionai8: checks 
Juicy_J_93: checks 
T3RSS1: checks 
MaCheCazzoFai: checks 
*** TURN *** [6h 4c 6s] [9d]
Billionai8: checks 
Juicy_J_93: checks 
T3RSS1: checks 
MaCheCazzoFai: bets 37100
Billionai8: folds 
Juicy_J_93: folds 
T3RSS1: folds 
Uncalled bet (37100) returned to MaCheCazzoFai
MaCheCazzoFai collected 74200 from pot
MaCheCazzoFai: doesn't show hand 
*** SUMMARY ***
Total pot 74200 | Rake 0 
Board [6h 4c 6s 9d]
Seat 1: T3RSS1 folded on the Turn
Seat 2: gibbo888 folded before Flop (didn't bet)
Seat 3: MaCheCazzoFai (button) collected (74200)
Seat 4: Billionai8 (small blind) folded on the Turn
Seat 5: Juicy_J_93 (big blind) folded on the Turn
Seat 6: Varle84 folded before Flop (didn't bet)
Seat 8: GuyFromGipsy folded before Flop (didn't bet)

PokerStars Hand #251207653615: Tournament #3767885527, $40+$10+$5 USD Hold'em No Limit - Level XXII (4000/8000) - 2024/06/26 21:12:51 UTC [2024/06/26 17:12:51 ET]
Table '3767885527 63' 8-max Seat #4 is the button
Seat 1: T3RSS1 (379414 in chips) 
Seat 2: gibbo888 (157249 in chips) 
Seat 3: MaCheCazzoFai (418988 in chips) 
Seat 4: Billionai8 (321431 in chips) 
Seat 5: Juicy_J_93 (147251 in chips) 
Seat 6: Varle84 (214073 in chips) 
Seat 7: JAYJOEEEEE (372572 in chips) 
Seat 8: GuyFromGipsy (331643 in chips) 
T3RSS1: posts the ante 1000
gibbo888: posts the ante 1000
MaCheCazzoFai: posts the ante 1000
Billionai8: posts the ante 1000
Juicy_J_93: posts the ante 1000
Varle84: posts the ante 1000
JAYJOEEEEE: posts the ante 1000
GuyFromGipsy: posts the ante 1000
Juicy_J_93: posts small blind 4000
Varle84: posts big blind 8000
*** HOLE CARDS ***
JAYJOEEEEE: raises 9600 to 17600
GuyFromGipsy: folds 
T3RSS1: folds 
gibbo888: folds 
MaCheCazzoFai: calls 17600
Billionai8: folds 
Juicy_J_93: folds 
Varle84: calls 9600
*** FLOP *** [Td 3d 6c]
Varle84: checks 
JAYJOEEEEE: bets 19440
MaCheCazzoFai: calls 19440
Varle84: folds 
*** TURN *** [Td 3d 6c] [Qc]
JAYJOEEEEE: bets 46656
MaCheCazzoFai: raises 98496 to 145152
JAYJOEEEEE: calls 98496
*** RIVER *** [Td 3d 6c Qc] [9d]
JAYJOEEEEE: checks 
MaCheCazzoFai: checks 
*** SHOW DOWN ***
JAYJOEEEEE: shows [Qs Kh] (a pair of Queens)
MaCheCazzoFai: shows [Ts Tc] (three of a kind, Tens)
MaCheCazzoFai collected 393984 from pot
*** SUMMARY ***
Total pot 393984 | Rake 0 
Board [Td 3d 6c Qc 9d]
Seat 1: T3RSS1 folded before Flop (didn't bet)
Seat 2: gibbo888 folded before Flop (didn't bet)
Seat 3: MaCheCazzoFai showed [Ts Tc] and won (393984) with three of a kind, Tens
Seat 4: Billionai8 (button) folded before Flop (didn't bet)
Seat 5: Juicy_J_93 (small blind) folded before Flop
Seat 6: Varle84 (big blind) folded on the Flop
Seat 7: JAYJOEEEEE showed [Qs Kh] and lost with a pair of Queens
Seat 8: GuyFromGipsy folded before Flop (didn't bet)

PokerStars Hand #251207684806: Tournament #3767885527, $40+$10+$5 USD Hold'em No Limit - Level XXIII (5000/10000) - 2024/06/26 21:14:32 UTC [2024/06/26 17:14:32 ET]
Table '3767885527 63' 8-max Seat #5 is the button
Seat 1: T3RSS1 (378414 in chips) 
Seat 2: gibbo888 (156249 in chips) 
Seat 3: MaCheCazzoFai (629780 in chips) 
Seat 4: Billionai8 (320431 in chips) 
Seat 5: Juicy_J_93 (142251 in chips) 
Seat 6: Varle84 (195473 in chips) 
Seat 7: JAYJOEEEEE (189380 in chips) 
Seat 8: GuyFromGipsy (330643 in chips) 
T3RSS1: posts the ante 1250
gibbo888: posts the ante 1250
MaCheCazzoFai: posts the ante 1250
Billionai8: posts the ante 1250
Juicy_J_93: posts the ante 1250
Varle84: posts the ante 1250
JAYJOEEEEE: posts the ante 1250
GuyFromGipsy: posts the ante 1250
Varle84: posts small blind 5000
JAYJOEEEEE: posts big blind 10000
*** HOLE CARDS ***
GuyFromGipsy: folds 
T3RSS1: raises 11000 to 21000
gibbo888: folds 
MaCheCazzoFai: folds 
Billionai8: calls 21000
Juicy_J_93: folds 
Varle84: folds 
JAYJOEEEEE: folds 
*** FLOP *** [Qd 6s 7h]
T3RSS1: bets 22110
Billionai8: calls 22110
*** TURN *** [Qd 6s 7h] [Ts]
T3RSS1: bets 56722
Billionai8: calls 56722
*** RIVER *** [Qd 6s 7h Ts] [8d]
T3RSS1: checks 
Billionai8: checks 
*** SHOW DOWN ***
T3RSS1: shows [As 9s] (a straight, Six to Ten)
Billionai8: mucks hand 
T3RSS1 collected 224664 from pot
*** SUMMARY ***
Total pot 224664 | Rake 0 
Board [Qd 6s 7h Ts 8d]
Seat 1: T3RSS1 showed [As 9s] and won (224664) with a straight, Six to Ten
Seat 2: gibbo888 folded before Flop (didn't bet)
Seat 3: MaCheCazzoFai folded before Flop (didn't bet)
Seat 4: Billionai8 mucked
Seat 5: Juicy_J_93 (button) folded before Flop (didn't bet)
Seat 6: Varle84 (small blind) folded before Flop
Seat 7: JAYJOEEEEE (big blind) folded before Flop
Seat 8: GuyFromGipsy folded before Flop (didn't bet)

PokerStars Hand #251207716607: Tournament #3767885527, $40+$10+$5 USD Hold'em No Limit - Level XXIII (5000/10000) - 2024/06/26 21:16:15 UTC [2024/06/26 17:16:15 ET]
Table '3767885527 63' 8-max Seat #6 is the button
Seat 1: T3RSS1 (501996 in chips) 
Seat 2: gibbo888 (154999 in chips) 
Seat 3: MaCheCazzoFai (628530 in chips) 
Seat 4: Billionai8 (219349 in chips) 
Seat 5: Juicy_J_93 (141001 in chips) 
Seat 6: Varle84 (189223 in chips) 
Seat 7: JAYJOEEEEE (178130 in chips) 
Seat 8: GuyFromGipsy (329393 in chips) 
T3RSS1: posts the ante 1250
gibbo888: posts the ante 1250
MaCheCazzoFai: posts the ante 1250
Billionai8: posts the ante 1250
Juicy_J_93: posts the ante 1250
Varle84: posts the ante 1250
JAYJOEEEEE: posts the ante 1250
GuyFromGipsy: posts the ante 1250
JAYJOEEEEE: posts small blind 5000
GuyFromGipsy: posts big blind 10000
*** HOLE CARDS ***
T3RSS1: folds 
gibbo888: raises 12000 to 22000
MaCheCazzoFai: folds 
Billionai8: folds 
Juicy_J_93: folds 
Varle84: folds 
JAYJOEEEEE: folds 
GuyFromGipsy: calls 12000
*** FLOP *** [Kh 2c 7d]
GuyFromGipsy: checks 
gibbo888: bets 131749 and is all-in
GuyFromGipsy: folds 
Uncalled bet (131749) returned to gibbo888
gibbo888 collected 59000 from pot
gibbo888: doesn't show hand 
*** SUMMARY ***
Total pot 59000 | Rake 0 
Board [Kh 2c 7d]
Seat 1: T3RSS1 folded before Flop (didn't bet)
Seat 2: gibbo888 collected (59000)
Seat 3: MaCheCazzoFai folded before Flop (didn't bet)
Seat 4: Billionai8 folded before Flop (didn't bet)
Seat 5: Juicy_J_93 folded before Flop (didn't bet)
Seat 6: Varle84 (button) folded before Flop (didn't bet)
Seat 7: JAYJOEEEEE (small blind) folded before Flop
Seat 8: GuyFromGipsy (big blind) folded on the Flop

PokerStars Hand #251207733118: Tournament #3767885527, $40+$10+$5 USD Hold'em No Limit - Level XXIII (5000/10000) - 2024/06/26 21:17:09 UTC [2024/06/26 17:17:09 ET]
Table '3767885527 63' 8-max Seat #7 is the button
Seat 1: T3RSS1 (500746 in chips) 
Seat 2: gibbo888 (190749 in chips) 
Seat 3: MaCheCazzoFai (627280 in chips) 
Seat 4: Billionai8 (218099 in chips) 
Seat 5: Juicy_J_93 (139751 in chips) 
Seat 6: Varle84 (187973 in chips) 
Seat 7: JAYJOEEEEE (171880 in chips) 
Seat 8: GuyFromGipsy (306143 in chips) 
T3RSS1: posts the ante 1250
gibbo888: posts the ante 1250
MaCheCazzoFai: posts the ante 1250
Billionai8: posts the ante 1250
Juicy_J_93: posts the ante 1250
Varle84: posts the ante 1250
JAYJOEEEEE: posts the ante 1250
GuyFromGipsy: posts the ante 1250
GuyFromGipsy: posts small blind 5000
T3RSS1: posts big blind 10000
*** HOLE CARDS ***
gibbo888: folds 
MaCheCazzoFai: folds 
Billionai8: folds 
Juicy_J_93: folds 
Varle84: folds 
JAYJOEEEEE: folds 
GuyFromGipsy: folds 
Uncalled bet (5000) returned to T3RSS1
T3RSS1 collected 20000 from pot
T3RSS1: doesn't show hand 
*** SUMMARY ***
Total pot 20000 | Rake 0 
Seat 1: T3RSS1 (big blind) collected (20000)
Seat 2: gibbo888 folded before Flop (didn't bet)
Seat 3: MaCheCazzoFai folded before Flop (didn't bet)
Seat 4: Billionai8 folded before Flop (didn't bet)
Seat 5: Juicy_J_93 folded before Flop (didn't bet)
Seat 6: Varle84 folded before Flop (didn't bet)
Seat 7: JAYJOEEEEE (button) folded before Flop (didn't bet)
Seat 8: GuyFromGipsy (small blind) folded before Flop

PokerStars Hand #251207738507: Tournament #3767885527, $40+$10+$5 USD Hold'em No Limit - Level XXIII (5000/10000) - 2024/06/26 21:17:26 UTC [2024/06/26 17:17:26 ET]
Table '3767885527 63' 8-max Seat #8 is the button
Seat 1: T3RSS1 (514496 in chips) 
Seat 2: gibbo888 (189499 in chips) 
Seat 3: MaCheCazzoFai (626030 in chips) 
Seat 4: Billionai8 (216849 in chips) 
Seat 5: Juicy_J_93 (138501 in chips) 
Seat 6: Varle84 (186723 in chips) 
Seat 7: JAYJOEEEEE (170630 in chips) 
Seat 8: GuyFromGipsy (299893 in chips) 
T3RSS1: posts the ante 1250
gibbo888: posts the ante 1250
MaCheCazzoFai: posts the ante 1250
Billionai8: posts the ante 1250
Juicy_J_93: posts the ante 1250
Varle84: posts the ante 1250
JAYJOEEEEE: posts the ante 1250
GuyFromGipsy: posts the ante 1250
T3RSS1: posts small blind 5000
gibbo888: posts big blind 10000
*** HOLE CARDS ***
MaCheCazzoFai: raises 10000 to 20000
Billionai8: folds 
Juicy_J_93: folds 
Varle84: folds 
JAYJOEEEEE: raises 149380 to 169380 and is all-in
GuyFromGipsy: folds 
T3RSS1: folds 
gibbo888: folds 
MaCheCazzoFai: folds 
Uncalled bet (149380) returned to JAYJOEEEEE
JAYJOEEEEE collected 65000 from pot
JAYJOEEEEE: doesn't show hand 
*** SUMMARY ***
Total pot 65000 | Rake 0 
Seat 1: T3RSS1 (small blind) folded before Flop
Seat 2: gibbo888 (big blind) folded before Flop
Seat 3: MaCheCazzoFai folded before Flop
Seat 4: Billionai8 folded before Flop (didn't bet)
Seat 5: Juicy_J_93 folded before Flop (didn't bet)
Seat 6: Varle84 folded before Flop (didn't bet)
Seat 7: JAYJOEEEEE collected (65000)
Seat 8: GuyFromGipsy (button) folded before Flop (didn't bet)

PokerStars Hand #251207748778: Tournament #3767885527, $40+$10+$5 USD Hold'em No Limit - Level XXIII (5000/10000) - 2024/06/26 21:17:59 UTC [2024/06/26 17:17:59 ET]
Table '3767885527 63' 8-max Seat #1 is the button
Seat 1: T3RSS1 (508246 in chips) 
Seat 2: gibbo888 (178249 in chips) 
Seat 3: MaCheCazzoFai (604780 in chips) 
Seat 4: Billionai8 (215599 in chips) 
Seat 5: Juicy_J_93 (137251 in chips) 
Seat 6: Varle84 (185473 in chips) 
Seat 7: JAYJOEEEEE (214380 in chips) 
Seat 8: GuyFromGipsy (298643 in chips) 
T3RSS1: posts the ante 1250
gibbo888: posts the ante 1250
MaCheCazzoFai: posts the ante 1250
Billionai8: posts the ante 1250
Juicy_J_93: posts the ante 1250
Varle84: posts the ante 1250
JAYJOEEEEE: posts the ante 1250
GuyFromGipsy: posts the ante 1250
gibbo888: posts small blind 5000
MaCheCazzoFai: posts big blind 10000
*** HOLE CARDS ***
Billionai8: folds 
Juicy_J_93: folds 
Varle84: raises 174223 to 184223 and is all-in
JAYJOEEEEE: folds 
GuyFromGipsy: folds 
T3RSS1: folds 
gibbo888: calls 171999 and is all-in
MaCheCazzoFai: folds 
Uncalled bet (7224) returned to Varle84
*** FLOP *** [As Ks Ad]
*** TURN *** [As Ks Ad] [4c]
*** RIVER *** [As Ks Ad 4c] [6h]
*** SHOW DOWN ***
gibbo888: shows [Ah Ac] (four of a kind, Aces)
Varle84: shows [8c 8s] (two pair, Aces and Eights)
gibbo888 collected 373998 from pot
*** SUMMARY ***
Total pot 373998 | Rake 0 
Board [As Ks Ad 4c 6h]
Seat 1: T3RSS1 (button) folded before Flop (didn't bet)
Seat 2: gibbo888 (small blind) showed [Ah Ac] and won (373998) with four of a kind, Aces
Seat 3: MaCheCazzoFai (big blind) folded before Flop
Seat 4: Billionai8 folded before Flop (didn't bet)
Seat 5: Juicy_J_93 folded before Flop (didn't bet)
Seat 6: Varle84 showed [8c 8s] and lost with two pair, Aces and Eights
Seat 7: JAYJOEEEEE folded before Flop (didn't bet)
Seat 8: GuyFromGipsy folded before Flop (didn't bet)

PokerStars Hand #251207761006: Tournament #3767885527, $40+$10+$5 USD Hold'em No Limit - Level XXIII (5000/10000) - 2024/06/26 21:18:39 UTC [2024/06/26 17:18:39 ET]
Table '3767885527 63' 8-max Seat #2 is the button
Seat 1: T3RSS1 (506996 in chips) 
Seat 2: gibbo888 (373998 in chips) 
Seat 3: MaCheCazzoFai (593530 in chips) 
Seat 4: Billionai8 (214349 in chips) 
Seat 5: Juicy_J_93 (136001 in chips) 
Seat 6: Varle84 (7224 in chips) 
Seat 7: JAYJOEEEEE (213130 in chips) 
Seat 8: GuyFromGipsy (297393 in chips) 
T3RSS1: posts the ante 1250
gibbo888: posts the ante 1250
MaCheCazzoFai: posts the ante 1250
Billionai8: posts the ante 1250
Juicy_J_93: posts the ante 1250
Varle84: posts the ante 1250
JAYJOEEEEE: posts the ante 1250
GuyFromGipsy: posts the ante 1250
MaCheCazzoFai: posts small blind 5000
Billionai8: posts big blind 10000
*** HOLE CARDS ***
Juicy_J_93: folds 
Varle84: calls 5974 and is all-in
JAYJOEEEEE: folds 
GuyFromGipsy: folds 
T3RSS1: folds 
gibbo888: folds 
MaCheCazzoFai: folds 
Uncalled bet (4026) returned to Billionai8
*** FLOP *** [Qc 2s Js]
*** TURN *** [Qc 2s Js] [5c]
*** RIVER *** [Qc 2s Js 5c] [3s]
*** SHOW DOWN ***
Billionai8: shows [5d Jd] (two pair, Jacks and Fives)
Varle84: shows [9c 3c] (a pair of Threes)
Billionai8 collected 26948 from pot
Varle84 finished the tournament in 137th place and received $139.27.
*** SUMMARY ***
Total pot 26948 | Rake 0 
Board [Qc 2s Js 5c 3s]
Seat 1: T3RSS1 folded before Flop (didn't bet)
Seat 2: gibbo888 (button) folded before Flop (didn't bet)
Seat 3: MaCheCazzoFai (small blind) folded before Flop
Seat 4: Billionai8 (big blind) showed [5d Jd] and won (26948) with two pair, Jacks and Fives
Seat 5: Juicy_J_93 folded before Flop (didn't bet)
Seat 6: Varle84 showed [9c 3c] and lost with a pair of Threes
Seat 7: JAYJOEEEEE folded before Flop (didn't bet)
Seat 8: GuyFromGipsy folded before Flop (didn't bet)


PokerStars Hand #251205405838: Tournament #3767885527, $40+$10+$5 USD Hold'em No Limit - Level XI (600/1200) - 2024/06/26 18:52:41 UTC [2024/06/26 14:52:41 ET]
Table '3767885527 61' 8-max Seat #7 is the button
Seat 1: ipayou (27075 in chips) 
Seat 2: MezuuÜuuT (13245 in chips) 
Seat 3: Hjerterdame1 (87216 in chips) 
Seat 4: ederpalasson (54943 in chips) 
Seat 6: ThalleSx (20480 in chips) 
Seat 7: fournn (59435 in chips) 
Seat 8: vagoyras (49499 in chips) 
ipayou: posts the ante 150
MezuuÜuuT: posts the ante 150
Hjerterdame1: posts the ante 150
ederpalasson: posts the ante 150
ThalleSx: posts the ante 150
fournn: posts the ante 150
vagoyras: posts the ante 150
vagoyras: posts small blind 600
ipayou: posts big blind 1200
*** HOLE CARDS ***
nacho2390 is disconnected 
MezuuÜuuT: folds 
Hjerterdame1: folds 
ederpalasson: raises 1200 to 2400
ThalleSx: folds 
fournn: folds 
vagoyras: folds 
ipayou: folds 
Uncalled bet (1200) returned to ederpalasson
ederpalasson collected 4050 from pot
ederpalasson: doesn't show hand 
*** SUMMARY ***
Total pot 4050 | Rake 0 
Seat 1: ipayou (big blind) folded before Flop
Seat 2: MezuuÜuuT folded before Flop (didn't bet)
Seat 3: Hjerterdame1 folded before Flop (didn't bet)
Seat 4: ederpalasson collected (4050)
Seat 6: ThalleSx folded before Flop (didn't bet)
Seat 7: fournn (button) folded before Flop (didn't bet)
Seat 8: vagoyras (small blind) folded before Flop

PokerStars Hand #251205418986: Tournament #3767885527, $40+$10+$5 USD Hold'em No Limit - Level XI (600/1200) - 2024/06/26 18:53:31 UTC [2024/06/26 14:53:31 ET]
Table '3767885527 61' 8-max Seat #8 is the button
Seat 1: ipayou (25725 in chips) 
Seat 2: MezuuÜuuT (13095 in chips) 
Seat 3: Hjerterdame1 (87066 in chips) 
Seat 4: ederpalasson (57643 in chips) 
Seat 5: nacho2390 (25000 in chips) 
Seat 6: ThalleSx (20330 in chips) 
Seat 7: fournn (59285 in chips) 
Seat 8: vagoyras (48749 in chips) 
ipayou: posts the ante 150
MezuuÜuuT: posts the ante 150
Hjerterdame1: posts the ante 150
ederpalasson: posts the ante 150
nacho2390: posts the ante 150
ThalleSx: posts the ante 150
fournn: posts the ante 150
vagoyras: posts the ante 150
ipayou: posts small blind 600
MezuuÜuuT: posts big blind 1200
*** HOLE CARDS ***
Hjerterdame1: raises 2000 to 3200
ederpalasson: folds 
nacho2390: raises 21650 to 24850 and is all-in
ThalleSx: folds 
fournn: folds 
vagoyras: folds 
ipayou: folds 
MezuuÜuuT: folds 
Hjerterdame1: folds [As]
Uncalled bet (21650) returned to nacho2390
nacho2390 collected 9400 from pot
nacho2390: doesn't show hand 
*** SUMMARY ***
Total pot 9400 | Rake 0 
Seat 1: ipayou (small blind) folded before Flop
Seat 2: MezuuÜuuT (big blind) folded before Flop
Seat 3: Hjerterdame1 folded before Flop
Seat 4: ederpalasson folded before Flop (didn't bet)
Seat 5: nacho2390 collected (9400)
Seat 6: ThalleSx folded before Flop (didn't bet)
Seat 7: fournn folded before Flop (didn't bet)
Seat 8: vagoyras (button) folded before Flop (didn't bet)

PokerStars Hand #251205436927: Tournament #3767885527, $40+$10+$5 USD Hold'em No Limit - Level XI (600/1200) - 2024/06/26 18:54:39 UTC [2024/06/26 14:54:39 ET]
Table '3767885527 61' 8-max Seat #1 is the button
Seat 1: ipayou (24975 in chips) 
Seat 2: MezuuÜuuT (11745 in chips) 
Seat 3: Hjerterdame1 (83716 in chips) 
Seat 4: ederpalasson (57493 in chips) 
Seat 5: nacho2390 (31050 in chips) 
Seat 6: ThalleSx (20180 in chips) 
Seat 7: fournn (59135 in chips) 
Seat 8: vagoyras (48599 in chips) 
ipayou: posts the ante 150
MezuuÜuuT: posts the ante 150
Hjerterdame1: posts the ante 150
ederpalasson: posts the ante 150
nacho2390: posts the ante 150
ThalleSx: posts the ante 150
fournn: posts the ante 150
vagoyras: posts the ante 150
MezuuÜuuT: posts small blind 600
Hjerterdame1: posts big blind 1200
*** HOLE CARDS ***
ederpalasson: raises 1200 to 2400
nacho2390: folds 
ThalleSx: folds 
fournn: folds 
vagoyras: folds 
ipayou: folds 
MezuuÜuuT: raises 9195 to 11595 and is all-in
Hjerterdame1: folds 
ederpalasson: calls 9195
*** FLOP *** [5s Qs 4h]
*** TURN *** [5s Qs 4h] [8s]
*** RIVER *** [5s Qs 4h 8s] [Ks]
*** SHOW DOWN ***
MezuuÜuuT: shows [Jh Ah] (high card Ace)
ederpalasson: shows [Tc 9c] (high card King)
MezuuÜuuT collected 25590 from pot
*** SUMMARY ***
Total pot 25590 | Rake 0 
Board [5s Qs 4h 8s Ks]
Seat 1: ipayou (button) folded before Flop (didn't bet)
Seat 2: MezuuÜuuT (small blind) showed [Jh Ah] and won (25590) with high card Ace
Seat 3: Hjerterdame1 (big blind) folded before Flop
Seat 4: ederpalasson showed [Tc 9c] and lost with high card King
Seat 5: nacho2390 folded before Flop (didn't bet)
Seat 6: ThalleSx folded before Flop (didn't bet)
Seat 7: fournn folded before Flop (didn't bet)
Seat 8: vagoyras folded before Flop (didn't bet)

PokerStars Hand #251205528139: Tournament #3767885527, $40+$10+$5 USD Hold'em No Limit - Level XI (600/1200) - 2024/06/26 19:02:04 UTC [2024/06/26 15:02:04 ET]
Table '3767885527 61' 8-max Seat #2 is the button
Seat 1: ipayou (24825 in chips) 
Seat 2: MezuuÜuuT (25590 in chips) 
Seat 3: Hjerterdame1 (82366 in chips) 
Seat 4: ederpalasson (45748 in chips) 
Seat 5: nacho2390 (30900 in chips) 
Seat 6: ThalleSx (20030 in chips) 
Seat 7: fournn (58985 in chips) 
Seat 8: vagoyras (48449 in chips) 
ipayou: posts the ante 150
MezuuÜuuT: posts the ante 150
Hjerterdame1: posts the ante 150
ederpalasson: posts the ante 150
nacho2390: posts the ante 150
ThalleSx: posts the ante 150
fournn: posts the ante 150
vagoyras: posts the ante 150
Hjerterdame1: posts small blind 600
ederpalasson: posts big blind 1200
*** HOLE CARDS ***
nacho2390: folds 
ThalleSx: folds 
fournn: folds 
vagoyras: folds 
ipayou: folds 
MezuuÜuuT: raises 1440 to 2640
Hjerterdame1: calls 2040
ederpalasson: folds 
*** FLOP *** [3h Ad 8c]
Hjerterdame1: checks 
MezuuÜuuT: checks 
*** TURN *** [3h Ad 8c] [5d]
Hjerterdame1: checks 
MezuuÜuuT: checks 
*** RIVER *** [3h Ad 8c 5d] [As]
Hjerterdame1: bets 3840
MezuuÜuuT: raises 5160 to 9000
Hjerterdame1: calls 5160
*** SHOW DOWN ***
MezuuÜuuT: shows [6c Ah] (three of a kind, Aces)
Hjerterdame1: shows [Ac 9h] (three of a kind, Aces - Nine kicker)
Hjerterdame1 collected 25680 from pot
*** SUMMARY ***
Total pot 25680 | Rake 0 
Board [3h Ad 8c 5d As]
Seat 1: ipayou folded before Flop (didn't bet)
Seat 2: MezuuÜuuT (button) showed [6c Ah] and lost with three of a kind, Aces
Seat 3: Hjerterdame1 (small blind) showed [Ac 9h] and won (25680) with three of a kind, Aces
Seat 4: ederpalasson (big blind) folded before Flop
Seat 5: nacho2390 folded before Flop (didn't bet)
Seat 6: ThalleSx folded before Flop (didn't bet)
Seat 7: fournn folded before Flop (didn't bet)
Seat 8: vagoyras folded before Flop (didn't bet)

PokerStars Hand #251205548705: Tournament #3767885527, $40+$10+$5 USD Hold'em No Limit - Level XI (600/1200) - 2024/06/26 19:03:27 UTC [2024/06/26 15:03:27 ET]
Table '3767885527 61' 8-max Seat #3 is the button
Seat 1: ipayou (24675 in chips) 
Seat 2: MezuuÜuuT (13800 in chips) 
Seat 3: Hjerterdame1 (96256 in chips) 
Seat 4: ederpalasson (44398 in chips) 
Seat 5: nacho2390 (30750 in chips) 
Seat 6: ThalleSx (19880 in chips) 
Seat 7: fournn (58835 in chips) 
Seat 8: vagoyras (48299 in chips) 
ipayou: posts the ante 150
MezuuÜuuT: posts the ante 150
Hjerterdame1: posts the ante 150
ederpalasson: posts the ante 150
nacho2390: posts the ante 150
ThalleSx: posts the ante 150
fournn: posts the ante 150
vagoyras: posts the ante 150
ederpalasson: posts small blind 600
nacho2390: posts big blind 1200
*** HOLE CARDS ***
ThalleSx: folds 
fournn: folds 
vagoyras: folds 
ipayou: raises 1200 to 2400
MezuuÜuuT: folds 
Hjerterdame1: folds 
ederpalasson: folds 
nacho2390: raises 28200 to 30600 and is all-in
ipayou: folds 
Uncalled bet (28200) returned to nacho2390
nacho2390 collected 6600 from pot
nacho2390: doesn't show hand 
*** SUMMARY ***
Total pot 6600 | Rake 0 
Seat 1: ipayou folded before Flop
Seat 2: MezuuÜuuT folded before Flop (didn't bet)
Seat 3: Hjerterdame1 (button) folded before Flop (didn't bet)
Seat 4: ederpalasson (small blind) folded before Flop
Seat 5: nacho2390 (big blind) collected (6600)
Seat 6: ThalleSx folded before Flop (didn't bet)
Seat 7: fournn folded before Flop (didn't bet)
Seat 8: vagoyras folded before Flop (didn't bet)

PokerStars Hand #251205556518: Tournament #3767885527, $40+$10+$5 USD Hold'em No Limit - Level XI (600/1200) - 2024/06/26 19:03:58 UTC [2024/06/26 15:03:58 ET]
Table '3767885527 61' 8-max Seat #4 is the button
Seat 1: ipayou (22125 in chips) 
Seat 2: MezuuÜuuT (13650 in chips) 
Seat 3: Hjerterdame1 (96106 in chips) 
Seat 4: ederpalasson (43648 in chips) 
Seat 5: nacho2390 (34800 in chips) 
Seat 6: ThalleSx (19730 in chips) 
Seat 7: fournn (58685 in chips) 
Seat 8: vagoyras (48149 in chips) 
ipayou: posts the ante 150
MezuuÜuuT: posts the ante 150
Hjerterdame1: posts the ante 150
ederpalasson: posts the ante 150
nacho2390: posts the ante 150
ThalleSx: posts the ante 150
fournn: posts the ante 150
vagoyras: posts the ante 150
nacho2390: posts small blind 600
ThalleSx: posts big blind 1200
*** HOLE CARDS ***
fournn: folds 
vagoyras: folds 
ipayou: folds 
MezuuÜuuT: folds 
Hjerterdame1: folds 
ederpalasson: folds 
nacho2390: folds 
Uncalled bet (600) returned to ThalleSx
ThalleSx collected 2400 from pot
ThalleSx: doesn't show hand 
*** SUMMARY ***
Total pot 2400 | Rake 0 
Seat 1: ipayou folded before Flop (didn't bet)
Seat 2: MezuuÜuuT folded before Flop (didn't bet)
Seat 3: Hjerterdame1 folded before Flop (didn't bet)
Seat 4: ederpalasson (button) folded before Flop (didn't bet)
Seat 5: nacho2390 (small blind) folded before Flop
Seat 6: ThalleSx (big blind) collected (2400)
Seat 7: fournn folded before Flop (didn't bet)
Seat 8: vagoyras folded before Flop (didn't bet)

PokerStars Hand #251205563690: Tournament #3767885527, $40+$10+$5 USD Hold'em No Limit - Level XI (600/1200) - 2024/06/26 19:04:26 UTC [2024/06/26 15:04:26 ET]
Table '3767885527 61' 8-max Seat #5 is the button
Seat 1: ipayou (21975 in chips) 
Seat 2: MezuuÜuuT (13500 in chips) 
Seat 3: Hjerterdame1 (95956 in chips) 
Seat 4: ederpalasson (43498 in chips) 
Seat 5: nacho2390 (34050 in chips) 
Seat 6: ThalleSx (21380 in chips) 
Seat 7: fournn (58535 in chips) 
Seat 8: vagoyras (47999 in chips) 
ipayou: posts the ante 150
MezuuÜuuT: posts the ante 150
Hjerterdame1: posts the ante 150
ederpalasson: posts the ante 150
nacho2390: posts the ante 150
ThalleSx: posts the ante 150
fournn: posts the ante 150
vagoyras: posts the ante 150
ThalleSx: posts small blind 600
fournn: posts big blind 1200
*** HOLE CARDS ***
vagoyras: folds 
ipayou: raises 1200 to 2400
MezuuÜuuT: folds 
Hjerterdame1: folds 
ederpalasson: raises 3000 to 5400
nacho2390: folds 
ThalleSx: folds 
fournn: folds 
ipayou: raises 16425 to 21825 and is all-in
ederpalasson: folds 
Uncalled bet (16425) returned to ipayou
ipayou collected 13800 from pot
*** SUMMARY ***
Total pot 13800 | Rake 0 
Seat 1: ipayou collected (13800)
Seat 2: MezuuÜuuT folded before Flop (didn't bet)
Seat 3: Hjerterdame1 folded before Flop (didn't bet)
Seat 4: ederpalasson folded before Flop
Seat 5: nacho2390 (button) folded before Flop (didn't bet)
Seat 6: ThalleSx (small blind) folded before Flop
Seat 7: fournn (big blind) folded before Flop
Seat 8: vagoyras folded before Flop (didn't bet)

PokerStars Hand #251205582065: Tournament #3767885527, $40+$10+$5 USD Hold'em No Limit - Level XI (600/1200) - 2024/06/26 19:05:36 UTC [2024/06/26 15:05:36 ET]
Table '3767885527 61' 8-max Seat #6 is the button
Seat 1: ipayou (30225 in chips) 
Seat 2: MezuuÜuuT (13350 in chips) 
Seat 3: Hjerterdame1 (95806 in chips) 
Seat 4: ederpalasson (37948 in chips) 
Seat 5: nacho2390 (33900 in chips) 
Seat 6: ThalleSx (20630 in chips) 
Seat 7: fournn (57185 in chips) 
Seat 8: vagoyras (47849 in chips) 
ipayou: posts the ante 150
MezuuÜuuT: posts the ante 150
Hjerterdame1: posts the ante 150
ederpalasson: posts the ante 150
nacho2390: posts the ante 150
ThalleSx: posts the ante 150
fournn: posts the ante 150
vagoyras: posts the ante 150
fournn: posts small blind 600
vagoyras: posts big blind 1200
*** HOLE CARDS ***
ipayou: folds 
MezuuÜuuT: folds 
Hjerterdame1: folds 
ederpalasson: folds 
nacho2390: folds 
ThalleSx: raises 19280 to 20480 and is all-in
fournn: folds 
vagoyras: folds 
Uncalled bet (19280) returned to ThalleSx
ThalleSx collected 4200 from pot
ThalleSx: doesn't show hand 
*** SUMMARY ***
Total pot 4200 | Rake 0 
Seat 1: ipayou folded before Flop (didn't bet)
Seat 2: MezuuÜuuT folded before Flop (didn't bet)
Seat 3: Hjerterdame1 folded before Flop (didn't bet)
Seat 4: ederpalasson folded before Flop (didn't bet)
Seat 5: nacho2390 folded before Flop (didn't bet)
Seat 6: ThalleSx (button) collected (4200)
Seat 7: fournn (small blind) folded before Flop
Seat 8: vagoyras (big blind) folded before Flop

PokerStars Hand #251205596018: Tournament #3767885527, $40+$10+$5 USD Hold'em No Limit - Level XI (600/1200) - 2024/06/26 19:06:29 UTC [2024/06/26 15:06:29 ET]
Table '3767885527 61' 8-max Seat #7 is the button
Seat 1: ipayou (30075 in chips) 
Seat 2: MezuuÜuuT (13200 in chips) 
Seat 3: Hjerterdame1 (95656 in chips) 
Seat 4: ederpalasson (37798 in chips) 
Seat 5: nacho2390 (33750 in chips) 
Seat 6: ThalleSx (23480 in chips) 
Seat 7: fournn (56435 in chips) 
Seat 8: vagoyras (46499 in chips) 
ipayou: posts the ante 150
MezuuÜuuT: posts the ante 150
Hjerterdame1: posts the ante 150
ederpalasson: posts the ante 150
nacho2390: posts the ante 150
ThalleSx: posts the ante 150
fournn: posts the ante 150
vagoyras: posts the ante 150
vagoyras: posts small blind 600
ipayou: posts big blind 1200
*** HOLE CARDS ***
MezuuÜuuT: folds 
Hjerterdame1: folds 
ederpalasson: folds 
nacho2390: raises 1320 to 2520
ThalleSx: folds 
fournn: folds 
vagoyras: folds 
ipayou: calls 1320
*** FLOP *** [3s 7h Ah]
ipayou: checks 
nacho2390: bets 1800
ipayou: raises 3480 to 5280
nacho2390: calls 3480
*** TURN *** [3s 7h Ah] [7c]
ipayou: bets 7800
nacho2390: calls 7800
*** RIVER *** [3s 7h Ah 7c] [9d]
ipayou: bets 14325 and is all-in
nacho2390: calls 14325
*** SHOW DOWN ***
ipayou: shows [Ad Ts] (two pair, Aces and Sevens)
nacho2390: shows [Qs Qc] (two pair, Queens and Sevens)
ipayou collected 61650 from pot
*** SUMMARY ***
Total pot 61650 | Rake 0 
Board [3s 7h Ah 7c 9d]
Seat 1: ipayou (big blind) showed [Ad Ts] and won (61650) with two pair, Aces and Sevens
Seat 2: MezuuÜuuT folded before Flop (didn't bet)
Seat 3: Hjerterdame1 folded before Flop (didn't bet)
Seat 4: ederpalasson folded before Flop (didn't bet)
Seat 5: nacho2390 showed [Qs Qc] and lost with two pair, Queens and Sevens
Seat 6: ThalleSx folded before Flop (didn't bet)
Seat 7: fournn (button) folded before Flop (didn't bet)
Seat 8: vagoyras (small blind) folded before Flop

PokerStars Hand #251205629947: Tournament #3767885527, $40+$10+$5 USD Hold'em No Limit - Level XI (600/1200) - 2024/06/26 19:08:36 UTC [2024/06/26 15:08:36 ET]
Table '3767885527 61' 8-max Seat #8 is the button
Seat 1: ipayou (61650 in chips) 
Seat 2: MezuuÜuuT (13050 in chips) 
Seat 3: Hjerterdame1 (95506 in chips) 
Seat 4: ederpalasson (37648 in chips) 
Seat 5: nacho2390 (3675 in chips) 
Seat 6: ThalleSx (23330 in chips) 
Seat 7: fournn (56285 in chips) 
Seat 8: vagoyras (45749 in chips) 
ipayou: posts the ante 150
MezuuÜuuT: posts the ante 150
Hjerterdame1: posts the ante 150
ederpalasson: posts the ante 150
nacho2390: posts the ante 150
ThalleSx: posts the ante 150
fournn: posts the ante 150
vagoyras: posts the ante 150
ipayou: posts small blind 600
MezuuÜuuT: posts big blind 1200
*** HOLE CARDS ***
Hjerterdame1: folds 
ederpalasson: folds 
nacho2390: folds 
ThalleSx: folds 
fournn: folds 
vagoyras: folds 
ipayou: raises 1320 to 2520
MezuuÜuuT: calls 1320
*** FLOP *** [Qh Kd 7c]
ipayou: checks 
MezuuÜuuT: checks 
*** TURN *** [Qh Kd 7c] [9h]
ipayou: bets 1800
MezuuÜuuT: folds 
Uncalled bet (1800) returned to ipayou
ipayou collected 6240 from pot
*** SUMMARY ***
Total pot 6240 | Rake 0 
Board [Qh Kd 7c 9h]
Seat 1: ipayou (small blind) collected (6240)
Seat 2: MezuuÜuuT (big blind) folded on the Turn
Seat 3: Hjerterdame1 folded before Flop (didn't bet)
Seat 4: ederpalasson folded before Flop (didn't bet)
Seat 5: nacho2390 folded before Flop (didn't bet)
Seat 6: ThalleSx folded before Flop (didn't bet)
Seat 7: fournn folded before Flop (didn't bet)
Seat 8: vagoyras (button) folded before Flop (didn't bet)

PokerStars Hand #251205645549: Tournament #3767885527, $40+$10+$5 USD Hold'em No Limit - Level XII (700/1400) - 2024/06/26 19:09:35 UTC [2024/06/26 15:09:35 ET]
Table '3767885527 61' 8-max Seat #1 is the button
Seat 1: ipayou (65220 in chips) 
Seat 2: MezuuÜuuT (10380 in chips) 
Seat 3: Hjerterdame1 (95356 in chips) 
Seat 4: ederpalasson (37498 in chips) 
Seat 5: nacho2390 (3525 in chips) 
Seat 6: ThalleSx (23180 in chips) 
Seat 7: fournn (56135 in chips) 
Seat 8: vagoyras (45599 in chips) 
ipayou: posts the ante 175
MezuuÜuuT: posts the ante 175
Hjerterdame1: posts the ante 175
ederpalasson: posts the ante 175
nacho2390: posts the ante 175
ThalleSx: posts the ante 175
fournn: posts the ante 175
vagoyras: posts the ante 175
MezuuÜuuT: posts small blind 700
Hjerterdame1: posts big blind 1400
*** HOLE CARDS ***
ederpalasson: folds 
nacho2390: folds 
ThalleSx: folds 
fournn: raises 1680 to 3080
vagoyras: folds 
ipayou: folds 
MezuuÜuuT: folds 
Hjerterdame1: folds 
Uncalled bet (1680) returned to fournn
fournn collected 4900 from pot
fournn: doesn't show hand 
*** SUMMARY ***
Total pot 4900 | Rake 0 
Seat 1: ipayou (button) folded before Flop (didn't bet)
Seat 2: MezuuÜuuT (small blind) folded before Flop
Seat 3: Hjerterdame1 (big blind) folded before Flop
Seat 4: ederpalasson folded before Flop (didn't bet)
Seat 5: nacho2390 folded before Flop (didn't bet)
Seat 6: ThalleSx folded before Flop (didn't bet)
Seat 7: fournn collected (4900)
Seat 8: vagoyras folded before Flop (didn't bet)

PokerStars Hand #251205652198: Tournament #3767885527, $40+$10+$5 USD Hold'em No Limit - Level XII (700/1400) - 2024/06/26 19:09:59 UTC [2024/06/26 15:09:59 ET]
Table '3767885527 61' 8-max Seat #2 is the button
Seat 1: ipayou (65045 in chips) 
Seat 2: MezuuÜuuT (9505 in chips) 
Seat 3: Hjerterdame1 (93781 in chips) 
Seat 4: ederpalasson (37323 in chips) 
Seat 5: nacho2390 (3350 in chips) 
Seat 6: ThalleSx (23005 in chips) 
Seat 7: fournn (59460 in chips) 
Seat 8: vagoyras (45424 in chips) 
ipayou: posts the ante 175
MezuuÜuuT: posts the ante 175
Hjerterdame1: posts the ante 175
ederpalasson: posts the ante 175
nacho2390: posts the ante 175
ThalleSx: posts the ante 175
fournn: posts the ante 175
vagoyras: posts the ante 175
Hjerterdame1: posts small blind 700
ederpalasson: posts big blind 1400
*** HOLE CARDS ***
nacho2390: folds 
ThalleSx: folds 
fournn: folds 
vagoyras: folds 
ipayou: folds 
MezuuÜuuT: folds 
Hjerterdame1: raises 2800 to 4200
ederpalasson: raises 6300 to 10500
Hjerterdame1: calls 6300
*** FLOP *** [Jc 2h 9d]
Hjerterdame1: bets 11200
ederpalasson: folds 
Uncalled bet (11200) returned to Hjerterdame1
Hjerterdame1 collected 22400 from pot
Hjerterdame1: doesn't show hand 
*** SUMMARY ***
Total pot 22400 | Rake 0 
Board [Jc 2h 9d]
Seat 1: ipayou folded before Flop (didn't bet)
Seat 2: MezuuÜuuT (button) folded before Flop (didn't bet)
Seat 3: Hjerterdame1 (small blind) collected (22400)
Seat 4: ederpalasson (big blind) folded on the Flop
Seat 5: nacho2390 folded before Flop (didn't bet)
Seat 6: ThalleSx folded before Flop (didn't bet)
Seat 7: fournn folded before Flop (didn't bet)
Seat 8: vagoyras folded before Flop (didn't bet)

PokerStars Hand #251205669543: Tournament #3767885527, $40+$10+$5 USD Hold'em No Limit - Level XII (700/1400) - 2024/06/26 19:11:04 UTC [2024/06/26 15:11:04 ET]
Table '3767885527 61' 8-max Seat #3 is the button
Seat 1: ipayou (64870 in chips) 
Seat 2: MezuuÜuuT (9330 in chips) 
Seat 3: Hjerterdame1 (105506 in chips) 
Seat 4: ederpalasson (26648 in chips) 
Seat 5: nacho2390 (3175 in chips) 
Seat 6: ThalleSx (22830 in chips) 
Seat 7: fournn (59285 in chips) 
Seat 8: vagoyras (45249 in chips) 
ipayou: posts the ante 175
MezuuÜuuT: posts the ante 175
Hjerterdame1: posts the ante 175
ederpalasson: posts the ante 175
nacho2390: posts the ante 175
ThalleSx: posts the ante 175
fournn: posts the ante 175
vagoyras: posts the ante 175
ederpalasson: posts small blind 700
nacho2390: posts big blind 1400
*** HOLE CARDS ***
ThalleSx: folds 
fournn: folds 
vagoyras: folds 
ipayou: folds 
MezuuÜuuT: folds 
Hjerterdame1: folds 
ederpalasson: raises 2800 to 4200
nacho2390: calls 1600 and is all-in
Uncalled bet (1200) returned to ederpalasson
*** FLOP *** [Ks 7h Jh]
*** TURN *** [Ks 7h Jh] [Kh]
*** RIVER *** [Ks 7h Jh Kh] [Ah]
*** SHOW DOWN ***
ederpalasson: shows [As Jc] (two pair, Aces and Kings)
nacho2390: shows [3h 2s] (a flush, Ace high)
nacho2390 collected 7400 from pot
*** SUMMARY ***
Total pot 7400 | Rake 0 
Board [Ks 7h Jh Kh Ah]
Seat 1: ipayou folded before Flop (didn't bet)
Seat 2: MezuuÜuuT folded before Flop (didn't bet)
Seat 3: Hjerterdame1 (button) folded before Flop (didn't bet)
Seat 4: ederpalasson (small blind) showed [As Jc] and lost with two pair, Aces and Kings
Seat 5: nacho2390 (big blind) showed [3h 2s] and won (7400) with a flush, Ace high
Seat 6: ThalleSx folded before Flop (didn't bet)
Seat 7: fournn folded before Flop (didn't bet)
Seat 8: vagoyras folded before Flop (didn't bet)

PokerStars Hand #251205680094: Tournament #3767885527, $40+$10+$5 USD Hold'em No Limit - Level XII (700/1400) - 2024/06/26 19:11:43 UTC [2024/06/26 15:11:43 ET]
Table '3767885527 61' 8-max Seat #4 is the button
Seat 1: ipayou (64695 in chips) 
Seat 2: MezuuÜuuT (9155 in chips) 
Seat 3: Hjerterdame1 (105331 in chips) 
Seat 4: ederpalasson (23473 in chips) 
Seat 5: nacho2390 (7400 in chips) 
Seat 6: ThalleSx (22655 in chips) 
Seat 7: fournn (59110 in chips) 
Seat 8: vagoyras (45074 in chips) 
ipayou: posts the ante 175
MezuuÜuuT: posts the ante 175
Hjerterdame1: posts the ante 175
ederpalasson: posts the ante 175
nacho2390: posts the ante 175
ThalleSx: posts the ante 175
fournn: posts the ante 175
vagoyras: posts the ante 175
nacho2390: posts small blind 700
ThalleSx: posts big blind 1400
*** HOLE CARDS ***
fournn: folds 
vagoyras: folds 
ipayou: folds 
MezuuÜuuT: folds 
Hjerterdame1: folds 
ederpalasson: folds 
nacho2390: raises 5825 to 7225 and is all-in
ThalleSx: calls 5825
*** FLOP *** [Qc 6c Ad]
*** TURN *** [Qc 6c Ad] [6h]
*** RIVER *** [Qc 6c Ad 6h] [9c]
*** SHOW DOWN ***
nacho2390: shows [Kh Qh] (two pair, Queens and Sixes)
ThalleSx: shows [5c Td] (a pair of Sixes)
nacho2390 collected 15850 from pot
*** SUMMARY ***
Total pot 15850 | Rake 0 
Board [Qc 6c Ad 6h 9c]
Seat 1: ipayou folded before Flop (didn't bet)
Seat 2: MezuuÜuuT folded before Flop (didn't bet)
Seat 3: Hjerterdame1 folded before Flop (didn't bet)
Seat 4: ederpalasson (button) folded before Flop (didn't bet)
Seat 5: nacho2390 (small blind) showed [Kh Qh] and won (15850) with two pair, Queens and Sixes
Seat 6: ThalleSx (big blind) showed [5c Td] and lost with a pair of Sixes
Seat 7: fournn folded before Flop (didn't bet)
Seat 8: vagoyras folded before Flop (didn't bet)

PokerStars Hand #251205691552: Tournament #3767885527, $40+$10+$5 USD Hold'em No Limit - Level XII (700/1400) - 2024/06/26 19:12:25 UTC [2024/06/26 15:12:25 ET]
Table '3767885527 61' 8-max Seat #5 is the button
Seat 1: ipayou (64520 in chips) 
Seat 2: MezuuÜuuT (8980 in chips) 
Seat 3: Hjerterdame1 (105156 in chips) 
Seat 4: ederpalasson (23298 in chips) 
Seat 5: nacho2390 (15850 in chips) 
Seat 6: ThalleSx (15255 in chips) 
Seat 7: fournn (58935 in chips) 
Seat 8: vagoyras (44899 in chips) 
ipayou: posts the ante 175
MezuuÜuuT: posts the ante 175
Hjerterdame1: posts the ante 175
ederpalasson: posts the ante 175
nacho2390: posts the ante 175
ThalleSx: posts the ante 175
fournn: posts the ante 175
vagoyras: posts the ante 175
ThalleSx: posts small blind 700
fournn: posts big blind 1400
*** HOLE CARDS ***
vagoyras: raises 1400 to 2800
ipayou: folds 
MezuuÜuuT: folds 
Hjerterdame1: folds 
ederpalasson: folds 
nacho2390: folds 
ThalleSx: raises 12280 to 15080 and is all-in
fournn: raises 43680 to 58760 and is all-in
vagoyras: folds 
Uncalled bet (43680) returned to fournn
*** FLOP *** [5s 3c 9d]
*** TURN *** [5s 3c 9d] [Ah]
*** RIVER *** [5s 3c 9d Ah] [Jd]
*** SHOW DOWN ***
ThalleSx: shows [Kh Ac] (a pair of Aces)
fournn: shows [Qd As] (a pair of Aces - lower kicker)
ThalleSx collected 34360 from pot
*** SUMMARY ***
Total pot 34360 | Rake 0 
Board [5s 3c 9d Ah Jd]
Seat 1: ipayou folded before Flop (didn't bet)
Seat 2: MezuuÜuuT folded before Flop (didn't bet)
Seat 3: Hjerterdame1 folded before Flop (didn't bet)
Seat 4: ederpalasson folded before Flop (didn't bet)
Seat 5: nacho2390 (button) folded before Flop (didn't bet)
Seat 6: ThalleSx (small blind) showed [Kh Ac] and won (34360) with a pair of Aces
Seat 7: fournn (big blind) showed [Qd As] and lost with a pair of Aces
Seat 8: vagoyras folded before Flop

PokerStars Hand #251205706826: Tournament #3767885527, $40+$10+$5 USD Hold'em No Limit - Level XII (700/1400) - 2024/06/26 19:13:21 UTC [2024/06/26 15:13:21 ET]
Table '3767885527 61' 8-max Seat #6 is the button
Seat 1: ipayou (64345 in chips) 
Seat 2: MezuuÜuuT (8805 in chips) 
Seat 3: Hjerterdame1 (104981 in chips) 
Seat 4: ederpalasson (23123 in chips) 
Seat 5: nacho2390 (15675 in chips) 
Seat 6: ThalleSx (34360 in chips) 
Seat 7: fournn (43680 in chips) 
Seat 8: vagoyras (41924 in chips) 
ipayou: posts the ante 175
MezuuÜuuT: posts the ante 175
Hjerterdame1: posts the ante 175
ederpalasson: posts the ante 175
nacho2390: posts the ante 175
ThalleSx: posts the ante 175
fournn: posts the ante 175
vagoyras: posts the ante 175
fournn: posts small blind 700
vagoyras: posts big blind 1400
*** HOLE CARDS ***
ipayou: folds 
MezuuÜuuT: folds 
Hjerterdame1: folds 
ederpalasson: raises 1400 to 2800
nacho2390: folds 
ThalleSx: folds 
fournn: folds 
vagoyras: folds 
Uncalled bet (1400) returned to ederpalasson
ederpalasson collected 4900 from pot
ederpalasson: doesn't show hand 
*** SUMMARY ***
Total pot 4900 | Rake 0 
Seat 1: ipayou folded before Flop (didn't bet)
Seat 2: MezuuÜuuT folded before Flop (didn't bet)
Seat 3: Hjerterdame1 folded before Flop (didn't bet)
Seat 4: ederpalasson collected (4900)
Seat 5: nacho2390 folded before Flop (didn't bet)
Seat 6: ThalleSx (button) folded before Flop (didn't bet)
Seat 7: fournn (small blind) folded before Flop
Seat 8: vagoyras (big blind) folded before Flop

PokerStars Hand #251205714150: Tournament #3767885527, $40+$10+$5 USD Hold'em No Limit - Level XII (700/1400) - 2024/06/26 19:13:49 UTC [2024/06/26 15:13:49 ET]
Table '3767885527 61' 8-max Seat #7 is the button
Seat 2: MezuuÜuuT (8630 in chips) 
Seat 3: Hjerterdame1 (104806 in chips) 
Seat 4: ederpalasson (26448 in chips) 
Seat 5: nacho2390 (15500 in chips) 
Seat 6: ThalleSx (34185 in chips) 
Seat 7: fournn (42805 in chips) 
Seat 8: vagoyras (40349 in chips) 
MezuuÜuuT: posts the ante 175
Hjerterdame1: posts the ante 175
ederpalasson: posts the ante 175
nacho2390: posts the ante 175
ThalleSx: posts the ante 175
fournn: posts the ante 175
vagoyras: posts the ante 175
vagoyras: posts small blind 700
MezuuÜuuT: posts big blind 1400
*** HOLE CARDS ***
Hjerterdame1: folds 
ederpalasson: raises 1400 to 2800
nacho2390: folds 
ThalleSx: folds 
fournn: folds 
vagoyras: folds 
MezuuÜuuT: calls 1400
*** FLOP *** [Qs 2d 5c]
MezuuÜuuT: checks 
ederpalasson: bets 7000
MezuuÜuuT: calls 5655 and is all-in
Uncalled bet (1345) returned to ederpalasson
*** TURN *** [Qs 2d 5c] [9h]
*** RIVER *** [Qs 2d 5c 9h] [2c]
*** SHOW DOWN ***
MezuuÜuuT: shows [5h Ah] (two pair, Fives and Deuces)
ederpalasson: shows [Kc Jc] (a pair of Deuces)
MezuuÜuuT collected 18835 from pot
*** SUMMARY ***
Total pot 18835 | Rake 0 
Board [Qs 2d 5c 9h 2c]
Seat 2: MezuuÜuuT (big blind) showed [5h Ah] and won (18835) with two pair, Fives and Deuces
Seat 3: Hjerterdame1 folded before Flop (didn't bet)
Seat 4: ederpalasson showed [Kc Jc] and lost with a pair of Deuces
Seat 5: nacho2390 folded before Flop (didn't bet)
Seat 6: ThalleSx folded before Flop (didn't bet)
Seat 7: fournn (button) folded before Flop (didn't bet)
Seat 8: vagoyras (small blind) folded before Flop

PokerStars Hand #251205733267: Tournament #3767885527, $40+$10+$5 USD Hold'em No Limit - Level XII (700/1400) - 2024/06/26 19:14:59 UTC [2024/06/26 15:14:59 ET]
Table '3767885527 61' 8-max Seat #8 is the button
Seat 2: MezuuÜuuT (18835 in chips) 
Seat 3: Hjerterdame1 (104631 in chips) 
Seat 4: ederpalasson (17818 in chips) 
Seat 5: nacho2390 (15325 in chips) 
Seat 6: ThalleSx (34010 in chips) 
Seat 7: fournn (42630 in chips) 
Seat 8: vagoyras (39474 in chips) 
MezuuÜuuT: posts the ante 175
Hjerterdame1: posts the ante 175
ederpalasson: posts the ante 175
nacho2390: posts the ante 175
ThalleSx: posts the ante 175
fournn: posts the ante 175
vagoyras: posts the ante 175
MezuuÜuuT: posts small blind 700
Hjerterdame1: posts big blind 1400
*** HOLE CARDS ***
ederpalasson: folds 
nacho2390: folds 
ThalleSx: raises 1400 to 2800
MyOnlyMemory is disconnected 
fournn: folds 
vagoyras: folds 
MezuuÜuuT: folds 
Hjerterdame1: folds 
Uncalled bet (1400) returned to ThalleSx
ThalleSx collected 4725 from pot
ThalleSx: doesn't show hand 
*** SUMMARY ***
Total pot 4725 | Rake 0 
Seat 2: MezuuÜuuT (small blind) folded before Flop
Seat 3: Hjerterdame1 (big blind) folded before Flop
Seat 4: ederpalasson folded before Flop (didn't bet)
Seat 5: nacho2390 folded before Flop (didn't bet)
Seat 6: ThalleSx collected (4725)
Seat 7: fournn folded before Flop (didn't bet)
Seat 8: vagoyras (button) folded before Flop (didn't bet)

PokerStars Hand #251205741477: Tournament #3767885527, $40+$10+$5 USD Hold'em No Limit - Level XII (700/1400) - 2024/06/26 19:15:29 UTC [2024/06/26 15:15:29 ET]
Table '3767885527 61' 8-max Seat #2 is the button
Seat 1: MyOnlyMemory (25000 in chips) 
Seat 2: MezuuÜuuT (17960 in chips) 
Seat 3: Hjerterdame1 (103056 in chips) 
Seat 4: ederpalasson (17643 in chips) 
Seat 5: nacho2390 (15150 in chips) 
Seat 6: ThalleSx (37160 in chips) 
Seat 7: fournn (42455 in chips) 
Seat 8: vagoyras (39299 in chips) 
MyOnlyMemory: posts the ante 175
MezuuÜuuT: posts the ante 175
Hjerterdame1: posts the ante 175
ederpalasson: posts the ante 175
nacho2390: posts the ante 175
ThalleSx: posts the ante 175
fournn: posts the ante 175
vagoyras: posts the ante 175
Hjerterdame1: posts small blind 700
ederpalasson: posts big blind 1400
*** HOLE CARDS ***
nacho2390: folds 
ThalleSx: folds 
fournn: folds 
vagoyras: folds 
MyOnlyMemory: raises 23425 to 24825 and is all-in
MezuuÜuuT: folds 
Hjerterdame1 has timed out
Hjerterdame1: folds 
Hjerterdame1 is sitting out
ederpalasson: folds 
Uncalled bet (23425) returned to MyOnlyMemory
MyOnlyMemory collected 4900 from pot
*** SUMMARY ***
Total pot 4900 | Rake 0 
Seat 1: MyOnlyMemory collected (4900)
Seat 2: MezuuÜuuT (button) folded before Flop (didn't bet)
Seat 3: Hjerterdame1 (small blind) folded before Flop
Seat 4: ederpalasson (big blind) folded before Flop
Seat 5: nacho2390 folded before Flop (didn't bet)
Seat 6: ThalleSx folded before Flop (didn't bet)
Seat 7: fournn folded before Flop (didn't bet)
Seat 8: vagoyras folded before Flop (didn't bet)

PokerStars Hand #251205775063: Tournament #3767885527, $40+$10+$5 USD Hold'em No Limit - Level XII (700/1400) - 2024/06/26 19:17:33 UTC [2024/06/26 15:17:33 ET]
Table '3767885527 61' 8-max Seat #3 is the button
Seat 1: MyOnlyMemory (28325 in chips) 
Seat 2: MezuuÜuuT (17785 in chips) 
Seat 3: Hjerterdame1 (102181 in chips) is sitting out
Seat 4: ederpalasson (16068 in chips) 
Seat 5: nacho2390 (14975 in chips) 
Seat 6: ThalleSx (36985 in chips) 
Seat 7: fournn (42280 in chips) 
Seat 8: vagoyras (39124 in chips) 
MyOnlyMemory: posts the ante 175
MezuuÜuuT: posts the ante 175
Hjerterdame1: posts the ante 175
ederpalasson: posts the ante 175
nacho2390: posts the ante 175
ThalleSx: posts the ante 175
fournn: posts the ante 175
vagoyras: posts the ante 175
ederpalasson: posts small blind 700
nacho2390: posts big blind 1400
*** HOLE CARDS ***
ThalleSx: folds 
fournn: folds 
vagoyras: folds 
MyOnlyMemory: folds 
MezuuÜuuT: raises 16210 to 17610 and is all-in
Hjerterdame1: folds 
ederpalasson: folds 
nacho2390: folds 
Uncalled bet (16210) returned to MezuuÜuuT
MezuuÜuuT collected 4900 from pot
MezuuÜuuT: doesn't show hand 
*** SUMMARY ***
Total pot 4900 | Rake 0 
Seat 1: MyOnlyMemory folded before Flop (didn't bet)
Seat 2: MezuuÜuuT collected (4900)
Seat 3: Hjerterdame1 (button) folded before Flop (didn't bet)
Seat 4: ederpalasson (small blind) folded before Flop
Seat 5: nacho2390 (big blind) folded before Flop
Seat 6: ThalleSx folded before Flop (didn't bet)
Seat 7: fournn folded before Flop (didn't bet)
Seat 8: vagoyras folded before Flop (didn't bet)

PokerStars Hand #251205782758: Tournament #3767885527, $40+$10+$5 USD Hold'em No Limit - Level XII (700/1400) - 2024/06/26 19:18:01 UTC [2024/06/26 15:18:01 ET]
Table '3767885527 61' 8-max Seat #4 is the button
Seat 1: MyOnlyMemory (28150 in chips) 
Seat 2: MezuuÜuuT (21110 in chips) 
Seat 3: Hjerterdame1 (102006 in chips) is sitting out
Seat 4: ederpalasson (15193 in chips) 
Seat 5: nacho2390 (13400 in chips) 
Seat 6: ThalleSx (36810 in chips) 
Seat 7: fournn (42105 in chips) 
Seat 8: vagoyras (38949 in chips) 
MyOnlyMemory: posts the ante 175
MezuuÜuuT: posts the ante 175
Hjerterdame1: posts the ante 175
ederpalasson: posts the ante 175
nacho2390: posts the ante 175
ThalleSx: posts the ante 175
fournn: posts the ante 175
vagoyras: posts the ante 175
nacho2390: posts small blind 700
ThalleSx: posts big blind 1400
*** HOLE CARDS ***
fournn: folds 
vagoyras: folds 
MyOnlyMemory: folds 
MezuuÜuuT: folds 
Hjerterdame1: folds 
ederpalasson: raises 13618 to 15018 and is all-in
nacho2390: folds 
ThalleSx: folds 
Uncalled bet (13618) returned to ederpalasson
ederpalasson collected 4900 from pot
ederpalasson: doesn't show hand 
*** SUMMARY ***
Total pot 4900 | Rake 0 
Seat 1: MyOnlyMemory folded before Flop (didn't bet)
Seat 2: MezuuÜuuT folded before Flop (didn't bet)
Seat 3: Hjerterdame1 folded before Flop (didn't bet)
Seat 4: ederpalasson (button) collected (4900)
Seat 5: nacho2390 (small blind) folded before Flop
Seat 6: ThalleSx (big blind) folded before Flop
Seat 7: fournn folded before Flop (didn't bet)
Seat 8: vagoyras folded before Flop (didn't bet)

PokerStars Hand #251205791259: Tournament #3767885527, $40+$10+$5 USD Hold'em No Limit - Level XII (700/1400) - 2024/06/26 19:18:32 UTC [2024/06/26 15:18:32 ET]
Table '3767885527 61' 8-max Seat #5 is the button
Seat 1: MyOnlyMemory (27975 in chips) 
Seat 2: MezuuÜuuT (20935 in chips) 
Seat 3: Hjerterdame1 (101831 in chips) is sitting out
Seat 4: ederpalasson (18518 in chips) 
Seat 5: nacho2390 (12525 in chips) 
Seat 6: ThalleSx (35235 in chips) 
Seat 7: fournn (41930 in chips) 
Seat 8: vagoyras (38774 in chips) 
MyOnlyMemory: posts the ante 175
MezuuÜuuT: posts the ante 175
Hjerterdame1: posts the ante 175
ederpalasson: posts the ante 175
nacho2390: posts the ante 175
ThalleSx: posts the ante 175
fournn: posts the ante 175
vagoyras: posts the ante 175
ThalleSx: posts small blind 700
fournn: posts big blind 1400
*** HOLE CARDS ***
vagoyras: folds 
Hjerterdame1 has returned
MyOnlyMemory: raises 1400 to 2800
MezuuÜuuT: folds 
Hjerterdame1: calls 2800
ederpalasson: folds 
nacho2390: folds 
ThalleSx: folds 
fournn: calls 1400
*** FLOP *** [Th 2s Ad]
fournn: checks 
MyOnlyMemory: checks 
Hjerterdame1: bets 4200
fournn: folds 
MyOnlyMemory: folds 
Uncalled bet (4200) returned to Hjerterdame1
Hjerterdame1 collected 10500 from pot
Hjerterdame1: doesn't show hand 
*** SUMMARY ***
Total pot 10500 | Rake 0 
Board [Th 2s Ad]
Seat 1: MyOnlyMemory folded on the Flop
Seat 2: MezuuÜuuT folded before Flop (didn't bet)
Seat 3: Hjerterdame1 collected (10500)
Seat 4: ederpalasson folded before Flop (didn't bet)
Seat 5: nacho2390 (button) folded before Flop (didn't bet)
Seat 6: ThalleSx (small blind) folded before Flop
Seat 7: fournn (big blind) folded on the Flop
Seat 8: vagoyras folded before Flop (didn't bet)

PokerStars Hand #251205815348: Tournament #3767885527, $40+$10+$5 USD Hold'em No Limit - Level XIII (800/1600) - 2024/06/26 19:20:00 UTC [2024/06/26 15:20:00 ET]
Table '3767885527 61' 8-max Seat #6 is the button
Seat 1: MyOnlyMemory (25000 in chips) 
Seat 2: MezuuÜuuT (20760 in chips) 
Seat 3: Hjerterdame1 (109356 in chips) 
Seat 4: ederpalasson (18343 in chips) 
Seat 5: nacho2390 (12350 in chips) 
Seat 6: ThalleSx (34360 in chips) 
Seat 7: fournn (38955 in chips) 
Seat 8: vagoyras (38599 in chips) 
MyOnlyMemory: posts the ante 200
MezuuÜuuT: posts the ante 200
Hjerterdame1: posts the ante 200
ederpalasson: posts the ante 200
nacho2390: posts the ante 200
ThalleSx: posts the ante 200
fournn: posts the ante 200
vagoyras: posts the ante 200
fournn: posts small blind 800
vagoyras: posts big blind 1600
*** HOLE CARDS ***
MyOnlyMemory: folds 
MezuuÜuuT: folds 
Hjerterdame1: folds 
ederpalasson: folds 
nacho2390: raises 10550 to 12150 and is all-in
ThalleSx: folds 
fournn: raises 26605 to 38755 and is all-in
vagoyras: folds 
Uncalled bet (26605) returned to fournn
*** FLOP *** [Qs 4c 9d]
*** TURN *** [Qs 4c 9d] [Jd]
*** RIVER *** [Qs 4c 9d Jd] [7c]
*** SHOW DOWN ***
fournn: shows [9s Ad] (a pair of Nines)
nacho2390: shows [Ah Jc] (a pair of Jacks)
nacho2390 collected 27500 from pot
*** SUMMARY ***
Total pot 27500 | Rake 0 
Board [Qs 4c 9d Jd 7c]
Seat 1: MyOnlyMemory folded before Flop (didn't bet)
Seat 2: MezuuÜuuT folded before Flop (didn't bet)
Seat 3: Hjerterdame1 folded before Flop (didn't bet)
Seat 4: ederpalasson folded before Flop (didn't bet)
Seat 5: nacho2390 showed [Ah Jc] and won (27500) with a pair of Jacks
Seat 6: ThalleSx (button) folded before Flop (didn't bet)
Seat 7: fournn (small blind) showed [9s Ad] and lost with a pair of Nines
Seat 8: vagoyras (big blind) folded before Flop

PokerStars Hand #251205827390: Tournament #3767885527, $40+$10+$5 USD Hold'em No Limit - Level XIII (800/1600) - 2024/06/26 19:20:45 UTC [2024/06/26 15:20:45 ET]
Table '3767885527 61' 8-max Seat #7 is the button
Seat 1: MyOnlyMemory (24800 in chips) 
Seat 2: MezuuÜuuT (20560 in chips) 
Seat 3: Hjerterdame1 (109156 in chips) 
Seat 4: ederpalasson (18143 in chips) 
Seat 5: nacho2390 (27500 in chips) 
Seat 6: ThalleSx (34160 in chips) 
Seat 7: fournn (26605 in chips) 
Seat 8: vagoyras (36799 in chips) 
MyOnlyMemory: posts the ante 200
MezuuÜuuT: posts the ante 200
Hjerterdame1: posts the ante 200
ederpalasson: posts the ante 200
nacho2390: posts the ante 200
ThalleSx: posts the ante 200
fournn: posts the ante 200
vagoyras: posts the ante 200
vagoyras: posts small blind 800
MyOnlyMemory: posts big blind 1600
*** HOLE CARDS ***
MezuuÜuuT: folds 
Hjerterdame1: folds 
ederpalasson: folds 
nacho2390: calls 1600
ThalleSx: folds 
fournn: folds 
vagoyras: raises 4000 to 5600
MyOnlyMemory: folds 
nacho2390: folds 
Uncalled bet (4000) returned to vagoyras
vagoyras collected 6400 from pot
vagoyras: doesn't show hand 
*** SUMMARY ***
Total pot 6400 | Rake 0 
Seat 1: MyOnlyMemory (big blind) folded before Flop
Seat 2: MezuuÜuuT folded before Flop (didn't bet)
Seat 3: Hjerterdame1 folded before Flop (didn't bet)
Seat 4: ederpalasson folded before Flop (didn't bet)
Seat 5: nacho2390 folded before Flop
Seat 6: ThalleSx folded before Flop (didn't bet)
Seat 7: fournn (button) folded before Flop (didn't bet)
Seat 8: vagoyras (small blind) collected (6400)

PokerStars Hand #251205846835: Tournament #3767885527, $40+$10+$5 USD Hold'em No Limit - Level XIII (800/1600) - 2024/06/26 19:21:56 UTC [2024/06/26 15:21:56 ET]
Table '3767885527 61' 8-max Seat #8 is the button
Seat 1: MyOnlyMemory (23000 in chips) 
Seat 2: MezuuÜuuT (20360 in chips) 
Seat 3: Hjerterdame1 (108956 in chips) 
Seat 4: ederpalasson (17943 in chips) 
Seat 5: nacho2390 (25700 in chips) 
Seat 6: ThalleSx (33960 in chips) 
Seat 7: fournn (26405 in chips) 
Seat 8: vagoyras (41399 in chips) 
MyOnlyMemory: posts the ante 200
MezuuÜuuT: posts the ante 200
Hjerterdame1: posts the ante 200
ederpalasson: posts the ante 200
nacho2390: posts the ante 200
ThalleSx: posts the ante 200
fournn: posts the ante 200
vagoyras: posts the ante 200
MyOnlyMemory: posts small blind 800
MezuuÜuuT: posts big blind 1600
*** HOLE CARDS ***
Hjerterdame1: raises 1600 to 3200
ederpalasson: folds 
nacho2390: folds 
ThalleSx: folds 
fournn: folds 
vagoyras: folds 
MyOnlyMemory: raises 19600 to 22800 and is all-in
MezuuÜuuT: folds 
Hjerterdame1: folds [Ah]
Uncalled bet (19600) returned to MyOnlyMemory
MyOnlyMemory collected 9600 from pot
*** SUMMARY ***
Total pot 9600 | Rake 0 
Seat 1: MyOnlyMemory (small blind) collected (9600)
Seat 2: MezuuÜuuT (big blind) folded before Flop
Seat 3: Hjerterdame1 folded before Flop
Seat 4: ederpalasson folded before Flop (didn't bet)
Seat 5: nacho2390 folded before Flop (didn't bet)
Seat 6: ThalleSx folded before Flop (didn't bet)
Seat 7: fournn folded before Flop (didn't bet)
Seat 8: vagoyras (button) folded before Flop (didn't bet)

PokerStars Hand #251205858889: Tournament #3767885527, $40+$10+$5 USD Hold'em No Limit - Level XIII (800/1600) - 2024/06/26 19:22:40 UTC [2024/06/26 15:22:40 ET]
Table '3767885527 61' 8-max Seat #1 is the button
Seat 1: MyOnlyMemory (29200 in chips) 
Seat 2: MezuuÜuuT (18560 in chips) 
Seat 3: Hjerterdame1 (105556 in chips) 
Seat 4: ederpalasson (17743 in chips) 
Seat 5: nacho2390 (25500 in chips) 
Seat 6: ThalleSx (33760 in chips) 
Seat 7: fournn (26205 in chips) 
Seat 8: vagoyras (41199 in chips) 
MyOnlyMemory: posts the ante 200
MezuuÜuuT: posts the ante 200
Hjerterdame1: posts the ante 200
ederpalasson: posts the ante 200
nacho2390: posts the ante 200
ThalleSx: posts the ante 200
fournn: posts the ante 200
vagoyras: posts the ante 200
MezuuÜuuT: posts small blind 800
Hjerterdame1: posts big blind 1600
*** HOLE CARDS ***
ederpalasson: raises 1600 to 3200
nacho2390: folds 
ThalleSx: folds 
fournn: folds 
vagoyras: folds 
MyOnlyMemory: folds 
MezuuÜuuT: folds 
Hjerterdame1: folds 
Uncalled bet (1600) returned to ederpalasson
ederpalasson collected 5600 from pot
ederpalasson: doesn't show hand 
*** SUMMARY ***
Total pot 5600 | Rake 0 
Seat 1: MyOnlyMemory (button) folded before Flop (didn't bet)
Seat 2: MezuuÜuuT (small blind) folded before Flop
Seat 3: Hjerterdame1 (big blind) folded before Flop
Seat 4: ederpalasson collected (5600)
Seat 5: nacho2390 folded before Flop (didn't bet)
Seat 6: ThalleSx folded before Flop (didn't bet)
Seat 7: fournn folded before Flop (didn't bet)
Seat 8: vagoyras folded before Flop (didn't bet)

PokerStars Hand #251205863876: Tournament #3767885527, $40+$10+$5 USD Hold'em No Limit - Level XIII (800/1600) - 2024/06/26 19:22:58 UTC [2024/06/26 15:22:58 ET]
Table '3767885527 61' 8-max Seat #2 is the button
Seat 1: MyOnlyMemory (29000 in chips) 
Seat 2: MezuuÜuuT (17560 in chips) 
Seat 3: Hjerterdame1 (103756 in chips) 
Seat 4: ederpalasson (21543 in chips) 
Seat 5: nacho2390 (25300 in chips) 
Seat 6: ThalleSx (33560 in chips) 
Seat 7: fournn (26005 in chips) 
Seat 8: vagoyras (40999 in chips) 
MyOnlyMemory: posts the ante 200
MezuuÜuuT: posts the ante 200
Hjerterdame1: posts the ante 200
ederpalasson: posts the ante 200
nacho2390: posts the ante 200
ThalleSx: posts the ante 200
fournn: posts the ante 200
vagoyras: posts the ante 200
Hjerterdame1: posts small blind 800
ederpalasson: posts big blind 1600
*** HOLE CARDS ***
nacho2390: folds 
ThalleSx: folds 
fournn: folds 
vagoyras: raises 1600 to 3200
MyOnlyMemory: folds 
MezuuÜuuT: folds 
Hjerterdame1: folds 
ederpalasson: calls 1600
*** FLOP *** [Jc 7c 4d]
ederpalasson: checks 
vagoyras: bets 2904
ederpalasson: folds 
Uncalled bet (2904) returned to vagoyras
vagoyras collected 8800 from pot
vagoyras: doesn't show hand 
*** SUMMARY ***
Total pot 8800 | Rake 0 
Board [Jc 7c 4d]
Seat 1: MyOnlyMemory folded before Flop (didn't bet)
Seat 2: MezuuÜuuT (button) folded before Flop (didn't bet)
Seat 3: Hjerterdame1 (small blind) folded before Flop
Seat 4: ederpalasson (big blind) folded on the Flop
Seat 5: nacho2390 folded before Flop (didn't bet)
Seat 6: ThalleSx folded before Flop (didn't bet)
Seat 7: fournn folded before Flop (didn't bet)
Seat 8: vagoyras collected (8800)

PokerStars Hand #251205889213: Tournament #3767885527, $40+$10+$5 USD Hold'em No Limit - Level XIII (800/1600) - 2024/06/26 19:24:31 UTC [2024/06/26 15:24:31 ET]
Table '3767885527 61' 8-max Seat #3 is the button
Seat 1: MyOnlyMemory (28800 in chips) 
Seat 2: MezuuÜuuT (17360 in chips) 
Seat 3: Hjerterdame1 (102756 in chips) 
Seat 4: ederpalasson (18143 in chips) 
Seat 5: nacho2390 (25100 in chips) 
Seat 6: ThalleSx (33360 in chips) 
Seat 7: fournn (25805 in chips) 
Seat 8: vagoyras (46399 in chips) 
MyOnlyMemory: posts the ante 200
MezuuÜuuT: posts the ante 200
Hjerterdame1: posts the ante 200
ederpalasson: posts the ante 200
nacho2390: posts the ante 200
ThalleSx: posts the ante 200
fournn: posts the ante 200
vagoyras: posts the ante 200
ederpalasson: posts small blind 800
nacho2390: posts big blind 1600
*** HOLE CARDS ***
ThalleSx: folds 
fournn: folds 
vagoyras: folds 
MyOnlyMemory: folds 
MezuuÜuuT: raises 15560 to 17160 and is all-in
Hjerterdame1: folds 
ederpalasson: folds 
nacho2390: folds 
Uncalled bet (15560) returned to MezuuÜuuT
MezuuÜuuT collected 5600 from pot
MezuuÜuuT: doesn't show hand 
*** SUMMARY ***
Total pot 5600 | Rake 0 
Seat 1: MyOnlyMemory folded before Flop (didn't bet)
Seat 2: MezuuÜuuT collected (5600)
Seat 3: Hjerterdame1 (button) folded before Flop (didn't bet)
Seat 4: ederpalasson (small blind) folded before Flop
Seat 5: nacho2390 (big blind) folded before Flop
Seat 6: ThalleSx folded before Flop (didn't bet)
Seat 7: fournn folded before Flop (didn't bet)
Seat 8: vagoyras folded before Flop (didn't bet)

PokerStars Hand #251205901575: Tournament #3767885527, $40+$10+$5 USD Hold'em No Limit - Level XIII (800/1600) - 2024/06/26 19:25:15 UTC [2024/06/26 15:25:15 ET]
Table '3767885527 61' 8-max Seat #4 is the button
Seat 1: MyOnlyMemory (28600 in chips) 
Seat 2: MezuuÜuuT (21160 in chips) 
Seat 3: Hjerterdame1 (102556 in chips) 
Seat 4: ederpalasson (17143 in chips) 
Seat 5: nacho2390 (23300 in chips) 
Seat 6: ThalleSx (33160 in chips) 
Seat 7: fournn (25605 in chips) 
Seat 8: vagoyras (46199 in chips) 
MyOnlyMemory: posts the ante 200
MezuuÜuuT: posts the ante 200
Hjerterdame1: posts the ante 200
ederpalasson: posts the ante 200
nacho2390: posts the ante 200
ThalleSx: posts the ante 200
fournn: posts the ante 200
vagoyras: posts the ante 200
nacho2390: posts small blind 800
ThalleSx: posts big blind 1600
*** HOLE CARDS ***
fournn: folds 
vagoyras: folds 
MyOnlyMemory: folds 
MezuuÜuuT: folds 
Hjerterdame1: folds 
ederpalasson: folds 
nacho2390: raises 21500 to 23100 and is all-in
ThalleSx: folds 
Uncalled bet (21500) returned to nacho2390
nacho2390 collected 4800 from pot
nacho2390: doesn't show hand 
*** SUMMARY ***
Total pot 4800 | Rake 0 
Seat 1: MyOnlyMemory folded before Flop (didn't bet)
Seat 2: MezuuÜuuT folded before Flop (didn't bet)
Seat 3: Hjerterdame1 folded before Flop (didn't bet)
Seat 4: ederpalasson (button) folded before Flop (didn't bet)
Seat 5: nacho2390 (small blind) collected (4800)
Seat 6: ThalleSx (big blind) folded before Flop
Seat 7: fournn folded before Flop (didn't bet)
Seat 8: vagoyras folded before Flop (didn't bet)

PokerStars Hand #251205909946: Tournament #3767885527, $40+$10+$5 USD Hold'em No Limit - Level XIII (800/1600) - 2024/06/26 19:25:46 UTC [2024/06/26 15:25:46 ET]
Table '3767885527 61' 8-max Seat #5 is the button
Seat 1: MyOnlyMemory (28400 in chips) 
Seat 2: MezuuÜuuT (20960 in chips) 
Seat 3: Hjerterdame1 (102356 in chips) 
Seat 4: ederpalasson (16943 in chips) 
Seat 5: nacho2390 (26300 in chips) 
Seat 6: ThalleSx (31360 in chips) 
Seat 7: fournn (25405 in chips) 
Seat 8: vagoyras (45999 in chips) 
MyOnlyMemory: posts the ante 200
MezuuÜuuT: posts the ante 200
Hjerterdame1: posts the ante 200
ederpalasson: posts the ante 200
nacho2390: posts the ante 200
ThalleSx: posts the ante 200
fournn: posts the ante 200
vagoyras: posts the ante 200
ThalleSx: posts small blind 800
fournn: posts big blind 1600
*** HOLE CARDS ***
vagoyras: folds 
MyOnlyMemory: folds 
MezuuÜuuT: folds 
Hjerterdame1: folds 
ederpalasson: folds 
nacho2390: raises 24500 to 26100 and is all-in
ThalleSx: folds 
fournn: folds 
Uncalled bet (24500) returned to nacho2390
nacho2390 collected 5600 from pot
nacho2390: doesn't show hand 
*** SUMMARY ***
Total pot 5600 | Rake 0 
Seat 1: MyOnlyMemory folded before Flop (didn't bet)
Seat 2: MezuuÜuuT folded before Flop (didn't bet)
Seat 3: Hjerterdame1 folded before Flop (didn't bet)
Seat 4: ederpalasson folded before Flop (didn't bet)
Seat 5: nacho2390 (button) collected (5600)
Seat 6: ThalleSx (small blind) folded before Flop
Seat 7: fournn (big blind) folded before Flop
Seat 8: vagoyras folded before Flop (didn't bet)

PokerStars Hand #251205922095: Tournament #3767885527, $40+$10+$5 USD Hold'em No Limit - Level XIII (800/1600) - 2024/06/26 19:26:30 UTC [2024/06/26 15:26:30 ET]
Table '3767885527 61' 8-max Seat #6 is the button
Seat 1: MyOnlyMemory (28200 in chips) 
Seat 2: MezuuÜuuT (20760 in chips) 
Seat 3: Hjerterdame1 (102156 in chips) 
Seat 4: ederpalasson (16743 in chips) 
Seat 5: nacho2390 (30100 in chips) 
Seat 6: ThalleSx (30360 in chips) 
Seat 7: fournn (23605 in chips) 
Seat 8: vagoyras (45799 in chips) 
MyOnlyMemory: posts the ante 200
MezuuÜuuT: posts the ante 200
Hjerterdame1: posts the ante 200
ederpalasson: posts the ante 200
nacho2390: posts the ante 200
ThalleSx: posts the ante 200
fournn: posts the ante 200
vagoyras: posts the ante 200
fournn: posts small blind 800
vagoyras: posts big blind 1600
*** HOLE CARDS ***
MyOnlyMemory: folds 
MezuuÜuuT: folds 
Hjerterdame1: raises 1600 to 3200
ederpalasson: folds 
nacho2390: folds 
ThalleSx: folds 
fournn: calls 2400
vagoyras: raises 8800 to 12000
Hjerterdame1: folds 
fournn: folds 
Uncalled bet (8800) returned to vagoyras
vagoyras collected 11200 from pot
vagoyras: doesn't show hand 
*** SUMMARY ***
Total pot 11200 | Rake 0 
Seat 1: MyOnlyMemory folded before Flop (didn't bet)
Seat 2: MezuuÜuuT folded before Flop (didn't bet)
Seat 3: Hjerterdame1 folded before Flop
Seat 4: ederpalasson folded before Flop (didn't bet)
Seat 5: nacho2390 folded before Flop (didn't bet)
Seat 6: ThalleSx (button) folded before Flop (didn't bet)
Seat 7: fournn (small blind) folded before Flop
Seat 8: vagoyras (big blind) collected (11200)

PokerStars Hand #251205934739: Tournament #3767885527, $40+$10+$5 USD Hold'em No Limit - Level XIII (800/1600) - 2024/06/26 19:27:17 UTC [2024/06/26 15:27:17 ET]
Table '3767885527 61' 8-max Seat #7 is the button
Seat 1: MyOnlyMemory (28000 in chips) 
Seat 2: MezuuÜuuT (20560 in chips) 
Seat 3: Hjerterdame1 (98756 in chips) 
Seat 4: ederpalasson (16543 in chips) 
Seat 5: nacho2390 (29900 in chips) 
Seat 6: ThalleSx (30160 in chips) 
Seat 7: fournn (20205 in chips) 
Seat 8: vagoyras (53599 in chips) 
MyOnlyMemory: posts the ante 200
MezuuÜuuT: posts the ante 200
Hjerterdame1: posts the ante 200
ederpalasson: posts the ante 200
nacho2390: posts the ante 200
ThalleSx: posts the ante 200
fournn: posts the ante 200
vagoyras: posts the ante 200
vagoyras: posts small blind 800
MyOnlyMemory: posts big blind 1600
*** HOLE CARDS ***
MezuuÜuuT: folds 
Hjerterdame1: folds 
ederpalasson: raises 14400 to 16000
nacho2390: folds 
ThalleSx: folds 
fournn: raises 4005 to 20005 and is all-in
vagoyras: folds 
MyOnlyMemory: folds 
ederpalasson: calls 343 and is all-in
Uncalled bet (3662) returned to fournn
*** FLOP *** [8s Td 5d]
*** TURN *** [8s Td 5d] [As]
*** RIVER *** [8s Td 5d As] [4d]
*** SHOW DOWN ***
ederpalasson: shows [5s 5c] (three of a kind, Fives)
fournn: shows [Ac Qc] (a pair of Aces)
ederpalasson collected 36686 from pot
*** SUMMARY ***
Total pot 36686 | Rake 0 
Board [8s Td 5d As 4d]
Seat 1: MyOnlyMemory (big blind) folded before Flop
Seat 2: MezuuÜuuT folded before Flop (didn't bet)
Seat 3: Hjerterdame1 folded before Flop (didn't bet)
Seat 4: ederpalasson showed [5s 5c] and won (36686) with three of a kind, Fives
Seat 5: nacho2390 folded before Flop (didn't bet)
Seat 6: ThalleSx folded before Flop (didn't bet)
Seat 7: fournn (button) showed [Ac Qc] and lost with a pair of Aces
Seat 8: vagoyras (small blind) folded before Flop

PokerStars Hand #251205945216: Tournament #3767885527, $40+$10+$5 USD Hold'em No Limit - Level XIII (800/1600) - 2024/06/26 19:27:56 UTC [2024/06/26 15:27:56 ET]
Table '3767885527 61' 8-max Seat #8 is the button
Seat 1: MyOnlyMemory (26200 in chips) 
Seat 2: MezuuÜuuT (20360 in chips) 
Seat 3: Hjerterdame1 (98556 in chips) 
Seat 4: ederpalasson (36686 in chips) 
Seat 5: nacho2390 (29700 in chips) 
Seat 6: ThalleSx (29960 in chips) 
Seat 7: fournn (3662 in chips) 
Seat 8: vagoyras (52599 in chips) 
MyOnlyMemory: posts the ante 200
MezuuÜuuT: posts the ante 200
Hjerterdame1: posts the ante 200
ederpalasson: posts the ante 200
nacho2390: posts the ante 200
ThalleSx: posts the ante 200
fournn: posts the ante 200
vagoyras: posts the ante 200
MyOnlyMemory: posts small blind 800
MezuuÜuuT: posts big blind 1600
*** HOLE CARDS ***
Hjerterdame1: calls 1600
ederpalasson: folds 
nacho2390: folds 
ThalleSx: raises 3200 to 4800
fournn: folds 
vagoyras: folds 
MyOnlyMemory: folds 
MezuuÜuuT: folds 
Hjerterdame1: calls 3200
*** FLOP *** [6h 9c 2s]
Hjerterdame1: checks 
ThalleSx: bets 4160
Hjerterdame1: raises 10960 to 15120
ThalleSx: raises 9840 to 24960 and is all-in
Hjerterdame1: calls 9840
*** TURN *** [6h 9c 2s] [8s]
*** RIVER *** [6h 9c 2s 8s] [7h]
*** SHOW DOWN ***
Hjerterdame1: shows [9d Td] (a straight, Six to Ten)
ThalleSx: shows [Jd Js] (a pair of Jacks)
Hjerterdame1 collected 63520 from pot
ThalleSx finished the tournament
*** SUMMARY ***
Total pot 63520 | Rake 0 
Board [6h 9c 2s 8s 7h]
Seat 1: MyOnlyMemory (small blind) folded before Flop
Seat 2: MezuuÜuuT (big blind) folded before Flop
Seat 3: Hjerterdame1 showed [9d Td] and won (63520) with a straight, Six to Ten
Seat 4: ederpalasson folded before Flop (didn't bet)
Seat 5: nacho2390 folded before Flop (didn't bet)
Seat 6: ThalleSx showed [Jd Js] and lost with a pair of Jacks
Seat 7: fournn folded before Flop (didn't bet)
Seat 8: vagoyras (button) folded before Flop (didn't bet)

PokerStars Hand #251205964100: Tournament #3767885527, $40+$10+$5 USD Hold'em No Limit - Level XIII (800/1600) - 2024/06/26 19:29:07 UTC [2024/06/26 15:29:07 ET]
Table '3767885527 61' 8-max Seat #1 is the button
Seat 1: MyOnlyMemory (25200 in chips) 
Seat 2: MezuuÜuuT (18560 in chips) 
Seat 3: Hjerterdame1 (132116 in chips) 
Seat 4: ederpalasson (36486 in chips) 
Seat 5: nacho2390 (29500 in chips) 
Seat 7: fournn (3462 in chips) 
Seat 8: vagoyras (52399 in chips) 
MyOnlyMemory: posts the ante 200
MezuuÜuuT: posts the ante 200
Hjerterdame1: posts the ante 200
ederpalasson: posts the ante 200
nacho2390: posts the ante 200
fournn: posts the ante 200
vagoyras: posts the ante 200
MezuuÜuuT: posts small blind 800
Hjerterdame1: posts big blind 1600
*** HOLE CARDS ***
ederpalasson: folds 
nacho2390: raises 1600 to 3200
fournn: folds 
vagoyras: folds 
MyOnlyMemory: folds 
MezuuÜuuT: folds 
Hjerterdame1: folds 
Uncalled bet (1600) returned to nacho2390
nacho2390 collected 5400 from pot
nacho2390: doesn't show hand 
*** SUMMARY ***
Total pot 5400 | Rake 0 
Seat 1: MyOnlyMemory (button) folded before Flop (didn't bet)
Seat 2: MezuuÜuuT (small blind) folded before Flop
Seat 3: Hjerterdame1 (big blind) folded before Flop
Seat 4: ederpalasson folded before Flop (didn't bet)
Seat 5: nacho2390 collected (5400)
Seat 7: fournn folded before Flop (didn't bet)
Seat 8: vagoyras folded before Flop (didn't bet)

PokerStars Hand #251205972453: Tournament #3767885527, $40+$10+$5 USD Hold'em No Limit - Level XIV (1000/2000) - 2024/06/26 19:29:37 UTC [2024/06/26 15:29:37 ET]
Table '3767885527 61' 8-max Seat #2 is the button
Seat 1: MyOnlyMemory (25000 in chips) 
Seat 2: MezuuÜuuT (17560 in chips) 
Seat 3: Hjerterdame1 (130316 in chips) 
Seat 4: ederpalasson (36286 in chips) 
Seat 5: nacho2390 (33100 in chips) 
Seat 7: fournn (3262 in chips) 
Seat 8: vagoyras (52199 in chips) 
MyOnlyMemory: posts the ante 250
MezuuÜuuT: posts the ante 250
Hjerterdame1: posts the ante 250
ederpalasson: posts the ante 250
nacho2390: posts the ante 250
fournn: posts the ante 250
vagoyras: posts the ante 250
Hjerterdame1: posts small blind 1000
ederpalasson: posts big blind 2000
*** HOLE CARDS ***
nacho2390: folds 
XARANDROS is disconnected 
fournn: folds 
vagoyras: raises 2000 to 4000
MyOnlyMemory: raises 20750 to 24750 and is all-in
MezuuÜuuT: folds 
Hjerterdame1: folds 
ederpalasson: folds 
vagoyras: folds 
Uncalled bet (20750) returned to MyOnlyMemory
MyOnlyMemory collected 12750 from pot
*** SUMMARY ***
Total pot 12750 | Rake 0 
Seat 1: MyOnlyMemory collected (12750)
Seat 2: MezuuÜuuT (button) folded before Flop (didn't bet)
Seat 3: Hjerterdame1 (small blind) folded before Flop
Seat 4: ederpalasson (big blind) folded before Flop
Seat 5: nacho2390 folded before Flop (didn't bet)
Seat 7: fournn folded before Flop (didn't bet)
Seat 8: vagoyras folded before Flop

PokerStars Hand #251205985005: Tournament #3767885527, $40+$10+$5 USD Hold'em No Limit - Level XIV (1000/2000) - 2024/06/26 19:30:23 UTC [2024/06/26 15:30:23 ET]
Table '3767885527 61' 8-max Seat #3 is the button
Seat 1: MyOnlyMemory (33500 in chips) 
Seat 2: MezuuÜuuT (17310 in chips) 
Seat 3: Hjerterdame1 (129066 in chips) 
Seat 4: ederpalasson (34036 in chips) 
Seat 5: nacho2390 (32850 in chips) 
Seat 6: XARANDROS (25000 in chips) 
Seat 7: fournn (3012 in chips) 
Seat 8: vagoyras (47949 in chips) 
MyOnlyMemory: posts the ante 250
MezuuÜuuT: posts the ante 250
Hjerterdame1: posts the ante 250
ederpalasson: posts the ante 250
nacho2390: posts the ante 250
XARANDROS: posts the ante 250
fournn: posts the ante 250
vagoyras: posts the ante 250
ederpalasson: posts small blind 1000
nacho2390: posts big blind 2000
*** HOLE CARDS ***
XARANDROS: raises 7000 to 9000
fournn: folds 
vagoyras: folds 
MyOnlyMemory: folds 
MezuuÜuuT: folds 
Hjerterdame1: folds 
ederpalasson: folds 
nacho2390: folds 
Uncalled bet (7000) returned to XARANDROS
XARANDROS collected 7000 from pot
*** SUMMARY ***
Total pot 7000 | Rake 0 
Seat 1: MyOnlyMemory folded before Flop (didn't bet)
Seat 2: MezuuÜuuT folded before Flop (didn't bet)
Seat 3: Hjerterdame1 (button) folded before Flop (didn't bet)
Seat 4: ederpalasson (small blind) folded before Flop
Seat 5: nacho2390 (big blind) folded before Flop
Seat 6: XARANDROS collected (7000)
Seat 7: fournn folded before Flop (didn't bet)
Seat 8: vagoyras folded before Flop (didn't bet)

PokerStars Hand #251205996344: Tournament #3767885527, $40+$10+$5 USD Hold'em No Limit - Level XIV (1000/2000) - 2024/06/26 19:31:04 UTC [2024/06/26 15:31:04 ET]
Table '3767885527 61' 8-max Seat #4 is the button
Seat 1: MyOnlyMemory (33250 in chips) 
Seat 2: MezuuÜuuT (17060 in chips) 
Seat 3: Hjerterdame1 (128816 in chips) 
Seat 4: ederpalasson (32786 in chips) 
Seat 5: nacho2390 (30600 in chips) 
Seat 6: XARANDROS (29750 in chips) 
Seat 7: fournn (2762 in chips) 
Seat 8: vagoyras (47699 in chips) 
MyOnlyMemory: posts the ante 250
MezuuÜuuT: posts the ante 250
Hjerterdame1: posts the ante 250
ederpalasson: posts the ante 250
nacho2390: posts the ante 250
XARANDROS: posts the ante 250
fournn: posts the ante 250
vagoyras: posts the ante 250
nacho2390: posts small blind 1000
XARANDROS: posts big blind 2000
*** HOLE CARDS ***
fournn: folds 
vagoyras: folds 
MyOnlyMemory: folds 
MezuuÜuuT: folds 
Hjerterdame1: raises 4000 to 6000
ederpalasson: folds 
nacho2390: folds 
XARANDROS: calls 4000
*** FLOP *** [9h As 3h]
XARANDROS: checks 
Hjerterdame1: bets 6000
XARANDROS: folds 
Uncalled bet (6000) returned to Hjerterdame1
Hjerterdame1 collected 15000 from pot
Hjerterdame1: doesn't show hand 
*** SUMMARY ***
Total pot 15000 | Rake 0 
Board [9h As 3h]
Seat 1: MyOnlyMemory folded before Flop (didn't bet)
Seat 2: MezuuÜuuT folded before Flop (didn't bet)
Seat 3: Hjerterdame1 collected (15000)
Seat 4: ederpalasson (button) folded before Flop (didn't bet)
Seat 5: nacho2390 (small blind) folded before Flop
Seat 6: XARANDROS (big blind) folded on the Flop
Seat 7: fournn folded before Flop (didn't bet)
Seat 8: vagoyras folded before Flop (didn't bet)

PokerStars Hand #251206018648: Tournament #3767885527, $40+$10+$5 USD Hold'em No Limit - Level XIV (1000/2000) - 2024/06/26 19:32:25 UTC [2024/06/26 15:32:25 ET]
Table '3767885527 61' 8-max Seat #5 is the button
Seat 1: MyOnlyMemory (33000 in chips) 
Seat 2: MezuuÜuuT (16810 in chips) 
Seat 3: Hjerterdame1 (137566 in chips) 
Seat 4: ederpalasson (32536 in chips) 
Seat 5: nacho2390 (29350 in chips) 
Seat 6: XARANDROS (23500 in chips) 
Seat 7: fournn (2512 in chips) 
Seat 8: vagoyras (47449 in chips) 
MyOnlyMemory: posts the ante 250
MezuuÜuuT: posts the ante 250
Hjerterdame1: posts the ante 250
ederpalasson: posts the ante 250
nacho2390: posts the ante 250
XARANDROS: posts the ante 250
fournn: posts the ante 250
vagoyras: posts the ante 250
XARANDROS: posts small blind 1000
fournn: posts big blind 2000
*** HOLE CARDS ***
vagoyras: folds 
MyOnlyMemory: raises 2000 to 4000
MezuuÜuuT: folds 
Hjerterdame1: calls 4000
ederpalasson: calls 4000
nacho2390: raises 25100 to 29100 and is all-in
XARANDROS: folds 
fournn: calls 262 and is all-in
MyOnlyMemory: raises 3650 to 32750 and is all-in
Hjerterdame1: folds 
ederpalasson: folds 
Uncalled bet (3650) returned to MyOnlyMemory
*** FLOP *** [Ad 6d 8h]
*** TURN *** [Ad 6d 8h] [3d]
*** RIVER *** [Ad 6d 8h 3d] [3h]
*** SHOW DOWN ***
MyOnlyMemory: shows [5c 5h] (two pair, Fives and Threes)
nacho2390: shows [Ac Jh] (two pair, Aces and Threes)
nacho2390 collected 57152 from side pot
fournn: shows [Qd 4d] (a flush, Ace high)
fournn collected 14310 from main pot
*** SUMMARY ***
Total pot 71462 Main pot 14310. Side pot 57152. | Rake 0 
Board [Ad 6d 8h 3d 3h]
Seat 1: MyOnlyMemory showed [5c 5h] and lost with two pair, Fives and Threes
Seat 2: MezuuÜuuT folded before Flop (didn't bet)
Seat 3: Hjerterdame1 folded before Flop
Seat 4: ederpalasson folded before Flop
Seat 5: nacho2390 (button) showed [Ac Jh] and won (57152) with two pair, Aces and Threes
Seat 6: XARANDROS (small blind) folded before Flop
Seat 7: fournn (big blind) showed [Qd 4d] and won (14310) with a flush, Ace high
Seat 8: vagoyras folded before Flop (didn't bet)

PokerStars Hand #251206037259: Tournament #3767885527, $40+$10+$5 USD Hold'em No Limit - Level XIV (1000/2000) - 2024/06/26 19:33:33 UTC [2024/06/26 15:33:33 ET]
Table '3767885527 61' 8-max Seat #6 is the button
Seat 1: MyOnlyMemory (3650 in chips) 
Seat 2: MezuuÜuuT (16560 in chips) 
Seat 3: Hjerterdame1 (133316 in chips) 
Seat 4: ederpalasson (28286 in chips) 
Seat 5: nacho2390 (57152 in chips) 
Seat 6: XARANDROS (22250 in chips) 
Seat 7: fournn (14310 in chips) 
Seat 8: vagoyras (47199 in chips) 
MyOnlyMemory: posts the ante 250
MezuuÜuuT: posts the ante 250
Hjerterdame1: posts the ante 250
ederpalasson: posts the ante 250
nacho2390: posts the ante 250
XARANDROS: posts the ante 250
fournn: posts the ante 250
vagoyras: posts the ante 250
fournn: posts small blind 1000
vagoyras: posts big blind 2000
*** HOLE CARDS ***
MyOnlyMemory: folds 
MezuuÜuuT: folds 
Hjerterdame1: raises 4000 to 6000
ederpalasson: folds 
nacho2390: folds 
XARANDROS: folds 
fournn: folds 
vagoyras: folds 
Uncalled bet (4000) returned to Hjerterdame1
Hjerterdame1 collected 7000 from pot
Hjerterdame1: doesn't show hand 
*** SUMMARY ***
Total pot 7000 | Rake 0 
Seat 1: MyOnlyMemory folded before Flop (didn't bet)
Seat 2: MezuuÜuuT folded before Flop (didn't bet)
Seat 3: Hjerterdame1 collected (7000)
Seat 4: ederpalasson folded before Flop (didn't bet)
Seat 5: nacho2390 folded before Flop (didn't bet)
Seat 6: XARANDROS (button) folded before Flop (didn't bet)
Seat 7: fournn (small blind) folded before Flop
Seat 8: vagoyras (big blind) folded before Flop

PokerStars Hand #251206052041: Tournament #3767885527, $40+$10+$5 USD Hold'em No Limit - Level XIV (1000/2000) - 2024/06/26 19:34:27 UTC [2024/06/26 15:34:27 ET]
Table '3767885527 61' 8-max Seat #7 is the button
Seat 1: MyOnlyMemory (3400 in chips) 
Seat 2: MezuuÜuuT (16310 in chips) 
Seat 3: Hjerterdame1 (138066 in chips) 
Seat 4: ederpalasson (28036 in chips) 
Seat 5: nacho2390 (56902 in chips) 
Seat 6: XARANDROS (22000 in chips) 
Seat 7: fournn (13060 in chips) 
Seat 8: vagoyras (44949 in chips) 
MyOnlyMemory: posts the ante 250
MezuuÜuuT: posts the ante 250
Hjerterdame1: posts the ante 250
ederpalasson: posts the ante 250
nacho2390: posts the ante 250
XARANDROS: posts the ante 250
fournn: posts the ante 250
vagoyras: posts the ante 250
vagoyras: posts small blind 1000
MyOnlyMemory: posts big blind 2000
*** HOLE CARDS ***
MezuuÜuuT: folds 
Hjerterdame1: folds 
ederpalasson: raises 2000 to 4000
nacho2390: folds 
XARANDROS: folds 
fournn: raises 8810 to 12810 and is all-in
vagoyras: folds 
MyOnlyMemory: calls 1150 and is all-in
ederpalasson: calls 8810
*** FLOP *** [Tc 9s 6c]
*** TURN *** [Tc 9s 6c] [Js]
*** RIVER *** [Tc 9s 6c Js] [9d]
*** SHOW DOWN ***
ederpalasson: shows [Qh As] (a pair of Nines)
fournn: shows [Ac Ts] (two pair, Tens and Nines)
fournn collected 19320 from side pot
MyOnlyMemory: shows [5d 6h] (two pair, Nines and Sixes)
fournn collected 12450 from main pot
MyOnlyMemory is sitting out
MyOnlyMemory finished the tournament
*** SUMMARY ***
Total pot 31770 Main pot 12450. Side pot 19320. | Rake 0 
Board [Tc 9s 6c Js 9d]
Seat 1: MyOnlyMemory (big blind) showed [5d 6h] and lost with two pair, Nines and Sixes
Seat 2: MezuuÜuuT folded before Flop (didn't bet)
Seat 3: Hjerterdame1 folded before Flop (didn't bet)
Seat 4: ederpalasson showed [Qh As] and lost with a pair of Nines
Seat 5: nacho2390 folded before Flop (didn't bet)
Seat 6: XARANDROS folded before Flop (didn't bet)
Seat 7: fournn (button) showed [Ac Ts] and won (31770) with two pair, Tens and Nines
Seat 8: vagoyras (small blind) folded before Flop


PokerStars Hand #251205109405: Tournament #3767885527, $40+$10+$5 USD Hold'em No Limit - Level IX (400/800) - 2024/06/26 18:33:44 UTC [2024/06/26 14:33:44 ET]
Table '3767885527 60' 8-max Seat #3 is the button
Seat 1: BerriSwEEE27 (25193 in chips) 
Seat 2: billisrd350 (27642 in chips) 
Seat 3: Amandaraujo (48387 in chips) 
Seat 4: kuenne71 (91409 in chips) 
Seat 5: Godfather_RJ (7105 in chips) 
Seat 6: Jayda26 (4412 in chips) 
Seat 7: DrawinDead321 (36369 in chips) 
Seat 8: TamTam93AT (81898 in chips) 
BerriSwEEE27: posts the ante 100
billisrd350: posts the ante 100
Amandaraujo: posts the ante 100
kuenne71: posts the ante 100
Godfather_RJ: posts the ante 100
Jayda26: posts the ante 100
DrawinDead321: posts the ante 100
TamTam93AT: posts the ante 100
kuenne71: posts small blind 400
Godfather_RJ: posts big blind 800
*** HOLE CARDS ***
Jayda26: folds 
DrawinDead321: raises 800 to 1600
TamTam93AT: folds 
BerriSwEEE27: folds 
billisrd350: folds 
Amandaraujo: calls 1600
kuenne71: folds 
Godfather_RJ: calls 800
*** FLOP *** [Ah 2h Jh]
Godfather_RJ: checks 
DrawinDead321: bets 3800
Amandaraujo: folds 
Godfather_RJ: folds 
Uncalled bet (3800) returned to DrawinDead321
DrawinDead321 collected 6000 from pot
*** SUMMARY ***
Total pot 6000 | Rake 0 
Board [Ah 2h Jh]
Seat 1: BerriSwEEE27 folded before Flop (didn't bet)
Seat 2: billisrd350 folded before Flop (didn't bet)
Seat 3: Amandaraujo (button) folded on the Flop
Seat 4: kuenne71 (small blind) folded before Flop
Seat 5: Godfather_RJ (big blind) folded on the Flop
Seat 6: Jayda26 folded before Flop (didn't bet)
Seat 7: DrawinDead321 collected (6000)
Seat 8: TamTam93AT folded before Flop (didn't bet)

PokerStars Hand #251205119056: Tournament #3767885527, $40+$10+$5 USD Hold'em No Limit - Level IX (400/800) - 2024/06/26 18:34:22 UTC [2024/06/26 14:34:22 ET]
Table '3767885527 60' 8-max Seat #4 is the button
Seat 1: BerriSwEEE27 (25093 in chips) 
Seat 2: billisrd350 (27542 in chips) 
Seat 3: Amandaraujo (46687 in chips) 
Seat 4: kuenne71 (90909 in chips) 
Seat 5: Godfather_RJ (5405 in chips) 
Seat 6: Jayda26 (4312 in chips) 
Seat 7: DrawinDead321 (40669 in chips) 
Seat 8: TamTam93AT (81798 in chips) 
BerriSwEEE27: posts the ante 100
billisrd350: posts the ante 100
Amandaraujo: posts the ante 100
kuenne71: posts the ante 100
Godfather_RJ: posts the ante 100
Jayda26: posts the ante 100
DrawinDead321: posts the ante 100
TamTam93AT: posts the ante 100
Godfather_RJ: posts small blind 400
Jayda26: posts big blind 800
*** HOLE CARDS ***
DrawinDead321: raises 800 to 1600
TamTam93AT: folds 
BerriSwEEE27: folds 
billisrd350: calls 1600
Amandaraujo: raises 2400 to 4000
kuenne71: folds 
Godfather_RJ: folds 
Jayda26: raises 212 to 4212 and is all-in
DrawinDead321: raises 36357 to 40569 and is all-in
billisrd350: folds 
Amandaraujo: folds 
Uncalled bet (36357) returned to DrawinDead321
*** FLOP *** [Ad Qs 4c]
*** TURN *** [Ad Qs 4c] [7s]
*** RIVER *** [Ad Qs 4c 7s] [8s]
*** SHOW DOWN ***
Jayda26: shows [9h Ac] (a pair of Aces)
DrawinDead321: shows [Kc As] (a pair of Aces - King kicker)
DrawinDead321 collected 15224 from pot
Jayda26 finished the tournament
*** SUMMARY ***
Total pot 15224 | Rake 0 
Board [Ad Qs 4c 7s 8s]
Seat 1: BerriSwEEE27 folded before Flop (didn't bet)
Seat 2: billisrd350 folded before Flop
Seat 3: Amandaraujo folded before Flop
Seat 4: kuenne71 (button) folded before Flop (didn't bet)
Seat 5: Godfather_RJ (small blind) folded before Flop
Seat 6: Jayda26 (big blind) showed [9h Ac] and lost with a pair of Aces
Seat 7: DrawinDead321 showed [Kc As] and won (15224) with a pair of Aces
Seat 8: TamTam93AT folded before Flop (didn't bet)

PokerStars Hand #251205129609: Tournament #3767885527, $40+$10+$5 USD Hold'em No Limit - Level IX (400/800) - 2024/06/26 18:35:03 UTC [2024/06/26 14:35:03 ET]
Table '3767885527 60' 8-max Seat #5 is the button
Seat 1: BerriSwEEE27 (24993 in chips) 
Seat 2: billisrd350 (25842 in chips) 
Seat 3: Amandaraujo (42587 in chips) 
Seat 4: kuenne71 (90809 in chips) 
Seat 5: Godfather_RJ (4905 in chips) 
Seat 7: DrawinDead321 (51581 in chips) 
Seat 8: TamTam93AT (81698 in chips) 
BerriSwEEE27: posts the ante 100
billisrd350: posts the ante 100
Amandaraujo: posts the ante 100
kuenne71: posts the ante 100
Godfather_RJ: posts the ante 100
DrawinDead321: posts the ante 100
TamTam93AT: posts the ante 100
DrawinDead321: posts small blind 400
TamTam93AT: posts big blind 800
*** HOLE CARDS ***
BerriSwEEE27: raises 880 to 1680
billisrd350: folds 
Amandaraujo: raises 1680 to 3360
kuenne71: folds 
Godfather_RJ: folds 
DrawinDead321: folds 
TamTam93AT: folds 
BerriSwEEE27: raises 21533 to 24893 and is all-in
Amandaraujo: folds 
Uncalled bet (21533) returned to BerriSwEEE27
BerriSwEEE27 collected 8620 from pot
*** SUMMARY ***
Total pot 8620 | Rake 0 
Seat 1: BerriSwEEE27 collected (8620)
Seat 2: billisrd350 folded before Flop (didn't bet)
Seat 3: Amandaraujo folded before Flop
Seat 4: kuenne71 folded before Flop (didn't bet)
Seat 5: Godfather_RJ (button) folded before Flop (didn't bet)
Seat 7: DrawinDead321 (small blind) folded before Flop
Seat 8: TamTam93AT (big blind) folded before Flop

PokerStars Hand #251205136323: Tournament #3767885527, $40+$10+$5 USD Hold'em No Limit - Level IX (400/800) - 2024/06/26 18:35:30 UTC [2024/06/26 14:35:30 ET]
Table '3767885527 60' 8-max Seat #7 is the button
Seat 1: BerriSwEEE27 (30153 in chips) 
Seat 2: billisrd350 (25742 in chips) 
Seat 3: Amandaraujo (39127 in chips) 
Seat 4: kuenne71 (90709 in chips) 
Seat 5: Godfather_RJ (4805 in chips) 
Seat 7: DrawinDead321 (51081 in chips) 
Seat 8: TamTam93AT (80798 in chips) 
BerriSwEEE27: posts the ante 100
billisrd350: posts the ante 100
Amandaraujo: posts the ante 100
kuenne71: posts the ante 100
Godfather_RJ: posts the ante 100
DrawinDead321: posts the ante 100
TamTam93AT: posts the ante 100
TamTam93AT: posts small blind 400
BerriSwEEE27: posts big blind 800
*** HOLE CARDS ***
billisrd350: folds 
Amandaraujo: raises 2700 to 3500
kuenne71: folds 
Godfather_RJ: folds 
DrawinDead321: folds 
TamTam93AT: folds 
BerriSwEEE27: folds 
Uncalled bet (2700) returned to Amandaraujo
Amandaraujo collected 2700 from pot
*** SUMMARY ***
Total pot 2700 | Rake 0 
Seat 1: BerriSwEEE27 (big blind) folded before Flop
Seat 2: billisrd350 folded before Flop (didn't bet)
Seat 3: Amandaraujo collected (2700)
Seat 4: kuenne71 folded before Flop (didn't bet)
Seat 5: Godfather_RJ folded before Flop (didn't bet)
Seat 7: DrawinDead321 (button) folded before Flop (didn't bet)
Seat 8: TamTam93AT (small blind) folded before Flop

PokerStars Hand #251205145676: Tournament #3767885527, $40+$10+$5 USD Hold'em No Limit - Level IX (400/800) - 2024/06/26 18:36:06 UTC [2024/06/26 14:36:06 ET]
Table '3767885527 60' 8-max Seat #8 is the button
Seat 1: BerriSwEEE27 (29253 in chips) 
Seat 2: billisrd350 (25642 in chips) 
Seat 3: Amandaraujo (40927 in chips) 
Seat 4: kuenne71 (90609 in chips) 
Seat 5: Godfather_RJ (4705 in chips) 
Seat 7: DrawinDead321 (50981 in chips) 
Seat 8: TamTam93AT (80298 in chips) 
BerriSwEEE27: posts the ante 100
billisrd350: posts the ante 100
Amandaraujo: posts the ante 100
kuenne71: posts the ante 100
Godfather_RJ: posts the ante 100
DrawinDead321: posts the ante 100
TamTam93AT: posts the ante 100
BerriSwEEE27: posts small blind 400
billisrd350: posts big blind 800
*** HOLE CARDS ***
Amandaraujo: raises 800 to 1600
kuenne71: folds 
Godfather_RJ: folds 
DrawinDead321: folds 
TamTam93AT: folds 
BerriSwEEE27: folds 
billisrd350: calls 800
*** FLOP *** [Ac 3s Kd]
billisrd350: checks 
Amandaraujo: bets 2150
billisrd350: calls 2150
*** TURN *** [Ac 3s Kd] [Jh]
billisrd350: checks 
Amandaraujo: bets 3200
billisrd350: calls 3200
*** RIVER *** [Ac 3s Kd Jh] [4h]
billisrd350: checks 
Amandaraujo: bets 7500
billisrd350: calls 7500
*** SHOW DOWN ***
Amandaraujo: shows [Qs 5h] (high card Ace)
billisrd350: shows [7s As] (a pair of Aces)
billisrd350 collected 30000 from pot
*** SUMMARY ***
Total pot 30000 | Rake 0 
Board [Ac 3s Kd Jh 4h]
Seat 1: BerriSwEEE27 (small blind) folded before Flop
Seat 2: billisrd350 (big blind) showed [7s As] and won (30000) with a pair of Aces
Seat 3: Amandaraujo showed [Qs 5h] and lost with high card Ace
Seat 4: kuenne71 folded before Flop (didn't bet)
Seat 5: Godfather_RJ folded before Flop (didn't bet)
Seat 7: DrawinDead321 folded before Flop (didn't bet)
Seat 8: TamTam93AT (button) folded before Flop (didn't bet)

PokerStars Hand #251205163720: Tournament #3767885527, $40+$10+$5 USD Hold'em No Limit - Level IX (400/800) - 2024/06/26 18:37:16 UTC [2024/06/26 14:37:16 ET]
Table '3767885527 60' 8-max Seat #1 is the button
Seat 1: BerriSwEEE27 (28753 in chips) 
Seat 2: billisrd350 (41092 in chips) 
Seat 3: Amandaraujo (26377 in chips) 
Seat 4: kuenne71 (90509 in chips) 
Seat 5: Godfather_RJ (4605 in chips) 
Seat 6: Teddygram902 (25000 in chips) 
Seat 7: DrawinDead321 (50881 in chips) 
Seat 8: TamTam93AT (80198 in chips) 
BerriSwEEE27: posts the ante 100
billisrd350: posts the ante 100
Amandaraujo: posts the ante 100
kuenne71: posts the ante 100
Godfather_RJ: posts the ante 100
Teddygram902: posts the ante 100
DrawinDead321: posts the ante 100
TamTam93AT: posts the ante 100
billisrd350: posts small blind 400
Amandaraujo: posts big blind 800
*** HOLE CARDS ***
kuenne71: folds 
Godfather_RJ: folds 
Teddygram902: folds 
DrawinDead321: folds 
TamTam93AT: folds 
BerriSwEEE27: folds 
billisrd350: calls 400
Amandaraujo: raises 2400 to 3200
billisrd350: raises 37792 to 40992 and is all-in
Amandaraujo: calls 23077 and is all-in
Uncalled bet (14715) returned to billisrd350
*** FLOP *** [Ad 9h 2c]
*** TURN *** [Ad 9h 2c] [Qs]
*** RIVER *** [Ad 9h 2c Qs] [5s]
*** SHOW DOWN ***
billisrd350: shows [6s 6c] (a pair of Sixes)
Amandaraujo: shows [Ts 9d] (a pair of Nines)
Amandaraujo collected 53354 from pot
*** SUMMARY ***
Total pot 53354 | Rake 0 
Board [Ad 9h 2c Qs 5s]
Seat 1: BerriSwEEE27 (button) folded before Flop (didn't bet)
Seat 2: billisrd350 (small blind) showed [6s 6c] and lost with a pair of Sixes
Seat 3: Amandaraujo (big blind) showed [Ts 9d] and won (53354) with a pair of Nines
Seat 4: kuenne71 folded before Flop (didn't bet)
Seat 5: Godfather_RJ folded before Flop (didn't bet)
Seat 6: Teddygram902 folded before Flop (didn't bet)
Seat 7: DrawinDead321 folded before Flop (didn't bet)
Seat 8: TamTam93AT folded before Flop (didn't bet)

PokerStars Hand #251205177588: Tournament #3767885527, $40+$10+$5 USD Hold'em No Limit - Level IX (400/800) - 2024/06/26 18:38:10 UTC [2024/06/26 14:38:10 ET]
Table '3767885527 60' 8-max Seat #2 is the button
Seat 1: BerriSwEEE27 (28653 in chips) 
Seat 2: billisrd350 (14715 in chips) 
Seat 3: Amandaraujo (53354 in chips) 
Seat 4: kuenne71 (90409 in chips) 
Seat 5: Godfather_RJ (4505 in chips) 
Seat 6: Teddygram902 (24900 in chips) 
Seat 7: DrawinDead321 (50781 in chips) 
Seat 8: TamTam93AT (80098 in chips) 
BerriSwEEE27: posts the ante 100
billisrd350: posts the ante 100
Amandaraujo: posts the ante 100
kuenne71: posts the ante 100
Godfather_RJ: posts the ante 100
Teddygram902: posts the ante 100
DrawinDead321: posts the ante 100
TamTam93AT: posts the ante 100
Amandaraujo: posts small blind 400
kuenne71: posts big blind 800
*** HOLE CARDS ***
Godfather_RJ: folds 
Teddygram902: folds 
DrawinDead321: folds 
TamTam93AT: folds 
BerriSwEEE27: raises 880 to 1680
billisrd350: raises 12935 to 14615 and is all-in
Amandaraujo: folds 
kuenne71: folds 
BerriSwEEE27: folds 
Uncalled bet (12935) returned to billisrd350
billisrd350 collected 5360 from pot
billisrd350: doesn't show hand 
*** SUMMARY ***
Total pot 5360 | Rake 0 
Seat 1: BerriSwEEE27 folded before Flop
Seat 2: billisrd350 (button) collected (5360)
Seat 3: Amandaraujo (small blind) folded before Flop
Seat 4: kuenne71 (big blind) folded before Flop
Seat 5: Godfather_RJ folded before Flop (didn't bet)
Seat 6: Teddygram902 folded before Flop (didn't bet)
Seat 7: DrawinDead321 folded before Flop (didn't bet)
Seat 8: TamTam93AT folded before Flop (didn't bet)

PokerStars Hand #251205182901: Tournament #3767885527, $40+$10+$5 USD Hold'em No Limit - Level IX (400/800) - 2024/06/26 18:38:30 UTC [2024/06/26 14:38:30 ET]
Table '3767885527 60' 8-max Seat #3 is the button
Seat 1: BerriSwEEE27 (26873 in chips) 
Seat 2: billisrd350 (18295 in chips) 
Seat 3: Amandaraujo (52854 in chips) 
Seat 4: kuenne71 (89509 in chips) 
Seat 5: Godfather_RJ (4405 in chips) 
Seat 6: Teddygram902 (24800 in chips) 
Seat 7: DrawinDead321 (50681 in chips) 
Seat 8: TamTam93AT (79998 in chips) 
BerriSwEEE27: posts the ante 100
billisrd350: posts the ante 100
Amandaraujo: posts the ante 100
kuenne71: posts the ante 100
Godfather_RJ: posts the ante 100
Teddygram902: posts the ante 100
DrawinDead321: posts the ante 100
TamTam93AT: posts the ante 100
kuenne71: posts small blind 400
Godfather_RJ: posts big blind 800
*** HOLE CARDS ***
Teddygram902: folds 
DrawinDead321: folds 
TamTam93AT: raises 880 to 1680
BerriSwEEE27: folds 
billisrd350: calls 1680
Amandaraujo: calls 1680
kuenne71: calls 1280
Godfather_RJ: calls 880
*** FLOP *** [Jd 5c Qh]
kuenne71: checks 
Godfather_RJ: checks 
TamTam93AT: checks 
billisrd350: checks 
Amandaraujo: checks 
*** TURN *** [Jd 5c Qh] [Ad]
kuenne71: checks 
Godfather_RJ: checks 
TamTam93AT: bets 2300
billisrd350: folds 
Amandaraujo: folds 
kuenne71: folds 
Godfather_RJ: folds 
Uncalled bet (2300) returned to TamTam93AT
TamTam93AT collected 9200 from pot
TamTam93AT: doesn't show hand 
*** SUMMARY ***
Total pot 9200 | Rake 0 
Board [Jd 5c Qh Ad]
Seat 1: BerriSwEEE27 folded before Flop (didn't bet)
Seat 2: billisrd350 folded on the Turn
Seat 3: Amandaraujo (button) folded on the Turn
Seat 4: kuenne71 (small blind) folded on the Turn
Seat 5: Godfather_RJ (big blind) folded on the Turn
Seat 6: Teddygram902 folded before Flop (didn't bet)
Seat 7: DrawinDead321 folded before Flop (didn't bet)
Seat 8: TamTam93AT collected (9200)

PokerStars Hand #251205199305: Tournament #3767885527, $40+$10+$5 USD Hold'em No Limit - Level IX (400/800) - 2024/06/26 18:39:34 UTC [2024/06/26 14:39:34 ET]
Table '3767885527 60' 8-max Seat #4 is the button
Seat 1: BerriSwEEE27 (26773 in chips) 
Seat 2: billisrd350 (16515 in chips) 
Seat 3: Amandaraujo (51074 in chips) 
Seat 4: kuenne71 (87729 in chips) 
Seat 5: Godfather_RJ (2625 in chips) 
Seat 6: Teddygram902 (24700 in chips) 
Seat 7: DrawinDead321 (50581 in chips) 
Seat 8: TamTam93AT (87418 in chips) 
BerriSwEEE27: posts the ante 100
billisrd350: posts the ante 100
Amandaraujo: posts the ante 100
kuenne71: posts the ante 100
Godfather_RJ: posts the ante 100
Teddygram902: posts the ante 100
DrawinDead321: posts the ante 100
TamTam93AT: posts the ante 100
Godfather_RJ: posts small blind 400
Teddygram902: posts big blind 800
*** HOLE CARDS ***
DrawinDead321: folds 
TamTam93AT: raises 960 to 1760
BerriSwEEE27: folds 
billisrd350: folds 
Amandaraujo: calls 1760
kuenne71: folds 
Godfather_RJ: folds 
Teddygram902: folds 
*** FLOP *** [Qh Jd 7h]
DrawinDead321 is disconnected 
DrawinDead321 is disconnected 
TamTam93AT: bets 3864
Amandaraujo: calls 3864
*** TURN *** [Qh Jd 7h] [5h]
TamTam93AT: checks 
Amandaraujo: checks 
*** RIVER *** [Qh Jd 7h 5h] [7d]
TamTam93AT: bets 9274
Amandaraujo: calls 9274
*** SHOW DOWN ***
TamTam93AT: shows [Ad Ac] (two pair, Aces and Sevens)
Amandaraujo: mucks hand 
TamTam93AT collected 31796 from pot
*** SUMMARY ***
Total pot 31796 | Rake 0 
Board [Qh Jd 7h 5h 7d]
Seat 1: BerriSwEEE27 folded before Flop (didn't bet)
Seat 2: billisrd350 folded before Flop (didn't bet)
Seat 3: Amandaraujo mucked
Seat 4: kuenne71 (button) folded before Flop (didn't bet)
Seat 5: Godfather_RJ (small blind) folded before Flop
Seat 6: Teddygram902 (big blind) folded before Flop
Seat 7: DrawinDead321 folded before Flop (didn't bet)
Seat 8: TamTam93AT showed [Ad Ac] and won (31796) with two pair, Aces and Sevens

PokerStars Hand #251205215342: Tournament #3767885527, $40+$10+$5 USD Hold'em No Limit - Level IX (400/800) - 2024/06/26 18:40:35 UTC [2024/06/26 14:40:35 ET]
Table '3767885527 60' 8-max Seat #5 is the button
Seat 1: BerriSwEEE27 (26673 in chips) 
Seat 2: billisrd350 (16415 in chips) 
Seat 3: Amandaraujo (36076 in chips) 
Seat 4: kuenne71 (87629 in chips) 
Seat 5: Godfather_RJ (2125 in chips) 
Seat 6: Teddygram902 (23800 in chips) 
Seat 7: DrawinDead321 (50481 in chips) 
Seat 8: TamTam93AT (104216 in chips) 
BerriSwEEE27: posts the ante 100
billisrd350: posts the ante 100
Amandaraujo: posts the ante 100
kuenne71: posts the ante 100
Godfather_RJ: posts the ante 100
Teddygram902: posts the ante 100
DrawinDead321: posts the ante 100
TamTam93AT: posts the ante 100
Teddygram902: posts small blind 400
DrawinDead321: posts big blind 800
*** HOLE CARDS ***
TamTam93AT: folds 
BerriSwEEE27: raises 880 to 1680
billisrd350: folds 
Amandaraujo: folds 
kuenne71: folds 
Godfather_RJ: folds 
Teddygram902: folds 
DrawinDead321: calls 880
*** FLOP *** [Tc 2c 6h]
DrawinDead321: checks 
BerriSwEEE27: bets 1144
DrawinDead321: calls 1144
*** TURN *** [Tc 2c 6h] [5d]
DrawinDead321: checks 
BerriSwEEE27: bets 5200
DrawinDead321: calls 5200
*** RIVER *** [Tc 2c 6h 5d] [Ad]
DrawinDead321: checks 
BerriSwEEE27: bets 18549 and is all-in
DrawinDead321: folds 
Uncalled bet (18549) returned to BerriSwEEE27
BerriSwEEE27 collected 17248 from pot
*** SUMMARY ***
Total pot 17248 | Rake 0 
Board [Tc 2c 6h 5d Ad]
Seat 1: BerriSwEEE27 collected (17248)
Seat 2: billisrd350 folded before Flop (didn't bet)
Seat 3: Amandaraujo folded before Flop (didn't bet)
Seat 4: kuenne71 folded before Flop (didn't bet)
Seat 5: Godfather_RJ (button) folded before Flop (didn't bet)
Seat 6: Teddygram902 (small blind) folded before Flop
Seat 7: DrawinDead321 (big blind) folded on the River
Seat 8: TamTam93AT folded before Flop (didn't bet)

PokerStars Hand #251205233752: Tournament #3767885527, $40+$10+$5 USD Hold'em No Limit - Level IX (400/800) - 2024/06/26 18:41:46 UTC [2024/06/26 14:41:46 ET]
Table '3767885527 60' 8-max Seat #6 is the button
Seat 1: BerriSwEEE27 (35797 in chips) 
Seat 2: billisrd350 (16315 in chips) 
Seat 3: Amandaraujo (35976 in chips) 
Seat 4: kuenne71 (87529 in chips) 
Seat 5: Godfather_RJ (2025 in chips) 
Seat 6: Teddygram902 (23300 in chips) 
Seat 7: DrawinDead321 (42357 in chips) 
Seat 8: TamTam93AT (104116 in chips) 
BerriSwEEE27: posts the ante 100
billisrd350: posts the ante 100
Amandaraujo: posts the ante 100
kuenne71: posts the ante 100
Godfather_RJ: posts the ante 100
Teddygram902: posts the ante 100
DrawinDead321: posts the ante 100
TamTam93AT: posts the ante 100
DrawinDead321: posts small blind 400
TamTam93AT: posts big blind 800
*** HOLE CARDS ***
BerriSwEEE27: raises 880 to 1680
billisrd350: folds 
Amandaraujo: calls 1680
kuenne71: calls 1680
Godfather_RJ: folds 
Teddygram902: raises 21520 to 23200 and is all-in
DrawinDead321: folds 
TamTam93AT: folds 
BerriSwEEE27: raises 12497 to 35697 and is all-in
Amandaraujo: folds 
kuenne71: folds 
Uncalled bet (12497) returned to BerriSwEEE27
*** FLOP *** [2d 6h As]
*** TURN *** [2d 6h As] [7d]
*** RIVER *** [2d 6h As 7d] [5c]
*** SHOW DOWN ***
BerriSwEEE27: shows [Ks Ad] (a pair of Aces)
Teddygram902: shows [Qs Ah] (a pair of Aces - lower kicker)
BerriSwEEE27 collected 51760 from pot
Teddygram902 finished the tournament
*** SUMMARY ***
Total pot 51760 | Rake 0 
Board [2d 6h As 7d 5c]
Seat 1: BerriSwEEE27 showed [Ks Ad] and won (51760) with a pair of Aces
Seat 2: billisrd350 folded before Flop (didn't bet)
Seat 3: Amandaraujo folded before Flop
Seat 4: kuenne71 folded before Flop
Seat 5: Godfather_RJ folded before Flop (didn't bet)
Seat 6: Teddygram902 (button) showed [Qs Ah] and lost with a pair of Aces
Seat 7: DrawinDead321 (small blind) folded before Flop
Seat 8: TamTam93AT (big blind) folded before Flop


PokerStars Hand #251205110414: Tournament #3767885527, $40+$10+$5 USD Hold'em No Limit - Level IX (400/800) - 2024/06/26 18:33:48 UTC [2024/06/26 14:33:48 ET]
Table '3767885527 59' 8-max Seat #7 is the button
Seat 1: vitor762 (22998 in chips) 
Seat 2: mikilool (24820 in chips) 
Seat 3: DaDumon (44609 in chips) 
Seat 4: Pkrscott1992 (70539 in chips) 
Seat 5: SkemGeeMan (25405 in chips) 
Seat 6: JACKPOT786 (30981 in chips) 
Seat 7: sandarobert1 (105968 in chips) 
Seat 8: thrasher71 (44724 in chips) 
vitor762: posts the ante 100
mikilool: posts the ante 100
DaDumon: posts the ante 100
Pkrscott1992: posts the ante 100
SkemGeeMan: posts the ante 100
JACKPOT786: posts the ante 100
sandarobert1: posts the ante 100
thrasher71: posts the ante 100
thrasher71: posts small blind 400
vitor762: posts big blind 800
*** HOLE CARDS ***
mikilool: folds 
DaDumon: folds 
Pkrscott1992: raises 800 to 1600
SkemGeeMan: folds 
JACKPOT786: folds 
sandarobert1: calls 1600
thrasher71: calls 1200
vitor762: calls 800
*** FLOP *** [8c Qh 5h]
thrasher71: checks 
vitor762: checks 
Pkrscott1992: checks 
sandarobert1: checks 
*** TURN *** [8c Qh 5h] [9c]
thrasher71: checks 
vitor762: checks 
Pkrscott1992: checks 
sandarobert1: bets 2520
thrasher71: raises 6280 to 8800
vitor762: folds 
Pkrscott1992: folds 
sandarobert1: folds 
Uncalled bet (6280) returned to thrasher71
thrasher71 collected 12240 from pot
thrasher71: doesn't show hand 
*** SUMMARY ***
Total pot 12240 | Rake 0 
Board [8c Qh 5h 9c]
Seat 1: vitor762 (big blind) folded on the Turn
Seat 2: mikilool folded before Flop (didn't bet)
Seat 3: DaDumon folded before Flop (didn't bet)
Seat 4: Pkrscott1992 folded on the Turn
Seat 5: SkemGeeMan folded before Flop (didn't bet)
Seat 6: JACKPOT786 folded before Flop (didn't bet)
Seat 7: sandarobert1 (button) folded on the Turn
Seat 8: thrasher71 (small blind) collected (12240)

PokerStars Hand #251205156405: Tournament #3767885527, $40+$10+$5 USD Hold'em No Limit - Level IX (400/800) - 2024/06/26 18:36:48 UTC [2024/06/26 14:36:48 ET]
Table '3767885527 59' 8-max Seat #8 is the button
Seat 1: vitor762 (21298 in chips) 
Seat 2: mikilool (24720 in chips) 
Seat 3: DaDumon (44509 in chips) 
Seat 4: Pkrscott1992 (68839 in chips) 
Seat 5: SkemGeeMan (25305 in chips) 
Seat 6: JACKPOT786 (30881 in chips) 
Seat 7: sandarobert1 (101748 in chips) 
Seat 8: thrasher71 (52744 in chips) 
vitor762: posts the ante 100
mikilool: posts the ante 100
DaDumon: posts the ante 100
Pkrscott1992: posts the ante 100
SkemGeeMan: posts the ante 100
JACKPOT786: posts the ante 100
sandarobert1: posts the ante 100
thrasher71: posts the ante 100
vitor762: posts small blind 400
mikilool: posts big blind 800
*** HOLE CARDS ***
DaDumon: folds 
Pkrscott1992: folds 
SkemGeeMan: folds 
JACKPOT786 has timed out
JACKPOT786: folds 
JACKPOT786 is sitting out
sandarobert1: folds 
JACKPOT786 has returned
thrasher71 has timed out
thrasher71: folds 
thrasher71 is sitting out
thrasher71 has returned
vitor762: calls 400
mikilool: raises 2000 to 2800
vitor762: folds 
Uncalled bet (2000) returned to mikilool
mikilool collected 2400 from pot
mikilool: doesn't show hand 
*** SUMMARY ***
Total pot 2400 | Rake 0 
Seat 1: vitor762 (small blind) folded before Flop
Seat 2: mikilool (big blind) collected (2400)
Seat 3: DaDumon folded before Flop (didn't bet)
Seat 4: Pkrscott1992 folded before Flop (didn't bet)
Seat 5: SkemGeeMan folded before Flop (didn't bet)
Seat 6: JACKPOT786 folded before Flop (didn't bet)
Seat 7: sandarobert1 folded before Flop (didn't bet)
Seat 8: thrasher71 (button) folded before Flop (didn't bet)

PokerStars Hand #251205181794: Tournament #3767885527, $40+$10+$5 USD Hold'em No Limit - Level IX (400/800) - 2024/06/26 18:38:26 UTC [2024/06/26 14:38:26 ET]
Table '3767885527 59' 8-max Seat #1 is the button
Seat 1: vitor762 (20398 in chips) 
Seat 2: mikilool (26220 in chips) 
Seat 3: DaDumon (44409 in chips) 
Seat 4: Pkrscott1992 (68739 in chips) 
Seat 5: SkemGeeMan (25205 in chips) 
Seat 6: JACKPOT786 (30781 in chips) 
Seat 7: sandarobert1 (101648 in chips) 
Seat 8: thrasher71 (52644 in chips) 
vitor762: posts the ante 100
mikilool: posts the ante 100
DaDumon: posts the ante 100
Pkrscott1992: posts the ante 100
SkemGeeMan: posts the ante 100
JACKPOT786: posts the ante 100
sandarobert1: posts the ante 100
thrasher71: posts the ante 100
mikilool: posts small blind 400
DaDumon: posts big blind 800
*** HOLE CARDS ***
Pkrscott1992: folds 
SkemGeeMan: folds 
JACKPOT786: folds 
sandarobert1: folds 
thrasher71: raises 800 to 1600
vitor762: folds 
mikilool: folds 
DaDumon: calls 800
*** FLOP *** [6c Kh 7h]
DaDumon: checks 
thrasher71: checks 
*** TURN *** [6c Kh 7h] [8c]
DaDumon: checks 
thrasher71: bets 1320
DaDumon: calls 1320
*** RIVER *** [6c Kh 7h 8c] [6s]
DaDumon: checks 
thrasher71: bets 5280
DaDumon: folds 
Uncalled bet (5280) returned to thrasher71
thrasher71 collected 7040 from pot
thrasher71: doesn't show hand 
*** SUMMARY ***
Total pot 7040 | Rake 0 
Board [6c Kh 7h 8c 6s]
Seat 1: vitor762 (button) folded before Flop (didn't bet)
Seat 2: mikilool (small blind) folded before Flop
Seat 3: DaDumon (big blind) folded on the River
Seat 4: Pkrscott1992 folded before Flop (didn't bet)
Seat 5: SkemGeeMan folded before Flop (didn't bet)
Seat 6: JACKPOT786 folded before Flop (didn't bet)
Seat 7: sandarobert1 folded before Flop (didn't bet)
Seat 8: thrasher71 collected (7040)

PokerStars Hand #251205208539: Tournament #3767885527, $40+$10+$5 USD Hold'em No Limit - Level IX (400/800) - 2024/06/26 18:40:09 UTC [2024/06/26 14:40:09 ET]
Table '3767885527 59' 8-max Seat #2 is the button
Seat 1: vitor762 (20298 in chips) 
Seat 2: mikilool (25720 in chips) 
Seat 3: DaDumon (41389 in chips) 
Seat 4: Pkrscott1992 (68639 in chips) 
Seat 5: SkemGeeMan (25105 in chips) 
Seat 6: JACKPOT786 (30681 in chips) 
Seat 7: sandarobert1 (101548 in chips) 
Seat 8: thrasher71 (56664 in chips) 
vitor762: posts the ante 100
mikilool: posts the ante 100
DaDumon: posts the ante 100
Pkrscott1992: posts the ante 100
SkemGeeMan: posts the ante 100
JACKPOT786: posts the ante 100
sandarobert1: posts the ante 100
thrasher71: posts the ante 100
DaDumon: posts small blind 400
Pkrscott1992: posts big blind 800
*** HOLE CARDS ***
SkemGeeMan: folds 
JACKPOT786: folds 
sandarobert1: raises 960 to 1760
thrasher71 has timed out
thrasher71: folds 
thrasher71 is sitting out
thrasher71 has returned
vitor762: raises 2640 to 4400
mikilool: folds 
DaDumon: folds 
Pkrscott1992: folds 
sandarobert1: calls 2640
*** FLOP *** [Qs Ks Kc]
sandarobert1: checks 
vitor762: bets 3200
sandarobert1: calls 3200
*** TURN *** [Qs Ks Kc] [9h]
sandarobert1: checks 
vitor762: checks 
*** RIVER *** [Qs Ks Kc 9h] [Td]
sandarobert1: bets 13416
vitor762: folds 
Uncalled bet (13416) returned to sandarobert1
sandarobert1 collected 17200 from pot
*** SUMMARY ***
Total pot 17200 | Rake 0 
Board [Qs Ks Kc 9h Td]
Seat 1: vitor762 folded on the River
Seat 2: mikilool (button) folded before Flop (didn't bet)
Seat 3: DaDumon (small blind) folded before Flop
Seat 4: Pkrscott1992 (big blind) folded before Flop
Seat 5: SkemGeeMan folded before Flop (didn't bet)
Seat 6: JACKPOT786 folded before Flop (didn't bet)
Seat 7: sandarobert1 collected (17200)
Seat 8: thrasher71 folded before Flop (didn't bet)

PokerStars Hand #251205246561: Tournament #3767885527, $40+$10+$5 USD Hold'em No Limit - Level X (500/1000) - 2024/06/26 18:42:35 UTC [2024/06/26 14:42:35 ET]
Table '3767885527 59' 8-max Seat #3 is the button
Seat 1: vitor762 (12598 in chips) 
Seat 2: mikilool (25620 in chips) 
Seat 3: DaDumon (40889 in chips) 
Seat 4: Pkrscott1992 (67739 in chips) 
Seat 5: SkemGeeMan (25005 in chips) 
Seat 6: JACKPOT786 (30581 in chips) 
Seat 7: sandarobert1 (111048 in chips) 
Seat 8: thrasher71 (56564 in chips) 
vitor762: posts the ante 125
mikilool: posts the ante 125
DaDumon: posts the ante 125
Pkrscott1992: posts the ante 125
SkemGeeMan: posts the ante 125
JACKPOT786: posts the ante 125
sandarobert1: posts the ante 125
thrasher71: posts the ante 125
Pkrscott1992: posts small blind 500
SkemGeeMan: posts big blind 1000
*** HOLE CARDS ***
JACKPOT786: folds 
sandarobert1: folds 
thrasher71: folds 
vitor762: folds 
mikilool: folds 
DaDumon: raises 1000 to 2000
Pkrscott1992: folds 
SkemGeeMan: calls 1000
*** FLOP *** [6h 8d Qd]
SkemGeeMan: checks 
DaDumon: bets 3020
SkemGeeMan: folds 
Uncalled bet (3020) returned to DaDumon
DaDumon collected 5500 from pot
DaDumon: doesn't show hand 
*** SUMMARY ***
Total pot 5500 | Rake 0 
Board [6h 8d Qd]
Seat 1: vitor762 folded before Flop (didn't bet)
Seat 2: mikilool folded before Flop (didn't bet)
Seat 3: DaDumon (button) collected (5500)
Seat 4: Pkrscott1992 (small blind) folded before Flop
Seat 5: SkemGeeMan (big blind) folded on the Flop
Seat 6: JACKPOT786 folded before Flop (didn't bet)
Seat 7: sandarobert1 folded before Flop (didn't bet)
Seat 8: thrasher71 folded before Flop (didn't bet)

PokerStars Hand #251205272142: Tournament #3767885527, $40+$10+$5 USD Hold'em No Limit - Level X (500/1000) - 2024/06/26 18:44:13 UTC [2024/06/26 14:44:13 ET]
Table '3767885527 59' 8-max Seat #4 is the button
Seat 1: vitor762 (12473 in chips) 
Seat 2: mikilool (25495 in chips) 
Seat 3: DaDumon (44264 in chips) 
Seat 4: Pkrscott1992 (67114 in chips) 
Seat 5: SkemGeeMan (22880 in chips) 
Seat 6: JACKPOT786 (30456 in chips) 
Seat 7: sandarobert1 (110923 in chips) 
Seat 8: thrasher71 (56439 in chips) 
vitor762: posts the ante 125
mikilool: posts the ante 125
DaDumon: posts the ante 125
Pkrscott1992: posts the ante 125
SkemGeeMan: posts the ante 125
JACKPOT786: posts the ante 125
sandarobert1: posts the ante 125
thrasher71: posts the ante 125
SkemGeeMan: posts small blind 500
JACKPOT786: posts big blind 1000
*** HOLE CARDS ***
sandarobert1: raises 1200 to 2200
thrasher71: folds 
vitor762: folds 
mikilool: folds 
DaDumon: folds 
Pkrscott1992: calls 2200
SkemGeeMan: folds 
JACKPOT786: calls 1200
*** FLOP *** [5s Qh 8c]
JACKPOT786: checks 
sandarobert1: bets 2835
Pkrscott1992: calls 2835
JACKPOT786: calls 2835
*** TURN *** [5s Qh 8c] [2s]
JACKPOT786: checks 
sandarobert1: checks 
Pkrscott1992: bets 9000
JACKPOT786: folds 
sandarobert1: folds 
Uncalled bet (9000) returned to Pkrscott1992
Pkrscott1992 collected 16605 from pot
Pkrscott1992: doesn't show hand 
*** SUMMARY ***
Total pot 16605 | Rake 0 
Board [5s Qh 8c 2s]
Seat 1: vitor762 folded before Flop (didn't bet)
Seat 2: mikilool folded before Flop (didn't bet)
Seat 3: DaDumon folded before Flop (didn't bet)
Seat 4: Pkrscott1992 (button) collected (16605)
Seat 5: SkemGeeMan (small blind) folded before Flop
Seat 6: JACKPOT786 (big blind) folded on the Turn
Seat 7: sandarobert1 folded on the Turn
Seat 8: thrasher71 folded before Flop (didn't bet)

PokerStars Hand #251205290523: Tournament #3767885527, $40+$10+$5 USD Hold'em No Limit - Level X (500/1000) - 2024/06/26 18:45:22 UTC [2024/06/26 14:45:22 ET]
Table '3767885527 59' 8-max Seat #5 is the button
Seat 1: vitor762 (12348 in chips) 
Seat 2: mikilool (25370 in chips) 
Seat 3: DaDumon (44139 in chips) 
Seat 4: Pkrscott1992 (78559 in chips) 
Seat 5: SkemGeeMan (22255 in chips) 
Seat 6: JACKPOT786 (25296 in chips) 
Seat 7: sandarobert1 (105763 in chips) 
Seat 8: thrasher71 (56314 in chips) 
vitor762: posts the ante 125
mikilool: posts the ante 125
DaDumon: posts the ante 125
Pkrscott1992: posts the ante 125
SkemGeeMan: posts the ante 125
JACKPOT786: posts the ante 125
sandarobert1: posts the ante 125
thrasher71: posts the ante 125
JACKPOT786: posts small blind 500
sandarobert1: posts big blind 1000
*** HOLE CARDS ***
thrasher71: folds 
vitor762: folds 
mikilool: folds 
DaDumon: folds 
Pkrscott1992: raises 1000 to 2000
SkemGeeMan: folds 
JACKPOT786: folds 
sandarobert1: calls 1000
*** FLOP *** [2h 9c Qs]
sandarobert1: checks 
Pkrscott1992: bets 2000
sandarobert1: calls 2000
*** TURN *** [2h 9c Qs] [Ah]
sandarobert1: checks 
Pkrscott1992: bets 5000
sandarobert1: folds 
Uncalled bet (5000) returned to Pkrscott1992
Pkrscott1992 collected 9500 from pot
Pkrscott1992: doesn't show hand 
*** SUMMARY ***
Total pot 9500 | Rake 0 
Board [2h 9c Qs Ah]
Seat 1: vitor762 folded before Flop (didn't bet)
Seat 2: mikilool folded before Flop (didn't bet)
Seat 3: DaDumon folded before Flop (didn't bet)
Seat 4: Pkrscott1992 collected (9500)
Seat 5: SkemGeeMan (button) folded before Flop (didn't bet)
Seat 6: JACKPOT786 (small blind) folded before Flop
Seat 7: sandarobert1 (big blind) folded on the Turn
Seat 8: thrasher71 folded before Flop (didn't bet)

PokerStars Hand #251205306333: Tournament #3767885527, $40+$10+$5 USD Hold'em No Limit - Level X (500/1000) - 2024/06/26 18:46:21 UTC [2024/06/26 14:46:21 ET]
Table '3767885527 59' 8-max Seat #6 is the button
Seat 1: vitor762 (12223 in chips) 
Seat 2: mikilool (25245 in chips) 
Seat 3: DaDumon (44014 in chips) 
Seat 5: SkemGeeMan (22130 in chips) 
Seat 6: JACKPOT786 (24671 in chips) 
Seat 7: sandarobert1 (101638 in chips) 
Seat 8: thrasher71 (56189 in chips) 
vitor762: posts the ante 125
mikilool: posts the ante 125
DaDumon: posts the ante 125
SkemGeeMan: posts the ante 125
JACKPOT786: posts the ante 125
sandarobert1: posts the ante 125
thrasher71: posts the ante 125
sandarobert1: posts small blind 500
thrasher71: posts big blind 1000
*** HOLE CARDS ***
vitor762: raises 1000 to 2000
mikilool: folds 
DaDumon: folds 
SkemGeeMan: raises 20005 to 22005 and is all-in
JACKPOT786: folds 
sandarobert1: folds 
Brauliocsp is disconnected 
thrasher71 has timed out
thrasher71: folds 
thrasher71 is sitting out
thrasher71 has returned
vitor762: folds 
Uncalled bet (20005) returned to SkemGeeMan
SkemGeeMan collected 6375 from pot
SkemGeeMan: doesn't show hand 
*** SUMMARY ***
Total pot 6375 | Rake 0 
Seat 1: vitor762 folded before Flop
Seat 2: mikilool folded before Flop (didn't bet)
Seat 3: DaDumon folded before Flop (didn't bet)
Seat 5: SkemGeeMan collected (6375)
Seat 6: JACKPOT786 (button) folded before Flop (didn't bet)
Seat 7: sandarobert1 (small blind) folded before Flop
Seat 8: thrasher71 (big blind) folded before Flop

PokerStars Hand #251205319416: Tournament #3767885527, $40+$10+$5 USD Hold'em No Limit - Level X (500/1000) - 2024/06/26 18:47:11 UTC [2024/06/26 14:47:11 ET]
Table '3767885527 59' 8-max Seat #7 is the button
Seat 1: vitor762 (10098 in chips) 
Seat 2: mikilool (25120 in chips) 
Seat 3: DaDumon (43889 in chips) 
Seat 4: Brauliocsp (25000 in chips) 
Seat 5: SkemGeeMan (26380 in chips) 
Seat 6: JACKPOT786 (24546 in chips) 
Seat 7: sandarobert1 (101013 in chips) 
Seat 8: thrasher71 (55064 in chips) 
vitor762: posts the ante 125
mikilool: posts the ante 125
DaDumon: posts the ante 125
Brauliocsp: posts the ante 125
SkemGeeMan: posts the ante 125
JACKPOT786: posts the ante 125
sandarobert1: posts the ante 125
thrasher71: posts the ante 125
thrasher71: posts small blind 500
vitor762: posts big blind 1000
*** HOLE CARDS ***
mikilool: raises 1000 to 2000
DaDumon: folds 
Brauliocsp: folds 
SkemGeeMan: folds 
JACKPOT786: folds 
sandarobert1: folds 
thrasher71 has timed out
thrasher71: folds 
thrasher71 is sitting out
thrasher71 has returned
vitor762: raises 7973 to 9973 and is all-in
mikilool: calls 7973
*** FLOP *** [9h 3c Js]
*** TURN *** [9h 3c Js] [6s]
*** RIVER *** [9h 3c Js 6s] [Td]
*** SHOW DOWN ***
vitor762: shows [9c 9d] (three of a kind, Nines)
mikilool: shows [As Qs] (high card Ace)
vitor762 collected 21446 from pot
*** SUMMARY ***
Total pot 21446 | Rake 0 
Board [9h 3c Js 6s Td]
Seat 1: vitor762 (big blind) showed [9c 9d] and won (21446) with three of a kind, Nines
Seat 2: mikilool showed [As Qs] and lost with high card Ace
Seat 3: DaDumon folded before Flop (didn't bet)
Seat 4: Brauliocsp folded before Flop (didn't bet)
Seat 5: SkemGeeMan folded before Flop (didn't bet)
Seat 6: JACKPOT786 folded before Flop (didn't bet)
Seat 7: sandarobert1 (button) folded before Flop (didn't bet)
Seat 8: thrasher71 (small blind) folded before Flop

PokerStars Hand #251205332711: Tournament #3767885527, $40+$10+$5 USD Hold'em No Limit - Level X (500/1000) - 2024/06/26 18:48:02 UTC [2024/06/26 14:48:02 ET]
Table '3767885527 59' 8-max Seat #8 is the button
Seat 1: vitor762 (21446 in chips) 
Seat 2: mikilool (15022 in chips) 
Seat 3: DaDumon (43764 in chips) 
Seat 4: Brauliocsp (24875 in chips) 
Seat 5: SkemGeeMan (26255 in chips) 
Seat 6: JACKPOT786 (24421 in chips) 
Seat 7: sandarobert1 (100888 in chips) 
Seat 8: thrasher71 (54439 in chips) 
vitor762: posts the ante 125
mikilool: posts the ante 125
DaDumon: posts the ante 125
Brauliocsp: posts the ante 125
SkemGeeMan: posts the ante 125
JACKPOT786: posts the ante 125
sandarobert1: posts the ante 125
thrasher71: posts the ante 125
vitor762: posts small blind 500
mikilool: posts big blind 1000
*** HOLE CARDS ***
DaDumon: raises 1000 to 2000
Brauliocsp: folds 
SkemGeeMan: folds 
JACKPOT786: folds 
sandarobert1: folds 
thrasher71: folds 
vitor762: folds 
mikilool: folds 
Uncalled bet (1000) returned to DaDumon
DaDumon collected 3500 from pot
DaDumon: doesn't show hand 
*** SUMMARY ***
Total pot 3500 | Rake 0 
Seat 1: vitor762 (small blind) folded before Flop
Seat 2: mikilool (big blind) folded before Flop
Seat 3: DaDumon collected (3500)
Seat 4: Brauliocsp folded before Flop (didn't bet)
Seat 5: SkemGeeMan folded before Flop (didn't bet)
Seat 6: JACKPOT786 folded before Flop (didn't bet)
Seat 7: sandarobert1 folded before Flop (didn't bet)
Seat 8: thrasher71 (button) folded before Flop (didn't bet)

PokerStars Hand #251205344455: Tournament #3767885527, $40+$10+$5 USD Hold'em No Limit - Level X (500/1000) - 2024/06/26 18:48:46 UTC [2024/06/26 14:48:46 ET]
Table '3767885527 59' 8-max Seat #1 is the button
Seat 1: vitor762 (20821 in chips) 
Seat 2: mikilool (13897 in chips) 
Seat 3: DaDumon (46139 in chips) 
Seat 4: Brauliocsp (24750 in chips) 
Seat 5: SkemGeeMan (26130 in chips) 
Seat 6: JACKPOT786 (24296 in chips) 
Seat 7: sandarobert1 (100763 in chips) 
Seat 8: thrasher71 (54314 in chips) 
vitor762: posts the ante 125
mikilool: posts the ante 125
DaDumon: posts the ante 125
Brauliocsp: posts the ante 125
SkemGeeMan: posts the ante 125
JACKPOT786: posts the ante 125
sandarobert1: posts the ante 125
thrasher71: posts the ante 125
mikilool: posts small blind 500
DaDumon: posts big blind 1000
*** HOLE CARDS ***
Brauliocsp: folds 
SkemGeeMan has timed out
SkemGeeMan: folds 
SkemGeeMan is sitting out
JACKPOT786: folds 
sandarobert1: folds 
SkemGeeMan has returned
thrasher71 has timed out
thrasher71: folds 
thrasher71 is sitting out
thrasher71 has returned
vitor762: folds 
mikilool: folds 
Uncalled bet (500) returned to DaDumon
DaDumon collected 2000 from pot
DaDumon: doesn't show hand 
*** SUMMARY ***
Total pot 2000 | Rake 0 
Seat 1: vitor762 (button) folded before Flop (didn't bet)
Seat 2: mikilool (small blind) folded before Flop
Seat 3: DaDumon (big blind) collected (2000)
Seat 4: Brauliocsp folded before Flop (didn't bet)
Seat 5: SkemGeeMan folded before Flop (didn't bet)
Seat 6: JACKPOT786 folded before Flop (didn't bet)
Seat 7: sandarobert1 folded before Flop (didn't bet)
Seat 8: thrasher71 folded before Flop (didn't bet)

PokerStars Hand #251205363134: Tournament #3767885527, $40+$10+$5 USD Hold'em No Limit - Level X (500/1000) - 2024/06/26 18:49:58 UTC [2024/06/26 14:49:58 ET]
Table '3767885527 59' 8-max Seat #2 is the button
Seat 1: vitor762 (20696 in chips) 
Seat 2: mikilool (13272 in chips) 
Seat 3: DaDumon (47514 in chips) 
Seat 4: Brauliocsp (24625 in chips) 
Seat 5: SkemGeeMan (26005 in chips) 
Seat 6: JACKPOT786 (24171 in chips) 
Seat 7: sandarobert1 (100638 in chips) 
Seat 8: thrasher71 (54189 in chips) 
vitor762: posts the ante 125
mikilool: posts the ante 125
DaDumon: posts the ante 125
Brauliocsp: posts the ante 125
SkemGeeMan: posts the ante 125
JACKPOT786: posts the ante 125
sandarobert1: posts the ante 125
thrasher71: posts the ante 125
DaDumon: posts small blind 500
Brauliocsp: posts big blind 1000
*** HOLE CARDS ***
SkemGeeMan: folds 
JACKPOT786: folds 
sandarobert1: raises 1000 to 2000
thrasher71: folds 
vitor762: folds 
mikilool: folds 
DaDumon: folds 
Brauliocsp: calls 1000
*** FLOP *** [3s Qc 9h]
Brauliocsp: checks 
sandarobert1: bets 1925
Brauliocsp: folds 
Uncalled bet (1925) returned to sandarobert1
sandarobert1 collected 5500 from pot
*** SUMMARY ***
Total pot 5500 | Rake 0 
Board [3s Qc 9h]
Seat 1: vitor762 folded before Flop (didn't bet)
Seat 2: mikilool (button) folded before Flop (didn't bet)
Seat 3: DaDumon (small blind) folded before Flop
Seat 4: Brauliocsp (big blind) folded on the Flop
Seat 5: SkemGeeMan folded before Flop (didn't bet)
Seat 6: JACKPOT786 folded before Flop (didn't bet)
Seat 7: sandarobert1 collected (5500)
Seat 8: thrasher71 folded before Flop (didn't bet)

PokerStars Hand #251205378621: Tournament #3767885527, $40+$10+$5 USD Hold'em No Limit - Level X (500/1000) - 2024/06/26 18:50:57 UTC [2024/06/26 14:50:57 ET]
Table '3767885527 59' 8-max Seat #3 is the button
Seat 1: vitor762 (20571 in chips) 
Seat 2: mikilool (13147 in chips) 
Seat 3: DaDumon (46889 in chips) 
Seat 4: Brauliocsp (22500 in chips) 
Seat 5: SkemGeeMan (25880 in chips) 
Seat 6: JACKPOT786 (24046 in chips) 
Seat 7: sandarobert1 (104013 in chips) 
Seat 8: thrasher71 (54064 in chips) 
vitor762: posts the ante 125
mikilool: posts the ante 125
DaDumon: posts the ante 125
Brauliocsp: posts the ante 125
SkemGeeMan: posts the ante 125
JACKPOT786: posts the ante 125
sandarobert1: posts the ante 125
thrasher71: posts the ante 125
Brauliocsp: posts small blind 500
SkemGeeMan: posts big blind 1000
*** HOLE CARDS ***
JACKPOT786: folds 
sandarobert1: folds 
thrasher71: raises 1000 to 2000
vitor762: folds 
mikilool: folds 
DaDumon: folds 
Brauliocsp: folds 
SkemGeeMan: folds 
Uncalled bet (1000) returned to thrasher71
thrasher71 collected 3500 from pot
thrasher71: doesn't show hand 
*** SUMMARY ***
Total pot 3500 | Rake 0 
Seat 1: vitor762 folded before Flop (didn't bet)
Seat 2: mikilool folded before Flop (didn't bet)
Seat 3: DaDumon (button) folded before Flop (didn't bet)
Seat 4: Brauliocsp (small blind) folded before Flop
Seat 5: SkemGeeMan (big blind) folded before Flop
Seat 6: JACKPOT786 folded before Flop (didn't bet)
Seat 7: sandarobert1 folded before Flop (didn't bet)
Seat 8: thrasher71 collected (3500)

PokerStars Hand #251205387982: Tournament #3767885527, $40+$10+$5 USD Hold'em No Limit - Level X (500/1000) - 2024/06/26 18:51:33 UTC [2024/06/26 14:51:33 ET]
Table '3767885527 59' 8-max Seat #4 is the button
Seat 1: vitor762 (20446 in chips) 
Seat 2: mikilool (13022 in chips) 
Seat 3: DaDumon (46764 in chips) 
Seat 4: Brauliocsp (21875 in chips) 
Seat 5: SkemGeeMan (24755 in chips) 
Seat 6: JACKPOT786 (23921 in chips) 
Seat 7: sandarobert1 (103888 in chips) 
Seat 8: thrasher71 (56439 in chips) 
vitor762: posts the ante 125
mikilool: posts the ante 125
DaDumon: posts the ante 125
Brauliocsp: posts the ante 125
SkemGeeMan: posts the ante 125
JACKPOT786: posts the ante 125
sandarobert1: posts the ante 125
thrasher71: posts the ante 125
SkemGeeMan: posts small blind 500
JACKPOT786: posts big blind 1000
*** HOLE CARDS ***
sandarobert1: raises 1000 to 2000
thrasher71: folds 
vitor762: folds 
mikilool: folds 
DaDumon: calls 2000
Brauliocsp: raises 19750 to 21750 and is all-in
SkemGeeMan: folds 
JACKPOT786: folds 
sandarobert1: folds 
DaDumon: calls 19750
*** FLOP *** [Qh 2s 2h]
*** TURN *** [Qh 2s 2h] [As]
*** RIVER *** [Qh 2s 2h As] [Ts]
*** SHOW DOWN ***
DaDumon: shows [3s 3d] (two pair, Threes and Deuces)
Brauliocsp: shows [Jd Js] (two pair, Jacks and Deuces)
Brauliocsp collected 48000 from pot
*** SUMMARY ***
Total pot 48000 | Rake 0 
Board [Qh 2s 2h As Ts]
Seat 1: vitor762 folded before Flop (didn't bet)
Seat 2: mikilool folded before Flop (didn't bet)
Seat 3: DaDumon showed [3s 3d] and lost with two pair, Threes and Deuces
Seat 4: Brauliocsp (button) showed [Jd Js] and won (48000) with two pair, Jacks and Deuces
Seat 5: SkemGeeMan (small blind) folded before Flop
Seat 6: JACKPOT786 (big blind) folded before Flop
Seat 7: sandarobert1 folded before Flop
Seat 8: thrasher71 folded before Flop (didn't bet)

PokerStars Hand #251205408563: Tournament #3767885527, $40+$10+$5 USD Hold'em No Limit - Level XI (600/1200) - 2024/06/26 18:52:51 UTC [2024/06/26 14:52:51 ET]
Table '3767885527 59' 8-max Seat #5 is the button
Seat 1: vitor762 (20321 in chips) 
Seat 2: mikilool (12897 in chips) 
Seat 3: DaDumon (24889 in chips) 
Seat 4: Brauliocsp (48000 in chips) 
Seat 5: SkemGeeMan (24130 in chips) 
Seat 6: JACKPOT786 (22796 in chips) 
Seat 7: sandarobert1 (101763 in chips) 
Seat 8: thrasher71 (56314 in chips) 
vitor762: posts the ante 150
mikilool: posts the ante 150
DaDumon: posts the ante 150
Brauliocsp: posts the ante 150
SkemGeeMan: posts the ante 150
JACKPOT786: posts the ante 150
sandarobert1: posts the ante 150
thrasher71: posts the ante 150
JACKPOT786: posts small blind 600
sandarobert1: posts big blind 1200
*** HOLE CARDS ***
thrasher71 has timed out
thrasher71: folds 
thrasher71 is sitting out
thrasher71 has returned
vitor762: folds 
mikilool: raises 11547 to 12747 and is all-in
DaDumon: folds 
Brauliocsp: folds 
SkemGeeMan: folds 
JACKPOT786: raises 9899 to 22646 and is all-in
sandarobert1: folds 
Uncalled bet (9899) returned to JACKPOT786
*** FLOP *** [2s 5h 4h]
*** TURN *** [2s 5h 4h] [6s]
*** RIVER *** [2s 5h 4h 6s] [Qd]
*** SHOW DOWN ***
JACKPOT786: shows [Ks Ad] (high card Ace)
mikilool: shows [Td As] (high card Ace - lower kicker)
JACKPOT786 collected 27894 from pot
mikilool finished the tournament
*** SUMMARY ***
Total pot 27894 | Rake 0 
Board [2s 5h 4h 6s Qd]
Seat 1: vitor762 folded before Flop (didn't bet)
Seat 2: mikilool showed [Td As] and lost with high card Ace
Seat 3: DaDumon folded before Flop (didn't bet)
Seat 4: Brauliocsp folded before Flop (didn't bet)
Seat 5: SkemGeeMan (button) folded before Flop (didn't bet)
Seat 6: JACKPOT786 (small blind) showed [Ks Ad] and won (27894) with high card Ace
Seat 7: sandarobert1 (big blind) folded before Flop
Seat 8: thrasher71 folded before Flop (didn't bet)


PokerStars Hand #251205536182: Tournament #3767885527, $40+$10+$5 USD Hold'em No Limit - Level XI (600/1200) - 2024/06/26 19:02:37 UTC [2024/06/26 15:02:37 ET]
Table '3767885527 58' 8-max Seat #1 is the button
Seat 1: krumbumbuli (17400 in chips) 
Seat 2: Philipoune (50891 in chips) 
Seat 3: Defence_BOMB (32394 in chips) 
Seat 4: alushi6 (24400 in chips) 
Seat 6: conradofpg (42390 in chips) 
Seat 7: jammy1875 (71068 in chips) 
Seat 8: DRY BLECKBERRY (54168 in chips) 
krumbumbuli: posts the ante 150
Philipoune: posts the ante 150
Defence_BOMB: posts the ante 150
alushi6: posts the ante 150
conradofpg: posts the ante 150
jammy1875: posts the ante 150
DRY BLECKBERRY: posts the ante 150
Philipoune: posts small blind 600
Defence_BOMB: posts big blind 1200
*** HOLE CARDS ***
alushi6: folds 
conradofpg: folds 
jammy1875: raises 1200 to 2400
DRY BLECKBERRY: raises 4800 to 7200
krumbumbuli: folds 
Philipoune: folds 
Defence_BOMB: folds 
MTTSharkSnG is disconnected 
jammy1875: calls 4800
*** FLOP *** [Kh 2d 8h]
jammy1875: checks 
DRY BLECKBERRY: bets 4800
jammy1875: calls 4800
*** TURN *** [Kh 2d 8h] [4s]
jammy1875: checks 
DRY BLECKBERRY: checks 
*** RIVER *** [Kh 2d 8h 4s] [3h]
jammy1875: bets 15825
DRY BLECKBERRY: folds 
Uncalled bet (15825) returned to jammy1875
jammy1875 collected 26850 from pot
*** SUMMARY ***
Total pot 26850 | Rake 0 
Board [Kh 2d 8h 4s 3h]
Seat 1: krumbumbuli (button) folded before Flop (didn't bet)
Seat 2: Philipoune (small blind) folded before Flop
Seat 3: Defence_BOMB (big blind) folded before Flop
Seat 4: alushi6 folded before Flop (didn't bet)
Seat 6: conradofpg folded before Flop (didn't bet)
Seat 7: jammy1875 collected (26850)
Seat 8: DRY BLECKBERRY folded on the River

PokerStars Hand #251205553975: Tournament #3767885527, $40+$10+$5 USD Hold'em No Limit - Level XI (600/1200) - 2024/06/26 19:03:48 UTC [2024/06/26 15:03:48 ET]
Table '3767885527 58' 8-max Seat #2 is the button
Seat 1: krumbumbuli (17250 in chips) 
Seat 2: Philipoune (50141 in chips) 
Seat 3: Defence_BOMB (31044 in chips) 
Seat 4: alushi6 (24250 in chips) 
Seat 5: MTTSharkSnG (25000 in chips) 
Seat 6: conradofpg (42240 in chips) 
Seat 7: jammy1875 (85768 in chips) 
Seat 8: DRY BLECKBERRY (42018 in chips) 
krumbumbuli: posts the ante 150
Philipoune: posts the ante 150
Defence_BOMB: posts the ante 150
alushi6: posts the ante 150
MTTSharkSnG: posts the ante 150
conradofpg: posts the ante 150
jammy1875: posts the ante 150
DRY BLECKBERRY: posts the ante 150
Defence_BOMB: posts small blind 600
alushi6: posts big blind 1200
*** HOLE CARDS ***
MTTSharkSnG: folds 
conradofpg: folds 
jammy1875: folds 
DRY BLECKBERRY: raises 1200 to 2400
krumbumbuli: folds 
Philipoune: folds 
Defence_BOMB: raises 28494 to 30894 and is all-in
alushi6: folds 
DRY BLECKBERRY: folds 
Uncalled bet (28494) returned to Defence_BOMB
Defence_BOMB collected 7200 from pot
Defence_BOMB: doesn't show hand 
*** SUMMARY ***
Total pot 7200 | Rake 0 
Seat 1: krumbumbuli folded before Flop (didn't bet)
Seat 2: Philipoune (button) folded before Flop (didn't bet)
Seat 3: Defence_BOMB (small blind) collected (7200)
Seat 4: alushi6 (big blind) folded before Flop
Seat 5: MTTSharkSnG folded before Flop (didn't bet)
Seat 6: conradofpg folded before Flop (didn't bet)
Seat 7: jammy1875 folded before Flop (didn't bet)
Seat 8: DRY BLECKBERRY folded before Flop

PokerStars Hand #251205561952: Tournament #3767885527, $40+$10+$5 USD Hold'em No Limit - Level XI (600/1200) - 2024/06/26 19:04:19 UTC [2024/06/26 15:04:19 ET]
Table '3767885527 58' 8-max Seat #3 is the button
Seat 1: krumbumbuli (17100 in chips) 
Seat 2: Philipoune (49991 in chips) 
Seat 3: Defence_BOMB (35694 in chips) 
Seat 4: alushi6 (22900 in chips) 
Seat 5: MTTSharkSnG (24850 in chips) 
Seat 6: conradofpg (42090 in chips) 
Seat 7: jammy1875 (85618 in chips) 
Seat 8: DRY BLECKBERRY (39468 in chips) 
krumbumbuli: posts the ante 150
Philipoune: posts the ante 150
Defence_BOMB: posts the ante 150
alushi6: posts the ante 150
MTTSharkSnG: posts the ante 150
conradofpg: posts the ante 150
jammy1875: posts the ante 150
DRY BLECKBERRY: posts the ante 150
alushi6: posts small blind 600
MTTSharkSnG: posts big blind 1200
*** HOLE CARDS ***
conradofpg: folds 
jammy1875: folds 
DRY BLECKBERRY: folds 
krumbumbuli: folds 
Philipoune: folds 
Defence_BOMB: folds 
alushi6: calls 600
MTTSharkSnG: raises 23500 to 24700 and is all-in
alushi6: folds 
Uncalled bet (23500) returned to MTTSharkSnG
MTTSharkSnG collected 3600 from pot
MTTSharkSnG: doesn't show hand 
*** SUMMARY ***
Total pot 3600 | Rake 0 
Seat 1: krumbumbuli folded before Flop (didn't bet)
Seat 2: Philipoune folded before Flop (didn't bet)
Seat 3: Defence_BOMB (button) folded before Flop (didn't bet)
Seat 4: alushi6 (small blind) folded before Flop
Seat 5: MTTSharkSnG (big blind) collected (3600)
Seat 6: conradofpg folded before Flop (didn't bet)
Seat 7: jammy1875 folded before Flop (didn't bet)
Seat 8: DRY BLECKBERRY folded before Flop (didn't bet)

PokerStars Hand #251205570283: Tournament #3767885527, $40+$10+$5 USD Hold'em No Limit - Level XI (600/1200) - 2024/06/26 19:04:52 UTC [2024/06/26 15:04:52 ET]
Table '3767885527 58' 8-max Seat #4 is the button
Seat 1: krumbumbuli (16950 in chips) 
Seat 2: Philipoune (49841 in chips) 
Seat 3: Defence_BOMB (35544 in chips) 
Seat 4: alushi6 (21550 in chips) 
Seat 5: MTTSharkSnG (27100 in chips) 
Seat 6: conradofpg (41940 in chips) 
Seat 7: jammy1875 (85468 in chips) 
Seat 8: DRY BLECKBERRY (39318 in chips) 
krumbumbuli: posts the ante 150
Philipoune: posts the ante 150
Defence_BOMB: posts the ante 150
alushi6: posts the ante 150
MTTSharkSnG: posts the ante 150
conradofpg: posts the ante 150
jammy1875: posts the ante 150
DRY BLECKBERRY: posts the ante 150
MTTSharkSnG: posts small blind 600
conradofpg: posts big blind 1200
*** HOLE CARDS ***
jammy1875: folds 
DRY BLECKBERRY: raises 1200 to 2400
krumbumbuli: folds 
Philipoune: folds 
Defence_BOMB: folds 
alushi6: folds 
MTTSharkSnG: raises 6000 to 8400
conradofpg has timed out
conradofpg: folds 
conradofpg is sitting out
DRY BLECKBERRY: folds 
Uncalled bet (6000) returned to MTTSharkSnG
conradofpg has returned
MTTSharkSnG collected 7200 from pot
MTTSharkSnG: doesn't show hand 
*** SUMMARY ***
Total pot 7200 | Rake 0 
Seat 1: krumbumbuli folded before Flop (didn't bet)
Seat 2: Philipoune folded before Flop (didn't bet)
Seat 3: Defence_BOMB folded before Flop (didn't bet)
Seat 4: alushi6 (button) folded before Flop (didn't bet)
Seat 5: MTTSharkSnG (small blind) collected (7200)
Seat 6: conradofpg (big blind) folded before Flop
Seat 7: jammy1875 folded before Flop (didn't bet)
Seat 8: DRY BLECKBERRY folded before Flop

PokerStars Hand #251205581428: Tournament #3767885527, $40+$10+$5 USD Hold'em No Limit - Level XI (600/1200) - 2024/06/26 19:05:34 UTC [2024/06/26 15:05:34 ET]
Table '3767885527 58' 8-max Seat #5 is the button
Seat 1: krumbumbuli (16800 in chips) 
Seat 2: Philipoune (49691 in chips) 
Seat 3: Defence_BOMB (35394 in chips) 
Seat 4: alushi6 (21400 in chips) 
Seat 5: MTTSharkSnG (31750 in chips) 
Seat 6: conradofpg (40590 in chips) 
Seat 7: jammy1875 (85318 in chips) 
Seat 8: DRY BLECKBERRY (36768 in chips) 
krumbumbuli: posts the ante 150
Philipoune: posts the ante 150
Defence_BOMB: posts the ante 150
alushi6: posts the ante 150
MTTSharkSnG: posts the ante 150
conradofpg: posts the ante 150
jammy1875: posts the ante 150
DRY BLECKBERRY: posts the ante 150
conradofpg: posts small blind 600
jammy1875: posts big blind 1200
*** HOLE CARDS ***
DRY BLECKBERRY: folds 
krumbumbuli: folds 
Philipoune: folds 
Defence_BOMB: folds 
alushi6: folds 
MTTSharkSnG: folds 
conradofpg: folds 
Uncalled bet (600) returned to jammy1875
jammy1875 collected 2400 from pot
*** SUMMARY ***
Total pot 2400 | Rake 0 
Seat 1: krumbumbuli folded before Flop (didn't bet)
Seat 2: Philipoune folded before Flop (didn't bet)
Seat 3: Defence_BOMB folded before Flop (didn't bet)
Seat 4: alushi6 folded before Flop (didn't bet)
Seat 5: MTTSharkSnG (button) folded before Flop (didn't bet)
Seat 6: conradofpg (small blind) folded before Flop
Seat 7: jammy1875 (big blind) collected (2400)
Seat 8: DRY BLECKBERRY folded before Flop (didn't bet)

PokerStars Hand #251205586748: Tournament #3767885527, $40+$10+$5 USD Hold'em No Limit - Level XI (600/1200) - 2024/06/26 19:05:54 UTC [2024/06/26 15:05:54 ET]
Table '3767885527 58' 8-max Seat #6 is the button
Seat 1: krumbumbuli (16650 in chips) 
Seat 2: Philipoune (49541 in chips) 
Seat 3: Defence_BOMB (35244 in chips) 
Seat 4: alushi6 (21250 in chips) 
Seat 5: MTTSharkSnG (31600 in chips) 
Seat 6: conradofpg (39840 in chips) 
Seat 7: jammy1875 (86968 in chips) 
Seat 8: DRY BLECKBERRY (36618 in chips) 
krumbumbuli: posts the ante 150
Philipoune: posts the ante 150
Defence_BOMB: posts the ante 150
alushi6: posts the ante 150
MTTSharkSnG: posts the ante 150
conradofpg: posts the ante 150
jammy1875: posts the ante 150
DRY BLECKBERRY: posts the ante 150
jammy1875: posts small blind 600
DRY BLECKBERRY: posts big blind 1200
*** HOLE CARDS ***
krumbumbuli: raises 15300 to 16500 and is all-in
Philipoune: folds 
Defence_BOMB: folds 
alushi6: folds 
MTTSharkSnG: folds 
conradofpg: folds 
jammy1875 has timed out
jammy1875: folds 
jammy1875 is sitting out
DRY BLECKBERRY: folds 
Uncalled bet (15300) returned to krumbumbuli
krumbumbuli collected 4200 from pot
krumbumbuli: doesn't show hand 
*** SUMMARY ***
Total pot 4200 | Rake 0 
Seat 1: krumbumbuli collected (4200)
Seat 2: Philipoune folded before Flop (didn't bet)
Seat 3: Defence_BOMB folded before Flop (didn't bet)
Seat 4: alushi6 folded before Flop (didn't bet)
Seat 5: MTTSharkSnG folded before Flop (didn't bet)
Seat 6: conradofpg (button) folded before Flop (didn't bet)
Seat 7: jammy1875 (small blind) folded before Flop
Seat 8: DRY BLECKBERRY (big blind) folded before Flop

PokerStars Hand #251205599329: Tournament #3767885527, $40+$10+$5 USD Hold'em No Limit - Level XI (600/1200) - 2024/06/26 19:06:41 UTC [2024/06/26 15:06:41 ET]
Table '3767885527 58' 8-max Seat #7 is the button
Seat 1: krumbumbuli (19500 in chips) 
Seat 2: Philipoune (49391 in chips) 
Seat 3: Defence_BOMB (35094 in chips) 
Seat 4: alushi6 (21100 in chips) 
Seat 5: MTTSharkSnG (31450 in chips) 
Seat 6: conradofpg (39690 in chips) 
Seat 7: jammy1875 (86218 in chips) is sitting out
Seat 8: DRY BLECKBERRY (35268 in chips) 
krumbumbuli: posts the ante 150
Philipoune: posts the ante 150
Defence_BOMB: posts the ante 150
alushi6: posts the ante 150
MTTSharkSnG: posts the ante 150
conradofpg: posts the ante 150
jammy1875: posts the ante 150
DRY BLECKBERRY: posts the ante 150
DRY BLECKBERRY: posts small blind 600
krumbumbuli: posts big blind 1200
*** HOLE CARDS ***
Philipoune: folds 
jammy1875 has returned
Defence_BOMB: folds 
alushi6: raises 1200 to 2400
MTTSharkSnG: folds 
conradofpg: folds 
jammy1875: calls 2400
DRY BLECKBERRY: folds 
krumbumbuli: calls 1200
*** FLOP *** [6d Qd As]
krumbumbuli: checks 
alushi6: checks 
jammy1875: bets 3600
krumbumbuli: calls 3600
alushi6: folds 
*** TURN *** [6d Qd As] [6s]
krumbumbuli: checks 
jammy1875: bets 16200
krumbumbuli: folds 
Uncalled bet (16200) returned to jammy1875
jammy1875 collected 16200 from pot
*** SUMMARY ***
Total pot 16200 | Rake 0 
Board [6d Qd As 6s]
Seat 1: krumbumbuli (big blind) folded on the Turn
Seat 2: Philipoune folded before Flop (didn't bet)
Seat 3: Defence_BOMB folded before Flop (didn't bet)
Seat 4: alushi6 folded on the Flop
Seat 5: MTTSharkSnG folded before Flop (didn't bet)
Seat 6: conradofpg folded before Flop (didn't bet)
Seat 7: jammy1875 (button) collected (16200)
Seat 8: DRY BLECKBERRY (small blind) folded before Flop

PokerStars Hand #251205616568: Tournament #3767885527, $40+$10+$5 USD Hold'em No Limit - Level XI (600/1200) - 2024/06/26 19:07:46 UTC [2024/06/26 15:07:46 ET]
Table '3767885527 58' 8-max Seat #8 is the button
Seat 1: krumbumbuli (13350 in chips) 
Seat 2: Philipoune (49241 in chips) 
Seat 3: Defence_BOMB (34944 in chips) 
Seat 4: alushi6 (18550 in chips) 
Seat 5: MTTSharkSnG (31300 in chips) 
Seat 6: conradofpg (39540 in chips) 
Seat 7: jammy1875 (96268 in chips) 
Seat 8: DRY BLECKBERRY (34518 in chips) 
krumbumbuli: posts the ante 150
Philipoune: posts the ante 150
Defence_BOMB: posts the ante 150
alushi6: posts the ante 150
MTTSharkSnG: posts the ante 150
conradofpg: posts the ante 150
jammy1875: posts the ante 150
DRY BLECKBERRY: posts the ante 150
krumbumbuli: posts small blind 600
Philipoune: posts big blind 1200
*** HOLE CARDS ***
Defence_BOMB: folds 
alushi6: folds 
MTTSharkSnG: folds 
conradofpg: raises 1200 to 2400
jammy1875: calls 2400
DRY BLECKBERRY: folds 
krumbumbuli: calls 1800
Philipoune: raises 46691 to 49091 and is all-in
conradofpg: folds 
jammy1875: folds 
krumbumbuli: calls 10800 and is all-in
Uncalled bet (35891) returned to Philipoune
*** FLOP *** [Qs 2c Kh]
*** TURN *** [Qs 2c Kh] [As]
*** RIVER *** [Qs 2c Kh As] [2d]
*** SHOW DOWN ***
krumbumbuli: shows [6d 9d] (a pair of Deuces)
Philipoune: shows [Jd Kc] (two pair, Kings and Deuces)
Philipoune collected 32400 from pot
krumbumbuli finished the tournament
*** SUMMARY ***
Total pot 32400 | Rake 0 
Board [Qs 2c Kh As 2d]
Seat 1: krumbumbuli (small blind) showed [6d 9d] and lost with a pair of Deuces
Seat 2: Philipoune (big blind) showed [Jd Kc] and won (32400) with two pair, Kings and Deuces
Seat 3: Defence_BOMB folded before Flop (didn't bet)
Seat 4: alushi6 folded before Flop (didn't bet)
Seat 5: MTTSharkSnG folded before Flop (didn't bet)
Seat 6: conradofpg folded before Flop
Seat 7: jammy1875 folded before Flop
Seat 8: DRY BLECKBERRY (button) folded before Flop (didn't bet)

PokerStars Hand #251205630096: Tournament #3767885527, $40+$10+$5 USD Hold'em No Limit - Level XI (600/1200) - 2024/06/26 19:08:37 UTC [2024/06/26 15:08:37 ET]
Table '3767885527 58' 8-max Seat #2 is the button
Seat 2: Philipoune (68291 in chips) 
Seat 3: Defence_BOMB (34794 in chips) 
Seat 4: alushi6 (18400 in chips) 
Seat 5: MTTSharkSnG (31150 in chips) 
Seat 6: conradofpg (36990 in chips) 
Seat 7: jammy1875 (93718 in chips) 
Seat 8: DRY BLECKBERRY (34368 in chips) 
Philipoune: posts the ante 150
Defence_BOMB: posts the ante 150
alushi6: posts the ante 150
MTTSharkSnG: posts the ante 150
conradofpg: posts the ante 150
jammy1875: posts the ante 150
DRY BLECKBERRY: posts the ante 150
Defence_BOMB: posts small blind 600
alushi6: posts big blind 1200
*** HOLE CARDS ***
MTTSharkSnG: folds 
conradofpg: folds 
jammy1875: raises 1200 to 2400
DRY BLECKBERRY: folds 
Philipoune: folds 
Defence_BOMB: folds 
leitalopez is disconnected 
alushi6: calls 1200
*** FLOP *** [8h 7c Kc]
alushi6: checks 
jammy1875: bets 3600
alushi6: calls 3600
*** TURN *** [8h 7c Kc] [Qs]
alushi6: checks 
jammy1875: bets 4800
alushi6: folds 
Uncalled bet (4800) returned to jammy1875
jammy1875 collected 13650 from pot
*** SUMMARY ***
Total pot 13650 | Rake 0 
Board [8h 7c Kc Qs]
Seat 2: Philipoune (button) folded before Flop (didn't bet)
Seat 3: Defence_BOMB (small blind) folded before Flop
Seat 4: alushi6 (big blind) folded on the Turn
Seat 5: MTTSharkSnG folded before Flop (didn't bet)
Seat 6: conradofpg folded before Flop (didn't bet)
Seat 7: jammy1875 collected (13650)
Seat 8: DRY BLECKBERRY folded before Flop (didn't bet)

PokerStars Hand #251205652099: Tournament #3767885527, $40+$10+$5 USD Hold'em No Limit - Level XII (700/1400) - 2024/06/26 19:09:59 UTC [2024/06/26 15:09:59 ET]
Table '3767885527 58' 8-max Seat #3 is the button
Seat 1: leitalopez (25000 in chips) 
Seat 2: Philipoune (68141 in chips) 
Seat 3: Defence_BOMB (34044 in chips) 
Seat 4: alushi6 (12250 in chips) 
Seat 5: MTTSharkSnG (31000 in chips) 
Seat 6: conradofpg (36840 in chips) 
Seat 7: jammy1875 (101218 in chips) 
Seat 8: DRY BLECKBERRY (34218 in chips) 
leitalopez: posts the ante 175
Philipoune: posts the ante 175
Defence_BOMB: posts the ante 175
alushi6: posts the ante 175
MTTSharkSnG: posts the ante 175
conradofpg: posts the ante 175
jammy1875: posts the ante 175
DRY BLECKBERRY: posts the ante 175
alushi6: posts small blind 700
MTTSharkSnG: posts big blind 1400
*** HOLE CARDS ***
conradofpg: folds 
jammy1875: raises 1400 to 2800
DRY BLECKBERRY: folds 
leitalopez: folds 
Philipoune: folds 
Defence_BOMB: folds 
alushi6: raises 9275 to 12075 and is all-in
MTTSharkSnG: folds 
jammy1875: calls 9275
*** FLOP *** [Ac Th Qh]
*** TURN *** [Ac Th Qh] [5d]
*** RIVER *** [Ac Th Qh 5d] [Ad]
*** SHOW DOWN ***
alushi6: shows [Kh Ah] (three of a kind, Aces)
jammy1875: shows [As 4h] (three of a kind, Aces - lower kicker)
alushi6 collected 26950 from pot
*** SUMMARY ***
Total pot 26950 | Rake 0 
Board [Ac Th Qh 5d Ad]
Seat 1: leitalopez folded before Flop (didn't bet)
Seat 2: Philipoune folded before Flop (didn't bet)
Seat 3: Defence_BOMB (button) folded before Flop (didn't bet)
Seat 4: alushi6 (small blind) showed [Kh Ah] and won (26950) with three of a kind, Aces
Seat 5: MTTSharkSnG (big blind) folded before Flop
Seat 6: conradofpg folded before Flop (didn't bet)
Seat 7: jammy1875 showed [As 4h] and lost with three of a kind, Aces
Seat 8: DRY BLECKBERRY folded before Flop (didn't bet)

PokerStars Hand #251205662045: Tournament #3767885527, $40+$10+$5 USD Hold'em No Limit - Level XII (700/1400) - 2024/06/26 19:10:36 UTC [2024/06/26 15:10:36 ET]
Table '3767885527 58' 8-max Seat #4 is the button
Seat 1: leitalopez (24825 in chips) 
Seat 2: Philipoune (67966 in chips) 
Seat 3: Defence_BOMB (33869 in chips) 
Seat 4: alushi6 (26950 in chips) 
Seat 5: MTTSharkSnG (29425 in chips) 
Seat 6: conradofpg (36665 in chips) 
Seat 7: jammy1875 (88968 in chips) 
Seat 8: DRY BLECKBERRY (34043 in chips) 
leitalopez: posts the ante 175
Philipoune: posts the ante 175
Defence_BOMB: posts the ante 175
alushi6: posts the ante 175
MTTSharkSnG: posts the ante 175
conradofpg: posts the ante 175
jammy1875: posts the ante 175
DRY BLECKBERRY: posts the ante 175
MTTSharkSnG: posts small blind 700
conradofpg: posts big blind 1400
*** HOLE CARDS ***
jammy1875: raises 1400 to 2800
DRY BLECKBERRY: folds 
leitalopez: raises 21850 to 24650 and is all-in
Philipoune: folds 
Defence_BOMB: folds 
alushi6: folds 
MTTSharkSnG: folds 
conradofpg: folds 
jammy1875: folds 
Uncalled bet (21850) returned to leitalopez
leitalopez collected 9100 from pot
leitalopez: doesn't show hand 
*** SUMMARY ***
Total pot 9100 | Rake 0 
Seat 1: leitalopez collected (9100)
Seat 2: Philipoune folded before Flop (didn't bet)
Seat 3: Defence_BOMB folded before Flop (didn't bet)
Seat 4: alushi6 (button) folded before Flop (didn't bet)
Seat 5: MTTSharkSnG (small blind) folded before Flop
Seat 6: conradofpg (big blind) folded before Flop
Seat 7: jammy1875 folded before Flop
Seat 8: DRY BLECKBERRY folded before Flop (didn't bet)

PokerStars Hand #251205672029: Tournament #3767885527, $40+$10+$5 USD Hold'em No Limit - Level XII (700/1400) - 2024/06/26 19:11:13 UTC [2024/06/26 15:11:13 ET]
Table '3767885527 58' 8-max Seat #5 is the button
Seat 1: leitalopez (30950 in chips) 
Seat 2: Philipoune (67791 in chips) 
Seat 3: Defence_BOMB (33694 in chips) 
Seat 4: alushi6 (26775 in chips) 
Seat 5: MTTSharkSnG (28550 in chips) 
Seat 6: conradofpg (35090 in chips) 
Seat 7: jammy1875 (85993 in chips) 
Seat 8: DRY BLECKBERRY (33868 in chips) 
leitalopez: posts the ante 175
Philipoune: posts the ante 175
Defence_BOMB: posts the ante 175
alushi6: posts the ante 175
MTTSharkSnG: posts the ante 175
conradofpg: posts the ante 175
jammy1875: posts the ante 175
DRY BLECKBERRY: posts the ante 175
conradofpg: posts small blind 700
jammy1875: posts big blind 1400
*** HOLE CARDS ***
DRY BLECKBERRY: folds 
leitalopez: folds 
Philipoune: folds 
Defence_BOMB: folds 
alushi6: raises 1400 to 2800
MTTSharkSnG: raises 25575 to 28375 and is all-in
conradofpg: folds 
jammy1875: folds 
alushi6: calls 23800 and is all-in
Uncalled bet (1775) returned to MTTSharkSnG
*** FLOP *** [As Qd 4c]
*** TURN *** [As Qd 4c] [7h]
*** RIVER *** [As Qd 4c 7h] [7s]
*** SHOW DOWN ***
alushi6: shows [Td Ts] (two pair, Tens and Sevens)
MTTSharkSnG: shows [Tc Th] (two pair, Tens and Sevens)
alushi6 collected 28350 from pot
MTTSharkSnG collected 28350 from pot
*** SUMMARY ***
Total pot 56700 | Rake 0 
Board [As Qd 4c 7h 7s]
Seat 1: leitalopez folded before Flop (didn't bet)
Seat 2: Philipoune folded before Flop (didn't bet)
Seat 3: Defence_BOMB folded before Flop (didn't bet)
Seat 4: alushi6 showed [Td Ts] and won (28350) with two pair, Tens and Sevens
Seat 5: MTTSharkSnG (button) showed [Tc Th] and won (28350) with two pair, Tens and Sevens
Seat 6: conradofpg (small blind) folded before Flop
Seat 7: jammy1875 (big blind) folded before Flop
Seat 8: DRY BLECKBERRY folded before Flop (didn't bet)

PokerStars Hand #251205681985: Tournament #3767885527, $40+$10+$5 USD Hold'em No Limit - Level XII (700/1400) - 2024/06/26 19:11:50 UTC [2024/06/26 15:11:50 ET]
Table '3767885527 58' 8-max Seat #6 is the button
Seat 1: leitalopez (30775 in chips) 
Seat 2: Philipoune (67616 in chips) 
Seat 3: Defence_BOMB (33519 in chips) 
Seat 4: alushi6 (28350 in chips) 
Seat 5: MTTSharkSnG (30125 in chips) 
Seat 6: conradofpg (34215 in chips) 
Seat 7: jammy1875 (84418 in chips) 
Seat 8: DRY BLECKBERRY (33693 in chips) 
leitalopez: posts the ante 175
Philipoune: posts the ante 175
Defence_BOMB: posts the ante 175
alushi6: posts the ante 175
MTTSharkSnG: posts the ante 175
conradofpg: posts the ante 175
jammy1875: posts the ante 175
DRY BLECKBERRY: posts the ante 175
jammy1875: posts small blind 700
DRY BLECKBERRY: posts big blind 1400
*** HOLE CARDS ***
leitalopez: raises 1400 to 2800
Philipoune: folds 
Defence_BOMB: folds 
alushi6: folds 
MTTSharkSnG: folds 
conradofpg: folds 
jammy1875: calls 2100
DRY BLECKBERRY: folds 
*** FLOP *** [4d 6s Qh]
jammy1875: checks 
leitalopez: bets 2772
jammy1875: calls 2772
*** TURN *** [4d 6s Qh] [Jc]
jammy1875: checks 
leitalopez: bets 4602
jammy1875: calls 4602
*** RIVER *** [4d 6s Qh Jc] [Kc]
jammy1875: checks 
leitalopez: checks 
*** SHOW DOWN ***
jammy1875: shows [5s 3s] (high card King)
leitalopez: shows [Kd Td] (a pair of Kings)
leitalopez collected 23148 from pot
*** SUMMARY ***
Total pot 23148 | Rake 0 
Board [4d 6s Qh Jc Kc]
Seat 1: leitalopez showed [Kd Td] and won (23148) with a pair of Kings
Seat 2: Philipoune folded before Flop (didn't bet)
Seat 3: Defence_BOMB folded before Flop (didn't bet)
Seat 4: alushi6 folded before Flop (didn't bet)
Seat 5: MTTSharkSnG folded before Flop (didn't bet)
Seat 6: conradofpg (button) folded before Flop (didn't bet)
Seat 7: jammy1875 (small blind) showed [5s 3s] and lost with high card King
Seat 8: DRY BLECKBERRY (big blind) folded before Flop

PokerStars Hand #251205698362: Tournament #3767885527, $40+$10+$5 USD Hold'em No Limit - Level XII (700/1400) - 2024/06/26 19:12:50 UTC [2024/06/26 15:12:50 ET]
Table '3767885527 58' 8-max Seat #7 is the button
Seat 1: leitalopez (43574 in chips) 
Seat 2: Philipoune (67441 in chips) 
Seat 3: Defence_BOMB (33344 in chips) 
Seat 4: alushi6 (28175 in chips) 
Seat 5: MTTSharkSnG (29950 in chips) 
Seat 6: conradofpg (34040 in chips) 
Seat 7: jammy1875 (74069 in chips) 
Seat 8: DRY BLECKBERRY (32118 in chips) 
leitalopez: posts the ante 175
Philipoune: posts the ante 175
Defence_BOMB: posts the ante 175
alushi6: posts the ante 175
MTTSharkSnG: posts the ante 175
conradofpg: posts the ante 175
jammy1875: posts the ante 175
DRY BLECKBERRY: posts the ante 175
DRY BLECKBERRY: posts small blind 700
leitalopez: posts big blind 1400
*** HOLE CARDS ***
Philipoune: folds 
Defence_BOMB: folds 
alushi6: folds 
MTTSharkSnG: raises 28375 to 29775 and is all-in
conradofpg: folds 
jammy1875: folds 
DRY BLECKBERRY: folds 
leitalopez: folds 
Uncalled bet (28375) returned to MTTSharkSnG
MTTSharkSnG collected 4900 from pot
MTTSharkSnG: doesn't show hand 
*** SUMMARY ***
Total pot 4900 | Rake 0 
Seat 1: leitalopez (big blind) folded before Flop
Seat 2: Philipoune folded before Flop (didn't bet)
Seat 3: Defence_BOMB folded before Flop (didn't bet)
Seat 4: alushi6 folded before Flop (didn't bet)
Seat 5: MTTSharkSnG collected (4900)
Seat 6: conradofpg folded before Flop (didn't bet)
Seat 7: jammy1875 (button) folded before Flop (didn't bet)
Seat 8: DRY BLECKBERRY (small blind) folded before Flop

PokerStars Hand #251205704639: Tournament #3767885527, $40+$10+$5 USD Hold'em No Limit - Level XII (700/1400) - 2024/06/26 19:13:13 UTC [2024/06/26 15:13:13 ET]
Table '3767885527 58' 8-max Seat #8 is the button
Seat 1: leitalopez (41999 in chips) 
Seat 2: Philipoune (67266 in chips) 
Seat 3: Defence_BOMB (33169 in chips) 
Seat 4: alushi6 (28000 in chips) 
Seat 5: MTTSharkSnG (33275 in chips) 
Seat 6: conradofpg (33865 in chips) 
Seat 7: jammy1875 (73894 in chips) 
Seat 8: DRY BLECKBERRY (31243 in chips) 
leitalopez: posts the ante 175
Philipoune: posts the ante 175
Defence_BOMB: posts the ante 175
alushi6: posts the ante 175
MTTSharkSnG: posts the ante 175
conradofpg: posts the ante 175
jammy1875: posts the ante 175
DRY BLECKBERRY: posts the ante 175
leitalopez: posts small blind 700
Philipoune: posts big blind 1400
*** HOLE CARDS ***
Defence_BOMB: folds 
alushi6: folds 
MTTSharkSnG: folds 
conradofpg: folds 
jammy1875: folds 
DRY BLECKBERRY: folds 
leitalopez: calls 700
Philipoune: checks 
*** FLOP *** [4s 9s Qd]
leitalopez: checks 
Philipoune: checks 
*** TURN *** [4s 9s Qd] [Jd]
leitalopez: bets 1400
Philipoune: folds 
Uncalled bet (1400) returned to leitalopez
leitalopez collected 4200 from pot
leitalopez: doesn't show hand 
*** SUMMARY ***
Total pot 4200 | Rake 0 
Board [4s 9s Qd Jd]
Seat 1: leitalopez (small blind) collected (4200)
Seat 2: Philipoune (big blind) folded on the Turn
Seat 3: Defence_BOMB folded before Flop (didn't bet)
Seat 4: alushi6 folded before Flop (didn't bet)
Seat 5: MTTSharkSnG folded before Flop (didn't bet)
Seat 6: conradofpg folded before Flop (didn't bet)
Seat 7: jammy1875 folded before Flop (didn't bet)
Seat 8: DRY BLECKBERRY (button) folded before Flop (didn't bet)

PokerStars Hand #251205716057: Tournament #3767885527, $40+$10+$5 USD Hold'em No Limit - Level XII (700/1400) - 2024/06/26 19:13:56 UTC [2024/06/26 15:13:56 ET]
Table '3767885527 58' 8-max Seat #1 is the button
Seat 1: leitalopez (44624 in chips) 
Seat 2: Philipoune (65691 in chips) 
Seat 3: Defence_BOMB (32994 in chips) 
Seat 4: alushi6 (27825 in chips) 
Seat 5: MTTSharkSnG (33100 in chips) 
Seat 6: conradofpg (33690 in chips) 
Seat 7: jammy1875 (73719 in chips) 
Seat 8: DRY BLECKBERRY (31068 in chips) 
leitalopez: posts the ante 175
Philipoune: posts the ante 175
Defence_BOMB: posts the ante 175
alushi6: posts the ante 175
MTTSharkSnG: posts the ante 175
conradofpg: posts the ante 175
jammy1875: posts the ante 175
DRY BLECKBERRY: posts the ante 175
Philipoune: posts small blind 700
Defence_BOMB: posts big blind 1400
*** HOLE CARDS ***
alushi6: raises 1400 to 2800
MTTSharkSnG: folds 
conradofpg: folds 
jammy1875: folds 
DRY BLECKBERRY: raises 4200 to 7000
leitalopez: folds 
Philipoune: folds 
Defence_BOMB: folds 
alushi6: raises 20650 to 27650 and is all-in
DRY BLECKBERRY: calls 20650
*** FLOP *** [7s 4d 5s]
*** TURN *** [7s 4d 5s] [Qh]
*** RIVER *** [7s 4d 5s Qh] [Ah]
*** SHOW DOWN ***
alushi6: shows [Kd Ad] (a pair of Aces)
DRY BLECKBERRY: shows [Ks As] (a pair of Aces)
alushi6 collected 29400 from pot
DRY BLECKBERRY collected 29400 from pot
*** SUMMARY ***
Total pot 58800 | Rake 0 
Board [7s 4d 5s Qh Ah]
Seat 1: leitalopez (button) folded before Flop (didn't bet)
Seat 2: Philipoune (small blind) folded before Flop
Seat 3: Defence_BOMB (big blind) folded before Flop
Seat 4: alushi6 showed [Kd Ad] and won (29400) with a pair of Aces
Seat 5: MTTSharkSnG folded before Flop (didn't bet)
Seat 6: conradofpg folded before Flop (didn't bet)
Seat 7: jammy1875 folded before Flop (didn't bet)
Seat 8: DRY BLECKBERRY showed [Ks As] and won (29400) with a pair of Aces

PokerStars Hand #251205730536: Tournament #3767885527, $40+$10+$5 USD Hold'em No Limit - Level XII (700/1400) - 2024/06/26 19:14:49 UTC [2024/06/26 15:14:49 ET]
Table '3767885527 58' 8-max Seat #2 is the button
Seat 1: leitalopez (44449 in chips) 
Seat 2: Philipoune (64816 in chips) 
Seat 3: Defence_BOMB (31419 in chips) 
Seat 4: alushi6 (29400 in chips) 
Seat 5: MTTSharkSnG (32925 in chips) 
Seat 6: conradofpg (33515 in chips) 
Seat 7: jammy1875 (73544 in chips) 
Seat 8: DRY BLECKBERRY (32643 in chips) 
leitalopez: posts the ante 175
Philipoune: posts the ante 175
Defence_BOMB: posts the ante 175
alushi6: posts the ante 175
MTTSharkSnG: posts the ante 175
conradofpg: posts the ante 175
jammy1875: posts the ante 175
DRY BLECKBERRY: posts the ante 175
Defence_BOMB: posts small blind 700
alushi6: posts big blind 1400
*** HOLE CARDS ***
MTTSharkSnG: folds 
conradofpg: folds 
jammy1875: folds 
DRY BLECKBERRY: raises 1400 to 2800
leitalopez: folds 
Philipoune: folds 
Defence_BOMB: folds 
alushi6: folds 
Uncalled bet (1400) returned to DRY BLECKBERRY
DRY BLECKBERRY collected 4900 from pot
DRY BLECKBERRY: doesn't show hand 
*** SUMMARY ***
Total pot 4900 | Rake 0 
Seat 1: leitalopez folded before Flop (didn't bet)
Seat 2: Philipoune (button) folded before Flop (didn't bet)
Seat 3: Defence_BOMB (small blind) folded before Flop
Seat 4: alushi6 (big blind) folded before Flop
Seat 5: MTTSharkSnG folded before Flop (didn't bet)
Seat 6: conradofpg folded before Flop (didn't bet)
Seat 7: jammy1875 folded before Flop (didn't bet)
Seat 8: DRY BLECKBERRY collected (4900)

PokerStars Hand #251205739557: Tournament #3767885527, $40+$10+$5 USD Hold'em No Limit - Level XII (700/1400) - 2024/06/26 19:15:22 UTC [2024/06/26 15:15:22 ET]
Table '3767885527 58' 8-max Seat #3 is the button
Seat 1: leitalopez (44274 in chips) 
Seat 2: Philipoune (64641 in chips) 
Seat 3: Defence_BOMB (30544 in chips) 
Seat 4: alushi6 (27825 in chips) 
Seat 5: MTTSharkSnG (32750 in chips) 
Seat 6: conradofpg (33340 in chips) 
Seat 7: jammy1875 (73369 in chips) 
Seat 8: DRY BLECKBERRY (35968 in chips) 
leitalopez: posts the ante 175
Philipoune: posts the ante 175
Defence_BOMB: posts the ante 175
alushi6: posts the ante 175
MTTSharkSnG: posts the ante 175
conradofpg: posts the ante 175
jammy1875: posts the ante 175
DRY BLECKBERRY: posts the ante 175
alushi6: posts small blind 700
MTTSharkSnG: posts big blind 1400
*** HOLE CARDS ***
conradofpg: folds 
jammy1875: folds 
DRY BLECKBERRY: raises 1400 to 2800
leitalopez: folds 
Philipoune: folds 
Defence_BOMB: folds 
alushi6: raises 24850 to 27650 and is all-in
MTTSharkSnG: raises 4925 to 32575 and is all-in
DRY BLECKBERRY: calls 29775
*** FLOP *** [3d 2d 7s]
*** TURN *** [3d 2d 7s] [8d]
*** RIVER *** [3d 2d 7s 8d] [Js]
*** SHOW DOWN ***
MTTSharkSnG: shows [Jc Ac] (a pair of Jacks)
DRY BLECKBERRY: shows [Kh Ah] (high card Ace)
MTTSharkSnG collected 9850 from side pot
alushi6: shows [Ks Qs] (high card King)
MTTSharkSnG collected 84350 from main pot
alushi6 finished the tournament
*** SUMMARY ***
Total pot 94200 Main pot 84350. Side pot 9850. | Rake 0 
Board [3d 2d 7s 8d Js]
Seat 1: leitalopez folded before Flop (didn't bet)
Seat 2: Philipoune folded before Flop (didn't bet)
Seat 3: Defence_BOMB (button) folded before Flop (didn't bet)
Seat 4: alushi6 (small blind) showed [Ks Qs] and lost with high card King
Seat 5: MTTSharkSnG (big blind) showed [Jc Ac] and won (94200) with a pair of Jacks
Seat 6: conradofpg folded before Flop (didn't bet)
Seat 7: jammy1875 folded before Flop (didn't bet)
Seat 8: DRY BLECKBERRY showed [Kh Ah] and lost with high card Ace

PokerStars Hand #251205752366: Tournament #3767885527, $40+$10+$5 USD Hold'em No Limit - Level XII (700/1400) - 2024/06/26 19:16:09 UTC [2024/06/26 15:16:09 ET]
Table '3767885527 58' 8-max Seat #5 is the button
Seat 1: leitalopez (44099 in chips) 
Seat 2: Philipoune (64466 in chips) 
Seat 3: Defence_BOMB (30369 in chips) 
Seat 5: MTTSharkSnG (94200 in chips) 
Seat 6: conradofpg (33165 in chips) 
Seat 7: jammy1875 (73194 in chips) 
Seat 8: DRY BLECKBERRY (3218 in chips) 
leitalopez: posts the ante 175
Philipoune: posts the ante 175
Defence_BOMB: posts the ante 175
MTTSharkSnG: posts the ante 175
conradofpg: posts the ante 175
jammy1875: posts the ante 175
DRY BLECKBERRY: posts the ante 175
conradofpg: posts small blind 700
jammy1875: posts big blind 1400
*** HOLE CARDS ***
DRY BLECKBERRY: folds 
leitalopez: folds 
Philipoune: folds 
Defence_BOMB: folds 
MTTSharkSnG: raises 1400 to 2800
conradofpg: folds 
jammy1875: raises 4200 to 7000
KingDugdale is disconnected 
MTTSharkSnG: calls 4200
*** FLOP *** [6h 5c 2s]
jammy1875: bets 5600
MTTSharkSnG: calls 5600
*** TURN *** [6h 5c 2s] [Qc]
jammy1875: bets 12163
MTTSharkSnG: folds 
Uncalled bet (12163) returned to jammy1875
jammy1875 collected 27125 from pot
*** SUMMARY ***
Total pot 27125 | Rake 0 
Board [6h 5c 2s Qc]
Seat 1: leitalopez folded before Flop (didn't bet)
Seat 2: Philipoune folded before Flop (didn't bet)
Seat 3: Defence_BOMB folded before Flop (didn't bet)
Seat 5: MTTSharkSnG (button) folded on the Turn
Seat 6: conradofpg (small blind) folded before Flop
Seat 7: jammy1875 (big blind) collected (27125)
Seat 8: DRY BLECKBERRY folded before Flop (didn't bet)

PokerStars Hand #251205773369: Tournament #3767885527, $40+$10+$5 USD Hold'em No Limit - Level XII (700/1400) - 2024/06/26 19:17:27 UTC [2024/06/26 15:17:27 ET]
Table '3767885527 58' 8-max Seat #6 is the button
Seat 1: leitalopez (43924 in chips) 
Seat 2: Philipoune (64291 in chips) 
Seat 3: Defence_BOMB (30194 in chips) 
Seat 4: KingDugdale (25000 in chips) 
Seat 5: MTTSharkSnG (81425 in chips) 
Seat 6: conradofpg (32290 in chips) 
Seat 7: jammy1875 (87544 in chips) 
Seat 8: DRY BLECKBERRY (3043 in chips) 
leitalopez: posts the ante 175
Philipoune: posts the ante 175
Defence_BOMB: posts the ante 175
KingDugdale: posts the ante 175
MTTSharkSnG: posts the ante 175
conradofpg: posts the ante 175
jammy1875: posts the ante 175
DRY BLECKBERRY: posts the ante 175
jammy1875: posts small blind 700
DRY BLECKBERRY: posts big blind 1400
*** HOLE CARDS ***
leitalopez: raises 1400 to 2800
Philipoune: folds 
Defence_BOMB: raises 4200 to 7000
KingDugdale: folds 
MTTSharkSnG: folds 
conradofpg: folds 
jammy1875: folds 
DRY BLECKBERRY: calls 1468 and is all-in
leitalopez: folds 
Uncalled bet (4132) returned to Defence_BOMB
*** FLOP *** [3d Th 7c]
*** TURN *** [3d Th 7c] [Kh]
*** RIVER *** [3d Th 7c Kh] [6h]
*** SHOW DOWN ***
DRY BLECKBERRY: shows [Tc As] (a pair of Tens)
Defence_BOMB: shows [Kc Ad] (a pair of Kings)
Defence_BOMB collected 10636 from pot
DRY BLECKBERRY finished the tournament
*** SUMMARY ***
Total pot 10636 | Rake 0 
Board [3d Th 7c Kh 6h]
Seat 1: leitalopez folded before Flop
Seat 2: Philipoune folded before Flop (didn't bet)
Seat 3: Defence_BOMB showed [Kc Ad] and won (10636) with a pair of Kings
Seat 4: KingDugdale folded before Flop (didn't bet)
Seat 5: MTTSharkSnG folded before Flop (didn't bet)
Seat 6: conradofpg (button) folded before Flop (didn't bet)
Seat 7: jammy1875 (small blind) folded before Flop
Seat 8: DRY BLECKBERRY (big blind) showed [Tc As] and lost with a pair of Tens

PokerStars Hand #251205785433: Tournament #3767885527, $40+$10+$5 USD Hold'em No Limit - Level XII (700/1400) - 2024/06/26 19:18:11 UTC [2024/06/26 15:18:11 ET]
Table '3767885527 58' 8-max Seat #7 is the button
Seat 1: leitalopez (40949 in chips) 
Seat 2: Philipoune (64116 in chips) 
Seat 3: Defence_BOMB (37787 in chips) 
Seat 4: KingDugdale (24825 in chips) 
Seat 5: MTTSharkSnG (81250 in chips) 
Seat 6: conradofpg (32115 in chips) 
Seat 7: jammy1875 (86669 in chips) 
leitalopez: posts the ante 175
Philipoune: posts the ante 175
Defence_BOMB: posts the ante 175
KingDugdale: posts the ante 175
MTTSharkSnG: posts the ante 175
conradofpg: posts the ante 175
jammy1875: posts the ante 175
leitalopez: posts small blind 700
Philipoune: posts big blind 1400
*** HOLE CARDS ***
Defence_BOMB: folds 
KingDugdale: folds 
MTTSharkSnG: folds 
conradofpg: folds 
jammy1875: folds 
leitalopez: calls 700
Philipoune: raises 62541 to 63941 and is all-in
leitalopez: folds 
Uncalled bet (62541) returned to Philipoune
Philipoune collected 4025 from pot
Philipoune: doesn't show hand 
*** SUMMARY ***
Total pot 4025 | Rake 0 
Seat 1: leitalopez (small blind) folded before Flop
Seat 2: Philipoune (big blind) collected (4025)
Seat 3: Defence_BOMB folded before Flop (didn't bet)
Seat 4: KingDugdale folded before Flop (didn't bet)
Seat 5: MTTSharkSnG folded before Flop (didn't bet)
Seat 6: conradofpg folded before Flop (didn't bet)
Seat 7: jammy1875 (button) folded before Flop (didn't bet)

PokerStars Hand #251205793783: Tournament #3767885527, $40+$10+$5 USD Hold'em No Limit - Level XII (700/1400) - 2024/06/26 19:18:41 UTC [2024/06/26 15:18:41 ET]
Table '3767885527 58' 8-max Seat #1 is the button
Seat 1: leitalopez (39374 in chips) 
Seat 2: Philipoune (66566 in chips) 
Seat 3: Defence_BOMB (37612 in chips) 
Seat 4: KingDugdale (24650 in chips) 
Seat 5: MTTSharkSnG (81075 in chips) 
Seat 6: conradofpg (31940 in chips) 
Seat 7: jammy1875 (86494 in chips) 
leitalopez: posts the ante 175
Philipoune: posts the ante 175
Defence_BOMB: posts the ante 175
KingDugdale: posts the ante 175
MTTSharkSnG: posts the ante 175
conradofpg: posts the ante 175
jammy1875: posts the ante 175
Philipoune: posts small blind 700
Defence_BOMB: posts big blind 1400
*** HOLE CARDS ***
KingDugdale: folds 
MTTSharkSnG: folds 
conradofpg: raises 1400 to 2800
jammy1875: raises 8400 to 11200
leitalopez: folds 
Philipoune: folds 
oO-HaiRoller-Oo is disconnected 
Defence_BOMB: folds 
conradofpg: folds 
Uncalled bet (8400) returned to jammy1875
jammy1875 collected 8925 from pot
*** SUMMARY ***
Total pot 8925 | Rake 0 
Seat 1: leitalopez (button) folded before Flop (didn't bet)
Seat 2: Philipoune (small blind) folded before Flop
Seat 3: Defence_BOMB (big blind) folded before Flop
Seat 4: KingDugdale folded before Flop (didn't bet)
Seat 5: MTTSharkSnG folded before Flop (didn't bet)
Seat 6: conradofpg folded before Flop
Seat 7: jammy1875 collected (8925)

PokerStars Hand #251205806355: Tournament #3767885527, $40+$10+$5 USD Hold'em No Limit - Level XIII (800/1600) - 2024/06/26 19:19:27 UTC [2024/06/26 15:19:27 ET]
Table '3767885527 58' 8-max Seat #2 is the button
Seat 1: leitalopez (39199 in chips) 
Seat 2: Philipoune (65691 in chips) 
Seat 3: Defence_BOMB (36037 in chips) 
Seat 4: KingDugdale (24475 in chips) 
Seat 5: MTTSharkSnG (80900 in chips) 
Seat 6: conradofpg (28965 in chips) 
Seat 7: jammy1875 (92444 in chips) 
Seat 8: oO-HaiRoller-Oo (25000 in chips) 
leitalopez: posts the ante 200
Philipoune: posts the ante 200
Defence_BOMB: posts the ante 200
KingDugdale: posts the ante 200
MTTSharkSnG: posts the ante 200
conradofpg: posts the ante 200
jammy1875: posts the ante 200
oO-HaiRoller-Oo: posts the ante 200
Defence_BOMB: posts small blind 800
KingDugdale: posts big blind 1600
*** HOLE CARDS ***
MTTSharkSnG: folds 
conradofpg: folds 
jammy1875: raises 1600 to 3200
oO-HaiRoller-Oo: folds 
leitalopez: raises 35799 to 38999 and is all-in
Philipoune: folds 
Defence_BOMB: folds 
KingDugdale: folds 
jammy1875: folds 
Uncalled bet (35799) returned to leitalopez
leitalopez collected 10400 from pot
leitalopez: doesn't show hand 
*** SUMMARY ***
Total pot 10400 | Rake 0 
Seat 1: leitalopez collected (10400)
Seat 2: Philipoune (button) folded before Flop (didn't bet)
Seat 3: Defence_BOMB (small blind) folded before Flop
Seat 4: KingDugdale (big blind) folded before Flop
Seat 5: MTTSharkSnG folded before Flop (didn't bet)
Seat 6: conradofpg folded before Flop (didn't bet)
Seat 7: jammy1875 folded before Flop
Seat 8: oO-HaiRoller-Oo folded before Flop (didn't bet)

PokerStars Hand #251205813172: Tournament #3767885527, $40+$10+$5 USD Hold'em No Limit - Level XIII (800/1600) - 2024/06/26 19:19:52 UTC [2024/06/26 15:19:52 ET]
Table '3767885527 58' 8-max Seat #3 is the button
Seat 1: leitalopez (46199 in chips) 
Seat 2: Philipoune (65491 in chips) 
Seat 3: Defence_BOMB (35037 in chips) 
Seat 4: KingDugdale (22675 in chips) 
Seat 5: MTTSharkSnG (80700 in chips) 
Seat 6: conradofpg (28765 in chips) 
Seat 7: jammy1875 (89044 in chips) 
Seat 8: oO-HaiRoller-Oo (24800 in chips) 
leitalopez: posts the ante 200
Philipoune: posts the ante 200
Defence_BOMB: posts the ante 200
KingDugdale: posts the ante 200
MTTSharkSnG: posts the ante 200
conradofpg: posts the ante 200
jammy1875: posts the ante 200
oO-HaiRoller-Oo: posts the ante 200
KingDugdale: posts small blind 800
MTTSharkSnG: posts big blind 1600
*** HOLE CARDS ***
conradofpg: raises 1600 to 3200
jammy1875: calls 3200
oO-HaiRoller-Oo: folds 
leitalopez: folds 
Philipoune: folds 
Defence_BOMB: folds 
KingDugdale: folds 
MTTSharkSnG: folds 
*** FLOP *** [2s 7h 6c]
conradofpg: checks 
jammy1875: checks 
*** TURN *** [2s 7h 6c] [Kh]
conradofpg: checks 
jammy1875: bets 4800
conradofpg: calls 4800
*** RIVER *** [2s 7h 6c Kh] [Qs]
conradofpg: checks 
jammy1875: bets 8400
conradofpg: folds 
Uncalled bet (8400) returned to jammy1875
jammy1875 collected 20000 from pot
*** SUMMARY ***
Total pot 20000 | Rake 0 
Board [2s 7h 6c Kh Qs]
Seat 1: leitalopez folded before Flop (didn't bet)
Seat 2: Philipoune folded before Flop (didn't bet)
Seat 3: Defence_BOMB (button) folded before Flop (didn't bet)
Seat 4: KingDugdale (small blind) folded before Flop
Seat 5: MTTSharkSnG (big blind) folded before Flop
Seat 6: conradofpg folded on the River
Seat 7: jammy1875 collected (20000)
Seat 8: oO-HaiRoller-Oo folded before Flop (didn't bet)

PokerStars Hand #251205843603: Tournament #3767885527, $40+$10+$5 USD Hold'em No Limit - Level XIII (800/1600) - 2024/06/26 19:21:44 UTC [2024/06/26 15:21:44 ET]
Table '3767885527 58' 8-max Seat #4 is the button
Seat 1: leitalopez (45999 in chips) 
Seat 2: Philipoune (65291 in chips) 
Seat 3: Defence_BOMB (34837 in chips) 
Seat 4: KingDugdale (21675 in chips) 
Seat 5: MTTSharkSnG (78900 in chips) 
Seat 6: conradofpg (20565 in chips) 
Seat 7: jammy1875 (100844 in chips) 
Seat 8: oO-HaiRoller-Oo (24600 in chips) 
leitalopez: posts the ante 200
Philipoune: posts the ante 200
Defence_BOMB: posts the ante 200
KingDugdale: posts the ante 200
MTTSharkSnG: posts the ante 200
conradofpg: posts the ante 200
jammy1875: posts the ante 200
oO-HaiRoller-Oo: posts the ante 200
MTTSharkSnG: posts small blind 800
conradofpg: posts big blind 1600
*** HOLE CARDS ***
jammy1875: folds 
oO-HaiRoller-Oo: raises 22800 to 24400 and is all-in
leitalopez: folds 
Philipoune: folds 
Defence_BOMB: folds 
KingDugdale: folds 
MTTSharkSnG: folds 
conradofpg: folds 
Uncalled bet (22800) returned to oO-HaiRoller-Oo
oO-HaiRoller-Oo collected 5600 from pot
oO-HaiRoller-Oo: doesn't show hand 
*** SUMMARY ***
Total pot 5600 | Rake 0 
Seat 1: leitalopez folded before Flop (didn't bet)
Seat 2: Philipoune folded before Flop (didn't bet)
Seat 3: Defence_BOMB folded before Flop (didn't bet)
Seat 4: KingDugdale (button) folded before Flop (didn't bet)
Seat 5: MTTSharkSnG (small blind) folded before Flop
Seat 6: conradofpg (big blind) folded before Flop
Seat 7: jammy1875 folded before Flop (didn't bet)
Seat 8: oO-HaiRoller-Oo collected (5600)

PokerStars Hand #251205850436: Tournament #3767885527, $40+$10+$5 USD Hold'em No Limit - Level XIII (800/1600) - 2024/06/26 19:22:09 UTC [2024/06/26 15:22:09 ET]
Table '3767885527 58' 8-max Seat #5 is the button
Seat 1: leitalopez (45799 in chips) 
Seat 2: Philipoune (65091 in chips) 
Seat 3: Defence_BOMB (34637 in chips) 
Seat 4: KingDugdale (21475 in chips) 
Seat 5: MTTSharkSnG (77900 in chips) 
Seat 6: conradofpg (18765 in chips) 
Seat 7: jammy1875 (100644 in chips) 
Seat 8: oO-HaiRoller-Oo (28400 in chips) 
leitalopez: posts the ante 200
Philipoune: posts the ante 200
Defence_BOMB: posts the ante 200
KingDugdale: posts the ante 200
MTTSharkSnG: posts the ante 200
conradofpg: posts the ante 200
jammy1875: posts the ante 200
oO-HaiRoller-Oo: posts the ante 200
conradofpg: posts small blind 800
jammy1875: posts big blind 1600
*** HOLE CARDS ***
oO-HaiRoller-Oo: folds 
leitalopez: folds 
Philipoune: folds 
Defence_BOMB: folds 
KingDugdale: raises 19675 to 21275 and is all-in
MTTSharkSnG: folds 
conradofpg: folds 
jammy1875: calls 19675
*** FLOP *** [Qh Qc Js]
*** TURN *** [Qh Qc Js] [Jh]
*** RIVER *** [Qh Qc Js Jh] [5h]
*** SHOW DOWN ***
jammy1875: shows [9s Ac] (two pair, Queens and Jacks)
KingDugdale: shows [Kc 9c] (two pair, Queens and Jacks - lower kicker)
jammy1875 collected 44950 from pot
KingDugdale finished the tournament
*** SUMMARY ***
Total pot 44950 | Rake 0 
Board [Qh Qc Js Jh 5h]
Seat 1: leitalopez folded before Flop (didn't bet)
Seat 2: Philipoune folded before Flop (didn't bet)
Seat 3: Defence_BOMB folded before Flop (didn't bet)
Seat 4: KingDugdale showed [Kc 9c] and lost with two pair, Queens and Jacks
Seat 5: MTTSharkSnG (button) folded before Flop (didn't bet)
Seat 6: conradofpg (small blind) folded before Flop
Seat 7: jammy1875 (big blind) showed [9s Ac] and won (44950) with two pair, Queens and Jacks
Seat 8: oO-HaiRoller-Oo folded before Flop (didn't bet)

PokerStars Hand #251205859502: Tournament #3767885527, $40+$10+$5 USD Hold'em No Limit - Level XIII (800/1600) - 2024/06/26 19:22:42 UTC [2024/06/26 15:22:42 ET]
Table '3767885527 58' 8-max Seat #6 is the button
Seat 1: leitalopez (45599 in chips) 
Seat 2: Philipoune (64891 in chips) 
Seat 3: Defence_BOMB (34437 in chips) 
Seat 5: MTTSharkSnG (77700 in chips) 
Seat 6: conradofpg (17765 in chips) 
Seat 7: jammy1875 (124119 in chips) 
Seat 8: oO-HaiRoller-Oo (28200 in chips) 
leitalopez: posts the ante 200
Philipoune: posts the ante 200
Defence_BOMB: posts the ante 200
MTTSharkSnG: posts the ante 200
conradofpg: posts the ante 200
jammy1875: posts the ante 200
oO-HaiRoller-Oo: posts the ante 200
jammy1875: posts small blind 800
oO-HaiRoller-Oo: posts big blind 1600
*** HOLE CARDS ***
leitalopez: folds 
Philipoune: folds 
Defence_BOMB: folds 
MTTSharkSnG: folds 
conradofpg: folds 
jammy1875: raises 1600 to 3200
oO-HaiRoller-Oo: calls 1600
*** FLOP *** [Jc 9d 5d]
jammy1875: bets 3200
oO-HaiRoller-Oo: calls 3200
*** TURN *** [Jc 9d 5d] [2h]
jammy1875: checks 
oO-HaiRoller-Oo: bets 21600 and is all-in
jammy1875: folds 
Uncalled bet (21600) returned to oO-HaiRoller-Oo
oO-HaiRoller-Oo collected 14200 from pot
oO-HaiRoller-Oo: doesn't show hand 
*** SUMMARY ***
Total pot 14200 | Rake 0 
Board [Jc 9d 5d 2h]
Seat 1: leitalopez folded before Flop (didn't bet)
Seat 2: Philipoune folded before Flop (didn't bet)
Seat 3: Defence_BOMB folded before Flop (didn't bet)
Seat 5: MTTSharkSnG folded before Flop (didn't bet)
Seat 6: conradofpg (button) folded before Flop (didn't bet)
Seat 7: jammy1875 (small blind) folded on the Turn
Seat 8: oO-HaiRoller-Oo (big blind) collected (14200)

PokerStars Hand #251205874752: Tournament #3767885527, $40+$10+$5 USD Hold'em No Limit - Level XIII (800/1600) - 2024/06/26 19:23:38 UTC [2024/06/26 15:23:38 ET]
Table '3767885527 58' 8-max Seat #7 is the button
Seat 1: leitalopez (45399 in chips) 
Seat 2: Philipoune (64691 in chips) 
Seat 3: Defence_BOMB (34237 in chips) 
Seat 4: Renailmatto (25000 in chips) 
Seat 5: MTTSharkSnG (77500 in chips) 
Seat 6: conradofpg (17565 in chips) 
Seat 7: jammy1875 (117519 in chips) 
Seat 8: oO-HaiRoller-Oo (35800 in chips) 
leitalopez: posts the ante 200
Philipoune: posts the ante 200
Defence_BOMB: posts the ante 200
Renailmatto: posts the ante 200
MTTSharkSnG: posts the ante 200
conradofpg: posts the ante 200
jammy1875: posts the ante 200
oO-HaiRoller-Oo: posts the ante 200
oO-HaiRoller-Oo: posts small blind 800
leitalopez: posts big blind 1600
*** HOLE CARDS ***
Philipoune: folds 
Defence_BOMB: folds 
Renailmatto: raises 1600 to 3200
MTTSharkSnG: folds 
conradofpg: folds 
jammy1875: folds 
oO-HaiRoller-Oo: calls 2400
leitalopez: calls 1600
*** FLOP *** [9h Kd Qs]
oO-HaiRoller-Oo: checks 
leitalopez: checks 
Renailmatto: bets 5600
oO-HaiRoller-Oo: calls 5600
leitalopez: folds 
*** TURN *** [9h Kd Qs] [Ts]
oO-HaiRoller-Oo: checks 
Renailmatto: checks 
*** RIVER *** [9h Kd Qs Ts] [6c]
oO-HaiRoller-Oo: bets 26800 and is all-in
Renailmatto: folds 
Uncalled bet (26800) returned to oO-HaiRoller-Oo
oO-HaiRoller-Oo collected 22400 from pot
oO-HaiRoller-Oo: doesn't show hand 
*** SUMMARY ***
Total pot 22400 | Rake 0 
Board [9h Kd Qs Ts 6c]
Seat 1: leitalopez (big blind) folded on the Flop
Seat 2: Philipoune folded before Flop (didn't bet)
Seat 3: Defence_BOMB folded before Flop (didn't bet)
Seat 4: Renailmatto folded on the River
Seat 5: MTTSharkSnG folded before Flop (didn't bet)
Seat 6: conradofpg folded before Flop (didn't bet)
Seat 7: jammy1875 (button) folded before Flop (didn't bet)
Seat 8: oO-HaiRoller-Oo (small blind) collected (22400)

PokerStars Hand #251205891218: Tournament #3767885527, $40+$10+$5 USD Hold'em No Limit - Level XIII (800/1600) - 2024/06/26 19:24:38 UTC [2024/06/26 15:24:38 ET]
Table '3767885527 58' 8-max Seat #8 is the button
Seat 1: leitalopez (41999 in chips) 
Seat 2: Philipoune (64491 in chips) 
Seat 3: Defence_BOMB (34037 in chips) 
Seat 4: Renailmatto (16000 in chips) 
Seat 5: MTTSharkSnG (77300 in chips) 
Seat 6: conradofpg (17365 in chips) 
Seat 7: jammy1875 (117319 in chips) 
Seat 8: oO-HaiRoller-Oo (49200 in chips) 
leitalopez: posts the ante 200
Philipoune: posts the ante 200
Defence_BOMB: posts the ante 200
Renailmatto: posts the ante 200
MTTSharkSnG: posts the ante 200
conradofpg: posts the ante 200
jammy1875: posts the ante 200
oO-HaiRoller-Oo: posts the ante 200
leitalopez: posts small blind 800
Philipoune: posts big blind 1600
*** HOLE CARDS ***
Defence_BOMB: folds 
Renailmatto: raises 14200 to 15800 and is all-in
MTTSharkSnG: folds 
conradofpg: folds 
jammy1875: folds 
oO-HaiRoller-Oo: folds 
leitalopez: folds 
Philipoune: folds 
Uncalled bet (14200) returned to Renailmatto
Renailmatto collected 5600 from pot
*** SUMMARY ***
Total pot 5600 | Rake 0 
Seat 1: leitalopez (small blind) folded before Flop
Seat 2: Philipoune (big blind) folded before Flop
Seat 3: Defence_BOMB folded before Flop (didn't bet)
Seat 4: Renailmatto collected (5600)
Seat 5: MTTSharkSnG folded before Flop (didn't bet)
Seat 6: conradofpg folded before Flop (didn't bet)
Seat 7: jammy1875 folded before Flop (didn't bet)
Seat 8: oO-HaiRoller-Oo (button) folded before Flop (didn't bet)

PokerStars Hand #251205896482: Tournament #3767885527, $40+$10+$5 USD Hold'em No Limit - Level XIII (800/1600) - 2024/06/26 19:24:57 UTC [2024/06/26 15:24:57 ET]
Table '3767885527 58' 8-max Seat #1 is the button
Seat 1: leitalopez (40999 in chips) 
Seat 2: Philipoune (62691 in chips) 
Seat 3: Defence_BOMB (33837 in chips) 
Seat 4: Renailmatto (19800 in chips) 
Seat 5: MTTSharkSnG (77100 in chips) 
Seat 6: conradofpg (17165 in chips) 
Seat 7: jammy1875 (117119 in chips) 
Seat 8: oO-HaiRoller-Oo (49000 in chips) 
leitalopez: posts the ante 200
Philipoune: posts the ante 200
Defence_BOMB: posts the ante 200
Renailmatto: posts the ante 200
MTTSharkSnG: posts the ante 200
conradofpg: posts the ante 200
jammy1875: posts the ante 200
oO-HaiRoller-Oo: posts the ante 200
Philipoune: posts small blind 800
Defence_BOMB: posts big blind 1600
*** HOLE CARDS ***
Renailmatto: folds 
MTTSharkSnG: folds 
conradofpg: folds 
jammy1875: folds 
oO-HaiRoller-Oo: folds 
leitalopez: raises 1600 to 3200
Philipoune: folds 
Defence_BOMB: folds 
Uncalled bet (1600) returned to leitalopez
leitalopez collected 5600 from pot
leitalopez: doesn't show hand 
*** SUMMARY ***
Total pot 5600 | Rake 0 
Seat 1: leitalopez (button) collected (5600)
Seat 2: Philipoune (small blind) folded before Flop
Seat 3: Defence_BOMB (big blind) folded before Flop
Seat 4: Renailmatto folded before Flop (didn't bet)
Seat 5: MTTSharkSnG folded before Flop (didn't bet)
Seat 6: conradofpg folded before Flop (didn't bet)
Seat 7: jammy1875 folded before Flop (didn't bet)
Seat 8: oO-HaiRoller-Oo folded before Flop (didn't bet)

PokerStars Hand #251205903815: Tournament #3767885527, $40+$10+$5 USD Hold'em No Limit - Level XIII (800/1600) - 2024/06/26 19:25:23 UTC [2024/06/26 15:25:23 ET]
Table '3767885527 58' 8-max Seat #2 is the button
Seat 1: leitalopez (44799 in chips) 
Seat 2: Philipoune (61691 in chips) 
Seat 3: Defence_BOMB (32037 in chips) 
Seat 4: Renailmatto (19600 in chips) 
Seat 5: MTTSharkSnG (76900 in chips) 
Seat 6: conradofpg (16965 in chips) 
Seat 7: jammy1875 (116919 in chips) 
Seat 8: oO-HaiRoller-Oo (48800 in chips) 
leitalopez: posts the ante 200
Philipoune: posts the ante 200
Defence_BOMB: posts the ante 200
Renailmatto: posts the ante 200
MTTSharkSnG: posts the ante 200
conradofpg: posts the ante 200
jammy1875: posts the ante 200
oO-HaiRoller-Oo: posts the ante 200
Defence_BOMB: posts small blind 800
Renailmatto: posts big blind 1600
*** HOLE CARDS ***
MTTSharkSnG: folds 
conradofpg: raises 15165 to 16765 and is all-in
jammy1875: raises 19965 to 36730
oO-HaiRoller-Oo: folds 
leitalopez: folds 
Philipoune: folds 
Defence_BOMB: folds 
Renailmatto: folds 
Uncalled bet (19965) returned to jammy1875
*** FLOP *** [3c Qh 2c]
*** TURN *** [3c Qh 2c] [9d]
*** RIVER *** [3c Qh 2c 9d] [2s]
*** SHOW DOWN ***
conradofpg: shows [Jh Js] (two pair, Jacks and Deuces)
jammy1875: shows [9s 9h] (a full house, Nines full of Deuces)
jammy1875 collected 37530 from pot
conradofpg finished the tournament
*** SUMMARY ***
Total pot 37530 | Rake 0 
Board [3c Qh 2c 9d 2s]
Seat 1: leitalopez folded before Flop (didn't bet)
Seat 2: Philipoune (button) folded before Flop (didn't bet)
Seat 3: Defence_BOMB (small blind) folded before Flop
Seat 4: Renailmatto (big blind) folded before Flop
Seat 5: MTTSharkSnG folded before Flop (didn't bet)
Seat 6: conradofpg showed [Jh Js] and lost with two pair, Jacks and Deuces
Seat 7: jammy1875 showed [9s 9h] and won (37530) with a full house, Nines full of Deuces
Seat 8: oO-HaiRoller-Oo folded before Flop (didn't bet)

PokerStars Hand #251205913936: Tournament #3767885527, $40+$10+$5 USD Hold'em No Limit - Level XIII (800/1600) - 2024/06/26 19:26:00 UTC [2024/06/26 15:26:00 ET]
Table '3767885527 58' 8-max Seat #3 is the button
Seat 1: leitalopez (44599 in chips) 
Seat 2: Philipoune (61491 in chips) 
Seat 3: Defence_BOMB (31037 in chips) 
Seat 4: Renailmatto (17800 in chips) 
Seat 5: MTTSharkSnG (76700 in chips) 
Seat 7: jammy1875 (137484 in chips) 
Seat 8: oO-HaiRoller-Oo (48600 in chips) 
leitalopez: posts the ante 200
Philipoune: posts the ante 200
Defence_BOMB: posts the ante 200
Renailmatto: posts the ante 200
MTTSharkSnG: posts the ante 200
jammy1875: posts the ante 200
oO-HaiRoller-Oo: posts the ante 200
Renailmatto: posts small blind 800
MTTSharkSnG: posts big blind 1600
*** HOLE CARDS ***
jammy1875: folds 
oO-HaiRoller-Oo: folds 
leitalopez: raises 1600 to 3200
Philipoune: folds 
Defence_BOMB: raises 27637 to 30837 and is all-in
Renailmatto: folds 
MTTSharkSnG: folds 
leitalopez: folds 
Uncalled bet (27637) returned to Defence_BOMB
Defence_BOMB collected 10200 from pot
Defence_BOMB: doesn't show hand 
*** SUMMARY ***
Total pot 10200 | Rake 0 
Seat 1: leitalopez folded before Flop
Seat 2: Philipoune folded before Flop (didn't bet)
Seat 3: Defence_BOMB (button) collected (10200)
Seat 4: Renailmatto (small blind) folded before Flop
Seat 5: MTTSharkSnG (big blind) folded before Flop
Seat 7: jammy1875 folded before Flop (didn't bet)
Seat 8: oO-HaiRoller-Oo folded before Flop (didn't bet)

PokerStars Hand #251205920621: Tournament #3767885527, $40+$10+$5 USD Hold'em No Limit - Level XIII (800/1600) - 2024/06/26 19:26:25 UTC [2024/06/26 15:26:25 ET]
Table '3767885527 58' 8-max Seat #4 is the button
Seat 1: leitalopez (41199 in chips) 
Seat 2: Philipoune (61291 in chips) 
Seat 3: Defence_BOMB (37837 in chips) 
Seat 4: Renailmatto (16800 in chips) 
Seat 5: MTTSharkSnG (74900 in chips) 
Seat 7: jammy1875 (137284 in chips) 
Seat 8: oO-HaiRoller-Oo (48400 in chips) 
leitalopez: posts the ante 200
Philipoune: posts the ante 200
Defence_BOMB: posts the ante 200
Renailmatto: posts the ante 200
MTTSharkSnG: posts the ante 200
jammy1875: posts the ante 200
oO-HaiRoller-Oo: posts the ante 200
MTTSharkSnG: posts small blind 800
jammy1875: posts big blind 1600
*** HOLE CARDS ***
oO-HaiRoller-Oo: folds 
leitalopez: folds 
Philipoune: raises 1600 to 3200
Defence_BOMB: folds 
Renailmatto: folds 
MTTSharkSnG: folds 
jammy1875: folds 
Uncalled bet (1600) returned to Philipoune
Philipoune collected 5400 from pot
Philipoune: doesn't show hand 
*** SUMMARY ***
Total pot 5400 | Rake 0 
Seat 1: leitalopez folded before Flop (didn't bet)
Seat 2: Philipoune collected (5400)
Seat 3: Defence_BOMB folded before Flop (didn't bet)
Seat 4: Renailmatto (button) folded before Flop (didn't bet)
Seat 5: MTTSharkSnG (small blind) folded before Flop
Seat 7: jammy1875 (big blind) folded before Flop
Seat 8: oO-HaiRoller-Oo folded before Flop (didn't bet)

PokerStars Hand #251205929066: Tournament #3767885527, $40+$10+$5 USD Hold'em No Limit - Level XIII (800/1600) - 2024/06/26 19:26:56 UTC [2024/06/26 15:26:56 ET]
Table '3767885527 58' 8-max Seat #5 is the button
Seat 1: leitalopez (40999 in chips) 
Seat 2: Philipoune (64891 in chips) 
Seat 3: Defence_BOMB (37637 in chips) 
Seat 4: Renailmatto (16600 in chips) 
Seat 5: MTTSharkSnG (73900 in chips) 
Seat 7: jammy1875 (135484 in chips) 
Seat 8: oO-HaiRoller-Oo (48200 in chips) 
leitalopez: posts the ante 200
Philipoune: posts the ante 200
Defence_BOMB: posts the ante 200
Renailmatto: posts the ante 200
MTTSharkSnG: posts the ante 200
jammy1875: posts the ante 200
oO-HaiRoller-Oo: posts the ante 200
jammy1875: posts small blind 800
oO-HaiRoller-Oo: posts big blind 1600
*** HOLE CARDS ***
JovemPromessa is disconnected 
leitalopez: folds 
Philipoune: raises 1600 to 3200
Defence_BOMB: folds 
Renailmatto: folds 
MTTSharkSnG: folds 
jammy1875: raises 8000 to 11200
oO-HaiRoller-Oo: folds 
Philipoune: calls 8000
*** FLOP *** [9s 2s 8c]
jammy1875: bets 9600
Philipoune: calls 9600
*** TURN *** [9s 2s 8c] [5c]
jammy1875: bets 44600
Philipoune: calls 43891 and is all-in
Uncalled bet (709) returned to jammy1875
*** RIVER *** [9s 2s 8c 5c] [As]
*** SHOW DOWN ***
jammy1875: shows [7d 7s] (a pair of Sevens)
Philipoune: shows [9h 9d] (three of a kind, Nines)
Philipoune collected 132382 from pot
*** SUMMARY ***
Total pot 132382 | Rake 0 
Board [9s 2s 8c 5c As]
Seat 1: leitalopez folded before Flop (didn't bet)
Seat 2: Philipoune showed [9h 9d] and won (132382) with three of a kind, Nines
Seat 3: Defence_BOMB folded before Flop (didn't bet)
Seat 4: Renailmatto folded before Flop (didn't bet)
Seat 5: MTTSharkSnG (button) folded before Flop (didn't bet)
Seat 7: jammy1875 (small blind) showed [7d 7s] and lost with a pair of Sevens
Seat 8: oO-HaiRoller-Oo (big blind) folded before Flop

PokerStars Hand #251205954734: Tournament #3767885527, $40+$10+$5 USD Hold'em No Limit - Level XIII (800/1600) - 2024/06/26 19:28:32 UTC [2024/06/26 15:28:32 ET]
Table '3767885527 58' 8-max Seat #7 is the button
Seat 1: leitalopez (40799 in chips) 
Seat 2: Philipoune (132382 in chips) 
Seat 3: Defence_BOMB (37437 in chips) 
Seat 4: Renailmatto (16400 in chips) 
Seat 5: MTTSharkSnG (73700 in chips) 
Seat 6: JovemPromessa (25000 in chips) 
Seat 7: jammy1875 (70593 in chips) 
Seat 8: oO-HaiRoller-Oo (46400 in chips) 
leitalopez: posts the ante 200
Philipoune: posts the ante 200
Defence_BOMB: posts the ante 200
Renailmatto: posts the ante 200
MTTSharkSnG: posts the ante 200
JovemPromessa: posts the ante 200
jammy1875: posts the ante 200
oO-HaiRoller-Oo: posts the ante 200
oO-HaiRoller-Oo: posts small blind 800
leitalopez: posts big blind 1600
*** HOLE CARDS ***
Philipoune: folds 
Defence_BOMB: raises 1920 to 3520
Renailmatto: calls 3520
MTTSharkSnG: folds 
JovemPromessa: raises 20480 to 24000
jammy1875: folds 
oO-HaiRoller-Oo: folds 
leitalopez: folds 
Defence_BOMB: folds 
Renailmatto: calls 12680 and is all-in
Uncalled bet (7800) returned to JovemPromessa
*** FLOP *** [Ac Qh 4s]
*** TURN *** [Ac Qh 4s] [7h]
*** RIVER *** [Ac Qh 4s 7h] [Kh]
*** SHOW DOWN ***
Renailmatto: shows [Th 9h] (a flush, King high)
JovemPromessa: shows [Jh As] (a pair of Aces)
Renailmatto collected 39920 from pot
*** SUMMARY ***
Total pot 39920 | Rake 0 
Board [Ac Qh 4s 7h Kh]
Seat 1: leitalopez (big blind) folded before Flop
Seat 2: Philipoune folded before Flop (didn't bet)
Seat 3: Defence_BOMB folded before Flop
Seat 4: Renailmatto showed [Th 9h] and won (39920) with a flush, King high
Seat 5: MTTSharkSnG folded before Flop (didn't bet)
Seat 6: JovemPromessa showed [Jh As] and lost with a pair of Aces
Seat 7: jammy1875 (button) folded before Flop (didn't bet)
Seat 8: oO-HaiRoller-Oo (small blind) folded before Flop

PokerStars Hand #251205965990: Tournament #3767885527, $40+$10+$5 USD Hold'em No Limit - Level XIV (1000/2000) - 2024/06/26 19:29:14 UTC [2024/06/26 15:29:14 ET]
Table '3767885527 58' 8-max Seat #8 is the button
Seat 1: leitalopez (38999 in chips) 
Seat 2: Philipoune (132182 in chips) 
Seat 3: Defence_BOMB (33717 in chips) 
Seat 4: Renailmatto (39920 in chips) 
Seat 5: MTTSharkSnG (73500 in chips) 
Seat 6: JovemPromessa (8600 in chips) 
Seat 7: jammy1875 (70393 in chips) 
Seat 8: oO-HaiRoller-Oo (45400 in chips) 
leitalopez: posts the ante 250
Philipoune: posts the ante 250
Defence_BOMB: posts the ante 250
Renailmatto: posts the ante 250
MTTSharkSnG: posts the ante 250
JovemPromessa: posts the ante 250
jammy1875: posts the ante 250
oO-HaiRoller-Oo: posts the ante 250
leitalopez: posts small blind 1000
Philipoune: posts big blind 2000
*** HOLE CARDS ***
Defence_BOMB: folds 
Renailmatto: folds 
MTTSharkSnG: folds 
JovemPromessa: folds 
jammy1875: folds 
oO-HaiRoller-Oo: raises 2200 to 4200
leitalopez: raises 34549 to 38749 and is all-in
Philipoune: folds 
oO-HaiRoller-Oo: folds [Kc]
Uncalled bet (34549) returned to leitalopez
leitalopez collected 12400 from pot
leitalopez: doesn't show hand 
*** SUMMARY ***
Total pot 12400 | Rake 0 
Seat 1: leitalopez (small blind) collected (12400)
Seat 2: Philipoune (big blind) folded before Flop
Seat 3: Defence_BOMB folded before Flop (didn't bet)
Seat 4: Renailmatto folded before Flop (didn't bet)
Seat 5: MTTSharkSnG folded before Flop (didn't bet)
Seat 6: JovemPromessa folded before Flop (didn't bet)
Seat 7: jammy1875 folded before Flop (didn't bet)
Seat 8: oO-HaiRoller-Oo (button) folded before Flop

PokerStars Hand #251205979313: Tournament #3767885527, $40+$10+$5 USD Hold'em No Limit - Level XIV (1000/2000) - 2024/06/26 19:30:02 UTC [2024/06/26 15:30:02 ET]
Table '3767885527 58' 8-max Seat #1 is the button
Seat 1: leitalopez (46949 in chips) 
Seat 2: Philipoune (129932 in chips) 
Seat 3: Defence_BOMB (33467 in chips) 
Seat 4: Renailmatto (39670 in chips) 
Seat 5: MTTSharkSnG (73250 in chips) 
Seat 6: JovemPromessa (8350 in chips) 
Seat 7: jammy1875 (70143 in chips) 
Seat 8: oO-HaiRoller-Oo (40950 in chips) 
leitalopez: posts the ante 250
Philipoune: posts the ante 250
Defence_BOMB: posts the ante 250
Renailmatto: posts the ante 250
MTTSharkSnG: posts the ante 250
JovemPromessa: posts the ante 250
jammy1875: posts the ante 250
oO-HaiRoller-Oo: posts the ante 250
Philipoune: posts small blind 1000
Defence_BOMB: posts big blind 2000
*** HOLE CARDS ***
Renailmatto: folds 
MTTSharkSnG: folds 
JovemPromessa: folds 
jammy1875: raises 2000 to 4000
oO-HaiRoller-Oo: folds 
leitalopez: folds 
Philipoune: folds 
Defence_BOMB: raises 29217 to 33217 and is all-in
jammy1875: calls 29217
*** FLOP *** [Kh 2s Th]
*** TURN *** [Kh 2s Th] [3c]
*** RIVER *** [Kh 2s Th 3c] [Jh]
*** SHOW DOWN ***
Defence_BOMB: shows [5s 5h] (a pair of Fives)
jammy1875: shows [Kc Ts] (two pair, Kings and Tens)
jammy1875 collected 69434 from pot
Defence_BOMB finished the tournament
*** SUMMARY ***
Total pot 69434 | Rake 0 
Board [Kh 2s Th 3c Jh]
Seat 1: leitalopez (button) folded before Flop (didn't bet)
Seat 2: Philipoune (small blind) folded before Flop
Seat 3: Defence_BOMB (big blind) showed [5s 5h] and lost with a pair of Fives
Seat 4: Renailmatto folded before Flop (didn't bet)
Seat 5: MTTSharkSnG folded before Flop (didn't bet)
Seat 6: JovemPromessa folded before Flop (didn't bet)
Seat 7: jammy1875 showed [Kc Ts] and won (69434) with two pair, Kings and Tens
Seat 8: oO-HaiRoller-Oo folded before Flop (didn't bet)

PokerStars Hand #251205991436: Tournament #3767885527, $40+$10+$5 USD Hold'em No Limit - Level XIV (1000/2000) - 2024/06/26 19:30:46 UTC [2024/06/26 15:30:46 ET]
Table '3767885527 58' 8-max Seat #2 is the button
Seat 1: leitalopez (46699 in chips) 
Seat 2: Philipoune (128682 in chips) 
Seat 4: Renailmatto (39420 in chips) 
Seat 5: MTTSharkSnG (73000 in chips) 
Seat 6: JovemPromessa (8100 in chips) 
Seat 7: jammy1875 (106110 in chips) 
Seat 8: oO-HaiRoller-Oo (40700 in chips) 
leitalopez: posts the ante 250
Philipoune: posts the ante 250
Renailmatto: posts the ante 250
MTTSharkSnG: posts the ante 250
JovemPromessa: posts the ante 250
jammy1875: posts the ante 250
oO-HaiRoller-Oo: posts the ante 250
Renailmatto: posts small blind 1000
MTTSharkSnG: posts big blind 2000
*** HOLE CARDS ***
JovemPromessa: raises 4000 to 6000
jammy1875: calls 6000
oO-HaiRoller-Oo: folds 
leitalopez: folds 
Philipoune: raises 122432 to 128432 and is all-in
Renailmatto: folds 
MTTSharkSnG: folds 
JovemPromessa: calls 1850 and is all-in
jammy1875: folds 
Uncalled bet (120582) returned to Philipoune
*** FLOP *** [2d 8d 4c]
*** TURN *** [2d 8d 4c] [5d]
*** RIVER *** [2d 8d 4c 5d] [7h]
*** SHOW DOWN ***
JovemPromessa: shows [Jc Ac] (high card Ace)
Philipoune: shows [9s 9h] (a pair of Nines)
Philipoune collected 26450 from pot
JovemPromessa finished the tournament
*** SUMMARY ***
Total pot 26450 | Rake 0 
Board [2d 8d 4c 5d 7h]
Seat 1: leitalopez folded before Flop (didn't bet)
Seat 2: Philipoune (button) showed [9s 9h] and won (26450) with a pair of Nines
Seat 4: Renailmatto (small blind) folded before Flop
Seat 5: MTTSharkSnG (big blind) folded before Flop
Seat 6: JovemPromessa showed [Jc Ac] and lost with high card Ace
Seat 7: jammy1875 folded before Flop
Seat 8: oO-HaiRoller-Oo folded before Flop (didn't bet)

PokerStars Hand #251205999281: Tournament #3767885527, $40+$10+$5 USD Hold'em No Limit - Level XIV (1000/2000) - 2024/06/26 19:31:15 UTC [2024/06/26 15:31:15 ET]
Table '3767885527 58' 8-max Seat #4 is the button
Seat 1: leitalopez (46449 in chips) 
Seat 2: Philipoune (147032 in chips) 
Seat 4: Renailmatto (38170 in chips) 
Seat 5: MTTSharkSnG (70750 in chips) 
Seat 7: jammy1875 (99860 in chips) 
Seat 8: oO-HaiRoller-Oo (40450 in chips) 
leitalopez: posts the ante 250
Philipoune: posts the ante 250
Renailmatto: posts the ante 250
MTTSharkSnG: posts the ante 250
jammy1875: posts the ante 250
oO-HaiRoller-Oo: posts the ante 250
MTTSharkSnG: posts small blind 1000
jammy1875: posts big blind 2000
*** HOLE CARDS ***
jeyun is disconnected 
oO-HaiRoller-Oo: raises 2200 to 4200
leitalopez: folds 
Philipoune: folds 
Renailmatto: folds 
MTTSharkSnG: folds 
jammy1875: folds 
Uncalled bet (2200) returned to oO-HaiRoller-Oo
oO-HaiRoller-Oo collected 6500 from pot
oO-HaiRoller-Oo: doesn't show hand 
tarantullv is disconnected 
*** SUMMARY ***
Total pot 6500 | Rake 0 
Seat 1: leitalopez folded before Flop (didn't bet)
Seat 2: Philipoune folded before Flop (didn't bet)
Seat 4: Renailmatto (button) folded before Flop (didn't bet)
Seat 5: MTTSharkSnG (small blind) folded before Flop
Seat 7: jammy1875 (big blind) folded before Flop
Seat 8: oO-HaiRoller-Oo collected (6500)

PokerStars Hand #251206003860: Tournament #3767885527, $40+$10+$5 USD Hold'em No Limit - Level XIV (1000/2000) - 2024/06/26 19:31:31 UTC [2024/06/26 15:31:31 ET]
Table '3767885527 58' 8-max Seat #5 is the button
Seat 1: leitalopez (46199 in chips) 
Seat 2: Philipoune (146782 in chips) 
Seat 3: jeyun (38917 in chips) 
Seat 4: Renailmatto (37920 in chips) 
Seat 5: MTTSharkSnG (69500 in chips) 
Seat 6: tarantullv (25000 in chips) out of hand (moved from another table into small blind)
Seat 7: jammy1875 (97610 in chips) 
Seat 8: oO-HaiRoller-Oo (44700 in chips) 
tarantullv will be allowed to play after the button
leitalopez: posts the ante 250
Philipoune: posts the ante 250
jeyun: posts the ante 250
Renailmatto: posts the ante 250
MTTSharkSnG: posts the ante 250
jammy1875: posts the ante 250
oO-HaiRoller-Oo: posts the ante 250
jammy1875: posts small blind 1000
oO-HaiRoller-Oo: posts big blind 2000
*** HOLE CARDS ***
leitalopez: folds 
Philipoune: folds 
jeyun: raises 2000 to 4000
Renailmatto: folds 
MTTSharkSnG: folds 
jammy1875: folds 
oO-HaiRoller-Oo: calls 2000
*** FLOP *** [Td 6s 3s]
oO-HaiRoller-Oo: checks 
jeyun: bets 3548
oO-HaiRoller-Oo: folds 
Uncalled bet (3548) returned to jeyun
jeyun collected 10750 from pot
*** SUMMARY ***
Total pot 10750 | Rake 0 
Board [Td 6s 3s]
Seat 1: leitalopez folded before Flop (didn't bet)
Seat 2: Philipoune folded before Flop (didn't bet)
Seat 3: jeyun collected (10750)
Seat 4: Renailmatto folded before Flop (didn't bet)
Seat 5: MTTSharkSnG (button) folded before Flop (didn't bet)
Seat 7: jammy1875 (small blind) folded before Flop
Seat 8: oO-HaiRoller-Oo (big blind) folded on the Flop

PokerStars Hand #251206017275: Tournament #3767885527, $40+$10+$5 USD Hold'em No Limit - Level XIV (1000/2000) - 2024/06/26 19:32:20 UTC [2024/06/26 15:32:20 ET]
Table '3767885527 58' 8-max Seat #7 is the button
Seat 1: leitalopez (45949 in chips) 
Seat 2: Philipoune (146532 in chips) 
Seat 3: jeyun (45417 in chips) 
Seat 4: Renailmatto (37670 in chips) 
Seat 5: MTTSharkSnG (69250 in chips) 
Seat 6: tarantullv (25000 in chips) 
Seat 7: jammy1875 (96360 in chips) 
Seat 8: oO-HaiRoller-Oo (40450 in chips) 
leitalopez: posts the ante 250
Philipoune: posts the ante 250
jeyun: posts the ante 250
Renailmatto: posts the ante 250
MTTSharkSnG: posts the ante 250
tarantullv: posts the ante 250
jammy1875: posts the ante 250
oO-HaiRoller-Oo: posts the ante 250
oO-HaiRoller-Oo: posts small blind 1000
leitalopez: posts big blind 2000
*** HOLE CARDS ***
Philipoune: folds 
jeyun: folds 
Renailmatto: folds 
MTTSharkSnG: raises 2000 to 4000
tarantullv: raises 20750 to 24750 and is all-in
jammy1875: folds 
oO-HaiRoller-Oo: folds 
leitalopez: folds 
MTTSharkSnG: folds 
Uncalled bet (20750) returned to tarantullv
tarantullv collected 13000 from pot
tarantullv: doesn't show hand 
*** SUMMARY ***
Total pot 13000 | Rake 0 
Seat 1: leitalopez (big blind) folded before Flop
Seat 2: Philipoune folded before Flop (didn't bet)
Seat 3: jeyun folded before Flop (didn't bet)
Seat 4: Renailmatto folded before Flop (didn't bet)
Seat 5: MTTSharkSnG folded before Flop
Seat 6: tarantullv collected (13000)
Seat 7: jammy1875 (button) folded before Flop (didn't bet)
Seat 8: oO-HaiRoller-Oo (small blind) folded before Flop

PokerStars Hand #251206024916: Tournament #3767885527, $40+$10+$5 USD Hold'em No Limit - Level XIV (1000/2000) - 2024/06/26 19:32:48 UTC [2024/06/26 15:32:48 ET]
Table '3767885527 58' 8-max Seat #8 is the button
Seat 1: leitalopez (43699 in chips) 
Seat 2: Philipoune (146282 in chips) 
Seat 3: jeyun (45167 in chips) 
Seat 4: Renailmatto (37420 in chips) 
Seat 5: MTTSharkSnG (65000 in chips) 
Seat 6: tarantullv (33750 in chips) 
Seat 7: jammy1875 (96110 in chips) 
Seat 8: oO-HaiRoller-Oo (39200 in chips) 
leitalopez: posts the ante 250
Philipoune: posts the ante 250
jeyun: posts the ante 250
Renailmatto: posts the ante 250
MTTSharkSnG: posts the ante 250
tarantullv: posts the ante 250
jammy1875: posts the ante 250
oO-HaiRoller-Oo: posts the ante 250
leitalopez: posts small blind 1000
Philipoune: posts big blind 2000
*** HOLE CARDS ***
jeyun: folds 
Renailmatto: folds 
MTTSharkSnG: folds 
tarantullv: folds 
jammy1875: folds 
oO-HaiRoller-Oo: raises 36950 to 38950 and is all-in
leitalopez: folds 
Philipoune: folds 
Uncalled bet (36950) returned to oO-HaiRoller-Oo
oO-HaiRoller-Oo collected 7000 from pot
oO-HaiRoller-Oo: doesn't show hand 
*** SUMMARY ***
Total pot 7000 | Rake 0 
Seat 1: leitalopez (small blind) folded before Flop
Seat 2: Philipoune (big blind) folded before Flop
Seat 3: jeyun folded before Flop (didn't bet)
Seat 4: Renailmatto folded before Flop (didn't bet)
Seat 5: MTTSharkSnG folded before Flop (didn't bet)
Seat 6: tarantullv folded before Flop (didn't bet)
Seat 7: jammy1875 folded before Flop (didn't bet)
Seat 8: oO-HaiRoller-Oo (button) collected (7000)

PokerStars Hand #251206029154: Tournament #3767885527, $40+$10+$5 USD Hold'em No Limit - Level XIV (1000/2000) - 2024/06/26 19:33:04 UTC [2024/06/26 15:33:04 ET]
Table '3767885527 58' 8-max Seat #1 is the button
Seat 1: leitalopez (42449 in chips) 
Seat 2: Philipoune (144032 in chips) 
Seat 3: jeyun (44917 in chips) 
Seat 4: Renailmatto (37170 in chips) 
Seat 5: MTTSharkSnG (64750 in chips) 
Seat 6: tarantullv (33500 in chips) 
Seat 7: jammy1875 (95860 in chips) 
Seat 8: oO-HaiRoller-Oo (43950 in chips) 
leitalopez: posts the ante 250
Philipoune: posts the ante 250
jeyun: posts the ante 250
Renailmatto: posts the ante 250
MTTSharkSnG: posts the ante 250
tarantullv: posts the ante 250
jammy1875: posts the ante 250
oO-HaiRoller-Oo: posts the ante 250
Philipoune: posts small blind 1000
jeyun: posts big blind 2000
*** HOLE CARDS ***
Renailmatto: folds 
MTTSharkSnG: raises 2000 to 4000
tarantullv: folds 
jammy1875: calls 4000
oO-HaiRoller-Oo: folds 
leitalopez: folds 
Philipoune: folds 
jeyun: calls 2000
*** FLOP *** [Ac As 6c]
jeyun: checks 
MTTSharkSnG: bets 4318
jammy1875: calls 4318
jeyun: folds 
*** TURN *** [Ac As 6c] [Qs]
MTTSharkSnG: bets 8758
jammy1875: calls 8758
*** RIVER *** [Ac As 6c Qs] [9c]
MTTSharkSnG: checks 
jammy1875: bets 22576
MTTSharkSnG: folds 
Uncalled bet (22576) returned to jammy1875
jammy1875 collected 41152 from pot
*** SUMMARY ***
Total pot 41152 | Rake 0 
Board [Ac As 6c Qs 9c]
Seat 1: leitalopez (button) folded before Flop (didn't bet)
Seat 2: Philipoune (small blind) folded before Flop
Seat 3: jeyun (big blind) folded on the Flop
Seat 4: Renailmatto folded before Flop (didn't bet)
Seat 5: MTTSharkSnG folded on the River
Seat 6: tarantullv folded before Flop (didn't bet)
Seat 7: jammy1875 collected (41152)
Seat 8: oO-HaiRoller-Oo folded before Flop (didn't bet)

PokerStars Hand #251206061077: Tournament #3767885527, $40+$10+$5 USD Hold'em No Limit - Level XIV (1000/2000) - 2024/06/26 19:35:00 UTC [2024/06/26 15:35:00 ET]
Table '3767885527 58' 8-max Seat #2 is the button
Seat 1: leitalopez (42199 in chips) 
Seat 2: Philipoune (142782 in chips) 
Seat 3: jeyun (40667 in chips) 
Seat 4: Renailmatto (36920 in chips) 
Seat 5: MTTSharkSnG (47424 in chips) 
Seat 6: tarantullv (33250 in chips) 
Seat 7: jammy1875 (119686 in chips) 
Seat 8: oO-HaiRoller-Oo (43700 in chips) 
leitalopez: posts the ante 250
Philipoune: posts the ante 250
jeyun: posts the ante 250
Renailmatto: posts the ante 250
MTTSharkSnG: posts the ante 250
tarantullv: posts the ante 250
jammy1875: posts the ante 250
oO-HaiRoller-Oo: posts the ante 250
jeyun: posts small blind 1000
Renailmatto: posts big blind 2000
*** HOLE CARDS ***
MTTSharkSnG: folds 
tarantullv: folds 
jammy1875: raises 2000 to 4000
oO-HaiRoller-Oo: folds 
leitalopez: folds 
Philipoune: folds 
jeyun: raises 36417 to 40417 and is all-in
Renailmatto: folds 
jammy1875: folds 
Uncalled bet (36417) returned to jeyun
jeyun collected 12000 from pot
*** SUMMARY ***
Total pot 12000 | Rake 0 
Seat 1: leitalopez folded before Flop (didn't bet)
Seat 2: Philipoune (button) folded before Flop (didn't bet)
Seat 3: jeyun (small blind) collected (12000)
Seat 4: Renailmatto (big blind) folded before Flop
Seat 5: MTTSharkSnG folded before Flop (didn't bet)
Seat 6: tarantullv folded before Flop (didn't bet)
Seat 7: jammy1875 folded before Flop
Seat 8: oO-HaiRoller-Oo folded before Flop (didn't bet)

PokerStars Hand #251206071448: Tournament #3767885527, $40+$10+$5 USD Hold'em No Limit - Level XIV (1000/2000) - 2024/06/26 19:35:38 UTC [2024/06/26 15:35:38 ET]
Table '3767885527 58' 8-max Seat #3 is the button
Seat 1: leitalopez (41949 in chips) 
Seat 2: Philipoune (142532 in chips) 
Seat 3: jeyun (48417 in chips) 
Seat 4: Renailmatto (34670 in chips) 
Seat 5: MTTSharkSnG (47174 in chips) 
Seat 6: tarantullv (33000 in chips) 
Seat 7: jammy1875 (115436 in chips) 
Seat 8: oO-HaiRoller-Oo (43450 in chips) 
leitalopez: posts the ante 250
Philipoune: posts the ante 250
jeyun: posts the ante 250
Renailmatto: posts the ante 250
MTTSharkSnG: posts the ante 250
tarantullv: posts the ante 250
jammy1875: posts the ante 250
oO-HaiRoller-Oo: posts the ante 250
Renailmatto: posts small blind 1000
MTTSharkSnG: posts big blind 2000
*** HOLE CARDS ***
tarantullv: folds 
jammy1875: folds 
oO-HaiRoller-Oo: raises 2200 to 4200
leitalopez: folds 
Philipoune: folds 
jeyun: folds 
Renailmatto: calls 3200
MTTSharkSnG: calls 2200
*** FLOP *** [6s Ts Ah]
Renailmatto: checks 
MTTSharkSnG: checks 
oO-HaiRoller-Oo: bets 6000
Renailmatto: folds 
MTTSharkSnG: folds 
Uncalled bet (6000) returned to oO-HaiRoller-Oo
oO-HaiRoller-Oo collected 14600 from pot
oO-HaiRoller-Oo: doesn't show hand 
*** SUMMARY ***
Total pot 14600 | Rake 0 
Board [6s Ts Ah]
Seat 1: leitalopez folded before Flop (didn't bet)
Seat 2: Philipoune folded before Flop (didn't bet)
Seat 3: jeyun (button) folded before Flop (didn't bet)
Seat 4: Renailmatto (small blind) folded on the Flop
Seat 5: MTTSharkSnG (big blind) folded on the Flop
Seat 6: tarantullv folded before Flop (didn't bet)
Seat 7: jammy1875 folded before Flop (didn't bet)
Seat 8: oO-HaiRoller-Oo collected (14600)

PokerStars Hand #251206081406: Tournament #3767885527, $40+$10+$5 USD Hold'em No Limit - Level XIV (1000/2000) - 2024/06/26 19:36:14 UTC [2024/06/26 15:36:14 ET]
Table '3767885527 58' 8-max Seat #4 is the button
Seat 1: leitalopez (41699 in chips) 
Seat 2: Philipoune (142282 in chips) 
Seat 3: jeyun (48167 in chips) 
Seat 4: Renailmatto (30220 in chips) 
Seat 5: MTTSharkSnG (42724 in chips) 
Seat 6: tarantullv (32750 in chips) 
Seat 7: jammy1875 (115186 in chips) 
Seat 8: oO-HaiRoller-Oo (53600 in chips) 
leitalopez: posts the ante 250
Philipoune: posts the ante 250
jeyun: posts the ante 250
Renailmatto: posts the ante 250
MTTSharkSnG: posts the ante 250
tarantullv: posts the ante 250
jammy1875: posts the ante 250
oO-HaiRoller-Oo: posts the ante 250
MTTSharkSnG: posts small blind 1000
tarantullv: posts big blind 2000
*** HOLE CARDS ***
jammy1875: folds 
oO-HaiRoller-Oo: folds 
leitalopez: folds 
Philipoune: folds 
jeyun: folds 
Renailmatto: folds 
MTTSharkSnG: folds 
Uncalled bet (1000) returned to tarantullv
tarantullv collected 4000 from pot
tarantullv: doesn't show hand 
*** SUMMARY ***
Total pot 4000 | Rake 0 
Seat 1: leitalopez folded before Flop (didn't bet)
Seat 2: Philipoune folded before Flop (didn't bet)
Seat 3: jeyun folded before Flop (didn't bet)
Seat 4: Renailmatto (button) folded before Flop (didn't bet)
Seat 5: MTTSharkSnG (small blind) folded before Flop
Seat 6: tarantullv (big blind) collected (4000)
Seat 7: jammy1875 folded before Flop (didn't bet)
Seat 8: oO-HaiRoller-Oo folded before Flop (didn't bet)

PokerStars Hand #251206083960: Tournament #3767885527, $40+$10+$5 USD Hold'em No Limit - Level XIV (1000/2000) - 2024/06/26 19:36:24 UTC [2024/06/26 15:36:24 ET]
Table '3767885527 58' 8-max Seat #5 is the button
Seat 1: leitalopez (41449 in chips) 
Seat 2: Philipoune (142032 in chips) 
Seat 3: jeyun (47917 in chips) 
Seat 4: Renailmatto (29970 in chips) 
Seat 5: MTTSharkSnG (41474 in chips) 
Seat 6: tarantullv (35500 in chips) 
Seat 7: jammy1875 (114936 in chips) 
Seat 8: oO-HaiRoller-Oo (53350 in chips) 
leitalopez: posts the ante 250
Philipoune: posts the ante 250
jeyun: posts the ante 250
Renailmatto: posts the ante 250
MTTSharkSnG: posts the ante 250
tarantullv: posts the ante 250
jammy1875: posts the ante 250
oO-HaiRoller-Oo: posts the ante 250
tarantullv: posts small blind 1000
jammy1875: posts big blind 2000
*** HOLE CARDS ***
oO-HaiRoller-Oo: folds 
leitalopez: raises 2000 to 4000
Philipoune: folds 
jeyun: folds 
Renailmatto: folds 
MTTSharkSnG: folds 
tarantullv: folds 
jammy1875: raises 110686 to 114686 and is all-in
leitalopez: calls 37199 and is all-in
Uncalled bet (73487) returned to jammy1875
*** FLOP *** [Ks 6c 4s]
*** TURN *** [Ks 6c 4s] [3h]
*** RIVER *** [Ks 6c 4s 3h] [2h]
*** SHOW DOWN ***
jammy1875: shows [2d 2c] (three of a kind, Deuces)
leitalopez: shows [Tc Td] (a pair of Tens)
jammy1875 collected 85398 from pot
leitalopez finished the tournament in 645th place
*** SUMMARY ***
Total pot 85398 | Rake 0 
Board [Ks 6c 4s 3h 2h]
Seat 1: leitalopez showed [Tc Td] and lost with a pair of Tens
Seat 2: Philipoune folded before Flop (didn't bet)
Seat 3: jeyun folded before Flop (didn't bet)
Seat 4: Renailmatto folded before Flop (didn't bet)
Seat 5: MTTSharkSnG (button) folded before Flop (didn't bet)
Seat 6: tarantullv (small blind) folded before Flop
Seat 7: jammy1875 (big blind) showed [2d 2c] and won (85398) with three of a kind, Deuces
Seat 8: oO-HaiRoller-Oo folded before Flop (didn't bet)


PokerStars Hand #251206681673: Tournament #3767885527, $40+$10+$5 USD Hold'em No Limit - Level XVII (1750/3500) - 2024/06/26 20:13:26 UTC [2024/06/26 16:13:26 ET]
Table '3767885527 57' 8-max Seat #1 is the button
Seat 1: yaniw777 (117541 in chips) 
Seat 2: LV_Arturs (62787 in chips) 
Seat 3: fellipeschmeil (55233 in chips) 
Seat 4: chuchukat (271199 in chips) 
Seat 5: lftgjc (137479 in chips) 
Seat 6: PavanaTTo23 (28951 in chips) 
Seat 7: drinho2pac (89661 in chips) 
Seat 8: Pedrozadota (111334 in chips) 
yaniw777: posts the ante 450
LV_Arturs: posts the ante 450
fellipeschmeil: posts the ante 450
chuchukat: posts the ante 450
lftgjc: posts the ante 450
PavanaTTo23: posts the ante 450
drinho2pac: posts the ante 450
Pedrozadota: posts the ante 450
LV_Arturs: posts small blind 1750
fellipeschmeil: posts big blind 3500
*** HOLE CARDS ***
chuchukat: raises 3500 to 7000
lftgjc: folds 
PavanaTTo23: folds 
drinho2pac: folds 
Pedrozadota: raises 3500 to 10500
yaniw777: folds 
LV_Arturs: folds 
fellipeschmeil: folds 
chuchukat: raises 260249 to 270749 and is all-in
Pedrozadota: folds 
Uncalled bet (260249) returned to chuchukat
chuchukat collected 29850 from pot
chuchukat: doesn't show hand 
*** SUMMARY ***
Total pot 29850 | Rake 0 
Seat 1: yaniw777 (button) folded before Flop (didn't bet)
Seat 2: LV_Arturs (small blind) folded before Flop
Seat 3: fellipeschmeil (big blind) folded before Flop
Seat 4: chuchukat collected (29850)
Seat 5: lftgjc folded before Flop (didn't bet)
Seat 6: PavanaTTo23 folded before Flop (didn't bet)
Seat 7: drinho2pac folded before Flop (didn't bet)
Seat 8: Pedrozadota folded before Flop

PokerStars Hand #251206693722: Tournament #3767885527, $40+$10+$5 USD Hold'em No Limit - Level XVII (1750/3500) - 2024/06/26 20:14:10 UTC [2024/06/26 16:14:10 ET]
Table '3767885527 57' 8-max Seat #2 is the button
Seat 1: yaniw777 (117091 in chips) 
Seat 2: LV_Arturs (60587 in chips) 
Seat 3: fellipeschmeil (51283 in chips) 
Seat 4: chuchukat (290099 in chips) 
Seat 5: lftgjc (137029 in chips) 
Seat 6: PavanaTTo23 (28501 in chips) 
Seat 7: drinho2pac (89211 in chips) 
Seat 8: Pedrozadota (100384 in chips) 
yaniw777: posts the ante 450
LV_Arturs: posts the ante 450
fellipeschmeil: posts the ante 450
chuchukat: posts the ante 450
lftgjc: posts the ante 450
PavanaTTo23: posts the ante 450
drinho2pac: posts the ante 450
Pedrozadota: posts the ante 450
fellipeschmeil: posts small blind 1750
chuchukat: posts big blind 3500
*** HOLE CARDS ***
lftgjc: folds 
PavanaTTo23: folds 
drinho2pac: raises 3850 to 7350
Pedrozadota: folds 
yaniw777: folds 
LV_Arturs: calls 7350
fellipeschmeil: folds 
chuchukat: folds 
*** FLOP *** [3h 7d 7c]
drinho2pac: checks 
LV_Arturs: checks 
*** TURN *** [3h 7d 7c] [9s]
drinho2pac: checks 
LV_Arturs: bets 7065
drinho2pac: calls 7065
*** RIVER *** [3h 7d 7c 9s] [5s]
drinho2pac: checks 
LV_Arturs: checks 
*** SHOW DOWN ***
drinho2pac: shows [Td Ad] (a pair of Sevens)
LV_Arturs: shows [As 3s] (two pair, Sevens and Threes)
LV_Arturs collected 37680 from pot
*** SUMMARY ***
Total pot 37680 | Rake 0 
Board [3h 7d 7c 9s 5s]
Seat 1: yaniw777 folded before Flop (didn't bet)
Seat 2: LV_Arturs (button) showed [As 3s] and won (37680) with two pair, Sevens and Threes
Seat 3: fellipeschmeil (small blind) folded before Flop
Seat 4: chuchukat (big blind) folded before Flop
Seat 5: lftgjc folded before Flop (didn't bet)
Seat 6: PavanaTTo23 folded before Flop (didn't bet)
Seat 7: drinho2pac showed [Td Ad] and lost with a pair of Sevens
Seat 8: Pedrozadota folded before Flop (didn't bet)

PokerStars Hand #251206715099: Tournament #3767885527, $40+$10+$5 USD Hold'em No Limit - Level XVII (1750/3500) - 2024/06/26 20:15:25 UTC [2024/06/26 16:15:25 ET]
Table '3767885527 57' 8-max Seat #3 is the button
Seat 1: yaniw777 (116641 in chips) 
Seat 2: LV_Arturs (83402 in chips) 
Seat 3: fellipeschmeil (49083 in chips) 
Seat 4: chuchukat (286149 in chips) 
Seat 5: lftgjc (136579 in chips) 
Seat 6: PavanaTTo23 (28051 in chips) 
Seat 7: drinho2pac (74346 in chips) 
Seat 8: Pedrozadota (99934 in chips) 
yaniw777: posts the ante 450
LV_Arturs: posts the ante 450
fellipeschmeil: posts the ante 450
chuchukat: posts the ante 450
lftgjc: posts the ante 450
PavanaTTo23: posts the ante 450
drinho2pac: posts the ante 450
Pedrozadota: posts the ante 450
chuchukat: posts small blind 1750
lftgjc: posts big blind 3500
*** HOLE CARDS ***
PavanaTTo23: folds 
drinho2pac: folds 
Pedrozadota: folds 
yaniw777: folds 
LV_Arturs: raises 3675 to 7175
fellipeschmeil: folds 
chuchukat: folds 
lftgjc: calls 3675
*** FLOP *** [7c 8s Qh]
lftgjc: checks 
LV_Arturs: checks 
*** TURN *** [7c 8s Qh] [Kd]
lftgjc: checks 
LV_Arturs: bets 12250
lftgjc: folds 
Uncalled bet (12250) returned to LV_Arturs
LV_Arturs collected 19700 from pot
*** SUMMARY ***
Total pot 19700 | Rake 0 
Board [7c 8s Qh Kd]
Seat 1: yaniw777 folded before Flop (didn't bet)
Seat 2: LV_Arturs collected (19700)
Seat 3: fellipeschmeil (button) folded before Flop (didn't bet)
Seat 4: chuchukat (small blind) folded before Flop
Seat 5: lftgjc (big blind) folded on the Turn
Seat 6: PavanaTTo23 folded before Flop (didn't bet)
Seat 7: drinho2pac folded before Flop (didn't bet)
Seat 8: Pedrozadota folded before Flop (didn't bet)

PokerStars Hand #251206737415: Tournament #3767885527, $40+$10+$5 USD Hold'em No Limit - Level XVIII (2000/4000) - 2024/06/26 20:16:45 UTC [2024/06/26 16:16:45 ET]
Table '3767885527 57' 8-max Seat #4 is the button
Seat 1: yaniw777 (116191 in chips) 
Seat 2: LV_Arturs (95477 in chips) 
Seat 3: fellipeschmeil (48633 in chips) 
Seat 4: chuchukat (283949 in chips) 
Seat 5: lftgjc (128954 in chips) 
Seat 6: PavanaTTo23 (27601 in chips) 
Seat 7: drinho2pac (73896 in chips) 
Seat 8: Pedrozadota (99484 in chips) 
yaniw777: posts the ante 500
LV_Arturs: posts the ante 500
fellipeschmeil: posts the ante 500
chuchukat: posts the ante 500
lftgjc: posts the ante 500
PavanaTTo23: posts the ante 500
drinho2pac: posts the ante 500
Pedrozadota: posts the ante 500
lftgjc: posts small blind 2000
PavanaTTo23: posts big blind 4000
*** HOLE CARDS ***
drinho2pac: folds 
Pedrozadota: folds 
yaniw777: raises 4400 to 8400
LV_Arturs: folds 
fellipeschmeil: folds 
chuchukat: folds 
lftgjc: folds 
PavanaTTo23: calls 4400
*** FLOP *** [2c Qd 6h]
PavanaTTo23: bets 18701 and is all-in
yaniw777: calls 18701
*** TURN *** [2c Qd 6h] [9h]
*** RIVER *** [2c Qd 6h 9h] [Qs]
*** SHOW DOWN ***
PavanaTTo23: shows [4d 3c] (a pair of Queens)
yaniw777: shows [Ac Js] (a pair of Queens - Ace kicker)
yaniw777 collected 60202 from pot
PavanaTTo23 finished the tournament in 344th place
*** SUMMARY ***
Total pot 60202 | Rake 0 
Board [2c Qd 6h 9h Qs]
Seat 1: yaniw777 showed [Ac Js] and won (60202) with a pair of Queens
Seat 2: LV_Arturs folded before Flop (didn't bet)
Seat 3: fellipeschmeil folded before Flop (didn't bet)
Seat 4: chuchukat (button) folded before Flop (didn't bet)
Seat 5: lftgjc (small blind) folded before Flop
Seat 6: PavanaTTo23 (big blind) showed [4d 3c] and lost with a pair of Queens
Seat 7: drinho2pac folded before Flop (didn't bet)
Seat 8: Pedrozadota folded before Flop (didn't bet)

PokerStars Hand #251206752041: Tournament #3767885527, $40+$10+$5 USD Hold'em No Limit - Level XVIII (2000/4000) - 2024/06/26 20:17:38 UTC [2024/06/26 16:17:38 ET]
Table '3767885527 57' 8-max Seat #5 is the button
Seat 1: yaniw777 (148792 in chips) 
Seat 2: LV_Arturs (94977 in chips) 
Seat 3: fellipeschmeil (48133 in chips) 
Seat 4: chuchukat (283449 in chips) 
Seat 5: lftgjc (126454 in chips) 
Seat 7: drinho2pac (73396 in chips) 
Seat 8: Pedrozadota (98984 in chips) 
yaniw777: posts the ante 500
LV_Arturs: posts the ante 500
fellipeschmeil: posts the ante 500
chuchukat: posts the ante 500
lftgjc: posts the ante 500
drinho2pac: posts the ante 500
Pedrozadota: posts the ante 500
drinho2pac: posts small blind 2000
Pedrozadota: posts big blind 4000
*** HOLE CARDS ***
yaniw777: raises 4400 to 8400
LV_Arturs: folds 
fellipeschmeil: folds 
chuchukat: calls 8400
lftgjc: raises 18000 to 26400
vip_1985Z is disconnected 
drinho2pac: folds 
Pedrozadota: folds 
yaniw777: folds 
chuchukat: folds 
Uncalled bet (18000) returned to lftgjc
lftgjc collected 34700 from pot
lftgjc: doesn't show hand 
*** SUMMARY ***
Total pot 34700 | Rake 0 
Seat 1: yaniw777 folded before Flop
Seat 2: LV_Arturs folded before Flop (didn't bet)
Seat 3: fellipeschmeil folded before Flop (didn't bet)
Seat 4: chuchukat folded before Flop
Seat 5: lftgjc (button) collected (34700)
Seat 7: drinho2pac (small blind) folded before Flop
Seat 8: Pedrozadota (big blind) folded before Flop

PokerStars Hand #251206765771: Tournament #3767885527, $40+$10+$5 USD Hold'em No Limit - Level XVIII (2000/4000) - 2024/06/26 20:18:26 UTC [2024/06/26 16:18:26 ET]
Table '3767885527 57' 8-max Seat #7 is the button
Seat 1: yaniw777 (139892 in chips) 
Seat 2: LV_Arturs (94477 in chips) 
Seat 3: fellipeschmeil (47633 in chips) 
Seat 4: chuchukat (274549 in chips) 
Seat 5: lftgjc (152254 in chips) 
Seat 6: vip_1985Z (36634 in chips) 
Seat 7: drinho2pac (70896 in chips) 
Seat 8: Pedrozadota (94484 in chips) 
yaniw777: posts the ante 500
LV_Arturs: posts the ante 500
fellipeschmeil: posts the ante 500
chuchukat: posts the ante 500
lftgjc: posts the ante 500
vip_1985Z: posts the ante 500
drinho2pac: posts the ante 500
Pedrozadota: posts the ante 500
Pedrozadota: posts small blind 2000
yaniw777: posts big blind 4000
*** HOLE CARDS ***
LV_Arturs: folds 
fellipeschmeil: folds 
chuchukat: folds 
lftgjc: folds 
vip_1985Z: folds 
drinho2pac: raises 4400 to 8400
Pedrozadota: folds 
yaniw777: folds 
Uncalled bet (4400) returned to drinho2pac
drinho2pac collected 14000 from pot
*** SUMMARY ***
Total pot 14000 | Rake 0 
Seat 1: yaniw777 (big blind) folded before Flop
Seat 2: LV_Arturs folded before Flop (didn't bet)
Seat 3: fellipeschmeil folded before Flop (didn't bet)
Seat 4: chuchukat folded before Flop (didn't bet)
Seat 5: lftgjc folded before Flop (didn't bet)
Seat 6: vip_1985Z folded before Flop (didn't bet)
Seat 7: drinho2pac (button) collected (14000)
Seat 8: Pedrozadota (small blind) folded before Flop

PokerStars Hand #251206777375: Tournament #3767885527, $40+$10+$5 USD Hold'em No Limit - Level XVIII (2000/4000) - 2024/06/26 20:19:07 UTC [2024/06/26 16:19:07 ET]
Table '3767885527 57' 8-max Seat #8 is the button
Seat 1: yaniw777 (135392 in chips) 
Seat 2: LV_Arturs (93977 in chips) 
Seat 3: fellipeschmeil (47133 in chips) 
Seat 4: chuchukat (274049 in chips) 
Seat 5: lftgjc (151754 in chips) 
Seat 6: vip_1985Z (36134 in chips) 
Seat 7: drinho2pac (80396 in chips) 
Seat 8: Pedrozadota (91984 in chips) 
yaniw777: posts the ante 500
LV_Arturs: posts the ante 500
fellipeschmeil: posts the ante 500
chuchukat: posts the ante 500
lftgjc: posts the ante 500
vip_1985Z: posts the ante 500
drinho2pac: posts the ante 500
Pedrozadota: posts the ante 500
yaniw777: posts small blind 2000
LV_Arturs: posts big blind 4000
*** HOLE CARDS ***
fellipeschmeil: folds 
chuchukat: folds 
lftgjc: folds 
vip_1985Z: folds 
drinho2pac: folds 
Pedrozadota: folds 
yaniw777: folds 
Uncalled bet (2000) returned to LV_Arturs
LV_Arturs collected 8000 from pot
*** SUMMARY ***
Total pot 8000 | Rake 0 
Seat 1: yaniw777 (small blind) folded before Flop
Seat 2: LV_Arturs (big blind) collected (8000)
Seat 3: fellipeschmeil folded before Flop (didn't bet)
Seat 4: chuchukat folded before Flop (didn't bet)
Seat 5: lftgjc folded before Flop (didn't bet)
Seat 6: vip_1985Z folded before Flop (didn't bet)
Seat 7: drinho2pac folded before Flop (didn't bet)
Seat 8: Pedrozadota (button) folded before Flop (didn't bet)

PokerStars Hand #251206785934: Tournament #3767885527, $40+$10+$5 USD Hold'em No Limit - Level XVIII (2000/4000) - 2024/06/26 20:19:38 UTC [2024/06/26 16:19:38 ET]
Table '3767885527 57' 8-max Seat #1 is the button
Seat 1: yaniw777 (132892 in chips) 
Seat 2: LV_Arturs (99477 in chips) 
Seat 3: fellipeschmeil (46633 in chips) 
Seat 4: chuchukat (273549 in chips) 
Seat 5: lftgjc (151254 in chips) 
Seat 6: vip_1985Z (35634 in chips) 
Seat 7: drinho2pac (79896 in chips) 
Seat 8: Pedrozadota (91484 in chips) 
yaniw777: posts the ante 500
LV_Arturs: posts the ante 500
fellipeschmeil: posts the ante 500
chuchukat: posts the ante 500
lftgjc: posts the ante 500
vip_1985Z: posts the ante 500
drinho2pac: posts the ante 500
Pedrozadota: posts the ante 500
LV_Arturs: posts small blind 2000
fellipeschmeil: posts big blind 4000
*** HOLE CARDS ***
chuchukat: folds 
lftgjc: folds 
vip_1985Z: folds 
drinho2pac: folds 
Pedrozadota: raises 4400 to 8400
yaniw777: folds 
LV_Arturs: folds 
fellipeschmeil: calls 4400
*** FLOP *** [Kh Qs 3s]
fellipeschmeil: checks 
Pedrozadota: bets 4000
fellipeschmeil: folds 
Uncalled bet (4000) returned to Pedrozadota
Pedrozadota collected 22800 from pot
Pedrozadota: doesn't show hand 
*** SUMMARY ***
Total pot 22800 | Rake 0 
Board [Kh Qs 3s]
Seat 1: yaniw777 (button) folded before Flop (didn't bet)
Seat 2: LV_Arturs (small blind) folded before Flop
Seat 3: fellipeschmeil (big blind) folded on the Flop
Seat 4: chuchukat folded before Flop (didn't bet)
Seat 5: lftgjc folded before Flop (didn't bet)
Seat 6: vip_1985Z folded before Flop (didn't bet)
Seat 7: drinho2pac folded before Flop (didn't bet)
Seat 8: Pedrozadota collected (22800)

PokerStars Hand #251206797298: Tournament #3767885527, $40+$10+$5 USD Hold'em No Limit - Level XVIII (2000/4000) - 2024/06/26 20:20:18 UTC [2024/06/26 16:20:18 ET]
Table '3767885527 57' 8-max Seat #2 is the button
Seat 1: yaniw777 (132392 in chips) 
Seat 2: LV_Arturs (96977 in chips) 
Seat 3: fellipeschmeil (37733 in chips) 
Seat 4: chuchukat (273049 in chips) 
Seat 5: lftgjc (150754 in chips) 
Seat 6: vip_1985Z (35134 in chips) 
Seat 7: drinho2pac (79396 in chips) 
Seat 8: Pedrozadota (105384 in chips) 
yaniw777: posts the ante 500
LV_Arturs: posts the ante 500
fellipeschmeil: posts the ante 500
chuchukat: posts the ante 500
lftgjc: posts the ante 500
vip_1985Z: posts the ante 500
drinho2pac: posts the ante 500
Pedrozadota: posts the ante 500
fellipeschmeil: posts small blind 2000
chuchukat: posts big blind 4000
*** HOLE CARDS ***
lftgjc: raises 4000 to 8000
vip_1985Z: folds 
drinho2pac: folds 
Pedrozadota: folds 
yaniw777: folds 
LV_Arturs: folds 
fellipeschmeil: folds 
chuchukat: calls 4000
*** FLOP *** [Td 2s 7s]
chuchukat: checks 
lftgjc: checks 
*** TURN *** [Td 2s 7s] [6d]
chuchukat: bets 8000
lftgjc: calls 8000
*** RIVER *** [Td 2s 7s 6d] [8h]
chuchukat: bets 48000
lftgjc: folds 
Uncalled bet (48000) returned to chuchukat
chuchukat collected 38000 from pot
chuchukat: doesn't show hand 
*** SUMMARY ***
Total pot 38000 | Rake 0 
Board [Td 2s 7s 6d 8h]
Seat 1: yaniw777 folded before Flop (didn't bet)
Seat 2: LV_Arturs (button) folded before Flop (didn't bet)
Seat 3: fellipeschmeil (small blind) folded before Flop
Seat 4: chuchukat (big blind) collected (38000)
Seat 5: lftgjc folded on the River
Seat 6: vip_1985Z folded before Flop (didn't bet)
Seat 7: drinho2pac folded before Flop (didn't bet)
Seat 8: Pedrozadota folded before Flop (didn't bet)

PokerStars Hand #251206817201: Tournament #3767885527, $40+$10+$5 USD Hold'em No Limit - Level XVIII (2000/4000) - 2024/06/26 20:21:28 UTC [2024/06/26 16:21:28 ET]
Table '3767885527 57' 8-max Seat #3 is the button
Seat 1: yaniw777 (131892 in chips) 
Seat 2: LV_Arturs (96477 in chips) 
Seat 3: fellipeschmeil (35233 in chips) 
Seat 4: chuchukat (294549 in chips) 
Seat 5: lftgjc (134254 in chips) 
Seat 6: vip_1985Z (34634 in chips) 
Seat 7: drinho2pac (78896 in chips) 
Seat 8: Pedrozadota (104884 in chips) 
yaniw777: posts the ante 500
LV_Arturs: posts the ante 500
fellipeschmeil: posts the ante 500
chuchukat: posts the ante 500
lftgjc: posts the ante 500
vip_1985Z: posts the ante 500
drinho2pac: posts the ante 500
Pedrozadota: posts the ante 500
chuchukat: posts small blind 2000
lftgjc: posts big blind 4000
*** HOLE CARDS ***
vip_1985Z: folds 
drinho2pac: folds 
Pedrozadota: folds 
yaniw777: folds 
LV_Arturs: folds 
fellipeschmeil: folds 
chuchukat: raises 10000 to 14000
lftgjc: raises 18000 to 32000
chuchukat: folds 
Uncalled bet (18000) returned to lftgjc
lftgjc collected 32000 from pot
lftgjc: doesn't show hand 
*** SUMMARY ***
Total pot 32000 | Rake 0 
Seat 1: yaniw777 folded before Flop (didn't bet)
Seat 2: LV_Arturs folded before Flop (didn't bet)
Seat 3: fellipeschmeil (button) folded before Flop (didn't bet)
Seat 4: chuchukat (small blind) folded before Flop
Seat 5: lftgjc (big blind) collected (32000)
Seat 6: vip_1985Z folded before Flop (didn't bet)
Seat 7: drinho2pac folded before Flop (didn't bet)
Seat 8: Pedrozadota folded before Flop (didn't bet)

PokerStars Hand #251206830495: Tournament #3767885527, $40+$10+$5 USD Hold'em No Limit - Level XVIII (2000/4000) - 2024/06/26 20:22:16 UTC [2024/06/26 16:22:16 ET]
Table '3767885527 57' 8-max Seat #4 is the button
Seat 1: yaniw777 (131392 in chips) 
Seat 2: LV_Arturs (95977 in chips) 
Seat 3: fellipeschmeil (34733 in chips) 
Seat 4: chuchukat (280049 in chips) 
Seat 5: lftgjc (151754 in chips) 
Seat 6: vip_1985Z (34134 in chips) 
Seat 7: drinho2pac (78396 in chips) 
Seat 8: Pedrozadota (104384 in chips) 
yaniw777: posts the ante 500
LV_Arturs: posts the ante 500
fellipeschmeil: posts the ante 500
chuchukat: posts the ante 500
lftgjc: posts the ante 500
vip_1985Z: posts the ante 500
drinho2pac: posts the ante 500
Pedrozadota: posts the ante 500
lftgjc: posts small blind 2000
vip_1985Z: posts big blind 4000
*** HOLE CARDS ***
drinho2pac: folds 
Pedrozadota: folds 
yaniw777: folds 
LV_Arturs: folds 
fellipeschmeil: folds 
chuchukat: raises 4000 to 8000
lftgjc: folds 
vip_1985Z: folds 
Uncalled bet (4000) returned to chuchukat
chuchukat collected 14000 from pot
chuchukat: doesn't show hand 
*** SUMMARY ***
Total pot 14000 | Rake 0 
Seat 1: yaniw777 folded before Flop (didn't bet)
Seat 2: LV_Arturs folded before Flop (didn't bet)
Seat 3: fellipeschmeil folded before Flop (didn't bet)
Seat 4: chuchukat (button) collected (14000)
Seat 5: lftgjc (small blind) folded before Flop
Seat 6: vip_1985Z (big blind) folded before Flop
Seat 7: drinho2pac folded before Flop (didn't bet)
Seat 8: Pedrozadota folded before Flop (didn't bet)

PokerStars Hand #251206840407: Tournament #3767885527, $40+$10+$5 USD Hold'em No Limit - Level XVIII (2000/4000) - 2024/06/26 20:22:51 UTC [2024/06/26 16:22:51 ET]
Table '3767885527 57' 8-max Seat #5 is the button
Seat 1: yaniw777 (130892 in chips) 
Seat 2: LV_Arturs (95477 in chips) 
Seat 3: fellipeschmeil (34233 in chips) 
Seat 4: chuchukat (289549 in chips) 
Seat 5: lftgjc (149254 in chips) 
Seat 6: vip_1985Z (29634 in chips) 
Seat 7: drinho2pac (77896 in chips) 
Seat 8: Pedrozadota (103884 in chips) 
yaniw777: posts the ante 500
LV_Arturs: posts the ante 500
fellipeschmeil: posts the ante 500
chuchukat: posts the ante 500
lftgjc: posts the ante 500
vip_1985Z: posts the ante 500
drinho2pac: posts the ante 500
Pedrozadota: posts the ante 500
vip_1985Z: posts small blind 2000
drinho2pac: posts big blind 4000
*** HOLE CARDS ***
Pedrozadota: folds 
yaniw777: folds 
LV_Arturs: folds 
fellipeschmeil: folds 
chuchukat: raises 4000 to 8000
lftgjc: folds 
vip_1985Z: folds 
drinho2pac: folds 
Uncalled bet (4000) returned to chuchukat
chuchukat collected 14000 from pot
chuchukat: doesn't show hand 
*** SUMMARY ***
Total pot 14000 | Rake 0 
Seat 1: yaniw777 folded before Flop (didn't bet)
Seat 2: LV_Arturs folded before Flop (didn't bet)
Seat 3: fellipeschmeil folded before Flop (didn't bet)
Seat 4: chuchukat collected (14000)
Seat 5: lftgjc (button) folded before Flop (didn't bet)
Seat 6: vip_1985Z (small blind) folded before Flop
Seat 7: drinho2pac (big blind) folded before Flop
Seat 8: Pedrozadota folded before Flop (didn't bet)

PokerStars Hand #251206852851: Tournament #3767885527, $40+$10+$5 USD Hold'em No Limit - Level XVIII (2000/4000) - 2024/06/26 20:23:35 UTC [2024/06/26 16:23:35 ET]
Table '3767885527 57' 8-max Seat #6 is the button
Seat 1: yaniw777 (130392 in chips) 
Seat 2: LV_Arturs (94977 in chips) 
Seat 3: fellipeschmeil (33733 in chips) 
Seat 4: chuchukat (299049 in chips) 
Seat 5: lftgjc (148754 in chips) 
Seat 6: vip_1985Z (27134 in chips) 
Seat 7: drinho2pac (73396 in chips) 
Seat 8: Pedrozadota (103384 in chips) 
yaniw777: posts the ante 500
LV_Arturs: posts the ante 500
fellipeschmeil: posts the ante 500
chuchukat: posts the ante 500
lftgjc: posts the ante 500
vip_1985Z: posts the ante 500
drinho2pac: posts the ante 500
Pedrozadota: posts the ante 500
drinho2pac: posts small blind 2000
Pedrozadota: posts big blind 4000
*** HOLE CARDS ***
yaniw777: raises 4400 to 8400
LV_Arturs: folds 
fellipeschmeil: folds 
chuchukat: folds 
lftgjc: folds 
vip_1985Z: folds 
drinho2pac: folds 
Pedrozadota: folds 
Uncalled bet (4400) returned to yaniw777
yaniw777 collected 14000 from pot
yaniw777: doesn't show hand 
*** SUMMARY ***
Total pot 14000 | Rake 0 
Seat 1: yaniw777 collected (14000)
Seat 2: LV_Arturs folded before Flop (didn't bet)
Seat 3: fellipeschmeil folded before Flop (didn't bet)
Seat 4: chuchukat folded before Flop (didn't bet)
Seat 5: lftgjc folded before Flop (didn't bet)
Seat 6: vip_1985Z (button) folded before Flop (didn't bet)
Seat 7: drinho2pac (small blind) folded before Flop
Seat 8: Pedrozadota (big blind) folded before Flop

PokerStars Hand #251206867419: Tournament #3767885527, $40+$10+$5 USD Hold'em No Limit - Level XVIII (2000/4000) - 2024/06/26 20:24:27 UTC [2024/06/26 16:24:27 ET]
Table '3767885527 57' 8-max Seat #7 is the button
Seat 1: yaniw777 (139892 in chips) 
Seat 2: LV_Arturs (94477 in chips) 
Seat 3: fellipeschmeil (33233 in chips) 
Seat 4: chuchukat (298549 in chips) 
Seat 5: lftgjc (148254 in chips) 
Seat 6: vip_1985Z (26634 in chips) 
Seat 7: drinho2pac (70896 in chips) 
Seat 8: Pedrozadota (98884 in chips) 
yaniw777: posts the ante 500
LV_Arturs: posts the ante 500
fellipeschmeil: posts the ante 500
chuchukat: posts the ante 500
lftgjc: posts the ante 500
vip_1985Z: posts the ante 500
drinho2pac: posts the ante 500
Pedrozadota: posts the ante 500
Pedrozadota: posts small blind 2000
yaniw777: posts big blind 4000
*** HOLE CARDS ***
LV_Arturs: folds 
fellipeschmeil: folds 
chuchukat: folds 
lftgjc: folds 
vip_1985Z: folds 
drinho2pac: folds 
Pedrozadota has timed out
Pedrozadota: folds 
Pedrozadota is sitting out
Uncalled bet (2000) returned to yaniw777
yaniw777 collected 8000 from pot
yaniw777: doesn't show hand 
Pedrozadota has returned
*** SUMMARY ***
Total pot 8000 | Rake 0 
Seat 1: yaniw777 (big blind) collected (8000)
Seat 2: LV_Arturs folded before Flop (didn't bet)
Seat 3: fellipeschmeil folded before Flop (didn't bet)
Seat 4: chuchukat folded before Flop (didn't bet)
Seat 5: lftgjc folded before Flop (didn't bet)
Seat 6: vip_1985Z folded before Flop (didn't bet)
Seat 7: drinho2pac (button) folded before Flop (didn't bet)
Seat 8: Pedrozadota (small blind) folded before Flop

PokerStars Hand #251206880994: Tournament #3767885527, $40+$10+$5 USD Hold'em No Limit - Level XVIII (2000/4000) - 2024/06/26 20:25:15 UTC [2024/06/26 16:25:15 ET]
Table '3767885527 57' 8-max Seat #8 is the button
Seat 1: yaniw777 (145392 in chips) 
Seat 2: LV_Arturs (93977 in chips) 
Seat 3: fellipeschmeil (32733 in chips) 
Seat 4: chuchukat (298049 in chips) 
Seat 5: lftgjc (147754 in chips) 
Seat 6: vip_1985Z (26134 in chips) 
Seat 7: drinho2pac (70396 in chips) 
Seat 8: Pedrozadota (96384 in chips) 
yaniw777: posts the ante 500
LV_Arturs: posts the ante 500
fellipeschmeil: posts the ante 500
chuchukat: posts the ante 500
lftgjc: posts the ante 500
vip_1985Z: posts the ante 500
drinho2pac: posts the ante 500
Pedrozadota: posts the ante 500
yaniw777: posts small blind 2000
LV_Arturs: posts big blind 4000
*** HOLE CARDS ***
fellipeschmeil: folds 
chuchukat: folds 
lftgjc: folds 
vip_1985Z: folds 
drinho2pac: folds 
Pedrozadota: raises 4400 to 8400
yaniw777: folds 
LV_Arturs: raises 85077 to 93477 and is all-in
Pedrozadota: folds 
Uncalled bet (85077) returned to LV_Arturs
LV_Arturs collected 22800 from pot
*** SUMMARY ***
Total pot 22800 | Rake 0 
Seat 1: yaniw777 (small blind) folded before Flop
Seat 2: LV_Arturs (big blind) collected (22800)
Seat 3: fellipeschmeil folded before Flop (didn't bet)
Seat 4: chuchukat folded before Flop (didn't bet)
Seat 5: lftgjc folded before Flop (didn't bet)
Seat 6: vip_1985Z folded before Flop (didn't bet)
Seat 7: drinho2pac folded before Flop (didn't bet)
Seat 8: Pedrozadota (button) folded before Flop

PokerStars Hand #251206897605: Tournament #3767885527, $40+$10+$5 USD Hold'em No Limit - Level XIX (2500/5000) - 2024/06/26 20:26:15 UTC [2024/06/26 16:26:15 ET]
Table '3767885527 57' 8-max Seat #1 is the button
Seat 1: yaniw777 (142892 in chips) 
Seat 2: LV_Arturs (107877 in chips) 
Seat 3: fellipeschmeil (32233 in chips) 
Seat 4: chuchukat (297549 in chips) 
Seat 5: lftgjc (147254 in chips) 
Seat 6: vip_1985Z (25634 in chips) 
Seat 7: drinho2pac (69896 in chips) 
Seat 8: Pedrozadota (87484 in chips) 
yaniw777: posts the ante 625
LV_Arturs: posts the ante 625
fellipeschmeil: posts the ante 625
chuchukat: posts the ante 625
lftgjc: posts the ante 625
vip_1985Z: posts the ante 625
drinho2pac: posts the ante 625
Pedrozadota: posts the ante 625
LV_Arturs: posts small blind 2500
fellipeschmeil: posts big blind 5000
*** HOLE CARDS ***
chuchukat: folds 
lftgjc: folds 
vip_1985Z: raises 20000 to 25000
drinho2pac: folds 
Pedrozadota: folds 
yaniw777: raises 117267 to 142267 and is all-in
LV_Arturs: folds 
fellipeschmeil: folds 
vip_1985Z: calls 9 and is all-in
Uncalled bet (117258) returned to yaniw777
*** FLOP *** [4d Ad Qs]
*** TURN *** [4d Ad Qs] [Ah]
*** RIVER *** [4d Ad Qs Ah] [Tc]
*** SHOW DOWN ***
vip_1985Z: shows [Ks As] (three of a kind, Aces)
yaniw777: shows [6s 6d] (two pair, Aces and Sixes)
vip_1985Z collected 62518 from pot
*** SUMMARY ***
Total pot 62518 | Rake 0 
Board [4d Ad Qs Ah Tc]
Seat 1: yaniw777 (button) showed [6s 6d] and lost with two pair, Aces and Sixes
Seat 2: LV_Arturs (small blind) folded before Flop
Seat 3: fellipeschmeil (big blind) folded before Flop
Seat 4: chuchukat folded before Flop (didn't bet)
Seat 5: lftgjc folded before Flop (didn't bet)
Seat 6: vip_1985Z showed [Ks As] and won (62518) with three of a kind, Aces
Seat 7: drinho2pac folded before Flop (didn't bet)
Seat 8: Pedrozadota folded before Flop (didn't bet)

PokerStars Hand #251206926650: Tournament #3767885527, $40+$10+$5 USD Hold'em No Limit - Level XIX (2500/5000) - 2024/06/26 20:27:59 UTC [2024/06/26 16:27:59 ET]
Table '3767885527 57' 8-max Seat #2 is the button
Seat 1: yaniw777 (117258 in chips) 
Seat 2: LV_Arturs (104752 in chips) 
Seat 3: fellipeschmeil (26608 in chips) 
Seat 4: chuchukat (296924 in chips) 
Seat 5: lftgjc (146629 in chips) 
Seat 6: vip_1985Z (62518 in chips) 
Seat 7: drinho2pac (69271 in chips) 
Seat 8: Pedrozadota (86859 in chips) 
yaniw777: posts the ante 625
LV_Arturs: posts the ante 625
fellipeschmeil: posts the ante 625
chuchukat: posts the ante 625
lftgjc: posts the ante 625
vip_1985Z: posts the ante 625
drinho2pac: posts the ante 625
Pedrozadota: posts the ante 625
fellipeschmeil: posts small blind 2500
chuchukat: posts big blind 5000
*** HOLE CARDS ***
lftgjc: folds 
vip_1985Z: folds 
drinho2pac: folds 
Pedrozadota: folds 
yaniw777: raises 5000 to 10000
LV_Arturs: folds 
fellipeschmeil: folds 
chuchukat: raises 30000 to 40000
yaniw777: folds 
Uncalled bet (30000) returned to chuchukat
chuchukat collected 27500 from pot
chuchukat: doesn't show hand 
*** SUMMARY ***
Total pot 27500 | Rake 0 
Seat 1: yaniw777 folded before Flop
Seat 2: LV_Arturs (button) folded before Flop (didn't bet)
Seat 3: fellipeschmeil (small blind) folded before Flop
Seat 4: chuchukat (big blind) collected (27500)
Seat 5: lftgjc folded before Flop (didn't bet)
Seat 6: vip_1985Z folded before Flop (didn't bet)
Seat 7: drinho2pac folded before Flop (didn't bet)
Seat 8: Pedrozadota folded before Flop (didn't bet)

PokerStars Hand #251206948693: Tournament #3767885527, $40+$10+$5 USD Hold'em No Limit - Level XIX (2500/5000) - 2024/06/26 20:29:19 UTC [2024/06/26 16:29:19 ET]
Table '3767885527 57' 8-max Seat #3 is the button
Seat 1: yaniw777 (106633 in chips) 
Seat 2: LV_Arturs (104127 in chips) 
Seat 3: fellipeschmeil (23483 in chips) 
Seat 4: chuchukat (313799 in chips) 
Seat 5: lftgjc (146004 in chips) 
Seat 6: vip_1985Z (61893 in chips) 
Seat 7: drinho2pac (68646 in chips) 
Seat 8: Pedrozadota (86234 in chips) 
yaniw777: posts the ante 625
LV_Arturs: posts the ante 625
fellipeschmeil: posts the ante 625
chuchukat: posts the ante 625
lftgjc: posts the ante 625
vip_1985Z: posts the ante 625
drinho2pac: posts the ante 625
Pedrozadota: posts the ante 625
chuchukat: posts small blind 2500
lftgjc: posts big blind 5000
*** HOLE CARDS ***
vip_1985Z: folds 
drinho2pac: folds 
Pedrozadota: folds 
yaniw777: folds 
LV_Arturs: raises 5250 to 10250
fellipeschmeil: folds 
chuchukat: folds 
lftgjc: calls 5250
*** FLOP *** [Jd 2c 8s]
lftgjc: checks 
LV_Arturs: bets 9000
lftgjc: folds 
Uncalled bet (9000) returned to LV_Arturs
LV_Arturs collected 28000 from pot
*** SUMMARY ***
Total pot 28000 | Rake 0 
Board [Jd 2c 8s]
Seat 1: yaniw777 folded before Flop (didn't bet)
Seat 2: LV_Arturs collected (28000)
Seat 3: fellipeschmeil (button) folded before Flop (didn't bet)
Seat 4: chuchukat (small blind) folded before Flop
Seat 5: lftgjc (big blind) folded on the Flop
Seat 6: vip_1985Z folded before Flop (didn't bet)
Seat 7: drinho2pac folded before Flop (didn't bet)
Seat 8: Pedrozadota folded before Flop (didn't bet)

PokerStars Hand #251206974963: Tournament #3767885527, $40+$10+$5 USD Hold'em No Limit - Level XIX (2500/5000) - 2024/06/26 20:30:54 UTC [2024/06/26 16:30:54 ET]
Table '3767885527 57' 8-max Seat #4 is the button
Seat 1: yaniw777 (106008 in chips) 
Seat 2: LV_Arturs (121252 in chips) 
Seat 3: fellipeschmeil (22858 in chips) 
Seat 4: chuchukat (310674 in chips) 
Seat 5: lftgjc (135129 in chips) 
Seat 6: vip_1985Z (61268 in chips) 
Seat 7: drinho2pac (68021 in chips) 
Seat 8: Pedrozadota (85609 in chips) 
yaniw777: posts the ante 625
LV_Arturs: posts the ante 625
fellipeschmeil: posts the ante 625
chuchukat: posts the ante 625
lftgjc: posts the ante 625
vip_1985Z: posts the ante 625
drinho2pac: posts the ante 625
Pedrozadota: posts the ante 625
lftgjc: posts small blind 2500
vip_1985Z: posts big blind 5000
*** HOLE CARDS ***
drinho2pac: folds 
Pedrozadota: raises 45000 to 50000
yaniw777: folds 
LV_Arturs: folds 
fellipeschmeil: folds 
chuchukat: folds 
lftgjc: folds 
vip_1985Z: folds 
Uncalled bet (45000) returned to Pedrozadota
Pedrozadota collected 17500 from pot
Pedrozadota: doesn't show hand 
*** SUMMARY ***
Total pot 17500 | Rake 0 
Seat 1: yaniw777 folded before Flop (didn't bet)
Seat 2: LV_Arturs folded before Flop (didn't bet)
Seat 3: fellipeschmeil folded before Flop (didn't bet)
Seat 4: chuchukat (button) folded before Flop (didn't bet)
Seat 5: lftgjc (small blind) folded before Flop
Seat 6: vip_1985Z (big blind) folded before Flop
Seat 7: drinho2pac folded before Flop (didn't bet)
Seat 8: Pedrozadota collected (17500)

PokerStars Hand #251206984965: Tournament #3767885527, $40+$10+$5 USD Hold'em No Limit - Level XIX (2500/5000) - 2024/06/26 20:31:30 UTC [2024/06/26 16:31:30 ET]
Table '3767885527 57' 8-max Seat #5 is the button
Seat 1: yaniw777 (105383 in chips) 
Seat 2: LV_Arturs (120627 in chips) 
Seat 3: fellipeschmeil (22233 in chips) 
Seat 4: chuchukat (310049 in chips) 
Seat 5: lftgjc (132004 in chips) 
Seat 6: vip_1985Z (55643 in chips) 
Seat 7: drinho2pac (67396 in chips) 
Seat 8: Pedrozadota (97484 in chips) 
yaniw777: posts the ante 625
LV_Arturs: posts the ante 625
fellipeschmeil: posts the ante 625
chuchukat: posts the ante 625
lftgjc: posts the ante 625
vip_1985Z: posts the ante 625
drinho2pac: posts the ante 625
Pedrozadota: posts the ante 625
vip_1985Z: posts small blind 2500
drinho2pac: posts big blind 5000
*** HOLE CARDS ***
Pedrozadota: folds 
yaniw777: folds 
LV_Arturs: folds 
fellipeschmeil: folds 
chuchukat: raises 304424 to 309424 and is all-in
lftgjc: folds 
vip_1985Z: folds 
drinho2pac: folds 
Uncalled bet (304424) returned to chuchukat
chuchukat collected 17500 from pot
chuchukat: doesn't show hand 
*** SUMMARY ***
Total pot 17500 | Rake 0 
Seat 1: yaniw777 folded before Flop (didn't bet)
Seat 2: LV_Arturs folded before Flop (didn't bet)
Seat 3: fellipeschmeil folded before Flop (didn't bet)
Seat 4: chuchukat collected (17500)
Seat 5: lftgjc (button) folded before Flop (didn't bet)
Seat 6: vip_1985Z (small blind) folded before Flop
Seat 7: drinho2pac (big blind) folded before Flop
Seat 8: Pedrozadota folded before Flop (didn't bet)

PokerStars Hand #251206999112: Tournament #3767885527, $40+$10+$5 USD Hold'em No Limit - Level XIX (2500/5000) - 2024/06/26 20:32:20 UTC [2024/06/26 16:32:20 ET]
Table '3767885527 57' 8-max Seat #6 is the button
Seat 1: yaniw777 (104758 in chips) 
Seat 2: LV_Arturs (120002 in chips) 
Seat 3: fellipeschmeil (21608 in chips) 
Seat 4: chuchukat (321924 in chips) 
Seat 5: lftgjc (131379 in chips) 
Seat 6: vip_1985Z (52518 in chips) 
Seat 7: drinho2pac (61771 in chips) 
Seat 8: Pedrozadota (96859 in chips) 
yaniw777: posts the ante 625
LV_Arturs: posts the ante 625
fellipeschmeil: posts the ante 625
chuchukat: posts the ante 625
lftgjc: posts the ante 625
vip_1985Z: posts the ante 625
drinho2pac: posts the ante 625
Pedrozadota: posts the ante 625
drinho2pac: posts small blind 2500
Pedrozadota: posts big blind 5000
*** HOLE CARDS ***
yaniw777: raises 5000 to 10000
LV_Arturs: folds 
fellipeschmeil: folds 
chuchukat: folds 
lftgjc: raises 15000 to 25000
vip_1985Z: folds 
drinho2pac: folds 
Pedrozadota: folds 
yaniw777: raises 79133 to 104133 and is all-in
lftgjc: calls 79133
*** FLOP *** [3d Qc 9h]
*** TURN *** [3d Qc 9h] [4s]
*** RIVER *** [3d Qc 9h 4s] [3c]
*** SHOW DOWN ***
yaniw777: shows [Kc Ks] (two pair, Kings and Threes)
lftgjc: shows [Ah As] (two pair, Aces and Threes)
lftgjc collected 220766 from pot
*** SUMMARY ***
Total pot 220766 | Rake 0 
Board [3d Qc 9h 4s 3c]
Seat 1: yaniw777 showed [Kc Ks] and lost with two pair, Kings and Threes
Seat 2: LV_Arturs folded before Flop (didn't bet)
Seat 3: fellipeschmeil folded before Flop (didn't bet)
Seat 4: chuchukat folded before Flop (didn't bet)
Seat 5: lftgjc showed [Ah As] and won (220766) with two pair, Aces and Threes
Seat 6: vip_1985Z (button) folded before Flop (didn't bet)
Seat 7: drinho2pac (small blind) folded before Flop
Seat 8: Pedrozadota (big blind) folded before Flop

PokerStars Hand #251207031976: Tournament #3767885527, $40+$10+$5 USD Hold'em No Limit - Level XIX (2500/5000) - 2024/06/26 20:34:17 UTC [2024/06/26 16:34:17 ET]
Table '3767885527 57' 8-max Seat #7 is the button
Seat 2: LV_Arturs (119377 in chips) 
Seat 3: fellipeschmeil (20983 in chips) 
Seat 4: chuchukat (321299 in chips) 
Seat 5: lftgjc (247387 in chips) 
Seat 6: vip_1985Z (51893 in chips) 
Seat 7: drinho2pac (58646 in chips) 
Seat 8: Pedrozadota (91234 in chips) 
LV_Arturs: posts the ante 625
fellipeschmeil: posts the ante 625
chuchukat: posts the ante 625
lftgjc: posts the ante 625
vip_1985Z: posts the ante 625
drinho2pac: posts the ante 625
Pedrozadota: posts the ante 625
Pedrozadota: posts small blind 2500
LV_Arturs: posts big blind 5000
*** HOLE CARDS ***
fellipeschmeil: raises 15000 to 20000
chuchukat: calls 20000
lftgjc: folds 
vip_1985Z: folds 
drinho2pac: raises 38021 to 58021 and is all-in
Pedrozadota: folds 
LV_Arturs: folds 
fellipeschmeil: calls 358 and is all-in
chuchukat: calls 38021
*** FLOP *** [Ts 2c Ad]
*** TURN *** [Ts 2c Ad] [7h]
*** RIVER *** [Ts 2c Ad 7h] [Ac]
*** SHOW DOWN ***
chuchukat: shows [Ah Jh] (three of a kind, Aces)
drinho2pac: shows [5d 5h] (two pair, Aces and Fives)
Naaarrrr is disconnected 
chuchukat collected 75326 from side pot
fellipeschmeil: shows [Qs As] (three of a kind, Aces - Queen kicker)
fellipeschmeil collected 72949 from main pot
drinho2pac finished the tournament in 295th place and received $104.64.
*** SUMMARY ***
Total pot 148275 Main pot 72949. Side pot 75326. | Rake 0 
Board [Ts 2c Ad 7h Ac]
Seat 2: LV_Arturs (big blind) folded before Flop
Seat 3: fellipeschmeil showed [Qs As] and won (72949) with three of a kind, Aces
Seat 4: chuchukat showed [Ah Jh] and won (75326) with three of a kind, Aces
Seat 5: lftgjc folded before Flop (didn't bet)
Seat 6: vip_1985Z folded before Flop (didn't bet)
Seat 7: drinho2pac (button) showed [5d 5h] and lost with two pair, Aces and Fives
Seat 8: Pedrozadota (small blind) folded before Flop

PokerStars Hand #251207050594: Tournament #3767885527, $40+$10+$5 USD Hold'em No Limit - Level XIX (2500/5000) - 2024/06/26 20:35:22 UTC [2024/06/26 16:35:22 ET]
Table '3767885527 57' 8-max Seat #8 is the button
Seat 1: Naaarrrr (227788 in chips) out of hand (moved from another table into small blind)
Seat 2: LV_Arturs (113752 in chips) 
Seat 3: fellipeschmeil (72949 in chips) 
Seat 4: chuchukat (337979 in chips) 
Seat 5: lftgjc (246762 in chips) 
Seat 6: vip_1985Z (51268 in chips) 
Seat 8: Pedrozadota (88109 in chips) 
Naaarrrr will be allowed to play after the button
LV_Arturs: posts the ante 625
fellipeschmeil: posts the ante 625
chuchukat: posts the ante 625
lftgjc: posts the ante 625
vip_1985Z: posts the ante 625
Pedrozadota: posts the ante 625
LV_Arturs: posts small blind 2500
fellipeschmeil: posts big blind 5000
*** HOLE CARDS ***
chuchukat: folds 
lftgjc: raises 5000 to 10000
vip_1985Z: folds 
Pedrozadota: folds 
LV_Arturs: raises 103127 to 113127 and is all-in
fellipeschmeil: folds 
gomsipjorn is disconnected 
lftgjc: folds 
Uncalled bet (103127) returned to LV_Arturs
LV_Arturs collected 28750 from pot
*** SUMMARY ***
Total pot 28750 | Rake 0 
Seat 2: LV_Arturs (small blind) collected (28750)
Seat 3: fellipeschmeil (big blind) folded before Flop
Seat 4: chuchukat folded before Flop (didn't bet)
Seat 5: lftgjc folded before Flop
Seat 6: vip_1985Z folded before Flop (didn't bet)
Seat 8: Pedrozadota (button) folded before Flop (didn't bet)

PokerStars Hand #251207061607: Tournament #3767885527, $40+$10+$5 USD Hold'em No Limit - Level XX (3000/6000) - 2024/06/26 20:36:01 UTC [2024/06/26 16:36:01 ET]
Table '3767885527 57' 8-max Seat #2 is the button
Seat 1: Naaarrrr (227788 in chips) 
Seat 2: LV_Arturs (131877 in chips) 
Seat 3: fellipeschmeil (67324 in chips) 
Seat 4: chuchukat (337354 in chips) 
Seat 5: lftgjc (236137 in chips) 
Seat 6: vip_1985Z (50643 in chips) 
Seat 7: gomsipjorn (229711 in chips) 
Seat 8: Pedrozadota (87484 in chips) 
Naaarrrr: posts the ante 750
LV_Arturs: posts the ante 750
fellipeschmeil: posts the ante 750
chuchukat: posts the ante 750
lftgjc: posts the ante 750
vip_1985Z: posts the ante 750
gomsipjorn: posts the ante 750
Pedrozadota: posts the ante 750
fellipeschmeil: posts small blind 3000
chuchukat: posts big blind 6000
*** HOLE CARDS ***
lftgjc: folds 
vip_1985Z: folds 
gomsipjorn: raises 7200 to 13200
Pedrozadota: folds 
Naaarrrr: folds 
LV_Arturs: folds 
fellipeschmeil: folds 
chuchukat: raises 37800 to 51000
gomsipjorn: folds 
Uncalled bet (37800) returned to chuchukat
chuchukat collected 35400 from pot
chuchukat: doesn't show hand 
*** SUMMARY ***
Total pot 35400 | Rake 0 
Seat 1: Naaarrrr folded before Flop (didn't bet)
Seat 2: LV_Arturs (button) folded before Flop (didn't bet)
Seat 3: fellipeschmeil (small blind) folded before Flop
Seat 4: chuchukat (big blind) collected (35400)
Seat 5: lftgjc folded before Flop (didn't bet)
Seat 6: vip_1985Z folded before Flop (didn't bet)
Seat 7: gomsipjorn folded before Flop
Seat 8: Pedrozadota folded before Flop (didn't bet)

PokerStars Hand #251207073081: Tournament #3767885527, $40+$10+$5 USD Hold'em No Limit - Level XX (3000/6000) - 2024/06/26 20:36:42 UTC [2024/06/26 16:36:42 ET]
Table '3767885527 57' 8-max Seat #3 is the button
Seat 1: Naaarrrr (227038 in chips) 
Seat 2: LV_Arturs (131127 in chips) 
Seat 3: fellipeschmeil (63574 in chips) 
Seat 4: chuchukat (358804 in chips) 
Seat 5: lftgjc (235387 in chips) 
Seat 6: vip_1985Z (49893 in chips) 
Seat 7: gomsipjorn (215761 in chips) 
Seat 8: Pedrozadota (86734 in chips) 
Naaarrrr: posts the ante 750
LV_Arturs: posts the ante 750
fellipeschmeil: posts the ante 750
chuchukat: posts the ante 750
lftgjc: posts the ante 750
vip_1985Z: posts the ante 750
gomsipjorn: posts the ante 750
Pedrozadota: posts the ante 750
chuchukat: posts small blind 3000
lftgjc: posts big blind 6000
*** HOLE CARDS ***
vip_1985Z: folds 
gomsipjorn: folds 
Pedrozadota: folds 
Naaarrrr: folds 
LV_Arturs: folds 
fellipeschmeil: folds 
chuchukat: raises 15000 to 21000
lftgjc: raises 33000 to 54000
chuchukat: folds 
Uncalled bet (33000) returned to lftgjc
lftgjc collected 48000 from pot
lftgjc: doesn't show hand 
*** SUMMARY ***
Total pot 48000 | Rake 0 
Seat 1: Naaarrrr folded before Flop (didn't bet)
Seat 2: LV_Arturs folded before Flop (didn't bet)
Seat 3: fellipeschmeil (button) folded before Flop (didn't bet)
Seat 4: chuchukat (small blind) folded before Flop
Seat 5: lftgjc (big blind) collected (48000)
Seat 6: vip_1985Z folded before Flop (didn't bet)
Seat 7: gomsipjorn folded before Flop (didn't bet)
Seat 8: Pedrozadota folded before Flop (didn't bet)

PokerStars Hand #251207083107: Tournament #3767885527, $40+$10+$5 USD Hold'em No Limit - Level XX (3000/6000) - 2024/06/26 20:37:17 UTC [2024/06/26 16:37:17 ET]
Table '3767885527 57' 8-max Seat #4 is the button
Seat 1: Naaarrrr (226288 in chips) 
Seat 2: LV_Arturs (130377 in chips) 
Seat 3: fellipeschmeil (62824 in chips) 
Seat 4: chuchukat (337054 in chips) 
Seat 5: lftgjc (261637 in chips) 
Seat 6: vip_1985Z (49143 in chips) 
Seat 7: gomsipjorn (215011 in chips) 
Seat 8: Pedrozadota (85984 in chips) 
Naaarrrr: posts the ante 750
LV_Arturs: posts the ante 750
fellipeschmeil: posts the ante 750
chuchukat: posts the ante 750
lftgjc: posts the ante 750
vip_1985Z: posts the ante 750
gomsipjorn: posts the ante 750
Pedrozadota: posts the ante 750
lftgjc: posts small blind 3000
vip_1985Z: posts big blind 6000
*** HOLE CARDS ***
gomsipjorn: raises 6000 to 12000
Pedrozadota: folds 
Naaarrrr: folds 
LV_Arturs: folds 
fellipeschmeil: folds 
chuchukat: calls 12000
lftgjc: folds 
vip_1985Z: calls 6000
*** FLOP *** [5h Ts 2d]
vip_1985Z: bets 36393 and is all-in
gomsipjorn: folds 
chuchukat: folds 
Uncalled bet (36393) returned to vip_1985Z
vip_1985Z collected 45000 from pot
vip_1985Z: doesn't show hand 
*** SUMMARY ***
Total pot 45000 | Rake 0 
Board [5h Ts 2d]
Seat 1: Naaarrrr folded before Flop (didn't bet)
Seat 2: LV_Arturs folded before Flop (didn't bet)
Seat 3: fellipeschmeil folded before Flop (didn't bet)
Seat 4: chuchukat (button) folded on the Flop
Seat 5: lftgjc (small blind) folded before Flop
Seat 6: vip_1985Z (big blind) collected (45000)
Seat 7: gomsipjorn folded on the Flop
Seat 8: Pedrozadota folded before Flop (didn't bet)

PokerStars Hand #251207097684: Tournament #3767885527, $40+$10+$5 USD Hold'em No Limit - Level XX (3000/6000) - 2024/06/26 20:38:08 UTC [2024/06/26 16:38:08 ET]
Table '3767885527 57' 8-max Seat #5 is the button
Seat 1: Naaarrrr (225538 in chips) 
Seat 2: LV_Arturs (129627 in chips) 
Seat 3: fellipeschmeil (62074 in chips) 
Seat 4: chuchukat (324304 in chips) 
Seat 5: lftgjc (257887 in chips) 
Seat 6: vip_1985Z (81393 in chips) 
Seat 7: gomsipjorn (202261 in chips) 
Seat 8: Pedrozadota (85234 in chips) 
Naaarrrr: posts the ante 750
LV_Arturs: posts the ante 750
fellipeschmeil: posts the ante 750
chuchukat: posts the ante 750
lftgjc: posts the ante 750
vip_1985Z: posts the ante 750
gomsipjorn: posts the ante 750
Pedrozadota: posts the ante 750
vip_1985Z: posts small blind 3000
gomsipjorn: posts big blind 6000
*** HOLE CARDS ***
Pedrozadota: folds 
Naaarrrr: folds 
LV_Arturs: folds 
fellipeschmeil: folds 
chuchukat: raises 6000 to 12000
lftgjc: folds 
vip_1985Z: folds 
gomsipjorn: folds 
Uncalled bet (6000) returned to chuchukat
chuchukat collected 21000 from pot
chuchukat: doesn't show hand 
*** SUMMARY ***
Total pot 21000 | Rake 0 
Seat 1: Naaarrrr folded before Flop (didn't bet)
Seat 2: LV_Arturs folded before Flop (didn't bet)
Seat 3: fellipeschmeil folded before Flop (didn't bet)
Seat 4: chuchukat collected (21000)
Seat 5: lftgjc (button) folded before Flop (didn't bet)
Seat 6: vip_1985Z (small blind) folded before Flop
Seat 7: gomsipjorn (big blind) folded before Flop
Seat 8: Pedrozadota folded before Flop (didn't bet)

PokerStars Hand #251207104273: Tournament #3767885527, $40+$10+$5 USD Hold'em No Limit - Level XX (3000/6000) - 2024/06/26 20:38:32 UTC [2024/06/26 16:38:32 ET]
Table '3767885527 57' 8-max Seat #6 is the button
Seat 1: Naaarrrr (224788 in chips) 
Seat 2: LV_Arturs (128877 in chips) 
Seat 3: fellipeschmeil (61324 in chips) 
Seat 4: chuchukat (338554 in chips) 
Seat 5: lftgjc (257137 in chips) 
Seat 6: vip_1985Z (77643 in chips) 
Seat 7: gomsipjorn (195511 in chips) 
Seat 8: Pedrozadota (84484 in chips) 
Naaarrrr: posts the ante 750
LV_Arturs: posts the ante 750
fellipeschmeil: posts the ante 750
chuchukat: posts the ante 750
lftgjc: posts the ante 750
vip_1985Z: posts the ante 750
gomsipjorn: posts the ante 750
Pedrozadota: posts the ante 750
gomsipjorn: posts small blind 3000
Pedrozadota: posts big blind 6000
*** HOLE CARDS ***
Naaarrrr: folds 
LV_Arturs: folds 
fellipeschmeil: folds 
chuchukat: folds 
lftgjc: folds 
vip_1985Z: folds 
gomsipjorn: calls 3000
Pedrozadota: checks 
*** FLOP *** [4c 7h Qc]
gomsipjorn: checks 
Pedrozadota: bets 6000
gomsipjorn: folds 
Uncalled bet (6000) returned to Pedrozadota
Pedrozadota collected 18000 from pot
Pedrozadota: doesn't show hand 
*** SUMMARY ***
Total pot 18000 | Rake 0 
Board [4c 7h Qc]
Seat 1: Naaarrrr folded before Flop (didn't bet)
Seat 2: LV_Arturs folded before Flop (didn't bet)
Seat 3: fellipeschmeil folded before Flop (didn't bet)
Seat 4: chuchukat folded before Flop (didn't bet)
Seat 5: lftgjc folded before Flop (didn't bet)
Seat 6: vip_1985Z (button) folded before Flop (didn't bet)
Seat 7: gomsipjorn (small blind) folded on the Flop
Seat 8: Pedrozadota (big blind) collected (18000)

PokerStars Hand #251207116119: Tournament #3767885527, $40+$10+$5 USD Hold'em No Limit - Level XX (3000/6000) - 2024/06/26 20:39:14 UTC [2024/06/26 16:39:14 ET]
Table '3767885527 57' 8-max Seat #7 is the button
Seat 1: Naaarrrr (224038 in chips) 
Seat 2: LV_Arturs (128127 in chips) 
Seat 3: fellipeschmeil (60574 in chips) 
Seat 4: chuchukat (337804 in chips) 
Seat 5: lftgjc (256387 in chips) 
Seat 6: vip_1985Z (76893 in chips) 
Seat 7: gomsipjorn (188761 in chips) 
Seat 8: Pedrozadota (95734 in chips) 
Naaarrrr: posts the ante 750
LV_Arturs: posts the ante 750
fellipeschmeil: posts the ante 750
chuchukat: posts the ante 750
lftgjc: posts the ante 750
vip_1985Z: posts the ante 750
gomsipjorn: posts the ante 750
Pedrozadota: posts the ante 750
Pedrozadota: posts small blind 3000
Naaarrrr: posts big blind 6000
*** HOLE CARDS ***
LV_Arturs: folds 
fellipeschmeil: folds 
chuchukat: folds 
lftgjc: folds 
vip_1985Z: folds 
gomsipjorn: folds 
Pedrozadota: raises 88984 to 94984 and is all-in
Naaarrrr: calls 88984
*** FLOP *** [Qh 4h 5s]
*** TURN *** [Qh 4h 5s] [Kc]
*** RIVER *** [Qh 4h 5s Kc] [Qd]
*** SHOW DOWN ***
Pedrozadota: shows [Jc 9c] (a pair of Queens)
Naaarrrr: shows [Ah Tc] (a pair of Queens - Ace kicker)
Naaarrrr collected 195968 from pot
Pedrozadota finished the tournament in 253rd place and received $104.64.
*** SUMMARY ***
Total pot 195968 | Rake 0 
Board [Qh 4h 5s Kc Qd]
Seat 1: Naaarrrr (big blind) showed [Ah Tc] and won (195968) with a pair of Queens
Seat 2: LV_Arturs folded before Flop (didn't bet)
Seat 3: fellipeschmeil folded before Flop (didn't bet)
Seat 4: chuchukat folded before Flop (didn't bet)
Seat 5: lftgjc folded before Flop (didn't bet)
Seat 6: vip_1985Z folded before Flop (didn't bet)
Seat 7: gomsipjorn (button) folded before Flop (didn't bet)
Seat 8: Pedrozadota (small blind) showed [Jc 9c] and lost with a pair of Queens

PokerStars Hand #251207124024: Tournament #3767885527, $40+$10+$5 USD Hold'em No Limit - Level XX (3000/6000) - 2024/06/26 20:39:42 UTC [2024/06/26 16:39:42 ET]
Table '3767885527 57' 8-max Seat #1 is the button
Seat 1: Naaarrrr (324272 in chips) 
Seat 2: LV_Arturs (127377 in chips) 
Seat 3: fellipeschmeil (59824 in chips) 
Seat 4: chuchukat (337054 in chips) 
Seat 5: lftgjc (255637 in chips) 
Seat 6: vip_1985Z (76143 in chips) 
Seat 7: gomsipjorn (188011 in chips) 
Naaarrrr: posts the ante 750
LV_Arturs: posts the ante 750
fellipeschmeil: posts the ante 750
chuchukat: posts the ante 750
lftgjc: posts the ante 750
vip_1985Z: posts the ante 750
gomsipjorn: posts the ante 750
LV_Arturs: posts small blind 3000
fellipeschmeil: posts big blind 6000
*** HOLE CARDS ***
chuchukat: folds 
lftgjc: folds 
vip_1985Z: folds 
gomsipjorn: folds 
Naaarrrr: raises 6000 to 12000
LV_Arturs: folds 
fellipeschmeil: calls 6000
*** FLOP *** [4c Ts 3d]
fellipeschmeil: checks 
Naaarrrr: bets 6000
fellipeschmeil: raises 41074 to 47074 and is all-in
Naaarrrr: calls 41074
*** TURN *** [4c Ts 3d] [5s]
*** RIVER *** [4c Ts 3d 5s] [8h]
*** SHOW DOWN ***
fellipeschmeil: shows [5d 6h] (a pair of Fives)
Naaarrrr: shows [Tc Jc] (a pair of Tens)
Naaarrrr collected 126398 from pot
fellipeschmeil finished the tournament in 249th place and received $104.64.
*** SUMMARY ***
Total pot 126398 | Rake 0 
Board [4c Ts 3d 5s 8h]
Seat 1: Naaarrrr (button) showed [Tc Jc] and won (126398) with a pair of Tens
Seat 2: LV_Arturs (small blind) folded before Flop
Seat 3: fellipeschmeil (big blind) showed [5d 6h] and lost with a pair of Fives
Seat 4: chuchukat folded before Flop (didn't bet)
Seat 5: lftgjc folded before Flop (didn't bet)
Seat 6: vip_1985Z folded before Flop (didn't bet)
Seat 7: gomsipjorn folded before Flop (didn't bet)


PokerStars Hand #251205060848: Tournament #3767885527, $40+$10+$5 USD Hold'em No Limit - Level VIII (350/700) - 2024/06/26 18:30:34 UTC [2024/06/26 14:30:34 ET]
Table '3767885527 37' 8-max Seat #7 is the button
Seat 1: Katwoman0106 (25000 in chips) 
Seat 2: fAArid88 (15471 in chips) 
Seat 3: Sully1993_11 (20248 in chips) 
Seat 4: nahumdj (36537 in chips) 
Seat 5: johnyguedes1 (71457 in chips) 
Seat 6: yuzoyai (10651 in chips) 
Seat 7: junior_re612 (44625 in chips) 
Seat 8: epo9 (33020 in chips) 
Katwoman0106: posts the ante 90
fAArid88: posts the ante 90
Sully1993_11: posts the ante 90
nahumdj: posts the ante 90
johnyguedes1: posts the ante 90
yuzoyai: posts the ante 90
junior_re612: posts the ante 90
epo9: posts the ante 90
epo9: posts small blind 350
Katwoman0106: posts big blind 700
*** HOLE CARDS ***
fAArid88: folds 
Sully1993_11: calls 700
nahumdj: folds 
johnyguedes1: folds 
yuzoyai: folds 
junior_re612: raises 1750 to 2450
epo9: folds 
Katwoman0106: calls 1750
Sully1993_11: calls 1750
*** FLOP *** [3c 5c Ks]
Katwoman0106: checks 
Sully1993_11: checks 
junior_re612: bets 2772
Katwoman0106: folds 
Sully1993_11: folds 
Uncalled bet (2772) returned to junior_re612
junior_re612 collected 8420 from pot
junior_re612: doesn't show hand 
*** SUMMARY ***
Total pot 8420 | Rake 0 
Board [3c 5c Ks]
Seat 1: Katwoman0106 (big blind) folded on the Flop
Seat 2: fAArid88 folded before Flop (didn't bet)
Seat 3: Sully1993_11 folded on the Flop
Seat 4: nahumdj folded before Flop (didn't bet)
Seat 5: johnyguedes1 folded before Flop (didn't bet)
Seat 6: yuzoyai folded before Flop (didn't bet)
Seat 7: junior_re612 (button) collected (8420)
Seat 8: epo9 (small blind) folded before Flop

PokerStars Hand #251205079554: Tournament #3767885527, $40+$10+$5 USD Hold'em No Limit - Level VIII (350/700) - 2024/06/26 18:31:47 UTC [2024/06/26 14:31:47 ET]
Table '3767885527 37' 8-max Seat #8 is the button
Seat 1: Katwoman0106 (22460 in chips) 
Seat 2: fAArid88 (15381 in chips) 
Seat 3: Sully1993_11 (17708 in chips) 
Seat 4: nahumdj (36447 in chips) 
Seat 5: johnyguedes1 (71367 in chips) 
Seat 6: yuzoyai (10561 in chips) 
Seat 7: junior_re612 (50505 in chips) 
Seat 8: epo9 (32580 in chips) 
Katwoman0106: posts the ante 90
fAArid88: posts the ante 90
Sully1993_11: posts the ante 90
nahumdj: posts the ante 90
johnyguedes1: posts the ante 90
yuzoyai: posts the ante 90
junior_re612: posts the ante 90
epo9: posts the ante 90
Katwoman0106: posts small blind 350
fAArid88: posts big blind 700
*** HOLE CARDS ***
Sully1993_11: folds 
nahumdj: folds 
johnyguedes1: folds 
yuzoyai: folds 
junior_re612: raises 700 to 1400
epo9: folds 
Katwoman0106: folds 
fAArid88: folds 
Uncalled bet (700) returned to junior_re612
junior_re612 collected 2470 from pot
junior_re612: doesn't show hand 
*** SUMMARY ***
Total pot 2470 | Rake 0 
Seat 1: Katwoman0106 (small blind) folded before Flop
Seat 2: fAArid88 (big blind) folded before Flop
Seat 3: Sully1993_11 folded before Flop (didn't bet)
Seat 4: nahumdj folded before Flop (didn't bet)
Seat 5: johnyguedes1 folded before Flop (didn't bet)
Seat 6: yuzoyai folded before Flop (didn't bet)
Seat 7: junior_re612 collected (2470)
Seat 8: epo9 (button) folded before Flop (didn't bet)

PokerStars Hand #251205088586: Tournament #3767885527, $40+$10+$5 USD Hold'em No Limit - Level IX (400/800) - 2024/06/26 18:32:23 UTC [2024/06/26 14:32:23 ET]
Table '3767885527 37' 8-max Seat #1 is the button
Seat 1: Katwoman0106 (22020 in chips) 
Seat 2: fAArid88 (14591 in chips) 
Seat 3: Sully1993_11 (17618 in chips) 
Seat 4: nahumdj (36357 in chips) 
Seat 5: johnyguedes1 (71277 in chips) 
Seat 6: yuzoyai (10471 in chips) 
Seat 7: junior_re612 (52185 in chips) 
Seat 8: epo9 (32490 in chips) 
Katwoman0106: posts the ante 100
fAArid88: posts the ante 100
Sully1993_11: posts the ante 100
nahumdj: posts the ante 100
johnyguedes1: posts the ante 100
yuzoyai: posts the ante 100
junior_re612: posts the ante 100
epo9: posts the ante 100
fAArid88: posts small blind 400
Sully1993_11: posts big blind 800
*** HOLE CARDS ***
nahumdj: folds 
johnyguedes1: raises 880 to 1680
yuzoyai: folds 
junior_re612: folds 
epo9: folds 
Katwoman0106: calls 1680
fAArid88: folds 
Sully1993_11: folds 
*** FLOP *** [Ad Ah 9s]
johnyguedes1: checks 
Katwoman0106: checks 
*** TURN *** [Ad Ah 9s] [6h]
johnyguedes1: bets 4449
Katwoman0106: folds 
Uncalled bet (4449) returned to johnyguedes1
johnyguedes1 collected 5360 from pot
johnyguedes1: doesn't show hand 
*** SUMMARY ***
Total pot 5360 | Rake 0 
Board [Ad Ah 9s 6h]
Seat 1: Katwoman0106 (button) folded on the Turn
Seat 2: fAArid88 (small blind) folded before Flop
Seat 3: Sully1993_11 (big blind) folded before Flop
Seat 4: nahumdj folded before Flop (didn't bet)
Seat 5: johnyguedes1 collected (5360)
Seat 6: yuzoyai folded before Flop (didn't bet)
Seat 7: junior_re612 folded before Flop (didn't bet)
Seat 8: epo9 folded before Flop (didn't bet)

PokerStars Hand #251205104056: Tournament #3767885527, $40+$10+$5 USD Hold'em No Limit - Level IX (400/800) - 2024/06/26 18:33:23 UTC [2024/06/26 14:33:23 ET]
Table '3767885527 37' 8-max Seat #2 is the button
Seat 1: Katwoman0106 (20240 in chips) 
Seat 2: fAArid88 (14091 in chips) 
Seat 3: Sully1993_11 (16718 in chips) 
Seat 4: nahumdj (36257 in chips) 
Seat 5: johnyguedes1 (74857 in chips) 
Seat 6: yuzoyai (10371 in chips) 
Seat 7: junior_re612 (52085 in chips) 
Seat 8: epo9 (32390 in chips) 
Katwoman0106: posts the ante 100
fAArid88: posts the ante 100
Sully1993_11: posts the ante 100
nahumdj: posts the ante 100
johnyguedes1: posts the ante 100
yuzoyai: posts the ante 100
junior_re612: posts the ante 100
epo9: posts the ante 100
Sully1993_11: posts small blind 400
nahumdj: posts big blind 800
*** HOLE CARDS ***
johnyguedes1: folds 
yuzoyai: folds 
junior_re612: folds 
epo9: raises 800 to 1600
Katwoman0106: folds 
fAArid88: folds 
Sully1993_11: calls 1200
nahumdj: calls 800
*** FLOP *** [Kc Ad 8d]
Sully1993_11: bets 2800
nahumdj: calls 2800
epo9: calls 2800
*** TURN *** [Kc Ad 8d] [Ks]
Sully1993_11: checks 
nahumdj: checks 
epo9: bets 4000
Sully1993_11: calls 4000
nahumdj: folds 
*** RIVER *** [Kc Ad 8d Ks] [4h]
Sully1993_11: checks 
epo9: checks 
*** SHOW DOWN ***
Sully1993_11: shows [Qh Ah] (two pair, Aces and Kings)
epo9: mucks hand 
Sully1993_11 collected 22000 from pot
*** SUMMARY ***
Total pot 22000 | Rake 0 
Board [Kc Ad 8d Ks 4h]
Seat 1: Katwoman0106 folded before Flop (didn't bet)
Seat 2: fAArid88 (button) folded before Flop (didn't bet)
Seat 3: Sully1993_11 (small blind) showed [Qh Ah] and won (22000) with two pair, Aces and Kings
Seat 4: nahumdj (big blind) folded on the Turn
Seat 5: johnyguedes1 folded before Flop (didn't bet)
Seat 6: yuzoyai folded before Flop (didn't bet)
Seat 7: junior_re612 folded before Flop (didn't bet)
Seat 8: epo9 mucked

PokerStars Hand #251205120323: Tournament #3767885527, $40+$10+$5 USD Hold'em No Limit - Level IX (400/800) - 2024/06/26 18:34:27 UTC [2024/06/26 14:34:27 ET]
Table '3767885527 37' 8-max Seat #3 is the button
Seat 1: Katwoman0106 (20140 in chips) 
Seat 2: fAArid88 (13991 in chips) 
Seat 3: Sully1993_11 (30218 in chips) 
Seat 4: nahumdj (31757 in chips) 
Seat 5: johnyguedes1 (74757 in chips) 
Seat 6: yuzoyai (10271 in chips) 
Seat 7: junior_re612 (51985 in chips) 
Seat 8: epo9 (23890 in chips) 
Katwoman0106: posts the ante 100
fAArid88: posts the ante 100
Sully1993_11: posts the ante 100
nahumdj: posts the ante 100
johnyguedes1: posts the ante 100
yuzoyai: posts the ante 100
junior_re612: posts the ante 100
epo9: posts the ante 100
nahumdj: posts small blind 400
johnyguedes1: posts big blind 800
*** HOLE CARDS ***
yuzoyai: folds 
junior_re612: folds 
epo9: folds 
Katwoman0106: folds 
fAArid88: folds 
Sully1993_11: folds 
nahumdj: folds 
Uncalled bet (400) returned to johnyguedes1
johnyguedes1 collected 1600 from pot
johnyguedes1: doesn't show hand 
*** SUMMARY ***
Total pot 1600 | Rake 0 
Seat 1: Katwoman0106 folded before Flop (didn't bet)
Seat 2: fAArid88 folded before Flop (didn't bet)
Seat 3: Sully1993_11 (button) folded before Flop (didn't bet)
Seat 4: nahumdj (small blind) folded before Flop
Seat 5: johnyguedes1 (big blind) collected (1600)
Seat 6: yuzoyai folded before Flop (didn't bet)
Seat 7: junior_re612 folded before Flop (didn't bet)
Seat 8: epo9 folded before Flop (didn't bet)

PokerStars Hand #251205130850: Tournament #3767885527, $40+$10+$5 USD Hold'em No Limit - Level IX (400/800) - 2024/06/26 18:35:08 UTC [2024/06/26 14:35:08 ET]
Table '3767885527 37' 8-max Seat #4 is the button
Seat 1: Katwoman0106 (20040 in chips) 
Seat 2: fAArid88 (13891 in chips) 
Seat 3: Sully1993_11 (30118 in chips) 
Seat 4: nahumdj (31257 in chips) 
Seat 5: johnyguedes1 (75857 in chips) 
Seat 6: yuzoyai (10171 in chips) 
Seat 7: junior_re612 (51885 in chips) 
Seat 8: epo9 (23790 in chips) 
Katwoman0106: posts the ante 100
fAArid88: posts the ante 100
Sully1993_11: posts the ante 100
nahumdj: posts the ante 100
johnyguedes1: posts the ante 100
yuzoyai: posts the ante 100
junior_re612: posts the ante 100
epo9: posts the ante 100
johnyguedes1: posts small blind 400
yuzoyai: posts big blind 800
*** HOLE CARDS ***
junior_re612: folds 
epo9: folds 
Katwoman0106: folds 
fAArid88: folds 
Sully1993_11: calls 800
nahumdj: folds 
johnyguedes1: raises 2400 to 3200
yuzoyai: raises 6871 to 10071 and is all-in
Sully1993_11: folds 
johnyguedes1: calls 6871
*** FLOP *** [7h 2c Qs]
*** TURN *** [7h 2c Qs] [5h]
*** RIVER *** [7h 2c Qs 5h] [5c]
*** SHOW DOWN ***
johnyguedes1: shows [Tc Jc] (a pair of Fives)
yuzoyai: shows [Ah Qh] (two pair, Queens and Fives)
yuzoyai collected 21742 from pot
*** SUMMARY ***
Total pot 21742 | Rake 0 
Board [7h 2c Qs 5h 5c]
Seat 1: Katwoman0106 folded before Flop (didn't bet)
Seat 2: fAArid88 folded before Flop (didn't bet)
Seat 3: Sully1993_11 folded before Flop
Seat 4: nahumdj (button) folded before Flop (didn't bet)
Seat 5: johnyguedes1 (small blind) showed [Tc Jc] and lost with a pair of Fives
Seat 6: yuzoyai (big blind) showed [Ah Qh] and won (21742) with two pair, Queens and Fives
Seat 7: junior_re612 folded before Flop (didn't bet)
Seat 8: epo9 folded before Flop (didn't bet)

PokerStars Hand #251205149407: Tournament #3767885527, $40+$10+$5 USD Hold'em No Limit - Level IX (400/800) - 2024/06/26 18:36:21 UTC [2024/06/26 14:36:21 ET]
Table '3767885527 37' 8-max Seat #5 is the button
Seat 1: Katwoman0106 (19940 in chips) 
Seat 2: fAArid88 (13791 in chips) 
Seat 3: Sully1993_11 (29218 in chips) 
Seat 4: nahumdj (31157 in chips) 
Seat 5: johnyguedes1 (65686 in chips) 
Seat 6: yuzoyai (21742 in chips) 
Seat 7: junior_re612 (51785 in chips) 
Seat 8: epo9 (23690 in chips) 
Katwoman0106: posts the ante 100
fAArid88: posts the ante 100
Sully1993_11: posts the ante 100
nahumdj: posts the ante 100
johnyguedes1: posts the ante 100
yuzoyai: posts the ante 100
junior_re612: posts the ante 100
epo9: posts the ante 100
yuzoyai: posts small blind 400
junior_re612: posts big blind 800
*** HOLE CARDS ***
epo9: folds 
Katwoman0106: folds 
fAArid88: folds 
Sully1993_11: raises 1600 to 2400
nahumdj: folds 
johnyguedes1: folds 
yuzoyai: folds 
junior_re612: folds 
Uncalled bet (1600) returned to Sully1993_11
Sully1993_11 collected 2800 from pot
Sully1993_11: doesn't show hand 
*** SUMMARY ***
Total pot 2800 | Rake 0 
Seat 1: Katwoman0106 folded before Flop (didn't bet)
Seat 2: fAArid88 folded before Flop (didn't bet)
Seat 3: Sully1993_11 collected (2800)
Seat 4: nahumdj folded before Flop (didn't bet)
Seat 5: johnyguedes1 (button) folded before Flop (didn't bet)
Seat 6: yuzoyai (small blind) folded before Flop
Seat 7: junior_re612 (big blind) folded before Flop
Seat 8: epo9 folded before Flop (didn't bet)

PokerStars Hand #251205158420: Tournament #3767885527, $40+$10+$5 USD Hold'em No Limit - Level IX (400/800) - 2024/06/26 18:36:56 UTC [2024/06/26 14:36:56 ET]
Table '3767885527 37' 8-max Seat #6 is the button
Seat 1: Katwoman0106 (19840 in chips) 
Seat 2: fAArid88 (13691 in chips) 
Seat 3: Sully1993_11 (31118 in chips) 
Seat 4: nahumdj (31057 in chips) 
Seat 5: johnyguedes1 (65586 in chips) 
Seat 6: yuzoyai (21242 in chips) 
Seat 7: junior_re612 (50885 in chips) 
Seat 8: epo9 (23590 in chips) 
Katwoman0106: posts the ante 100
fAArid88: posts the ante 100
Sully1993_11: posts the ante 100
nahumdj: posts the ante 100
johnyguedes1: posts the ante 100
yuzoyai: posts the ante 100
junior_re612: posts the ante 100
epo9: posts the ante 100
junior_re612: posts small blind 400
epo9: posts big blind 800
*** HOLE CARDS ***
Katwoman0106: raises 800 to 1600
fAArid88: folds 
Sully1993_11: folds 
nahumdj: folds 
johnyguedes1: folds 
yuzoyai: folds 
junior_re612: calls 1200
epo9: calls 800
*** FLOP *** [8s 3h Th]
junior_re612: checks 
epo9: bets 2400
Katwoman0106: calls 2400
junior_re612: folds 
*** TURN *** [8s 3h Th] [4c]
epo9: bets 7200
Katwoman0106: raises 8540 to 15740 and is all-in
epo9: calls 8540
*** RIVER *** [8s 3h Th 4c] [Ad]
*** SHOW DOWN ***
epo9: shows [9h Kh] (high card Ace)
Katwoman0106: shows [Td Kd] (a pair of Tens)
Katwoman0106 collected 41880 from pot
*** SUMMARY ***
Total pot 41880 | Rake 0 
Board [8s 3h Th 4c Ad]
Seat 1: Katwoman0106 showed [Td Kd] and won (41880) with a pair of Tens
Seat 2: fAArid88 folded before Flop (didn't bet)
Seat 3: Sully1993_11 folded before Flop (didn't bet)
Seat 4: nahumdj folded before Flop (didn't bet)
Seat 5: johnyguedes1 folded before Flop (didn't bet)
Seat 6: yuzoyai (button) folded before Flop (didn't bet)
Seat 7: junior_re612 (small blind) folded on the Flop
Seat 8: epo9 (big blind) showed [9h Kh] and lost with high card Ace

PokerStars Hand #251205177548: Tournament #3767885527, $40+$10+$5 USD Hold'em No Limit - Level IX (400/800) - 2024/06/26 18:38:09 UTC [2024/06/26 14:38:09 ET]
Table '3767885527 37' 8-max Seat #7 is the button
Seat 1: Katwoman0106 (41880 in chips) 
Seat 2: fAArid88 (13591 in chips) 
Seat 3: Sully1993_11 (31018 in chips) 
Seat 4: nahumdj (30957 in chips) 
Seat 5: johnyguedes1 (65486 in chips) 
Seat 6: yuzoyai (21142 in chips) 
Seat 7: junior_re612 (49185 in chips) 
Seat 8: epo9 (3750 in chips) 
Katwoman0106: posts the ante 100
fAArid88: posts the ante 100
Sully1993_11: posts the ante 100
nahumdj: posts the ante 100
johnyguedes1: posts the ante 100
yuzoyai: posts the ante 100
junior_re612: posts the ante 100
epo9: posts the ante 100
epo9: posts small blind 400
Katwoman0106: posts big blind 800
*** HOLE CARDS ***
fAArid88: folds 
Sully1993_11: calls 800
nahumdj: folds 
johnyguedes1: folds 
yuzoyai: folds 
junior_re612: folds 
epo9: calls 400
Katwoman0106: checks 
*** FLOP *** [3s 6d Jd]
epo9: checks 
Katwoman0106: checks 
Sully1993_11: checks 
*** TURN *** [3s 6d Jd] [Qc]
epo9: bets 2850 and is all-in
Katwoman0106: folds 
Sully1993_11: folds 
Uncalled bet (2850) returned to epo9
epo9 collected 3200 from pot
*** SUMMARY ***
Total pot 3200 | Rake 0 
Board [3s 6d Jd Qc]
Seat 1: Katwoman0106 (big blind) folded on the Turn
Seat 2: fAArid88 folded before Flop (didn't bet)
Seat 3: Sully1993_11 folded on the Turn
Seat 4: nahumdj folded before Flop (didn't bet)
Seat 5: johnyguedes1 folded before Flop (didn't bet)
Seat 6: yuzoyai folded before Flop (didn't bet)
Seat 7: junior_re612 (button) folded before Flop (didn't bet)
Seat 8: epo9 (small blind) collected (3200)

PokerStars Hand #251205191801: Tournament #3767885527, $40+$10+$5 USD Hold'em No Limit - Level IX (400/800) - 2024/06/26 18:39:05 UTC [2024/06/26 14:39:05 ET]
Table '3767885527 37' 8-max Seat #8 is the button
Seat 1: Katwoman0106 (40980 in chips) 
Seat 2: fAArid88 (13491 in chips) 
Seat 3: Sully1993_11 (30118 in chips) 
Seat 4: nahumdj (30857 in chips) 
Seat 5: johnyguedes1 (65386 in chips) 
Seat 6: yuzoyai (21042 in chips) 
Seat 7: junior_re612 (49085 in chips) 
Seat 8: epo9 (6050 in chips) 
Katwoman0106: posts the ante 100
fAArid88: posts the ante 100
Sully1993_11: posts the ante 100
nahumdj: posts the ante 100
johnyguedes1: posts the ante 100
yuzoyai: posts the ante 100
junior_re612: posts the ante 100
epo9: posts the ante 100
Katwoman0106: posts small blind 400
fAArid88: posts big blind 800
*** HOLE CARDS ***
Sully1993_11: folds 
nahumdj: raises 800 to 1600
johnyguedes1: folds 
yuzoyai: folds 
junior_re612: folds 
epo9: folds 
Katwoman0106: folds 
fAArid88: raises 11791 to 13391 and is all-in
nahumdj: calls 11791
*** FLOP *** [4h Kc 2c]
*** TURN *** [4h Kc 2c] [4c]
*** RIVER *** [4h Kc 2c 4c] [8c]
*** SHOW DOWN ***
fAArid88: shows [Tc Ts] (a flush, King high)
nahumdj: shows [9s 9d] (two pair, Nines and Fours)
fAArid88 collected 27982 from pot
*** SUMMARY ***
Total pot 27982 | Rake 0 
Board [4h Kc 2c 4c 8c]
Seat 1: Katwoman0106 (small blind) folded before Flop
Seat 2: fAArid88 (big blind) showed [Tc Ts] and won (27982) with a flush, King high
Seat 3: Sully1993_11 folded before Flop (didn't bet)
Seat 4: nahumdj showed [9s 9d] and lost with two pair, Nines and Fours
Seat 5: johnyguedes1 folded before Flop (didn't bet)
Seat 6: yuzoyai folded before Flop (didn't bet)
Seat 7: junior_re612 folded before Flop (didn't bet)
Seat 8: epo9 (button) folded before Flop (didn't bet)

PokerStars Hand #251205202869: Tournament #3767885527, $40+$10+$5 USD Hold'em No Limit - Level IX (400/800) - 2024/06/26 18:39:48 UTC [2024/06/26 14:39:48 ET]
Table '3767885527 37' 8-max Seat #1 is the button
Seat 1: Katwoman0106 (40480 in chips) 
Seat 2: fAArid88 (27982 in chips) 
Seat 3: Sully1993_11 (30018 in chips) 
Seat 4: nahumdj (17366 in chips) 
Seat 5: johnyguedes1 (65286 in chips) 
Seat 6: yuzoyai (20942 in chips) 
Seat 7: junior_re612 (48985 in chips) 
Seat 8: epo9 (5950 in chips) 
Katwoman0106: posts the ante 100
fAArid88: posts the ante 100
Sully1993_11: posts the ante 100
nahumdj: posts the ante 100
johnyguedes1: posts the ante 100
yuzoyai: posts the ante 100
junior_re612: posts the ante 100
epo9: posts the ante 100
fAArid88: posts small blind 400
Sully1993_11: posts big blind 800
*** HOLE CARDS ***
nahumdj: folds 
johnyguedes1: folds 
yuzoyai: folds 
junior_re612: raises 800 to 1600
epo9: folds 
Katwoman0106: folds 
fAArid88: folds 
Sully1993_11: folds 
Uncalled bet (800) returned to junior_re612
junior_re612 collected 2800 from pot
junior_re612: doesn't show hand 
*** SUMMARY ***
Total pot 2800 | Rake 0 
Seat 1: Katwoman0106 (button) folded before Flop (didn't bet)
Seat 2: fAArid88 (small blind) folded before Flop
Seat 3: Sully1993_11 (big blind) folded before Flop
Seat 4: nahumdj folded before Flop (didn't bet)
Seat 5: johnyguedes1 folded before Flop (didn't bet)
Seat 6: yuzoyai folded before Flop (didn't bet)
Seat 7: junior_re612 collected (2800)
Seat 8: epo9 folded before Flop (didn't bet)

PokerStars Hand #251205212451: Tournament #3767885527, $40+$10+$5 USD Hold'em No Limit - Level IX (400/800) - 2024/06/26 18:40:24 UTC [2024/06/26 14:40:24 ET]
Table '3767885527 37' 8-max Seat #2 is the button
Seat 1: Katwoman0106 (40380 in chips) 
Seat 2: fAArid88 (27482 in chips) 
Seat 3: Sully1993_11 (29118 in chips) 
Seat 4: nahumdj (17266 in chips) 
Seat 5: johnyguedes1 (65186 in chips) 
Seat 6: yuzoyai (20842 in chips) 
Seat 7: junior_re612 (50885 in chips) 
Seat 8: epo9 (5850 in chips) 
Katwoman0106: posts the ante 100
fAArid88: posts the ante 100
Sully1993_11: posts the ante 100
nahumdj: posts the ante 100
johnyguedes1: posts the ante 100
yuzoyai: posts the ante 100
junior_re612: posts the ante 100
epo9: posts the ante 100
Sully1993_11: posts small blind 400
nahumdj: posts big blind 800
*** HOLE CARDS ***
johnyguedes1: folds 
yuzoyai: folds 
junior_re612: raises 800 to 1600
epo9: calls 1600
Katwoman0106: calls 1600
fAArid88: folds 
Sully1993_11: folds 
nahumdj: folds 
*** FLOP *** [Jd 7c 7h]
junior_re612: checks 
epo9: bets 4150 and is all-in
Katwoman0106: calls 4150
junior_re612: folds 
*** TURN *** [Jd 7c 7h] [Ah]
*** RIVER *** [Jd 7c 7h Ah] [Qd]
*** SHOW DOWN ***
epo9: shows [Ks Qs] (two pair, Queens and Sevens)
Katwoman0106: shows [7d 7s] (four of a kind, Sevens)
Katwoman0106 collected 15100 from pot
epo9 finished the tournament
*** SUMMARY ***
Total pot 15100 | Rake 0 
Board [Jd 7c 7h Ah Qd]
Seat 1: Katwoman0106 showed [7d 7s] and won (15100) with four of a kind, Sevens
Seat 2: fAArid88 (button) folded before Flop (didn't bet)
Seat 3: Sully1993_11 (small blind) folded before Flop
Seat 4: nahumdj (big blind) folded before Flop
Seat 5: johnyguedes1 folded before Flop (didn't bet)
Seat 6: yuzoyai folded before Flop (didn't bet)
Seat 7: junior_re612 folded on the Flop
Seat 8: epo9 showed [Ks Qs] and lost with two pair, Queens and Sevens

PokerStars Hand #251205229299: Tournament #3767885527, $40+$10+$5 USD Hold'em No Limit - Level IX (400/800) - 2024/06/26 18:41:29 UTC [2024/06/26 14:41:29 ET]
Table '3767885527 37' 8-max Seat #3 is the button
Seat 1: Katwoman0106 (49630 in chips) 
Seat 2: fAArid88 (27382 in chips) 
Seat 3: Sully1993_11 (28618 in chips) 
Seat 4: nahumdj (16366 in chips) 
Seat 5: johnyguedes1 (65086 in chips) 
Seat 6: yuzoyai (20742 in chips) 
Seat 7: junior_re612 (49185 in chips) 
Katwoman0106: posts the ante 100
fAArid88: posts the ante 100
Sully1993_11: posts the ante 100
nahumdj: posts the ante 100
johnyguedes1: posts the ante 100
yuzoyai: posts the ante 100
junior_re612: posts the ante 100
nahumdj: posts small blind 400
johnyguedes1: posts big blind 800
*** HOLE CARDS ***
yuzoyai: folds 
junior_re612: folds 
Katwoman0106: folds 
fAArid88: folds 
Sully1993_11: folds 
nahumdj: folds 
Uncalled bet (400) returned to johnyguedes1
johnyguedes1 collected 1500 from pot
johnyguedes1: doesn't show hand 
*** SUMMARY ***
Total pot 1500 | Rake 0 
Seat 1: Katwoman0106 folded before Flop (didn't bet)
Seat 2: fAArid88 folded before Flop (didn't bet)
Seat 3: Sully1993_11 (button) folded before Flop (didn't bet)
Seat 4: nahumdj (small blind) folded before Flop
Seat 5: johnyguedes1 (big blind) collected (1500)
Seat 6: yuzoyai folded before Flop (didn't bet)
Seat 7: junior_re612 folded before Flop (didn't bet)

PokerStars Hand #251205233398: Tournament #3767885527, $40+$10+$5 USD Hold'em No Limit - Level IX (400/800) - 2024/06/26 18:41:45 UTC [2024/06/26 14:41:45 ET]
Table '3767885527 37' 8-max Seat #4 is the button
Seat 1: Katwoman0106 (49530 in chips) 
Seat 2: fAArid88 (27282 in chips) 
Seat 3: Sully1993_11 (28518 in chips) 
Seat 4: nahumdj (15866 in chips) 
Seat 5: johnyguedes1 (66086 in chips) 
Seat 6: yuzoyai (20642 in chips) 
Seat 7: junior_re612 (49085 in chips) 
Katwoman0106: posts the ante 100
fAArid88: posts the ante 100
Sully1993_11: posts the ante 100
nahumdj: posts the ante 100
johnyguedes1: posts the ante 100
yuzoyai: posts the ante 100
junior_re612: posts the ante 100
johnyguedes1: posts small blind 400
yuzoyai: posts big blind 800
*** HOLE CARDS ***
junior_re612: raises 800 to 1600
Katwoman0106: folds 
fAArid88: folds 
Sully1993_11: calls 1600
nahumdj: raises 14166 to 15766 and is all-in
johnyguedes1: folds 
yuzoyai: folds 
junior_re612: folds 
Sully1993_11: folds 
Uncalled bet (14166) returned to nahumdj
nahumdj collected 6700 from pot
*** SUMMARY ***
Total pot 6700 | Rake 0 
Seat 1: Katwoman0106 folded before Flop (didn't bet)
Seat 2: fAArid88 folded before Flop (didn't bet)
Seat 3: Sully1993_11 folded before Flop
Seat 4: nahumdj (button) collected (6700)
Seat 5: johnyguedes1 (small blind) folded before Flop
Seat 6: yuzoyai (big blind) folded before Flop
Seat 7: junior_re612 folded before Flop

PokerStars Hand #251205245960: Tournament #3767885527, $40+$10+$5 USD Hold'em No Limit - Level X (500/1000) - 2024/06/26 18:42:33 UTC [2024/06/26 14:42:33 ET]
Table '3767885527 37' 8-max Seat #5 is the button
Seat 1: Katwoman0106 (49430 in chips) 
Seat 2: fAArid88 (27182 in chips) 
Seat 3: Sully1993_11 (26818 in chips) 
Seat 4: nahumdj (20866 in chips) 
Seat 5: johnyguedes1 (65586 in chips) 
Seat 6: yuzoyai (19742 in chips) 
Seat 7: junior_re612 (47385 in chips) 
Seat 8: Amandaraujo (34196 in chips) 
Katwoman0106: posts the ante 125
fAArid88: posts the ante 125
Sully1993_11: posts the ante 125
nahumdj: posts the ante 125
johnyguedes1: posts the ante 125
yuzoyai: posts the ante 125
junior_re612: posts the ante 125
Amandaraujo: posts the ante 125
yuzoyai: posts small blind 500
junior_re612: posts big blind 1000
*** HOLE CARDS ***
Amandaraujo: raises 1000 to 2000
Katwoman0106: folds 
fAArid88: folds 
Sully1993_11: folds 
nahumdj: folds 
johnyguedes1: folds 
yuzoyai: folds 
junior_re612: calls 1000
*** FLOP *** [2h Qs Kc]
junior_re612: checks 
Amandaraujo: bets 3750
junior_re612: folds 
Uncalled bet (3750) returned to Amandaraujo
Amandaraujo collected 5500 from pot
Amandaraujo: doesn't show hand 
*** SUMMARY ***
Total pot 5500 | Rake 0 
Board [2h Qs Kc]
Seat 1: Katwoman0106 folded before Flop (didn't bet)
Seat 2: fAArid88 folded before Flop (didn't bet)
Seat 3: Sully1993_11 folded before Flop (didn't bet)
Seat 4: nahumdj folded before Flop (didn't bet)
Seat 5: johnyguedes1 (button) folded before Flop (didn't bet)
Seat 6: yuzoyai (small blind) folded before Flop
Seat 7: junior_re612 (big blind) folded on the Flop
Seat 8: Amandaraujo collected (5500)

PokerStars Hand #251205263306: Tournament #3767885527, $40+$10+$5 USD Hold'em No Limit - Level X (500/1000) - 2024/06/26 18:43:39 UTC [2024/06/26 14:43:39 ET]
Table '3767885527 37' 8-max Seat #6 is the button
Seat 1: Katwoman0106 (49305 in chips) 
Seat 2: fAArid88 (27057 in chips) 
Seat 3: Sully1993_11 (26693 in chips) 
Seat 4: nahumdj (20741 in chips) 
Seat 5: johnyguedes1 (65461 in chips) 
Seat 6: yuzoyai (19117 in chips) 
Seat 7: junior_re612 (45260 in chips) 
Seat 8: Amandaraujo (37571 in chips) 
Katwoman0106: posts the ante 125
fAArid88: posts the ante 125
Sully1993_11: posts the ante 125
nahumdj: posts the ante 125
johnyguedes1: posts the ante 125
yuzoyai: posts the ante 125
junior_re612: posts the ante 125
Amandaraujo: posts the ante 125
junior_re612: posts small blind 500
Amandaraujo: posts big blind 1000
*** HOLE CARDS ***
Katwoman0106: folds 
fAArid88: raises 1000 to 2000
Sully1993_11: folds 
nahumdj: folds 
johnyguedes1: folds 
yuzoyai: folds 
junior_re612: folds 
Amandaraujo: calls 1000
*** FLOP *** [Ts Qh Qd]
Amandaraujo: checks 
fAArid88: checks 
*** TURN *** [Ts Qh Qd] [4s]
Amandaraujo: checks 
fAArid88: bets 1375
Amandaraujo: calls 1375
*** RIVER *** [Ts Qh Qd 4s] [4d]
Amandaraujo: checks 
fAArid88: checks 
*** SHOW DOWN ***
Amandaraujo: shows [3d 3h] (two pair, Queens and Fours)
fAArid88: shows [Ah 9h] (two pair, Queens and Fours - Ace kicker)
fAArid88 collected 8250 from pot
*** SUMMARY ***
Total pot 8250 | Rake 0 
Board [Ts Qh Qd 4s 4d]
Seat 1: Katwoman0106 folded before Flop (didn't bet)
Seat 2: fAArid88 showed [Ah 9h] and won (8250) with two pair, Queens and Fours
Seat 3: Sully1993_11 folded before Flop (didn't bet)
Seat 4: nahumdj folded before Flop (didn't bet)
Seat 5: johnyguedes1 folded before Flop (didn't bet)
Seat 6: yuzoyai (button) folded before Flop (didn't bet)
Seat 7: junior_re612 (small blind) folded before Flop
Seat 8: Amandaraujo (big blind) showed [3d 3h] and lost with two pair, Queens and Fours

PokerStars Hand #251205277832: Tournament #3767885527, $40+$10+$5 USD Hold'em No Limit - Level X (500/1000) - 2024/06/26 18:44:34 UTC [2024/06/26 14:44:34 ET]
Table '3767885527 37' 8-max Seat #7 is the button
Seat 1: Katwoman0106 (49180 in chips) 
Seat 2: fAArid88 (31807 in chips) 
Seat 3: Sully1993_11 (26568 in chips) 
Seat 4: nahumdj (20616 in chips) 
Seat 5: johnyguedes1 (65336 in chips) 
Seat 6: yuzoyai (18992 in chips) 
Seat 7: junior_re612 (44635 in chips) 
Seat 8: Amandaraujo (34071 in chips) 
Katwoman0106: posts the ante 125
fAArid88: posts the ante 125
Sully1993_11: posts the ante 125
nahumdj: posts the ante 125
johnyguedes1: posts the ante 125
yuzoyai: posts the ante 125
junior_re612: posts the ante 125
Amandaraujo: posts the ante 125
Amandaraujo: posts small blind 500
Katwoman0106: posts big blind 1000
*** HOLE CARDS ***
fAArid88: folds 
Sully1993_11: folds 
nahumdj: folds 
johnyguedes1: folds 
yuzoyai: folds 
junior_re612: raises 1500 to 2500
Amandaraujo: calls 2000
Katwoman0106: calls 1500
*** FLOP *** [5s Qh Js]
Amandaraujo: bets 4250
Katwoman0106: folds 
junior_re612: calls 4250
*** TURN *** [5s Qh Js] [6c]
Amandaraujo: checks 
junior_re612: checks 
*** RIVER *** [5s Qh Js 6c] [5h]
Amandaraujo: checks 
junior_re612: bets 12750
Amandaraujo: folds 
Uncalled bet (12750) returned to junior_re612
junior_re612 collected 17000 from pot
junior_re612: doesn't show hand 
*** SUMMARY ***
Total pot 17000 | Rake 0 
Board [5s Qh Js 6c 5h]
Seat 1: Katwoman0106 (big blind) folded on the Flop
Seat 2: fAArid88 folded before Flop (didn't bet)
Seat 3: Sully1993_11 folded before Flop (didn't bet)
Seat 4: nahumdj folded before Flop (didn't bet)
Seat 5: johnyguedes1 folded before Flop (didn't bet)
Seat 6: yuzoyai folded before Flop (didn't bet)
Seat 7: junior_re612 (button) collected (17000)
Seat 8: Amandaraujo (small blind) folded on the River

PokerStars Hand #251205293414: Tournament #3767885527, $40+$10+$5 USD Hold'em No Limit - Level X (500/1000) - 2024/06/26 18:45:33 UTC [2024/06/26 14:45:33 ET]
Table '3767885527 37' 8-max Seat #8 is the button
Seat 1: Katwoman0106 (46555 in chips) 
Seat 2: fAArid88 (31682 in chips) 
Seat 3: Sully1993_11 (26443 in chips) 
Seat 4: nahumdj (20491 in chips) 
Seat 5: johnyguedes1 (65211 in chips) 
Seat 6: yuzoyai (18867 in chips) 
Seat 7: junior_re612 (54760 in chips) 
Seat 8: Amandaraujo (27196 in chips) 
Katwoman0106: posts the ante 125
fAArid88: posts the ante 125
Sully1993_11: posts the ante 125
nahumdj: posts the ante 125
johnyguedes1: posts the ante 125
yuzoyai: posts the ante 125
junior_re612: posts the ante 125
Amandaraujo: posts the ante 125
Katwoman0106: posts small blind 500
fAArid88: posts big blind 1000
*** HOLE CARDS ***
Sully1993_11: folds 
nahumdj: raises 1000 to 2000
johnyguedes1: folds 
yuzoyai: folds 
junior_re612: calls 2000
Amandaraujo: raises 2000 to 4000
Katwoman0106: folds 
fAArid88: folds 
nahumdj: raises 16366 to 20366 and is all-in
junior_re612: folds 
Amandaraujo: calls 16366
*** FLOP *** [9d 4s 7d]
*** TURN *** [9d 4s 7d] [Ts]
*** RIVER *** [9d 4s 7d Ts] [Td]
*** SHOW DOWN ***
nahumdj: shows [As Kc] (a pair of Tens)
Amandaraujo: shows [Jh 8s] (a straight, Seven to Jack)
Amandaraujo collected 45232 from pot
nahumdj finished the tournament
Naaarrrr is disconnected 
*** SUMMARY ***
Total pot 45232 | Rake 0 
Board [9d 4s 7d Ts Td]
Seat 1: Katwoman0106 (small blind) folded before Flop
Seat 2: fAArid88 (big blind) folded before Flop
Seat 3: Sully1993_11 folded before Flop (didn't bet)
Seat 4: nahumdj showed [As Kc] and lost with a pair of Tens
Seat 5: johnyguedes1 folded before Flop (didn't bet)
Seat 6: yuzoyai folded before Flop (didn't bet)
Seat 7: junior_re612 folded before Flop
Seat 8: Amandaraujo (button) showed [Jh 8s] and won (45232) with a straight, Seven to Jack

PokerStars Hand #251205306343: Tournament #3767885527, $40+$10+$5 USD Hold'em No Limit - Level X (500/1000) - 2024/06/26 18:46:21 UTC [2024/06/26 14:46:21 ET]
Table '3767885527 37' 8-max Seat #1 is the button
Seat 1: Katwoman0106 (45930 in chips) 
Seat 2: fAArid88 (30557 in chips) 
Seat 3: Sully1993_11 (26318 in chips) 
Seat 4: Naaarrrr (25000 in chips) 
Seat 5: johnyguedes1 (65086 in chips) 
Seat 6: yuzoyai (18742 in chips) 
Seat 7: junior_re612 (52635 in chips) 
Seat 8: Amandaraujo (51937 in chips) 
Katwoman0106: posts the ante 125
fAArid88: posts the ante 125
Sully1993_11: posts the ante 125
Naaarrrr: posts the ante 125
johnyguedes1: posts the ante 125
yuzoyai: posts the ante 125
junior_re612: posts the ante 125
Amandaraujo: posts the ante 125
fAArid88: posts small blind 500
Sully1993_11: posts big blind 1000
*** HOLE CARDS ***
Naaarrrr: raises 1000 to 2000
johnyguedes1: folds 
yuzoyai: folds 
junior_re612: folds 
Amandaraujo: calls 2000
Katwoman0106: calls 2000
fAArid88: folds 
Sully1993_11: calls 1000
*** FLOP *** [5s 7s 8c]
Sully1993_11: checks 
Naaarrrr: checks 
Amandaraujo: checks 
Katwoman0106: bets 8333
Sully1993_11: raises 15860 to 24193 and is all-in
Naaarrrr: folds 
Amandaraujo: folds 
Katwoman0106: calls 15860
*** TURN *** [5s 7s 8c] [Th]
*** RIVER *** [5s 7s 8c Th] [Jh]
*** SHOW DOWN ***
Sully1993_11: shows [7h 5h] (two pair, Sevens and Fives)
Katwoman0106: shows [4d 6d] (a straight, Four to Eight)
Katwoman0106 collected 57886 from pot
Sully1993_11 finished the tournament
*** SUMMARY ***
Total pot 57886 | Rake 0 
Board [5s 7s 8c Th Jh]
Seat 1: Katwoman0106 (button) showed [4d 6d] and won (57886) with a straight, Four to Eight
Seat 2: fAArid88 (small blind) folded before Flop
Seat 3: Sully1993_11 (big blind) showed [7h 5h] and lost with two pair, Sevens and Fives
Seat 4: Naaarrrr folded on the Flop
Seat 5: johnyguedes1 folded before Flop (didn't bet)
Seat 6: yuzoyai folded before Flop (didn't bet)
Seat 7: junior_re612 folded before Flop (didn't bet)
Seat 8: Amandaraujo folded on the Flop

PokerStars Hand #251205323229: Tournament #3767885527, $40+$10+$5 USD Hold'em No Limit - Level X (500/1000) - 2024/06/26 18:47:26 UTC [2024/06/26 14:47:26 ET]
Table '3767885527 37' 8-max Seat #2 is the button
Seat 1: Katwoman0106 (77498 in chips) 
Seat 2: fAArid88 (29932 in chips) 
Seat 4: Naaarrrr (22875 in chips) 
Seat 5: johnyguedes1 (64961 in chips) 
Seat 6: yuzoyai (18617 in chips) 
Seat 7: junior_re612 (52510 in chips) 
Seat 8: Amandaraujo (49812 in chips) 
Katwoman0106: posts the ante 125
fAArid88: posts the ante 125
Naaarrrr: posts the ante 125
johnyguedes1: posts the ante 125
yuzoyai: posts the ante 125
junior_re612: posts the ante 125
Amandaraujo: posts the ante 125
Naaarrrr: posts small blind 500
johnyguedes1: posts big blind 1000
*** HOLE CARDS ***
yuzoyai: folds 
junior_re612: folds 
Amandaraujo: raises 1000 to 2000
Katwoman0106: folds 
fAArid88: folds 
Naaarrrr: folds 
paulscot1 is disconnected 
johnyguedes1: calls 1000
*** FLOP *** [Kh Jh 2d]
johnyguedes1: checks 
Amandaraujo: checks 
*** TURN *** [Kh Jh 2d] [6c]
johnyguedes1: checks 
Amandaraujo: checks 
*** RIVER *** [Kh Jh 2d 6c] [8c]
johnyguedes1: checks 
Amandaraujo: checks 
*** SHOW DOWN ***
johnyguedes1: shows [7d 7c] (a pair of Sevens)
Amandaraujo: mucks hand 
johnyguedes1 collected 5375 from pot
*** SUMMARY ***
Total pot 5375 | Rake 0 
Board [Kh Jh 2d 6c 8c]
Seat 1: Katwoman0106 folded before Flop (didn't bet)
Seat 2: fAArid88 (button) folded before Flop (didn't bet)
Seat 4: Naaarrrr (small blind) folded before Flop
Seat 5: johnyguedes1 (big blind) showed [7d 7c] and won (5375) with a pair of Sevens
Seat 6: yuzoyai folded before Flop (didn't bet)
Seat 7: junior_re612 folded before Flop (didn't bet)
Seat 8: Amandaraujo mucked

PokerStars Hand #251205333204: Tournament #3767885527, $40+$10+$5 USD Hold'em No Limit - Level X (500/1000) - 2024/06/26 18:48:04 UTC [2024/06/26 14:48:04 ET]
Table '3767885527 37' 8-max Seat #4 is the button
Seat 1: Katwoman0106 (77373 in chips) 
Seat 2: fAArid88 (29807 in chips) 
Seat 3: paulscot1 (25000 in chips) 
Seat 4: Naaarrrr (22250 in chips) 
Seat 5: johnyguedes1 (68211 in chips) 
Seat 6: yuzoyai (18492 in chips) 
Seat 7: junior_re612 (52385 in chips) 
Seat 8: Amandaraujo (47687 in chips) 
Katwoman0106: posts the ante 125
fAArid88: posts the ante 125
paulscot1: posts the ante 125
Naaarrrr: posts the ante 125
johnyguedes1: posts the ante 125
yuzoyai: posts the ante 125
junior_re612: posts the ante 125
Amandaraujo: posts the ante 125
johnyguedes1: posts small blind 500
yuzoyai: posts big blind 1000
*** HOLE CARDS ***
junior_re612: folds 
Amandaraujo: folds 
Katwoman0106: folds 
fAArid88: folds 
paulscot1: raises 1650 to 2650
Naaarrrr: calls 2650
johnyguedes1: folds 
yuzoyai: folds 
*** FLOP *** [Qs Ts Tc]
paulscot1: bets 2574
Naaarrrr: folds 
Uncalled bet (2574) returned to paulscot1
paulscot1 collected 7800 from pot
paulscot1: doesn't show hand 
*** SUMMARY ***
Total pot 7800 | Rake 0 
Board [Qs Ts Tc]
Seat 1: Katwoman0106 folded before Flop (didn't bet)
Seat 2: fAArid88 folded before Flop (didn't bet)
Seat 3: paulscot1 collected (7800)
Seat 4: Naaarrrr (button) folded on the Flop
Seat 5: johnyguedes1 (small blind) folded before Flop
Seat 6: yuzoyai (big blind) folded before Flop
Seat 7: junior_re612 folded before Flop (didn't bet)
Seat 8: Amandaraujo folded before Flop (didn't bet)

PokerStars Hand #251205342935: Tournament #3767885527, $40+$10+$5 USD Hold'em No Limit - Level X (500/1000) - 2024/06/26 18:48:41 UTC [2024/06/26 14:48:41 ET]
Table '3767885527 37' 8-max Seat #5 is the button
Seat 1: Katwoman0106 (77248 in chips) 
Seat 2: fAArid88 (29682 in chips) 
Seat 3: paulscot1 (30025 in chips) 
Seat 4: Naaarrrr (19475 in chips) 
Seat 5: johnyguedes1 (67586 in chips) 
Seat 6: yuzoyai (17367 in chips) 
Seat 7: junior_re612 (52260 in chips) 
Seat 8: Amandaraujo (47562 in chips) 
Katwoman0106: posts the ante 125
fAArid88: posts the ante 125
paulscot1: posts the ante 125
Naaarrrr: posts the ante 125
johnyguedes1: posts the ante 125
yuzoyai: posts the ante 125
junior_re612: posts the ante 125
Amandaraujo: posts the ante 125
yuzoyai: posts small blind 500
junior_re612: posts big blind 1000
*** HOLE CARDS ***
Amandaraujo: folds 
Katwoman0106: folds 
fAArid88: folds 
paulscot1: folds 
Naaarrrr: raises 1000 to 2000
johnyguedes1: folds 
yuzoyai: folds 
junior_re612: folds 
Uncalled bet (1000) returned to Naaarrrr
Naaarrrr collected 3500 from pot
Naaarrrr: doesn't show hand 
*** SUMMARY ***
Total pot 3500 | Rake 0 
Seat 1: Katwoman0106 folded before Flop (didn't bet)
Seat 2: fAArid88 folded before Flop (didn't bet)
Seat 3: paulscot1 folded before Flop (didn't bet)
Seat 4: Naaarrrr collected (3500)
Seat 5: johnyguedes1 (button) folded before Flop (didn't bet)
Seat 6: yuzoyai (small blind) folded before Flop
Seat 7: junior_re612 (big blind) folded before Flop
Seat 8: Amandaraujo folded before Flop (didn't bet)

PokerStars Hand #251205352104: Tournament #3767885527, $40+$10+$5 USD Hold'em No Limit - Level X (500/1000) - 2024/06/26 18:49:16 UTC [2024/06/26 14:49:16 ET]
Table '3767885527 37' 8-max Seat #6 is the button
Seat 1: Katwoman0106 (77123 in chips) 
Seat 2: fAArid88 (29557 in chips) 
Seat 3: paulscot1 (29900 in chips) 
Seat 4: Naaarrrr (21850 in chips) 
Seat 5: johnyguedes1 (67461 in chips) 
Seat 6: yuzoyai (16742 in chips) 
Seat 7: junior_re612 (51135 in chips) 
Seat 8: Amandaraujo (47437 in chips) 
Katwoman0106: posts the ante 125
fAArid88: posts the ante 125
paulscot1: posts the ante 125
Naaarrrr: posts the ante 125
johnyguedes1: posts the ante 125
yuzoyai: posts the ante 125
junior_re612: posts the ante 125
Amandaraujo: posts the ante 125
junior_re612: posts small blind 500
Amandaraujo: posts big blind 1000
*** HOLE CARDS ***
Katwoman0106: folds 
fAArid88: raises 1000 to 2000
paulscot1: folds 
Naaarrrr: folds 
johnyguedes1: folds 
yuzoyai: calls 2000
junior_re612: folds 
Amandaraujo: calls 1000
*** FLOP *** [8h Qh 2s]
Amandaraujo: checks 
fAArid88: checks 
yuzoyai: bets 1950
Amandaraujo: folds 
fAArid88: raises 12050 to 14000
yuzoyai: raises 617 to 14617 and is all-in
fAArid88: calls 617
*** TURN *** [8h Qh 2s] [2d]
*** RIVER *** [8h Qh 2s 2d] [5c]
*** SHOW DOWN ***
fAArid88: shows [9s 8s] (two pair, Eights and Deuces)
yuzoyai: shows [Td Qd] (two pair, Queens and Deuces)
yuzoyai collected 36734 from pot
*** SUMMARY ***
Total pot 36734 | Rake 0 
Board [8h Qh 2s 2d 5c]
Seat 1: Katwoman0106 folded before Flop (didn't bet)
Seat 2: fAArid88 showed [9s 8s] and lost with two pair, Eights and Deuces
Seat 3: paulscot1 folded before Flop (didn't bet)
Seat 4: Naaarrrr folded before Flop (didn't bet)
Seat 5: johnyguedes1 folded before Flop (didn't bet)
Seat 6: yuzoyai (button) showed [Td Qd] and won (36734) with two pair, Queens and Deuces
Seat 7: junior_re612 (small blind) folded before Flop
Seat 8: Amandaraujo (big blind) folded on the Flop

PokerStars Hand #251205372845: Tournament #3767885527, $40+$10+$5 USD Hold'em No Limit - Level X (500/1000) - 2024/06/26 18:50:35 UTC [2024/06/26 14:50:35 ET]
Table '3767885527 37' 8-max Seat #7 is the button
Seat 1: Katwoman0106 (76998 in chips) 
Seat 2: fAArid88 (12815 in chips) 
Seat 3: paulscot1 (29775 in chips) 
Seat 4: Naaarrrr (21725 in chips) 
Seat 5: johnyguedes1 (67336 in chips) 
Seat 6: yuzoyai (36734 in chips) 
Seat 7: junior_re612 (50510 in chips) 
Seat 8: Amandaraujo (45312 in chips) 
Katwoman0106: posts the ante 125
fAArid88: posts the ante 125
paulscot1: posts the ante 125
Naaarrrr: posts the ante 125
johnyguedes1: posts the ante 125
yuzoyai: posts the ante 125
junior_re612: posts the ante 125
Amandaraujo: posts the ante 125
Amandaraujo: posts small blind 500
Katwoman0106: posts big blind 1000
*** HOLE CARDS ***
fAArid88: raises 11690 to 12690 and is all-in
paulscot1: folds 
Naaarrrr: folds 
johnyguedes1: folds 
yuzoyai: folds 
junior_re612: folds 
Amandaraujo: folds 
Katwoman0106: folds 
Uncalled bet (11690) returned to fAArid88
fAArid88 collected 3500 from pot
fAArid88: doesn't show hand 
*** SUMMARY ***
Total pot 3500 | Rake 0 
Seat 1: Katwoman0106 (big blind) folded before Flop
Seat 2: fAArid88 collected (3500)
Seat 3: paulscot1 folded before Flop (didn't bet)
Seat 4: Naaarrrr folded before Flop (didn't bet)
Seat 5: johnyguedes1 folded before Flop (didn't bet)
Seat 6: yuzoyai folded before Flop (didn't bet)
Seat 7: junior_re612 (button) folded before Flop (didn't bet)
Seat 8: Amandaraujo (small blind) folded before Flop

PokerStars Hand #251205380018: Tournament #3767885527, $40+$10+$5 USD Hold'em No Limit - Level X (500/1000) - 2024/06/26 18:51:03 UTC [2024/06/26 14:51:03 ET]
Table '3767885527 37' 8-max Seat #8 is the button
Seat 1: Katwoman0106 (75873 in chips) 
Seat 2: fAArid88 (15190 in chips) 
Seat 3: paulscot1 (29650 in chips) 
Seat 4: Naaarrrr (21600 in chips) 
Seat 5: johnyguedes1 (67211 in chips) 
Seat 6: yuzoyai (36609 in chips) 
Seat 7: junior_re612 (50385 in chips) 
Seat 8: Amandaraujo (44687 in chips) 
Katwoman0106: posts the ante 125
fAArid88: posts the ante 125
paulscot1: posts the ante 125
Naaarrrr: posts the ante 125
johnyguedes1: posts the ante 125
yuzoyai: posts the ante 125
junior_re612: posts the ante 125
Amandaraujo: posts the ante 125
Katwoman0106: posts small blind 500
fAArid88: posts big blind 1000
*** HOLE CARDS ***
paulscot1: folds 
Naaarrrr: folds 
johnyguedes1: folds 
yuzoyai: folds 
junior_re612: folds 
Amandaraujo: raises 1000 to 2000
Katwoman0106: folds 
fAArid88: folds 
Uncalled bet (1000) returned to Amandaraujo
Amandaraujo collected 3500 from pot
Amandaraujo: doesn't show hand 
*** SUMMARY ***
Total pot 3500 | Rake 0 
Seat 1: Katwoman0106 (small blind) folded before Flop
Seat 2: fAArid88 (big blind) folded before Flop
Seat 3: paulscot1 folded before Flop (didn't bet)
Seat 4: Naaarrrr folded before Flop (didn't bet)
Seat 5: johnyguedes1 folded before Flop (didn't bet)
Seat 6: yuzoyai folded before Flop (didn't bet)
Seat 7: junior_re612 folded before Flop (didn't bet)
Seat 8: Amandaraujo (button) collected (3500)

PokerStars Hand #251205388503: Tournament #3767885527, $40+$10+$5 USD Hold'em No Limit - Level X (500/1000) - 2024/06/26 18:51:35 UTC [2024/06/26 14:51:35 ET]
Table '3767885527 37' 8-max Seat #1 is the button
Seat 1: Katwoman0106 (75248 in chips) 
Seat 2: fAArid88 (14065 in chips) 
Seat 3: paulscot1 (29525 in chips) 
Seat 4: Naaarrrr (21475 in chips) 
Seat 5: johnyguedes1 (67086 in chips) 
Seat 6: yuzoyai (36484 in chips) 
Seat 7: junior_re612 (50260 in chips) 
Seat 8: Amandaraujo (47062 in chips) 
Katwoman0106: posts the ante 125
fAArid88: posts the ante 125
paulscot1: posts the ante 125
Naaarrrr: posts the ante 125
johnyguedes1: posts the ante 125
yuzoyai: posts the ante 125
junior_re612: posts the ante 125
Amandaraujo: posts the ante 125
fAArid88: posts small blind 500
paulscot1: posts big blind 1000
*** HOLE CARDS ***
Naaarrrr: folds 
johnyguedes1: folds 
yuzoyai: folds 
junior_re612: raises 1000 to 2000
Amandaraujo: calls 2000
Katwoman0106: folds 
fAArid88: folds 
paulscot1: folds 
*** FLOP *** [Kc 6d 4d]
junior_re612: bets 2150
Amandaraujo: calls 2150
*** TURN *** [Kc 6d 4d] [8c]
junior_re612: checks 
Amandaraujo: bets 6400
junior_re612: folds 
Uncalled bet (6400) returned to Amandaraujo
Amandaraujo collected 10800 from pot
*** SUMMARY ***
Total pot 10800 | Rake 0 
Board [Kc 6d 4d 8c]
Seat 1: Katwoman0106 (button) folded before Flop (didn't bet)
Seat 2: fAArid88 (small blind) folded before Flop
Seat 3: paulscot1 (big blind) folded before Flop
Seat 4: Naaarrrr folded before Flop (didn't bet)
Seat 5: johnyguedes1 folded before Flop (didn't bet)
Seat 6: yuzoyai folded before Flop (didn't bet)
Seat 7: junior_re612 folded on the Turn
Seat 8: Amandaraujo collected (10800)

PokerStars Hand #251205408535: Tournament #3767885527, $40+$10+$5 USD Hold'em No Limit - Level XI (600/1200) - 2024/06/26 18:52:51 UTC [2024/06/26 14:52:51 ET]
Table '3767885527 37' 8-max Seat #2 is the button
Seat 1: Katwoman0106 (75123 in chips) 
Seat 2: fAArid88 (13440 in chips) 
Seat 3: paulscot1 (28400 in chips) 
Seat 4: Naaarrrr (21350 in chips) 
Seat 5: johnyguedes1 (66961 in chips) 
Seat 6: yuzoyai (36359 in chips) 
Seat 7: junior_re612 (45985 in chips) 
Seat 8: Amandaraujo (53587 in chips) 
Katwoman0106: posts the ante 150
fAArid88: posts the ante 150
paulscot1: posts the ante 150
Naaarrrr: posts the ante 150
johnyguedes1: posts the ante 150
yuzoyai: posts the ante 150
junior_re612: posts the ante 150
Amandaraujo: posts the ante 150
paulscot1: posts small blind 600
Naaarrrr: posts big blind 1200
*** HOLE CARDS ***
johnyguedes1: raises 1320 to 2520
yuzoyai: folds 
junior_re612: folds 
Amandaraujo: calls 2520
Katwoman0106: folds 
fAArid88: calls 2520
paulscot1: folds 
Naaarrrr: calls 1320
*** FLOP *** [Ah 2h Kh]
Naaarrrr: checks 
johnyguedes1: checks 
Amandaraujo: checks 
fAArid88: checks 
*** TURN *** [Ah 2h Kh] [5c]
Naaarrrr: checks 
johnyguedes1: checks 
Amandaraujo: checks 
fAArid88: checks 
*** RIVER *** [Ah 2h Kh 5c] [8d]
Naaarrrr: checks 
johnyguedes1: bets 9860
Amandaraujo: folds 
fAArid88: folds 
Naaarrrr: folds 
Uncalled bet (9860) returned to johnyguedes1
johnyguedes1 collected 11880 from pot
johnyguedes1: doesn't show hand 
*** SUMMARY ***
Total pot 11880 | Rake 0 
Board [Ah 2h Kh 5c 8d]
Seat 1: Katwoman0106 folded before Flop (didn't bet)
Seat 2: fAArid88 (button) folded on the River
Seat 3: paulscot1 (small blind) folded before Flop
Seat 4: Naaarrrr (big blind) folded on the River
Seat 5: johnyguedes1 collected (11880)
Seat 6: yuzoyai folded before Flop (didn't bet)
Seat 7: junior_re612 folded before Flop (didn't bet)
Seat 8: Amandaraujo folded on the River

PokerStars Hand #251205436915: Tournament #3767885527, $40+$10+$5 USD Hold'em No Limit - Level XI (600/1200) - 2024/06/26 18:54:39 UTC [2024/06/26 14:54:39 ET]
Table '3767885527 37' 8-max Seat #3 is the button
Seat 1: Katwoman0106 (74973 in chips) 
Seat 2: fAArid88 (10770 in chips) 
Seat 3: paulscot1 (27650 in chips) 
Seat 4: Naaarrrr (18680 in chips) 
Seat 5: johnyguedes1 (76171 in chips) 
Seat 6: yuzoyai (36209 in chips) 
Seat 7: junior_re612 (45835 in chips) 
Seat 8: Amandaraujo (50917 in chips) 
Katwoman0106: posts the ante 150
fAArid88: posts the ante 150
paulscot1: posts the ante 150
Naaarrrr: posts the ante 150
johnyguedes1: posts the ante 150
yuzoyai: posts the ante 150
junior_re612: posts the ante 150
Amandaraujo: posts the ante 150
Naaarrrr: posts small blind 600
johnyguedes1: posts big blind 1200
*** HOLE CARDS ***
yuzoyai: folds 
junior_re612: folds 
Amandaraujo: folds 
Katwoman0106: folds 
fAArid88: folds 
paulscot1: raises 1440 to 2640
Naaarrrr: folds 
johnyguedes1: calls 1440
*** FLOP *** [6c 4d Kh]
johnyguedes1: checks 
paulscot1: bets 2400
johnyguedes1: raises 4440 to 6840
paulscot1: raises 18020 to 24860 and is all-in
johnyguedes1: folds 
Uncalled bet (18020) returned to paulscot1
paulscot1 collected 20760 from pot
paulscot1: doesn't show hand 
*** SUMMARY ***
Total pot 20760 | Rake 0 
Board [6c 4d Kh]
Seat 1: Katwoman0106 folded before Flop (didn't bet)
Seat 2: fAArid88 folded before Flop (didn't bet)
Seat 3: paulscot1 (button) collected (20760)
Seat 4: Naaarrrr (small blind) folded before Flop
Seat 5: johnyguedes1 (big blind) folded on the Flop
Seat 6: yuzoyai folded before Flop (didn't bet)
Seat 7: junior_re612 folded before Flop (didn't bet)
Seat 8: Amandaraujo folded before Flop (didn't bet)

PokerStars Hand #251205528176: Tournament #3767885527, $40+$10+$5 USD Hold'em No Limit - Level XI (600/1200) - 2024/06/26 19:02:04 UTC [2024/06/26 15:02:04 ET]
Table '3767885527 37' 8-max Seat #4 is the button
Seat 1: Katwoman0106 (74823 in chips) 
Seat 2: fAArid88 (10620 in chips) 
Seat 3: paulscot1 (38780 in chips) 
Seat 4: Naaarrrr (17930 in chips) 
Seat 5: johnyguedes1 (66541 in chips) 
Seat 6: yuzoyai (36059 in chips) 
Seat 7: junior_re612 (45685 in chips) 
Seat 8: Amandaraujo (50767 in chips) 
Katwoman0106: posts the ante 150
fAArid88: posts the ante 150
paulscot1: posts the ante 150
Naaarrrr: posts the ante 150
johnyguedes1: posts the ante 150
yuzoyai: posts the ante 150
junior_re612: posts the ante 150
Amandaraujo: posts the ante 150
johnyguedes1: posts small blind 600
yuzoyai: posts big blind 1200
*** HOLE CARDS ***
junior_re612: folds 
Amandaraujo: raises 1200 to 2400
Katwoman0106: folds 
fAArid88: folds 
paulscot1: folds 
Naaarrrr: folds 
johnyguedes1: folds 
yuzoyai: raises 33509 to 35909 and is all-in
Amandaraujo: folds 
Uncalled bet (33509) returned to yuzoyai
yuzoyai collected 6600 from pot
yuzoyai: doesn't show hand 
*** SUMMARY ***
Total pot 6600 | Rake 0 
Seat 1: Katwoman0106 folded before Flop (didn't bet)
Seat 2: fAArid88 folded before Flop (didn't bet)
Seat 3: paulscot1 folded before Flop (didn't bet)
Seat 4: Naaarrrr (button) folded before Flop (didn't bet)
Seat 5: johnyguedes1 (small blind) folded before Flop
Seat 6: yuzoyai (big blind) collected (6600)
Seat 7: junior_re612 folded before Flop (didn't bet)
Seat 8: Amandaraujo folded before Flop

PokerStars Hand #251205539837: Tournament #3767885527, $40+$10+$5 USD Hold'em No Limit - Level XI (600/1200) - 2024/06/26 19:02:52 UTC [2024/06/26 15:02:52 ET]
Table '3767885527 37' 8-max Seat #5 is the button
Seat 1: Katwoman0106 (74673 in chips) 
Seat 2: fAArid88 (10470 in chips) 
Seat 3: paulscot1 (38630 in chips) 
Seat 4: Naaarrrr (17780 in chips) 
Seat 5: johnyguedes1 (65791 in chips) 
Seat 6: yuzoyai (40109 in chips) 
Seat 7: junior_re612 (45535 in chips) 
Seat 8: Amandaraujo (48217 in chips) 
Katwoman0106: posts the ante 150
fAArid88: posts the ante 150
paulscot1: posts the ante 150
Naaarrrr: posts the ante 150
johnyguedes1: posts the ante 150
yuzoyai: posts the ante 150
junior_re612: posts the ante 150
Amandaraujo: posts the ante 150
yuzoyai: posts small blind 600
junior_re612: posts big blind 1200
*** HOLE CARDS ***
Amandaraujo: calls 1200
Katwoman0106: calls 1200
fAArid88: folds 
paulscot1: folds 
Naaarrrr: folds 
johnyguedes1: calls 1200
yuzoyai: calls 600
junior_re612: checks 
*** FLOP *** [6c 3h Qd]
yuzoyai: bets 2376
junior_re612: calls 2376
Amandaraujo: folds 
Katwoman0106: raises 7164 to 9540
johnyguedes1: folds 
yuzoyai: folds 
junior_re612: raises 34645 to 44185 and is all-in
Katwoman0106: folds [Qh]
Uncalled bet (34645) returned to junior_re612
junior_re612 collected 28656 from pot
junior_re612: doesn't show hand 
*** SUMMARY ***
Total pot 28656 | Rake 0 
Board [6c 3h Qd]
Seat 1: Katwoman0106 folded on the Flop
Seat 2: fAArid88 folded before Flop (didn't bet)
Seat 3: paulscot1 folded before Flop (didn't bet)
Seat 4: Naaarrrr folded before Flop (didn't bet)
Seat 5: johnyguedes1 (button) folded on the Flop
Seat 6: yuzoyai (small blind) folded on the Flop
Seat 7: junior_re612 (big blind) collected (28656)
Seat 8: Amandaraujo folded on the Flop

PokerStars Hand #251205565547: Tournament #3767885527, $40+$10+$5 USD Hold'em No Limit - Level XI (600/1200) - 2024/06/26 19:04:33 UTC [2024/06/26 15:04:33 ET]
Table '3767885527 37' 8-max Seat #6 is the button
Seat 1: Katwoman0106 (63783 in chips) 
Seat 2: fAArid88 (10320 in chips) 
Seat 3: paulscot1 (38480 in chips) 
Seat 4: Naaarrrr (17630 in chips) 
Seat 5: johnyguedes1 (64441 in chips) 
Seat 6: yuzoyai (36383 in chips) 
Seat 7: junior_re612 (63301 in chips) 
Seat 8: Amandaraujo (46867 in chips) 
Katwoman0106: posts the ante 150
fAArid88: posts the ante 150
paulscot1: posts the ante 150
Naaarrrr: posts the ante 150
johnyguedes1: posts the ante 150
yuzoyai: posts the ante 150
junior_re612: posts the ante 150
Amandaraujo: posts the ante 150
junior_re612: posts small blind 600
Amandaraujo: posts big blind 1200
*** HOLE CARDS ***
Katwoman0106: folds 
fAArid88: folds 
paulscot1: raises 1980 to 3180
Naaarrrr: raises 14300 to 17480 and is all-in
johnyguedes1: folds 
yuzoyai: folds 
junior_re612: raises 45671 to 63151 and is all-in
Amandaraujo: folds 
paulscot1: folds 
Uncalled bet (45671) returned to junior_re612
*** FLOP *** [3d Qc Th]
*** TURN *** [3d Qc Th] [7h]
*** RIVER *** [3d Qc Th 7h] [3c]
*** SHOW DOWN ***
junior_re612: shows [Kh Ah] (a pair of Threes)
Naaarrrr: shows [Ks Ad] (a pair of Threes)
junior_re612 collected 20270 from pot
Naaarrrr collected 20270 from pot
*** SUMMARY ***
Total pot 40540 | Rake 0 
Board [3d Qc Th 7h 3c]
Seat 1: Katwoman0106 folded before Flop (didn't bet)
Seat 2: fAArid88 folded before Flop (didn't bet)
Seat 3: paulscot1 folded before Flop
Seat 4: Naaarrrr showed [Ks Ad] and won (20270) with a pair of Threes
Seat 5: johnyguedes1 folded before Flop (didn't bet)
Seat 6: yuzoyai (button) folded before Flop (didn't bet)
Seat 7: junior_re612 (small blind) showed [Kh Ah] and won (20270) with a pair of Threes
Seat 8: Amandaraujo (big blind) folded before Flop

PokerStars Hand #251205578140: Tournament #3767885527, $40+$10+$5 USD Hold'em No Limit - Level XI (600/1200) - 2024/06/26 19:05:21 UTC [2024/06/26 15:05:21 ET]
Table '3767885527 37' 8-max Seat #7 is the button
Seat 1: Katwoman0106 (63633 in chips) 
Seat 2: fAArid88 (10170 in chips) 
Seat 3: paulscot1 (35150 in chips) 
Seat 4: Naaarrrr (20270 in chips) 
Seat 5: johnyguedes1 (64291 in chips) 
Seat 6: yuzoyai (36233 in chips) 
Seat 7: junior_re612 (65941 in chips) 
Seat 8: Amandaraujo (45517 in chips) 
Katwoman0106: posts the ante 150
fAArid88: posts the ante 150
paulscot1: posts the ante 150
Naaarrrr: posts the ante 150
johnyguedes1: posts the ante 150
yuzoyai: posts the ante 150
junior_re612: posts the ante 150
Amandaraujo: posts the ante 150
Amandaraujo: posts small blind 600
Katwoman0106: posts big blind 1200
*** HOLE CARDS ***
fAArid88: folds 
paulscot1: folds 
Naaarrrr: folds 
johnyguedes1: folds 
yuzoyai: raises 1200 to 2400
junior_re612: folds 
Amandaraujo: calls 1800
Katwoman0106: folds 
*** FLOP *** [9c 2s 6d]
Amandaraujo: checks 
yuzoyai: checks 
*** TURN *** [9c 2s 6d] [Js]
Amandaraujo: checks 
yuzoyai: bets 3840
Amandaraujo: calls 3840
*** RIVER *** [9c 2s 6d Js] [6s]
Amandaraujo: checks 
yuzoyai: bets 11918
Amandaraujo: folds 
Uncalled bet (11918) returned to yuzoyai
yuzoyai collected 14880 from pot
yuzoyai: doesn't show hand 
*** SUMMARY ***
Total pot 14880 | Rake 0 
Board [9c 2s 6d Js 6s]
Seat 1: Katwoman0106 (big blind) folded before Flop
Seat 2: fAArid88 folded before Flop (didn't bet)
Seat 3: paulscot1 folded before Flop (didn't bet)
Seat 4: Naaarrrr folded before Flop (didn't bet)
Seat 5: johnyguedes1 folded before Flop (didn't bet)
Seat 6: yuzoyai collected (14880)
Seat 7: junior_re612 (button) folded before Flop (didn't bet)
Seat 8: Amandaraujo (small blind) folded on the River

PokerStars Hand #251205601413: Tournament #3767885527, $40+$10+$5 USD Hold'em No Limit - Level XI (600/1200) - 2024/06/26 19:06:49 UTC [2024/06/26 15:06:49 ET]
Table '3767885527 37' 8-max Seat #8 is the button
Seat 1: Katwoman0106 (62283 in chips) 
Seat 2: fAArid88 (10020 in chips) 
Seat 3: paulscot1 (35000 in chips) 
Seat 4: Naaarrrr (20120 in chips) 
Seat 5: johnyguedes1 (64141 in chips) 
Seat 6: yuzoyai (44723 in chips) 
Seat 7: junior_re612 (65791 in chips) 
Seat 8: Amandaraujo (39127 in chips) 
Katwoman0106: posts the ante 150
fAArid88: posts the ante 150
paulscot1: posts the ante 150
Naaarrrr: posts the ante 150
johnyguedes1: posts the ante 150
yuzoyai: posts the ante 150
junior_re612: posts the ante 150
Amandaraujo: posts the ante 150
Katwoman0106: posts small blind 600
fAArid88: posts big blind 1200
*** HOLE CARDS ***
paulscot1: raises 1440 to 2640
Naaarrrr: folds 
johnyguedes1: folds 
yuzoyai: raises 3960 to 6600
junior_re612: folds 
Amandaraujo: calls 6600
Katwoman0106: folds 
fAArid88: folds 
paulscot1: calls 3960
*** FLOP *** [8c Ts 2s]
paulscot1: checks 
yuzoyai: checks 
Amandaraujo: checks 
*** TURN *** [8c Ts 2s] [Kc]
paulscot1: checks 
yuzoyai: bets 11280
Amandaraujo: folds 
paulscot1: calls 11280
*** RIVER *** [8c Ts 2s Kc] [Jc]
paulscot1: checks 
yuzoyai: checks 
*** SHOW DOWN ***
paulscot1: shows [8s 9s] (a pair of Eights)
yuzoyai: shows [Kh Qs] (a pair of Kings)
yuzoyai collected 45360 from pot
*** SUMMARY ***
Total pot 45360 | Rake 0 
Board [8c Ts 2s Kc Jc]
Seat 1: Katwoman0106 (small blind) folded before Flop
Seat 2: fAArid88 (big blind) folded before Flop
Seat 3: paulscot1 showed [8s 9s] and lost with a pair of Eights
Seat 4: Naaarrrr folded before Flop (didn't bet)
Seat 5: johnyguedes1 folded before Flop (didn't bet)
Seat 6: yuzoyai showed [Kh Qs] and won (45360) with a pair of Kings
Seat 7: junior_re612 folded before Flop (didn't bet)
Seat 8: Amandaraujo (button) folded on the Turn

PokerStars Hand #251205627441: Tournament #3767885527, $40+$10+$5 USD Hold'em No Limit - Level XI (600/1200) - 2024/06/26 19:08:27 UTC [2024/06/26 15:08:27 ET]
Table '3767885527 37' 8-max Seat #1 is the button
Seat 1: Katwoman0106 (61533 in chips) 
Seat 2: fAArid88 (8670 in chips) 
Seat 3: paulscot1 (16970 in chips) 
Seat 4: Naaarrrr (19970 in chips) 
Seat 5: johnyguedes1 (63991 in chips) 
Seat 6: yuzoyai (72053 in chips) 
Seat 7: junior_re612 (65641 in chips) 
Seat 8: Amandaraujo (32377 in chips) 
Katwoman0106: posts the ante 150
fAArid88: posts the ante 150
paulscot1: posts the ante 150
Naaarrrr: posts the ante 150
johnyguedes1: posts the ante 150
yuzoyai: posts the ante 150
junior_re612: posts the ante 150
Amandaraujo: posts the ante 150
fAArid88: posts small blind 600
paulscot1: posts big blind 1200
*** HOLE CARDS ***
Naaarrrr: raises 1200 to 2400
johnyguedes1: folds 
yuzoyai: folds 
junior_re612: folds 
Amandaraujo: raises 2400 to 4800
Katwoman0106: folds 
fAArid88: folds 
paulscot1: folds 
Naaarrrr: raises 15020 to 19820 and is all-in
Amandaraujo: calls 15020
*** FLOP *** [3h Ks Kd]
*** TURN *** [3h Ks Kd] [5h]
*** RIVER *** [3h Ks Kd 5h] [6c]
*** SHOW DOWN ***
Naaarrrr: shows [8d 8s] (two pair, Kings and Eights)
Amandaraujo: shows [Kc Js] (three of a kind, Kings)
Amandaraujo collected 42640 from pot
Naaarrrr finished the tournament
*** SUMMARY ***
Total pot 42640 | Rake 0 
Board [3h Ks Kd 5h 6c]
Seat 1: Katwoman0106 (button) folded before Flop (didn't bet)
Seat 2: fAArid88 (small blind) folded before Flop
Seat 3: paulscot1 (big blind) folded before Flop
Seat 4: Naaarrrr showed [8d 8s] and lost with two pair, Kings and Eights
Seat 5: johnyguedes1 folded before Flop (didn't bet)
Seat 6: yuzoyai folded before Flop (didn't bet)
Seat 7: junior_re612 folded before Flop (didn't bet)
Seat 8: Amandaraujo showed [Kc Js] and won (42640) with three of a kind, Kings

PokerStars Hand #251205641324: Tournament #3767885527, $40+$10+$5 USD Hold'em No Limit - Level XII (700/1400) - 2024/06/26 19:09:19 UTC [2024/06/26 15:09:19 ET]
Table '3767885527 37' 8-max Seat #2 is the button
Seat 1: Katwoman0106 (61383 in chips) 
Seat 2: fAArid88 (7920 in chips) 
Seat 3: paulscot1 (15620 in chips) 
Seat 5: johnyguedes1 (63841 in chips) 
Seat 6: yuzoyai (71903 in chips) 
Seat 7: junior_re612 (65491 in chips) 
Seat 8: Amandaraujo (55047 in chips) 
Katwoman0106: posts the ante 175
fAArid88: posts the ante 175
paulscot1: posts the ante 175
johnyguedes1: posts the ante 175
yuzoyai: posts the ante 175
junior_re612: posts the ante 175
Amandaraujo: posts the ante 175
paulscot1: posts small blind 700
johnyguedes1: posts big blind 1400
*** HOLE CARDS ***
yuzoyai: folds 
SWE_CS is disconnected 
junior_re612: folds 
Amandaraujo: folds 
Katwoman0106: raises 1400 to 2800
fAArid88: raises 4945 to 7745 and is all-in
paulscot1: folds 
johnyguedes1: raises 9145 to 16890
Katwoman0106: folds 
Uncalled bet (9145) returned to johnyguedes1
*** FLOP *** [3d Tc Th]
*** TURN *** [3d Tc Th] [4s]
*** RIVER *** [3d Tc Th 4s] [2h]
*** SHOW DOWN ***
johnyguedes1: shows [Ad 9s] (a pair of Tens)
fAArid88: shows [4d Ah] (two pair, Tens and Fours)
fAArid88 collected 20215 from pot
*** SUMMARY ***
Total pot 20215 | Rake 0 
Board [3d Tc Th 4s 2h]
Seat 1: Katwoman0106 folded before Flop
Seat 2: fAArid88 (button) showed [4d Ah] and won (20215) with two pair, Tens and Fours
Seat 3: paulscot1 (small blind) folded before Flop
Seat 5: johnyguedes1 (big blind) showed [Ad 9s] and lost with a pair of Tens
Seat 6: yuzoyai folded before Flop (didn't bet)
Seat 7: junior_re612 folded before Flop (didn't bet)
Seat 8: Amandaraujo folded before Flop (didn't bet)

PokerStars Hand #251205651552: Tournament #3767885527, $40+$10+$5 USD Hold'em No Limit - Level XII (700/1400) - 2024/06/26 19:09:57 UTC [2024/06/26 15:09:57 ET]
Table '3767885527 37' 8-max Seat #3 is the button
Seat 1: Katwoman0106 (58408 in chips) 
Seat 2: fAArid88 (20215 in chips) 
Seat 3: paulscot1 (14745 in chips) 
Seat 4: SWE_CS (25000 in chips) out of hand (moved from another table into small blind)
Seat 5: johnyguedes1 (55921 in chips) 
Seat 6: yuzoyai (71728 in chips) 
Seat 7: junior_re612 (65316 in chips) 
Seat 8: Amandaraujo (54872 in chips) 
SWE_CS will be allowed to play after the button
Katwoman0106: posts the ante 175
fAArid88: posts the ante 175
paulscot1: posts the ante 175
johnyguedes1: posts the ante 175
yuzoyai: posts the ante 175
junior_re612: posts the ante 175
Amandaraujo: posts the ante 175
johnyguedes1: posts small blind 700
yuzoyai: posts big blind 1400
*** HOLE CARDS ***
junior_re612: folds 
Amandaraujo: folds 
Katwoman0106: folds 
fAArid88: folds 
paulscot1: folds 
johnyguedes1: calls 700
yuzoyai: checks 
*** FLOP *** [3c Ac Js]
johnyguedes1: bets 1400
yuzoyai: raises 2952 to 4352
johnyguedes1: calls 2952
*** TURN *** [3c Ac Js] [6h]
johnyguedes1: checks 
yuzoyai: checks 
*** RIVER *** [3c Ac Js 6h] [4s]
johnyguedes1: bets 10565
yuzoyai: folds 
Uncalled bet (10565) returned to johnyguedes1
johnyguedes1 collected 12729 from pot
johnyguedes1: doesn't show hand 
*** SUMMARY ***
Total pot 12729 | Rake 0 
Board [3c Ac Js 6h 4s]
Seat 1: Katwoman0106 folded before Flop (didn't bet)
Seat 2: fAArid88 folded before Flop (didn't bet)
Seat 3: paulscot1 (button) folded before Flop (didn't bet)
Seat 5: johnyguedes1 (small blind) collected (12729)
Seat 6: yuzoyai (big blind) folded on the River
Seat 7: junior_re612 folded before Flop (didn't bet)
Seat 8: Amandaraujo folded before Flop (didn't bet)

PokerStars Hand #251205673323: Tournament #3767885527, $40+$10+$5 USD Hold'em No Limit - Level XII (700/1400) - 2024/06/26 19:11:18 UTC [2024/06/26 15:11:18 ET]
Table '3767885527 37' 8-max Seat #5 is the button
Seat 1: Katwoman0106 (58233 in chips) 
Seat 2: fAArid88 (20040 in chips) 
Seat 3: paulscot1 (14570 in chips) 
Seat 4: SWE_CS (25000 in chips) 
Seat 5: johnyguedes1 (62723 in chips) 
Seat 6: yuzoyai (65801 in chips) 
Seat 7: junior_re612 (65141 in chips) 
Seat 8: Amandaraujo (54697 in chips) 
Katwoman0106: posts the ante 175
fAArid88: posts the ante 175
paulscot1: posts the ante 175
SWE_CS: posts the ante 175
johnyguedes1: posts the ante 175
yuzoyai: posts the ante 175
junior_re612: posts the ante 175
Amandaraujo: posts the ante 175
yuzoyai: posts small blind 700
junior_re612: posts big blind 1400
*** HOLE CARDS ***
Amandaraujo: folds 
Katwoman0106: folds 
fAArid88: folds 
paulscot1: folds 
SWE_CS: folds 
johnyguedes1: raises 1540 to 2940
yuzoyai: folds 
junior_re612: calls 1540
*** FLOP *** [Js 7d 4h]
junior_re612: checks 
johnyguedes1: bets 2633
junior_re612: folds 
Uncalled bet (2633) returned to johnyguedes1
johnyguedes1 collected 7980 from pot
johnyguedes1: doesn't show hand 
*** SUMMARY ***
Total pot 7980 | Rake 0 
Board [Js 7d 4h]
Seat 1: Katwoman0106 folded before Flop (didn't bet)
Seat 2: fAArid88 folded before Flop (didn't bet)
Seat 3: paulscot1 folded before Flop (didn't bet)
Seat 4: SWE_CS folded before Flop (didn't bet)
Seat 5: johnyguedes1 (button) collected (7980)
Seat 6: yuzoyai (small blind) folded before Flop
Seat 7: junior_re612 (big blind) folded on the Flop
Seat 8: Amandaraujo folded before Flop (didn't bet)

PokerStars Hand #251205684942: Tournament #3767885527, $40+$10+$5 USD Hold'em No Limit - Level XII (700/1400) - 2024/06/26 19:12:01 UTC [2024/06/26 15:12:01 ET]
Table '3767885527 37' 8-max Seat #6 is the button
Seat 1: Katwoman0106 (58058 in chips) 
Seat 2: fAArid88 (19865 in chips) 
Seat 3: paulscot1 (14395 in chips) 
Seat 4: SWE_CS (24825 in chips) 
Seat 5: johnyguedes1 (67588 in chips) 
Seat 6: yuzoyai (64926 in chips) 
Seat 7: junior_re612 (62026 in chips) 
Seat 8: Amandaraujo (54522 in chips) 
Katwoman0106: posts the ante 175
fAArid88: posts the ante 175
paulscot1: posts the ante 175
SWE_CS: posts the ante 175
johnyguedes1: posts the ante 175
yuzoyai: posts the ante 175
junior_re612: posts the ante 175
Amandaraujo: posts the ante 175
junior_re612: posts small blind 700
Amandaraujo: posts big blind 1400
*** HOLE CARDS ***
Katwoman0106: folds 
fAArid88: folds 
paulscot1: raises 12820 to 14220 and is all-in
SWE_CS: folds 
johnyguedes1: folds 
yuzoyai: folds 
junior_re612: folds 
Amandaraujo: folds 
Uncalled bet (12820) returned to paulscot1
paulscot1 collected 4900 from pot
paulscot1: doesn't show hand 
*** SUMMARY ***
Total pot 4900 | Rake 0 
Seat 1: Katwoman0106 folded before Flop (didn't bet)
Seat 2: fAArid88 folded before Flop (didn't bet)
Seat 3: paulscot1 collected (4900)
Seat 4: SWE_CS folded before Flop (didn't bet)
Seat 5: johnyguedes1 folded before Flop (didn't bet)
Seat 6: yuzoyai (button) folded before Flop (didn't bet)
Seat 7: junior_re612 (small blind) folded before Flop
Seat 8: Amandaraujo (big blind) folded before Flop

PokerStars Hand #251205694572: Tournament #3767885527, $40+$10+$5 USD Hold'em No Limit - Level XII (700/1400) - 2024/06/26 19:12:36 UTC [2024/06/26 15:12:36 ET]
Table '3767885527 37' 8-max Seat #7 is the button
Seat 1: Katwoman0106 (57883 in chips) 
Seat 2: fAArid88 (19690 in chips) 
Seat 3: paulscot1 (17720 in chips) 
Seat 4: SWE_CS (24650 in chips) 
Seat 5: johnyguedes1 (67413 in chips) 
Seat 6: yuzoyai (64751 in chips) 
Seat 7: junior_re612 (61151 in chips) 
Seat 8: Amandaraujo (52947 in chips) 
Katwoman0106: posts the ante 175
fAArid88: posts the ante 175
paulscot1: posts the ante 175
SWE_CS: posts the ante 175
johnyguedes1: posts the ante 175
yuzoyai: posts the ante 175
junior_re612: posts the ante 175
Amandaraujo: posts the ante 175
Amandaraujo: posts small blind 700
Katwoman0106: posts big blind 1400
*** HOLE CARDS ***
fAArid88: folds 
paulscot1: folds 
SWE_CS: folds 
johnyguedes1: raises 1540 to 2940
yuzoyai: folds 
junior_re612: calls 2940
Amandaraujo: calls 2240
Katwoman0106: calls 1540
*** FLOP *** [2h Jc 6s]
Amandaraujo: checks 
Katwoman0106: checks 
johnyguedes1: checks 
junior_re612: checks 
*** TURN *** [2h Jc 6s] [Jh]
Amandaraujo: checks 
Katwoman0106: bets 7373
johnyguedes1: folds 
junior_re612: folds 
Amandaraujo: folds 
Uncalled bet (7373) returned to Katwoman0106
Katwoman0106 collected 13160 from pot
Katwoman0106: doesn't show hand 
*** SUMMARY ***
Total pot 13160 | Rake 0 
Board [2h Jc 6s Jh]
Seat 1: Katwoman0106 (big blind) collected (13160)
Seat 2: fAArid88 folded before Flop (didn't bet)
Seat 3: paulscot1 folded before Flop (didn't bet)
Seat 4: SWE_CS folded before Flop (didn't bet)
Seat 5: johnyguedes1 folded on the Turn
Seat 6: yuzoyai folded before Flop (didn't bet)
Seat 7: junior_re612 (button) folded on the Turn
Seat 8: Amandaraujo (small blind) folded on the Turn

PokerStars Hand #251205711410: Tournament #3767885527, $40+$10+$5 USD Hold'em No Limit - Level XII (700/1400) - 2024/06/26 19:13:39 UTC [2024/06/26 15:13:39 ET]
Table '3767885527 37' 8-max Seat #8 is the button
Seat 1: Katwoman0106 (67928 in chips) 
Seat 2: fAArid88 (19515 in chips) 
Seat 3: paulscot1 (17545 in chips) 
Seat 4: SWE_CS (24475 in chips) 
Seat 5: johnyguedes1 (64298 in chips) 
Seat 6: yuzoyai (64576 in chips) 
Seat 7: junior_re612 (58036 in chips) 
Seat 8: Amandaraujo (49832 in chips) 
Katwoman0106: posts the ante 175
fAArid88: posts the ante 175
paulscot1: posts the ante 175
SWE_CS: posts the ante 175
johnyguedes1: posts the ante 175
yuzoyai: posts the ante 175
junior_re612: posts the ante 175
Amandaraujo: posts the ante 175
Katwoman0106: posts small blind 700
fAArid88: posts big blind 1400
*** HOLE CARDS ***
paulscot1: folds 
SWE_CS: folds 
johnyguedes1: folds 
yuzoyai: folds 
junior_re612: folds 
Amandaraujo: folds 
Katwoman0106: folds 
Uncalled bet (700) returned to fAArid88
fAArid88 collected 2800 from pot
fAArid88: doesn't show hand 
*** SUMMARY ***
Total pot 2800 | Rake 0 
Seat 1: Katwoman0106 (small blind) folded before Flop
Seat 2: fAArid88 (big blind) collected (2800)
Seat 3: paulscot1 folded before Flop (didn't bet)
Seat 4: SWE_CS folded before Flop (didn't bet)
Seat 5: johnyguedes1 folded before Flop (didn't bet)
Seat 6: yuzoyai folded before Flop (didn't bet)
Seat 7: junior_re612 folded before Flop (didn't bet)
Seat 8: Amandaraujo (button) folded before Flop (didn't bet)

PokerStars Hand #251205721838: Tournament #3767885527, $40+$10+$5 USD Hold'em No Limit - Level XII (700/1400) - 2024/06/26 19:14:17 UTC [2024/06/26 15:14:17 ET]
Table '3767885527 37' 8-max Seat #1 is the button
Seat 1: Katwoman0106 (67053 in chips) 
Seat 2: fAArid88 (21440 in chips) 
Seat 3: paulscot1 (17370 in chips) 
Seat 4: SWE_CS (24300 in chips) 
Seat 5: johnyguedes1 (64123 in chips) 
Seat 6: yuzoyai (64401 in chips) 
Seat 7: junior_re612 (57861 in chips) 
Seat 8: Amandaraujo (49657 in chips) 
Katwoman0106: posts the ante 175
fAArid88: posts the ante 175
paulscot1: posts the ante 175
SWE_CS: posts the ante 175
johnyguedes1: posts the ante 175
yuzoyai: posts the ante 175
junior_re612: posts the ante 175
Amandaraujo: posts the ante 175
fAArid88: posts small blind 700
paulscot1: posts big blind 1400
*** HOLE CARDS ***
SWE_CS: folds 
johnyguedes1: folds 
yuzoyai: folds 
junior_re612: folds 
Amandaraujo: raises 1400 to 2800
Katwoman0106: calls 2800
fAArid88: raises 18465 to 21265 and is all-in
paulscot1: folds 
Amandaraujo: folds 
Katwoman0106: calls 18465
*** FLOP *** [6d 3h 2h]
*** TURN *** [6d 3h 2h] [Qs]
*** RIVER *** [6d 3h 2h Qs] [5c]
*** SHOW DOWN ***
fAArid88: shows [Qd Ks] (a pair of Queens)
Katwoman0106: shows [Ac 9c] (high card Ace)
fAArid88 collected 48130 from pot
*** SUMMARY ***
Total pot 48130 | Rake 0 
Board [6d 3h 2h Qs 5c]
Seat 1: Katwoman0106 (button) showed [Ac 9c] and lost with high card Ace
Seat 2: fAArid88 (small blind) showed [Qd Ks] and won (48130) with a pair of Queens
Seat 3: paulscot1 (big blind) folded before Flop
Seat 4: SWE_CS folded before Flop (didn't bet)
Seat 5: johnyguedes1 folded before Flop (didn't bet)
Seat 6: yuzoyai folded before Flop (didn't bet)
Seat 7: junior_re612 folded before Flop (didn't bet)
Seat 8: Amandaraujo folded before Flop

PokerStars Hand #251205733111: Tournament #3767885527, $40+$10+$5 USD Hold'em No Limit - Level XII (700/1400) - 2024/06/26 19:14:59 UTC [2024/06/26 15:14:59 ET]
Table '3767885527 37' 8-max Seat #2 is the button
Seat 1: Katwoman0106 (45613 in chips) 
Seat 2: fAArid88 (48130 in chips) 
Seat 3: paulscot1 (15795 in chips) 
Seat 4: SWE_CS (24125 in chips) 
Seat 5: johnyguedes1 (63948 in chips) 
Seat 6: yuzoyai (64226 in chips) 
Seat 7: junior_re612 (57686 in chips) 
Seat 8: Amandaraujo (46682 in chips) 
Katwoman0106: posts the ante 175
fAArid88: posts the ante 175
paulscot1: posts the ante 175
SWE_CS: posts the ante 175
johnyguedes1: posts the ante 175
yuzoyai: posts the ante 175
junior_re612: posts the ante 175
Amandaraujo: posts the ante 175
paulscot1: posts small blind 700
SWE_CS: posts big blind 1400
*** HOLE CARDS ***
johnyguedes1: folds 
yuzoyai: folds 
junior_re612: folds 
Amandaraujo: raises 1400 to 2800
Katwoman0106: calls 2800
fAArid88: folds 
paulscot1: folds 
SWE_CS: folds 
*** FLOP *** [8s 3d 8h]
Amandaraujo: checks 
Katwoman0106: checks 
*** TURN *** [8s 3d 8h] [7s]
Amandaraujo: checks 
Katwoman0106: checks 
*** RIVER *** [8s 3d 8h 7s] [6s]
Amandaraujo: checks 
Katwoman0106: checks 
*** SHOW DOWN ***
Amandaraujo: shows [Qd Jd] (a pair of Eights)
Katwoman0106: shows [2c 2h] (two pair, Eights and Deuces)
Katwoman0106 collected 9100 from pot
*** SUMMARY ***
Total pot 9100 | Rake 0 
Board [8s 3d 8h 7s 6s]
Seat 1: Katwoman0106 showed [2c 2h] and won (9100) with two pair, Eights and Deuces
Seat 2: fAArid88 (button) folded before Flop (didn't bet)
Seat 3: paulscot1 (small blind) folded before Flop
Seat 4: SWE_CS (big blind) folded before Flop
Seat 5: johnyguedes1 folded before Flop (didn't bet)
Seat 6: yuzoyai folded before Flop (didn't bet)
Seat 7: junior_re612 folded before Flop (didn't bet)
Seat 8: Amandaraujo showed [Qd Jd] and lost with a pair of Eights

PokerStars Hand #251205743653: Tournament #3767885527, $40+$10+$5 USD Hold'em No Limit - Level XII (700/1400) - 2024/06/26 19:15:38 UTC [2024/06/26 15:15:38 ET]
Table '3767885527 37' 8-max Seat #3 is the button
Seat 1: Katwoman0106 (51738 in chips) 
Seat 2: fAArid88 (47955 in chips) 
Seat 3: paulscot1 (14920 in chips) 
Seat 4: SWE_CS (22550 in chips) 
Seat 5: johnyguedes1 (63773 in chips) 
Seat 6: yuzoyai (64051 in chips) 
Seat 7: junior_re612 (57511 in chips) 
Seat 8: Amandaraujo (43707 in chips) 
Katwoman0106: posts the ante 175
fAArid88: posts the ante 175
paulscot1: posts the ante 175
SWE_CS: posts the ante 175
johnyguedes1: posts the ante 175
yuzoyai: posts the ante 175
junior_re612: posts the ante 175
Amandaraujo: posts the ante 175
SWE_CS: posts small blind 700
johnyguedes1: posts big blind 1400
*** HOLE CARDS ***
yuzoyai: raises 1400 to 2800
junior_re612: folds 
Amandaraujo: calls 2800
Katwoman0106: folds 
fAArid88: raises 8400 to 11200
paulscot1: folds 
SWE_CS: folds 
johnyguedes1: folds 
yuzoyai: folds 
Amandaraujo: calls 8400
*** FLOP *** [Kc 5d 5s]
Amandaraujo: checks 
fAArid88: checks 
*** TURN *** [Kc 5d 5s] [2h]
Amandaraujo: checks 
fAArid88: checks 
*** RIVER *** [Kc 5d 5s 2h] [6d]
Amandaraujo: checks 
fAArid88: bets 8400
Amandaraujo: raises 8400 to 16800
fAArid88: raises 8400 to 25200
Amandaraujo: raises 7132 to 32332 and is all-in
fAArid88: calls 7132
*** SHOW DOWN ***
Amandaraujo: shows [2s 5c] (a full house, Fives full of Deuces)
fAArid88: shows [Kh Kd] (a full house, Kings full of Fives)
fAArid88 collected 93364 from pot
Amandaraujo finished the tournament
*** SUMMARY ***
Total pot 93364 | Rake 0 
Board [Kc 5d 5s 2h 6d]
Seat 1: Katwoman0106 folded before Flop (didn't bet)
Seat 2: fAArid88 showed [Kh Kd] and won (93364) with a full house, Kings full of Fives
Seat 3: paulscot1 (button) folded before Flop (didn't bet)
Seat 4: SWE_CS (small blind) folded before Flop
Seat 5: johnyguedes1 (big blind) folded before Flop
Seat 6: yuzoyai folded before Flop
Seat 7: junior_re612 folded before Flop (didn't bet)
Seat 8: Amandaraujo showed [2s 5c] and lost with a full house, Fives full of Deuces

PokerStars Hand #251205761850: Tournament #3767885527, $40+$10+$5 USD Hold'em No Limit - Level XII (700/1400) - 2024/06/26 19:16:45 UTC [2024/06/26 15:16:45 ET]
Table '3767885527 37' 8-max Seat #4 is the button
Seat 1: Katwoman0106 (51563 in chips) 
Seat 2: fAArid88 (97612 in chips) 
Seat 3: paulscot1 (14745 in chips) 
Seat 4: SWE_CS (21675 in chips) 
Seat 5: johnyguedes1 (62198 in chips) 
Seat 6: yuzoyai (61076 in chips) 
Seat 7: junior_re612 (57336 in chips) 
Katwoman0106: posts the ante 175
fAArid88: posts the ante 175
paulscot1: posts the ante 175
SWE_CS: posts the ante 175
johnyguedes1: posts the ante 175
yuzoyai: posts the ante 175
junior_re612: posts the ante 175
johnyguedes1: posts small blind 700
yuzoyai: posts big blind 1400
*** HOLE CARDS ***
junior_re612: folds 
Katwoman0106: folds 
fAArid88: folds 
paulscot1: raises 13170 to 14570 and is all-in
SWE_CS: folds 
johnyguedes1: folds 
yuzoyai: folds 
Uncalled bet (13170) returned to paulscot1
paulscot1 collected 4725 from pot
paulscot1: doesn't show hand 
*** SUMMARY ***
Total pot 4725 | Rake 0 
Seat 1: Katwoman0106 folded before Flop (didn't bet)
Seat 2: fAArid88 folded before Flop (didn't bet)
Seat 3: paulscot1 collected (4725)
Seat 4: SWE_CS (button) folded before Flop (didn't bet)
Seat 5: johnyguedes1 (small blind) folded before Flop
Seat 6: yuzoyai (big blind) folded before Flop
Seat 7: junior_re612 folded before Flop (didn't bet)

PokerStars Hand #251205771643: Tournament #3767885527, $40+$10+$5 USD Hold'em No Limit - Level XII (700/1400) - 2024/06/26 19:17:20 UTC [2024/06/26 15:17:20 ET]
Table '3767885527 37' 8-max Seat #5 is the button
Seat 1: Katwoman0106 (51388 in chips) 
Seat 2: fAArid88 (97437 in chips) 
Seat 3: paulscot1 (17895 in chips) 
Seat 4: SWE_CS (21500 in chips) 
Seat 5: johnyguedes1 (61323 in chips) 
Seat 6: yuzoyai (59501 in chips) 
Seat 7: junior_re612 (57161 in chips) 
Katwoman0106: posts the ante 175
fAArid88: posts the ante 175
paulscot1: posts the ante 175
SWE_CS: posts the ante 175
johnyguedes1: posts the ante 175
yuzoyai: posts the ante 175
junior_re612: posts the ante 175
yuzoyai: posts small blind 700
junior_re612: posts big blind 1400
*** HOLE CARDS ***
Katwoman0106: raises 1400 to 2800
fAArid88: folds 
paulscot1: folds 
SWE_CS: folds 
johnyguedes1: folds 
yuzoyai: folds 
junior_re612: folds 
Uncalled bet (1400) returned to Katwoman0106
Katwoman0106 collected 4725 from pot
*** SUMMARY ***
Total pot 4725 | Rake 0 
Seat 1: Katwoman0106 collected (4725)
Seat 2: fAArid88 folded before Flop (didn't bet)
Seat 3: paulscot1 folded before Flop (didn't bet)
Seat 4: SWE_CS folded before Flop (didn't bet)
Seat 5: johnyguedes1 (button) folded before Flop (didn't bet)
Seat 6: yuzoyai (small blind) folded before Flop
Seat 7: junior_re612 (big blind) folded before Flop

PokerStars Hand #251205782195: Tournament #3767885527, $40+$10+$5 USD Hold'em No Limit - Level XII (700/1400) - 2024/06/26 19:17:59 UTC [2024/06/26 15:17:59 ET]
Table '3767885527 37' 8-max Seat #6 is the button
Seat 1: Katwoman0106 (54538 in chips) 
Seat 2: fAArid88 (97262 in chips) 
Seat 3: paulscot1 (17720 in chips) 
Seat 4: SWE_CS (21325 in chips) 
Seat 5: johnyguedes1 (61148 in chips) 
Seat 6: yuzoyai (58626 in chips) 
Seat 7: junior_re612 (55586 in chips) 
Katwoman0106: posts the ante 175
fAArid88: posts the ante 175
paulscot1: posts the ante 175
SWE_CS: posts the ante 175
johnyguedes1: posts the ante 175
yuzoyai: posts the ante 175
junior_re612: posts the ante 175
junior_re612: posts small blind 700
Katwoman0106: posts big blind 1400
*** HOLE CARDS ***
fAArid88: folds 
bashfoc2 is disconnected 
paulscot1: folds 
SWE_CS: folds 
johnyguedes1: folds 
yuzoyai: folds 
junior_re612: folds 
Uncalled bet (700) returned to Katwoman0106
Katwoman0106 collected 2625 from pot
*** SUMMARY ***
Total pot 2625 | Rake 0 
Seat 1: Katwoman0106 (big blind) collected (2625)
Seat 2: fAArid88 folded before Flop (didn't bet)
Seat 3: paulscot1 folded before Flop (didn't bet)
Seat 4: SWE_CS folded before Flop (didn't bet)
Seat 5: johnyguedes1 folded before Flop (didn't bet)
Seat 6: yuzoyai (button) folded before Flop (didn't bet)
Seat 7: junior_re612 (small blind) folded before Flop

PokerStars Hand #251205788415: Tournament #3767885527, $40+$10+$5 USD Hold'em No Limit - Level XII (700/1400) - 2024/06/26 19:18:22 UTC [2024/06/26 15:18:22 ET]
Table '3767885527 37' 8-max Seat #7 is the button
Seat 1: Katwoman0106 (56288 in chips) 
Seat 2: fAArid88 (97087 in chips) 
Seat 3: paulscot1 (17545 in chips) 
Seat 4: SWE_CS (21150 in chips) 
Seat 5: johnyguedes1 (60973 in chips) 
Seat 6: yuzoyai (58451 in chips) 
Seat 7: junior_re612 (54711 in chips) 
Seat 8: bashfoc2 (25000 in chips) out of hand (moved from another table into small blind)
bashfoc2 will be allowed to play after the button
Katwoman0106: posts the ante 175
fAArid88: posts the ante 175
paulscot1: posts the ante 175
SWE_CS: posts the ante 175
johnyguedes1: posts the ante 175
yuzoyai: posts the ante 175
junior_re612: posts the ante 175
Katwoman0106: posts small blind 700
fAArid88: posts big blind 1400
*** HOLE CARDS ***
paulscot1: folds 
SWE_CS: folds 
johnyguedes1: raises 1540 to 2940
yuzoyai: folds 
junior_re612: folds 
Katwoman0106: folds 
fAArid88: calls 1540
*** FLOP *** [6s 2s 3s]
fAArid88: checks 
johnyguedes1: bets 1951
fAArid88: raises 7839 to 9790
johnyguedes1: calls 7839
*** TURN *** [6s 2s 3s] [8s]
fAArid88: bets 9800
johnyguedes1: calls 9800
*** RIVER *** [6s 2s 3s 8s] [9c]
fAArid88: bets 26600
johnyguedes1: calls 26600
*** SHOW DOWN ***
fAArid88: shows [4h As] (a flush, Ace high)
johnyguedes1: mucks hand 
fAArid88 collected 100185 from pot
*** SUMMARY ***
Total pot 100185 | Rake 0 
Board [6s 2s 3s 8s 9c]
Seat 1: Katwoman0106 (small blind) folded before Flop
Seat 2: fAArid88 (big blind) showed [4h As] and won (100185) with a flush, Ace high
Seat 3: paulscot1 folded before Flop (didn't bet)
Seat 4: SWE_CS folded before Flop (didn't bet)
Seat 5: johnyguedes1 mucked
Seat 6: yuzoyai folded before Flop (didn't bet)
Seat 7: junior_re612 (button) folded before Flop (didn't bet)

PokerStars Hand #251205813184: Tournament #3767885527, $40+$10+$5 USD Hold'em No Limit - Level XIII (800/1600) - 2024/06/26 19:19:52 UTC [2024/06/26 15:19:52 ET]
Table '3767885527 37' 8-max Seat #1 is the button
Seat 1: Katwoman0106 (55413 in chips) 
Seat 2: fAArid88 (147967 in chips) 
Seat 3: paulscot1 (17370 in chips) 
Seat 4: SWE_CS (20975 in chips) 
Seat 5: johnyguedes1 (11668 in chips) 
Seat 6: yuzoyai (58276 in chips) 
Seat 7: junior_re612 (54536 in chips) 
Seat 8: bashfoc2 (25000 in chips) 
Katwoman0106: posts the ante 200
fAArid88: posts the ante 200
paulscot1: posts the ante 200
SWE_CS: posts the ante 200
johnyguedes1: posts the ante 200
yuzoyai: posts the ante 200
junior_re612: posts the ante 200
bashfoc2: posts the ante 200
fAArid88: posts small blind 800
paulscot1: posts big blind 1600
*** HOLE CARDS ***
SWE_CS: folds 
johnyguedes1: folds 
yuzoyai: folds 
junior_re612: folds 
bashfoc2: raises 4800 to 6400
Katwoman0106: folds 
fAArid88: folds 
paulscot1: folds 
Uncalled bet (4800) returned to bashfoc2
bashfoc2 collected 5600 from pot
bashfoc2: doesn't show hand 
*** SUMMARY ***
Total pot 5600 | Rake 0 
Seat 1: Katwoman0106 (button) folded before Flop (didn't bet)
Seat 2: fAArid88 (small blind) folded before Flop
Seat 3: paulscot1 (big blind) folded before Flop
Seat 4: SWE_CS folded before Flop (didn't bet)
Seat 5: johnyguedes1 folded before Flop (didn't bet)
Seat 6: yuzoyai folded before Flop (didn't bet)
Seat 7: junior_re612 folded before Flop (didn't bet)
Seat 8: bashfoc2 collected (5600)

PokerStars Hand #251205819663: Tournament #3767885527, $40+$10+$5 USD Hold'em No Limit - Level XIII (800/1600) - 2024/06/26 19:20:16 UTC [2024/06/26 15:20:16 ET]
Table '3767885527 37' 8-max Seat #2 is the button
Seat 1: Katwoman0106 (55213 in chips) 
Seat 2: fAArid88 (146967 in chips) 
Seat 3: paulscot1 (15570 in chips) 
Seat 4: SWE_CS (20775 in chips) 
Seat 5: johnyguedes1 (11468 in chips) 
Seat 6: yuzoyai (58076 in chips) 
Seat 7: junior_re612 (54336 in chips) 
Seat 8: bashfoc2 (28800 in chips) 
Katwoman0106: posts the ante 200
fAArid88: posts the ante 200
paulscot1: posts the ante 200
SWE_CS: posts the ante 200
johnyguedes1: posts the ante 200
yuzoyai: posts the ante 200
junior_re612: posts the ante 200
bashfoc2: posts the ante 200
paulscot1: posts small blind 800
SWE_CS: posts big blind 1600
*** HOLE CARDS ***
johnyguedes1: folds 
yuzoyai: folds 
junior_re612: folds 
bashfoc2: folds 
Katwoman0106: raises 1600 to 3200
fAArid88: folds 
paulscot1: folds 
SWE_CS: calls 1600
*** FLOP *** [Jd Ad 3s]
SWE_CS: checks 
Katwoman0106: checks 
*** TURN *** [Jd Ad 3s] [Kd]
SWE_CS: checks 
Katwoman0106: checks 
*** RIVER *** [Jd Ad 3s Kd] [Qd]
SWE_CS: bets 4400
Katwoman0106: folds [Qs Ks]
Uncalled bet (4400) returned to SWE_CS
SWE_CS collected 8800 from pot
SWE_CS: doesn't show hand 
*** SUMMARY ***
Total pot 8800 | Rake 0 
Board [Jd Ad 3s Kd Qd]
Seat 1: Katwoman0106 folded on the River
Seat 2: fAArid88 (button) folded before Flop (didn't bet)
Seat 3: paulscot1 (small blind) folded before Flop
Seat 4: SWE_CS (big blind) collected (8800)
Seat 5: johnyguedes1 folded before Flop (didn't bet)
Seat 6: yuzoyai folded before Flop (didn't bet)
Seat 7: junior_re612 folded before Flop (didn't bet)
Seat 8: bashfoc2 folded before Flop (didn't bet)

PokerStars Hand #251205832214: Tournament #3767885527, $40+$10+$5 USD Hold'em No Limit - Level XIII (800/1600) - 2024/06/26 19:21:02 UTC [2024/06/26 15:21:02 ET]
Table '3767885527 37' 8-max Seat #3 is the button
Seat 1: Katwoman0106 (51813 in chips) 
Seat 2: fAArid88 (146767 in chips) 
Seat 3: paulscot1 (14570 in chips) 
Seat 4: SWE_CS (26175 in chips) 
Seat 5: johnyguedes1 (11268 in chips) 
Seat 6: yuzoyai (57876 in chips) 
Seat 7: junior_re612 (54136 in chips) 
Seat 8: bashfoc2 (28600 in chips) 
Katwoman0106: posts the ante 200
fAArid88: posts the ante 200
paulscot1: posts the ante 200
SWE_CS: posts the ante 200
johnyguedes1: posts the ante 200
yuzoyai: posts the ante 200
junior_re612: posts the ante 200
bashfoc2: posts the ante 200
SWE_CS: posts small blind 800
johnyguedes1: posts big blind 1600
*** HOLE CARDS ***
yuzoyai: raises 1600 to 3200
junior_re612: folds 
bashfoc2: raises 4800 to 8000
Katwoman0106: folds 
fAArid88: folds 
paulscot1: folds 
SWE_CS: raises 17975 to 25975 and is all-in
johnyguedes1: folds 
yuzoyai: raises 31701 to 57676 and is all-in
bashfoc2: calls 20400 and is all-in
Uncalled bet (29276) returned to yuzoyai
*** FLOP *** [4s 7s Ac]
*** TURN *** [4s 7s Ac] [3h]
*** RIVER *** [4s 7s Ac 3h] [Ad]
*** SHOW DOWN ***
yuzoyai: shows [Kh Kc] (two pair, Aces and Kings)
bashfoc2: shows [As Qd] (three of a kind, Aces)
bashfoc2 collected 4850 from side pot
SWE_CS: shows [Qs Qc] (two pair, Aces and Queens)
bashfoc2 collected 81125 from main pot
SWE_CS finished the tournament
*** SUMMARY ***
Total pot 85975 Main pot 81125. Side pot 4850. | Rake 0 
Board [4s 7s Ac 3h Ad]
Seat 1: Katwoman0106 folded before Flop (didn't bet)
Seat 2: fAArid88 folded before Flop (didn't bet)
Seat 3: paulscot1 (button) folded before Flop (didn't bet)
Seat 4: SWE_CS (small blind) showed [Qs Qc] and lost with two pair, Aces and Queens
Seat 5: johnyguedes1 (big blind) folded before Flop
Seat 6: yuzoyai showed [Kh Kc] and lost with two pair, Aces and Kings
Seat 7: junior_re612 folded before Flop (didn't bet)
Seat 8: bashfoc2 showed [As Qd] and won (85975) with three of a kind, Aces


PokerStars Hand #251205591253: Tournament #3767885527, $40+$10+$5 USD Hold'em No Limit - Level XI (600/1200) - 2024/06/26 19:06:11 UTC [2024/06/26 15:06:11 ET]
Table '3767885527 35' 8-max Seat #1 is the button
Seat 1: hiran bass (33141 in chips) 
Seat 2: Famazaja (33260 in chips) 
Seat 3: atg590 (72411 in chips) 
Seat 4: PhoenixGrind (96000 in chips) 
Seat 5: Johevera (49368 in chips) 
Seat 6: sQuezzeYoU!! (44387 in chips) 
Seat 7: jaimico00793 (8393 in chips) 
Seat 8: gwallgofddyn (102599 in chips) 
hiran bass: posts the ante 150
Famazaja: posts the ante 150
atg590: posts the ante 150
PhoenixGrind: posts the ante 150
Johevera: posts the ante 150
sQuezzeYoU!!: posts the ante 150
jaimico00793: posts the ante 150
gwallgofddyn: posts the ante 150
Famazaja: posts small blind 600
atg590: posts big blind 1200
*** HOLE CARDS ***
PhoenixGrind: folds 
Johevera: folds 
sQuezzeYoU!!: folds 
jaimico00793: folds 
gwallgofddyn: raises 1560 to 2760
hiran bass: calls 2760
Famazaja: folds 
atg590: calls 1560
*** FLOP *** [2d 4d Js]
atg590: checks 
gwallgofddyn: bets 4032
hiran bass: folds 
atg590: calls 4032
*** TURN *** [2d 4d Js] [9h]
atg590: checks 
gwallgofddyn: checks 
*** RIVER *** [2d 4d Js 9h] [5s]
atg590: bets 9072
gwallgofddyn: folds 
Uncalled bet (9072) returned to atg590
atg590 collected 18144 from pot
*** SUMMARY ***
Total pot 18144 | Rake 0 
Board [2d 4d Js 9h 5s]
Seat 1: hiran bass (button) folded on the Flop
Seat 2: Famazaja (small blind) folded before Flop
Seat 3: atg590 (big blind) collected (18144)
Seat 4: PhoenixGrind folded before Flop (didn't bet)
Seat 5: Johevera folded before Flop (didn't bet)
Seat 6: sQuezzeYoU!! folded before Flop (didn't bet)
Seat 7: jaimico00793 folded before Flop (didn't bet)
Seat 8: gwallgofddyn folded on the River

PokerStars Hand #251205606358: Tournament #3767885527, $40+$10+$5 USD Hold'em No Limit - Level XI (600/1200) - 2024/06/26 19:07:07 UTC [2024/06/26 15:07:07 ET]
Table '3767885527 35' 8-max Seat #2 is the button
Seat 1: hiran bass (30231 in chips) 
Seat 2: Famazaja (32510 in chips) 
Seat 3: atg590 (83613 in chips) 
Seat 4: PhoenixGrind (95850 in chips) 
Seat 5: Johevera (49218 in chips) 
Seat 6: sQuezzeYoU!! (44237 in chips) 
Seat 7: jaimico00793 (8243 in chips) 
Seat 8: gwallgofddyn (95657 in chips) 
hiran bass: posts the ante 150
Famazaja: posts the ante 150
atg590: posts the ante 150
PhoenixGrind: posts the ante 150
Johevera: posts the ante 150
sQuezzeYoU!!: posts the ante 150
jaimico00793: posts the ante 150
gwallgofddyn: posts the ante 150
atg590: posts small blind 600
PhoenixGrind: posts big blind 1200
*** HOLE CARDS ***
Johevera: folds 
sQuezzeYoU!!: folds 
jaimico00793: raises 6893 to 8093 and is all-in
gwallgofddyn: folds 
hiran bass: folds 
Famazaja: folds 
atg590: folds 
PhoenixGrind: calls 6893
*** FLOP *** [Qs 9h 5d]
*** TURN *** [Qs 9h 5d] [Ac]
*** RIVER *** [Qs 9h 5d Ac] [8d]
*** SHOW DOWN ***
PhoenixGrind: shows [Kd 3d] (high card Ace)
jaimico00793: shows [Qc Ad] (two pair, Aces and Queens)
jaimico00793 collected 17986 from pot
*** SUMMARY ***
Total pot 17986 | Rake 0 
Board [Qs 9h 5d Ac 8d]
Seat 1: hiran bass folded before Flop (didn't bet)
Seat 2: Famazaja (button) folded before Flop (didn't bet)
Seat 3: atg590 (small blind) folded before Flop
Seat 4: PhoenixGrind (big blind) showed [Kd 3d] and lost with high card Ace
Seat 5: Johevera folded before Flop (didn't bet)
Seat 6: sQuezzeYoU!! folded before Flop (didn't bet)
Seat 7: jaimico00793 showed [Qc Ad] and won (17986) with two pair, Aces and Queens
Seat 8: gwallgofddyn folded before Flop (didn't bet)

PokerStars Hand #251205612998: Tournament #3767885527, $40+$10+$5 USD Hold'em No Limit - Level XI (600/1200) - 2024/06/26 19:07:32 UTC [2024/06/26 15:07:32 ET]
Table '3767885527 35' 8-max Seat #3 is the button
Seat 1: hiran bass (30081 in chips) 
Seat 2: Famazaja (32360 in chips) 
Seat 3: atg590 (82863 in chips) 
Seat 4: PhoenixGrind (87607 in chips) 
Seat 5: Johevera (49068 in chips) 
Seat 6: sQuezzeYoU!! (44087 in chips) 
Seat 7: jaimico00793 (17986 in chips) 
Seat 8: gwallgofddyn (95507 in chips) 
hiran bass: posts the ante 150
Famazaja: posts the ante 150
atg590: posts the ante 150
PhoenixGrind: posts the ante 150
Johevera: posts the ante 150
sQuezzeYoU!!: posts the ante 150
jaimico00793: posts the ante 150
gwallgofddyn: posts the ante 150
PhoenixGrind: posts small blind 600
Johevera: posts big blind 1200
*** HOLE CARDS ***
sQuezzeYoU!!: folds 
jaimico00793: folds 
gwallgofddyn: raises 1560 to 2760
hiran bass: raises 3840 to 6600
Famazaja: folds 
atg590: folds 
PhoenixGrind: folds 
Johevera: folds 
gwallgofddyn: calls 3840
*** FLOP *** [7c Qc Kh]
gwallgofddyn: checks 
hiran bass: checks 
*** TURN *** [7c Qc Kh] [9h]
gwallgofddyn: checks 
hiran bass: checks 
*** RIVER *** [7c Qc Kh 9h] [5c]
gwallgofddyn: bets 6480
hiran bass: folds 
Uncalled bet (6480) returned to gwallgofddyn
gwallgofddyn collected 16200 from pot
gwallgofddyn: doesn't show hand 
*** SUMMARY ***
Total pot 16200 | Rake 0 
Board [7c Qc Kh 9h 5c]
Seat 1: hiran bass folded on the River
Seat 2: Famazaja folded before Flop (didn't bet)
Seat 3: atg590 (button) folded before Flop (didn't bet)
Seat 4: PhoenixGrind (small blind) folded before Flop
Seat 5: Johevera (big blind) folded before Flop
Seat 6: sQuezzeYoU!! folded before Flop (didn't bet)
Seat 7: jaimico00793 folded before Flop (didn't bet)
Seat 8: gwallgofddyn collected (16200)

PokerStars Hand #251205632476: Tournament #3767885527, $40+$10+$5 USD Hold'em No Limit - Level XI (600/1200) - 2024/06/26 19:08:46 UTC [2024/06/26 15:08:46 ET]
Table '3767885527 35' 8-max Seat #4 is the button
Seat 1: hiran bass (23331 in chips) 
Seat 2: Famazaja (32210 in chips) 
Seat 3: atg590 (82713 in chips) 
Seat 4: PhoenixGrind (86857 in chips) 
Seat 5: Johevera (47718 in chips) 
Seat 6: sQuezzeYoU!! (43937 in chips) 
Seat 7: jaimico00793 (17836 in chips) 
Seat 8: gwallgofddyn (104957 in chips) 
hiran bass: posts the ante 150
Famazaja: posts the ante 150
atg590: posts the ante 150
PhoenixGrind: posts the ante 150
Johevera: posts the ante 150
sQuezzeYoU!!: posts the ante 150
jaimico00793: posts the ante 150
gwallgofddyn: posts the ante 150
Johevera: posts small blind 600
sQuezzeYoU!!: posts big blind 1200
*** HOLE CARDS ***
jaimico00793: folds 
gwallgofddyn: folds 
hiran bass: folds 
Famazaja: folds 
atg590: folds 
PhoenixGrind: raises 1800 to 3000
Johevera: folds 
sQuezzeYoU!!: folds 
Uncalled bet (1800) returned to PhoenixGrind
PhoenixGrind collected 4200 from pot
PhoenixGrind: doesn't show hand 
*** SUMMARY ***
Total pot 4200 | Rake 0 
Seat 1: hiran bass folded before Flop (didn't bet)
Seat 2: Famazaja folded before Flop (didn't bet)
Seat 3: atg590 folded before Flop (didn't bet)
Seat 4: PhoenixGrind (button) collected (4200)
Seat 5: Johevera (small blind) folded before Flop
Seat 6: sQuezzeYoU!! (big blind) folded before Flop
Seat 7: jaimico00793 folded before Flop (didn't bet)
Seat 8: gwallgofddyn folded before Flop (didn't bet)

PokerStars Hand #251205637604: Tournament #3767885527, $40+$10+$5 USD Hold'em No Limit - Level XI (600/1200) - 2024/06/26 19:09:05 UTC [2024/06/26 15:09:05 ET]
Table '3767885527 35' 8-max Seat #5 is the button
Seat 1: hiran bass (23181 in chips) 
Seat 2: Famazaja (32060 in chips) 
Seat 3: atg590 (82563 in chips) 
Seat 4: PhoenixGrind (89707 in chips) 
Seat 5: Johevera (46968 in chips) 
Seat 6: sQuezzeYoU!! (42587 in chips) 
Seat 7: jaimico00793 (17686 in chips) 
Seat 8: gwallgofddyn (104807 in chips) 
hiran bass: posts the ante 150
Famazaja: posts the ante 150
atg590: posts the ante 150
PhoenixGrind: posts the ante 150
Johevera: posts the ante 150
sQuezzeYoU!!: posts the ante 150
jaimico00793: posts the ante 150
gwallgofddyn: posts the ante 150
sQuezzeYoU!!: posts small blind 600
jaimico00793: posts big blind 1200
*** HOLE CARDS ***
gwallgofddyn: folds 
hiran bass: folds 
Famazaja: raises 1200 to 2400
atg590: folds 
PhoenixGrind: folds 
Johevera: folds 
sQuezzeYoU!!: calls 1800
jaimico00793: folds 
*** FLOP *** [8c 7c Kh]
sQuezzeYoU!!: checks 
Famazaja: bets 3600
sQuezzeYoU!!: calls 3600
*** TURN *** [8c 7c Kh] [3d]
sQuezzeYoU!!: checks 
Famazaja: checks 
*** RIVER *** [8c 7c Kh 3d] [8h]
sQuezzeYoU!!: bets 8496
Famazaja: folds 
Uncalled bet (8496) returned to sQuezzeYoU!!
sQuezzeYoU!! collected 14400 from pot
sQuezzeYoU!!: doesn't show hand 
*** SUMMARY ***
Total pot 14400 | Rake 0 
Board [8c 7c Kh 3d 8h]
Seat 1: hiran bass folded before Flop (didn't bet)
Seat 2: Famazaja folded on the River
Seat 3: atg590 folded before Flop (didn't bet)
Seat 4: PhoenixGrind folded before Flop (didn't bet)
Seat 5: Johevera (button) folded before Flop (didn't bet)
Seat 6: sQuezzeYoU!! (small blind) collected (14400)
Seat 7: jaimico00793 (big blind) folded before Flop
Seat 8: gwallgofddyn folded before Flop (didn't bet)

PokerStars Hand #251205652966: Tournament #3767885527, $40+$10+$5 USD Hold'em No Limit - Level XII (700/1400) - 2024/06/26 19:10:02 UTC [2024/06/26 15:10:02 ET]
Table '3767885527 35' 8-max Seat #6 is the button
Seat 1: hiran bass (23031 in chips) 
Seat 2: Famazaja (25910 in chips) 
Seat 3: atg590 (82413 in chips) 
Seat 4: PhoenixGrind (89557 in chips) 
Seat 5: Johevera (46818 in chips) 
Seat 6: sQuezzeYoU!! (50837 in chips) 
Seat 7: jaimico00793 (16336 in chips) 
Seat 8: gwallgofddyn (104657 in chips) 
hiran bass: posts the ante 175
Famazaja: posts the ante 175
atg590: posts the ante 175
PhoenixGrind: posts the ante 175
Johevera: posts the ante 175
sQuezzeYoU!!: posts the ante 175
jaimico00793: posts the ante 175
gwallgofddyn: posts the ante 175
jaimico00793: posts small blind 700
gwallgofddyn: posts big blind 1400
*** HOLE CARDS ***
hiran bass: folds 
Famazaja: folds 
atg590: folds 
PhoenixGrind has timed out
PhoenixGrind: folds 
PhoenixGrind is sitting out
Johevera: raises 1540 to 2940
sQuezzeYoU!!: folds 
PhoenixGrind has returned
jaimico00793: folds 
gwallgofddyn: calls 1540
*** FLOP *** [Qd Kc Ts]
gwallgofddyn: checks 
Johevera: bets 5985
gwallgofddyn: calls 5985
*** TURN *** [Qd Kc Ts] [Qh]
gwallgofddyn: checks 
Johevera: checks 
*** RIVER *** [Qd Kc Ts Qh] [2s]
gwallgofddyn: bets 16100
Johevera: folds 
Uncalled bet (16100) returned to gwallgofddyn
gwallgofddyn collected 19950 from pot
gwallgofddyn: doesn't show hand 
*** SUMMARY ***
Total pot 19950 | Rake 0 
Board [Qd Kc Ts Qh 2s]
Seat 1: hiran bass folded before Flop (didn't bet)
Seat 2: Famazaja folded before Flop (didn't bet)
Seat 3: atg590 folded before Flop (didn't bet)
Seat 4: PhoenixGrind folded before Flop (didn't bet)
Seat 5: Johevera folded on the River
Seat 6: sQuezzeYoU!! (button) folded before Flop (didn't bet)
Seat 7: jaimico00793 (small blind) folded before Flop
Seat 8: gwallgofddyn (big blind) collected (19950)

PokerStars Hand #251205674037: Tournament #3767885527, $40+$10+$5 USD Hold'em No Limit - Level XII (700/1400) - 2024/06/26 19:11:21 UTC [2024/06/26 15:11:21 ET]
Table '3767885527 35' 8-max Seat #7 is the button
Seat 1: hiran bass (22856 in chips) 
Seat 2: Famazaja (25735 in chips) 
Seat 3: atg590 (82238 in chips) 
Seat 4: PhoenixGrind (89382 in chips) 
Seat 5: Johevera (37718 in chips) 
Seat 6: sQuezzeYoU!! (50662 in chips) 
Seat 7: jaimico00793 (15461 in chips) 
Seat 8: gwallgofddyn (115507 in chips) 
hiran bass: posts the ante 175
Famazaja: posts the ante 175
atg590: posts the ante 175
PhoenixGrind: posts the ante 175
Johevera: posts the ante 175
sQuezzeYoU!!: posts the ante 175
jaimico00793: posts the ante 175
gwallgofddyn: posts the ante 175
gwallgofddyn: posts small blind 700
hiran bass: posts big blind 1400
*** HOLE CARDS ***
Famazaja: raises 1400 to 2800
atg590: folds 
PhoenixGrind: folds 
Johevera: folds 
sQuezzeYoU!!: raises 5600 to 8400
jaimico00793: folds 
gwallgofddyn: folds 
hiran bass: folds 
Famazaja: folds 
Uncalled bet (5600) returned to sQuezzeYoU!!
sQuezzeYoU!! collected 9100 from pot
sQuezzeYoU!!: doesn't show hand 
*** SUMMARY ***
Total pot 9100 | Rake 0 
Seat 1: hiran bass (big blind) folded before Flop
Seat 2: Famazaja folded before Flop
Seat 3: atg590 folded before Flop (didn't bet)
Seat 4: PhoenixGrind folded before Flop (didn't bet)
Seat 5: Johevera folded before Flop (didn't bet)
Seat 6: sQuezzeYoU!! collected (9100)
Seat 7: jaimico00793 (button) folded before Flop (didn't bet)
Seat 8: gwallgofddyn (small blind) folded before Flop

PokerStars Hand #251205684914: Tournament #3767885527, $40+$10+$5 USD Hold'em No Limit - Level XII (700/1400) - 2024/06/26 19:12:01 UTC [2024/06/26 15:12:01 ET]
Table '3767885527 35' 8-max Seat #8 is the button
Seat 1: hiran bass (21281 in chips) 
Seat 2: Famazaja (22760 in chips) 
Seat 3: atg590 (82063 in chips) 
Seat 4: PhoenixGrind (89207 in chips) 
Seat 5: Johevera (37543 in chips) 
Seat 6: sQuezzeYoU!! (56787 in chips) 
Seat 7: jaimico00793 (15286 in chips) 
Seat 8: gwallgofddyn (114632 in chips) 
hiran bass: posts the ante 175
Famazaja: posts the ante 175
atg590: posts the ante 175
PhoenixGrind: posts the ante 175
Johevera: posts the ante 175
sQuezzeYoU!!: posts the ante 175
jaimico00793: posts the ante 175
gwallgofddyn: posts the ante 175
hiran bass: posts small blind 700
Famazaja: posts big blind 1400
*** HOLE CARDS ***
atg590: folds 
PhoenixGrind: folds 
Johevera: folds 
sQuezzeYoU!!: folds 
jaimico00793: folds 
gwallgofddyn: folds 
hiran bass: raises 19706 to 21106 and is all-in
Famazaja: folds 
Uncalled bet (19706) returned to hiran bass
hiran bass collected 4200 from pot
hiran bass: doesn't show hand 
*** SUMMARY ***
Total pot 4200 | Rake 0 
Seat 1: hiran bass (small blind) collected (4200)
Seat 2: Famazaja (big blind) folded before Flop
Seat 3: atg590 folded before Flop (didn't bet)
Seat 4: PhoenixGrind folded before Flop (didn't bet)
Seat 5: Johevera folded before Flop (didn't bet)
Seat 6: sQuezzeYoU!! folded before Flop (didn't bet)
Seat 7: jaimico00793 folded before Flop (didn't bet)
Seat 8: gwallgofddyn (button) folded before Flop (didn't bet)

PokerStars Hand #251205690421: Tournament #3767885527, $40+$10+$5 USD Hold'em No Limit - Level XII (700/1400) - 2024/06/26 19:12:21 UTC [2024/06/26 15:12:21 ET]
Table '3767885527 35' 8-max Seat #1 is the button
Seat 1: hiran bass (23906 in chips) 
Seat 2: Famazaja (21185 in chips) 
Seat 3: atg590 (81888 in chips) 
Seat 4: PhoenixGrind (89032 in chips) 
Seat 5: Johevera (37368 in chips) 
Seat 6: sQuezzeYoU!! (56612 in chips) 
Seat 7: jaimico00793 (15111 in chips) 
Seat 8: gwallgofddyn (114457 in chips) 
hiran bass: posts the ante 175
Famazaja: posts the ante 175
atg590: posts the ante 175
PhoenixGrind: posts the ante 175
Johevera: posts the ante 175
sQuezzeYoU!!: posts the ante 175
jaimico00793: posts the ante 175
gwallgofddyn: posts the ante 175
Famazaja: posts small blind 700
atg590: posts big blind 1400
*** HOLE CARDS ***
PhoenixGrind: folds 
Johevera: folds 
sQuezzeYoU!!: folds 
jaimico00793: folds 
gwallgofddyn: raises 1820 to 3220
hiran bass: folds 
Famazaja: folds 
atg590: folds 
Uncalled bet (1820) returned to gwallgofddyn
gwallgofddyn collected 4900 from pot
gwallgofddyn: doesn't show hand 
*** SUMMARY ***
Total pot 4900 | Rake 0 
Seat 1: hiran bass (button) folded before Flop (didn't bet)
Seat 2: Famazaja (small blind) folded before Flop
Seat 3: atg590 (big blind) folded before Flop
Seat 4: PhoenixGrind folded before Flop (didn't bet)
Seat 5: Johevera folded before Flop (didn't bet)
Seat 6: sQuezzeYoU!! folded before Flop (didn't bet)
Seat 7: jaimico00793 folded before Flop (didn't bet)
Seat 8: gwallgofddyn collected (4900)

PokerStars Hand #251205696633: Tournament #3767885527, $40+$10+$5 USD Hold'em No Limit - Level XII (700/1400) - 2024/06/26 19:12:44 UTC [2024/06/26 15:12:44 ET]
Table '3767885527 35' 8-max Seat #2 is the button
Seat 1: hiran bass (23731 in chips) 
Seat 2: Famazaja (20310 in chips) 
Seat 3: atg590 (80313 in chips) 
Seat 4: PhoenixGrind (88857 in chips) 
Seat 5: Johevera (37193 in chips) 
Seat 6: sQuezzeYoU!! (56437 in chips) 
Seat 7: jaimico00793 (14936 in chips) 
Seat 8: gwallgofddyn (117782 in chips) 
hiran bass: posts the ante 175
Famazaja: posts the ante 175
atg590: posts the ante 175
PhoenixGrind: posts the ante 175
Johevera: posts the ante 175
sQuezzeYoU!!: posts the ante 175
jaimico00793: posts the ante 175
gwallgofddyn: posts the ante 175
atg590: posts small blind 700
PhoenixGrind: posts big blind 1400
*** HOLE CARDS ***
Johevera: folds 
sQuezzeYoU!!: folds 
jaimico00793: folds 
gwallgofddyn: raises 1820 to 3220
hiran bass: folds 
Famazaja: calls 3220
atg590: folds 
PhoenixGrind: folds 
*** FLOP *** [Kh 6d 3d]
gwallgofddyn: bets 2800
Famazaja: raises 14115 to 16915 and is all-in
gwallgofddyn: calls 14115
*** TURN *** [Kh 6d 3d] [6s]
*** RIVER *** [Kh 6d 3d 6s] [Ac]
*** SHOW DOWN ***
gwallgofddyn: shows [Kc 8c] (two pair, Kings and Sixes)
Famazaja: shows [8d 9d] (a pair of Sixes)
gwallgofddyn collected 43770 from pot
Famazaja finished the tournament
*** SUMMARY ***
Total pot 43770 | Rake 0 
Board [Kh 6d 3d 6s Ac]
Seat 1: hiran bass folded before Flop (didn't bet)
Seat 2: Famazaja (button) showed [8d 9d] and lost with a pair of Sixes
Seat 3: atg590 (small blind) folded before Flop
Seat 4: PhoenixGrind (big blind) folded before Flop
Seat 5: Johevera folded before Flop (didn't bet)
Seat 6: sQuezzeYoU!! folded before Flop (didn't bet)
Seat 7: jaimico00793 folded before Flop (didn't bet)
Seat 8: gwallgofddyn showed [Kc 8c] and won (43770) with two pair, Kings and Sixes

PokerStars Hand #251205716395: Tournament #3767885527, $40+$10+$5 USD Hold'em No Limit - Level XII (700/1400) - 2024/06/26 19:13:57 UTC [2024/06/26 15:13:57 ET]
Table '3767885527 35' 8-max Seat #3 is the button
Seat 1: hiran bass (23556 in chips) 
Seat 3: atg590 (79438 in chips) 
Seat 4: PhoenixGrind (87282 in chips) 
Seat 5: Johevera (37018 in chips) 
Seat 6: sQuezzeYoU!! (56262 in chips) 
Seat 7: jaimico00793 (14761 in chips) 
Seat 8: gwallgofddyn (141242 in chips) 
hiran bass: posts the ante 175
atg590: posts the ante 175
PhoenixGrind: posts the ante 175
Johevera: posts the ante 175
sQuezzeYoU!!: posts the ante 175
jaimico00793: posts the ante 175
gwallgofddyn: posts the ante 175
PhoenixGrind: posts small blind 700
Johevera: posts big blind 1400
*** HOLE CARDS ***
sQuezzeYoU!!: folds 
jaimico00793: raises 13186 to 14586 and is all-in
gwallgofddyn: folds 
hiran bass: folds 
atg590: folds 
PhoenixGrind: folds 
StoraEss is disconnected 
Johevera: folds 
Uncalled bet (13186) returned to jaimico00793
jaimico00793 collected 4725 from pot
jaimico00793: doesn't show hand 
*** SUMMARY ***
Total pot 4725 | Rake 0 
Seat 1: hiran bass folded before Flop (didn't bet)
Seat 3: atg590 (button) folded before Flop (didn't bet)
Seat 4: PhoenixGrind (small blind) folded before Flop
Seat 5: Johevera (big blind) folded before Flop
Seat 6: sQuezzeYoU!! folded before Flop (didn't bet)
Seat 7: jaimico00793 collected (4725)
Seat 8: gwallgofddyn folded before Flop (didn't bet)

PokerStars Hand #251205723452: Tournament #3767885527, $40+$10+$5 USD Hold'em No Limit - Level XII (700/1400) - 2024/06/26 19:14:23 UTC [2024/06/26 15:14:23 ET]
Table '3767885527 35' 8-max Seat #4 is the button
Seat 1: hiran bass (23381 in chips) 
Seat 2: StoraEss (25000 in chips) 
Seat 3: atg590 (79263 in chips) 
Seat 4: PhoenixGrind (86407 in chips) 
Seat 5: Johevera (35443 in chips) 
Seat 6: sQuezzeYoU!! (56087 in chips) 
Seat 7: jaimico00793 (17911 in chips) 
Seat 8: gwallgofddyn (141067 in chips) 
hiran bass: posts the ante 175
StoraEss: posts the ante 175
atg590: posts the ante 175
PhoenixGrind: posts the ante 175
Johevera: posts the ante 175
sQuezzeYoU!!: posts the ante 175
jaimico00793: posts the ante 175
gwallgofddyn: posts the ante 175
Johevera: posts small blind 700
sQuezzeYoU!!: posts big blind 1400
*** HOLE CARDS ***
jaimico00793: folds 
gwallgofddyn: raises 1820 to 3220
hiran bass: folds 
StoraEss: folds 
atg590: calls 3220
PhoenixGrind: folds 
Johevera: folds 
sQuezzeYoU!!: folds 
*** FLOP *** [3d Qh Qc]
gwallgofddyn: checks 
atg590: checks 
*** TURN *** [3d Qh Qc] [Qd]
gwallgofddyn: checks 
atg590: bets 4200
gwallgofddyn: calls 4200
*** RIVER *** [3d Qh Qc Qd] [6d]
gwallgofddyn: checks 
atg590: bets 9170
gwallgofddyn: folds 
Uncalled bet (9170) returned to atg590
atg590 collected 18340 from pot
*** SUMMARY ***
Total pot 18340 | Rake 0 
Board [3d Qh Qc Qd 6d]
Seat 1: hiran bass folded before Flop (didn't bet)
Seat 2: StoraEss folded before Flop (didn't bet)
Seat 3: atg590 collected (18340)
Seat 4: PhoenixGrind (button) folded before Flop (didn't bet)
Seat 5: Johevera (small blind) folded before Flop
Seat 6: sQuezzeYoU!! (big blind) folded before Flop
Seat 7: jaimico00793 folded before Flop (didn't bet)
Seat 8: gwallgofddyn folded on the River

PokerStars Hand #251205738663: Tournament #3767885527, $40+$10+$5 USD Hold'em No Limit - Level XII (700/1400) - 2024/06/26 19:15:19 UTC [2024/06/26 15:15:19 ET]
Table '3767885527 35' 8-max Seat #5 is the button
Seat 1: hiran bass (23206 in chips) 
Seat 2: StoraEss (24825 in chips) 
Seat 3: atg590 (90008 in chips) 
Seat 4: PhoenixGrind (86232 in chips) 
Seat 5: Johevera (34568 in chips) 
Seat 6: sQuezzeYoU!! (54512 in chips) 
Seat 7: jaimico00793 (17736 in chips) 
Seat 8: gwallgofddyn (133472 in chips) 
hiran bass: posts the ante 175
StoraEss: posts the ante 175
atg590: posts the ante 175
PhoenixGrind: posts the ante 175
Johevera: posts the ante 175
sQuezzeYoU!!: posts the ante 175
jaimico00793: posts the ante 175
gwallgofddyn: posts the ante 175
sQuezzeYoU!!: posts small blind 700
jaimico00793: posts big blind 1400
*** HOLE CARDS ***
gwallgofddyn: folds 
hiran bass: folds 
StoraEss: folds 
atg590: folds 
PhoenixGrind: raises 2100 to 3500
Johevera: folds 
sQuezzeYoU!!: folds 
jaimico00793: folds 
Uncalled bet (2100) returned to PhoenixGrind
PhoenixGrind collected 4900 from pot
PhoenixGrind: doesn't show hand 
*** SUMMARY ***
Total pot 4900 | Rake 0 
Seat 1: hiran bass folded before Flop (didn't bet)
Seat 2: StoraEss folded before Flop (didn't bet)
Seat 3: atg590 folded before Flop (didn't bet)
Seat 4: PhoenixGrind collected (4900)
Seat 5: Johevera (button) folded before Flop (didn't bet)
Seat 6: sQuezzeYoU!! (small blind) folded before Flop
Seat 7: jaimico00793 (big blind) folded before Flop
Seat 8: gwallgofddyn folded before Flop (didn't bet)

PokerStars Hand #251205745892: Tournament #3767885527, $40+$10+$5 USD Hold'em No Limit - Level XII (700/1400) - 2024/06/26 19:15:46 UTC [2024/06/26 15:15:46 ET]
Table '3767885527 35' 8-max Seat #6 is the button
Seat 1: hiran bass (23031 in chips) 
Seat 2: StoraEss (24650 in chips) 
Seat 3: atg590 (89833 in chips) 
Seat 4: PhoenixGrind (89557 in chips) 
Seat 5: Johevera (34393 in chips) 
Seat 6: sQuezzeYoU!! (53637 in chips) 
Seat 7: jaimico00793 (16161 in chips) 
Seat 8: gwallgofddyn (133297 in chips) 
hiran bass: posts the ante 175
StoraEss: posts the ante 175
atg590: posts the ante 175
PhoenixGrind: posts the ante 175
Johevera: posts the ante 175
sQuezzeYoU!!: posts the ante 175
jaimico00793: posts the ante 175
gwallgofddyn: posts the ante 175
jaimico00793: posts small blind 700
gwallgofddyn: posts big blind 1400
*** HOLE CARDS ***
hiran bass: raises 1400 to 2800
StoraEss: folds 
atg590: folds 
PhoenixGrind: folds 
Johevera: folds 
sQuezzeYoU!!: folds 
jaimico00793: folds 
gwallgofddyn: calls 1400
*** FLOP *** [6s 6h 3s]
gwallgofddyn: checks 
hiran bass: bets 2541
gwallgofddyn: raises 5159 to 7700
hiran bass: folds 
Uncalled bet (5159) returned to gwallgofddyn
gwallgofddyn collected 12782 from pot
gwallgofddyn: doesn't show hand 
*** SUMMARY ***
Total pot 12782 | Rake 0 
Board [6s 6h 3s]
Seat 1: hiran bass folded on the Flop
Seat 2: StoraEss folded before Flop (didn't bet)
Seat 3: atg590 folded before Flop (didn't bet)
Seat 4: PhoenixGrind folded before Flop (didn't bet)
Seat 5: Johevera folded before Flop (didn't bet)
Seat 6: sQuezzeYoU!! (button) folded before Flop (didn't bet)
Seat 7: jaimico00793 (small blind) folded before Flop
Seat 8: gwallgofddyn (big blind) collected (12782)

PokerStars Hand #251205759420: Tournament #3767885527, $40+$10+$5 USD Hold'em No Limit - Level XII (700/1400) - 2024/06/26 19:16:35 UTC [2024/06/26 15:16:35 ET]
Table '3767885527 35' 8-max Seat #7 is the button
Seat 1: hiran bass (17515 in chips) 
Seat 2: StoraEss (24475 in chips) 
Seat 3: atg590 (89658 in chips) 
Seat 4: PhoenixGrind (89382 in chips) 
Seat 5: Johevera (34218 in chips) 
Seat 6: sQuezzeYoU!! (53462 in chips) 
Seat 7: jaimico00793 (15286 in chips) 
Seat 8: gwallgofddyn (140563 in chips) 
hiran bass: posts the ante 175
StoraEss: posts the ante 175
atg590: posts the ante 175
PhoenixGrind: posts the ante 175
Johevera: posts the ante 175
sQuezzeYoU!!: posts the ante 175
jaimico00793: posts the ante 175
gwallgofddyn: posts the ante 175
gwallgofddyn: posts small blind 700
hiran bass: posts big blind 1400
*** HOLE CARDS ***
StoraEss: folds 
atg590: folds 
PhoenixGrind: folds 
Johevera: folds 
sQuezzeYoU!!: folds 
jaimico00793: folds 
gwallgofddyn: raises 138988 to 140388 and is all-in
hiran bass: folds 
Uncalled bet (138988) returned to gwallgofddyn
gwallgofddyn collected 4200 from pot
gwallgofddyn: doesn't show hand 
*** SUMMARY ***
Total pot 4200 | Rake 0 
Seat 1: hiran bass (big blind) folded before Flop
Seat 2: StoraEss folded before Flop (didn't bet)
Seat 3: atg590 folded before Flop (didn't bet)
Seat 4: PhoenixGrind folded before Flop (didn't bet)
Seat 5: Johevera folded before Flop (didn't bet)
Seat 6: sQuezzeYoU!! folded before Flop (didn't bet)
Seat 7: jaimico00793 (button) folded before Flop (didn't bet)
Seat 8: gwallgofddyn (small blind) collected (4200)

PokerStars Hand #251205770206: Tournament #3767885527, $40+$10+$5 USD Hold'em No Limit - Level XII (700/1400) - 2024/06/26 19:17:15 UTC [2024/06/26 15:17:15 ET]
Table '3767885527 35' 8-max Seat #8 is the button
Seat 1: hiran bass (15940 in chips) 
Seat 2: StoraEss (24300 in chips) 
Seat 3: atg590 (89483 in chips) 
Seat 4: PhoenixGrind (89207 in chips) 
Seat 5: Johevera (34043 in chips) 
Seat 6: sQuezzeYoU!! (53287 in chips) 
Seat 7: jaimico00793 (15111 in chips) 
Seat 8: gwallgofddyn (143188 in chips) 
hiran bass: posts the ante 175
StoraEss: posts the ante 175
atg590: posts the ante 175
PhoenixGrind: posts the ante 175
Johevera: posts the ante 175
sQuezzeYoU!!: posts the ante 175
jaimico00793: posts the ante 175
gwallgofddyn: posts the ante 175
hiran bass: posts small blind 700
StoraEss: posts big blind 1400
*** HOLE CARDS ***
atg590: folds 
PhoenixGrind: folds 
Johevera: folds 
sQuezzeYoU!!: folds 
jaimico00793: raises 13536 to 14936 and is all-in
gwallgofddyn: folds 
hiran bass: folds 
StoraEss: folds 
Uncalled bet (13536) returned to jaimico00793
jaimico00793 collected 4900 from pot
jaimico00793: doesn't show hand 
*** SUMMARY ***
Total pot 4900 | Rake 0 
Seat 1: hiran bass (small blind) folded before Flop
Seat 2: StoraEss (big blind) folded before Flop
Seat 3: atg590 folded before Flop (didn't bet)
Seat 4: PhoenixGrind folded before Flop (didn't bet)
Seat 5: Johevera folded before Flop (didn't bet)
Seat 6: sQuezzeYoU!! folded before Flop (didn't bet)
Seat 7: jaimico00793 collected (4900)
Seat 8: gwallgofddyn (button) folded before Flop (didn't bet)

PokerStars Hand #251205775902: Tournament #3767885527, $40+$10+$5 USD Hold'em No Limit - Level XII (700/1400) - 2024/06/26 19:17:36 UTC [2024/06/26 15:17:36 ET]
Table '3767885527 35' 8-max Seat #1 is the button
Seat 1: hiran bass (15065 in chips) 
Seat 2: StoraEss (22725 in chips) 
Seat 3: atg590 (89308 in chips) 
Seat 4: PhoenixGrind (89032 in chips) 
Seat 5: Johevera (33868 in chips) 
Seat 6: sQuezzeYoU!! (53112 in chips) 
Seat 7: jaimico00793 (18436 in chips) 
Seat 8: gwallgofddyn (143013 in chips) 
hiran bass: posts the ante 175
StoraEss: posts the ante 175
atg590: posts the ante 175
PhoenixGrind: posts the ante 175
Johevera: posts the ante 175
sQuezzeYoU!!: posts the ante 175
jaimico00793: posts the ante 175
gwallgofddyn: posts the ante 175
StoraEss: posts small blind 700
atg590: posts big blind 1400
*** HOLE CARDS ***
PhoenixGrind: folds 
Johevera: folds 
sQuezzeYoU!!: folds 
jaimico00793: folds 
gwallgofddyn: raises 1820 to 3220
hiran bass: folds 
StoraEss: raises 19330 to 22550 and is all-in
atg590: folds 
gwallgofddyn: folds 
Uncalled bet (19330) returned to StoraEss
StoraEss collected 9240 from pot
StoraEss: doesn't show hand 
*** SUMMARY ***
Total pot 9240 | Rake 0 
Seat 1: hiran bass (button) folded before Flop (didn't bet)
Seat 2: StoraEss (small blind) collected (9240)
Seat 3: atg590 (big blind) folded before Flop
Seat 4: PhoenixGrind folded before Flop (didn't bet)
Seat 5: Johevera folded before Flop (didn't bet)
Seat 6: sQuezzeYoU!! folded before Flop (didn't bet)
Seat 7: jaimico00793 folded before Flop (didn't bet)
Seat 8: gwallgofddyn folded before Flop

PokerStars Hand #251205782081: Tournament #3767885527, $40+$10+$5 USD Hold'em No Limit - Level XII (700/1400) - 2024/06/26 19:17:59 UTC [2024/06/26 15:17:59 ET]
Table '3767885527 35' 8-max Seat #2 is the button
Seat 1: hiran bass (14890 in chips) 
Seat 2: StoraEss (28570 in chips) 
Seat 3: atg590 (87733 in chips) 
Seat 4: PhoenixGrind (88857 in chips) 
Seat 5: Johevera (33693 in chips) 
Seat 6: sQuezzeYoU!! (52937 in chips) 
Seat 7: jaimico00793 (18261 in chips) 
Seat 8: gwallgofddyn (139618 in chips) 
hiran bass: posts the ante 175
StoraEss: posts the ante 175
atg590: posts the ante 175
PhoenixGrind: posts the ante 175
Johevera: posts the ante 175
sQuezzeYoU!!: posts the ante 175
jaimico00793: posts the ante 175
gwallgofddyn: posts the ante 175
atg590: posts small blind 700
PhoenixGrind: posts big blind 1400
*** HOLE CARDS ***
Johevera: raises 1400 to 2800
sQuezzeYoU!!: folds 
jaimico00793: calls 2800
gwallgofddyn: folds 
hiran bass: folds 
StoraEss: folds 
atg590: folds 
PhoenixGrind: calls 1400
*** FLOP *** [6s Ac 5h]
PhoenixGrind: checks 
Johevera: checks 
jaimico00793: checks 
*** TURN *** [6s Ac 5h] [Kd]
PhoenixGrind: checks 
Johevera: bets 4900
jaimico00793: calls 4900
PhoenixGrind: folds 
*** RIVER *** [6s Ac 5h Kd] [7d]
Johevera: bets 25818 and is all-in
jaimico00793: calls 10386 and is all-in
Uncalled bet (15432) returned to Johevera
*** SHOW DOWN ***
Johevera: shows [As Kc] (two pair, Aces and Kings)
jaimico00793: shows [Ad Ah] (three of a kind, Aces)
jaimico00793 collected 41072 from pot
*** SUMMARY ***
Total pot 41072 | Rake 0 
Board [6s Ac 5h Kd 7d]
Seat 1: hiran bass folded before Flop (didn't bet)
Seat 2: StoraEss (button) folded before Flop (didn't bet)
Seat 3: atg590 (small blind) folded before Flop
Seat 4: PhoenixGrind (big blind) folded on the Turn
Seat 5: Johevera showed [As Kc] and lost with two pair, Aces and Kings
Seat 6: sQuezzeYoU!! folded before Flop (didn't bet)
Seat 7: jaimico00793 showed [Ad Ah] and won (41072) with three of a kind, Aces
Seat 8: gwallgofddyn folded before Flop (didn't bet)

PokerStars Hand #251205812123: Tournament #3767885527, $40+$10+$5 USD Hold'em No Limit - Level XIII (800/1600) - 2024/06/26 19:19:48 UTC [2024/06/26 15:19:48 ET]
Table '3767885527 35' 8-max Seat #3 is the button
Seat 1: hiran bass (14715 in chips) 
Seat 2: StoraEss (28395 in chips) 
Seat 3: atg590 (86858 in chips) 
Seat 4: PhoenixGrind (85882 in chips) 
Seat 5: Johevera (15432 in chips) 
Seat 6: sQuezzeYoU!! (52762 in chips) 
Seat 7: jaimico00793 (41072 in chips) 
Seat 8: gwallgofddyn (139443 in chips) 
hiran bass: posts the ante 200
StoraEss: posts the ante 200
atg590: posts the ante 200
PhoenixGrind: posts the ante 200
Johevera: posts the ante 200
sQuezzeYoU!!: posts the ante 200
jaimico00793: posts the ante 200
gwallgofddyn: posts the ante 200
PhoenixGrind: posts small blind 800
Johevera: posts big blind 1600
*** HOLE CARDS ***
sQuezzeYoU!!: raises 1875 to 3475
jaimico00793: folds 
gwallgofddyn: folds 
hiran bass: folds 
StoraEss: folds 
atg590: folds 
PhoenixGrind: folds 
Johevera: calls 1875
*** FLOP *** [Kh Ts 9d]
Johevera: checks 
sQuezzeYoU!!: bets 2805
Johevera: folds 
Uncalled bet (2805) returned to sQuezzeYoU!!
sQuezzeYoU!! collected 9350 from pot
sQuezzeYoU!!: doesn't show hand 
*** SUMMARY ***
Total pot 9350 | Rake 0 
Board [Kh Ts 9d]
Seat 1: hiran bass folded before Flop (didn't bet)
Seat 2: StoraEss folded before Flop (didn't bet)
Seat 3: atg590 (button) folded before Flop (didn't bet)
Seat 4: PhoenixGrind (small blind) folded before Flop
Seat 5: Johevera (big blind) folded on the Flop
Seat 6: sQuezzeYoU!! collected (9350)
Seat 7: jaimico00793 folded before Flop (didn't bet)
Seat 8: gwallgofddyn folded before Flop (didn't bet)

PokerStars Hand #251205822373: Tournament #3767885527, $40+$10+$5 USD Hold'em No Limit - Level XIII (800/1600) - 2024/06/26 19:20:26 UTC [2024/06/26 15:20:26 ET]
Table '3767885527 35' 8-max Seat #4 is the button
Seat 1: hiran bass (14515 in chips) 
Seat 2: StoraEss (28195 in chips) 
Seat 3: atg590 (86658 in chips) 
Seat 4: PhoenixGrind (84882 in chips) 
Seat 5: Johevera (11757 in chips) 
Seat 6: sQuezzeYoU!! (58437 in chips) 
Seat 7: jaimico00793 (40872 in chips) 
Seat 8: gwallgofddyn (139243 in chips) 
hiran bass: posts the ante 200
StoraEss: posts the ante 200
atg590: posts the ante 200
PhoenixGrind: posts the ante 200
Johevera: posts the ante 200
sQuezzeYoU!!: posts the ante 200
jaimico00793: posts the ante 200
gwallgofddyn: posts the ante 200
Johevera: posts small blind 800
sQuezzeYoU!!: posts big blind 1600
*** HOLE CARDS ***
jaimico00793: folds 
gwallgofddyn: raises 2080 to 3680
hiran bass: raises 10635 to 14315 and is all-in
StoraEss: folds 
atg590: folds 
PhoenixGrind: folds 
Johevera: folds 
sQuezzeYoU!!: folds 
gwallgofddyn: calls 10635
*** FLOP *** [Jc 9c 2c]
*** TURN *** [Jc 9c 2c] [4c]
*** RIVER *** [Jc 9c 2c 4c] [3c]
*** SHOW DOWN ***
gwallgofddyn: shows [Qh Js] (a flush, Jack high)
hiran bass: shows [Ts Tc] (a flush, Jack high - Ten higher)
hiran bass collected 32630 from pot
*** SUMMARY ***
Total pot 32630 | Rake 0 
Board [Jc 9c 2c 4c 3c]
Seat 1: hiran bass showed [Ts Tc] and won (32630) with a flush, Jack high
Seat 2: StoraEss folded before Flop (didn't bet)
Seat 3: atg590 folded before Flop (didn't bet)
Seat 4: PhoenixGrind (button) folded before Flop (didn't bet)
Seat 5: Johevera (small blind) folded before Flop
Seat 6: sQuezzeYoU!! (big blind) folded before Flop
Seat 7: jaimico00793 folded before Flop (didn't bet)
Seat 8: gwallgofddyn showed [Qh Js] and lost with a flush, Jack high

PokerStars Hand #251205830432: Tournament #3767885527, $40+$10+$5 USD Hold'em No Limit - Level XIII (800/1600) - 2024/06/26 19:20:56 UTC [2024/06/26 15:20:56 ET]
Table '3767885527 35' 8-max Seat #5 is the button
Seat 1: hiran bass (32630 in chips) 
Seat 2: StoraEss (27995 in chips) 
Seat 3: atg590 (86458 in chips) 
Seat 4: PhoenixGrind (84682 in chips) 
Seat 5: Johevera (10757 in chips) 
Seat 6: sQuezzeYoU!! (56637 in chips) 
Seat 7: jaimico00793 (40672 in chips) 
Seat 8: gwallgofddyn (124728 in chips) 
hiran bass: posts the ante 200
StoraEss: posts the ante 200
atg590: posts the ante 200
PhoenixGrind: posts the ante 200
Johevera: posts the ante 200
sQuezzeYoU!!: posts the ante 200
jaimico00793: posts the ante 200
gwallgofddyn: posts the ante 200
sQuezzeYoU!!: posts small blind 800
jaimico00793: posts big blind 1600
*** HOLE CARDS ***
gwallgofddyn: folds 
hiran bass: folds 
StoraEss: folds 
atg590: folds 
PhoenixGrind: folds 
Johevera: folds 
sQuezzeYoU!!: raises 3712 to 5312
jaimico00793: folds 
Uncalled bet (3712) returned to sQuezzeYoU!!
sQuezzeYoU!! collected 4800 from pot
sQuezzeYoU!!: doesn't show hand 
*** SUMMARY ***
Total pot 4800 | Rake 0 
Seat 1: hiran bass folded before Flop (didn't bet)
Seat 2: StoraEss folded before Flop (didn't bet)
Seat 3: atg590 folded before Flop (didn't bet)
Seat 4: PhoenixGrind folded before Flop (didn't bet)
Seat 5: Johevera (button) folded before Flop (didn't bet)
Seat 6: sQuezzeYoU!! (small blind) collected (4800)
Seat 7: jaimico00793 (big blind) folded before Flop
Seat 8: gwallgofddyn folded before Flop (didn't bet)

PokerStars Hand #251205839279: Tournament #3767885527, $40+$10+$5 USD Hold'em No Limit - Level XIII (800/1600) - 2024/06/26 19:21:29 UTC [2024/06/26 15:21:29 ET]
Table '3767885527 35' 8-max Seat #6 is the button
Seat 1: hiran bass (32430 in chips) 
Seat 2: StoraEss (27795 in chips) 
Seat 3: atg590 (86258 in chips) 
Seat 4: PhoenixGrind (84482 in chips) 
Seat 5: Johevera (10557 in chips) 
Seat 6: sQuezzeYoU!! (59637 in chips) 
Seat 7: jaimico00793 (38872 in chips) 
Seat 8: gwallgofddyn (124528 in chips) 
hiran bass: posts the ante 200
StoraEss: posts the ante 200
atg590: posts the ante 200
PhoenixGrind: posts the ante 200
Johevera: posts the ante 200
sQuezzeYoU!!: posts the ante 200
jaimico00793: posts the ante 200
gwallgofddyn: posts the ante 200
jaimico00793: posts small blind 800
gwallgofddyn: posts big blind 1600
*** HOLE CARDS ***
hiran bass: folds 
StoraEss: raises 1600 to 3200
atg590: folds 
PhoenixGrind: folds 
Johevera: raises 7157 to 10357 and is all-in
sQuezzeYoU!!: folds 
jaimico00793: folds 
gwallgofddyn: folds 
StoraEss: calls 7157
*** FLOP *** [Ts Ad 5d]
*** TURN *** [Ts Ad 5d] [2h]
*** RIVER *** [Ts Ad 5d 2h] [Jd]
*** SHOW DOWN ***
StoraEss: shows [Js Qs] (a pair of Jacks)
Johevera: shows [8d 9c] (high card Ace)
StoraEss collected 24714 from pot
Johevera finished the tournament
*** SUMMARY ***
Total pot 24714 | Rake 0 
Board [Ts Ad 5d 2h Jd]
Seat 1: hiran bass folded before Flop (didn't bet)
Seat 2: StoraEss showed [Js Qs] and won (24714) with a pair of Jacks
Seat 3: atg590 folded before Flop (didn't bet)
Seat 4: PhoenixGrind folded before Flop (didn't bet)
Seat 5: Johevera showed [8d 9c] and lost with high card Ace
Seat 6: sQuezzeYoU!! (button) folded before Flop (didn't bet)
Seat 7: jaimico00793 (small blind) folded before Flop
Seat 8: gwallgofddyn (big blind) folded before Flop

PokerStars Hand #251205851429: Tournament #3767885527, $40+$10+$5 USD Hold'em No Limit - Level XIII (800/1600) - 2024/06/26 19:22:13 UTC [2024/06/26 15:22:13 ET]
Table '3767885527 35' 8-max Seat #7 is the button
Seat 1: hiran bass (32230 in chips) 
Seat 2: StoraEss (41952 in chips) 
Seat 3: atg590 (86058 in chips) 
Seat 4: PhoenixGrind (84282 in chips) 
Seat 6: sQuezzeYoU!! (59437 in chips) 
Seat 7: jaimico00793 (37872 in chips) 
Seat 8: gwallgofddyn (122728 in chips) 
hiran bass: posts the ante 200
StoraEss: posts the ante 200
atg590: posts the ante 200
PhoenixGrind: posts the ante 200
sQuezzeYoU!!: posts the ante 200
jaimico00793: posts the ante 200
gwallgofddyn: posts the ante 200
gwallgofddyn: posts small blind 800
hiran bass: posts big blind 1600
*** HOLE CARDS ***
StoraEss: raises 1600 to 3200
atg590: folds 
PhoenixGrind: folds 
sQuezzeYoU!!: folds 
jaimico00793: folds 
gwallgofddyn: folds 
hiran bass: calls 1600
*** FLOP *** [7d 5h 9d]
hiran bass: checks 
StoraEss: bets 4800
hiran bass: folds 
Uncalled bet (4800) returned to StoraEss
StoraEss collected 8600 from pot
StoraEss: doesn't show hand 
*** SUMMARY ***
Total pot 8600 | Rake 0 
Board [7d 5h 9d]
Seat 1: hiran bass (big blind) folded on the Flop
Seat 2: StoraEss collected (8600)
Seat 3: atg590 folded before Flop (didn't bet)
Seat 4: PhoenixGrind folded before Flop (didn't bet)
Seat 6: sQuezzeYoU!! folded before Flop (didn't bet)
Seat 7: jaimico00793 (button) folded before Flop (didn't bet)
Seat 8: gwallgofddyn (small blind) folded before Flop

PokerStars Hand #251205865562: Tournament #3767885527, $40+$10+$5 USD Hold'em No Limit - Level XIII (800/1600) - 2024/06/26 19:23:04 UTC [2024/06/26 15:23:04 ET]
Table '3767885527 35' 8-max Seat #8 is the button
Seat 1: hiran bass (28830 in chips) 
Seat 2: StoraEss (47152 in chips) 
Seat 3: atg590 (85858 in chips) 
Seat 4: PhoenixGrind (84082 in chips) 
Seat 6: sQuezzeYoU!! (59237 in chips) 
Seat 7: jaimico00793 (37672 in chips) 
Seat 8: gwallgofddyn (121728 in chips) 
hiran bass: posts the ante 200
StoraEss: posts the ante 200
atg590: posts the ante 200
PhoenixGrind: posts the ante 200
sQuezzeYoU!!: posts the ante 200
jaimico00793: posts the ante 200
gwallgofddyn: posts the ante 200
hiran bass: posts small blind 800
StoraEss: posts big blind 1600
*** HOLE CARDS ***
atg590: folds 
PhoenixGrind: folds 
sQuezzeYoU!!: folds 
jaimico00793: raises 1920 to 3520
gwallgofddyn: folds 
hiran bass: folds 
StoraEss: calls 1920
*** FLOP *** [Ac 7c 5s]
StoraEss: checks 
jaimico00793: bets 2310
StoraEss: folds 
Uncalled bet (2310) returned to jaimico00793
jaimico00793 collected 9240 from pot
jaimico00793: doesn't show hand 
*** SUMMARY ***
Total pot 9240 | Rake 0 
Board [Ac 7c 5s]
Seat 1: hiran bass (small blind) folded before Flop
Seat 2: StoraEss (big blind) folded on the Flop
Seat 3: atg590 folded before Flop (didn't bet)
Seat 4: PhoenixGrind folded before Flop (didn't bet)
Seat 6: sQuezzeYoU!! folded before Flop (didn't bet)
Seat 7: jaimico00793 collected (9240)
Seat 8: gwallgofddyn (button) folded before Flop (didn't bet)

PokerStars Hand #251205874205: Tournament #3767885527, $40+$10+$5 USD Hold'em No Limit - Level XIII (800/1600) - 2024/06/26 19:23:36 UTC [2024/06/26 15:23:36 ET]
Table '3767885527 35' 8-max Seat #1 is the button
Seat 1: hiran bass (27830 in chips) 
Seat 2: StoraEss (43432 in chips) 
Seat 3: atg590 (85658 in chips) 
Seat 4: PhoenixGrind (83882 in chips) 
Seat 5: Khanuman Men (40468 in chips) 
Seat 6: sQuezzeYoU!! (59037 in chips) 
Seat 7: jaimico00793 (43192 in chips) 
Seat 8: gwallgofddyn (121528 in chips) 
hiran bass: posts the ante 200
StoraEss: posts the ante 200
atg590: posts the ante 200
PhoenixGrind: posts the ante 200
Khanuman Men: posts the ante 200
sQuezzeYoU!!: posts the ante 200
jaimico00793: posts the ante 200
gwallgofddyn: posts the ante 200
StoraEss: posts small blind 800
atg590: posts big blind 1600
*** HOLE CARDS ***
PhoenixGrind: folds 
Khanuman Men: folds 
sQuezzeYoU!!: folds 
jaimico00793: raises 1600 to 3200
gwallgofddyn: folds 
hiran bass: folds 
StoraEss: folds 
atg590: raises 4800 to 8000
jaimico00793: folds 
Uncalled bet (4800) returned to atg590
atg590 collected 8800 from pot
*** SUMMARY ***
Total pot 8800 | Rake 0 
Seat 1: hiran bass (button) folded before Flop (didn't bet)
Seat 2: StoraEss (small blind) folded before Flop
Seat 3: atg590 (big blind) collected (8800)
Seat 4: PhoenixGrind folded before Flop (didn't bet)
Seat 5: Khanuman Men folded before Flop (didn't bet)
Seat 6: sQuezzeYoU!! folded before Flop (didn't bet)
Seat 7: jaimico00793 folded before Flop
Seat 8: gwallgofddyn folded before Flop (didn't bet)

PokerStars Hand #251205882429: Tournament #3767885527, $40+$10+$5 USD Hold'em No Limit - Level XIII (800/1600) - 2024/06/26 19:24:06 UTC [2024/06/26 15:24:06 ET]
Table '3767885527 35' 8-max Seat #2 is the button
Seat 1: hiran bass (27630 in chips) 
Seat 2: StoraEss (42432 in chips) 
Seat 3: atg590 (91058 in chips) 
Seat 4: PhoenixGrind (83682 in chips) 
Seat 5: Khanuman Men (40268 in chips) 
Seat 6: sQuezzeYoU!! (58837 in chips) 
Seat 7: jaimico00793 (39792 in chips) 
Seat 8: gwallgofddyn (121328 in chips) 
hiran bass: posts the ante 200
StoraEss: posts the ante 200
atg590: posts the ante 200
PhoenixGrind: posts the ante 200
Khanuman Men: posts the ante 200
sQuezzeYoU!!: posts the ante 200
jaimico00793: posts the ante 200
gwallgofddyn: posts the ante 200
atg590: posts small blind 800
PhoenixGrind: posts big blind 1600
*** HOLE CARDS ***
Khanuman Men: folds 
sQuezzeYoU!!: folds 
jaimico00793: folds 
gwallgofddyn: raises 2080 to 3680
hiran bass: folds 
StoraEss: folds 
atg590: raises 5280 to 8960
PhoenixGrind: folds 
gwallgofddyn: folds 
Uncalled bet (5280) returned to atg590
atg590 collected 10560 from pot
*** SUMMARY ***
Total pot 10560 | Rake 0 
Seat 1: hiran bass folded before Flop (didn't bet)
Seat 2: StoraEss (button) folded before Flop (didn't bet)
Seat 3: atg590 (small blind) collected (10560)
Seat 4: PhoenixGrind (big blind) folded before Flop
Seat 5: Khanuman Men folded before Flop (didn't bet)
Seat 6: sQuezzeYoU!! folded before Flop (didn't bet)
Seat 7: jaimico00793 folded before Flop (didn't bet)
Seat 8: gwallgofddyn folded before Flop

PokerStars Hand #251205889792: Tournament #3767885527, $40+$10+$5 USD Hold'em No Limit - Level XIII (800/1600) - 2024/06/26 19:24:33 UTC [2024/06/26 15:24:33 ET]
Table '3767885527 35' 8-max Seat #3 is the button
Seat 1: hiran bass (27430 in chips) 
Seat 2: StoraEss (42232 in chips) 
Seat 3: atg590 (97738 in chips) 
Seat 4: PhoenixGrind (81882 in chips) 
Seat 5: Khanuman Men (40068 in chips) 
Seat 6: sQuezzeYoU!! (58637 in chips) 
Seat 7: jaimico00793 (39592 in chips) 
Seat 8: gwallgofddyn (117448 in chips) 
hiran bass: posts the ante 200
StoraEss: posts the ante 200
atg590: posts the ante 200
PhoenixGrind: posts the ante 200
Khanuman Men: posts the ante 200
sQuezzeYoU!!: posts the ante 200
jaimico00793: posts the ante 200
gwallgofddyn: posts the ante 200
PhoenixGrind: posts small blind 800
Khanuman Men: posts big blind 1600
*** HOLE CARDS ***
sQuezzeYoU!!: folds 
jaimico00793: folds 
gwallgofddyn: folds 
hiran bass: folds 
StoraEss: folds 
atg590: folds 
PhoenixGrind: calls 800
Khanuman Men: raises 4800 to 6400
PhoenixGrind: calls 4800
*** FLOP *** [3s Ad Ah]
PhoenixGrind: checks 
Khanuman Men: checks 
*** TURN *** [3s Ad Ah] [8c]
PhoenixGrind: checks 
Khanuman Men: bets 4800
PhoenixGrind: calls 4800
*** RIVER *** [3s Ad Ah 8c] [5s]
PhoenixGrind: checks 
Khanuman Men: checks 
*** SHOW DOWN ***
PhoenixGrind: shows [3c Tc] (two pair, Aces and Threes)
Khanuman Men: mucks hand 
PhoenixGrind collected 24000 from pot
*** SUMMARY ***
Total pot 24000 | Rake 0 
Board [3s Ad Ah 8c 5s]
Seat 1: hiran bass folded before Flop (didn't bet)
Seat 2: StoraEss folded before Flop (didn't bet)
Seat 3: atg590 (button) folded before Flop (didn't bet)
Seat 4: PhoenixGrind (small blind) showed [3c Tc] and won (24000) with two pair, Aces and Threes
Seat 5: Khanuman Men (big blind) mucked
Seat 6: sQuezzeYoU!! folded before Flop (didn't bet)
Seat 7: jaimico00793 folded before Flop (didn't bet)
Seat 8: gwallgofddyn folded before Flop (didn't bet)

PokerStars Hand #251205909564: Tournament #3767885527, $40+$10+$5 USD Hold'em No Limit - Level XIII (800/1600) - 2024/06/26 19:25:44 UTC [2024/06/26 15:25:44 ET]
Table '3767885527 35' 8-max Seat #4 is the button
Seat 1: hiran bass (27230 in chips) 
Seat 2: StoraEss (42032 in chips) 
Seat 3: atg590 (97538 in chips) 
Seat 4: PhoenixGrind (94482 in chips) 
Seat 5: Khanuman Men (28668 in chips) 
Seat 6: sQuezzeYoU!! (58437 in chips) 
Seat 7: jaimico00793 (39392 in chips) 
Seat 8: gwallgofddyn (117248 in chips) 
hiran bass: posts the ante 200
StoraEss: posts the ante 200
atg590: posts the ante 200
PhoenixGrind: posts the ante 200
Khanuman Men: posts the ante 200
sQuezzeYoU!!: posts the ante 200
jaimico00793: posts the ante 200
gwallgofddyn: posts the ante 200
Khanuman Men: posts small blind 800
sQuezzeYoU!!: posts big blind 1600
*** HOLE CARDS ***
jaimico00793: folds 
gwallgofddyn: raises 2080 to 3680
hiran bass: raises 23350 to 27030 and is all-in
StoraEss: folds 
atg590: folds 
PhoenixGrind: folds 
Khanuman Men: folds 
sQuezzeYoU!!: folds 
gwallgofddyn: folds 
Uncalled bet (23350) returned to hiran bass
hiran bass collected 11360 from pot
hiran bass: doesn't show hand 
*** SUMMARY ***
Total pot 11360 | Rake 0 
Seat 1: hiran bass collected (11360)
Seat 2: StoraEss folded before Flop (didn't bet)
Seat 3: atg590 folded before Flop (didn't bet)
Seat 4: PhoenixGrind (button) folded before Flop (didn't bet)
Seat 5: Khanuman Men (small blind) folded before Flop
Seat 6: sQuezzeYoU!! (big blind) folded before Flop
Seat 7: jaimico00793 folded before Flop (didn't bet)
Seat 8: gwallgofddyn folded before Flop

PokerStars Hand #251205920011: Tournament #3767885527, $40+$10+$5 USD Hold'em No Limit - Level XIII (800/1600) - 2024/06/26 19:26:22 UTC [2024/06/26 15:26:22 ET]
Table '3767885527 35' 8-max Seat #5 is the button
Seat 1: hiran bass (34710 in chips) 
Seat 2: StoraEss (41832 in chips) 
Seat 3: atg590 (97338 in chips) 
Seat 4: PhoenixGrind (94282 in chips) 
Seat 5: Khanuman Men (27668 in chips) 
Seat 6: sQuezzeYoU!! (56637 in chips) 
Seat 7: jaimico00793 (39192 in chips) 
Seat 8: gwallgofddyn (113368 in chips) 
hiran bass: posts the ante 200
StoraEss: posts the ante 200
atg590: posts the ante 200
PhoenixGrind: posts the ante 200
Khanuman Men: posts the ante 200
sQuezzeYoU!!: posts the ante 200
jaimico00793: posts the ante 200
gwallgofddyn: posts the ante 200
sQuezzeYoU!!: posts small blind 800
jaimico00793: posts big blind 1600
*** HOLE CARDS ***
gwallgofddyn: folds 
hiran bass: folds 
StoraEss: folds 
atg590: folds 
PhoenixGrind: folds 
Khanuman Men: raises 1600 to 3200
sQuezzeYoU!!: folds 
jaimico00793: calls 1600
*** FLOP *** [Jc Js Ac]
jaimico00793: checks 
Khanuman Men: bets 3200
jaimico00793: folds 
Uncalled bet (3200) returned to Khanuman Men
Khanuman Men collected 8800 from pot
*** SUMMARY ***
Total pot 8800 | Rake 0 
Board [Jc Js Ac]
Seat 1: hiran bass folded before Flop (didn't bet)
Seat 2: StoraEss folded before Flop (didn't bet)
Seat 3: atg590 folded before Flop (didn't bet)
Seat 4: PhoenixGrind folded before Flop (didn't bet)
Seat 5: Khanuman Men (button) collected (8800)
Seat 6: sQuezzeYoU!! (small blind) folded before Flop
Seat 7: jaimico00793 (big blind) folded on the Flop
Seat 8: gwallgofddyn folded before Flop (didn't bet)

PokerStars Hand #251205930914: Tournament #3767885527, $40+$10+$5 USD Hold'em No Limit - Level XIII (800/1600) - 2024/06/26 19:27:02 UTC [2024/06/26 15:27:02 ET]
Table '3767885527 35' 8-max Seat #6 is the button
Seat 1: hiran bass (34510 in chips) 
Seat 2: StoraEss (41632 in chips) 
Seat 3: atg590 (97138 in chips) 
Seat 4: PhoenixGrind (94082 in chips) 
Seat 5: Khanuman Men (33068 in chips) 
Seat 6: sQuezzeYoU!! (55637 in chips) 
Seat 7: jaimico00793 (35792 in chips) 
Seat 8: gwallgofddyn (113168 in chips) 
hiran bass: posts the ante 200
StoraEss: posts the ante 200
atg590: posts the ante 200
PhoenixGrind: posts the ante 200
Khanuman Men: posts the ante 200
sQuezzeYoU!!: posts the ante 200
jaimico00793: posts the ante 200
gwallgofddyn: posts the ante 200
jaimico00793: posts small blind 800
gwallgofddyn: posts big blind 1600
*** HOLE CARDS ***
hiran bass: folds 
StoraEss: raises 1600 to 3200
atg590: folds 
PhoenixGrind: folds 
Khanuman Men: folds 
sQuezzeYoU!!: folds 
jaimico00793: folds 
gwallgofddyn: folds 
Uncalled bet (1600) returned to StoraEss
StoraEss collected 5600 from pot
StoraEss: doesn't show hand 
*** SUMMARY ***
Total pot 5600 | Rake 0 
Seat 1: hiran bass folded before Flop (didn't bet)
Seat 2: StoraEss collected (5600)
Seat 3: atg590 folded before Flop (didn't bet)
Seat 4: PhoenixGrind folded before Flop (didn't bet)
Seat 5: Khanuman Men folded before Flop (didn't bet)
Seat 6: sQuezzeYoU!! (button) folded before Flop (didn't bet)
Seat 7: jaimico00793 (small blind) folded before Flop
Seat 8: gwallgofddyn (big blind) folded before Flop

PokerStars Hand #251205943397: Tournament #3767885527, $40+$10+$5 USD Hold'em No Limit - Level XIII (800/1600) - 2024/06/26 19:27:49 UTC [2024/06/26 15:27:49 ET]
Table '3767885527 35' 8-max Seat #7 is the button
Seat 1: hiran bass (34310 in chips) 
Seat 2: StoraEss (45432 in chips) 
Seat 3: atg590 (96938 in chips) 
Seat 4: PhoenixGrind (93882 in chips) 
Seat 5: Khanuman Men (32868 in chips) 
Seat 6: sQuezzeYoU!! (55437 in chips) 
Seat 7: jaimico00793 (34792 in chips) 
Seat 8: gwallgofddyn (111368 in chips) 
hiran bass: posts the ante 200
StoraEss: posts the ante 200
atg590: posts the ante 200
PhoenixGrind: posts the ante 200
Khanuman Men: posts the ante 200
sQuezzeYoU!!: posts the ante 200
jaimico00793: posts the ante 200
gwallgofddyn: posts the ante 200
gwallgofddyn: posts small blind 800
hiran bass: posts big blind 1600
*** HOLE CARDS ***
StoraEss: folds 
atg590: folds 
PhoenixGrind: folds 
Khanuman Men: folds 
sQuezzeYoU!!: folds 
jaimico00793: raises 1600 to 3200
gwallgofddyn: folds 
hiran bass: calls 1600
*** FLOP *** [8s 7c Jd]
hiran bass: checks 
jaimico00793: bets 2200
hiran bass: calls 2200
*** TURN *** [8s 7c Jd] [5d]
hiran bass: checks 
jaimico00793: bets 6960
hiran bass: calls 6960
*** RIVER *** [8s 7c Jd 5d] [As]
hiran bass: checks 
jaimico00793: checks 
*** SHOW DOWN ***
hiran bass: shows [6d 8c] (a pair of Eights)
jaimico00793: shows [7d Ad] (two pair, Aces and Sevens)
jaimico00793 collected 27120 from pot
*** SUMMARY ***
Total pot 27120 | Rake 0 
Board [8s 7c Jd 5d As]
Seat 1: hiran bass (big blind) showed [6d 8c] and lost with a pair of Eights
Seat 2: StoraEss folded before Flop (didn't bet)
Seat 3: atg590 folded before Flop (didn't bet)
Seat 4: PhoenixGrind folded before Flop (didn't bet)
Seat 5: Khanuman Men folded before Flop (didn't bet)
Seat 6: sQuezzeYoU!! folded before Flop (didn't bet)
Seat 7: jaimico00793 (button) showed [7d Ad] and won (27120) with two pair, Aces and Sevens
Seat 8: gwallgofddyn (small blind) folded before Flop

PokerStars Hand #251205967644: Tournament #3767885527, $40+$10+$5 USD Hold'em No Limit - Level XIV (1000/2000) - 2024/06/26 19:29:20 UTC [2024/06/26 15:29:20 ET]
Table '3767885527 35' 8-max Seat #8 is the button
Seat 1: hiran bass (21750 in chips) 
Seat 2: StoraEss (45232 in chips) 
Seat 3: atg590 (96738 in chips) 
Seat 4: PhoenixGrind (93682 in chips) 
Seat 5: Khanuman Men (32668 in chips) 
Seat 6: sQuezzeYoU!! (55237 in chips) 
Seat 7: jaimico00793 (49352 in chips) 
Seat 8: gwallgofddyn (110368 in chips) 
hiran bass: posts the ante 250
StoraEss: posts the ante 250
atg590: posts the ante 250
PhoenixGrind: posts the ante 250
Khanuman Men: posts the ante 250
sQuezzeYoU!!: posts the ante 250
jaimico00793: posts the ante 250
gwallgofddyn: posts the ante 250
hiran bass: posts small blind 1000
StoraEss: posts big blind 2000
*** HOLE CARDS ***
atg590: folds 
PhoenixGrind: folds 
Khanuman Men: raises 30418 to 32418 and is all-in
sQuezzeYoU!!: folds 
jaimico00793: folds 
gwallgofddyn: folds 
hiran bass: folds 
StoraEss: folds 
Uncalled bet (30418) returned to Khanuman Men
Khanuman Men collected 7000 from pot
*** SUMMARY ***
Total pot 7000 | Rake 0 
Seat 1: hiran bass (small blind) folded before Flop
Seat 2: StoraEss (big blind) folded before Flop
Seat 3: atg590 folded before Flop (didn't bet)
Seat 4: PhoenixGrind folded before Flop (didn't bet)
Seat 5: Khanuman Men collected (7000)
Seat 6: sQuezzeYoU!! folded before Flop (didn't bet)
Seat 7: jaimico00793 folded before Flop (didn't bet)
Seat 8: gwallgofddyn (button) folded before Flop (didn't bet)

PokerStars Hand #251205972493: Tournament #3767885527, $40+$10+$5 USD Hold'em No Limit - Level XIV (1000/2000) - 2024/06/26 19:29:37 UTC [2024/06/26 15:29:37 ET]
Table '3767885527 35' 8-max Seat #1 is the button
Seat 1: hiran bass (20500 in chips) 
Seat 2: StoraEss (42982 in chips) 
Seat 3: atg590 (96488 in chips) 
Seat 4: PhoenixGrind (93432 in chips) 
Seat 5: Khanuman Men (37418 in chips) 
Seat 6: sQuezzeYoU!! (54987 in chips) 
Seat 7: jaimico00793 (49102 in chips) 
Seat 8: gwallgofddyn (110118 in chips) 
hiran bass: posts the ante 250
StoraEss: posts the ante 250
atg590: posts the ante 250
PhoenixGrind: posts the ante 250
Khanuman Men: posts the ante 250
sQuezzeYoU!!: posts the ante 250
jaimico00793: posts the ante 250
gwallgofddyn: posts the ante 250
StoraEss: posts small blind 1000
atg590: posts big blind 2000
*** HOLE CARDS ***
PhoenixGrind: raises 3000 to 5000
Khanuman Men: folds 
sQuezzeYoU!!: raises 8000 to 13000
jaimico00793: folds 
gwallgofddyn: folds 
hiran bass: folds 
StoraEss: folds 
atg590: folds 
PhoenixGrind: raises 80182 to 93182 and is all-in
sQuezzeYoU!!: calls 41737 and is all-in
Uncalled bet (38445) returned to PhoenixGrind
*** FLOP *** [2s 5h Js]
*** TURN *** [2s 5h Js] [Qc]
*** RIVER *** [2s 5h Js Qc] [8c]
*** SHOW DOWN ***
PhoenixGrind: shows [Kd Kh] (a pair of Kings)
sQuezzeYoU!!: shows [Ac As] (a pair of Aces)
sQuezzeYoU!! collected 114474 from pot
*** SUMMARY ***
Total pot 114474 | Rake 0 
Board [2s 5h Js Qc 8c]
Seat 1: hiran bass (button) folded before Flop (didn't bet)
Seat 2: StoraEss (small blind) folded before Flop
Seat 3: atg590 (big blind) folded before Flop
Seat 4: PhoenixGrind showed [Kd Kh] and lost with a pair of Kings
Seat 5: Khanuman Men folded before Flop (didn't bet)
Seat 6: sQuezzeYoU!! showed [Ac As] and won (114474) with a pair of Aces
Seat 7: jaimico00793 folded before Flop (didn't bet)
Seat 8: gwallgofddyn folded before Flop (didn't bet)

PokerStars Hand #251205985418: Tournament #3767885527, $40+$10+$5 USD Hold'em No Limit - Level XIV (1000/2000) - 2024/06/26 19:30:24 UTC [2024/06/26 15:30:24 ET]
Table '3767885527 35' 8-max Seat #2 is the button
Seat 1: hiran bass (20250 in chips) 
Seat 2: StoraEss (41732 in chips) 
Seat 3: atg590 (94238 in chips) 
Seat 4: PhoenixGrind (38445 in chips) 
Seat 5: Khanuman Men (37168 in chips) 
Seat 6: sQuezzeYoU!! (114474 in chips) 
Seat 7: jaimico00793 (48852 in chips) 
Seat 8: gwallgofddyn (109868 in chips) 
hiran bass: posts the ante 250
StoraEss: posts the ante 250
atg590: posts the ante 250
PhoenixGrind: posts the ante 250
Khanuman Men: posts the ante 250
sQuezzeYoU!!: posts the ante 250
jaimico00793: posts the ante 250
gwallgofddyn: posts the ante 250
atg590: posts small blind 1000
PhoenixGrind: posts big blind 2000
*** HOLE CARDS ***
Khanuman Men: folds 
sQuezzeYoU!!: folds 
jaimico00793: folds 
gwallgofddyn: raises 2200 to 4200
hiran bass: folds 
StoraEss: calls 4200
atg590: calls 3200
PhoenixGrind: folds 
*** FLOP *** [6s 5h 2d]
atg590: checks 
gwallgofddyn: checks 
StoraEss: checks 
*** TURN *** [6s 5h 2d] [9s]
atg590: checks 
gwallgofddyn: bets 6640
StoraEss: calls 6640
atg590: folds 
*** RIVER *** [6s 5h 2d 9s] [8d]
gwallgofddyn: checks 
StoraEss: checks 
*** SHOW DOWN ***
gwallgofddyn: shows [9c Kc] (a pair of Nines)
StoraEss: mucks hand 
gwallgofddyn collected 29880 from pot
*** SUMMARY ***
Total pot 29880 | Rake 0 
Board [6s 5h 2d 9s 8d]
Seat 1: hiran bass folded before Flop (didn't bet)
Seat 2: StoraEss (button) mucked
Seat 3: atg590 (small blind) folded on the Turn
Seat 4: PhoenixGrind (big blind) folded before Flop
Seat 5: Khanuman Men folded before Flop (didn't bet)
Seat 6: sQuezzeYoU!! folded before Flop (didn't bet)
Seat 7: jaimico00793 folded before Flop (didn't bet)
Seat 8: gwallgofddyn showed [9c Kc] and won (29880) with a pair of Nines

PokerStars Hand #251206002315: Tournament #3767885527, $40+$10+$5 USD Hold'em No Limit - Level XIV (1000/2000) - 2024/06/26 19:31:26 UTC [2024/06/26 15:31:26 ET]
Table '3767885527 35' 8-max Seat #3 is the button
Seat 1: hiran bass (20000 in chips) 
Seat 2: StoraEss (30642 in chips) 
Seat 3: atg590 (89788 in chips) 
Seat 4: PhoenixGrind (36195 in chips) 
Seat 5: Khanuman Men (36918 in chips) 
Seat 6: sQuezzeYoU!! (114224 in chips) 
Seat 7: jaimico00793 (48602 in chips) 
Seat 8: gwallgofddyn (128658 in chips) 
hiran bass: posts the ante 250
StoraEss: posts the ante 250
atg590: posts the ante 250
PhoenixGrind: posts the ante 250
Khanuman Men: posts the ante 250
sQuezzeYoU!!: posts the ante 250
jaimico00793: posts the ante 250
gwallgofddyn: posts the ante 250
PhoenixGrind: posts small blind 1000
Khanuman Men: posts big blind 2000
*** HOLE CARDS ***
sQuezzeYoU!!: folds 
jaimico00793: folds 
gwallgofddyn: folds 
hiran bass: folds 
StoraEss: folds 
atg590: folds 
PhoenixGrind: raises 3000 to 5000
Khanuman Men: raises 31668 to 36668 and is all-in
PhoenixGrind: calls 30945 and is all-in
Uncalled bet (723) returned to Khanuman Men
*** FLOP *** [Ks Ac 3c]
*** TURN *** [Ks Ac 3c] [3s]
*** RIVER *** [Ks Ac 3c 3s] [8s]
*** SHOW DOWN ***
PhoenixGrind: shows [Tc Ts] (two pair, Tens and Threes)
Khanuman Men: shows [Jh Js] (two pair, Jacks and Threes)
Khanuman Men collected 73890 from pot
PhoenixGrind finished the tournament
*** SUMMARY ***
Total pot 73890 | Rake 0 
Board [Ks Ac 3c 3s 8s]
Seat 1: hiran bass folded before Flop (didn't bet)
Seat 2: StoraEss folded before Flop (didn't bet)
Seat 3: atg590 (button) folded before Flop (didn't bet)
Seat 4: PhoenixGrind (small blind) showed [Tc Ts] and lost with two pair, Tens and Threes
Seat 5: Khanuman Men (big blind) showed [Jh Js] and won (73890) with two pair, Jacks and Threes
Seat 6: sQuezzeYoU!! folded before Flop (didn't bet)
Seat 7: jaimico00793 folded before Flop (didn't bet)
Seat 8: gwallgofddyn folded before Flop (didn't bet)

PokerStars Hand #251206010011: Tournament #3767885527, $40+$10+$5 USD Hold'em No Limit - Level XIV (1000/2000) - 2024/06/26 19:31:54 UTC [2024/06/26 15:31:54 ET]
Table '3767885527 35' 8-max Seat #5 is the button
Seat 1: hiran bass (19750 in chips) 
Seat 2: StoraEss (30392 in chips) 
Seat 3: atg590 (89538 in chips) 
Seat 5: Khanuman Men (74613 in chips) 
Seat 6: sQuezzeYoU!! (113974 in chips) 
Seat 7: jaimico00793 (48352 in chips) 
Seat 8: gwallgofddyn (128408 in chips) 
hiran bass: posts the ante 250
StoraEss: posts the ante 250
atg590: posts the ante 250
Khanuman Men: posts the ante 250
sQuezzeYoU!!: posts the ante 250
jaimico00793: posts the ante 250
gwallgofddyn: posts the ante 250
sQuezzeYoU!!: posts small blind 1000
jaimico00793: posts big blind 2000
*** HOLE CARDS ***
gwallgofddyn: folds 
hiran bass: folds 
StoraEss: folds 
atg590: folds 
Khanuman Men: folds 
sQuezzeYoU!!: calls 1000
jaimico00793: checks 
*** FLOP *** [Kh 4s Js]
sQuezzeYoU!!: bets 2121
Dih21 is disconnected 
jaimico00793: folds 
Uncalled bet (2121) returned to sQuezzeYoU!!
sQuezzeYoU!! collected 5750 from pot
sQuezzeYoU!!: doesn't show hand 
*** SUMMARY ***
Total pot 5750 | Rake 0 
Board [Kh 4s Js]
Seat 1: hiran bass folded before Flop (didn't bet)
Seat 2: StoraEss folded before Flop (didn't bet)
Seat 3: atg590 folded before Flop (didn't bet)
Seat 5: Khanuman Men (button) folded before Flop (didn't bet)
Seat 6: sQuezzeYoU!! (small blind) collected (5750)
Seat 7: jaimico00793 (big blind) folded on the Flop
Seat 8: gwallgofddyn folded before Flop (didn't bet)

PokerStars Hand #251206020088: Tournament #3767885527, $40+$10+$5 USD Hold'em No Limit - Level XIV (1000/2000) - 2024/06/26 19:32:30 UTC [2024/06/26 15:32:30 ET]
Table '3767885527 35' 8-max Seat #6 is the button
Seat 1: hiran bass (19500 in chips) 
Seat 2: StoraEss (30142 in chips) 
Seat 3: atg590 (89288 in chips) 
Seat 4: Dih21 (25000 in chips) 
Seat 5: Khanuman Men (74363 in chips) 
Seat 6: sQuezzeYoU!! (117474 in chips) 
Seat 7: jaimico00793 (46102 in chips) 
Seat 8: gwallgofddyn (128158 in chips) 
hiran bass: posts the ante 250
StoraEss: posts the ante 250
atg590: posts the ante 250
Dih21: posts the ante 250
Khanuman Men: posts the ante 250
sQuezzeYoU!!: posts the ante 250
jaimico00793: posts the ante 250
gwallgofddyn: posts the ante 250
jaimico00793: posts small blind 1000
gwallgofddyn: posts big blind 2000
*** HOLE CARDS ***
hiran bass: raises 17250 to 19250 and is all-in
StoraEss: folds 
atg590: folds 
Dih21: folds 
Khanuman Men: folds 
sQuezzeYoU!!: folds 
jaimico00793: folds 
gwallgofddyn: folds 
Uncalled bet (17250) returned to hiran bass
hiran bass collected 7000 from pot
hiran bass: doesn't show hand 
*** SUMMARY ***
Total pot 7000 | Rake 0 
Seat 1: hiran bass collected (7000)
Seat 2: StoraEss folded before Flop (didn't bet)
Seat 3: atg590 folded before Flop (didn't bet)
Seat 4: Dih21 folded before Flop (didn't bet)
Seat 5: Khanuman Men folded before Flop (didn't bet)
Seat 6: sQuezzeYoU!! (button) folded before Flop (didn't bet)
Seat 7: jaimico00793 (small blind) folded before Flop
Seat 8: gwallgofddyn (big blind) folded before Flop

PokerStars Hand #251206027954: Tournament #3767885527, $40+$10+$5 USD Hold'em No Limit - Level XIV (1000/2000) - 2024/06/26 19:32:59 UTC [2024/06/26 15:32:59 ET]
Table '3767885527 35' 8-max Seat #7 is the button
Seat 1: hiran bass (24250 in chips) 
Seat 2: StoraEss (29892 in chips) 
Seat 3: atg590 (89038 in chips) 
Seat 4: Dih21 (24750 in chips) 
Seat 5: Khanuman Men (74113 in chips) 
Seat 6: sQuezzeYoU!! (117224 in chips) 
Seat 7: jaimico00793 (44852 in chips) 
Seat 8: gwallgofddyn (125908 in chips) 
hiran bass: posts the ante 250
StoraEss: posts the ante 250
atg590: posts the ante 250
Dih21: posts the ante 250
Khanuman Men: posts the ante 250
sQuezzeYoU!!: posts the ante 250
jaimico00793: posts the ante 250
gwallgofddyn: posts the ante 250
gwallgofddyn: posts small blind 1000
hiran bass: posts big blind 2000
*** HOLE CARDS ***
StoraEss: folds 
atg590: folds 
Dih21: raises 22500 to 24500 and is all-in
Khanuman Men: folds 
sQuezzeYoU!!: folds 
jaimico00793: folds 
gwallgofddyn: folds 
hiran bass: folds 
Uncalled bet (22500) returned to Dih21
Dih21 collected 7000 from pot
Dih21: doesn't show hand 
*** SUMMARY ***
Total pot 7000 | Rake 0 
Seat 1: hiran bass (big blind) folded before Flop
Seat 2: StoraEss folded before Flop (didn't bet)
Seat 3: atg590 folded before Flop (didn't bet)
Seat 4: Dih21 collected (7000)
Seat 5: Khanuman Men folded before Flop (didn't bet)
Seat 6: sQuezzeYoU!! folded before Flop (didn't bet)
Seat 7: jaimico00793 (button) folded before Flop (didn't bet)
Seat 8: gwallgofddyn (small blind) folded before Flop

PokerStars Hand #251206034295: Tournament #3767885527, $40+$10+$5 USD Hold'em No Limit - Level XIV (1000/2000) - 2024/06/26 19:33:22 UTC [2024/06/26 15:33:22 ET]
Table '3767885527 35' 8-max Seat #8 is the button
Seat 1: hiran bass (22000 in chips) 
Seat 2: StoraEss (29642 in chips) 
Seat 3: atg590 (88788 in chips) 
Seat 4: Dih21 (29500 in chips) 
Seat 5: Khanuman Men (73863 in chips) 
Seat 6: sQuezzeYoU!! (116974 in chips) 
Seat 7: jaimico00793 (44602 in chips) 
Seat 8: gwallgofddyn (124658 in chips) 
hiran bass: posts the ante 250
StoraEss: posts the ante 250
atg590: posts the ante 250
Dih21: posts the ante 250
Khanuman Men: posts the ante 250
sQuezzeYoU!!: posts the ante 250
jaimico00793: posts the ante 250
gwallgofddyn: posts the ante 250
hiran bass: posts small blind 1000
StoraEss: posts big blind 2000
*** HOLE CARDS ***
atg590: folds 
Dih21: folds 
Khanuman Men: raises 2000 to 4000
sQuezzeYoU!!: folds 
jaimico00793: folds 
gwallgofddyn: calls 4000
hiran bass: folds 
StoraEss: raises 25392 to 29392 and is all-in
Khanuman Men: calls 25392
gwallgofddyn: calls 25392
*** FLOP *** [Ad 2h Kd]
Khanuman Men: checks 
gwallgofddyn: checks 
*** TURN *** [Ad 2h Kd] [2c]
Khanuman Men: bets 12000
gwallgofddyn: folds 
Uncalled bet (12000) returned to Khanuman Men
*** RIVER *** [Ad 2h Kd 2c] [8c]
*** SHOW DOWN ***
StoraEss: shows [7h Td] (a pair of Deuces)
Khanuman Men: shows [As Ac] (a full house, Aces full of Deuces)
Khanuman Men collected 91176 from pot
StoraEss finished the tournament
*** SUMMARY ***
Total pot 91176 | Rake 0 
Board [Ad 2h Kd 2c 8c]
Seat 1: hiran bass (small blind) folded before Flop
Seat 2: StoraEss (big blind) showed [7h Td] and lost with a pair of Deuces
Seat 3: atg590 folded before Flop (didn't bet)
Seat 4: Dih21 folded before Flop (didn't bet)
Seat 5: Khanuman Men showed [As Ac] and won (91176) with a full house, Aces full of Deuces
Seat 6: sQuezzeYoU!! folded before Flop (didn't bet)
Seat 7: jaimico00793 folded before Flop (didn't bet)
Seat 8: gwallgofddyn (button) folded on the Turn

PokerStars Hand #251206053476: Tournament #3767885527, $40+$10+$5 USD Hold'em No Limit - Level XIV (1000/2000) - 2024/06/26 19:34:32 UTC [2024/06/26 15:34:32 ET]
Table '3767885527 35' 8-max Seat #1 is the button
Seat 1: hiran bass (20750 in chips) 
Seat 3: atg590 (88538 in chips) 
Seat 4: Dih21 (29250 in chips) 
Seat 5: Khanuman Men (135397 in chips) 
Seat 6: sQuezzeYoU!! (116724 in chips) 
Seat 7: jaimico00793 (44352 in chips) 
Seat 8: gwallgofddyn (95016 in chips) 
hiran bass: posts the ante 250
atg590: posts the ante 250
Dih21: posts the ante 250
Khanuman Men: posts the ante 250
sQuezzeYoU!!: posts the ante 250
jaimico00793: posts the ante 250
gwallgofddyn: posts the ante 250
atg590: posts small blind 1000
Dih21: posts big blind 2000
*** HOLE CARDS ***
Khanuman Men: folds 
sQuezzeYoU!!: folds 
jaimico00793: folds 
gwallgofddyn: folds 
hiran bass: raises 18500 to 20500 and is all-in
atg590: folds 
Dih21: folds 
Uncalled bet (18500) returned to hiran bass
hiran bass collected 6750 from pot
hiran bass: doesn't show hand 
*** SUMMARY ***
Total pot 6750 | Rake 0 
Seat 1: hiran bass (button) collected (6750)
Seat 3: atg590 (small blind) folded before Flop
Seat 4: Dih21 (big blind) folded before Flop
Seat 5: Khanuman Men folded before Flop (didn't bet)
Seat 6: sQuezzeYoU!! folded before Flop (didn't bet)
Seat 7: jaimico00793 folded before Flop (didn't bet)
Seat 8: gwallgofddyn folded before Flop (didn't bet)

PokerStars Hand #251206059007: Tournament #3767885527, $40+$10+$5 USD Hold'em No Limit - Level XIV (1000/2000) - 2024/06/26 19:34:52 UTC [2024/06/26 15:34:52 ET]
Table '3767885527 35' 8-max Seat #3 is the button
Seat 1: hiran bass (25250 in chips) 
Seat 3: atg590 (87288 in chips) 
Seat 4: Dih21 (27000 in chips) 
Seat 5: Khanuman Men (135147 in chips) 
Seat 6: sQuezzeYoU!! (116474 in chips) 
Seat 7: jaimico00793 (44102 in chips) 
Seat 8: gwallgofddyn (94766 in chips) 
hiran bass: posts the ante 250
atg590: posts the ante 250
Dih21: posts the ante 250
Khanuman Men: posts the ante 250
sQuezzeYoU!!: posts the ante 250
jaimico00793: posts the ante 250
gwallgofddyn: posts the ante 250
Dih21: posts small blind 1000
Khanuman Men: posts big blind 2000
*** HOLE CARDS ***
sQuezzeYoU!!: folds 
jaimico00793: raises 2000 to 4000
gwallgofddyn: folds 
hiran bass: folds 
atg590: folds 
Dih21: raises 22750 to 26750 and is all-in
Khanuman Men: folds 
jaimico00793: calls 22750
*** FLOP *** [5c 8d 9s]
*** TURN *** [5c 8d 9s] [Jd]
*** RIVER *** [5c 8d 9s Jd] [6h]
EugeneShev is disconnected 
*** SHOW DOWN ***
Dih21: shows [As Qh] (high card Ace)
jaimico00793: shows [Qs Qc] (a pair of Queens)
jaimico00793 collected 57250 from pot
Dih21 finished the tournament
*** SUMMARY ***
Total pot 57250 | Rake 0 
Board [5c 8d 9s Jd 6h]
Seat 1: hiran bass folded before Flop (didn't bet)
Seat 3: atg590 (button) folded before Flop (didn't bet)
Seat 4: Dih21 (small blind) showed [As Qh] and lost with high card Ace
Seat 5: Khanuman Men (big blind) folded before Flop
Seat 6: sQuezzeYoU!! folded before Flop (didn't bet)
Seat 7: jaimico00793 showed [Qs Qc] and won (57250) with a pair of Queens
Seat 8: gwallgofddyn folded before Flop (didn't bet)

PokerStars Hand #251206066186: Tournament #3767885527, $40+$10+$5 USD Hold'em No Limit - Level XIV (1000/2000) - 2024/06/26 19:35:19 UTC [2024/06/26 15:35:19 ET]
Table '3767885527 35' 8-max Seat #5 is the button
Seat 1: hiran bass (25000 in chips) 
Seat 2: EugeneShev (25000 in chips) 
Seat 3: atg590 (87038 in chips) 
Seat 5: Khanuman Men (132897 in chips) 
Seat 6: sQuezzeYoU!! (116224 in chips) 
Seat 7: jaimico00793 (74352 in chips) 
Seat 8: gwallgofddyn (94516 in chips) 
hiran bass: posts the ante 250
EugeneShev: posts the ante 250
atg590: posts the ante 250
Khanuman Men: posts the ante 250
sQuezzeYoU!!: posts the ante 250
jaimico00793: posts the ante 250
gwallgofddyn: posts the ante 250
sQuezzeYoU!!: posts small blind 1000
jaimico00793: posts big blind 2000
*** HOLE CARDS ***
gwallgofddyn: folds 
hiran bass: folds 
XARANDROS is disconnected 
EugeneShev: raises 22750 to 24750 and is all-in
atg590: folds 
Khanuman Men: folds 
sQuezzeYoU!!: folds 
jaimico00793: calls 22750
*** FLOP *** [Td Js 6d]
*** TURN *** [Td Js 6d] [2h]
*** RIVER *** [Td Js 6d 2h] [8c]
*** SHOW DOWN ***
jaimico00793: shows [Ks Ac] (high card Ace)
EugeneShev: shows [Kc Qc] (high card King)
jaimico00793 collected 52250 from pot
EugeneShev finished the tournament
*** SUMMARY ***
Total pot 52250 | Rake 0 
Board [Td Js 6d 2h 8c]
Seat 1: hiran bass folded before Flop (didn't bet)
Seat 2: EugeneShev showed [Kc Qc] and lost with high card King
Seat 3: atg590 folded before Flop (didn't bet)
Seat 5: Khanuman Men (button) folded before Flop (didn't bet)
Seat 6: sQuezzeYoU!! (small blind) folded before Flop
Seat 7: jaimico00793 (big blind) showed [Ks Ac] and won (52250) with high card Ace
Seat 8: gwallgofddyn folded before Flop (didn't bet)

PokerStars Hand #251206087350: Tournament #3767885527, $40+$10+$5 USD Hold'em No Limit - Level XIV (1000/2000) - 2024/06/26 19:36:36 UTC [2024/06/26 15:36:36 ET]
Table '3767885527 35' 8-max Seat #6 is the button
Seat 1: hiran bass (24750 in chips) 
Seat 3: atg590 (86788 in chips) 
Seat 4: XARANDROS (21750 in chips) 
Seat 5: Khanuman Men (132647 in chips) 
Seat 6: sQuezzeYoU!! (114974 in chips) 
Seat 7: jaimico00793 (101602 in chips) 
Seat 8: gwallgofddyn (94266 in chips) 
hiran bass: posts the ante 250
atg590: posts the ante 250
XARANDROS: posts the ante 250
Khanuman Men: posts the ante 250
sQuezzeYoU!!: posts the ante 250
jaimico00793: posts the ante 250
gwallgofddyn: posts the ante 250
jaimico00793: posts small blind 1000
gwallgofddyn: posts big blind 2000
*** HOLE CARDS ***
hiran bass: folds 
atg590: raises 4000 to 6000
XARANDROS: folds 
sprase1999 is disconnected 
Khanuman Men: folds 
sQuezzeYoU!!: folds 
jaimico00793: folds 
gwallgofddyn: folds 
Uncalled bet (4000) returned to atg590
atg590 collected 6750 from pot
*** SUMMARY ***
Total pot 6750 | Rake 0 
Seat 1: hiran bass folded before Flop (didn't bet)
Seat 3: atg590 collected (6750)
Seat 4: XARANDROS folded before Flop (didn't bet)
Seat 5: Khanuman Men folded before Flop (didn't bet)
Seat 6: sQuezzeYoU!! (button) folded before Flop (didn't bet)
Seat 7: jaimico00793 (small blind) folded before Flop
Seat 8: gwallgofddyn (big blind) folded before Flop

PokerStars Hand #251206096179: Tournament #3767885527, $40+$10+$5 USD Hold'em No Limit - Level XIV (1000/2000) - 2024/06/26 19:37:08 UTC [2024/06/26 15:37:08 ET]
Table '3767885527 35' 8-max Seat #7 is the button
Seat 1: hiran bass (24500 in chips) 
Seat 2: sprase1999 (44428 in chips) 
Seat 3: atg590 (91288 in chips) 
Seat 4: XARANDROS (21500 in chips) 
Seat 5: Khanuman Men (132397 in chips) 
Seat 6: sQuezzeYoU!! (114724 in chips) 
Seat 7: jaimico00793 (100352 in chips) 
Seat 8: gwallgofddyn (92016 in chips) 
hiran bass: posts the ante 250
sprase1999: posts the ante 250
atg590: posts the ante 250
XARANDROS: posts the ante 250
Khanuman Men: posts the ante 250
sQuezzeYoU!!: posts the ante 250
jaimico00793: posts the ante 250
gwallgofddyn: posts the ante 250
gwallgofddyn: posts small blind 1000
hiran bass: posts big blind 2000
*** HOLE CARDS ***
sprase1999: folds 
atg590: raises 4000 to 6000
XARANDROS: folds 
Khanuman Men: folds 
sQuezzeYoU!!: folds 
jaimico00793: folds 
gwallgofddyn: folds 
hiran bass: folds 
Uncalled bet (4000) returned to atg590
atg590 collected 7000 from pot
*** SUMMARY ***
Total pot 7000 | Rake 0 
Seat 1: hiran bass (big blind) folded before Flop
Seat 2: sprase1999 folded before Flop (didn't bet)
Seat 3: atg590 collected (7000)
Seat 4: XARANDROS folded before Flop (didn't bet)
Seat 5: Khanuman Men folded before Flop (didn't bet)
Seat 6: sQuezzeYoU!! folded before Flop (didn't bet)
Seat 7: jaimico00793 (button) folded before Flop (didn't bet)
Seat 8: gwallgofddyn (small blind) folded before Flop

PokerStars Hand #251206102087: Tournament #3767885527, $40+$10+$5 USD Hold'em No Limit - Level XIV (1000/2000) - 2024/06/26 19:37:29 UTC [2024/06/26 15:37:29 ET]
Table '3767885527 35' 8-max Seat #8 is the button
Seat 1: hiran bass (22250 in chips) 
Seat 2: sprase1999 (44178 in chips) 
Seat 3: atg590 (96038 in chips) 
Seat 4: XARANDROS (21250 in chips) 
Seat 5: Khanuman Men (132147 in chips) 
Seat 6: sQuezzeYoU!! (114474 in chips) 
Seat 7: jaimico00793 (100102 in chips) 
Seat 8: gwallgofddyn (90766 in chips) 
hiran bass: posts the ante 250
sprase1999: posts the ante 250
atg590: posts the ante 250
XARANDROS: posts the ante 250
Khanuman Men: posts the ante 250
sQuezzeYoU!!: posts the ante 250
jaimico00793: posts the ante 250
gwallgofddyn: posts the ante 250
hiran bass: posts small blind 1000
sprase1999: posts big blind 2000
*** HOLE CARDS ***
atg590: folds 
XARANDROS: folds 
Khanuman Men: folds 
sQuezzeYoU!!: folds 
jaimico00793: folds 
gwallgofddyn: folds 
hiran bass: calls 1000
sprase1999: checks 
*** FLOP *** [Qs Qd Jh]
hiran bass: checks 
sprase1999: checks 
*** TURN *** [Qs Qd Jh] [Ts]
hiran bass: bets 2000
sprase1999: calls 2000
*** RIVER *** [Qs Qd Jh Ts] [3d]
hiran bass: bets 8000
sprase1999: folds 
Uncalled bet (8000) returned to hiran bass
hiran bass collected 10000 from pot
hiran bass: doesn't show hand 
*** SUMMARY ***
Total pot 10000 | Rake 0 
Board [Qs Qd Jh Ts 3d]
Seat 1: hiran bass (small blind) collected (10000)
Seat 2: sprase1999 (big blind) folded on the River
Seat 3: atg590 folded before Flop (didn't bet)
Seat 4: XARANDROS folded before Flop (didn't bet)
Seat 5: Khanuman Men folded before Flop (didn't bet)
Seat 6: sQuezzeYoU!! folded before Flop (didn't bet)
Seat 7: jaimico00793 folded before Flop (didn't bet)
Seat 8: gwallgofddyn (button) folded before Flop (didn't bet)

PokerStars Hand #251206116655: Tournament #3767885527, $40+$10+$5 USD Hold'em No Limit - Level XIV (1000/2000) - 2024/06/26 19:38:24 UTC [2024/06/26 15:38:24 ET]
Table '3767885527 35' 8-max Seat #1 is the button
Seat 1: hiran bass (28000 in chips) 
Seat 2: sprase1999 (39928 in chips) 
Seat 3: atg590 (95788 in chips) 
Seat 4: XARANDROS (21000 in chips) 
Seat 5: Khanuman Men (131897 in chips) 
Seat 6: sQuezzeYoU!! (114224 in chips) 
Seat 7: jaimico00793 (99852 in chips) 
Seat 8: gwallgofddyn (90516 in chips) 
hiran bass: posts the ante 250
sprase1999: posts the ante 250
atg590: posts the ante 250
XARANDROS: posts the ante 250
Khanuman Men: posts the ante 250
sQuezzeYoU!!: posts the ante 250
jaimico00793: posts the ante 250
gwallgofddyn: posts the ante 250
sprase1999: posts small blind 1000
atg590: posts big blind 2000
*** HOLE CARDS ***
XARANDROS: folds 
Khanuman Men: folds 
sQuezzeYoU!!: raises 2260 to 4260
jaimico00793: folds 
gwallgofddyn: folds 
hiran bass: folds 
sprase1999: folds 
atg590: calls 2260
*** FLOP *** [3c 5h Kh]
atg590: checks 
sQuezzeYoU!!: bets 3608
atg590: calls 3608
*** TURN *** [3c 5h Kh] [7h]
atg590: checks 
sQuezzeYoU!!: bets 15054
atg590: folds 
Uncalled bet (15054) returned to sQuezzeYoU!!
sQuezzeYoU!! collected 18736 from pot
sQuezzeYoU!!: doesn't show hand 
*** SUMMARY ***
Total pot 18736 | Rake 0 
Board [3c 5h Kh 7h]
Seat 1: hiran bass (button) folded before Flop (didn't bet)
Seat 2: sprase1999 (small blind) folded before Flop
Seat 3: atg590 (big blind) folded on the Turn
Seat 4: XARANDROS folded before Flop (didn't bet)
Seat 5: Khanuman Men folded before Flop (didn't bet)
Seat 6: sQuezzeYoU!! collected (18736)
Seat 7: jaimico00793 folded before Flop (didn't bet)
Seat 8: gwallgofddyn folded before Flop (didn't bet)

PokerStars Hand #251206137234: Tournament #3767885527, $40+$10+$5 USD Hold'em No Limit - Level XV (1250/2500) - 2024/06/26 19:39:39 UTC [2024/06/26 15:39:39 ET]
Table '3767885527 35' 8-max Seat #2 is the button
Seat 1: hiran bass (27750 in chips) 
Seat 2: sprase1999 (38678 in chips) 
Seat 3: atg590 (87670 in chips) 
Seat 4: XARANDROS (20750 in chips) 
Seat 5: Khanuman Men (131647 in chips) 
Seat 6: sQuezzeYoU!! (124842 in chips) 
Seat 7: jaimico00793 (99602 in chips) 
Seat 8: gwallgofddyn (90266 in chips) 
hiran bass: posts the ante 325
sprase1999: posts the ante 325
atg590: posts the ante 325
XARANDROS: posts the ante 325
Khanuman Men: posts the ante 325
sQuezzeYoU!!: posts the ante 325
jaimico00793: posts the ante 325
gwallgofddyn: posts the ante 325
atg590: posts small blind 1250
XARANDROS: posts big blind 2500
*** HOLE CARDS ***
Khanuman Men: folds 
sQuezzeYoU!!: folds 
jaimico00793: folds 
gwallgofddyn: folds 
hiran bass: folds 
sprase1999: raises 2500 to 5000
atg590: calls 3750
XARANDROS: calls 2500
*** FLOP *** [3s 2s As]
atg590: checks 
XARANDROS: checks 
sprase1999: checks 
*** TURN *** [3s 2s As] [2h]
atg590: bets 11300
XARANDROS: folds 
sprase1999: folds 
Uncalled bet (11300) returned to atg590
atg590 collected 17600 from pot
*** SUMMARY ***
Total pot 17600 | Rake 0 
Board [3s 2s As 2h]
Seat 1: hiran bass folded before Flop (didn't bet)
Seat 2: sprase1999 (button) folded on the Turn
Seat 3: atg590 (small blind) collected (17600)
Seat 4: XARANDROS (big blind) folded on the Turn
Seat 5: Khanuman Men folded before Flop (didn't bet)
Seat 6: sQuezzeYoU!! folded before Flop (didn't bet)
Seat 7: jaimico00793 folded before Flop (didn't bet)
Seat 8: gwallgofddyn folded before Flop (didn't bet)

PokerStars Hand #251206155113: Tournament #3767885527, $40+$10+$5 USD Hold'em No Limit - Level XV (1250/2500) - 2024/06/26 19:40:44 UTC [2024/06/26 15:40:44 ET]
Table '3767885527 35' 8-max Seat #3 is the button
Seat 1: hiran bass (27425 in chips) 
Seat 2: sprase1999 (33353 in chips) 
Seat 3: atg590 (99945 in chips) 
Seat 4: XARANDROS (15425 in chips) 
Seat 5: Khanuman Men (131322 in chips) 
Seat 6: sQuezzeYoU!! (124517 in chips) 
Seat 7: jaimico00793 (99277 in chips) 
Seat 8: gwallgofddyn (89941 in chips) 
hiran bass: posts the ante 325
sprase1999: posts the ante 325
atg590: posts the ante 325
XARANDROS: posts the ante 325
Khanuman Men: posts the ante 325
sQuezzeYoU!!: posts the ante 325
jaimico00793: posts the ante 325
gwallgofddyn: posts the ante 325
XARANDROS: posts small blind 1250
Khanuman Men: posts big blind 2500
*** HOLE CARDS ***
sQuezzeYoU!!: folds 
jaimico00793: folds 
gwallgofddyn: folds 
hiran bass: raises 24600 to 27100 and is all-in
sprase1999: raises 5928 to 33028 and is all-in
atg590: folds 
XARANDROS: calls 13850 and is all-in
Khanuman Men: folds 
Uncalled bet (5928) returned to sprase1999
*** FLOP *** [2d Ad 5s]
*** TURN *** [2d Ad 5s] [7h]
*** RIVER *** [2d Ad 5s 7h] [6h]
*** SHOW DOWN ***
hiran bass: shows [2s 2c] (three of a kind, Deuces)
sprase1999: shows [Js Qs] (high card Ace)
hiran bass collected 24000 from side pot
XARANDROS: shows [Kc As] (a pair of Aces)
hiran bass collected 50400 from main pot
XARANDROS finished the tournament in 585th place
*** SUMMARY ***
Total pot 74400 Main pot 50400. Side pot 24000. | Rake 0 
Board [2d Ad 5s 7h 6h]
Seat 1: hiran bass showed [2s 2c] and won (74400) with three of a kind, Deuces
Seat 2: sprase1999 showed [Js Qs] and lost with high card Ace
Seat 3: atg590 (button) folded before Flop (didn't bet)
Seat 4: XARANDROS (small blind) showed [Kc As] and lost with a pair of Aces
Seat 5: Khanuman Men (big blind) folded before Flop
Seat 6: sQuezzeYoU!! folded before Flop (didn't bet)
Seat 7: jaimico00793 folded before Flop (didn't bet)
Seat 8: gwallgofddyn folded before Flop (didn't bet)


PokerStars Hand #251206619955: Tournament #3767885527, $40+$10+$5 USD Hold'em No Limit - Level XVII (1750/3500) - 2024/06/26 20:09:49 UTC [2024/06/26 16:09:49 ET]
Table '3767885527 34' 8-max Seat #5 is the button
Seat 1: Bigprad (46872 in chips) 
Seat 2: martincho186 (79240 in chips) 
Seat 3: kuenne71 (152521 in chips) 
Seat 4: Equinox616 (176866 in chips) 
Seat 5: gladiatore99 (81128 in chips) 
Seat 6: SolidYerna (203657 in chips) 
Seat 7: Dominosu (145930 in chips) 
Seat 8: mazzy4629 (17725 in chips) 
Bigprad: posts the ante 450
martincho186: posts the ante 450
kuenne71: posts the ante 450
Equinox616: posts the ante 450
gladiatore99: posts the ante 450
SolidYerna: posts the ante 450
Dominosu: posts the ante 450
mazzy4629: posts the ante 450
SolidYerna: posts small blind 1750
Dominosu: posts big blind 3500
*** HOLE CARDS ***
mazzy4629: folds 
Bigprad: folds 
martincho186: folds 
kuenne71: folds 
Equinox616: folds 
gladiatore99: raises 3500 to 7000
SolidYerna: raises 196207 to 203207 and is all-in
Dominosu: folds 
gladiatore99: folds 
Uncalled bet (196207) returned to SolidYerna
SolidYerna collected 21100 from pot
SolidYerna: doesn't show hand 
*** SUMMARY ***
Total pot 21100 | Rake 0 
Seat 1: Bigprad folded before Flop (didn't bet)
Seat 2: martincho186 folded before Flop (didn't bet)
Seat 3: kuenne71 folded before Flop (didn't bet)
Seat 4: Equinox616 folded before Flop (didn't bet)
Seat 5: gladiatore99 (button) folded before Flop
Seat 6: SolidYerna (small blind) collected (21100)
Seat 7: Dominosu (big blind) folded before Flop
Seat 8: mazzy4629 folded before Flop (didn't bet)

PokerStars Hand #251206630683: Tournament #3767885527, $40+$10+$5 USD Hold'em No Limit - Level XVII (1750/3500) - 2024/06/26 20:10:26 UTC [2024/06/26 16:10:26 ET]
Table '3767885527 34' 8-max Seat #6 is the button
Seat 1: Bigprad (46422 in chips) 
Seat 2: martincho186 (78790 in chips) 
Seat 3: kuenne71 (152071 in chips) 
Seat 4: Equinox616 (176416 in chips) 
Seat 5: gladiatore99 (73678 in chips) 
Seat 6: SolidYerna (217307 in chips) 
Seat 7: Dominosu (141980 in chips) 
Seat 8: mazzy4629 (17275 in chips) 
Bigprad: posts the ante 450
martincho186: posts the ante 450
kuenne71: posts the ante 450
Equinox616: posts the ante 450
gladiatore99: posts the ante 450
SolidYerna: posts the ante 450
Dominosu: posts the ante 450
mazzy4629: posts the ante 450
Dominosu: posts small blind 1750
mazzy4629: posts big blind 3500
*** HOLE CARDS ***
Bigprad: folds 
martincho186: folds 
kuenne71: folds 
Equinox616: folds 
gladiatore99: folds 
SolidYerna: folds 
Dominosu: folds 
Uncalled bet (1750) returned to mazzy4629
mazzy4629 collected 7100 from pot
*** SUMMARY ***
Total pot 7100 | Rake 0 
Seat 1: Bigprad folded before Flop (didn't bet)
Seat 2: martincho186 folded before Flop (didn't bet)
Seat 3: kuenne71 folded before Flop (didn't bet)
Seat 4: Equinox616 folded before Flop (didn't bet)
Seat 5: gladiatore99 folded before Flop (didn't bet)
Seat 6: SolidYerna (button) folded before Flop (didn't bet)
Seat 7: Dominosu (small blind) folded before Flop
Seat 8: mazzy4629 (big blind) collected (7100)

PokerStars Hand #251206636906: Tournament #3767885527, $40+$10+$5 USD Hold'em No Limit - Level XVII (1750/3500) - 2024/06/26 20:10:48 UTC [2024/06/26 16:10:48 ET]
Table '3767885527 34' 8-max Seat #7 is the button
Seat 1: Bigprad (45972 in chips) 
Seat 2: martincho186 (78340 in chips) 
Seat 3: kuenne71 (151621 in chips) 
Seat 4: Equinox616 (175966 in chips) 
Seat 5: gladiatore99 (73228 in chips) 
Seat 6: SolidYerna (216857 in chips) 
Seat 7: Dominosu (139780 in chips) 
Seat 8: mazzy4629 (22175 in chips) 
Bigprad: posts the ante 450
martincho186: posts the ante 450
kuenne71: posts the ante 450
Equinox616: posts the ante 450
gladiatore99: posts the ante 450
SolidYerna: posts the ante 450
Dominosu: posts the ante 450
mazzy4629: posts the ante 450
mazzy4629: posts small blind 1750
Bigprad: posts big blind 3500
*** HOLE CARDS ***
martincho186: folds 
kuenne71: raises 3500 to 7000
Equinox616: folds 
gladiatore99: folds 
SolidYerna: folds 
Dominosu: folds 
mazzy4629: folds 
Bigprad: calls 3500
*** FLOP *** [2c Js 2h]
Bigprad: checks 
kuenne71: bets 9675
Bigprad: calls 9675
*** TURN *** [2c Js 2h] [5d]
Bigprad: checks 
kuenne71: bets 38700
Bigprad: folds 
Uncalled bet (38700) returned to kuenne71
kuenne71 collected 38700 from pot
kuenne71: doesn't show hand 
*** SUMMARY ***
Total pot 38700 | Rake 0 
Board [2c Js 2h 5d]
Seat 1: Bigprad (big blind) folded on the Turn
Seat 2: martincho186 folded before Flop (didn't bet)
Seat 3: kuenne71 collected (38700)
Seat 4: Equinox616 folded before Flop (didn't bet)
Seat 5: gladiatore99 folded before Flop (didn't bet)
Seat 6: SolidYerna folded before Flop (didn't bet)
Seat 7: Dominosu (button) folded before Flop (didn't bet)
Seat 8: mazzy4629 (small blind) folded before Flop

PokerStars Hand #251206644673: Tournament #3767885527, $40+$10+$5 USD Hold'em No Limit - Level XVII (1750/3500) - 2024/06/26 20:11:15 UTC [2024/06/26 16:11:15 ET]
Table '3767885527 34' 8-max Seat #8 is the button
Seat 1: Bigprad (28847 in chips) 
Seat 2: martincho186 (77890 in chips) 
Seat 3: kuenne71 (173196 in chips) 
Seat 4: Equinox616 (175516 in chips) 
Seat 5: gladiatore99 (72778 in chips) 
Seat 6: SolidYerna (216407 in chips) 
Seat 7: Dominosu (139330 in chips) 
Seat 8: mazzy4629 (19975 in chips) 
Bigprad: posts the ante 450
martincho186: posts the ante 450
kuenne71: posts the ante 450
Equinox616: posts the ante 450
gladiatore99: posts the ante 450
SolidYerna: posts the ante 450
Dominosu: posts the ante 450
mazzy4629: posts the ante 450
Bigprad: posts small blind 1750
martincho186: posts big blind 3500
*** HOLE CARDS ***
kuenne71: folds 
Equinox616: folds 
gladiatore99: folds 
SolidYerna: folds 
Dominosu: raises 3500 to 7000
mazzy4629: folds 
Bigprad: folds 
martincho186: calls 3500
*** FLOP *** [7s 8h 5s]
martincho186: checks 
Dominosu: checks 
*** TURN *** [7s 8h 5s] [4s]
martincho186: checks 
Dominosu: checks 
*** RIVER *** [7s 8h 5s 4s] [Ah]
martincho186: checks 
Dominosu: checks 
*** SHOW DOWN ***
martincho186: shows [Kd 9d] (high card Ace)
Dominosu: shows [7h Kh] (a pair of Sevens)
Dominosu collected 19350 from pot
*** SUMMARY ***
Total pot 19350 | Rake 0 
Board [7s 8h 5s 4s Ah]
Seat 1: Bigprad (small blind) folded before Flop
Seat 2: martincho186 (big blind) showed [Kd 9d] and lost with high card Ace
Seat 3: kuenne71 folded before Flop (didn't bet)
Seat 4: Equinox616 folded before Flop (didn't bet)
Seat 5: gladiatore99 folded before Flop (didn't bet)
Seat 6: SolidYerna folded before Flop (didn't bet)
Seat 7: Dominosu showed [7h Kh] and won (19350) with a pair of Sevens
Seat 8: mazzy4629 (button) folded before Flop (didn't bet)

PokerStars Hand #251206658680: Tournament #3767885527, $40+$10+$5 USD Hold'em No Limit - Level XVII (1750/3500) - 2024/06/26 20:12:05 UTC [2024/06/26 16:12:05 ET]
Table '3767885527 34' 8-max Seat #1 is the button
Seat 1: Bigprad (26647 in chips) 
Seat 2: martincho186 (70440 in chips) 
Seat 3: kuenne71 (172746 in chips) 
Seat 4: Equinox616 (175066 in chips) 
Seat 5: gladiatore99 (72328 in chips) 
Seat 6: SolidYerna (215957 in chips) 
Seat 7: Dominosu (151230 in chips) 
Seat 8: mazzy4629 (19525 in chips) 
Bigprad: posts the ante 450
martincho186: posts the ante 450
kuenne71: posts the ante 450
Equinox616: posts the ante 450
gladiatore99: posts the ante 450
SolidYerna: posts the ante 450
Dominosu: posts the ante 450
mazzy4629: posts the ante 450
martincho186: posts small blind 1750
kuenne71: posts big blind 3500
*** HOLE CARDS ***
Equinox616: folds 
gladiatore99: folds 
SolidYerna: raises 3850 to 7350
Dominosu: folds 
mazzy4629: folds 
Bigprad: raises 18847 to 26197 and is all-in
martincho186: folds 
kuenne71: folds 
SolidYerna: calls 18847
*** FLOP *** [4c 3s 6h]
*** TURN *** [4c 3s 6h] [7s]
*** RIVER *** [4c 3s 6h 7s] [8c]
*** SHOW DOWN ***
SolidYerna: shows [Ac Tc] (high card Ace)
Bigprad: shows [2c 2d] (a pair of Deuces)
Bigprad collected 61244 from pot
*** SUMMARY ***
Total pot 61244 | Rake 0 
Board [4c 3s 6h 7s 8c]
Seat 1: Bigprad (button) showed [2c 2d] and won (61244) with a pair of Deuces
Seat 2: martincho186 (small blind) folded before Flop
Seat 3: kuenne71 (big blind) folded before Flop
Seat 4: Equinox616 folded before Flop (didn't bet)
Seat 5: gladiatore99 folded before Flop (didn't bet)
Seat 6: SolidYerna showed [Ac Tc] and lost with high card Ace
Seat 7: Dominosu folded before Flop (didn't bet)
Seat 8: mazzy4629 folded before Flop (didn't bet)

PokerStars Hand #251206671507: Tournament #3767885527, $40+$10+$5 USD Hold'em No Limit - Level XVII (1750/3500) - 2024/06/26 20:12:50 UTC [2024/06/26 16:12:50 ET]
Table '3767885527 34' 8-max Seat #2 is the button
Seat 1: Bigprad (61244 in chips) 
Seat 2: martincho186 (68240 in chips) 
Seat 3: kuenne71 (168796 in chips) 
Seat 4: Equinox616 (174616 in chips) 
Seat 5: gladiatore99 (71878 in chips) 
Seat 6: SolidYerna (189310 in chips) 
Seat 7: Dominosu (150780 in chips) 
Seat 8: mazzy4629 (19075 in chips) 
Bigprad: posts the ante 450
martincho186: posts the ante 450
kuenne71: posts the ante 450
Equinox616: posts the ante 450
gladiatore99: posts the ante 450
SolidYerna: posts the ante 450
Dominosu: posts the ante 450
mazzy4629: posts the ante 450
kuenne71: posts small blind 1750
Equinox616: posts big blind 3500
*** HOLE CARDS ***
gladiatore99: raises 3500 to 7000
SolidYerna: folds 
Dominosu: folds 
mazzy4629: folds 
Bigprad: folds 
martincho186: folds 
kuenne71: folds 
Equinox616: calls 3500
*** FLOP *** [4s Jh Ts]
Equinox616: checks 
gladiatore99: checks 
*** TURN *** [4s Jh Ts] [4h]
Equinox616: bets 7000
gladiatore99: calls 7000
*** RIVER *** [4s Jh Ts 4h] [8c]
Equinox616: bets 17500
gladiatore99: folds 
Uncalled bet (17500) returned to Equinox616
Equinox616 collected 33350 from pot
Equinox616: doesn't show hand 
*** SUMMARY ***
Total pot 33350 | Rake 0 
Board [4s Jh Ts 4h 8c]
Seat 1: Bigprad folded before Flop (didn't bet)
Seat 2: martincho186 (button) folded before Flop (didn't bet)
Seat 3: kuenne71 (small blind) folded before Flop
Seat 4: Equinox616 (big blind) collected (33350)
Seat 5: gladiatore99 folded on the River
Seat 6: SolidYerna folded before Flop (didn't bet)
Seat 7: Dominosu folded before Flop (didn't bet)
Seat 8: mazzy4629 folded before Flop (didn't bet)

PokerStars Hand #251206692239: Tournament #3767885527, $40+$10+$5 USD Hold'em No Limit - Level XVII (1750/3500) - 2024/06/26 20:14:05 UTC [2024/06/26 16:14:05 ET]
Table '3767885527 34' 8-max Seat #3 is the button
Seat 1: Bigprad (60794 in chips) 
Seat 2: martincho186 (67790 in chips) 
Seat 3: kuenne71 (166596 in chips) 
Seat 4: Equinox616 (193516 in chips) 
Seat 5: gladiatore99 (57428 in chips) 
Seat 6: SolidYerna (188860 in chips) 
Seat 7: Dominosu (150330 in chips) 
Seat 8: mazzy4629 (18625 in chips) 
Bigprad: posts the ante 450
martincho186: posts the ante 450
kuenne71: posts the ante 450
Equinox616: posts the ante 450
gladiatore99: posts the ante 450
SolidYerna: posts the ante 450
Dominosu: posts the ante 450
mazzy4629: posts the ante 450
Equinox616: posts small blind 1750
gladiatore99: posts big blind 3500
*** HOLE CARDS ***
SolidYerna: folds 
Dominosu: raises 4200 to 7700
mazzy4629: folds 
Bigprad: folds 
martincho186: folds 
kuenne71: folds 
Equinox616: folds 
gladiatore99: folds 
Uncalled bet (4200) returned to Dominosu
Dominosu collected 12350 from pot
Dominosu: doesn't show hand 
*** SUMMARY ***
Total pot 12350 | Rake 0 
Seat 1: Bigprad folded before Flop (didn't bet)
Seat 2: martincho186 folded before Flop (didn't bet)
Seat 3: kuenne71 (button) folded before Flop (didn't bet)
Seat 4: Equinox616 (small blind) folded before Flop
Seat 5: gladiatore99 (big blind) folded before Flop
Seat 6: SolidYerna folded before Flop (didn't bet)
Seat 7: Dominosu collected (12350)
Seat 8: mazzy4629 folded before Flop (didn't bet)

PokerStars Hand #251206697297: Tournament #3767885527, $40+$10+$5 USD Hold'em No Limit - Level XVII (1750/3500) - 2024/06/26 20:14:23 UTC [2024/06/26 16:14:23 ET]
Table '3767885527 34' 8-max Seat #4 is the button
Seat 1: Bigprad (60344 in chips) 
Seat 2: martincho186 (67340 in chips) 
Seat 3: kuenne71 (166146 in chips) 
Seat 4: Equinox616 (191316 in chips) 
Seat 5: gladiatore99 (53478 in chips) 
Seat 6: SolidYerna (188410 in chips) 
Seat 7: Dominosu (158730 in chips) 
Seat 8: mazzy4629 (18175 in chips) 
Bigprad: posts the ante 450
martincho186: posts the ante 450
kuenne71: posts the ante 450
Equinox616: posts the ante 450
gladiatore99: posts the ante 450
SolidYerna: posts the ante 450
Dominosu: posts the ante 450
mazzy4629: posts the ante 450
gladiatore99: posts small blind 1750
SolidYerna: posts big blind 3500
*** HOLE CARDS ***
Dominosu: folds 
mazzy4629: folds 
Bigprad: folds 
martincho186: folds 
kuenne71: raises 3500 to 7000
Equinox616: calls 7000
gladiatore99: folds 
SolidYerna: folds 
*** FLOP *** [9s 2h 6d]
kuenne71: checks 
Equinox616: checks 
*** TURN *** [9s 2h 6d] [5s]
kuenne71: checks 
Equinox616: bets 11425
kuenne71: calls 11425
*** RIVER *** [9s 2h 6d 5s] [Kc]
kuenne71: checks 
Equinox616: checks 
*** SHOW DOWN ***
kuenne71: shows [Ac 7s] (high card Ace)
Equinox616: shows [9c Jh] (a pair of Nines)
Equinox616 collected 45700 from pot
*** SUMMARY ***
Total pot 45700 | Rake 0 
Board [9s 2h 6d 5s Kc]
Seat 1: Bigprad folded before Flop (didn't bet)
Seat 2: martincho186 folded before Flop (didn't bet)
Seat 3: kuenne71 showed [Ac 7s] and lost with high card Ace
Seat 4: Equinox616 (button) showed [9c Jh] and won (45700) with a pair of Nines
Seat 5: gladiatore99 (small blind) folded before Flop
Seat 6: SolidYerna (big blind) folded before Flop
Seat 7: Dominosu folded before Flop (didn't bet)
Seat 8: mazzy4629 folded before Flop (didn't bet)

PokerStars Hand #251206715787: Tournament #3767885527, $40+$10+$5 USD Hold'em No Limit - Level XVII (1750/3500) - 2024/06/26 20:15:28 UTC [2024/06/26 16:15:28 ET]
Table '3767885527 34' 8-max Seat #5 is the button
Seat 1: Bigprad (59894 in chips) 
Seat 2: martincho186 (66890 in chips) 
Seat 3: kuenne71 (147271 in chips) 
Seat 4: Equinox616 (218141 in chips) 
Seat 5: gladiatore99 (51278 in chips) 
Seat 6: SolidYerna (184460 in chips) 
Seat 7: Dominosu (158280 in chips) 
Seat 8: mazzy4629 (17725 in chips) 
Bigprad: posts the ante 450
martincho186: posts the ante 450
kuenne71: posts the ante 450
Equinox616: posts the ante 450
gladiatore99: posts the ante 450
SolidYerna: posts the ante 450
Dominosu: posts the ante 450
mazzy4629: posts the ante 450
SolidYerna: posts small blind 1750
Dominosu: posts big blind 3500
*** HOLE CARDS ***
mazzy4629: raises 13775 to 17275 and is all-in
Bigprad: folds 
martincho186: folds 
kuenne71: folds 
Equinox616: folds 
gladiatore99: folds 
SolidYerna: folds 
Dominosu: folds 
Uncalled bet (13775) returned to mazzy4629
mazzy4629 collected 12350 from pot
*** SUMMARY ***
Total pot 12350 | Rake 0 
Seat 1: Bigprad folded before Flop (didn't bet)
Seat 2: martincho186 folded before Flop (didn't bet)
Seat 3: kuenne71 folded before Flop (didn't bet)
Seat 4: Equinox616 folded before Flop (didn't bet)
Seat 5: gladiatore99 (button) folded before Flop (didn't bet)
Seat 6: SolidYerna (small blind) folded before Flop
Seat 7: Dominosu (big blind) folded before Flop
Seat 8: mazzy4629 collected (12350)

PokerStars Hand #251206723933: Tournament #3767885527, $40+$10+$5 USD Hold'em No Limit - Level XVIII (2000/4000) - 2024/06/26 20:15:57 UTC [2024/06/26 16:15:57 ET]
Table '3767885527 34' 8-max Seat #6 is the button
Seat 1: Bigprad (59444 in chips) 
Seat 2: martincho186 (66440 in chips) 
Seat 3: kuenne71 (146821 in chips) 
Seat 4: Equinox616 (217691 in chips) 
Seat 5: gladiatore99 (50828 in chips) 
Seat 6: SolidYerna (182260 in chips) 
Seat 7: Dominosu (154330 in chips) 
Seat 8: mazzy4629 (26125 in chips) 
Bigprad: posts the ante 500
martincho186: posts the ante 500
kuenne71: posts the ante 500
Equinox616: posts the ante 500
gladiatore99: posts the ante 500
SolidYerna: posts the ante 500
Dominosu: posts the ante 500
mazzy4629: posts the ante 500
Dominosu: posts small blind 2000
mazzy4629: posts big blind 4000
*** HOLE CARDS ***
Bigprad: folds 
martincho186: raises 4000 to 8000
kuenne71: folds 
Equinox616: folds 
gladiatore99: folds 
SolidYerna: folds 
Dominosu: folds 
mazzy4629: folds 
Uncalled bet (4000) returned to martincho186
martincho186 collected 14000 from pot
*** SUMMARY ***
Total pot 14000 | Rake 0 
Seat 1: Bigprad folded before Flop (didn't bet)
Seat 2: martincho186 collected (14000)
Seat 3: kuenne71 folded before Flop (didn't bet)
Seat 4: Equinox616 folded before Flop (didn't bet)
Seat 5: gladiatore99 folded before Flop (didn't bet)
Seat 6: SolidYerna (button) folded before Flop (didn't bet)
Seat 7: Dominosu (small blind) folded before Flop
Seat 8: mazzy4629 (big blind) folded before Flop

PokerStars Hand #251206730587: Tournament #3767885527, $40+$10+$5 USD Hold'em No Limit - Level XVIII (2000/4000) - 2024/06/26 20:16:20 UTC [2024/06/26 16:16:20 ET]
Table '3767885527 34' 8-max Seat #7 is the button
Seat 1: Bigprad (58944 in chips) 
Seat 2: martincho186 (75940 in chips) 
Seat 3: kuenne71 (146321 in chips) 
Seat 4: Equinox616 (217191 in chips) 
Seat 5: gladiatore99 (50328 in chips) 
Seat 6: SolidYerna (181760 in chips) 
Seat 7: Dominosu (151830 in chips) 
Seat 8: mazzy4629 (21625 in chips) 
Bigprad: posts the ante 500
martincho186: posts the ante 500
kuenne71: posts the ante 500
Equinox616: posts the ante 500
gladiatore99: posts the ante 500
SolidYerna: posts the ante 500
Dominosu: posts the ante 500
mazzy4629: posts the ante 500
mazzy4629: posts small blind 2000
Bigprad: posts big blind 4000
*** HOLE CARDS ***
martincho186: folds 
kuenne71: folds 
Equinox616: raises 6000 to 10000
gladiatore99: folds 
SolidYerna: folds 
Dominosu: folds 
mazzy4629: folds 
Bigprad: folds 
Uncalled bet (6000) returned to Equinox616
Equinox616 collected 14000 from pot
Equinox616: doesn't show hand 
*** SUMMARY ***
Total pot 14000 | Rake 0 
Seat 1: Bigprad (big blind) folded before Flop
Seat 2: martincho186 folded before Flop (didn't bet)
Seat 3: kuenne71 folded before Flop (didn't bet)
Seat 4: Equinox616 collected (14000)
Seat 5: gladiatore99 folded before Flop (didn't bet)
Seat 6: SolidYerna folded before Flop (didn't bet)
Seat 7: Dominosu (button) folded before Flop (didn't bet)
Seat 8: mazzy4629 (small blind) folded before Flop

PokerStars Hand #251206747254: Tournament #3767885527, $40+$10+$5 USD Hold'em No Limit - Level XVIII (2000/4000) - 2024/06/26 20:17:20 UTC [2024/06/26 16:17:20 ET]
Table '3767885527 34' 8-max Seat #8 is the button
Seat 1: Bigprad (54444 in chips) 
Seat 2: martincho186 (75440 in chips) 
Seat 3: kuenne71 (145821 in chips) 
Seat 4: Equinox616 (226691 in chips) 
Seat 5: gladiatore99 (49828 in chips) 
Seat 6: SolidYerna (181260 in chips) 
Seat 7: Dominosu (151330 in chips) 
Seat 8: mazzy4629 (19125 in chips) 
Bigprad: posts the ante 500
martincho186: posts the ante 500
kuenne71: posts the ante 500
Equinox616: posts the ante 500
gladiatore99: posts the ante 500
SolidYerna: posts the ante 500
Dominosu: posts the ante 500
mazzy4629: posts the ante 500
Bigprad: posts small blind 2000
martincho186: posts big blind 4000
*** HOLE CARDS ***
kuenne71: folds 
Equinox616: folds 
gladiatore99: folds 
SolidYerna: folds 
Dominosu: raises 4800 to 8800
mazzy4629: folds 
Bigprad: folds 
martincho186: folds 
Uncalled bet (4800) returned to Dominosu
Dominosu collected 14000 from pot
Dominosu: doesn't show hand 
*** SUMMARY ***
Total pot 14000 | Rake 0 
Seat 1: Bigprad (small blind) folded before Flop
Seat 2: martincho186 (big blind) folded before Flop
Seat 3: kuenne71 folded before Flop (didn't bet)
Seat 4: Equinox616 folded before Flop (didn't bet)
Seat 5: gladiatore99 folded before Flop (didn't bet)
Seat 6: SolidYerna folded before Flop (didn't bet)
Seat 7: Dominosu collected (14000)
Seat 8: mazzy4629 (button) folded before Flop (didn't bet)

PokerStars Hand #251206752472: Tournament #3767885527, $40+$10+$5 USD Hold'em No Limit - Level XVIII (2000/4000) - 2024/06/26 20:17:39 UTC [2024/06/26 16:17:39 ET]
Table '3767885527 34' 8-max Seat #1 is the button
Seat 1: Bigprad (51944 in chips) 
Seat 2: martincho186 (70940 in chips) 
Seat 3: kuenne71 (145321 in chips) 
Seat 4: Equinox616 (226191 in chips) 
Seat 5: gladiatore99 (49328 in chips) 
Seat 6: SolidYerna (180760 in chips) 
Seat 7: Dominosu (160830 in chips) 
Seat 8: mazzy4629 (18625 in chips) 
Bigprad: posts the ante 500
martincho186: posts the ante 500
kuenne71: posts the ante 500
Equinox616: posts the ante 500
gladiatore99: posts the ante 500
SolidYerna: posts the ante 500
Dominosu: posts the ante 500
mazzy4629: posts the ante 500
martincho186: posts small blind 2000
kuenne71: posts big blind 4000
*** HOLE CARDS ***
Equinox616: raises 4000 to 8000
gladiatore99: folds 
SolidYerna: folds 
Dominosu: raises 14000 to 22000
mazzy4629: folds 
Bigprad: folds 
martincho186: folds 
kuenne71: folds 
Equinox616: calls 14000
*** FLOP *** [6s 6h Qc]
Equinox616: bets 31000
Dominosu: calls 31000
*** TURN *** [6s 6h Qc] [6d]
Equinox616: checks 
Dominosu: checks 
*** RIVER *** [6s 6h Qc 6d] [8s]
Equinox616: bets 32000
Dominosu: raises 75330 to 107330 and is all-in
Equinox616: calls 75330
*** SHOW DOWN ***
Dominosu: shows [Kc Ks] (a full house, Sixes full of Kings)
Equinox616: shows [Qh Kd] (a full house, Sixes full of Queens)
Dominosu collected 330660 from pot
*** SUMMARY ***
Total pot 330660 | Rake 0 
Board [6s 6h Qc 6d 8s]
Seat 1: Bigprad (button) folded before Flop (didn't bet)
Seat 2: martincho186 (small blind) folded before Flop
Seat 3: kuenne71 (big blind) folded before Flop
Seat 4: Equinox616 showed [Qh Kd] and lost with a full house, Sixes full of Queens
Seat 5: gladiatore99 folded before Flop (didn't bet)
Seat 6: SolidYerna folded before Flop (didn't bet)
Seat 7: Dominosu showed [Kc Ks] and won (330660) with a full house, Sixes full of Kings
Seat 8: mazzy4629 folded before Flop (didn't bet)

PokerStars Hand #251206804174: Tournament #3767885527, $40+$10+$5 USD Hold'em No Limit - Level XVIII (2000/4000) - 2024/06/26 20:20:42 UTC [2024/06/26 16:20:42 ET]
Table '3767885527 34' 8-max Seat #2 is the button
Seat 1: Bigprad (51444 in chips) 
Seat 2: martincho186 (68440 in chips) 
Seat 3: kuenne71 (140821 in chips) 
Seat 4: Equinox616 (65361 in chips) 
Seat 5: gladiatore99 (48828 in chips) 
Seat 6: SolidYerna (180260 in chips) 
Seat 7: Dominosu (330660 in chips) 
Seat 8: mazzy4629 (18125 in chips) 
Bigprad: posts the ante 500
martincho186: posts the ante 500
kuenne71: posts the ante 500
Equinox616: posts the ante 500
gladiatore99: posts the ante 500
SolidYerna: posts the ante 500
Dominosu: posts the ante 500
mazzy4629: posts the ante 500
kuenne71: posts small blind 2000
Equinox616: posts big blind 4000
*** HOLE CARDS ***
gladiatore99: folds 
SolidYerna: folds 
Dominosu: raises 4800 to 8800
mazzy4629: folds 
Bigprad: folds 
martincho186: folds 
kuenne71: calls 6800
Equinox616: folds 
*** FLOP *** [Kh 2c Qs]
kuenne71: checks 
Dominosu: checks 
*** TURN *** [Kh 2c Qs] [7s]
kuenne71: checks 
Dominosu: bets 8448
kuenne71: folds 
Uncalled bet (8448) returned to Dominosu
Dominosu collected 25600 from pot
Dominosu: doesn't show hand 
*** SUMMARY ***
Total pot 25600 | Rake 0 
Board [Kh 2c Qs 7s]
Seat 1: Bigprad folded before Flop (didn't bet)
Seat 2: martincho186 (button) folded before Flop (didn't bet)
Seat 3: kuenne71 (small blind) folded on the Turn
Seat 4: Equinox616 (big blind) folded before Flop
Seat 5: gladiatore99 folded before Flop (didn't bet)
Seat 6: SolidYerna folded before Flop (didn't bet)
Seat 7: Dominosu collected (25600)
Seat 8: mazzy4629 folded before Flop (didn't bet)

PokerStars Hand #251206822533: Tournament #3767885527, $40+$10+$5 USD Hold'em No Limit - Level XVIII (2000/4000) - 2024/06/26 20:21:47 UTC [2024/06/26 16:21:47 ET]
Table '3767885527 34' 8-max Seat #3 is the button
Seat 1: Bigprad (50944 in chips) 
Seat 2: martincho186 (67940 in chips) 
Seat 3: kuenne71 (131521 in chips) 
Seat 4: Equinox616 (60861 in chips) 
Seat 5: gladiatore99 (48328 in chips) 
Seat 6: SolidYerna (179760 in chips) 
Seat 7: Dominosu (346960 in chips) 
Seat 8: mazzy4629 (17625 in chips) 
Bigprad: posts the ante 500
martincho186: posts the ante 500
kuenne71: posts the ante 500
Equinox616: posts the ante 500
gladiatore99: posts the ante 500
SolidYerna: posts the ante 500
Dominosu: posts the ante 500
mazzy4629: posts the ante 500
Equinox616: posts small blind 2000
gladiatore99: posts big blind 4000
*** HOLE CARDS ***
SolidYerna: folds 
Dominosu: folds 
mazzy4629: folds 
Bigprad: raises 46444 to 50444 and is all-in
martincho186: folds 
kuenne71: folds 
Equinox616: raises 9917 to 60361 and is all-in
gladiatore99: folds 
Uncalled bet (9917) returned to Equinox616
*** FLOP *** [4h 5d As]
*** TURN *** [4h 5d As] [Qc]
*** RIVER *** [4h 5d As Qc] [5s]
*** SHOW DOWN ***
Equinox616: shows [9h Ac] (two pair, Aces and Fives)
Bigprad: shows [Qh Ah] (two pair, Aces and Queens)
Bigprad collected 108888 from pot
*** SUMMARY ***
Total pot 108888 | Rake 0 
Board [4h 5d As Qc 5s]
Seat 1: Bigprad showed [Qh Ah] and won (108888) with two pair, Aces and Queens
Seat 2: martincho186 folded before Flop (didn't bet)
Seat 3: kuenne71 (button) folded before Flop (didn't bet)
Seat 4: Equinox616 (small blind) showed [9h Ac] and lost with two pair, Aces and Fives
Seat 5: gladiatore99 (big blind) folded before Flop
Seat 6: SolidYerna folded before Flop (didn't bet)
Seat 7: Dominosu folded before Flop (didn't bet)
Seat 8: mazzy4629 folded before Flop (didn't bet)

PokerStars Hand #251206836302: Tournament #3767885527, $40+$10+$5 USD Hold'em No Limit - Level XVIII (2000/4000) - 2024/06/26 20:22:36 UTC [2024/06/26 16:22:36 ET]
Table '3767885527 34' 8-max Seat #4 is the button
Seat 1: Bigprad (108888 in chips) 
Seat 2: martincho186 (67440 in chips) 
Seat 3: kuenne71 (131021 in chips) 
Seat 4: Equinox616 (9917 in chips) 
Seat 5: gladiatore99 (43828 in chips) 
Seat 6: SolidYerna (179260 in chips) 
Seat 7: Dominosu (346460 in chips) 
Seat 8: mazzy4629 (17125 in chips) 
Bigprad: posts the ante 500
martincho186: posts the ante 500
kuenne71: posts the ante 500
Equinox616: posts the ante 500
gladiatore99: posts the ante 500
SolidYerna: posts the ante 500
Dominosu: posts the ante 500
mazzy4629: posts the ante 500
gladiatore99: posts small blind 2000
SolidYerna: posts big blind 4000
*** HOLE CARDS ***
Dominosu: folds 
mazzy4629: folds 
Bigprad: folds 
martincho186: folds 
kuenne71: folds 
Equinox616: raises 5417 to 9417 and is all-in
gladiatore99: calls 7417
SolidYerna: folds 
*** FLOP *** [Qd 4h 9d]
*** TURN *** [Qd 4h 9d] [Qh]
*** RIVER *** [Qd 4h 9d Qh] [8h]
*** SHOW DOWN ***
gladiatore99: shows [Ah Ac] (two pair, Aces and Queens)
Equinox616: shows [6h 7h] (a flush, Queen high)
Equinox616 collected 26834 from pot
*** SUMMARY ***
Total pot 26834 | Rake 0 
Board [Qd 4h 9d Qh 8h]
Seat 1: Bigprad folded before Flop (didn't bet)
Seat 2: martincho186 folded before Flop (didn't bet)
Seat 3: kuenne71 folded before Flop (didn't bet)
Seat 4: Equinox616 (button) showed [6h 7h] and won (26834) with a flush, Queen high
Seat 5: gladiatore99 (small blind) showed [Ah Ac] and lost with two pair, Aces and Queens
Seat 6: SolidYerna (big blind) folded before Flop
Seat 7: Dominosu folded before Flop (didn't bet)
Seat 8: mazzy4629 folded before Flop (didn't bet)

PokerStars Hand #251206847393: Tournament #3767885527, $40+$10+$5 USD Hold'em No Limit - Level XVIII (2000/4000) - 2024/06/26 20:23:16 UTC [2024/06/26 16:23:16 ET]
Table '3767885527 34' 8-max Seat #5 is the button
Seat 1: Bigprad (108388 in chips) 
Seat 2: martincho186 (66940 in chips) 
Seat 3: kuenne71 (130521 in chips) 
Seat 4: Equinox616 (26834 in chips) 
Seat 5: gladiatore99 (33911 in chips) 
Seat 6: SolidYerna (174760 in chips) 
Seat 7: Dominosu (345960 in chips) 
Seat 8: mazzy4629 (16625 in chips) 
Bigprad: posts the ante 500
martincho186: posts the ante 500
kuenne71: posts the ante 500
Equinox616: posts the ante 500
gladiatore99: posts the ante 500
SolidYerna: posts the ante 500
Dominosu: posts the ante 500
mazzy4629: posts the ante 500
SolidYerna: posts small blind 2000
Dominosu: posts big blind 4000
*** HOLE CARDS ***
mazzy4629: raises 12125 to 16125 and is all-in
Bigprad: folds 
martincho186: folds 
kuenne71: folds 
Equinox616: folds 
gladiatore99: folds 
SolidYerna: folds 
Dominosu has timed out
Dominosu: folds 
Dominosu is sitting out
Uncalled bet (12125) returned to mazzy4629
Dominosu has returned
mazzy4629 collected 14000 from pot
*** SUMMARY ***
Total pot 14000 | Rake 0 
Seat 1: Bigprad folded before Flop (didn't bet)
Seat 2: martincho186 folded before Flop (didn't bet)
Seat 3: kuenne71 folded before Flop (didn't bet)
Seat 4: Equinox616 folded before Flop (didn't bet)
Seat 5: gladiatore99 (button) folded before Flop (didn't bet)
Seat 6: SolidYerna (small blind) folded before Flop
Seat 7: Dominosu (big blind) folded before Flop
Seat 8: mazzy4629 collected (14000)

PokerStars Hand #251206856352: Tournament #3767885527, $40+$10+$5 USD Hold'em No Limit - Level XVIII (2000/4000) - 2024/06/26 20:23:48 UTC [2024/06/26 16:23:48 ET]
Table '3767885527 34' 8-max Seat #6 is the button
Seat 1: Bigprad (107888 in chips) 
Seat 2: martincho186 (66440 in chips) 
Seat 3: kuenne71 (130021 in chips) 
Seat 4: Equinox616 (26334 in chips) 
Seat 5: gladiatore99 (33411 in chips) 
Seat 6: SolidYerna (172260 in chips) 
Seat 7: Dominosu (341460 in chips) 
Seat 8: mazzy4629 (26125 in chips) 
Bigprad: posts the ante 500
martincho186: posts the ante 500
kuenne71: posts the ante 500
Equinox616: posts the ante 500
gladiatore99: posts the ante 500
SolidYerna: posts the ante 500
Dominosu: posts the ante 500
mazzy4629: posts the ante 500
Dominosu: posts small blind 2000
mazzy4629: posts big blind 4000
*** HOLE CARDS ***
Bigprad: raises 4000 to 8000
martincho186: folds 
kuenne71: calls 8000
Equinox616: folds 
gladiatore99: folds 
SolidYerna: folds 
Dominosu: folds 
mazzy4629: calls 4000
*** FLOP *** [5d 8c Ah]
mazzy4629: checks 
Bigprad: bets 30000
kuenne71: calls 30000
mazzy4629: folds 
*** TURN *** [5d 8c Ah] [2d]
Bigprad: bets 69388 and is all-in
kuenne71: calls 69388
*** RIVER *** [5d 8c Ah 2d] [Jc]
*** SHOW DOWN ***
Bigprad: shows [5c Ac] (two pair, Aces and Fives)
kuenne71: shows [Td Ad] (a pair of Aces)
Bigprad collected 228776 from pot
*** SUMMARY ***
Total pot 228776 | Rake 0 
Board [5d 8c Ah 2d Jc]
Seat 1: Bigprad showed [5c Ac] and won (228776) with two pair, Aces and Fives
Seat 2: martincho186 folded before Flop (didn't bet)
Seat 3: kuenne71 showed [Td Ad] and lost with a pair of Aces
Seat 4: Equinox616 folded before Flop (didn't bet)
Seat 5: gladiatore99 folded before Flop (didn't bet)
Seat 6: SolidYerna (button) folded before Flop (didn't bet)
Seat 7: Dominosu (small blind) folded before Flop
Seat 8: mazzy4629 (big blind) folded on the Flop

PokerStars Hand #251206868087: Tournament #3767885527, $40+$10+$5 USD Hold'em No Limit - Level XVIII (2000/4000) - 2024/06/26 20:24:29 UTC [2024/06/26 16:24:29 ET]
Table '3767885527 34' 8-max Seat #7 is the button
Seat 1: Bigprad (228776 in chips) 
Seat 2: martincho186 (65940 in chips) 
Seat 3: kuenne71 (22133 in chips) 
Seat 4: Equinox616 (25834 in chips) 
Seat 5: gladiatore99 (32911 in chips) 
Seat 6: SolidYerna (171760 in chips) 
Seat 7: Dominosu (338960 in chips) 
Seat 8: mazzy4629 (17625 in chips) 
Bigprad: posts the ante 500
martincho186: posts the ante 500
kuenne71: posts the ante 500
Equinox616: posts the ante 500
gladiatore99: posts the ante 500
SolidYerna: posts the ante 500
Dominosu: posts the ante 500
mazzy4629: posts the ante 500
mazzy4629: posts small blind 2000
Bigprad: posts big blind 4000
*** HOLE CARDS ***
martincho186: folds 
kuenne71: raises 17633 to 21633 and is all-in
Equinox616: folds 
gladiatore99: folds 
SolidYerna: folds 
Dominosu: folds 
mazzy4629: folds 
Bigprad: calls 17633
*** FLOP *** [Kd 8h 5c]
*** TURN *** [Kd 8h 5c] [6h]
*** RIVER *** [Kd 8h 5c 6h] [9d]
*** SHOW DOWN ***
Bigprad: shows [Ts Td] (a pair of Tens)
kuenne71: shows [Tc Kc] (a pair of Kings)
kuenne71 collected 49266 from pot
*** SUMMARY ***
Total pot 49266 | Rake 0 
Board [Kd 8h 5c 6h 9d]
Seat 1: Bigprad (big blind) showed [Ts Td] and lost with a pair of Tens
Seat 2: martincho186 folded before Flop (didn't bet)
Seat 3: kuenne71 showed [Tc Kc] and won (49266) with a pair of Kings
Seat 4: Equinox616 folded before Flop (didn't bet)
Seat 5: gladiatore99 folded before Flop (didn't bet)
Seat 6: SolidYerna folded before Flop (didn't bet)
Seat 7: Dominosu (button) folded before Flop (didn't bet)
Seat 8: mazzy4629 (small blind) folded before Flop

PokerStars Hand #251206875512: Tournament #3767885527, $40+$10+$5 USD Hold'em No Limit - Level XVIII (2000/4000) - 2024/06/26 20:24:56 UTC [2024/06/26 16:24:56 ET]
Table '3767885527 34' 8-max Seat #8 is the button
Seat 1: Bigprad (206643 in chips) 
Seat 2: martincho186 (65440 in chips) 
Seat 3: kuenne71 (49266 in chips) 
Seat 4: Equinox616 (25334 in chips) 
Seat 5: gladiatore99 (32411 in chips) 
Seat 6: SolidYerna (171260 in chips) 
Seat 7: Dominosu (338460 in chips) 
Seat 8: mazzy4629 (15125 in chips) 
Bigprad: posts the ante 500
martincho186: posts the ante 500
kuenne71: posts the ante 500
Equinox616: posts the ante 500
gladiatore99: posts the ante 500
SolidYerna: posts the ante 500
Dominosu: posts the ante 500
mazzy4629: posts the ante 500
Bigprad: posts small blind 2000
martincho186: posts big blind 4000
*** HOLE CARDS ***
kuenne71: folds 
Equinox616: folds 
gladiatore99: folds 
SolidYerna: folds 
Dominosu: raises 4800 to 8800
mazzy4629: folds 
Bigprad: folds 
martincho186: calls 4800
*** FLOP *** [7s 8d 4h]
martincho186: checks 
Dominosu: bets 7788
martincho186: raises 48352 to 56140 and is all-in
Dominosu: folds 
Uncalled bet (48352) returned to martincho186
martincho186 collected 39176 from pot
*** SUMMARY ***
Total pot 39176 | Rake 0 
Board [7s 8d 4h]
Seat 1: Bigprad (small blind) folded before Flop
Seat 2: martincho186 (big blind) collected (39176)
Seat 3: kuenne71 folded before Flop (didn't bet)
Seat 4: Equinox616 folded before Flop (didn't bet)
Seat 5: gladiatore99 folded before Flop (didn't bet)
Seat 6: SolidYerna folded before Flop (didn't bet)
Seat 7: Dominosu folded on the Flop
Seat 8: mazzy4629 (button) folded before Flop (didn't bet)

PokerStars Hand #251206889937: Tournament #3767885527, $40+$10+$5 USD Hold'em No Limit - Level XVIII (2000/4000) - 2024/06/26 20:25:48 UTC [2024/06/26 16:25:48 ET]
Table '3767885527 34' 8-max Seat #1 is the button
Seat 1: Bigprad (204143 in chips) 
Seat 2: martincho186 (87528 in chips) 
Seat 3: kuenne71 (48766 in chips) 
Seat 4: Equinox616 (24834 in chips) 
Seat 5: gladiatore99 (31911 in chips) 
Seat 6: SolidYerna (170760 in chips) 
Seat 7: Dominosu (321372 in chips) 
Seat 8: mazzy4629 (14625 in chips) 
Bigprad: posts the ante 500
martincho186: posts the ante 500
kuenne71: posts the ante 500
Equinox616: posts the ante 500
gladiatore99: posts the ante 500
SolidYerna: posts the ante 500
Dominosu: posts the ante 500
mazzy4629: posts the ante 500
martincho186: posts small blind 2000
kuenne71: posts big blind 4000
*** HOLE CARDS ***
Equinox616: folds 
gladiatore99: folds 
SolidYerna: raises 4400 to 8400
Dominosu: folds 
mazzy4629: folds 
Bigprad: folds 
martincho186: folds 
kuenne71: calls 4400
*** FLOP *** [6c 4c Jd]
kuenne71: checks 
SolidYerna: checks 
*** TURN *** [6c 4c Jd] [Ad]
kuenne71: checks 
SolidYerna: bets 4000
kuenne71: folds 
Uncalled bet (4000) returned to SolidYerna
SolidYerna collected 22800 from pot
SolidYerna: doesn't show hand 
*** SUMMARY ***
Total pot 22800 | Rake 0 
Board [6c 4c Jd Ad]
Seat 1: Bigprad (button) folded before Flop (didn't bet)
Seat 2: martincho186 (small blind) folded before Flop
Seat 3: kuenne71 (big blind) folded on the Turn
Seat 4: Equinox616 folded before Flop (didn't bet)
Seat 5: gladiatore99 folded before Flop (didn't bet)
Seat 6: SolidYerna collected (22800)
Seat 7: Dominosu folded before Flop (didn't bet)
Seat 8: mazzy4629 folded before Flop (didn't bet)

PokerStars Hand #251206902688: Tournament #3767885527, $40+$10+$5 USD Hold'em No Limit - Level XIX (2500/5000) - 2024/06/26 20:26:33 UTC [2024/06/26 16:26:33 ET]
Table '3767885527 34' 8-max Seat #2 is the button
Seat 1: Bigprad (203643 in chips) 
Seat 2: martincho186 (85028 in chips) 
Seat 3: kuenne71 (39866 in chips) 
Seat 4: Equinox616 (24334 in chips) 
Seat 5: gladiatore99 (31411 in chips) 
Seat 6: SolidYerna (184660 in chips) 
Seat 7: Dominosu (320872 in chips) 
Seat 8: mazzy4629 (14125 in chips) 
Bigprad: posts the ante 625
martincho186: posts the ante 625
kuenne71: posts the ante 625
Equinox616: posts the ante 625
gladiatore99: posts the ante 625
SolidYerna: posts the ante 625
Dominosu: posts the ante 625
mazzy4629: posts the ante 625
kuenne71: posts small blind 2500
Equinox616: posts big blind 5000
*** HOLE CARDS ***
gladiatore99: folds 
SolidYerna: raises 5500 to 10500
Dominosu: folds 
mazzy4629: folds 
Bigprad: folds 
martincho186: folds 
kuenne71: folds 
Equinox616: folds 
Uncalled bet (5500) returned to SolidYerna
SolidYerna collected 17500 from pot
SolidYerna: doesn't show hand 
*** SUMMARY ***
Total pot 17500 | Rake 0 
Seat 1: Bigprad folded before Flop (didn't bet)
Seat 2: martincho186 (button) folded before Flop (didn't bet)
Seat 3: kuenne71 (small blind) folded before Flop
Seat 4: Equinox616 (big blind) folded before Flop
Seat 5: gladiatore99 folded before Flop (didn't bet)
Seat 6: SolidYerna collected (17500)
Seat 7: Dominosu folded before Flop (didn't bet)
Seat 8: mazzy4629 folded before Flop (didn't bet)

PokerStars Hand #251206909304: Tournament #3767885527, $40+$10+$5 USD Hold'em No Limit - Level XIX (2500/5000) - 2024/06/26 20:26:57 UTC [2024/06/26 16:26:57 ET]
Table '3767885527 34' 8-max Seat #3 is the button
Seat 1: Bigprad (203018 in chips) 
Seat 2: martincho186 (84403 in chips) 
Seat 3: kuenne71 (36741 in chips) 
Seat 4: Equinox616 (18709 in chips) 
Seat 5: gladiatore99 (30786 in chips) 
Seat 6: SolidYerna (196535 in chips) 
Seat 7: Dominosu (320247 in chips) 
Seat 8: mazzy4629 (13500 in chips) 
Bigprad: posts the ante 625
martincho186: posts the ante 625
kuenne71: posts the ante 625
Equinox616: posts the ante 625
gladiatore99: posts the ante 625
SolidYerna: posts the ante 625
Dominosu: posts the ante 625
mazzy4629: posts the ante 625
Equinox616: posts small blind 2500
gladiatore99: posts big blind 5000
*** HOLE CARDS ***
SolidYerna: raises 5500 to 10500
Dominosu: folds 
mazzy4629: folds 
Bigprad: folds 
martincho186: folds 
kuenne71: folds 
Equinox616: folds 
gladiatore99: raises 19661 to 30161 and is all-in
SolidYerna: calls 19661
*** FLOP *** [Jc Qd 2s]
*** TURN *** [Jc Qd 2s] [Td]
*** RIVER *** [Jc Qd 2s Td] [5s]
*** SHOW DOWN ***
gladiatore99: shows [As Jh] (a pair of Jacks)
SolidYerna: shows [Ac 5c] (a pair of Fives)
gladiatore99 collected 67822 from pot
*** SUMMARY ***
Total pot 67822 | Rake 0 
Board [Jc Qd 2s Td 5s]
Seat 1: Bigprad folded before Flop (didn't bet)
Seat 2: martincho186 folded before Flop (didn't bet)
Seat 3: kuenne71 (button) folded before Flop (didn't bet)
Seat 4: Equinox616 (small blind) folded before Flop
Seat 5: gladiatore99 (big blind) showed [As Jh] and won (67822) with a pair of Jacks
Seat 6: SolidYerna showed [Ac 5c] and lost with a pair of Fives
Seat 7: Dominosu folded before Flop (didn't bet)
Seat 8: mazzy4629 folded before Flop (didn't bet)

PokerStars Hand #251206922196: Tournament #3767885527, $40+$10+$5 USD Hold'em No Limit - Level XIX (2500/5000) - 2024/06/26 20:27:43 UTC [2024/06/26 16:27:43 ET]
Table '3767885527 34' 8-max Seat #4 is the button
Seat 1: Bigprad (202393 in chips) 
Seat 2: martincho186 (83778 in chips) 
Seat 3: kuenne71 (36116 in chips) 
Seat 4: Equinox616 (15584 in chips) 
Seat 5: gladiatore99 (67822 in chips) 
Seat 6: SolidYerna (165749 in chips) 
Seat 7: Dominosu (319622 in chips) 
Seat 8: mazzy4629 (12875 in chips) 
Bigprad: posts the ante 625
martincho186: posts the ante 625
kuenne71: posts the ante 625
Equinox616: posts the ante 625
gladiatore99: posts the ante 625
SolidYerna: posts the ante 625
Dominosu: posts the ante 625
mazzy4629: posts the ante 625
gladiatore99: posts small blind 2500
SolidYerna: posts big blind 5000
*** HOLE CARDS ***
Dominosu: folds 
mazzy4629: raises 7250 to 12250 and is all-in
Bigprad: folds 
martincho186: folds 
kuenne71: folds 
Equinox616: folds 
gladiatore99: raises 54947 to 67197 and is all-in
SolidYerna: folds 
Uncalled bet (54947) returned to gladiatore99
*** FLOP *** [Qs 6h Tc]
*** TURN *** [Qs 6h Tc] [Qc]
*** RIVER *** [Qs 6h Tc Qc] [Ts]
*** SHOW DOWN ***
gladiatore99: shows [5d Ad] (two pair, Queens and Tens)
mazzy4629: shows [Js Qd] (a full house, Queens full of Tens)
mazzy4629 collected 34500 from pot
*** SUMMARY ***
Total pot 34500 | Rake 0 
Board [Qs 6h Tc Qc Ts]
Seat 1: Bigprad folded before Flop (didn't bet)
Seat 2: martincho186 folded before Flop (didn't bet)
Seat 3: kuenne71 folded before Flop (didn't bet)
Seat 4: Equinox616 (button) folded before Flop (didn't bet)
Seat 5: gladiatore99 (small blind) showed [5d Ad] and lost with two pair, Queens and Tens
Seat 6: SolidYerna (big blind) folded before Flop
Seat 7: Dominosu folded before Flop (didn't bet)
Seat 8: mazzy4629 showed [Js Qd] and won (34500) with a full house, Queens full of Tens

PokerStars Hand #251206930046: Tournament #3767885527, $40+$10+$5 USD Hold'em No Limit - Level XIX (2500/5000) - 2024/06/26 20:28:11 UTC [2024/06/26 16:28:11 ET]
Table '3767885527 34' 8-max Seat #5 is the button
Seat 1: Bigprad (201768 in chips) 
Seat 2: martincho186 (83153 in chips) 
Seat 3: kuenne71 (35491 in chips) 
Seat 4: Equinox616 (14959 in chips) 
Seat 5: gladiatore99 (54947 in chips) 
Seat 6: SolidYerna (160124 in chips) 
Seat 7: Dominosu (318997 in chips) 
Seat 8: mazzy4629 (34500 in chips) 
Bigprad: posts the ante 625
martincho186: posts the ante 625
kuenne71: posts the ante 625
Equinox616: posts the ante 625
gladiatore99: posts the ante 625
SolidYerna: posts the ante 625
Dominosu: posts the ante 625
mazzy4629: posts the ante 625
SolidYerna: posts small blind 2500
Dominosu: posts big blind 5000
*** HOLE CARDS ***
mazzy4629: folds 
Bigprad: raises 5000 to 10000
martincho186: folds 
kuenne71: folds 
Equinox616: folds 
gladiatore99: folds 
SolidYerna: folds 
Dominosu: calls 5000
*** FLOP *** [Kd 3h 8c]
Dominosu: checks 
Bigprad: bets 10000
Dominosu: folds 
Uncalled bet (10000) returned to Bigprad
Bigprad collected 27500 from pot
*** SUMMARY ***
Total pot 27500 | Rake 0 
Board [Kd 3h 8c]
Seat 1: Bigprad collected (27500)
Seat 2: martincho186 folded before Flop (didn't bet)
Seat 3: kuenne71 folded before Flop (didn't bet)
Seat 4: Equinox616 folded before Flop (didn't bet)
Seat 5: gladiatore99 (button) folded before Flop (didn't bet)
Seat 6: SolidYerna (small blind) folded before Flop
Seat 7: Dominosu (big blind) folded on the Flop
Seat 8: mazzy4629 folded before Flop (didn't bet)

PokerStars Hand #251206937030: Tournament #3767885527, $40+$10+$5 USD Hold'em No Limit - Level XIX (2500/5000) - 2024/06/26 20:28:36 UTC [2024/06/26 16:28:36 ET]
Table '3767885527 34' 8-max Seat #6 is the button
Seat 1: Bigprad (218643 in chips) 
Seat 2: martincho186 (82528 in chips) 
Seat 3: kuenne71 (34866 in chips) 
Seat 4: Equinox616 (14334 in chips) 
Seat 5: gladiatore99 (54322 in chips) 
Seat 6: SolidYerna (156999 in chips) 
Seat 7: Dominosu (308372 in chips) 
Seat 8: mazzy4629 (33875 in chips) 
Bigprad: posts the ante 625
martincho186: posts the ante 625
kuenne71: posts the ante 625
Equinox616: posts the ante 625
gladiatore99: posts the ante 625
SolidYerna: posts the ante 625
Dominosu: posts the ante 625
mazzy4629: posts the ante 625
Dominosu: posts small blind 2500
mazzy4629: posts big blind 5000
*** HOLE CARDS ***
Bigprad: folds 
martincho186: folds 
kuenne71: folds 
Equinox616: folds 
gladiatore99: folds 
SolidYerna: raises 7500 to 12500
Dominosu: folds 
mazzy4629: folds 
Uncalled bet (7500) returned to SolidYerna
SolidYerna collected 17500 from pot
SolidYerna: doesn't show hand 
*** SUMMARY ***
Total pot 17500 | Rake 0 
Seat 1: Bigprad folded before Flop (didn't bet)
Seat 2: martincho186 folded before Flop (didn't bet)
Seat 3: kuenne71 folded before Flop (didn't bet)
Seat 4: Equinox616 folded before Flop (didn't bet)
Seat 5: gladiatore99 folded before Flop (didn't bet)
Seat 6: SolidYerna (button) collected (17500)
Seat 7: Dominosu (small blind) folded before Flop
Seat 8: mazzy4629 (big blind) folded before Flop

PokerStars Hand #251206947613: Tournament #3767885527, $40+$10+$5 USD Hold'em No Limit - Level XIX (2500/5000) - 2024/06/26 20:29:15 UTC [2024/06/26 16:29:15 ET]
Table '3767885527 34' 8-max Seat #7 is the button
Seat 1: Bigprad (218018 in chips) 
Seat 2: martincho186 (81903 in chips) 
Seat 3: kuenne71 (34241 in chips) 
Seat 4: Equinox616 (13709 in chips) 
Seat 5: gladiatore99 (53697 in chips) 
Seat 6: SolidYerna (168874 in chips) 
Seat 7: Dominosu (305247 in chips) 
Seat 8: mazzy4629 (28250 in chips) 
Bigprad: posts the ante 625
martincho186: posts the ante 625
kuenne71: posts the ante 625
Equinox616: posts the ante 625
gladiatore99: posts the ante 625
SolidYerna: posts the ante 625
Dominosu: posts the ante 625
mazzy4629: posts the ante 625
mazzy4629: posts small blind 2500
Bigprad: posts big blind 5000
*** HOLE CARDS ***
martincho186: folds 
kuenne71: folds 
Equinox616: folds 
gladiatore99: folds 
SolidYerna: raises 5500 to 10500
Dominosu: folds 
mazzy4629: folds 
Bigprad: folds 
Uncalled bet (5500) returned to SolidYerna
SolidYerna collected 17500 from pot
SolidYerna: doesn't show hand 
*** SUMMARY ***
Total pot 17500 | Rake 0 
Seat 1: Bigprad (big blind) folded before Flop
Seat 2: martincho186 folded before Flop (didn't bet)
Seat 3: kuenne71 folded before Flop (didn't bet)
Seat 4: Equinox616 folded before Flop (didn't bet)
Seat 5: gladiatore99 folded before Flop (didn't bet)
Seat 6: SolidYerna collected (17500)
Seat 7: Dominosu (button) folded before Flop (didn't bet)
Seat 8: mazzy4629 (small blind) folded before Flop

PokerStars Hand #251206952447: Tournament #3767885527, $40+$10+$5 USD Hold'em No Limit - Level XIX (2500/5000) - 2024/06/26 20:29:33 UTC [2024/06/26 16:29:33 ET]
Table '3767885527 34' 8-max Seat #8 is the button
Seat 1: Bigprad (212393 in chips) 
Seat 2: martincho186 (81278 in chips) 
Seat 3: kuenne71 (33616 in chips) 
Seat 4: Equinox616 (13084 in chips) 
Seat 5: gladiatore99 (53072 in chips) 
Seat 6: SolidYerna (180749 in chips) 
Seat 7: Dominosu (304622 in chips) 
Seat 8: mazzy4629 (25125 in chips) 
Bigprad: posts the ante 625
martincho186: posts the ante 625
kuenne71: posts the ante 625
Equinox616: posts the ante 625
gladiatore99: posts the ante 625
SolidYerna: posts the ante 625
Dominosu: posts the ante 625
mazzy4629: posts the ante 625
Bigprad: posts small blind 2500
martincho186: posts big blind 5000
*** HOLE CARDS ***
kuenne71: folds 
Equinox616 has timed out
Equinox616: folds 
Equinox616 is sitting out
gladiatore99: folds 
Equinox616 has returned
SolidYerna: folds 
Dominosu: raises 6000 to 11000
mazzy4629: folds 
Bigprad: folds 
martincho186: folds 
Uncalled bet (6000) returned to Dominosu
Dominosu collected 17500 from pot
Dominosu: doesn't show hand 
*** SUMMARY ***
Total pot 17500 | Rake 0 
Seat 1: Bigprad (small blind) folded before Flop
Seat 2: martincho186 (big blind) folded before Flop
Seat 3: kuenne71 folded before Flop (didn't bet)
Seat 4: Equinox616 folded before Flop (didn't bet)
Seat 5: gladiatore99 folded before Flop (didn't bet)
Seat 6: SolidYerna folded before Flop (didn't bet)
Seat 7: Dominosu collected (17500)
Seat 8: mazzy4629 (button) folded before Flop (didn't bet)

PokerStars Hand #251206974574: Tournament #3767885527, $40+$10+$5 USD Hold'em No Limit - Level XIX (2500/5000) - 2024/06/26 20:30:53 UTC [2024/06/26 16:30:53 ET]
Table '3767885527 34' 8-max Seat #1 is the button
Seat 1: Bigprad (209268 in chips) 
Seat 2: martincho186 (75653 in chips) 
Seat 3: kuenne71 (32991 in chips) 
Seat 4: Equinox616 (12459 in chips) 
Seat 5: gladiatore99 (52447 in chips) 
Seat 6: SolidYerna (180124 in chips) 
Seat 7: Dominosu (316497 in chips) 
Seat 8: mazzy4629 (24500 in chips) 
Bigprad: posts the ante 625
martincho186: posts the ante 625
kuenne71: posts the ante 625
Equinox616: posts the ante 625
gladiatore99: posts the ante 625
SolidYerna: posts the ante 625
Dominosu: posts the ante 625
mazzy4629: posts the ante 625
martincho186: posts small blind 2500
kuenne71: posts big blind 5000
*** HOLE CARDS ***
Equinox616 has timed out
Equinox616: folds 
Equinox616 is sitting out
gladiatore99: folds 
SolidYerna: raises 5500 to 10500
Dominosu: folds 
mazzy4629: folds 
Bigprad: calls 10500
martincho186: folds 
kuenne71: calls 5500
*** FLOP *** [Jd 7d Kc]
kuenne71: checks 
SolidYerna: checks 
Bigprad: checks 
*** TURN *** [Jd 7d Kc] [5c]
kuenne71: checks 
SolidYerna: checks 
Bigprad: checks 
*** RIVER *** [Jd 7d Kc 5c] [2c]
kuenne71: checks 
Equinox616 has returned
SolidYerna: checks 
Bigprad: checks 
*** SHOW DOWN ***
kuenne71: shows [7h 8s] (a pair of Sevens)
SolidYerna: mucks hand 
Bigprad: mucks hand 
kuenne71 collected 39000 from pot
*** SUMMARY ***
Total pot 39000 | Rake 0 
Board [Jd 7d Kc 5c 2c]
Seat 1: Bigprad (button) mucked
Seat 2: martincho186 (small blind) folded before Flop
Seat 3: kuenne71 (big blind) showed [7h 8s] and won (39000) with a pair of Sevens
Seat 4: Equinox616 folded before Flop (didn't bet)
Seat 5: gladiatore99 folded before Flop (didn't bet)
Seat 6: SolidYerna mucked
Seat 7: Dominosu folded before Flop (didn't bet)
Seat 8: mazzy4629 folded before Flop (didn't bet)

PokerStars Hand #251206990927: Tournament #3767885527, $40+$10+$5 USD Hold'em No Limit - Level XIX (2500/5000) - 2024/06/26 20:31:51 UTC [2024/06/26 16:31:51 ET]
Table '3767885527 34' 8-max Seat #2 is the button
Seat 1: Bigprad (198143 in chips) 
Seat 2: martincho186 (72528 in chips) 
Seat 3: kuenne71 (60866 in chips) 
Seat 4: Equinox616 (11834 in chips) 
Seat 5: gladiatore99 (51822 in chips) 
Seat 6: SolidYerna (168999 in chips) 
Seat 7: Dominosu (315872 in chips) 
Seat 8: mazzy4629 (23875 in chips) 
Bigprad: posts the ante 625
martincho186: posts the ante 625
kuenne71: posts the ante 625
Equinox616: posts the ante 625
gladiatore99: posts the ante 625
SolidYerna: posts the ante 625
Dominosu: posts the ante 625
mazzy4629: posts the ante 625
kuenne71: posts small blind 2500
Equinox616: posts big blind 5000
*** HOLE CARDS ***
gladiatore99: folds 
SolidYerna: folds 
Dominosu: folds 
mazzy4629: folds 
Bigprad: folds 
martincho186: folds 
kuenne71: raises 10000 to 15000
Equinox616: calls 6209 and is all-in
Uncalled bet (3791) returned to kuenne71
*** FLOP *** [2h Jc 8s]
*** TURN *** [2h Jc 8s] [Js]
*** RIVER *** [2h Jc 8s Js] [8c]
*** SHOW DOWN ***
kuenne71: shows [Jh Qc] (a full house, Jacks full of Eights)
Equinox616: shows [9c Ac] (two pair, Jacks and Eights)
kuenne71 collected 27418 from pot
Equinox616 finished the tournament in 305th place
*** SUMMARY ***
Total pot 27418 | Rake 0 
Board [2h Jc 8s Js 8c]
Seat 1: Bigprad folded before Flop (didn't bet)
Seat 2: martincho186 (button) folded before Flop (didn't bet)
Seat 3: kuenne71 (small blind) showed [Jh Qc] and won (27418) with a full house, Jacks full of Eights
Seat 4: Equinox616 (big blind) showed [9c Ac] and lost with two pair, Jacks and Eights
Seat 5: gladiatore99 folded before Flop (didn't bet)
Seat 6: SolidYerna folded before Flop (didn't bet)
Seat 7: Dominosu folded before Flop (didn't bet)
Seat 8: mazzy4629 folded before Flop (didn't bet)


PokerStars Hand #251205349458: Tournament #3767885527, $40+$10+$5 USD Hold'em No Limit - Level X (500/1000) - 2024/06/26 18:49:06 UTC [2024/06/26 14:49:06 ET]
Table '3767885527 33' 8-max Seat #8 is the button
Seat 1: IgorHKR (22577 in chips) 
Seat 2: trigobrien (39296 in chips) 
Seat 3: markyLP (40629 in chips) 
Seat 4: AllanEM (33357 in chips) 
Seat 5: handsfull69 (35869 in chips) 
Seat 6: IceFire12338 (38991 in chips) 
Seat 7: ENG.Brito (45891 in chips) 
Seat 8: BorIska1993 (66204 in chips) 
IgorHKR: posts the ante 125
trigobrien: posts the ante 125
markyLP: posts the ante 125
AllanEM: posts the ante 125
handsfull69: posts the ante 125
IceFire12338: posts the ante 125
ENG.Brito: posts the ante 125
BorIska1993: posts the ante 125
IgorHKR: posts small blind 500
trigobrien: posts big blind 1000
*** HOLE CARDS ***
markyLP: folds 
AllanEM: folds 
handsfull69: folds 
IceFire12338: folds 
ENG.Brito: folds 
BorIska1993: folds 
IgorHKR: calls 500
trigobrien: checks 
*** FLOP *** [Ah 2s 6h]
IgorHKR: checks 
trigobrien: checks 
*** TURN *** [Ah 2s 6h] [8d]
IgorHKR: bets 5000
trigobrien: folds 
Uncalled bet (5000) returned to IgorHKR
IgorHKR collected 3000 from pot
IgorHKR: doesn't show hand 
*** SUMMARY ***
Total pot 3000 | Rake 0 
Board [Ah 2s 6h 8d]
Seat 1: IgorHKR (small blind) collected (3000)
Seat 2: trigobrien (big blind) folded on the Turn
Seat 3: markyLP folded before Flop (didn't bet)
Seat 4: AllanEM folded before Flop (didn't bet)
Seat 5: handsfull69 folded before Flop (didn't bet)
Seat 6: IceFire12338 folded before Flop (didn't bet)
Seat 7: ENG.Brito folded before Flop (didn't bet)
Seat 8: BorIska1993 (button) folded before Flop (didn't bet)

PokerStars Hand #251205361019: Tournament #3767885527, $40+$10+$5 USD Hold'em No Limit - Level X (500/1000) - 2024/06/26 18:49:50 UTC [2024/06/26 14:49:50 ET]
Table '3767885527 33' 8-max Seat #1 is the button
Seat 1: IgorHKR (24452 in chips) 
Seat 2: trigobrien (38171 in chips) 
Seat 3: markyLP (40504 in chips) 
Seat 4: AllanEM (33232 in chips) 
Seat 5: handsfull69 (35744 in chips) 
Seat 6: IceFire12338 (38866 in chips) 
Seat 7: ENG.Brito (45766 in chips) 
Seat 8: BorIska1993 (66079 in chips) 
IgorHKR: posts the ante 125
trigobrien: posts the ante 125
markyLP: posts the ante 125
AllanEM: posts the ante 125
handsfull69: posts the ante 125
IceFire12338: posts the ante 125
ENG.Brito: posts the ante 125
BorIska1993: posts the ante 125
trigobrien: posts small blind 500
markyLP: posts big blind 1000
*** HOLE CARDS ***
AllanEM: folds 
handsfull69: folds 
IceFire12338: folds 
ENG.Brito: folds 
BorIska1993: folds 
IgorHKR: folds 
trigobrien: calls 500
markyLP: raises 2500 to 3500
trigobrien: calls 2500
*** FLOP *** [7c Qd 7h]
trigobrien: checks 
markyLP: bets 2400
trigobrien: folds 
Uncalled bet (2400) returned to markyLP
markyLP collected 8000 from pot
markyLP: doesn't show hand 
*** SUMMARY ***
Total pot 8000 | Rake 0 
Board [7c Qd 7h]
Seat 1: IgorHKR (button) folded before Flop (didn't bet)
Seat 2: trigobrien (small blind) folded on the Flop
Seat 3: markyLP (big blind) collected (8000)
Seat 4: AllanEM folded before Flop (didn't bet)
Seat 5: handsfull69 folded before Flop (didn't bet)
Seat 6: IceFire12338 folded before Flop (didn't bet)
Seat 7: ENG.Brito folded before Flop (didn't bet)
Seat 8: BorIska1993 folded before Flop (didn't bet)

PokerStars Hand #251205373685: Tournament #3767885527, $40+$10+$5 USD Hold'em No Limit - Level X (500/1000) - 2024/06/26 18:50:38 UTC [2024/06/26 14:50:38 ET]
Table '3767885527 33' 8-max Seat #2 is the button
Seat 1: IgorHKR (24327 in chips) 
Seat 2: trigobrien (34546 in chips) 
Seat 3: markyLP (44879 in chips) 
Seat 4: AllanEM (33107 in chips) 
Seat 5: handsfull69 (35619 in chips) 
Seat 6: IceFire12338 (38741 in chips) 
Seat 7: ENG.Brito (45641 in chips) 
Seat 8: BorIska1993 (65954 in chips) 
IgorHKR: posts the ante 125
trigobrien: posts the ante 125
markyLP: posts the ante 125
AllanEM: posts the ante 125
handsfull69: posts the ante 125
IceFire12338: posts the ante 125
ENG.Brito: posts the ante 125
BorIska1993: posts the ante 125
markyLP: posts small blind 500
AllanEM: posts big blind 1000
*** HOLE CARDS ***
handsfull69: folds 
IceFire12338: folds 
ENG.Brito: folds 
BorIska1993: raises 1100 to 2100
IgorHKR: folds 
trigobrien: folds 
markyLP: calls 1600
AllanEM: folds 
*** FLOP *** [Tc Jc 9d]
markyLP: checks 
BorIska1993: bets 3162
markyLP: folds 
Uncalled bet (3162) returned to BorIska1993
BorIska1993 collected 6200 from pot
BorIska1993: doesn't show hand 
*** SUMMARY ***
Total pot 6200 | Rake 0 
Board [Tc Jc 9d]
Seat 1: IgorHKR folded before Flop (didn't bet)
Seat 2: trigobrien (button) folded before Flop (didn't bet)
Seat 3: markyLP (small blind) folded on the Flop
Seat 4: AllanEM (big blind) folded before Flop
Seat 5: handsfull69 folded before Flop (didn't bet)
Seat 6: IceFire12338 folded before Flop (didn't bet)
Seat 7: ENG.Brito folded before Flop (didn't bet)
Seat 8: BorIska1993 collected (6200)

PokerStars Hand #251205385936: Tournament #3767885527, $40+$10+$5 USD Hold'em No Limit - Level X (500/1000) - 2024/06/26 18:51:25 UTC [2024/06/26 14:51:25 ET]
Table '3767885527 33' 8-max Seat #3 is the button
Seat 1: IgorHKR (24202 in chips) 
Seat 2: trigobrien (34421 in chips) 
Seat 3: markyLP (42654 in chips) 
Seat 4: AllanEM (31982 in chips) 
Seat 5: handsfull69 (35494 in chips) 
Seat 6: IceFire12338 (38616 in chips) 
Seat 7: ENG.Brito (45516 in chips) 
Seat 8: BorIska1993 (69929 in chips) 
IgorHKR: posts the ante 125
trigobrien: posts the ante 125
markyLP: posts the ante 125
AllanEM: posts the ante 125
handsfull69: posts the ante 125
IceFire12338: posts the ante 125
ENG.Brito: posts the ante 125
BorIska1993: posts the ante 125
AllanEM: posts small blind 500
handsfull69: posts big blind 1000
*** HOLE CARDS ***
IceFire12338: folds 
ENG.Brito: folds 
BorIska1993: folds 
IgorHKR: folds 
trigobrien: folds 
markyLP: folds 
AllanEM: calls 500
handsfull69: raises 34369 to 35369 and is all-in
AllanEM: folds 
Uncalled bet (34369) returned to handsfull69
handsfull69 collected 3000 from pot
*** SUMMARY ***
Total pot 3000 | Rake 0 
Seat 1: IgorHKR folded before Flop (didn't bet)
Seat 2: trigobrien folded before Flop (didn't bet)
Seat 3: markyLP (button) folded before Flop (didn't bet)
Seat 4: AllanEM (small blind) folded before Flop
Seat 5: handsfull69 (big blind) collected (3000)
Seat 6: IceFire12338 folded before Flop (didn't bet)
Seat 7: ENG.Brito folded before Flop (didn't bet)
Seat 8: BorIska1993 folded before Flop (didn't bet)

PokerStars Hand #251205394739: Tournament #3767885527, $40+$10+$5 USD Hold'em No Limit - Level X (500/1000) - 2024/06/26 18:51:58 UTC [2024/06/26 14:51:58 ET]
Table '3767885527 33' 8-max Seat #4 is the button
Seat 1: IgorHKR (24077 in chips) 
Seat 2: trigobrien (34296 in chips) 
Seat 3: markyLP (42529 in chips) 
Seat 4: AllanEM (30857 in chips) 
Seat 5: handsfull69 (37369 in chips) 
Seat 6: IceFire12338 (38491 in chips) 
Seat 7: ENG.Brito (45391 in chips) 
Seat 8: BorIska1993 (69804 in chips) 
IgorHKR: posts the ante 125
trigobrien: posts the ante 125
markyLP: posts the ante 125
AllanEM: posts the ante 125
handsfull69: posts the ante 125
IceFire12338: posts the ante 125
ENG.Brito: posts the ante 125
BorIska1993: posts the ante 125
handsfull69: posts small blind 500
IceFire12338: posts big blind 1000
*** HOLE CARDS ***
ENG.Brito: raises 1000 to 2000
BorIska1993: folds 
IgorHKR: folds 
trigobrien: folds 
markyLP: folds 
AllanEM: folds 
handsfull69: calls 1500
IceFire12338: calls 1000
*** FLOP *** [5c Qs Ac]
handsfull69: bets 3500
IceFire12338: calls 3500
ENG.Brito: folds 
*** TURN *** [5c Qs Ac] [Tc]
handsfull69: bets 6000
IceFire12338: calls 6000
*** RIVER *** [5c Qs Ac Tc] [2s]
handsfull69: bets 11000
IceFire12338: calls 11000
*** SHOW DOWN ***
handsfull69: shows [6c 7c] (a flush, Ace high)
IceFire12338: mucks hand 
handsfull69 collected 48000 from pot
*** SUMMARY ***
Total pot 48000 | Rake 0 
Board [5c Qs Ac Tc 2s]
Seat 1: IgorHKR folded before Flop (didn't bet)
Seat 2: trigobrien folded before Flop (didn't bet)
Seat 3: markyLP folded before Flop (didn't bet)
Seat 4: AllanEM (button) folded before Flop (didn't bet)
Seat 5: handsfull69 (small blind) showed [6c 7c] and won (48000) with a flush, Ace high
Seat 6: IceFire12338 (big blind) mucked
Seat 7: ENG.Brito folded on the Flop
Seat 8: BorIska1993 folded before Flop (didn't bet)

PokerStars Hand #251205416211: Tournament #3767885527, $40+$10+$5 USD Hold'em No Limit - Level XI (600/1200) - 2024/06/26 18:53:20 UTC [2024/06/26 14:53:20 ET]
Table '3767885527 33' 8-max Seat #5 is the button
Seat 1: IgorHKR (23952 in chips) 
Seat 2: trigobrien (34171 in chips) 
Seat 3: markyLP (42404 in chips) 
Seat 4: AllanEM (30732 in chips) 
Seat 5: handsfull69 (62744 in chips) 
Seat 6: IceFire12338 (15866 in chips) 
Seat 7: ENG.Brito (43266 in chips) 
Seat 8: BorIska1993 (69679 in chips) 
IgorHKR: posts the ante 150
trigobrien: posts the ante 150
markyLP: posts the ante 150
AllanEM: posts the ante 150
handsfull69: posts the ante 150
IceFire12338: posts the ante 150
ENG.Brito: posts the ante 150
BorIska1993: posts the ante 150
IceFire12338: posts small blind 600
ENG.Brito: posts big blind 1200
*** HOLE CARDS ***
BorIska1993: raises 1320 to 2520
IgorHKR: folds 
trigobrien: folds 
markyLP: folds 
AllanEM: folds 
handsfull69: folds 
IceFire12338: calls 1920
ENG.Brito: folds 
*** FLOP *** [7d Kh Ad]
IceFire12338: checks 
BorIska1993: bets 2232
IceFire12338: calls 2232
*** TURN *** [7d Kh Ad] [5d]
IceFire12338: checks 
BorIska1993: checks 
*** RIVER *** [7d Kh Ad 5d] [4h]
IceFire12338: checks 
BorIska1993: checks 
*** SHOW DOWN ***
IceFire12338: shows [Ks Js] (a pair of Kings)
BorIska1993: shows [Ah 2h] (a pair of Aces)
BorIska1993 collected 11904 from pot
*** SUMMARY ***
Total pot 11904 | Rake 0 
Board [7d Kh Ad 5d 4h]
Seat 1: IgorHKR folded before Flop (didn't bet)
Seat 2: trigobrien folded before Flop (didn't bet)
Seat 3: markyLP folded before Flop (didn't bet)
Seat 4: AllanEM folded before Flop (didn't bet)
Seat 5: handsfull69 (button) folded before Flop (didn't bet)
Seat 6: IceFire12338 (small blind) showed [Ks Js] and lost with a pair of Kings
Seat 7: ENG.Brito (big blind) folded before Flop
Seat 8: BorIska1993 showed [Ah 2h] and won (11904) with a pair of Aces

PokerStars Hand #251205431445: Tournament #3767885527, $40+$10+$5 USD Hold'em No Limit - Level XI (600/1200) - 2024/06/26 18:54:18 UTC [2024/06/26 14:54:18 ET]
Table '3767885527 33' 8-max Seat #6 is the button
Seat 1: IgorHKR (23802 in chips) 
Seat 2: trigobrien (34021 in chips) 
Seat 3: markyLP (42254 in chips) 
Seat 4: AllanEM (30582 in chips) 
Seat 5: handsfull69 (62594 in chips) 
Seat 6: IceFire12338 (10964 in chips) 
Seat 7: ENG.Brito (41916 in chips) 
Seat 8: BorIska1993 (76681 in chips) 
IgorHKR: posts the ante 150
trigobrien: posts the ante 150
markyLP: posts the ante 150
AllanEM: posts the ante 150
handsfull69: posts the ante 150
IceFire12338: posts the ante 150
ENG.Brito: posts the ante 150
BorIska1993: posts the ante 150
ENG.Brito: posts small blind 600
BorIska1993: posts big blind 1200
*** HOLE CARDS ***
IgorHKR: folds 
trigobrien: folds 
markyLP: folds 
AllanEM: folds 
handsfull69: folds 
IceFire12338: raises 9614 to 10814 and is all-in
ENG.Brito: folds 
BorIska1993: calls 9614
*** FLOP *** [7c Qh Jh]
*** TURN *** [7c Qh Jh] [9d]
*** RIVER *** [7c Qh Jh 9d] [3d]
*** SHOW DOWN ***
BorIska1993: shows [Ad 9s] (a pair of Nines)
IceFire12338: shows [Td Qs] (a pair of Queens)
IceFire12338 collected 23428 from pot
*** SUMMARY ***
Total pot 23428 | Rake 0 
Board [7c Qh Jh 9d 3d]
Seat 1: IgorHKR folded before Flop (didn't bet)
Seat 2: trigobrien folded before Flop (didn't bet)
Seat 3: markyLP folded before Flop (didn't bet)
Seat 4: AllanEM folded before Flop (didn't bet)
Seat 5: handsfull69 folded before Flop (didn't bet)
Seat 6: IceFire12338 (button) showed [Td Qs] and won (23428) with a pair of Queens
Seat 7: ENG.Brito (small blind) folded before Flop
Seat 8: BorIska1993 (big blind) showed [Ad 9s] and lost with a pair of Nines

PokerStars Hand #251205440094: Tournament #3767885527, $40+$10+$5 USD Hold'em No Limit - Level XI (600/1200) - 2024/06/26 18:54:51 UTC [2024/06/26 14:54:51 ET]
Table '3767885527 33' 8-max Seat #7 is the button
Seat 1: IgorHKR (23652 in chips) 
Seat 2: trigobrien (33871 in chips) 
Seat 3: markyLP (42104 in chips) 
Seat 4: AllanEM (30432 in chips) 
Seat 5: handsfull69 (62444 in chips) 
Seat 6: IceFire12338 (23428 in chips) 
Seat 7: ENG.Brito (41166 in chips) 
Seat 8: BorIska1993 (65717 in chips) 
IgorHKR: posts the ante 150
trigobrien: posts the ante 150
markyLP: posts the ante 150
AllanEM: posts the ante 150
handsfull69: posts the ante 150
IceFire12338: posts the ante 150
ENG.Brito: posts the ante 150
BorIska1993: posts the ante 150
BorIska1993: posts small blind 600
IgorHKR: posts big blind 1200
*** HOLE CARDS ***
trigobrien: folds 
markyLP: folds 
AllanEM: folds 
handsfull69: raises 1200 to 2400
IceFire12338: folds 
ENG.Brito: folds 
BorIska1993: folds 
IgorHKR: folds 
Uncalled bet (1200) returned to handsfull69
handsfull69 collected 4200 from pot
*** SUMMARY ***
Total pot 4200 | Rake 0 
Seat 1: IgorHKR (big blind) folded before Flop
Seat 2: trigobrien folded before Flop (didn't bet)
Seat 3: markyLP folded before Flop (didn't bet)
Seat 4: AllanEM folded before Flop (didn't bet)
Seat 5: handsfull69 collected (4200)
Seat 6: IceFire12338 folded before Flop (didn't bet)
Seat 7: ENG.Brito (button) folded before Flop (didn't bet)
Seat 8: BorIska1993 (small blind) folded before Flop

PokerStars Hand #251205528169: Tournament #3767885527, $40+$10+$5 USD Hold'em No Limit - Level XI (600/1200) - 2024/06/26 19:02:04 UTC [2024/06/26 15:02:04 ET]
Table '3767885527 33' 8-max Seat #8 is the button
Seat 1: IgorHKR (22302 in chips) 
Seat 2: trigobrien (33721 in chips) 
Seat 3: markyLP (41954 in chips) 
Seat 4: AllanEM (30282 in chips) 
Seat 5: handsfull69 (65294 in chips) 
Seat 6: IceFire12338 (23278 in chips) 
Seat 7: ENG.Brito (41016 in chips) 
Seat 8: BorIska1993 (64967 in chips) 
IgorHKR: posts the ante 150
trigobrien: posts the ante 150
markyLP: posts the ante 150
AllanEM: posts the ante 150
handsfull69: posts the ante 150
IceFire12338: posts the ante 150
ENG.Brito: posts the ante 150
BorIska1993: posts the ante 150
IgorHKR: posts small blind 600
trigobrien: posts big blind 1200
*** HOLE CARDS ***
markyLP: folds 
AllanEM: folds 
handsfull69: folds 
IceFire12338: folds 
ENG.Brito: folds 
BorIska1993: raises 1200 to 2400
IgorHKR: folds 
trigobrien: calls 1200
*** FLOP *** [Jd Ts 5h]
trigobrien: checks 
BorIska1993: bets 1980
trigobrien: calls 1980
*** TURN *** [Jd Ts 5h] [Td]
trigobrien: checks 
BorIska1993: checks 
*** RIVER *** [Jd Ts 5h Td] [Ac]
trigobrien: bets 5280
BorIska1993: folds 
Uncalled bet (5280) returned to trigobrien
trigobrien collected 10560 from pot
*** SUMMARY ***
Total pot 10560 | Rake 0 
Board [Jd Ts 5h Td Ac]
Seat 1: IgorHKR (small blind) folded before Flop
Seat 2: trigobrien (big blind) collected (10560)
Seat 3: markyLP folded before Flop (didn't bet)
Seat 4: AllanEM folded before Flop (didn't bet)
Seat 5: handsfull69 folded before Flop (didn't bet)
Seat 6: IceFire12338 folded before Flop (didn't bet)
Seat 7: ENG.Brito folded before Flop (didn't bet)
Seat 8: BorIska1993 (button) folded on the River

PokerStars Hand #251205614352: Tournament #3767885527, $40+$10+$5 USD Hold'em No Limit - Level XI (600/1200) - 2024/06/26 19:07:37 UTC [2024/06/26 15:07:37 ET]
Table '3767885527 96' 8-max Seat #1 is the button
Seat 1: MKL1010 (37531 in chips) 
Seat 2: DontCryClumsy88 (24246 in chips) 
Seat 3: Eux1986 (89833 in chips) 
Seat 4: moratto1992 (28490 in chips) 
Seat 5: 4fast2u (33091 in chips) 
Seat 6: Dizzydarts (24186 in chips) 
Seat 7: ivan limeira (52552 in chips) 
Seat 8: Mike.fontova (10582 in chips) 
MKL1010: posts the ante 150
DontCryClumsy88: posts the ante 150
Eux1986: posts the ante 150
moratto1992: posts the ante 150
4fast2u: posts the ante 150
Dizzydarts: posts the ante 150
ivan limeira: posts the ante 150
Mike.fontova: posts the ante 150
DontCryClumsy88: posts small blind 600
Eux1986: posts big blind 1200
*** HOLE CARDS ***
moratto1992: raises 1200 to 2400
4fast2u: folds 
Dizzydarts: folds 
ivan limeira: folds 
Mike.fontova: calls 2400
MKL1010: folds 
DontCryClumsy88: calls 1800
Eux1986: calls 1200
*** FLOP *** [2h Kh 8s]
DontCryClumsy88: checks 
Eux1986: checks 
moratto1992: checks 
Mike.fontova: bets 8032 and is all-in
DontCryClumsy88: raises 13664 to 21696 and is all-in
Eux1986: folds 
moratto1992: folds 
Uncalled bet (13664) returned to DontCryClumsy88
*** TURN *** [2h Kh 8s] [Td]
*** RIVER *** [2h Kh 8s Td] [8d]
*** SHOW DOWN ***
DontCryClumsy88: shows [Kd Jc] (two pair, Kings and Eights)
Mike.fontova: shows [Js Jd] (two pair, Jacks and Eights)
DontCryClumsy88 collected 26864 from pot
Mike.fontova finished the tournament
*** SUMMARY ***
Total pot 26864 | Rake 0 
Board [2h Kh 8s Td 8d]
Seat 1: MKL1010 (button) folded before Flop (didn't bet)
Seat 2: DontCryClumsy88 (small blind) showed [Kd Jc] and won (26864) with two pair, Kings and Eights
Seat 3: Eux1986 (big blind) folded on the Flop
Seat 4: moratto1992 folded on the Flop
Seat 5: 4fast2u folded before Flop (didn't bet)
Seat 6: Dizzydarts folded before Flop (didn't bet)
Seat 7: ivan limeira folded before Flop (didn't bet)
Seat 8: Mike.fontova showed [Js Jd] and lost with two pair, Jacks and Eights

PokerStars Hand #251205627968: Tournament #3767885527, $40+$10+$5 USD Hold'em No Limit - Level XI (600/1200) - 2024/06/26 19:08:29 UTC [2024/06/26 15:08:29 ET]
Table '3767885527 96' 8-max Seat #2 is the button
Seat 1: MKL1010 (37381 in chips) 
Seat 2: DontCryClumsy88 (40528 in chips) 
Seat 3: Eux1986 (87283 in chips) 
Seat 4: moratto1992 (25940 in chips) 
Seat 5: 4fast2u (32941 in chips) 
Seat 6: Dizzydarts (24036 in chips) 
Seat 7: ivan limeira (52402 in chips) 
MKL1010: posts the ante 150
DontCryClumsy88: posts the ante 150
Eux1986: posts the ante 150
moratto1992: posts the ante 150
4fast2u: posts the ante 150
Dizzydarts: posts the ante 150
ivan limeira: posts the ante 150
Eux1986: posts small blind 600
moratto1992: posts big blind 1200
*** HOLE CARDS ***
4fast2u: folds 
Dizzydarts: folds 
ivan limeira: folds 
MKL1010: raises 1200 to 2400
DontCryClumsy88: calls 2400
Eux1986: folds 
moratto1992: raises 23390 to 25790 and is all-in
MKL1010: folds 
DontCryClumsy88: folds 
Uncalled bet (23390) returned to moratto1992
moratto1992 collected 8850 from pot
moratto1992: doesn't show hand 
*** SUMMARY ***
Total pot 8850 | Rake 0 
Seat 1: MKL1010 folded before Flop
Seat 2: DontCryClumsy88 (button) folded before Flop
Seat 3: Eux1986 (small blind) folded before Flop
Seat 4: moratto1992 (big blind) collected (8850)
Seat 5: 4fast2u folded before Flop (didn't bet)
Seat 6: Dizzydarts folded before Flop (didn't bet)
Seat 7: ivan limeira folded before Flop (didn't bet)

PokerStars Hand #251205637815: Tournament #3767885527, $40+$10+$5 USD Hold'em No Limit - Level XI (600/1200) - 2024/06/26 19:09:06 UTC [2024/06/26 15:09:06 ET]
Table '3767885527 96' 8-max Seat #3 is the button
Seat 1: MKL1010 (34831 in chips) 
Seat 2: DontCryClumsy88 (37978 in chips) 
Seat 3: Eux1986 (86533 in chips) 
Seat 4: moratto1992 (32240 in chips) 
Seat 5: 4fast2u (32791 in chips) 
Seat 6: Dizzydarts (23886 in chips) 
Seat 7: ivan limeira (52252 in chips) 
MKL1010: posts the ante 150
DontCryClumsy88: posts the ante 150
Eux1986: posts the ante 150
moratto1992: posts the ante 150
4fast2u: posts the ante 150
Dizzydarts: posts the ante 150
ivan limeira: posts the ante 150
moratto1992: posts small blind 600
4fast2u: posts big blind 1200
*** HOLE CARDS ***
Dizzydarts: folds 
ivan limeira: folds 
MKL1010: folds 
DontCryClumsy88: folds 
Eux1986: folds 
moratto1992: calls 600
DontCryClumsy88 is disconnected 
4fast2u: checks 
*** FLOP *** [6d 9s Kh]
moratto1992: checks 
DontCryClumsy88 is disconnected 
4fast2u: checks 
*** TURN *** [6d 9s Kh] [6c]
moratto1992: bets 1200
4fast2u: calls 1200
*** RIVER *** [6d 9s Kh 6c] [6h]
moratto1992: bets 1200
4fast2u: calls 1200
*** SHOW DOWN ***
moratto1992: shows [2s 2c] (a full house, Sixes full of Deuces)
4fast2u: mucks hand 
moratto1992 collected 8250 from pot
*** SUMMARY ***
Total pot 8250 | Rake 0 
Board [6d 9s Kh 6c 6h]
Seat 1: MKL1010 folded before Flop (didn't bet)
Seat 2: DontCryClumsy88 folded before Flop (didn't bet)
Seat 3: Eux1986 (button) folded before Flop (didn't bet)
Seat 4: moratto1992 (small blind) showed [2s 2c] and won (8250) with a full house, Sixes full of Deuces
Seat 5: 4fast2u (big blind) mucked
Seat 6: Dizzydarts folded before Flop (didn't bet)
Seat 7: ivan limeira folded before Flop (didn't bet)

PokerStars Hand #251205649992: Tournament #3767885527, $40+$10+$5 USD Hold'em No Limit - Level XII (700/1400) - 2024/06/26 19:09:51 UTC [2024/06/26 15:09:51 ET]
Table '3767885527 96' 8-max Seat #4 is the button
Seat 1: MKL1010 (34681 in chips) 
Seat 2: DontCryClumsy88 (37828 in chips) 
Seat 3: Eux1986 (86383 in chips) 
Seat 4: moratto1992 (36740 in chips) 
Seat 5: 4fast2u (29041 in chips) 
Seat 6: Dizzydarts (23736 in chips) 
Seat 7: ivan limeira (52102 in chips) 
MKL1010: posts the ante 175
DontCryClumsy88: posts the ante 175
Eux1986: posts the ante 175
moratto1992: posts the ante 175
4fast2u: posts the ante 175
Dizzydarts: posts the ante 175
ivan limeira: posts the ante 175
4fast2u: posts small blind 700
Dizzydarts: posts big blind 1400
*** HOLE CARDS ***
ivan limeira: folds 
MKL1010: folds 
DontCryClumsy88: folds 
Eux1986: raises 2800 to 4200
moratto1992: folds 
4fast2u: raises 8225 to 12425
Dizzydarts: folds 
Eux1986: raises 73783 to 86208 and is all-in
4fast2u: calls 16441 and is all-in
Uncalled bet (57342) returned to Eux1986
*** FLOP *** [Ts 6h Qs]
*** TURN *** [Ts 6h Qs] [4d]
*** RIVER *** [Ts 6h Qs 4d] [6s]
*** SHOW DOWN ***
4fast2u: shows [As Ah] (two pair, Aces and Sixes)
Eux1986: shows [4c 4h] (a full house, Fours full of Sixes)
Eux1986 collected 60357 from pot
4fast2u finished the tournament
*** SUMMARY ***
Total pot 60357 | Rake 0 
Board [Ts 6h Qs 4d 6s]
Seat 1: MKL1010 folded before Flop (didn't bet)
Seat 2: DontCryClumsy88 folded before Flop (didn't bet)
Seat 3: Eux1986 showed [4c 4h] and won (60357) with a full house, Fours full of Sixes
Seat 4: moratto1992 (button) folded before Flop (didn't bet)
Seat 5: 4fast2u (small blind) showed [As Ah] and lost with two pair, Aces and Sixes
Seat 6: Dizzydarts (big blind) folded before Flop
Seat 7: ivan limeira folded before Flop (didn't bet)

PokerStars Hand #251205661495: Tournament #3767885527, $40+$10+$5 USD Hold'em No Limit - Level XII (700/1400) - 2024/06/26 19:10:34 UTC [2024/06/26 15:10:34 ET]
Table '3767885527 96' 8-max Seat #6 is the button
Seat 1: MKL1010 (34506 in chips) 
Seat 2: DontCryClumsy88 (37653 in chips) 
Seat 3: Eux1986 (117699 in chips) 
Seat 4: moratto1992 (36565 in chips) 
Seat 6: Dizzydarts (22161 in chips) 
Seat 7: ivan limeira (51927 in chips) 
Seat 8: diabo656 (78175 in chips) 
MKL1010: posts the ante 175
DontCryClumsy88: posts the ante 175
Eux1986: posts the ante 175
moratto1992: posts the ante 175
Dizzydarts: posts the ante 175
ivan limeira: posts the ante 175
diabo656: posts the ante 175
ivan limeira: posts small blind 700
diabo656: posts big blind 1400
*** HOLE CARDS ***
MKL1010: folds 
DontCryClumsy88: folds 
Eux1986: folds 
moratto1992: folds 
Dizzydarts: raises 1400 to 2800
ivan limeira: folds 
diabo656 has timed out
diabo656: folds 
diabo656 is sitting out
Uncalled bet (1400) returned to Dizzydarts
Dizzydarts collected 4725 from pot
Dizzydarts: doesn't show hand 
*** SUMMARY ***
Total pot 4725 | Rake 0 
Seat 1: MKL1010 folded before Flop (didn't bet)
Seat 2: DontCryClumsy88 folded before Flop (didn't bet)
Seat 3: Eux1986 folded before Flop (didn't bet)
Seat 4: moratto1992 folded before Flop (didn't bet)
Seat 6: Dizzydarts (button) collected (4725)
Seat 7: ivan limeira (small blind) folded before Flop
Seat 8: diabo656 (big blind) folded before Flop

PokerStars Hand #251205669658: Tournament #3767885527, $40+$10+$5 USD Hold'em No Limit - Level XII (700/1400) - 2024/06/26 19:11:04 UTC [2024/06/26 15:11:04 ET]
Table '3767885527 96' 8-max Seat #7 is the button
Seat 1: MKL1010 (34331 in chips) 
Seat 2: DontCryClumsy88 (37478 in chips) 
Seat 3: Eux1986 (117524 in chips) 
Seat 4: moratto1992 (36390 in chips) 
Seat 6: Dizzydarts (25311 in chips) 
Seat 7: ivan limeira (51052 in chips) 
Seat 8: diabo656 (76600 in chips) is sitting out
MKL1010: posts the ante 175
DontCryClumsy88: posts the ante 175
Eux1986: posts the ante 175
moratto1992: posts the ante 175
Dizzydarts: posts the ante 175
ivan limeira: posts the ante 175
diabo656: posts the ante 175
diabo656: posts small blind 700
MKL1010: posts big blind 1400
*** HOLE CARDS ***
DontCryClumsy88: folds 
Eux1986: folds 
moratto1992: folds 
Dizzydarts: calls 1400
ivan limeira: folds 
diabo656: folds 
MKL1010: checks 
*** FLOP *** [Ah 8s 9h]
diabo656 has returned
MKL1010: checks 
Dizzydarts: bets 2363
MKL1010: folds 
Uncalled bet (2363) returned to Dizzydarts
Dizzydarts collected 4725 from pot
Dizzydarts: doesn't show hand 
*** SUMMARY ***
Total pot 4725 | Rake 0 
Board [Ah 8s 9h]
Seat 1: MKL1010 (big blind) folded on the Flop
Seat 2: DontCryClumsy88 folded before Flop (didn't bet)
Seat 3: Eux1986 folded before Flop (didn't bet)
Seat 4: moratto1992 folded before Flop (didn't bet)
Seat 6: Dizzydarts collected (4725)
Seat 7: ivan limeira (button) folded before Flop (didn't bet)
Seat 8: diabo656 (small blind) folded before Flop

PokerStars Hand #251205677346: Tournament #3767885527, $40+$10+$5 USD Hold'em No Limit - Level XII (700/1400) - 2024/06/26 19:11:33 UTC [2024/06/26 15:11:33 ET]
Table '3767885527 96' 8-max Seat #8 is the button
Seat 1: MKL1010 (32756 in chips) 
Seat 2: DontCryClumsy88 (37303 in chips) 
Seat 3: Eux1986 (117349 in chips) 
Seat 4: moratto1992 (36215 in chips) 
Seat 6: Dizzydarts (28461 in chips) 
Seat 7: ivan limeira (50877 in chips) 
Seat 8: diabo656 (75725 in chips) 
MKL1010: posts the ante 175
DontCryClumsy88: posts the ante 175
Eux1986: posts the ante 175
moratto1992: posts the ante 175
Dizzydarts: posts the ante 175
ivan limeira: posts the ante 175
diabo656: posts the ante 175
MKL1010: posts small blind 700
DontCryClumsy88: posts big blind 1400
*** HOLE CARDS ***
Eux1986: folds 
moratto1992: raises 1400 to 2800
Dizzydarts: folds 
ivan limeira: raises 4900 to 7700
diabo656 has timed out
diabo656: folds 
diabo656 is sitting out
diabo656 has returned
MKL1010: folds 
DontCryClumsy88: folds 
moratto1992: calls 4900
*** FLOP *** [As 5d 6c]
moratto1992: checks 
ivan limeira: bets 4200
UnterMauern is disconnected 
moratto1992: folds 
Uncalled bet (4200) returned to ivan limeira
ivan limeira collected 18725 from pot
ivan limeira: doesn't show hand 
*** SUMMARY ***
Total pot 18725 | Rake 0 
Board [As 5d 6c]
Seat 1: MKL1010 (small blind) folded before Flop
Seat 2: DontCryClumsy88 (big blind) folded before Flop
Seat 3: Eux1986 folded before Flop (didn't bet)
Seat 4: moratto1992 folded on the Flop
Seat 6: Dizzydarts folded before Flop (didn't bet)
Seat 7: ivan limeira collected (18725)
Seat 8: diabo656 (button) folded before Flop (didn't bet)

PokerStars Hand #251205698735: Tournament #3767885527, $40+$10+$5 USD Hold'em No Limit - Level XII (700/1400) - 2024/06/26 19:12:52 UTC [2024/06/26 15:12:52 ET]
Table '3767885527 96' 8-max Seat #1 is the button
Seat 1: MKL1010 (31881 in chips) 
Seat 2: DontCryClumsy88 (35728 in chips) 
Seat 3: Eux1986 (117174 in chips) 
Seat 4: moratto1992 (28340 in chips) 
Seat 5: UnterMauern (25000 in chips) 
Seat 6: Dizzydarts (28286 in chips) 
Seat 7: ivan limeira (61727 in chips) 
Seat 8: diabo656 (75550 in chips) 
MKL1010: posts the ante 175
DontCryClumsy88: posts the ante 175
Eux1986: posts the ante 175
moratto1992: posts the ante 175
UnterMauern: posts the ante 175
Dizzydarts: posts the ante 175
ivan limeira: posts the ante 175
diabo656: posts the ante 175
DontCryClumsy88: posts small blind 700
Eux1986: posts big blind 1400
*** HOLE CARDS ***
moratto1992: folds 
UnterMauern: folds 
Dizzydarts: raises 1400 to 2800
ivan limeira: folds 
diabo656: folds 
MKL1010: folds 
DontCryClumsy88: calls 2100
Eux1986: calls 1400
*** FLOP *** [Ks As 9d]
DontCryClumsy88: checks 
Eux1986: bets 1400
Dizzydarts: calls 1400
DontCryClumsy88: calls 1400
*** TURN *** [Ks As 9d] [4d]
DontCryClumsy88: checks 
Eux1986: checks 
Dizzydarts: bets 2100
DontCryClumsy88: calls 2100
Eux1986: folds 
*** RIVER *** [Ks As 9d 4d] [Tc]
DontCryClumsy88: checks 
Dizzydarts: checks 
*** SHOW DOWN ***
DontCryClumsy88: shows [8d Ad] (a pair of Aces)
Dizzydarts: mucks hand 
DontCryClumsy88 collected 18200 from pot
*** SUMMARY ***
Total pot 18200 | Rake 0 
Board [Ks As 9d 4d Tc]
Seat 1: MKL1010 (button) folded before Flop (didn't bet)
Seat 2: DontCryClumsy88 (small blind) showed [8d Ad] and won (18200) with a pair of Aces
Seat 3: Eux1986 (big blind) folded on the Turn
Seat 4: moratto1992 folded before Flop (didn't bet)
Seat 5: UnterMauern folded before Flop (didn't bet)
Seat 6: Dizzydarts mucked
Seat 7: ivan limeira folded before Flop (didn't bet)
Seat 8: diabo656 folded before Flop (didn't bet)

PokerStars Hand #251205717395: Tournament #3767885527, $40+$10+$5 USD Hold'em No Limit - Level XII (700/1400) - 2024/06/26 19:14:01 UTC [2024/06/26 15:14:01 ET]
Table '3767885527 96' 8-max Seat #2 is the button
Seat 1: MKL1010 (31706 in chips) 
Seat 2: DontCryClumsy88 (47453 in chips) 
Seat 3: Eux1986 (112799 in chips) 
Seat 4: moratto1992 (28165 in chips) 
Seat 5: UnterMauern (24825 in chips) 
Seat 6: Dizzydarts (21811 in chips) 
Seat 7: ivan limeira (61552 in chips) 
Seat 8: diabo656 (75375 in chips) 
MKL1010: posts the ante 175
DontCryClumsy88: posts the ante 175
Eux1986: posts the ante 175
moratto1992: posts the ante 175
UnterMauern: posts the ante 175
Dizzydarts: posts the ante 175
ivan limeira: posts the ante 175
diabo656: posts the ante 175
Eux1986: posts small blind 700
moratto1992: posts big blind 1400
*** HOLE CARDS ***
UnterMauern: folds 
Dizzydarts: raises 1400 to 2800
ivan limeira: folds 
diabo656: folds 
MKL1010: folds 
DontCryClumsy88: calls 2800
Eux1986: folds 
moratto1992: folds 
*** FLOP *** [3d 6c 8d]
Dizzydarts: checks 
DontCryClumsy88: checks 
*** TURN *** [3d 6c 8d] [5c]
Dizzydarts: checks 
DontCryClumsy88: checks 
*** RIVER *** [3d 6c 8d 5c] [Td]
Dizzydarts: checks 
DontCryClumsy88: checks 
*** SHOW DOWN ***
Dizzydarts: shows [Qs Ah] (high card Ace)
DontCryClumsy88: shows [Qc Ad] (high card Ace)
Dizzydarts collected 4550 from pot
DontCryClumsy88 collected 4550 from pot
*** SUMMARY ***
Total pot 9100 | Rake 0 
Board [3d 6c 8d 5c Td]
Seat 1: MKL1010 folded before Flop (didn't bet)
Seat 2: DontCryClumsy88 (button) showed [Qc Ad] and won (4550) with high card Ace
Seat 3: Eux1986 (small blind) folded before Flop
Seat 4: moratto1992 (big blind) folded before Flop
Seat 5: UnterMauern folded before Flop (didn't bet)
Seat 6: Dizzydarts showed [Qs Ah] and won (4550) with high card Ace
Seat 7: ivan limeira folded before Flop (didn't bet)
Seat 8: diabo656 folded before Flop (didn't bet)

PokerStars Hand #251205729421: Tournament #3767885527, $40+$10+$5 USD Hold'em No Limit - Level XII (700/1400) - 2024/06/26 19:14:45 UTC [2024/06/26 15:14:45 ET]
Table '3767885527 96' 8-max Seat #3 is the button
Seat 1: MKL1010 (31531 in chips) 
Seat 2: DontCryClumsy88 (49028 in chips) 
Seat 3: Eux1986 (111924 in chips) 
Seat 4: moratto1992 (26590 in chips) 
Seat 5: UnterMauern (24650 in chips) 
Seat 6: Dizzydarts (23386 in chips) 
Seat 7: ivan limeira (61377 in chips) 
Seat 8: diabo656 (75200 in chips) 
MKL1010: posts the ante 175
DontCryClumsy88: posts the ante 175
Eux1986: posts the ante 175
moratto1992: posts the ante 175
UnterMauern: posts the ante 175
Dizzydarts: posts the ante 175
ivan limeira: posts the ante 175
diabo656: posts the ante 175
moratto1992: posts small blind 700
UnterMauern: posts big blind 1400
*** HOLE CARDS ***
Dizzydarts: folds 
ivan limeira: folds 
diabo656 has timed out
diabo656: folds 
diabo656 is sitting out
MKL1010: folds 
DontCryClumsy88: folds 
Eux1986: calls 1400
moratto1992: calls 700
diabo656 has returned
UnterMauern: checks 
*** FLOP *** [Th 4d 3h]
moratto1992: checks 
UnterMauern: checks 
Eux1986: bets 2800
moratto1992: calls 2800
UnterMauern: folds 
*** TURN *** [Th 4d 3h] [8s]
moratto1992: bets 22215 and is all-in
Eux1986: folds 
Uncalled bet (22215) returned to moratto1992
moratto1992 collected 11200 from pot
moratto1992: doesn't show hand 
*** SUMMARY ***
Total pot 11200 | Rake 0 
Board [Th 4d 3h 8s]
Seat 1: MKL1010 folded before Flop (didn't bet)
Seat 2: DontCryClumsy88 folded before Flop (didn't bet)
Seat 3: Eux1986 (button) folded on the Turn
Seat 4: moratto1992 (small blind) collected (11200)
Seat 5: UnterMauern (big blind) folded on the Flop
Seat 6: Dizzydarts folded before Flop (didn't bet)
Seat 7: ivan limeira folded before Flop (didn't bet)
Seat 8: diabo656 folded before Flop (didn't bet)

PokerStars Hand #251205757480: Tournament #3767885527, $40+$10+$5 USD Hold'em No Limit - Level XII (700/1400) - 2024/06/26 19:16:28 UTC [2024/06/26 15:16:28 ET]
Table '3767885527 96' 8-max Seat #4 is the button
Seat 1: MKL1010 (31356 in chips) 
Seat 2: DontCryClumsy88 (48853 in chips) 
Seat 3: Eux1986 (107549 in chips) 
Seat 4: moratto1992 (33415 in chips) 
Seat 5: UnterMauern (23075 in chips) 
Seat 6: Dizzydarts (23211 in chips) 
Seat 7: ivan limeira (61202 in chips) 
Seat 8: diabo656 (75025 in chips) 
MKL1010: posts the ante 175
DontCryClumsy88: posts the ante 175
Eux1986: posts the ante 175
moratto1992: posts the ante 175
UnterMauern: posts the ante 175
Dizzydarts: posts the ante 175
ivan limeira: posts the ante 175
diabo656: posts the ante 175
UnterMauern: posts small blind 700
Dizzydarts: posts big blind 1400
*** HOLE CARDS ***
MKL1010 is disconnected 
ivan limeira: folds 
diabo656: folds 
MKL1010 is connected 
MKL1010 is connected 
MKL1010: folds 
DontCryClumsy88: folds 
Eux1986: calls 1400
moratto1992: folds 
UnterMauern: folds 
Dizzydarts: checks 
*** FLOP *** [Tc 5d 5s]
Dizzydarts: checks 
Eux1986: checks 
*** TURN *** [Tc 5d 5s] [6h]
Dizzydarts: checks 
Eux1986: bets 2800
Dizzydarts: folds 
Uncalled bet (2800) returned to Eux1986
Eux1986 collected 4900 from pot
Eux1986: doesn't show hand 
*** SUMMARY ***
Total pot 4900 | Rake 0 
Board [Tc 5d 5s 6h]
Seat 1: MKL1010 folded before Flop (didn't bet)
Seat 2: DontCryClumsy88 folded before Flop (didn't bet)
Seat 3: Eux1986 collected (4900)
Seat 4: moratto1992 (button) folded before Flop (didn't bet)
Seat 5: UnterMauern (small blind) folded before Flop
Seat 6: Dizzydarts (big blind) folded on the Turn
Seat 7: ivan limeira folded before Flop (didn't bet)
Seat 8: diabo656 folded before Flop (didn't bet)

PokerStars Hand #251205771625: Tournament #3767885527, $40+$10+$5 USD Hold'em No Limit - Level XII (700/1400) - 2024/06/26 19:17:20 UTC [2024/06/26 15:17:20 ET]
Table '3767885527 96' 8-max Seat #5 is the button
Seat 1: MKL1010 (31181 in chips) 
Seat 2: DontCryClumsy88 (48678 in chips) 
Seat 3: Eux1986 (110874 in chips) 
Seat 4: moratto1992 (33240 in chips) 
Seat 5: UnterMauern (22200 in chips) 
Seat 6: Dizzydarts (21636 in chips) 
Seat 7: ivan limeira (61027 in chips) 
Seat 8: diabo656 (74850 in chips) 
MKL1010: posts the ante 175
DontCryClumsy88: posts the ante 175
Eux1986: posts the ante 175
moratto1992: posts the ante 175
UnterMauern: posts the ante 175
Dizzydarts: posts the ante 175
ivan limeira: posts the ante 175
diabo656: posts the ante 175
Dizzydarts: posts small blind 700
ivan limeira: posts big blind 1400
*** HOLE CARDS ***
diabo656 has timed out
diabo656: folds 
diabo656 is sitting out
MKL1010: folds 
diabo656 has returned
DontCryClumsy88: folds 
Eux1986: folds 
moratto1992: folds 
UnterMauern: folds 
Dizzydarts: calls 700
ivan limeira: raises 59452 to 60852 and is all-in
Dizzydarts: folds 
Uncalled bet (59452) returned to ivan limeira
ivan limeira collected 4200 from pot
ivan limeira: doesn't show hand 
*** SUMMARY ***
Total pot 4200 | Rake 0 
Seat 1: MKL1010 folded before Flop (didn't bet)
Seat 2: DontCryClumsy88 folded before Flop (didn't bet)
Seat 3: Eux1986 folded before Flop (didn't bet)
Seat 4: moratto1992 folded before Flop (didn't bet)
Seat 5: UnterMauern (button) folded before Flop (didn't bet)
Seat 6: Dizzydarts (small blind) folded before Flop
Seat 7: ivan limeira (big blind) collected (4200)
Seat 8: diabo656 folded before Flop (didn't bet)

PokerStars Hand #251205783980: Tournament #3767885527, $40+$10+$5 USD Hold'em No Limit - Level XII (700/1400) - 2024/06/26 19:18:05 UTC [2024/06/26 15:18:05 ET]
Table '3767885527 96' 8-max Seat #6 is the button
Seat 1: MKL1010 (31006 in chips) 
Seat 2: DontCryClumsy88 (48503 in chips) 
Seat 3: Eux1986 (110699 in chips) 
Seat 4: moratto1992 (33065 in chips) 
Seat 5: UnterMauern (22025 in chips) 
Seat 6: Dizzydarts (20061 in chips) 
Seat 7: ivan limeira (63652 in chips) 
Seat 8: diabo656 (74675 in chips) 
MKL1010: posts the ante 175
DontCryClumsy88: posts the ante 175
Eux1986: posts the ante 175
moratto1992: posts the ante 175
UnterMauern: posts the ante 175
Dizzydarts: posts the ante 175
ivan limeira: posts the ante 175
diabo656: posts the ante 175
ivan limeira: posts small blind 700
diabo656: posts big blind 1400
*** HOLE CARDS ***
MKL1010: folds 
DontCryClumsy88: folds 
Eux1986: folds 
moratto1992: folds 
UnterMauern: folds 
Dizzydarts: raises 1400 to 2800
ivan limeira: folds 
diabo656: calls 1400
*** FLOP *** [9d Ah Ks]
diabo656: checks 
Dizzydarts: checks 
*** TURN *** [9d Ah Ks] [Qc]
diabo656: bets 3850
Dizzydarts: folds 
Uncalled bet (3850) returned to diabo656
diabo656 collected 7700 from pot
*** SUMMARY ***
Total pot 7700 | Rake 0 
Board [9d Ah Ks Qc]
Seat 1: MKL1010 folded before Flop (didn't bet)
Seat 2: DontCryClumsy88 folded before Flop (didn't bet)
Seat 3: Eux1986 folded before Flop (didn't bet)
Seat 4: moratto1992 folded before Flop (didn't bet)
Seat 5: UnterMauern folded before Flop (didn't bet)
Seat 6: Dizzydarts (button) folded on the Turn
Seat 7: ivan limeira (small blind) folded before Flop
Seat 8: diabo656 (big blind) collected (7700)

PokerStars Hand #251205796194: Tournament #3767885527, $40+$10+$5 USD Hold'em No Limit - Level XII (700/1400) - 2024/06/26 19:18:50 UTC [2024/06/26 15:18:50 ET]
Table '3767885527 96' 8-max Seat #7 is the button
Seat 1: MKL1010 (30831 in chips) 
Seat 2: DontCryClumsy88 (48328 in chips) 
Seat 3: Eux1986 (110524 in chips) 
Seat 4: moratto1992 (32890 in chips) 
Seat 5: UnterMauern (21850 in chips) 
Seat 6: Dizzydarts (17086 in chips) 
Seat 7: ivan limeira (62777 in chips) 
Seat 8: diabo656 (79400 in chips) 
MKL1010: posts the ante 175
DontCryClumsy88: posts the ante 175
Eux1986: posts the ante 175
moratto1992: posts the ante 175
UnterMauern: posts the ante 175
Dizzydarts: posts the ante 175
ivan limeira: posts the ante 175
diabo656: posts the ante 175
diabo656: posts small blind 700
MKL1010: posts big blind 1400
*** HOLE CARDS ***
DontCryClumsy88: calls 1400
Eux1986: folds 
moratto1992: folds 
UnterMauern: folds 
Dizzydarts: calls 1400
ivan limeira: folds 
diabo656: folds 
MKL1010: checks 
*** FLOP *** [3d Qd Kh]
MKL1010: checks 
DontCryClumsy88: checks 
Dizzydarts: checks 
*** TURN *** [3d Qd Kh] [5c]
MKL1010: bets 2800
DontCryClumsy88: calls 2800
Dizzydarts: folds 
*** RIVER *** [3d Qd Kh 5c] [Ac]
MKL1010: checks 
DontCryClumsy88: bets 3927
MKL1010: calls 3927
*** SHOW DOWN ***
DontCryClumsy88: shows [Jc Td] (a straight, Ten to Ace)
MKL1010: mucks hand 
DontCryClumsy88 collected 19754 from pot
*** SUMMARY ***
Total pot 19754 | Rake 0 
Board [3d Qd Kh 5c Ac]
Seat 1: MKL1010 (big blind) mucked
Seat 2: DontCryClumsy88 showed [Jc Td] and won (19754) with a straight, Ten to Ace
Seat 3: Eux1986 folded before Flop (didn't bet)
Seat 4: moratto1992 folded before Flop (didn't bet)
Seat 5: UnterMauern folded before Flop (didn't bet)
Seat 6: Dizzydarts folded on the Turn
Seat 7: ivan limeira (button) folded before Flop (didn't bet)
Seat 8: diabo656 (small blind) folded before Flop

PokerStars Hand #251205810694: Tournament #3767885527, $40+$10+$5 USD Hold'em No Limit - Level XIII (800/1600) - 2024/06/26 19:19:43 UTC [2024/06/26 15:19:43 ET]
Table '3767885527 96' 8-max Seat #8 is the button
Seat 1: MKL1010 (22529 in chips) 
Seat 2: DontCryClumsy88 (59780 in chips) 
Seat 3: Eux1986 (110349 in chips) 
Seat 4: moratto1992 (32715 in chips) 
Seat 5: UnterMauern (21675 in chips) 
Seat 6: Dizzydarts (15511 in chips) 
Seat 7: ivan limeira (62602 in chips) 
Seat 8: diabo656 (78525 in chips) 
MKL1010: posts the ante 200
DontCryClumsy88: posts the ante 200
Eux1986: posts the ante 200
moratto1992: posts the ante 200
UnterMauern: posts the ante 200
Dizzydarts: posts the ante 200
ivan limeira: posts the ante 200
diabo656: posts the ante 200
MKL1010: posts small blind 800
DontCryClumsy88: posts big blind 1600
*** HOLE CARDS ***
Eux1986: folds 
moratto1992: folds 
UnterMauern: folds 
Dizzydarts: folds 
ivan limeira: folds 
diabo656: folds 
MKL1010: calls 800
DontCryClumsy88: checks 
*** FLOP *** [5h 9s Jc]
MKL1010: checks 
DontCryClumsy88: checks 
*** TURN *** [5h 9s Jc] [Ad]
MKL1010: checks 
DontCryClumsy88: bets 2640
MKL1010: folds 
Uncalled bet (2640) returned to DontCryClumsy88
DontCryClumsy88 collected 4800 from pot
*** SUMMARY ***
Total pot 4800 | Rake 0 
Board [5h 9s Jc Ad]
Seat 1: MKL1010 (small blind) folded on the Turn
Seat 2: DontCryClumsy88 (big blind) collected (4800)
Seat 3: Eux1986 folded before Flop (didn't bet)
Seat 4: moratto1992 folded before Flop (didn't bet)
Seat 5: UnterMauern folded before Flop (didn't bet)
Seat 6: Dizzydarts folded before Flop (didn't bet)
Seat 7: ivan limeira folded before Flop (didn't bet)
Seat 8: diabo656 (button) folded before Flop (didn't bet)

PokerStars Hand #251205820329: Tournament #3767885527, $40+$10+$5 USD Hold'em No Limit - Level XIII (800/1600) - 2024/06/26 19:20:18 UTC [2024/06/26 15:20:18 ET]
Table '3767885527 96' 8-max Seat #1 is the button
Seat 1: MKL1010 (20729 in chips) 
Seat 2: DontCryClumsy88 (62780 in chips) 
Seat 3: Eux1986 (110149 in chips) 
Seat 4: moratto1992 (32515 in chips) 
Seat 5: UnterMauern (21475 in chips) 
Seat 6: Dizzydarts (15311 in chips) 
Seat 7: ivan limeira (62402 in chips) 
Seat 8: diabo656 (78325 in chips) 
MKL1010: posts the ante 200
DontCryClumsy88: posts the ante 200
Eux1986: posts the ante 200
moratto1992: posts the ante 200
UnterMauern: posts the ante 200
Dizzydarts: posts the ante 200
ivan limeira: posts the ante 200
diabo656: posts the ante 200
DontCryClumsy88: posts small blind 800
Eux1986: posts big blind 1600
*** HOLE CARDS ***
moratto1992: folds 
UnterMauern: folds 
Dizzydarts: raises 1600 to 3200
ivan limeira: folds 
diabo656: folds 
MKL1010: folds 
DontCryClumsy88: folds 
Eux1986: calls 1600
*** FLOP *** [6d Jd 2c]
Eux1986: checks 
Dizzydarts: bets 11911 and is all-in
Eux1986: folds 
Uncalled bet (11911) returned to Dizzydarts
Dizzydarts collected 8800 from pot
Dizzydarts: doesn't show hand 
*** SUMMARY ***
Total pot 8800 | Rake 0 
Board [6d Jd 2c]
Seat 1: MKL1010 (button) folded before Flop (didn't bet)
Seat 2: DontCryClumsy88 (small blind) folded before Flop
Seat 3: Eux1986 (big blind) folded on the Flop
Seat 4: moratto1992 folded before Flop (didn't bet)
Seat 5: UnterMauern folded before Flop (didn't bet)
Seat 6: Dizzydarts collected (8800)
Seat 7: ivan limeira folded before Flop (didn't bet)
Seat 8: diabo656 folded before Flop (didn't bet)

PokerStars Hand #251205830398: Tournament #3767885527, $40+$10+$5 USD Hold'em No Limit - Level XIII (800/1600) - 2024/06/26 19:20:56 UTC [2024/06/26 15:20:56 ET]
Table '3767885527 96' 8-max Seat #2 is the button
Seat 1: MKL1010 (20529 in chips) 
Seat 2: DontCryClumsy88 (61780 in chips) 
Seat 3: Eux1986 (106749 in chips) 
Seat 4: moratto1992 (32315 in chips) 
Seat 5: UnterMauern (21275 in chips) 
Seat 6: Dizzydarts (20711 in chips) 
Seat 7: ivan limeira (62202 in chips) 
Seat 8: diabo656 (78125 in chips) 
MKL1010: posts the ante 200
DontCryClumsy88: posts the ante 200
Eux1986: posts the ante 200
moratto1992: posts the ante 200
UnterMauern: posts the ante 200
Dizzydarts: posts the ante 200
ivan limeira: posts the ante 200
diabo656: posts the ante 200
Eux1986: posts small blind 800
moratto1992: posts big blind 1600
*** HOLE CARDS ***
UnterMauern: raises 19200 to 20800
Dizzydarts: folds 
ivan limeira: folds 
diabo656: folds 
MKL1010: folds 
DontCryClumsy88: folds 
Eux1986: folds 
moratto1992: folds 
Uncalled bet (19200) returned to UnterMauern
UnterMauern collected 5600 from pot
UnterMauern: doesn't show hand 
*** SUMMARY ***
Total pot 5600 | Rake 0 
Seat 1: MKL1010 folded before Flop (didn't bet)
Seat 2: DontCryClumsy88 (button) folded before Flop (didn't bet)
Seat 3: Eux1986 (small blind) folded before Flop
Seat 4: moratto1992 (big blind) folded before Flop
Seat 5: UnterMauern collected (5600)
Seat 6: Dizzydarts folded before Flop (didn't bet)
Seat 7: ivan limeira folded before Flop (didn't bet)
Seat 8: diabo656 folded before Flop (didn't bet)

PokerStars Hand #251205840255: Tournament #3767885527, $40+$10+$5 USD Hold'em No Limit - Level XIII (800/1600) - 2024/06/26 19:21:32 UTC [2024/06/26 15:21:32 ET]
Table '3767885527 96' 8-max Seat #3 is the button
Seat 1: MKL1010 (20329 in chips) 
Seat 2: DontCryClumsy88 (61580 in chips) 
Seat 3: Eux1986 (105749 in chips) 
Seat 4: moratto1992 (30515 in chips) 
Seat 5: UnterMauern (25075 in chips) 
Seat 6: Dizzydarts (20511 in chips) 
Seat 7: ivan limeira (62002 in chips) 
Seat 8: diabo656 (77925 in chips) 
MKL1010: posts the ante 200
DontCryClumsy88: posts the ante 200
Eux1986: posts the ante 200
moratto1992: posts the ante 200
UnterMauern: posts the ante 200
Dizzydarts: posts the ante 200
ivan limeira: posts the ante 200
diabo656: posts the ante 200
moratto1992: posts small blind 800
UnterMauern: posts big blind 1600
*** HOLE CARDS ***
Dizzydarts: folds 
ivan limeira: folds 
diabo656: folds 
MKL1010: folds 
DontCryClumsy88: folds 
Eux1986: folds 
moratto1992: raises 28715 to 30315 and is all-in
UnterMauern: folds 
Uncalled bet (28715) returned to moratto1992
moratto1992 collected 4800 from pot
moratto1992: doesn't show hand 
*** SUMMARY ***
Total pot 4800 | Rake 0 
Seat 1: MKL1010 folded before Flop (didn't bet)
Seat 2: DontCryClumsy88 folded before Flop (didn't bet)
Seat 3: Eux1986 (button) folded before Flop (didn't bet)
Seat 4: moratto1992 (small blind) collected (4800)
Seat 5: UnterMauern (big blind) folded before Flop
Seat 6: Dizzydarts folded before Flop (didn't bet)
Seat 7: ivan limeira folded before Flop (didn't bet)
Seat 8: diabo656 folded before Flop (didn't bet)

PokerStars Hand #251205848401: Tournament #3767885527, $40+$10+$5 USD Hold'em No Limit - Level XIII (800/1600) - 2024/06/26 19:22:02 UTC [2024/06/26 15:22:02 ET]
Table '3767885527 96' 8-max Seat #4 is the button
Seat 1: MKL1010 (20129 in chips) 
Seat 2: DontCryClumsy88 (61380 in chips) 
Seat 3: Eux1986 (105549 in chips) 
Seat 4: moratto1992 (33515 in chips) 
Seat 5: UnterMauern (23275 in chips) 
Seat 6: Dizzydarts (20311 in chips) 
Seat 7: ivan limeira (61802 in chips) 
Seat 8: diabo656 (77725 in chips) 
MKL1010: posts the ante 200
DontCryClumsy88: posts the ante 200
Eux1986: posts the ante 200
moratto1992: posts the ante 200
UnterMauern: posts the ante 200
Dizzydarts: posts the ante 200
ivan limeira: posts the ante 200
diabo656: posts the ante 200
UnterMauern: posts small blind 800
Dizzydarts: posts big blind 1600
*** HOLE CARDS ***
ivan limeira: folds 
diabo656: calls 1600
MKL1010: folds 
DontCryClumsy88: folds 
Eux1986: folds 
moratto1992: folds 
UnterMauern: folds 
Dizzydarts: checks 
*** FLOP *** [3h 5s 9c]
Dizzydarts: checks 
diabo656: bets 5600
Dizzydarts: folds 
Uncalled bet (5600) returned to diabo656
diabo656 collected 5600 from pot
*** SUMMARY ***
Total pot 5600 | Rake 0 
Board [3h 5s 9c]
Seat 1: MKL1010 folded before Flop (didn't bet)
Seat 2: DontCryClumsy88 folded before Flop (didn't bet)
Seat 3: Eux1986 folded before Flop (didn't bet)
Seat 4: moratto1992 (button) folded before Flop (didn't bet)
Seat 5: UnterMauern (small blind) folded before Flop
Seat 6: Dizzydarts (big blind) folded on the Flop
Seat 7: ivan limeira folded before Flop (didn't bet)
Seat 8: diabo656 collected (5600)

PokerStars Hand #251205860002: Tournament #3767885527, $40+$10+$5 USD Hold'em No Limit - Level XIII (800/1600) - 2024/06/26 19:22:44 UTC [2024/06/26 15:22:44 ET]
Table '3767885527 96' 8-max Seat #5 is the button
Seat 1: MKL1010 (19929 in chips) 
Seat 2: DontCryClumsy88 (61180 in chips) 
Seat 3: Eux1986 (105349 in chips) 
Seat 4: moratto1992 (33315 in chips) 
Seat 5: UnterMauern (22275 in chips) 
Seat 6: Dizzydarts (18511 in chips) 
Seat 7: ivan limeira (61602 in chips) 
Seat 8: diabo656 (81525 in chips) 
MKL1010: posts the ante 200
DontCryClumsy88: posts the ante 200
Eux1986: posts the ante 200
moratto1992: posts the ante 200
UnterMauern: posts the ante 200
Dizzydarts: posts the ante 200
ivan limeira: posts the ante 200
diabo656: posts the ante 200
Dizzydarts: posts small blind 800
ivan limeira: posts big blind 1600
*** HOLE CARDS ***
diabo656: folds 
MKL1010: folds 
DontCryClumsy88: folds 
Eux1986: calls 1600
moratto1992: calls 1600
UnterMauern: calls 1600
Dizzydarts: raises 16711 to 18311 and is all-in
ivan limeira: folds 
Eux1986: folds 
moratto1992: folds 
UnterMauern: folds 
Uncalled bet (16711) returned to Dizzydarts
Dizzydarts collected 9600 from pot
Dizzydarts: doesn't show hand 
*** SUMMARY ***
Total pot 9600 | Rake 0 
Seat 1: MKL1010 folded before Flop (didn't bet)
Seat 2: DontCryClumsy88 folded before Flop (didn't bet)
Seat 3: Eux1986 folded before Flop
Seat 4: moratto1992 folded before Flop
Seat 5: UnterMauern (button) folded before Flop
Seat 6: Dizzydarts (small blind) collected (9600)
Seat 7: ivan limeira (big blind) folded before Flop
Seat 8: diabo656 folded before Flop (didn't bet)

PokerStars Hand #251205876143: Tournament #3767885527, $40+$10+$5 USD Hold'em No Limit - Level XIII (800/1600) - 2024/06/26 19:23:43 UTC [2024/06/26 15:23:43 ET]
Table '3767885527 96' 8-max Seat #6 is the button
Seat 1: MKL1010 (19729 in chips) 
Seat 2: DontCryClumsy88 (60980 in chips) 
Seat 3: Eux1986 (103549 in chips) 
Seat 4: moratto1992 (31515 in chips) 
Seat 5: UnterMauern (20475 in chips) 
Seat 6: Dizzydarts (26311 in chips) 
Seat 7: ivan limeira (59802 in chips) 
Seat 8: diabo656 (81325 in chips) 
MKL1010: posts the ante 200
DontCryClumsy88: posts the ante 200
Eux1986: posts the ante 200
moratto1992: posts the ante 200
UnterMauern: posts the ante 200
Dizzydarts: posts the ante 200
ivan limeira: posts the ante 200
diabo656: posts the ante 200
ivan limeira: posts small blind 800
diabo656: posts big blind 1600
*** HOLE CARDS ***
MKL1010: raises 17929 to 19529 and is all-in
DontCryClumsy88: folds 
Eux1986: folds 
moratto1992: folds 
UnterMauern: folds 
Dizzydarts: folds 
ivan limeira: folds 
diabo656 is disconnected 
diabo656 is connected 
diabo656 is connected 
diabo656: folds 
Uncalled bet (17929) returned to MKL1010
MKL1010 collected 5600 from pot
MKL1010: doesn't show hand 
*** SUMMARY ***
Total pot 5600 | Rake 0 
Seat 1: MKL1010 collected (5600)
Seat 2: DontCryClumsy88 folded before Flop (didn't bet)
Seat 3: Eux1986 folded before Flop (didn't bet)
Seat 4: moratto1992 folded before Flop (didn't bet)
Seat 5: UnterMauern folded before Flop (didn't bet)
Seat 6: Dizzydarts (button) folded before Flop (didn't bet)
Seat 7: ivan limeira (small blind) folded before Flop
Seat 8: diabo656 (big blind) folded before Flop

PokerStars Hand #251205887405: Tournament #3767885527, $40+$10+$5 USD Hold'em No Limit - Level XIII (800/1600) - 2024/06/26 19:24:24 UTC [2024/06/26 15:24:24 ET]
Table '3767885527 96' 8-max Seat #7 is the button
Seat 1: MKL1010 (23529 in chips) 
Seat 2: DontCryClumsy88 (60780 in chips) 
Seat 3: Eux1986 (103349 in chips) 
Seat 4: moratto1992 (31315 in chips) 
Seat 5: UnterMauern (20275 in chips) 
Seat 6: Dizzydarts (26111 in chips) 
Seat 7: ivan limeira (58802 in chips) 
Seat 8: diabo656 (79525 in chips) 
MKL1010: posts the ante 200
DontCryClumsy88: posts the ante 200
Eux1986: posts the ante 200
moratto1992: posts the ante 200
UnterMauern: posts the ante 200
Dizzydarts: posts the ante 200
ivan limeira: posts the ante 200
diabo656: posts the ante 200
diabo656: posts small blind 800
MKL1010: posts big blind 1600
*** HOLE CARDS ***
DontCryClumsy88: folds 
Eux1986: raises 1600 to 3200
moratto1992: raises 4160 to 7360
UnterMauern: folds 
Dizzydarts: folds 
ivan limeira: folds 
diabo656 is connected 
diabo656 is connected 
diabo656: folds 
MKL1010: folds 
Eux1986: raises 95789 to 103149 and is all-in
moratto1992: folds 
Uncalled bet (95789) returned to Eux1986
Eux1986 collected 18720 from pot
Eux1986: doesn't show hand 
*** SUMMARY ***
Total pot 18720 | Rake 0 
Seat 1: MKL1010 (big blind) folded before Flop
Seat 2: DontCryClumsy88 folded before Flop (didn't bet)
Seat 3: Eux1986 collected (18720)
Seat 4: moratto1992 folded before Flop
Seat 5: UnterMauern folded before Flop (didn't bet)
Seat 6: Dizzydarts folded before Flop (didn't bet)
Seat 7: ivan limeira (button) folded before Flop (didn't bet)
Seat 8: diabo656 (small blind) folded before Flop

PokerStars Hand #251205907060: Tournament #3767885527, $40+$10+$5 USD Hold'em No Limit - Level XIII (800/1600) - 2024/06/26 19:25:35 UTC [2024/06/26 15:25:35 ET]
Table '3767885527 96' 8-max Seat #8 is the button
Seat 1: MKL1010 (21729 in chips) 
Seat 2: DontCryClumsy88 (60580 in chips) 
Seat 3: Eux1986 (114509 in chips) 
Seat 4: moratto1992 (23755 in chips) 
Seat 5: UnterMauern (20075 in chips) 
Seat 6: Dizzydarts (25911 in chips) 
Seat 7: ivan limeira (58602 in chips) 
Seat 8: diabo656 (78525 in chips) 
MKL1010: posts the ante 200
DontCryClumsy88: posts the ante 200
Eux1986: posts the ante 200
moratto1992: posts the ante 200
UnterMauern: posts the ante 200
Dizzydarts: posts the ante 200
ivan limeira: posts the ante 200
diabo656: posts the ante 200
MKL1010: posts small blind 800
DontCryClumsy88: posts big blind 1600
*** HOLE CARDS ***
Eux1986: folds 
moratto1992: raises 1600 to 3200
UnterMauern: folds 
Dizzydarts: folds 
ivan limeira: folds 
diabo656: folds 
MKL1010: folds 
DontCryClumsy88: folds 
Uncalled bet (1600) returned to moratto1992
moratto1992 collected 5600 from pot
moratto1992: doesn't show hand 
*** SUMMARY ***
Total pot 5600 | Rake 0 
Seat 1: MKL1010 (small blind) folded before Flop
Seat 2: DontCryClumsy88 (big blind) folded before Flop
Seat 3: Eux1986 folded before Flop (didn't bet)
Seat 4: moratto1992 collected (5600)
Seat 5: UnterMauern folded before Flop (didn't bet)
Seat 6: Dizzydarts folded before Flop (didn't bet)
Seat 7: ivan limeira folded before Flop (didn't bet)
Seat 8: diabo656 (button) folded before Flop (didn't bet)

PokerStars Hand #251205914078: Tournament #3767885527, $40+$10+$5 USD Hold'em No Limit - Level XIII (800/1600) - 2024/06/26 19:26:01 UTC [2024/06/26 15:26:01 ET]
Table '3767885527 96' 8-max Seat #1 is the button
Seat 1: MKL1010 (20729 in chips) 
Seat 2: DontCryClumsy88 (58780 in chips) 
Seat 3: Eux1986 (114309 in chips) 
Seat 4: moratto1992 (27555 in chips) 
Seat 5: UnterMauern (19875 in chips) 
Seat 6: Dizzydarts (25711 in chips) 
Seat 7: ivan limeira (58402 in chips) 
Seat 8: diabo656 (78325 in chips) 
MKL1010: posts the ante 200
DontCryClumsy88: posts the ante 200
Eux1986: posts the ante 200
moratto1992: posts the ante 200
UnterMauern: posts the ante 200
Dizzydarts: posts the ante 200
ivan limeira: posts the ante 200
diabo656: posts the ante 200
DontCryClumsy88: posts small blind 800
Eux1986: posts big blind 1600
*** HOLE CARDS ***
moratto1992: folds 
UnterMauern: raises 18075 to 19675 and is all-in
Dizzydarts: folds 
ivan limeira: folds 
diabo656: calls 19675
MKL1010: folds 
DontCryClumsy88: folds 
Eux1986: folds 
*** FLOP *** [6s 5c 3s]
*** TURN *** [6s 5c 3s] [Jh]
*** RIVER *** [6s 5c 3s Jh] [Th]
*** SHOW DOWN ***
UnterMauern: shows [6d Ah] (a pair of Sixes)
diabo656: shows [8s 8c] (a pair of Eights)
diabo656 collected 43350 from pot
UnterMauern finished the tournament
*** SUMMARY ***
Total pot 43350 | Rake 0 
Board [6s 5c 3s Jh Th]
Seat 1: MKL1010 (button) folded before Flop (didn't bet)
Seat 2: DontCryClumsy88 (small blind) folded before Flop
Seat 3: Eux1986 (big blind) folded before Flop
Seat 4: moratto1992 folded before Flop (didn't bet)
Seat 5: UnterMauern showed [6d Ah] and lost with a pair of Sixes
Seat 6: Dizzydarts folded before Flop (didn't bet)
Seat 7: ivan limeira folded before Flop (didn't bet)
Seat 8: diabo656 showed [8s 8c] and won (43350) with a pair of Eights

PokerStars Hand #251205922433: Tournament #3767885527, $40+$10+$5 USD Hold'em No Limit - Level XIII (800/1600) - 2024/06/26 19:26:31 UTC [2024/06/26 15:26:31 ET]
Table '3767885527 96' 8-max Seat #2 is the button
Seat 1: MKL1010 (20529 in chips) 
Seat 2: DontCryClumsy88 (57780 in chips) 
Seat 3: Eux1986 (112509 in chips) 
Seat 4: moratto1992 (27355 in chips) 
Seat 6: Dizzydarts (25511 in chips) 
Seat 7: ivan limeira (58202 in chips) 
Seat 8: diabo656 (101800 in chips) 
MKL1010: posts the ante 200
DontCryClumsy88: posts the ante 200
Eux1986: posts the ante 200
moratto1992: posts the ante 200
Dizzydarts: posts the ante 200
ivan limeira: posts the ante 200
diabo656: posts the ante 200
Eux1986: posts small blind 800
moratto1992: posts big blind 1600
*** HOLE CARDS ***
Dizzydarts: folds 
ivan limeira: folds 
diabo656: folds 
MKL1010: folds 
DontCryClumsy88: folds 
Eux1986: calls 800
moratto1992: checks 
*** FLOP *** [3c Jh 6c]
Eux1986: checks 
moratto1992: checks 
*** TURN *** [3c Jh 6c] [Qd]
Ace-hai is disconnected 
Eux1986: checks 
moratto1992: bets 1600
Eux1986: folds 
Uncalled bet (1600) returned to moratto1992
moratto1992 collected 4600 from pot
moratto1992: doesn't show hand 
*** SUMMARY ***
Total pot 4600 | Rake 0 
Board [3c Jh 6c Qd]
Seat 1: MKL1010 folded before Flop (didn't bet)
Seat 2: DontCryClumsy88 (button) folded before Flop (didn't bet)
Seat 3: Eux1986 (small blind) folded on the Turn
Seat 4: moratto1992 (big blind) collected (4600)
Seat 6: Dizzydarts folded before Flop (didn't bet)
Seat 7: ivan limeira folded before Flop (didn't bet)
Seat 8: diabo656 folded before Flop (didn't bet)

PokerStars Hand #251205940461: Tournament #3767885527, $40+$10+$5 USD Hold'em No Limit - Level XIII (800/1600) - 2024/06/26 19:27:38 UTC [2024/06/26 15:27:38 ET]
Table '3767885527 96' 8-max Seat #3 is the button
Seat 1: MKL1010 (20329 in chips) 
Seat 2: DontCryClumsy88 (57580 in chips) 
Seat 3: Eux1986 (110709 in chips) 
Seat 4: moratto1992 (30155 in chips) 
Seat 5: Ace-hai (25000 in chips) 
Seat 6: Dizzydarts (25311 in chips) 
Seat 7: ivan limeira (58002 in chips) 
Seat 8: diabo656 (101600 in chips) 
MKL1010: posts the ante 200
DontCryClumsy88: posts the ante 200
Eux1986: posts the ante 200
moratto1992: posts the ante 200
Ace-hai: posts the ante 200
Dizzydarts: posts the ante 200
ivan limeira: posts the ante 200
diabo656: posts the ante 200
moratto1992: posts small blind 800
Ace-hai: posts big blind 1600
*** HOLE CARDS ***
Dizzydarts: folds 
ivan limeira: folds 
diabo656: folds 
MKL1010: raises 18529 to 20129 and is all-in
DontCryClumsy88: folds 
Eux1986: raises 18529 to 38658
moratto1992: folds 
Ace-hai: calls 23200 and is all-in
Uncalled bet (13858) returned to Eux1986
*** FLOP *** [5c 9s 3d]
*** TURN *** [5c 9s 3d] [6s]
*** RIVER *** [5c 9s 3d 6s] [Js]
*** SHOW DOWN ***
Ace-hai: shows [Td Ts] (a pair of Tens)
Eux1986: shows [Kh Jh] (a pair of Jacks)
Eux1986 collected 9342 from side pot
MKL1010: shows [As 3s] (a flush, Ace high)
MKL1010 collected 62787 from main pot
Ace-hai finished the tournament
*** SUMMARY ***
Total pot 72129 Main pot 62787. Side pot 9342. | Rake 0 
Board [5c 9s 3d 6s Js]
Seat 1: MKL1010 showed [As 3s] and won (62787) with a flush, Ace high
Seat 2: DontCryClumsy88 folded before Flop (didn't bet)
Seat 3: Eux1986 (button) showed [Kh Jh] and won (9342) with a pair of Jacks
Seat 4: moratto1992 (small blind) folded before Flop
Seat 5: Ace-hai (big blind) showed [Td Ts] and lost with a pair of Tens
Seat 6: Dizzydarts folded before Flop (didn't bet)
Seat 7: ivan limeira folded before Flop (didn't bet)
Seat 8: diabo656 folded before Flop (didn't bet)

PokerStars Hand #251205952611: Tournament #3767885527, $40+$10+$5 USD Hold'em No Limit - Level XIII (800/1600) - 2024/06/26 19:28:24 UTC [2024/06/26 15:28:24 ET]
Table '3767885527 96' 8-max Seat #4 is the button
Seat 1: MKL1010 (62787 in chips) 
Seat 2: DontCryClumsy88 (57380 in chips) 
Seat 3: Eux1986 (95051 in chips) 
Seat 4: moratto1992 (29155 in chips) 
Seat 6: Dizzydarts (25111 in chips) 
Seat 7: ivan limeira (57802 in chips) 
Seat 8: diabo656 (101400 in chips) 
MKL1010: posts the ante 200
DontCryClumsy88: posts the ante 200
Eux1986: posts the ante 200
moratto1992: posts the ante 200
Dizzydarts: posts the ante 200
ivan limeira: posts the ante 200
diabo656: posts the ante 200
Dizzydarts: posts small blind 800
ivan limeira: posts big blind 1600
*** HOLE CARDS ***
diabo656: calls 1600
MKL1010: folds 
DontCryClumsy88: calls 1600
Eux1986: folds 
moratto1992: folds 
Dizzydarts: calls 800
ivan limeira: raises 56002 to 57602 and is all-in
diabo656: folds 
DontCryClumsy88: folds 
Dizzydarts: folds 
Uncalled bet (56002) returned to ivan limeira
ivan limeira collected 7800 from pot
ivan limeira: doesn't show hand 
*** SUMMARY ***
Total pot 7800 | Rake 0 
Seat 1: MKL1010 folded before Flop (didn't bet)
Seat 2: DontCryClumsy88 folded before Flop
Seat 3: Eux1986 folded before Flop (didn't bet)
Seat 4: moratto1992 (button) folded before Flop (didn't bet)
Seat 6: Dizzydarts (small blind) folded before Flop
Seat 7: ivan limeira (big blind) collected (7800)
Seat 8: diabo656 folded before Flop

PokerStars Hand #251205962072: Tournament #3767885527, $40+$10+$5 USD Hold'em No Limit - Level XIII (800/1600) - 2024/06/26 19:28:59 UTC [2024/06/26 15:28:59 ET]
Table '3767885527 96' 8-max Seat #6 is the button
Seat 1: MKL1010 (62587 in chips) 
Seat 2: DontCryClumsy88 (55580 in chips) 
Seat 3: Eux1986 (94851 in chips) 
Seat 4: moratto1992 (28955 in chips) 
Seat 6: Dizzydarts (23311 in chips) 
Seat 7: ivan limeira (63802 in chips) 
Seat 8: diabo656 (99600 in chips) 
MKL1010: posts the ante 200
DontCryClumsy88: posts the ante 200
Eux1986: posts the ante 200
moratto1992: posts the ante 200
Dizzydarts: posts the ante 200
ivan limeira: posts the ante 200
diabo656: posts the ante 200
ivan limeira: posts small blind 800
diabo656: posts big blind 1600
*** HOLE CARDS ***
MKL1010: folds 
DontCryClumsy88: calls 1600
Eux1986: folds 
moratto1992: folds 
Dizzydarts: folds 
ivan limeira: calls 800
diabo656: checks 
*** FLOP *** [Jh 3d Qd]
ivan limeira: checks 
cardinals970 is disconnected 
diabo656: checks 
DontCryClumsy88: bets 2046
ivan limeira: folds 
diabo656: folds 
Uncalled bet (2046) returned to DontCryClumsy88
DontCryClumsy88 collected 6200 from pot
*** SUMMARY ***
Total pot 6200 | Rake 0 
Board [Jh 3d Qd]
Seat 1: MKL1010 folded before Flop (didn't bet)
Seat 2: DontCryClumsy88 collected (6200)
Seat 3: Eux1986 folded before Flop (didn't bet)
Seat 4: moratto1992 folded before Flop (didn't bet)
Seat 6: Dizzydarts (button) folded before Flop (didn't bet)
Seat 7: ivan limeira (small blind) folded on the Flop
Seat 8: diabo656 (big blind) folded on the Flop

PokerStars Hand #251205977881: Tournament #3767885527, $40+$10+$5 USD Hold'em No Limit - Level XIV (1000/2000) - 2024/06/26 19:29:57 UTC [2024/06/26 15:29:57 ET]
Table '3767885527 96' 8-max Seat #7 is the button
Seat 1: MKL1010 (62387 in chips) 
Seat 2: DontCryClumsy88 (59980 in chips) 
Seat 3: Eux1986 (94651 in chips) 
Seat 4: moratto1992 (28755 in chips) 
Seat 5: cardinals970 (25000 in chips) 
Seat 6: Dizzydarts (23111 in chips) 
Seat 7: ivan limeira (62002 in chips) 
Seat 8: diabo656 (97800 in chips) 
MKL1010: posts the ante 250
DontCryClumsy88: posts the ante 250
Eux1986: posts the ante 250
moratto1992: posts the ante 250
cardinals970: posts the ante 250
Dizzydarts: posts the ante 250
ivan limeira: posts the ante 250
diabo656: posts the ante 250
diabo656: posts small blind 1000
MKL1010: posts big blind 2000
*** HOLE CARDS ***
DontCryClumsy88: folds 
Eux1986: folds 
moratto1992: folds 
cardinals970: folds 
Dizzydarts: folds 
ivan limeira: raises 2000 to 4000
diabo656: folds 
MKL1010: calls 2000
*** FLOP *** [8d Kh 7c]
MKL1010: checks 
ivan limeira: bets 2750
MKL1010: calls 2750
*** TURN *** [8d Kh 7c] [3h]
MKL1010: checks 
ivan limeira: checks 
*** RIVER *** [8d Kh 7c 3h] [8h]
MKL1010: bets 8250
ivan limeira: calls 8250
*** SHOW DOWN ***
MKL1010: shows [Kc Qh] (two pair, Kings and Eights)
ivan limeira: mucks hand 
MKL1010 collected 33000 from pot
*** SUMMARY ***
Total pot 33000 | Rake 0 
Board [8d Kh 7c 3h 8h]
Seat 1: MKL1010 (big blind) showed [Kc Qh] and won (33000) with two pair, Kings and Eights
Seat 2: DontCryClumsy88 folded before Flop (didn't bet)
Seat 3: Eux1986 folded before Flop (didn't bet)
Seat 4: moratto1992 folded before Flop (didn't bet)
Seat 5: cardinals970 folded before Flop (didn't bet)
Seat 6: Dizzydarts folded before Flop (didn't bet)
Seat 7: ivan limeira (button) mucked
Seat 8: diabo656 (small blind) folded before Flop

PokerStars Hand #251205994012: Tournament #3767885527, $40+$10+$5 USD Hold'em No Limit - Level XIV (1000/2000) - 2024/06/26 19:30:56 UTC [2024/06/26 15:30:56 ET]
Table '3767885527 96' 8-max Seat #8 is the button
Seat 1: MKL1010 (80137 in chips) 
Seat 2: DontCryClumsy88 (59730 in chips) 
Seat 3: Eux1986 (94401 in chips) 
Seat 4: moratto1992 (28505 in chips) 
Seat 5: cardinals970 (24750 in chips) 
Seat 6: Dizzydarts (22861 in chips) 
Seat 7: ivan limeira (46752 in chips) 
Seat 8: diabo656 (96550 in chips) 
MKL1010: posts the ante 250
DontCryClumsy88: posts the ante 250
Eux1986: posts the ante 250
moratto1992: posts the ante 250
cardinals970: posts the ante 250
Dizzydarts: posts the ante 250
ivan limeira: posts the ante 250
diabo656: posts the ante 250
MKL1010: posts small blind 1000
DontCryClumsy88: posts big blind 2000
*** HOLE CARDS ***
Eux1986: folds 
moratto1992: folds 
cardinals970: folds 
Dizzydarts: folds 
ivan limeira: raises 2000 to 4000
diabo656: calls 4000
MKL1010: folds 
DontCryClumsy88: calls 2000
*** FLOP *** [4d 3s Ac]
DontCryClumsy88: checks 
ivan limeira: bets 3750
diabo656: raises 3750 to 7500
DontCryClumsy88: folds 
ivan limeira: calls 3750
*** TURN *** [4d 3s Ac] [3h]
ivan limeira: checks 
diabo656: bets 84800 and is all-in
ivan limeira: folds 
Uncalled bet (84800) returned to diabo656
diabo656 collected 30000 from pot
*** SUMMARY ***
Total pot 30000 | Rake 0 
Board [4d 3s Ac 3h]
Seat 1: MKL1010 (small blind) folded before Flop
Seat 2: DontCryClumsy88 (big blind) folded on the Flop
Seat 3: Eux1986 folded before Flop (didn't bet)
Seat 4: moratto1992 folded before Flop (didn't bet)
Seat 5: cardinals970 folded before Flop (didn't bet)
Seat 6: Dizzydarts folded before Flop (didn't bet)
Seat 7: ivan limeira folded on the Turn
Seat 8: diabo656 (button) collected (30000)

PokerStars Hand #251206012118: Tournament #3767885527, $40+$10+$5 USD Hold'em No Limit - Level XIV (1000/2000) - 2024/06/26 19:32:01 UTC [2024/06/26 15:32:01 ET]
Table '3767885527 96' 8-max Seat #1 is the button
Seat 1: MKL1010 (78887 in chips) 
Seat 2: DontCryClumsy88 (55480 in chips) 
Seat 3: Eux1986 (94151 in chips) 
Seat 4: moratto1992 (28255 in chips) 
Seat 5: cardinals970 (24500 in chips) 
Seat 6: Dizzydarts (22611 in chips) 
Seat 7: ivan limeira (35002 in chips) 
Seat 8: diabo656 (114800 in chips) 
MKL1010: posts the ante 250
DontCryClumsy88: posts the ante 250
Eux1986: posts the ante 250
moratto1992: posts the ante 250
cardinals970: posts the ante 250
Dizzydarts: posts the ante 250
ivan limeira: posts the ante 250
diabo656: posts the ante 250
DontCryClumsy88: posts small blind 1000
Eux1986: posts big blind 2000
*** HOLE CARDS ***
moratto1992: folds 
cardinals970: folds 
Dizzydarts: folds 
ivan limeira: raises 2000 to 4000
diabo656: folds 
MKL1010: folds 
DontCryClumsy88: folds 
Eux1986: folds 
Uncalled bet (2000) returned to ivan limeira
ivan limeira collected 7000 from pot
ivan limeira: doesn't show hand 
*** SUMMARY ***
Total pot 7000 | Rake 0 
Seat 1: MKL1010 (button) folded before Flop (didn't bet)
Seat 2: DontCryClumsy88 (small blind) folded before Flop
Seat 3: Eux1986 (big blind) folded before Flop
Seat 4: moratto1992 folded before Flop (didn't bet)
Seat 5: cardinals970 folded before Flop (didn't bet)
Seat 6: Dizzydarts folded before Flop (didn't bet)
Seat 7: ivan limeira collected (7000)
Seat 8: diabo656 folded before Flop (didn't bet)

PokerStars Hand #251206023652: Tournament #3767885527, $40+$10+$5 USD Hold'em No Limit - Level XIV (1000/2000) - 2024/06/26 19:32:43 UTC [2024/06/26 15:32:43 ET]
Table '3767885527 96' 8-max Seat #2 is the button
Seat 1: MKL1010 (78637 in chips) 
Seat 2: DontCryClumsy88 (54230 in chips) 
Seat 3: Eux1986 (91901 in chips) 
Seat 4: moratto1992 (28005 in chips) 
Seat 5: cardinals970 (24250 in chips) 
Seat 6: Dizzydarts (22361 in chips) 
Seat 7: ivan limeira (39752 in chips) 
Seat 8: diabo656 (114550 in chips) 
MKL1010: posts the ante 250
DontCryClumsy88: posts the ante 250
Eux1986: posts the ante 250
moratto1992: posts the ante 250
cardinals970: posts the ante 250
Dizzydarts: posts the ante 250
ivan limeira: posts the ante 250
diabo656: posts the ante 250
Eux1986: posts small blind 1000
moratto1992: posts big blind 2000
*** HOLE CARDS ***
cardinals970: folds 
Dizzydarts: folds 
ivan limeira: raises 2000 to 4000
diabo656: folds 
MKL1010: folds 
DontCryClumsy88: folds 
Eux1986: calls 3000
moratto1992: folds 
*** FLOP *** [7s 4d Qd]
Eux1986: checks 
ivan limeira: bets 3000
Eux1986: calls 3000
*** TURN *** [7s 4d Qd] [3h]
Eux1986: checks 
ivan limeira: bets 9000
Eux1986: folds 
Uncalled bet (9000) returned to ivan limeira
ivan limeira collected 18000 from pot
ivan limeira: doesn't show hand 
*** SUMMARY ***
Total pot 18000 | Rake 0 
Board [7s 4d Qd 3h]
Seat 1: MKL1010 folded before Flop (didn't bet)
Seat 2: DontCryClumsy88 (button) folded before Flop (didn't bet)
Seat 3: Eux1986 (small blind) folded on the Turn
Seat 4: moratto1992 (big blind) folded before Flop
Seat 5: cardinals970 folded before Flop (didn't bet)
Seat 6: Dizzydarts folded before Flop (didn't bet)
Seat 7: ivan limeira collected (18000)
Seat 8: diabo656 folded before Flop (didn't bet)

PokerStars Hand #251206039056: Tournament #3767885527, $40+$10+$5 USD Hold'em No Limit - Level XIV (1000/2000) - 2024/06/26 19:33:40 UTC [2024/06/26 15:33:40 ET]
Table '3767885527 96' 8-max Seat #3 is the button
Seat 1: MKL1010 (78387 in chips) 
Seat 2: DontCryClumsy88 (53980 in chips) 
Seat 3: Eux1986 (84651 in chips) 
Seat 4: moratto1992 (25755 in chips) 
Seat 5: cardinals970 (24000 in chips) 
Seat 6: Dizzydarts (22111 in chips) 
Seat 7: ivan limeira (50502 in chips) 
Seat 8: diabo656 (114300 in chips) 
MKL1010: posts the ante 250
DontCryClumsy88: posts the ante 250
Eux1986: posts the ante 250
moratto1992: posts the ante 250
cardinals970: posts the ante 250
Dizzydarts: posts the ante 250
ivan limeira: posts the ante 250
diabo656: posts the ante 250
moratto1992: posts small blind 1000
cardinals970: posts big blind 2000
*** HOLE CARDS ***
Dizzydarts: folds 
ivan limeira: raises 2000 to 4000
diabo656: calls 4000
MKL1010: folds 
DontCryClumsy88: calls 4000
Eux1986: raises 6000 to 10000
moratto1992: folds 
cardinals970: folds 
ivan limeira: folds 
diabo656: calls 6000
DontCryClumsy88: calls 6000
*** FLOP *** [8s 7c Ks]
diabo656: checks 
DontCryClumsy88: checks 
Eux1986: bets 26000
diabo656: folds 
DontCryClumsy88: raises 17730 to 43730 and is all-in
Eux1986: calls 17730
*** TURN *** [8s 7c Ks] [6d]
*** RIVER *** [8s 7c Ks 6d] [3c]
*** SHOW DOWN ***
DontCryClumsy88: shows [7d 7s] (three of a kind, Sevens)
Eux1986: shows [As Ad] (a pair of Aces)
DontCryClumsy88 collected 126460 from pot
*** SUMMARY ***
Total pot 126460 | Rake 0 
Board [8s 7c Ks 6d 3c]
Seat 1: MKL1010 folded before Flop (didn't bet)
Seat 2: DontCryClumsy88 showed [7d 7s] and won (126460) with three of a kind, Sevens
Seat 3: Eux1986 (button) showed [As Ad] and lost with a pair of Aces
Seat 4: moratto1992 (small blind) folded before Flop
Seat 5: cardinals970 (big blind) folded before Flop
Seat 6: Dizzydarts folded before Flop (didn't bet)
Seat 7: ivan limeira folded before Flop
Seat 8: diabo656 folded on the Flop

PokerStars Hand #251206056776: Tournament #3767885527, $40+$10+$5 USD Hold'em No Limit - Level XIV (1000/2000) - 2024/06/26 19:34:45 UTC [2024/06/26 15:34:45 ET]
Table '3767885527 96' 8-max Seat #4 is the button
Seat 1: MKL1010 (78137 in chips) 
Seat 2: DontCryClumsy88 (126460 in chips) 
Seat 3: Eux1986 (30671 in chips) 
Seat 4: moratto1992 (24505 in chips) 
Seat 5: cardinals970 (21750 in chips) 
Seat 6: Dizzydarts (21861 in chips) 
Seat 7: ivan limeira (46252 in chips) 
Seat 8: diabo656 (104050 in chips) 
MKL1010: posts the ante 250
DontCryClumsy88: posts the ante 250
Eux1986: posts the ante 250
moratto1992: posts the ante 250
cardinals970: posts the ante 250
Dizzydarts: posts the ante 250
ivan limeira: posts the ante 250
diabo656: posts the ante 250
cardinals970: posts small blind 1000
Dizzydarts: posts big blind 2000
*** HOLE CARDS ***
ivan limeira: folds 
diabo656: folds 
MKL1010: folds 
DontCryClumsy88: raises 2000 to 4000
Eux1986: folds 
moratto1992: raises 20255 to 24255 and is all-in
cardinals970: folds 
Dizzydarts: folds 
DontCryClumsy88: calls 20255
*** FLOP *** [Js 4h Kc]
*** TURN *** [Js 4h Kc] [7s]
*** RIVER *** [Js 4h Kc 7s] [Jc]
*** SHOW DOWN ***
DontCryClumsy88: shows [Ks Ac] (two pair, Kings and Jacks)
moratto1992: shows [8h Kh] (two pair, Kings and Jacks - lower kicker)
DontCryClumsy88 collected 53510 from pot
moratto1992 finished the tournament
*** SUMMARY ***
Total pot 53510 | Rake 0 
Board [Js 4h Kc 7s Jc]
Seat 1: MKL1010 folded before Flop (didn't bet)
Seat 2: DontCryClumsy88 showed [Ks Ac] and won (53510) with two pair, Kings and Jacks
Seat 3: Eux1986 folded before Flop (didn't bet)
Seat 4: moratto1992 (button) showed [8h Kh] and lost with two pair, Kings and Jacks
Seat 5: cardinals970 (small blind) folded before Flop
Seat 6: Dizzydarts (big blind) folded before Flop
Seat 7: ivan limeira folded before Flop (didn't bet)
Seat 8: diabo656 folded before Flop (didn't bet)

PokerStars Hand #251206064993: Tournament #3767885527, $40+$10+$5 USD Hold'em No Limit - Level XIV (1000/2000) - 2024/06/26 19:35:15 UTC [2024/06/26 15:35:15 ET]
Table '3767885527 96' 8-max Seat #5 is the button
Seat 1: MKL1010 (77887 in chips) 
Seat 2: DontCryClumsy88 (155465 in chips) 
Seat 3: Eux1986 (30421 in chips) 
Seat 5: cardinals970 (20500 in chips) 
Seat 6: Dizzydarts (19611 in chips) 
Seat 7: ivan limeira (46002 in chips) 
Seat 8: diabo656 (103800 in chips) 
MKL1010: posts the ante 250
DontCryClumsy88: posts the ante 250
Eux1986: posts the ante 250
cardinals970: posts the ante 250
Dizzydarts: posts the ante 250
ivan limeira: posts the ante 250
diabo656: posts the ante 250
Dizzydarts: posts small blind 1000
ivan limeira: posts big blind 2000
*** HOLE CARDS ***
diabo656: folds 
MKL1010: folds 
DontCryClumsy88: folds 
Eux1986: folds 
cardinals970: raises 18250 to 20250 and is all-in
Dizzydarts: calls 18361 and is all-in
ivan limeira: folds 
Uncalled bet (889) returned to cardinals970
*** FLOP *** [5c 2s 5d]
*** TURN *** [5c 2s 5d] [4c]
*** RIVER *** [5c 2s 5d 4c] [4h]
*** SHOW DOWN ***
Dizzydarts: shows [6d 6s] (two pair, Sixes and Fives)
cardinals970: shows [Kc Kh] (two pair, Kings and Fives)
cardinals970 collected 42472 from pot
Dizzydarts finished the tournament
*** SUMMARY ***
Total pot 42472 | Rake 0 
Board [5c 2s 5d 4c 4h]
Seat 1: MKL1010 folded before Flop (didn't bet)
Seat 2: DontCryClumsy88 folded before Flop (didn't bet)
Seat 3: Eux1986 folded before Flop (didn't bet)
Seat 5: cardinals970 (button) showed [Kc Kh] and won (42472) with two pair, Kings and Fives
Seat 6: Dizzydarts (small blind) showed [6d 6s] and lost with two pair, Sixes and Fives
Seat 7: ivan limeira (big blind) folded before Flop
Seat 8: diabo656 folded before Flop (didn't bet)

PokerStars Hand #251206077467: Tournament #3767885527, $40+$10+$5 USD Hold'em No Limit - Level XIV (1000/2000) - 2024/06/26 19:36:00 UTC [2024/06/26 15:36:00 ET]
Table '3767885527 96' 8-max Seat #7 is the button
Seat 1: MKL1010 (77637 in chips) 
Seat 2: DontCryClumsy88 (155215 in chips) 
Seat 3: Eux1986 (30171 in chips) 
Seat 4: Bigprad (89372 in chips) 
Seat 5: cardinals970 (43361 in chips) 
Seat 7: ivan limeira (43752 in chips) 
Seat 8: diabo656 (103550 in chips) 
MKL1010: posts the ante 250
DontCryClumsy88: posts the ante 250
Eux1986: posts the ante 250
Bigprad: posts the ante 250
cardinals970: posts the ante 250
ivan limeira: posts the ante 250
diabo656: posts the ante 250
diabo656: posts small blind 1000
MKL1010: posts big blind 2000
*** HOLE CARDS ***
DontCryClumsy88: raises 2000 to 4000
Eux1986: folds 
Bigprad: folds 
cardinals970: folds 
ivan limeira: raises 6000 to 10000
diabo656: calls 9000
MKL1010: folds 
DontCryClumsy88: folds 
*** FLOP *** [9s 6s 5d]
diabo656: checks 
ivan limeira: bets 9158
diabo656: calls 9158
*** TURN *** [9s 6s 5d] [6c]
Dueces4Days is disconnected 
diabo656: checks 
ivan limeira: checks 
*** RIVER *** [9s 6s 5d 6c] [Ad]
diabo656: checks 
ivan limeira: checks 
*** SHOW DOWN ***
diabo656: shows [Qd As] (two pair, Aces and Sixes)
ivan limeira: mucks hand 
diabo656 collected 46066 from pot
*** SUMMARY ***
Total pot 46066 | Rake 0 
Board [9s 6s 5d 6c Ad]
Seat 1: MKL1010 (big blind) folded before Flop
Seat 2: DontCryClumsy88 folded before Flop
Seat 3: Eux1986 folded before Flop (didn't bet)
Seat 4: Bigprad folded before Flop (didn't bet)
Seat 5: cardinals970 folded before Flop (didn't bet)
Seat 7: ivan limeira (button) mucked
Seat 8: diabo656 (small blind) showed [Qd As] and won (46066) with two pair, Aces and Sixes

PokerStars Hand #251206096899: Tournament #3767885527, $40+$10+$5 USD Hold'em No Limit - Level XIV (1000/2000) - 2024/06/26 19:37:11 UTC [2024/06/26 15:37:11 ET]
Table '3767885527 96' 8-max Seat #8 is the button
Seat 1: MKL1010 (75387 in chips) 
Seat 2: DontCryClumsy88 (150965 in chips) 
Seat 3: Eux1986 (29921 in chips) 
Seat 4: Bigprad (89122 in chips) 
Seat 5: cardinals970 (43111 in chips) 
Seat 6: Dueces4Days (141708 in chips) 
Seat 7: ivan limeira (24344 in chips) 
Seat 8: diabo656 (130208 in chips) 
MKL1010: posts the ante 250
DontCryClumsy88: posts the ante 250
Eux1986: posts the ante 250
Bigprad: posts the ante 250
cardinals970: posts the ante 250
Dueces4Days: posts the ante 250
ivan limeira: posts the ante 250
diabo656: posts the ante 250
MKL1010: posts small blind 1000
DontCryClumsy88: posts big blind 2000
*** HOLE CARDS ***
Eux1986: folds 
Bigprad: folds 
cardinals970: folds 
Dueces4Days: folds 
ivan limeira: folds 
diabo656: raises 7000 to 9000
MKL1010: folds 
DontCryClumsy88: folds 
Uncalled bet (7000) returned to diabo656
diabo656 collected 7000 from pot
*** SUMMARY ***
Total pot 7000 | Rake 0 
Seat 1: MKL1010 (small blind) folded before Flop
Seat 2: DontCryClumsy88 (big blind) folded before Flop
Seat 3: Eux1986 folded before Flop (didn't bet)
Seat 4: Bigprad folded before Flop (didn't bet)
Seat 5: cardinals970 folded before Flop (didn't bet)
Seat 6: Dueces4Days folded before Flop (didn't bet)
Seat 7: ivan limeira folded before Flop (didn't bet)
Seat 8: diabo656 (button) collected (7000)

PokerStars Hand #251206104233: Tournament #3767885527, $40+$10+$5 USD Hold'em No Limit - Level XIV (1000/2000) - 2024/06/26 19:37:37 UTC [2024/06/26 15:37:37 ET]
Table '3767885527 96' 8-max Seat #1 is the button
Seat 1: MKL1010 (74137 in chips) 
Seat 2: DontCryClumsy88 (148715 in chips) 
Seat 3: Eux1986 (29671 in chips) 
Seat 4: Bigprad (88872 in chips) 
Seat 5: cardinals970 (42861 in chips) 
Seat 6: Dueces4Days (141458 in chips) 
Seat 7: ivan limeira (24094 in chips) 
Seat 8: diabo656 (134958 in chips) 
MKL1010: posts the ante 250
DontCryClumsy88: posts the ante 250
Eux1986: posts the ante 250
Bigprad: posts the ante 250
cardinals970: posts the ante 250
Dueces4Days: posts the ante 250
ivan limeira: posts the ante 250
diabo656: posts the ante 250
DontCryClumsy88: posts small blind 1000
Eux1986: posts big blind 2000
*** HOLE CARDS ***
Bigprad: folds 
cardinals970: folds 
Dueces4Days: raises 2000 to 4000
ivan limeira: folds 
diabo656: folds 
MKL1010: folds 
DontCryClumsy88: folds 
Eux1986: calls 2000
*** FLOP *** [5d Ad 7c]
Eux1986: checks 
Dueces4Days: bets 2750
Eux1986: folds 
Uncalled bet (2750) returned to Dueces4Days
Dueces4Days collected 11000 from pot
Dueces4Days: doesn't show hand 
*** SUMMARY ***
Total pot 11000 | Rake 0 
Board [5d Ad 7c]
Seat 1: MKL1010 (button) folded before Flop (didn't bet)
Seat 2: DontCryClumsy88 (small blind) folded before Flop
Seat 3: Eux1986 (big blind) folded on the Flop
Seat 4: Bigprad folded before Flop (didn't bet)
Seat 5: cardinals970 folded before Flop (didn't bet)
Seat 6: Dueces4Days collected (11000)
Seat 7: ivan limeira folded before Flop (didn't bet)
Seat 8: diabo656 folded before Flop (didn't bet)

PokerStars Hand #251206112187: Tournament #3767885527, $40+$10+$5 USD Hold'em No Limit - Level XIV (1000/2000) - 2024/06/26 19:38:07 UTC [2024/06/26 15:38:07 ET]
Table '3767885527 96' 8-max Seat #2 is the button
Seat 1: MKL1010 (73887 in chips) 
Seat 2: DontCryClumsy88 (147465 in chips) 
Seat 3: Eux1986 (25421 in chips) 
Seat 4: Bigprad (88622 in chips) 
Seat 5: cardinals970 (42611 in chips) 
Seat 6: Dueces4Days (148208 in chips) 
Seat 7: ivan limeira (23844 in chips) 
Seat 8: diabo656 (134708 in chips) 
MKL1010: posts the ante 250
DontCryClumsy88: posts the ante 250
Eux1986: posts the ante 250
Bigprad: posts the ante 250
cardinals970: posts the ante 250
Dueces4Days: posts the ante 250
ivan limeira: posts the ante 250
diabo656: posts the ante 250
Eux1986: posts small blind 1000
Bigprad: posts big blind 2000
*** HOLE CARDS ***
cardinals970: folds 
Dueces4Days: raises 2000 to 4000
ivan limeira: folds 
diabo656: folds 
MKL1010: folds 
DontCryClumsy88: folds 
Eux1986: folds 
Bigprad: folds 
Uncalled bet (2000) returned to Dueces4Days
Dueces4Days collected 7000 from pot
Dueces4Days: doesn't show hand 
*** SUMMARY ***
Total pot 7000 | Rake 0 
Seat 1: MKL1010 folded before Flop (didn't bet)
Seat 2: DontCryClumsy88 (button) folded before Flop (didn't bet)
Seat 3: Eux1986 (small blind) folded before Flop
Seat 4: Bigprad (big blind) folded before Flop
Seat 5: cardinals970 folded before Flop (didn't bet)
Seat 6: Dueces4Days collected (7000)
Seat 7: ivan limeira folded before Flop (didn't bet)
Seat 8: diabo656 folded before Flop (didn't bet)

PokerStars Hand #251206118379: Tournament #3767885527, $40+$10+$5 USD Hold'em No Limit - Level XIV (1000/2000) - 2024/06/26 19:38:30 UTC [2024/06/26 15:38:30 ET]
Table '3767885527 96' 8-max Seat #3 is the button
Seat 1: MKL1010 (73637 in chips) 
Seat 2: DontCryClumsy88 (147215 in chips) 
Seat 3: Eux1986 (24171 in chips) 
Seat 4: Bigprad (86372 in chips) 
Seat 5: cardinals970 (42361 in chips) 
Seat 6: Dueces4Days (152958 in chips) 
Seat 7: ivan limeira (23594 in chips) 
Seat 8: diabo656 (134458 in chips) 
MKL1010: posts the ante 250
DontCryClumsy88: posts the ante 250
Eux1986: posts the ante 250
Bigprad: posts the ante 250
cardinals970: posts the ante 250
Dueces4Days: posts the ante 250
ivan limeira: posts the ante 250
diabo656: posts the ante 250
Bigprad: posts small blind 1000
cardinals970: posts big blind 2000
*** HOLE CARDS ***
Dueces4Days: raises 2000 to 4000
ivan limeira: folds 
diabo656: folds 
MKL1010: calls 4000
DontCryClumsy88: calls 4000
Eux1986: folds 
Bigprad: calls 3000
cardinals970: folds 
*** FLOP *** [Th 9s 4h]
Bigprad: checks 
Dueces4Days: checks 
MKL1010: bets 6000
DontCryClumsy88: folds 
Bigprad: calls 6000
Dueces4Days: calls 6000
*** TURN *** [Th 9s 4h] [Jd]
Bigprad: checks 
Dueces4Days: checks 
MKL1010: bets 19000
Bigprad: calls 19000
Dueces4Days: raises 123708 to 142708 and is all-in
MKL1010: calls 44387 and is all-in
Bigprad: folds 
Uncalled bet (79321) returned to Dueces4Days
*** RIVER *** [Th 9s 4h Jd] [6d]
*** SHOW DOWN ***
Dueces4Days: shows [Kc Qs] (a straight, Nine to King)
MKL1010: shows [Td Tc] (three of a kind, Tens)
Dueces4Days collected 183774 from pot
MKL1010 finished the tournament in 610th place
*** SUMMARY ***
Total pot 183774 | Rake 0 
Board [Th 9s 4h Jd 6d]
Seat 1: MKL1010 showed [Td Tc] and lost with three of a kind, Tens
Seat 2: DontCryClumsy88 folded on the Flop
Seat 3: Eux1986 (button) folded before Flop (didn't bet)
Seat 4: Bigprad (small blind) folded on the Turn
Seat 5: cardinals970 (big blind) folded before Flop
Seat 6: Dueces4Days showed [Kc Qs] and won (183774) with a straight, Nine to King
Seat 7: ivan limeira folded before Flop (didn't bet)
Seat 8: diabo656 folded before Flop (didn't bet)

PokerStars Hand #251206139227: Tournament #3767885527, $40+$10+$5 USD Hold'em No Limit - Level XV (1250/2500) - 2024/06/26 19:39:46 UTC [2024/06/26 15:39:46 ET]
Table '3767885527 96' 8-max Seat #4 is the button
Seat 2: DontCryClumsy88 (142965 in chips) 
Seat 3: Eux1986 (23921 in chips) 
Seat 4: Bigprad (57122 in chips) 
Seat 5: cardinals970 (40111 in chips) 
Seat 6: Dueces4Days (263095 in chips) 
Seat 7: ivan limeira (23344 in chips) 
Seat 8: diabo656 (134208 in chips) 
DontCryClumsy88: posts the ante 325
Eux1986: posts the ante 325
Bigprad: posts the ante 325
cardinals970: posts the ante 325
Dueces4Days: posts the ante 325
ivan limeira: posts the ante 325
diabo656: posts the ante 325
cardinals970: posts small blind 1250
Dueces4Days: posts big blind 2500
*** HOLE CARDS ***
ivan limeira: raises 2500 to 5000
diabo656: calls 5000
DontCryClumsy88: folds 
Eux1986: folds 
Bigprad: folds 
cardinals970: folds 
Dueces4Days: calls 2500
*** FLOP *** [9s Js 2h]
Dueces4Days: checks 
ivan limeira: checks 
diabo656: bets 18525
Dueces4Days: raises 31025 to 49550
ivan limeira: folds 
diabo656: calls 31025
*** TURN *** [9s Js 2h] [Qd]
Dueces4Days: bets 176438
diabo656: calls 79333 and is all-in
Uncalled bet (97105) returned to Dueces4Days
*** RIVER *** [9s Js 2h Qd] [4d]
*** SHOW DOWN ***
Dueces4Days: shows [Ts 7s] (high card Queen)
diabo656: shows [Jc Qc] (two pair, Queens and Jacks)
diabo656 collected 276291 from pot
*** SUMMARY ***
Total pot 276291 | Rake 0 
Board [9s Js 2h Qd 4d]
Seat 2: DontCryClumsy88 folded before Flop (didn't bet)
Seat 3: Eux1986 folded before Flop (didn't bet)
Seat 4: Bigprad (button) folded before Flop (didn't bet)
Seat 5: cardinals970 (small blind) folded before Flop
Seat 6: Dueces4Days (big blind) showed [Ts 7s] and lost with high card Queen
Seat 7: ivan limeira folded on the Flop
Seat 8: diabo656 showed [Jc Qc] and won (276291) with two pair, Queens and Jacks

PokerStars Hand #251206164105: Tournament #3767885527, $40+$10+$5 USD Hold'em No Limit - Level XV (1250/2500) - 2024/06/26 19:41:16 UTC [2024/06/26 15:41:16 ET]
Table '3767885527 96' 8-max Seat #5 is the button
Seat 1: Scairone (30771 in chips) 
Seat 2: DontCryClumsy88 (142640 in chips) 
Seat 3: Eux1986 (23596 in chips) 
Seat 4: Bigprad (56797 in chips) 
Seat 5: cardinals970 (38536 in chips) 
Seat 6: Dueces4Days (128887 in chips) 
Seat 7: ivan limeira (18019 in chips) 
Seat 8: diabo656 (276291 in chips) 
Scairone: posts the ante 325
DontCryClumsy88: posts the ante 325
Eux1986: posts the ante 325
Bigprad: posts the ante 325
cardinals970: posts the ante 325
Dueces4Days: posts the ante 325
ivan limeira: posts the ante 325
diabo656: posts the ante 325
Dueces4Days: posts small blind 1250
ivan limeira: posts big blind 2500
*** HOLE CARDS ***
diabo656: folds 
Scairone: folds 
DontCryClumsy88: folds 
Eux1986: folds 
Bigprad: folds 
cardinals970: folds 
Dueces4Days: raises 126062 to 128562 and is all-in
ivan limeira: calls 15194 and is all-in
Uncalled bet (110868) returned to Dueces4Days
*** FLOP *** [7c 8c 4d]
*** TURN *** [7c 8c 4d] [7s]
*** RIVER *** [7c 8c 4d 7s] [7h]
*** SHOW DOWN ***
Dueces4Days: shows [8h 5d] (a full house, Sevens full of Eights)
ivan limeira: shows [As Tc] (three of a kind, Sevens)
Dueces4Days collected 37988 from pot
ivan limeira finished the tournament in 577th place
*** SUMMARY ***
Total pot 37988 | Rake 0 
Board [7c 8c 4d 7s 7h]
Seat 1: Scairone folded before Flop (didn't bet)
Seat 2: DontCryClumsy88 folded before Flop (didn't bet)
Seat 3: Eux1986 folded before Flop (didn't bet)
Seat 4: Bigprad folded before Flop (didn't bet)
Seat 5: cardinals970 (button) folded before Flop (didn't bet)
Seat 6: Dueces4Days (small blind) showed [8h 5d] and won (37988) with a full house, Sevens full of Eights
Seat 7: ivan limeira (big blind) showed [As Tc] and lost with three of a kind, Sevens
Seat 8: diabo656 folded before Flop (didn't bet)


PokerStars Hand #251205799339: Tournament #3767885527, $40+$10+$5 USD Hold'em No Limit - Level XII (700/1400) - 2024/06/26 19:19:02 UTC [2024/06/26 15:19:02 ET]
Table '3767885527 94' 8-max Seat #5 is the button
Seat 1: pazipro (66633 in chips) 
Seat 2: 010101777 (43448 in chips) 
Seat 3: Parrafelipe (15667 in chips) 
Seat 4: PIUlimeira (52085 in chips) 
Seat 5: Ale7anderr77 (71117 in chips) 
Seat 6: Hookz (24007 in chips) 
Seat 7: esdeathonlol (26575 in chips) 
Seat 8: Thrumbo (76020 in chips) 
pazipro: posts the ante 175
010101777: posts the ante 175
Parrafelipe: posts the ante 175
PIUlimeira: posts the ante 175
Ale7anderr77: posts the ante 175
Hookz: posts the ante 175
esdeathonlol: posts the ante 175
Thrumbo: posts the ante 175
Hookz: posts small blind 700
esdeathonlol: posts big blind 1400
*** HOLE CARDS ***
Thrumbo: raises 1540 to 2940
pazipro: folds 
010101777: calls 2940
Parrafelipe: folds 
PIUlimeira: folds 
Ale7anderr77: raises 7840 to 10780
Hookz: folds 
esdeathonlol: folds 
Thrumbo: folds 
010101777: raises 32493 to 43273 and is all-in
Ale7anderr77: calls 32493
*** FLOP *** [6c Ts Tc]
*** TURN *** [6c Ts Tc] [Qs]
*** RIVER *** [6c Ts Tc Qs] [Jc]
*** SHOW DOWN ***
010101777: shows [9h 9s] (two pair, Tens and Nines)
Ale7anderr77: shows [Qd Kh] (two pair, Queens and Tens)
Ale7anderr77 collected 92986 from pot
010101777 finished the tournament
*** SUMMARY ***
Total pot 92986 | Rake 0 
Board [6c Ts Tc Qs Jc]
Seat 1: pazipro folded before Flop (didn't bet)
Seat 2: 010101777 showed [9h 9s] and lost with two pair, Tens and Nines
Seat 3: Parrafelipe folded before Flop (didn't bet)
Seat 4: PIUlimeira folded before Flop (didn't bet)
Seat 5: Ale7anderr77 (button) showed [Qd Kh] and won (92986) with two pair, Queens and Tens
Seat 6: Hookz (small blind) folded before Flop
Seat 7: esdeathonlol (big blind) folded before Flop
Seat 8: Thrumbo folded before Flop

PokerStars Hand #251205823612: Tournament #3767885527, $40+$10+$5 USD Hold'em No Limit - Level XIII (800/1600) - 2024/06/26 19:20:30 UTC [2024/06/26 15:20:30 ET]
Table '3767885527 94' 8-max Seat #6 is the button
Seat 1: pazipro (66458 in chips) 
Seat 3: Parrafelipe (15492 in chips) 
Seat 4: PIUlimeira (51910 in chips) 
Seat 5: Ale7anderr77 (120655 in chips) 
Seat 6: Hookz (23132 in chips) 
Seat 7: esdeathonlol (25000 in chips) 
Seat 8: Thrumbo (72905 in chips) 
pazipro: posts the ante 200
Parrafelipe: posts the ante 200
PIUlimeira: posts the ante 200
Ale7anderr77: posts the ante 200
Hookz: posts the ante 200
esdeathonlol: posts the ante 200
Thrumbo: posts the ante 200
esdeathonlol: posts small blind 800
Thrumbo: posts big blind 1600
*** HOLE CARDS ***
pazipro: folds 
Parrafelipe: folds 
PIUlimeira: folds 
Ale7anderr77: raises 1600 to 3200
Hookz: folds 
esdeathonlol: folds 
saupra506 is disconnected 
Thrumbo: calls 1600
*** FLOP *** [Ts Tc 4s]
Thrumbo: checks 
Ale7anderr77: bets 2924
Thrumbo: raises 4334 to 7258
Ale7anderr77: calls 4334
*** TURN *** [Ts Tc 4s] [Kh]
Thrumbo: bets 10402
Ale7anderr77: calls 10402
*** RIVER *** [Ts Tc 4s Kh] [7s]
Thrumbo: bets 13176
Ale7anderr77: raises 22292 to 35468
Thrumbo: raises 16377 to 51845 and is all-in
Ale7anderr77: calls 16377
*** SHOW DOWN ***
Thrumbo: shows [Kd Td] (a full house, Tens full of Kings)
Ale7anderr77: shows [Ks 5s] (a flush, King high)
Thrumbo collected 147610 from pot
*** SUMMARY ***
Total pot 147610 | Rake 0 
Board [Ts Tc 4s Kh 7s]
Seat 1: pazipro folded before Flop (didn't bet)
Seat 3: Parrafelipe folded before Flop (didn't bet)
Seat 4: PIUlimeira folded before Flop (didn't bet)
Seat 5: Ale7anderr77 showed [Ks 5s] and lost with a flush, King high
Seat 6: Hookz (button) folded before Flop (didn't bet)
Seat 7: esdeathonlol (small blind) folded before Flop
Seat 8: Thrumbo (big blind) showed [Kd Td] and won (147610) with a full house, Tens full of Kings

PokerStars Hand #251205857723: Tournament #3767885527, $40+$10+$5 USD Hold'em No Limit - Level XIII (800/1600) - 2024/06/26 19:22:36 UTC [2024/06/26 15:22:36 ET]
Table '3767885527 94' 8-max Seat #7 is the button
Seat 1: pazipro (66258 in chips) 
Seat 2: saupra506 (25000 in chips) 
Seat 3: Parrafelipe (15292 in chips) 
Seat 4: PIUlimeira (51710 in chips) 
Seat 5: Ale7anderr77 (47750 in chips) 
Seat 6: Hookz (22932 in chips) 
Seat 7: esdeathonlol (24000 in chips) 
Seat 8: Thrumbo (147610 in chips) 
pazipro: posts the ante 200
saupra506: posts the ante 200
Parrafelipe: posts the ante 200
PIUlimeira: posts the ante 200
Ale7anderr77: posts the ante 200
Hookz: posts the ante 200
esdeathonlol: posts the ante 200
Thrumbo: posts the ante 200
Thrumbo: posts small blind 800
pazipro: posts big blind 1600
*** HOLE CARDS ***
saupra506: folds 
Parrafelipe: folds 
PIUlimeira: raises 1600 to 3200
Ale7anderr77: calls 3200
Hookz: folds 
esdeathonlol: folds 
Thrumbo: folds 
pazipro: folds 
*** FLOP *** [8c 7d Th]
PIUlimeira: checks 
Ale7anderr77: checks 
*** TURN *** [8c 7d Th] [5d]
PIUlimeira: bets 5920
Ale7anderr77: calls 5920
*** RIVER *** [8c 7d Th 5d] [Jc]
PIUlimeira: checks 
Ale7anderr77: bets 17125
PIUlimeira: folds 
Uncalled bet (17125) returned to Ale7anderr77
Ale7anderr77 collected 22240 from pot
*** SUMMARY ***
Total pot 22240 | Rake 0 
Board [8c 7d Th 5d Jc]
Seat 1: pazipro (big blind) folded before Flop
Seat 2: saupra506 folded before Flop (didn't bet)
Seat 3: Parrafelipe folded before Flop (didn't bet)
Seat 4: PIUlimeira folded on the River
Seat 5: Ale7anderr77 collected (22240)
Seat 6: Hookz folded before Flop (didn't bet)
Seat 7: esdeathonlol (button) folded before Flop (didn't bet)
Seat 8: Thrumbo (small blind) folded before Flop

PokerStars Hand #251205890730: Tournament #3767885527, $40+$10+$5 USD Hold'em No Limit - Level XIII (800/1600) - 2024/06/26 19:24:36 UTC [2024/06/26 15:24:36 ET]
Table '3767885527 94' 8-max Seat #8 is the button
Seat 1: pazipro (64458 in chips) 
Seat 2: saupra506 (24800 in chips) 
Seat 3: Parrafelipe (15092 in chips) 
Seat 4: PIUlimeira (42390 in chips) 
Seat 5: Ale7anderr77 (60670 in chips) 
Seat 6: Hookz (22732 in chips) 
Seat 7: esdeathonlol (23800 in chips) 
Seat 8: Thrumbo (146610 in chips) 
pazipro: posts the ante 200
saupra506: posts the ante 200
Parrafelipe: posts the ante 200
PIUlimeira: posts the ante 200
Ale7anderr77: posts the ante 200
Hookz: posts the ante 200
esdeathonlol: posts the ante 200
Thrumbo: posts the ante 200
pazipro: posts small blind 800
saupra506: posts big blind 1600
*** HOLE CARDS ***
Parrafelipe: folds 
PIUlimeira: folds 
Ale7anderr77: folds 
Hookz: folds 
esdeathonlol: raises 1600 to 3200
Thrumbo: folds 
pazipro: folds 
saupra506: calls 1600
*** FLOP *** [Js 2c 6s]
saupra506: checks 
esdeathonlol: bets 6400
saupra506: folds [Td]
Uncalled bet (6400) returned to esdeathonlol
esdeathonlol collected 8800 from pot
*** SUMMARY ***
Total pot 8800 | Rake 0 
Board [Js 2c 6s]
Seat 1: pazipro (small blind) folded before Flop
Seat 2: saupra506 (big blind) folded on the Flop
Seat 3: Parrafelipe folded before Flop (didn't bet)
Seat 4: PIUlimeira folded before Flop (didn't bet)
Seat 5: Ale7anderr77 folded before Flop (didn't bet)
Seat 6: Hookz folded before Flop (didn't bet)
Seat 7: esdeathonlol collected (8800)
Seat 8: Thrumbo (button) folded before Flop (didn't bet)

PokerStars Hand #251205906340: Tournament #3767885527, $40+$10+$5 USD Hold'em No Limit - Level XIII (800/1600) - 2024/06/26 19:25:33 UTC [2024/06/26 15:25:33 ET]
Table '3767885527 94' 8-max Seat #1 is the button
Seat 1: pazipro (63458 in chips) 
Seat 2: saupra506 (21400 in chips) 
Seat 3: Parrafelipe (14892 in chips) 
Seat 4: PIUlimeira (42190 in chips) 
Seat 5: Ale7anderr77 (60470 in chips) 
Seat 6: Hookz (22532 in chips) 
Seat 7: esdeathonlol (29200 in chips) 
Seat 8: Thrumbo (146410 in chips) 
pazipro: posts the ante 200
saupra506: posts the ante 200
Parrafelipe: posts the ante 200
PIUlimeira: posts the ante 200
Ale7anderr77: posts the ante 200
Hookz: posts the ante 200
esdeathonlol: posts the ante 200
Thrumbo: posts the ante 200
saupra506: posts small blind 800
Parrafelipe: posts big blind 1600
*** HOLE CARDS ***
PIUlimeira: raises 1600 to 3200
Ale7anderr77: folds 
Hookz: folds 
esdeathonlol: folds 
Thrumbo: folds 
pazipro: raises 4800 to 8000
saupra506: folds 
Parrafelipe: folds 
PIUlimeira: folds 
Uncalled bet (4800) returned to pazipro
pazipro collected 10400 from pot
pazipro: doesn't show hand 
*** SUMMARY ***
Total pot 10400 | Rake 0 
Seat 1: pazipro (button) collected (10400)
Seat 2: saupra506 (small blind) folded before Flop
Seat 3: Parrafelipe (big blind) folded before Flop
Seat 4: PIUlimeira folded before Flop
Seat 5: Ale7anderr77 folded before Flop (didn't bet)
Seat 6: Hookz folded before Flop (didn't bet)
Seat 7: esdeathonlol folded before Flop (didn't bet)
Seat 8: Thrumbo folded before Flop (didn't bet)

PokerStars Hand #251205918304: Tournament #3767885527, $40+$10+$5 USD Hold'em No Limit - Level XIII (800/1600) - 2024/06/26 19:26:16 UTC [2024/06/26 15:26:16 ET]
Table '3767885527 94' 8-max Seat #2 is the button
Seat 1: pazipro (70458 in chips) 
Seat 2: saupra506 (20400 in chips) 
Seat 3: Parrafelipe (13092 in chips) 
Seat 4: PIUlimeira (38790 in chips) 
Seat 5: Ale7anderr77 (60270 in chips) 
Seat 6: Hookz (22332 in chips) 
Seat 7: esdeathonlol (29000 in chips) 
Seat 8: Thrumbo (146210 in chips) 
pazipro: posts the ante 200
saupra506: posts the ante 200
Parrafelipe: posts the ante 200
PIUlimeira: posts the ante 200
Ale7anderr77: posts the ante 200
Hookz: posts the ante 200
esdeathonlol: posts the ante 200
Thrumbo: posts the ante 200
Parrafelipe: posts small blind 800
PIUlimeira: posts big blind 1600
*** HOLE CARDS ***
Ale7anderr77: raises 1600 to 3200
Hookz: raises 18932 to 22132 and is all-in
esdeathonlol: folds 
Thrumbo: folds 
pazipro: folds 
saupra506: folds 
Parrafelipe: folds 
PIUlimeira: folds 
Ale7anderr77: folds 
Uncalled bet (18932) returned to Hookz
Hookz collected 10400 from pot
Hookz: doesn't show hand 
*** SUMMARY ***
Total pot 10400 | Rake 0 
Seat 1: pazipro folded before Flop (didn't bet)
Seat 2: saupra506 (button) folded before Flop (didn't bet)
Seat 3: Parrafelipe (small blind) folded before Flop
Seat 4: PIUlimeira (big blind) folded before Flop
Seat 5: Ale7anderr77 folded before Flop
Seat 6: Hookz collected (10400)
Seat 7: esdeathonlol folded before Flop (didn't bet)
Seat 8: Thrumbo folded before Flop (didn't bet)

PokerStars Hand #251205932095: Tournament #3767885527, $40+$10+$5 USD Hold'em No Limit - Level XIII (800/1600) - 2024/06/26 19:27:07 UTC [2024/06/26 15:27:07 ET]
Table '3767885527 94' 8-max Seat #3 is the button
Seat 1: pazipro (70258 in chips) 
Seat 2: saupra506 (20200 in chips) 
Seat 3: Parrafelipe (12092 in chips) 
Seat 4: PIUlimeira (36990 in chips) 
Seat 5: Ale7anderr77 (56870 in chips) 
Seat 6: Hookz (29332 in chips) 
Seat 7: esdeathonlol (28800 in chips) 
Seat 8: Thrumbo (146010 in chips) 
pazipro: posts the ante 200
saupra506: posts the ante 200
Parrafelipe: posts the ante 200
PIUlimeira: posts the ante 200
Ale7anderr77: posts the ante 200
Hookz: posts the ante 200
esdeathonlol: posts the ante 200
Thrumbo: posts the ante 200
PIUlimeira: posts small blind 800
Ale7anderr77: posts big blind 1600
*** HOLE CARDS ***
Hookz: folds 
esdeathonlol: folds 
Thrumbo: folds 
pazipro: raises 1600 to 3200
saupra506: folds 
Parrafelipe: folds 
PIUlimeira: folds 
Ale7anderr77: calls 1600
*** FLOP *** [5s 3h 2d]
Ale7anderr77: checks 
pazipro: bets 2640
Ale7anderr77: raises 6387 to 9027
pazipro: folds 
Uncalled bet (6387) returned to Ale7anderr77
Ale7anderr77 collected 14080 from pot
*** SUMMARY ***
Total pot 14080 | Rake 0 
Board [5s 3h 2d]
Seat 1: pazipro folded on the Flop
Seat 2: saupra506 folded before Flop (didn't bet)
Seat 3: Parrafelipe (button) folded before Flop (didn't bet)
Seat 4: PIUlimeira (small blind) folded before Flop
Seat 5: Ale7anderr77 (big blind) collected (14080)
Seat 6: Hookz folded before Flop (didn't bet)
Seat 7: esdeathonlol folded before Flop (didn't bet)
Seat 8: Thrumbo folded before Flop (didn't bet)

PokerStars Hand #251205947468: Tournament #3767885527, $40+$10+$5 USD Hold'em No Limit - Level XIII (800/1600) - 2024/06/26 19:28:04 UTC [2024/06/26 15:28:04 ET]
Table '3767885527 94' 8-max Seat #4 is the button
Seat 1: pazipro (64218 in chips) 
Seat 2: saupra506 (20000 in chips) 
Seat 3: Parrafelipe (11892 in chips) 
Seat 4: PIUlimeira (35990 in chips) 
Seat 5: Ale7anderr77 (64910 in chips) 
Seat 6: Hookz (29132 in chips) 
Seat 7: esdeathonlol (28600 in chips) 
Seat 8: Thrumbo (145810 in chips) 
pazipro: posts the ante 200
saupra506: posts the ante 200
Parrafelipe: posts the ante 200
PIUlimeira: posts the ante 200
Ale7anderr77: posts the ante 200
Hookz: posts the ante 200
esdeathonlol: posts the ante 200
Thrumbo: posts the ante 200
Ale7anderr77: posts small blind 800
Hookz: posts big blind 1600
*** HOLE CARDS ***
esdeathonlol: folds 
Thrumbo: folds 
pazipro: folds 
saupra506: raises 1920 to 3520
Parrafelipe: folds 
PIUlimeira: folds 
Ale7anderr77: folds 
Hookz: folds 
Uncalled bet (1920) returned to saupra506
saupra506 collected 5600 from pot
*** SUMMARY ***
Total pot 5600 | Rake 0 
Seat 1: pazipro folded before Flop (didn't bet)
Seat 2: saupra506 collected (5600)
Seat 3: Parrafelipe folded before Flop (didn't bet)
Seat 4: PIUlimeira (button) folded before Flop (didn't bet)
Seat 5: Ale7anderr77 (small blind) folded before Flop
Seat 6: Hookz (big blind) folded before Flop
Seat 7: esdeathonlol folded before Flop (didn't bet)
Seat 8: Thrumbo folded before Flop (didn't bet)

PokerStars Hand #251205954400: Tournament #3767885527, $40+$10+$5 USD Hold'em No Limit - Level XIII (800/1600) - 2024/06/26 19:28:30 UTC [2024/06/26 15:28:30 ET]
Table '3767885527 94' 8-max Seat #5 is the button
Seat 1: pazipro (64018 in chips) 
Seat 2: saupra506 (23800 in chips) 
Seat 3: Parrafelipe (11692 in chips) 
Seat 4: PIUlimeira (35790 in chips) 
Seat 5: Ale7anderr77 (63910 in chips) 
Seat 6: Hookz (27332 in chips) 
Seat 7: esdeathonlol (28400 in chips) 
Seat 8: Thrumbo (145610 in chips) 
pazipro: posts the ante 200
saupra506: posts the ante 200
Parrafelipe: posts the ante 200
PIUlimeira: posts the ante 200
Ale7anderr77: posts the ante 200
Hookz: posts the ante 200
esdeathonlol: posts the ante 200
Thrumbo: posts the ante 200
Hookz: posts small blind 800
esdeathonlol: posts big blind 1600
*** HOLE CARDS ***
Thrumbo: folds 
pazipro: folds 
saupra506: folds 
Parrafelipe: folds 
PIUlimeira: folds 
Ale7anderr77: raises 1600 to 3200
Hookz: raises 23932 to 27132 and is all-in
esdeathonlol: folds 
Ale7anderr77: folds 
Uncalled bet (23932) returned to Hookz
Hookz collected 9600 from pot
Hookz: doesn't show hand 
*** SUMMARY ***
Total pot 9600 | Rake 0 
Seat 1: pazipro folded before Flop (didn't bet)
Seat 2: saupra506 folded before Flop (didn't bet)
Seat 3: Parrafelipe folded before Flop (didn't bet)
Seat 4: PIUlimeira folded before Flop (didn't bet)
Seat 5: Ale7anderr77 (button) folded before Flop
Seat 6: Hookz (small blind) collected (9600)
Seat 7: esdeathonlol (big blind) folded before Flop
Seat 8: Thrumbo folded before Flop (didn't bet)

PokerStars Hand #251205970421: Tournament #3767885527, $40+$10+$5 USD Hold'em No Limit - Level XIV (1000/2000) - 2024/06/26 19:29:30 UTC [2024/06/26 15:29:30 ET]
Table '3767885527 94' 8-max Seat #6 is the button
Seat 1: pazipro (63818 in chips) 
Seat 2: saupra506 (23600 in chips) 
Seat 3: Parrafelipe (11492 in chips) 
Seat 4: PIUlimeira (35590 in chips) 
Seat 5: Ale7anderr77 (60510 in chips) 
Seat 6: Hookz (33532 in chips) 
Seat 7: esdeathonlol (26600 in chips) 
Seat 8: Thrumbo (145410 in chips) 
pazipro: posts the ante 250
saupra506: posts the ante 250
Parrafelipe: posts the ante 250
PIUlimeira: posts the ante 250
Ale7anderr77: posts the ante 250
Hookz: posts the ante 250
esdeathonlol: posts the ante 250
Thrumbo: posts the ante 250
esdeathonlol: posts small blind 1000
Thrumbo: posts big blind 2000
*** HOLE CARDS ***
pazipro: raises 2000 to 4000
saupra506: folds 
Parrafelipe: folds 
PIUlimeira: folds 
Ale7anderr77: folds 
Hookz: folds 
esdeathonlol: folds 
Thrumbo: calls 2000
*** FLOP *** [5h 4s 9h]
Thrumbo: checks 
pazipro: checks 
*** TURN *** [5h 4s 9h] [Kh]
Thrumbo: checks 
pazipro: checks 
*** RIVER *** [5h 4s 9h Kh] [Ah]
Thrumbo: checks 
pazipro: checks 
*** SHOW DOWN ***
Thrumbo: shows [7c 5c] (a pair of Fives)
pazipro: shows [Qs Ad] (a pair of Aces)
pazipro collected 11000 from pot
*** SUMMARY ***
Total pot 11000 | Rake 0 
Board [5h 4s 9h Kh Ah]
Seat 1: pazipro showed [Qs Ad] and won (11000) with a pair of Aces
Seat 2: saupra506 folded before Flop (didn't bet)
Seat 3: Parrafelipe folded before Flop (didn't bet)
Seat 4: PIUlimeira folded before Flop (didn't bet)
Seat 5: Ale7anderr77 folded before Flop (didn't bet)
Seat 6: Hookz (button) folded before Flop (didn't bet)
Seat 7: esdeathonlol (small blind) folded before Flop
Seat 8: Thrumbo (big blind) showed [7c 5c] and lost with a pair of Fives

PokerStars Hand #251205987450: Tournament #3767885527, $40+$10+$5 USD Hold'em No Limit - Level XIV (1000/2000) - 2024/06/26 19:30:32 UTC [2024/06/26 15:30:32 ET]
Table '3767885527 94' 8-max Seat #7 is the button
Seat 1: pazipro (70568 in chips) 
Seat 2: saupra506 (23350 in chips) 
Seat 3: Parrafelipe (11242 in chips) 
Seat 4: PIUlimeira (35340 in chips) 
Seat 5: Ale7anderr77 (60260 in chips) 
Seat 6: Hookz (33282 in chips) 
Seat 7: esdeathonlol (25350 in chips) 
Seat 8: Thrumbo (141160 in chips) 
pazipro: posts the ante 250
saupra506: posts the ante 250
Parrafelipe: posts the ante 250
PIUlimeira: posts the ante 250
Ale7anderr77: posts the ante 250
Hookz: posts the ante 250
esdeathonlol: posts the ante 250
Thrumbo: posts the ante 250
Thrumbo: posts small blind 1000
pazipro: posts big blind 2000
*** HOLE CARDS ***
saupra506: folds 
Parrafelipe: folds 
PIUlimeira: folds 
Ale7anderr77: folds 
Hookz: folds 
esdeathonlol: raises 2000 to 4000
Thrumbo: folds 
pazipro: calls 2000
*** FLOP *** [Jc Qh 3d]
pazipro: checks 
esdeathonlol: bets 6000
pazipro: raises 23000 to 29000
esdeathonlol: folds 
Uncalled bet (23000) returned to pazipro
pazipro collected 23000 from pot
pazipro: doesn't show hand 
*** SUMMARY ***
Total pot 23000 | Rake 0 
Board [Jc Qh 3d]
Seat 1: pazipro (big blind) collected (23000)
Seat 2: saupra506 folded before Flop (didn't bet)
Seat 3: Parrafelipe folded before Flop (didn't bet)
Seat 4: PIUlimeira folded before Flop (didn't bet)
Seat 5: Ale7anderr77 folded before Flop (didn't bet)
Seat 6: Hookz folded before Flop (didn't bet)
Seat 7: esdeathonlol (button) folded on the Flop
Seat 8: Thrumbo (small blind) folded before Flop

PokerStars Hand #251206000911: Tournament #3767885527, $40+$10+$5 USD Hold'em No Limit - Level XIV (1000/2000) - 2024/06/26 19:31:21 UTC [2024/06/26 15:31:21 ET]
Table '3767885527 94' 8-max Seat #8 is the button
Seat 1: pazipro (83318 in chips) 
Seat 2: saupra506 (23100 in chips) 
Seat 3: Parrafelipe (10992 in chips) 
Seat 4: PIUlimeira (35090 in chips) 
Seat 5: Ale7anderr77 (60010 in chips) 
Seat 6: Hookz (33032 in chips) 
Seat 7: esdeathonlol (15100 in chips) 
Seat 8: Thrumbo (139910 in chips) 
pazipro: posts the ante 250
saupra506: posts the ante 250
Parrafelipe: posts the ante 250
PIUlimeira: posts the ante 250
Ale7anderr77: posts the ante 250
Hookz: posts the ante 250
esdeathonlol: posts the ante 250
Thrumbo: posts the ante 250
pazipro: posts small blind 1000
saupra506: posts big blind 2000
*** HOLE CARDS ***
Parrafelipe: folds 
PIUlimeira: folds 
Ale7anderr77: folds 
Hookz: folds 
esdeathonlol: folds 
Thrumbo: folds 
pazipro: raises 81068 to 83068 and is all-in
saupra506: folds 
Uncalled bet (81068) returned to pazipro
pazipro collected 6000 from pot
pazipro: doesn't show hand 
*** SUMMARY ***
Total pot 6000 | Rake 0 
Seat 1: pazipro (small blind) collected (6000)
Seat 2: saupra506 (big blind) folded before Flop
Seat 3: Parrafelipe folded before Flop (didn't bet)
Seat 4: PIUlimeira folded before Flop (didn't bet)
Seat 5: Ale7anderr77 folded before Flop (didn't bet)
Seat 6: Hookz folded before Flop (didn't bet)
Seat 7: esdeathonlol folded before Flop (didn't bet)
Seat 8: Thrumbo (button) folded before Flop (didn't bet)

PokerStars Hand #251206008118: Tournament #3767885527, $40+$10+$5 USD Hold'em No Limit - Level XIV (1000/2000) - 2024/06/26 19:31:47 UTC [2024/06/26 15:31:47 ET]
Table '3767885527 94' 8-max Seat #1 is the button
Seat 1: pazipro (87068 in chips) 
Seat 2: saupra506 (20850 in chips) 
Seat 3: Parrafelipe (10742 in chips) 
Seat 4: PIUlimeira (34840 in chips) 
Seat 5: Ale7anderr77 (59760 in chips) 
Seat 6: Hookz (32782 in chips) 
Seat 7: esdeathonlol (14850 in chips) 
Seat 8: Thrumbo (139660 in chips) 
pazipro: posts the ante 250
saupra506: posts the ante 250
Parrafelipe: posts the ante 250
PIUlimeira: posts the ante 250
Ale7anderr77: posts the ante 250
Hookz: posts the ante 250
esdeathonlol: posts the ante 250
Thrumbo: posts the ante 250
saupra506: posts small blind 1000
Parrafelipe: posts big blind 2000
*** HOLE CARDS ***
PIUlimeira: raises 2000 to 4000
Ale7anderr77: folds 
Hookz: folds 
esdeathonlol: folds 
Thrumbo: folds 
pazipro: folds 
saupra506: folds 
Parrafelipe: raises 6492 to 10492 and is all-in
PIUlimeira: calls 6492
*** FLOP *** [5d 8s 5s]
*** TURN *** [5d 8s 5s] [2h]
*** RIVER *** [5d 8s 5s 2h] [Kc]
*** SHOW DOWN ***
Parrafelipe: shows [Ks Qc] (two pair, Kings and Fives)
PIUlimeira: shows [Ad 6d] (a pair of Fives)
Parrafelipe collected 23984 from pot
*** SUMMARY ***
Total pot 23984 | Rake 0 
Board [5d 8s 5s 2h Kc]
Seat 1: pazipro (button) folded before Flop (didn't bet)
Seat 2: saupra506 (small blind) folded before Flop
Seat 3: Parrafelipe (big blind) showed [Ks Qc] and won (23984) with two pair, Kings and Fives
Seat 4: PIUlimeira showed [Ad 6d] and lost with a pair of Fives
Seat 5: Ale7anderr77 folded before Flop (didn't bet)
Seat 6: Hookz folded before Flop (didn't bet)
Seat 7: esdeathonlol folded before Flop (didn't bet)
Seat 8: Thrumbo folded before Flop (didn't bet)

PokerStars Hand #251206017394: Tournament #3767885527, $40+$10+$5 USD Hold'em No Limit - Level XIV (1000/2000) - 2024/06/26 19:32:20 UTC [2024/06/26 15:32:20 ET]
Table '3767885527 94' 8-max Seat #2 is the button
Seat 1: pazipro (86818 in chips) 
Seat 2: saupra506 (19600 in chips) 
Seat 3: Parrafelipe (23984 in chips) 
Seat 4: PIUlimeira (24098 in chips) 
Seat 5: Ale7anderr77 (59510 in chips) 
Seat 6: Hookz (32532 in chips) 
Seat 7: esdeathonlol (14600 in chips) 
Seat 8: Thrumbo (139410 in chips) 
pazipro: posts the ante 250
saupra506: posts the ante 250
Parrafelipe: posts the ante 250
PIUlimeira: posts the ante 250
Ale7anderr77: posts the ante 250
Hookz: posts the ante 250
esdeathonlol: posts the ante 250
Thrumbo: posts the ante 250
Parrafelipe: posts small blind 1000
PIUlimeira: posts big blind 2000
*** HOLE CARDS ***
Ale7anderr77: folds 
Hookz: folds 
esdeathonlol: folds 
Thrumbo: folds 
pazipro: raises 2000 to 4000
saupra506: folds 
Parrafelipe: folds 
PIUlimeira: calls 2000
*** FLOP *** [4s Ah 5h]
PIUlimeira: checks 
pazipro: bets 3300
PIUlimeira: calls 3300
*** TURN *** [4s Ah 5h] [9h]
PIUlimeira: checks 
pazipro: bets 5280
PIUlimeira: raises 11268 to 16548 and is all-in
pazipro: calls 11268
*** RIVER *** [4s Ah 5h 9h] [Th]
*** SHOW DOWN ***
PIUlimeira: shows [As Ac] (three of a kind, Aces)
pazipro: shows [Kh Kd] (a flush, Ace high)
pazipro collected 50696 from pot
PIUlimeira finished the tournament
*** SUMMARY ***
Total pot 50696 | Rake 0 
Board [4s Ah 5h 9h Th]
Seat 1: pazipro showed [Kh Kd] and won (50696) with a flush, Ace high
Seat 2: saupra506 (button) folded before Flop (didn't bet)
Seat 3: Parrafelipe (small blind) folded before Flop
Seat 4: PIUlimeira (big blind) showed [As Ac] and lost with three of a kind, Aces
Seat 5: Ale7anderr77 folded before Flop (didn't bet)
Seat 6: Hookz folded before Flop (didn't bet)
Seat 7: esdeathonlol folded before Flop (didn't bet)
Seat 8: Thrumbo folded before Flop (didn't bet)


PokerStars Hand #251206793997: Tournament #3767885527, $40+$10+$5 USD Hold'em No Limit - Level XVIII (2000/4000) - 2024/06/26 20:20:06 UTC [2024/06/26 16:20:06 ET]
Table '3767885527 93' 8-max Seat #7 is the button
Seat 1: lucaromanoo1 (161854 in chips) 
Seat 2: mobky (72000 in chips) 
Seat 3: supervaganj (155290 in chips) 
Seat 4: Vamoclan (70599 in chips) 
Seat 5: pj0901 (232619 in chips) 
Seat 6: Proosty2 (70728 in chips) 
Seat 7: gibbo888 (234866 in chips) 
Seat 8: DR. ELDAR (101766 in chips) 
lucaromanoo1: posts the ante 500
mobky: posts the ante 500
supervaganj: posts the ante 500
Vamoclan: posts the ante 500
pj0901: posts the ante 500
Proosty2: posts the ante 500
gibbo888: posts the ante 500
DR. ELDAR: posts the ante 500
DR. ELDAR: posts small blind 2000
lucaromanoo1: posts big blind 4000
*** HOLE CARDS ***
mobky: calls 4000
supervaganj: folds 
Vamoclan: folds 
pj0901: folds 
Proosty2: folds 
gibbo888: folds 
DR. ELDAR: folds 
lucaromanoo1: checks 
*** FLOP *** [4h Kd 3s]
lucaromanoo1: checks 
mobky: bets 4000
lucaromanoo1: calls 4000
*** TURN *** [4h Kd 3s] [8d]
lucaromanoo1: checks 
mobky: bets 11000
lucaromanoo1: calls 11000
*** RIVER *** [4h Kd 3s 8d] [5s]
lucaromanoo1: checks 
mobky: checks 
*** SHOW DOWN ***
lucaromanoo1: shows [Ks 7h] (a pair of Kings)
mobky: mucks hand 
lucaromanoo1 collected 44000 from pot
*** SUMMARY ***
Total pot 44000 | Rake 0 
Board [4h Kd 3s 8d 5s]
Seat 1: lucaromanoo1 (big blind) showed [Ks 7h] and won (44000) with a pair of Kings
Seat 2: mobky mucked
Seat 3: supervaganj folded before Flop (didn't bet)
Seat 4: Vamoclan folded before Flop (didn't bet)
Seat 5: pj0901 folded before Flop (didn't bet)
Seat 6: Proosty2 folded before Flop (didn't bet)
Seat 7: gibbo888 (button) folded before Flop (didn't bet)
Seat 8: DR. ELDAR (small blind) folded before Flop

PokerStars Hand #251206807867: Tournament #3767885527, $40+$10+$5 USD Hold'em No Limit - Level XVIII (2000/4000) - 2024/06/26 20:20:55 UTC [2024/06/26 16:20:55 ET]
Table '3767885527 93' 8-max Seat #8 is the button
Seat 1: lucaromanoo1 (186354 in chips) 
Seat 2: mobky (52500 in chips) 
Seat 3: supervaganj (154790 in chips) 
Seat 4: Vamoclan (70099 in chips) 
Seat 5: pj0901 (232119 in chips) 
Seat 6: Proosty2 (70228 in chips) 
Seat 7: gibbo888 (234366 in chips) 
Seat 8: DR. ELDAR (99266 in chips) 
lucaromanoo1: posts the ante 500
mobky: posts the ante 500
supervaganj: posts the ante 500
Vamoclan: posts the ante 500
pj0901: posts the ante 500
Proosty2: posts the ante 500
gibbo888: posts the ante 500
DR. ELDAR: posts the ante 500
lucaromanoo1: posts small blind 2000
mobky: posts big blind 4000
*** HOLE CARDS ***
supervaganj: folds 
Vamoclan: folds 
pj0901: folds 
Proosty2: folds 
gibbo888: folds 
DR. ELDAR: folds 
lucaromanoo1: raises 181854 to 185854 and is all-in
mobky: folds 
Uncalled bet (181854) returned to lucaromanoo1
lucaromanoo1 collected 12000 from pot
lucaromanoo1: doesn't show hand 
*** SUMMARY ***
Total pot 12000 | Rake 0 
Seat 1: lucaromanoo1 (small blind) collected (12000)
Seat 2: mobky (big blind) folded before Flop
Seat 3: supervaganj folded before Flop (didn't bet)
Seat 4: Vamoclan folded before Flop (didn't bet)
Seat 5: pj0901 folded before Flop (didn't bet)
Seat 6: Proosty2 folded before Flop (didn't bet)
Seat 7: gibbo888 folded before Flop (didn't bet)
Seat 8: DR. ELDAR (button) folded before Flop (didn't bet)

PokerStars Hand #251206820274: Tournament #3767885527, $40+$10+$5 USD Hold'em No Limit - Level XVIII (2000/4000) - 2024/06/26 20:21:39 UTC [2024/06/26 16:21:39 ET]
Table '3767885527 93' 8-max Seat #1 is the button
Seat 1: lucaromanoo1 (193854 in chips) 
Seat 2: mobky (48000 in chips) 
Seat 3: supervaganj (154290 in chips) 
Seat 4: Vamoclan (69599 in chips) 
Seat 5: pj0901 (231619 in chips) 
Seat 6: Proosty2 (69728 in chips) 
Seat 7: gibbo888 (233866 in chips) 
Seat 8: DR. ELDAR (98766 in chips) 
lucaromanoo1: posts the ante 500
mobky: posts the ante 500
supervaganj: posts the ante 500
Vamoclan: posts the ante 500
pj0901: posts the ante 500
Proosty2: posts the ante 500
gibbo888: posts the ante 500
DR. ELDAR: posts the ante 500
mobky: posts small blind 2000
supervaganj: posts big blind 4000
*** HOLE CARDS ***
Vamoclan: folds 
pj0901: folds 
Proosty2: raises 4000 to 8000
gibbo888: folds 
DR. ELDAR: folds 
lucaromanoo1: folds 
mobky: folds 
supervaganj: calls 4000
*** FLOP *** [Kd 2c 5d]
supervaganj: checks 
Proosty2: bets 5520
supervaganj: folds 
Uncalled bet (5520) returned to Proosty2
Proosty2 collected 22000 from pot
Proosty2: doesn't show hand 
*** SUMMARY ***
Total pot 22000 | Rake 0 
Board [Kd 2c 5d]
Seat 1: lucaromanoo1 (button) folded before Flop (didn't bet)
Seat 2: mobky (small blind) folded before Flop
Seat 3: supervaganj (big blind) folded on the Flop
Seat 4: Vamoclan folded before Flop (didn't bet)
Seat 5: pj0901 folded before Flop (didn't bet)
Seat 6: Proosty2 collected (22000)
Seat 7: gibbo888 folded before Flop (didn't bet)
Seat 8: DR. ELDAR folded before Flop (didn't bet)

PokerStars Hand #251206830724: Tournament #3767885527, $40+$10+$5 USD Hold'em No Limit - Level XVIII (2000/4000) - 2024/06/26 20:22:16 UTC [2024/06/26 16:22:16 ET]
Table '3767885527 93' 8-max Seat #2 is the button
Seat 1: lucaromanoo1 (193354 in chips) 
Seat 2: mobky (45500 in chips) 
Seat 3: supervaganj (145790 in chips) 
Seat 4: Vamoclan (69099 in chips) 
Seat 5: pj0901 (231119 in chips) 
Seat 6: Proosty2 (83228 in chips) 
Seat 7: gibbo888 (233366 in chips) 
Seat 8: DR. ELDAR (98266 in chips) 
lucaromanoo1: posts the ante 500
mobky: posts the ante 500
supervaganj: posts the ante 500
Vamoclan: posts the ante 500
pj0901: posts the ante 500
Proosty2: posts the ante 500
gibbo888: posts the ante 500
DR. ELDAR: posts the ante 500
supervaganj: posts small blind 2000
Vamoclan: posts big blind 4000
*** HOLE CARDS ***
pj0901 has timed out
pj0901: folds 
pj0901 is sitting out
Proosty2: raises 4000 to 8000
pj0901 has returned
gibbo888: folds 
DR. ELDAR: folds 
lucaromanoo1: folds 
mobky: calls 8000
supervaganj: folds 
Vamoclan: folds 
*** FLOP *** [2h Ts 9c]
Proosty2: checks 
mobky: checks 
*** TURN *** [2h Ts 9c] [8d]
Proosty2: checks 
mobky: bets 26000
Proosty2: folds 
Uncalled bet (26000) returned to mobky
mobky collected 26000 from pot
*** SUMMARY ***
Total pot 26000 | Rake 0 
Board [2h Ts 9c 8d]
Seat 1: lucaromanoo1 folded before Flop (didn't bet)
Seat 2: mobky (button) collected (26000)
Seat 3: supervaganj (small blind) folded before Flop
Seat 4: Vamoclan (big blind) folded before Flop
Seat 5: pj0901 folded before Flop (didn't bet)
Seat 6: Proosty2 folded on the Turn
Seat 7: gibbo888 folded before Flop (didn't bet)
Seat 8: DR. ELDAR folded before Flop (didn't bet)

PokerStars Hand #251206854632: Tournament #3767885527, $40+$10+$5 USD Hold'em No Limit - Level XVIII (2000/4000) - 2024/06/26 20:23:41 UTC [2024/06/26 16:23:41 ET]
Table '3767885527 93' 8-max Seat #3 is the button
Seat 1: lucaromanoo1 (192854 in chips) 
Seat 2: mobky (63000 in chips) 
Seat 3: supervaganj (143290 in chips) 
Seat 4: Vamoclan (64599 in chips) 
Seat 5: pj0901 (230619 in chips) 
Seat 6: Proosty2 (74728 in chips) 
Seat 7: gibbo888 (232866 in chips) 
Seat 8: DR. ELDAR (97766 in chips) 
lucaromanoo1: posts the ante 500
mobky: posts the ante 500
supervaganj: posts the ante 500
Vamoclan: posts the ante 500
pj0901: posts the ante 500
Proosty2: posts the ante 500
gibbo888: posts the ante 500
DR. ELDAR: posts the ante 500
Vamoclan: posts small blind 2000
pj0901: posts big blind 4000
*** HOLE CARDS ***
Proosty2: folds 
gibbo888: folds 
DR. ELDAR: folds 
lucaromanoo1: folds 
mobky: raises 4123 to 8123
supervaganj: folds 
Vamoclan: folds 
pj0901: raises 221996 to 230119 and is all-in
mobky: folds 
Uncalled bet (221996) returned to pj0901
pj0901 collected 22246 from pot
pj0901: doesn't show hand 
*** SUMMARY ***
Total pot 22246 | Rake 0 
Seat 1: lucaromanoo1 folded before Flop (didn't bet)
Seat 2: mobky folded before Flop
Seat 3: supervaganj (button) folded before Flop (didn't bet)
Seat 4: Vamoclan (small blind) folded before Flop
Seat 5: pj0901 (big blind) collected (22246)
Seat 6: Proosty2 folded before Flop (didn't bet)
Seat 7: gibbo888 folded before Flop (didn't bet)
Seat 8: DR. ELDAR folded before Flop (didn't bet)

PokerStars Hand #251206871845: Tournament #3767885527, $40+$10+$5 USD Hold'em No Limit - Level XVIII (2000/4000) - 2024/06/26 20:24:43 UTC [2024/06/26 16:24:43 ET]
Table '3767885527 93' 8-max Seat #4 is the button
Seat 1: lucaromanoo1 (192354 in chips) 
Seat 2: mobky (54377 in chips) 
Seat 3: supervaganj (142790 in chips) 
Seat 4: Vamoclan (62099 in chips) 
Seat 5: pj0901 (244242 in chips) 
Seat 6: Proosty2 (74228 in chips) 
Seat 7: gibbo888 (232366 in chips) 
Seat 8: DR. ELDAR (97266 in chips) 
lucaromanoo1: posts the ante 500
mobky: posts the ante 500
supervaganj: posts the ante 500
Vamoclan: posts the ante 500
pj0901: posts the ante 500
Proosty2: posts the ante 500
gibbo888: posts the ante 500
DR. ELDAR: posts the ante 500
pj0901: posts small blind 2000
Proosty2: posts big blind 4000
*** HOLE CARDS ***
gibbo888: folds 
DR. ELDAR: folds 
lucaromanoo1: folds 
mobky: folds 
supervaganj: folds 
Vamoclan: folds 
pj0901: raises 239742 to 243742 and is all-in
Proosty2: folds 
Uncalled bet (239742) returned to pj0901
pj0901 collected 12000 from pot
pj0901: doesn't show hand 
*** SUMMARY ***
Total pot 12000 | Rake 0 
Seat 1: lucaromanoo1 folded before Flop (didn't bet)
Seat 2: mobky folded before Flop (didn't bet)
Seat 3: supervaganj folded before Flop (didn't bet)
Seat 4: Vamoclan (button) folded before Flop (didn't bet)
Seat 5: pj0901 (small blind) collected (12000)
Seat 6: Proosty2 (big blind) folded before Flop
Seat 7: gibbo888 folded before Flop (didn't bet)
Seat 8: DR. ELDAR folded before Flop (didn't bet)

PokerStars Hand #251206877625: Tournament #3767885527, $40+$10+$5 USD Hold'em No Limit - Level XVIII (2000/4000) - 2024/06/26 20:25:04 UTC [2024/06/26 16:25:04 ET]
Table '3767885527 93' 8-max Seat #5 is the button
Seat 1: lucaromanoo1 (191854 in chips) 
Seat 2: mobky (53877 in chips) 
Seat 3: supervaganj (142290 in chips) 
Seat 4: Vamoclan (61599 in chips) 
Seat 5: pj0901 (251742 in chips) 
Seat 6: Proosty2 (69728 in chips) 
Seat 7: gibbo888 (231866 in chips) 
Seat 8: DR. ELDAR (96766 in chips) 
lucaromanoo1: posts the ante 500
mobky: posts the ante 500
supervaganj: posts the ante 500
Vamoclan: posts the ante 500
pj0901: posts the ante 500
Proosty2: posts the ante 500
gibbo888: posts the ante 500
DR. ELDAR: posts the ante 500
Proosty2: posts small blind 2000
gibbo888: posts big blind 4000
*** HOLE CARDS ***
DR. ELDAR: folds 
lucaromanoo1: folds 
mobky: folds 
supervaganj: folds 
Vamoclan: folds 
pj0901: folds 
Proosty2: calls 2000
gibbo888: raises 227366 to 231366 and is all-in
Proosty2: folds 
Uncalled bet (227366) returned to gibbo888
gibbo888 collected 12000 from pot
gibbo888: doesn't show hand 
*** SUMMARY ***
Total pot 12000 | Rake 0 
Seat 1: lucaromanoo1 folded before Flop (didn't bet)
Seat 2: mobky folded before Flop (didn't bet)
Seat 3: supervaganj folded before Flop (didn't bet)
Seat 4: Vamoclan folded before Flop (didn't bet)
Seat 5: pj0901 (button) folded before Flop (didn't bet)
Seat 6: Proosty2 (small blind) folded before Flop
Seat 7: gibbo888 (big blind) collected (12000)
Seat 8: DR. ELDAR folded before Flop (didn't bet)

PokerStars Hand #251206888352: Tournament #3767885527, $40+$10+$5 USD Hold'em No Limit - Level XVIII (2000/4000) - 2024/06/26 20:25:42 UTC [2024/06/26 16:25:42 ET]
Table '3767885527 93' 8-max Seat #6 is the button
Seat 1: lucaromanoo1 (191354 in chips) 
Seat 2: mobky (53377 in chips) 
Seat 3: supervaganj (141790 in chips) 
Seat 4: Vamoclan (61099 in chips) 
Seat 5: pj0901 (251242 in chips) 
Seat 6: Proosty2 (65228 in chips) 
Seat 7: gibbo888 (239366 in chips) 
Seat 8: DR. ELDAR (96266 in chips) 
lucaromanoo1: posts the ante 500
mobky: posts the ante 500
supervaganj: posts the ante 500
Vamoclan: posts the ante 500
pj0901: posts the ante 500
Proosty2: posts the ante 500
gibbo888: posts the ante 500
DR. ELDAR: posts the ante 500
gibbo888: posts small blind 2000
DR. ELDAR: posts big blind 4000
*** HOLE CARDS ***
lucaromanoo1: raises 4000 to 8000
mobky: calls 8000
supervaganj: folds 
Vamoclan: folds 
pj0901: folds 
Proosty2: folds 
gibbo888: calls 6000
DR. ELDAR: calls 4000
*** FLOP *** [2d Ad 9d]
gibbo888: checks 
DR. ELDAR: checks 
lucaromanoo1: checks 
mobky: checks 
*** TURN *** [2d Ad 9d] [Ks]
gibbo888: bets 15840
DR. ELDAR: folds 
lucaromanoo1: folds 
mobky: folds 
Uncalled bet (15840) returned to gibbo888
gibbo888 collected 36000 from pot
gibbo888: doesn't show hand 
*** SUMMARY ***
Total pot 36000 | Rake 0 
Board [2d Ad 9d Ks]
Seat 1: lucaromanoo1 folded on the Turn
Seat 2: mobky folded on the Turn
Seat 3: supervaganj folded before Flop (didn't bet)
Seat 4: Vamoclan folded before Flop (didn't bet)
Seat 5: pj0901 folded before Flop (didn't bet)
Seat 6: Proosty2 (button) folded before Flop (didn't bet)
Seat 7: gibbo888 (small blind) collected (36000)
Seat 8: DR. ELDAR (big blind) folded on the Turn

PokerStars Hand #251206903318: Tournament #3767885527, $40+$10+$5 USD Hold'em No Limit - Level XIX (2500/5000) - 2024/06/26 20:26:36 UTC [2024/06/26 16:26:36 ET]
Table '3767885527 93' 8-max Seat #7 is the button
Seat 1: lucaromanoo1 (182854 in chips) 
Seat 2: mobky (44877 in chips) 
Seat 3: supervaganj (141290 in chips) 
Seat 4: Vamoclan (60599 in chips) 
Seat 5: pj0901 (250742 in chips) 
Seat 6: Proosty2 (64728 in chips) 
Seat 7: gibbo888 (266866 in chips) 
Seat 8: DR. ELDAR (87766 in chips) 
lucaromanoo1: posts the ante 625
mobky: posts the ante 625
supervaganj: posts the ante 625
Vamoclan: posts the ante 625
pj0901: posts the ante 625
Proosty2: posts the ante 625
gibbo888: posts the ante 625
DR. ELDAR: posts the ante 625
DR. ELDAR: posts small blind 2500
lucaromanoo1: posts big blind 5000
*** HOLE CARDS ***
mobky: folds 
supervaganj: raises 5000 to 10000
Vamoclan: folds 
pj0901: folds 
Proosty2: folds 
gibbo888: folds 
DR. ELDAR: folds 
lucaromanoo1: calls 5000
*** FLOP *** [3c Qd Qs]
lucaromanoo1: checks 
supervaganj: bets 6900
lucaromanoo1: raises 15600 to 22500
supervaganj: folds 
Uncalled bet (15600) returned to lucaromanoo1
lucaromanoo1 collected 41300 from pot
lucaromanoo1: doesn't show hand 
*** SUMMARY ***
Total pot 41300 | Rake 0 
Board [3c Qd Qs]
Seat 1: lucaromanoo1 (big blind) collected (41300)
Seat 2: mobky folded before Flop (didn't bet)
Seat 3: supervaganj folded on the Flop
Seat 4: Vamoclan folded before Flop (didn't bet)
Seat 5: pj0901 folded before Flop (didn't bet)
Seat 6: Proosty2 folded before Flop (didn't bet)
Seat 7: gibbo888 (button) folded before Flop (didn't bet)
Seat 8: DR. ELDAR (small blind) folded before Flop

PokerStars Hand #251206918858: Tournament #3767885527, $40+$10+$5 USD Hold'em No Limit - Level XIX (2500/5000) - 2024/06/26 20:27:32 UTC [2024/06/26 16:27:32 ET]
Table '3767885527 93' 8-max Seat #8 is the button
Seat 1: lucaromanoo1 (206629 in chips) 
Seat 2: mobky (44252 in chips) 
Seat 3: supervaganj (123765 in chips) 
Seat 4: Vamoclan (59974 in chips) 
Seat 5: pj0901 (250117 in chips) 
Seat 6: Proosty2 (64103 in chips) 
Seat 7: gibbo888 (266241 in chips) 
Seat 8: DR. ELDAR (84641 in chips) 
lucaromanoo1: posts the ante 625
mobky: posts the ante 625
supervaganj: posts the ante 625
Vamoclan: posts the ante 625
pj0901: posts the ante 625
Proosty2: posts the ante 625
gibbo888: posts the ante 625
DR. ELDAR: posts the ante 625
lucaromanoo1: posts small blind 2500
mobky: posts big blind 5000
*** HOLE CARDS ***
supervaganj: folds 
Vamoclan: folds 
pj0901: raises 5000 to 10000
Proosty2: folds 
gibbo888: folds 
DR. ELDAR: folds 
lucaromanoo1: calls 7500
mobky: folds 
*** FLOP *** [8s 9s 8h]
lucaromanoo1: checks 
pj0901: checks 
*** TURN *** [8s 9s 8h] [2h]
lucaromanoo1: checks 
pj0901: checks 
*** RIVER *** [8s 9s 8h 2h] [Kd]
lucaromanoo1: checks 
pj0901: checks 
*** SHOW DOWN ***
lucaromanoo1: shows [7h 7s] (two pair, Eights and Sevens)
pj0901: mucks hand 
lucaromanoo1 collected 30000 from pot
*** SUMMARY ***
Total pot 30000 | Rake 0 
Board [8s 9s 8h 2h Kd]
Seat 1: lucaromanoo1 (small blind) showed [7h 7s] and won (30000) with two pair, Eights and Sevens
Seat 2: mobky (big blind) folded before Flop
Seat 3: supervaganj folded before Flop (didn't bet)
Seat 4: Vamoclan folded before Flop (didn't bet)
Seat 5: pj0901 mucked
Seat 6: Proosty2 folded before Flop (didn't bet)
Seat 7: gibbo888 folded before Flop (didn't bet)
Seat 8: DR. ELDAR (button) folded before Flop (didn't bet)

PokerStars Hand #251206944723: Tournament #3767885527, $40+$10+$5 USD Hold'em No Limit - Level XIX (2500/5000) - 2024/06/26 20:29:05 UTC [2024/06/26 16:29:05 ET]
Table '3767885527 93' 8-max Seat #1 is the button
Seat 1: lucaromanoo1 (226004 in chips) 
Seat 2: mobky (38627 in chips) 
Seat 3: supervaganj (123140 in chips) 
Seat 4: Vamoclan (59349 in chips) 
Seat 5: pj0901 (239492 in chips) 
Seat 6: Proosty2 (63478 in chips) 
Seat 7: gibbo888 (265616 in chips) 
Seat 8: DR. ELDAR (84016 in chips) 
lucaromanoo1: posts the ante 625
mobky: posts the ante 625
supervaganj: posts the ante 625
Vamoclan: posts the ante 625
pj0901: posts the ante 625
Proosty2: posts the ante 625
gibbo888: posts the ante 625
DR. ELDAR: posts the ante 625
mobky: posts small blind 2500
supervaganj: posts big blind 5000
*** HOLE CARDS ***
Vamoclan: folds 
pj0901: folds 
Proosty2: folds 
gibbo888: raises 5000 to 10000
DR. ELDAR: folds 
lucaromanoo1: folds 
mobky: folds 
supervaganj: calls 5000
*** FLOP *** [Ah 5d 2h]
supervaganj: checks 
gibbo888: bets 12100
supervaganj: folds 
Uncalled bet (12100) returned to gibbo888
gibbo888 collected 27500 from pot
gibbo888: doesn't show hand 
*** SUMMARY ***
Total pot 27500 | Rake 0 
Board [Ah 5d 2h]
Seat 1: lucaromanoo1 (button) folded before Flop (didn't bet)
Seat 2: mobky (small blind) folded before Flop
Seat 3: supervaganj (big blind) folded on the Flop
Seat 4: Vamoclan folded before Flop (didn't bet)
Seat 5: pj0901 folded before Flop (didn't bet)
Seat 6: Proosty2 folded before Flop (didn't bet)
Seat 7: gibbo888 collected (27500)
Seat 8: DR. ELDAR folded before Flop (didn't bet)

PokerStars Hand #251206960344: Tournament #3767885527, $40+$10+$5 USD Hold'em No Limit - Level XIX (2500/5000) - 2024/06/26 20:30:01 UTC [2024/06/26 16:30:01 ET]
Table '3767885527 93' 8-max Seat #2 is the button
Seat 1: lucaromanoo1 (225379 in chips) 
Seat 2: mobky (35502 in chips) 
Seat 3: supervaganj (112515 in chips) 
Seat 4: Vamoclan (58724 in chips) 
Seat 5: pj0901 (238867 in chips) 
Seat 6: Proosty2 (62853 in chips) 
Seat 7: gibbo888 (282491 in chips) 
Seat 8: DR. ELDAR (83391 in chips) 
lucaromanoo1: posts the ante 625
mobky: posts the ante 625
supervaganj: posts the ante 625
Vamoclan: posts the ante 625
pj0901: posts the ante 625
Proosty2: posts the ante 625
gibbo888: posts the ante 625
DR. ELDAR: posts the ante 625
supervaganj: posts small blind 2500
Vamoclan: posts big blind 5000
*** HOLE CARDS ***
pj0901: folds 
Proosty2: folds 
gibbo888: folds 
DR. ELDAR: folds 
lucaromanoo1: folds 
mobky: folds 
supervaganj: raises 106890 to 111890 and is all-in
Vamoclan: folds 
Uncalled bet (106890) returned to supervaganj
supervaganj collected 15000 from pot
supervaganj: doesn't show hand 
*** SUMMARY ***
Total pot 15000 | Rake 0 
Seat 1: lucaromanoo1 folded before Flop (didn't bet)
Seat 2: mobky (button) folded before Flop (didn't bet)
Seat 3: supervaganj (small blind) collected (15000)
Seat 4: Vamoclan (big blind) folded before Flop
Seat 5: pj0901 folded before Flop (didn't bet)
Seat 6: Proosty2 folded before Flop (didn't bet)
Seat 7: gibbo888 folded before Flop (didn't bet)
Seat 8: DR. ELDAR folded before Flop (didn't bet)

PokerStars Hand #251206971586: Tournament #3767885527, $40+$10+$5 USD Hold'em No Limit - Level XIX (2500/5000) - 2024/06/26 20:30:42 UTC [2024/06/26 16:30:42 ET]
Table '3767885527 93' 8-max Seat #3 is the button
Seat 1: lucaromanoo1 (224754 in chips) 
Seat 2: mobky (34877 in chips) 
Seat 3: supervaganj (121890 in chips) 
Seat 4: Vamoclan (53099 in chips) 
Seat 5: pj0901 (238242 in chips) 
Seat 6: Proosty2 (62228 in chips) 
Seat 7: gibbo888 (281866 in chips) 
Seat 8: DR. ELDAR (82766 in chips) 
lucaromanoo1: posts the ante 625
mobky: posts the ante 625
supervaganj: posts the ante 625
Vamoclan: posts the ante 625
pj0901: posts the ante 625
Proosty2: posts the ante 625
gibbo888: posts the ante 625
DR. ELDAR: posts the ante 625
Vamoclan: posts small blind 2500
pj0901: posts big blind 5000
*** HOLE CARDS ***
Proosty2: folds 
gibbo888: folds 
DR. ELDAR: folds 
lucaromanoo1: folds 
mobky: folds 
supervaganj: folds 
Vamoclan: folds 
Uncalled bet (2500) returned to pj0901
pj0901 collected 10000 from pot
pj0901: doesn't show hand 
*** SUMMARY ***
Total pot 10000 | Rake 0 
Seat 1: lucaromanoo1 folded before Flop (didn't bet)
Seat 2: mobky folded before Flop (didn't bet)
Seat 3: supervaganj (button) folded before Flop (didn't bet)
Seat 4: Vamoclan (small blind) folded before Flop
Seat 5: pj0901 (big blind) collected (10000)
Seat 6: Proosty2 folded before Flop (didn't bet)
Seat 7: gibbo888 folded before Flop (didn't bet)
Seat 8: DR. ELDAR folded before Flop (didn't bet)

PokerStars Hand #251206984975: Tournament #3767885527, $40+$10+$5 USD Hold'em No Limit - Level XIX (2500/5000) - 2024/06/26 20:31:30 UTC [2024/06/26 16:31:30 ET]
Table '3767885527 93' 8-max Seat #4 is the button
Seat 1: lucaromanoo1 (224129 in chips) 
Seat 2: mobky (34252 in chips) 
Seat 3: supervaganj (121265 in chips) 
Seat 4: Vamoclan (49974 in chips) 
Seat 5: pj0901 (245117 in chips) 
Seat 6: Proosty2 (61603 in chips) 
Seat 7: gibbo888 (281241 in chips) 
Seat 8: DR. ELDAR (82141 in chips) 
lucaromanoo1: posts the ante 625
mobky: posts the ante 625
supervaganj: posts the ante 625
Vamoclan: posts the ante 625
pj0901: posts the ante 625
Proosty2: posts the ante 625
gibbo888: posts the ante 625
DR. ELDAR: posts the ante 625
pj0901: posts small blind 2500
Proosty2: posts big blind 5000
*** HOLE CARDS ***
gibbo888: folds 
DR. ELDAR: folds 
lucaromanoo1: folds 
mobky has timed out
mobky: folds 
mobky is sitting out
mobky has returned
supervaganj: folds 
Vamoclan: folds 
pj0901: raises 239492 to 244492 and is all-in
Proosty2: folds 
Uncalled bet (239492) returned to pj0901
pj0901 collected 15000 from pot
pj0901: doesn't show hand 
*** SUMMARY ***
Total pot 15000 | Rake 0 
Seat 1: lucaromanoo1 folded before Flop (didn't bet)
Seat 2: mobky folded before Flop (didn't bet)
Seat 3: supervaganj folded before Flop (didn't bet)
Seat 4: Vamoclan (button) folded before Flop (didn't bet)
Seat 5: pj0901 (small blind) collected (15000)
Seat 6: Proosty2 (big blind) folded before Flop
Seat 7: gibbo888 folded before Flop (didn't bet)
Seat 8: DR. ELDAR folded before Flop (didn't bet)

PokerStars Hand #251206999200: Tournament #3767885527, $40+$10+$5 USD Hold'em No Limit - Level XIX (2500/5000) - 2024/06/26 20:32:20 UTC [2024/06/26 16:32:20 ET]
Table '3767885527 93' 8-max Seat #5 is the button
Seat 1: lucaromanoo1 (223504 in chips) 
Seat 2: mobky (33627 in chips) 
Seat 3: supervaganj (120640 in chips) 
Seat 4: Vamoclan (49349 in chips) 
Seat 5: pj0901 (254492 in chips) 
Seat 6: Proosty2 (55978 in chips) 
Seat 7: gibbo888 (280616 in chips) 
Seat 8: DR. ELDAR (81516 in chips) 
lucaromanoo1: posts the ante 625
mobky: posts the ante 625
supervaganj: posts the ante 625
Vamoclan: posts the ante 625
pj0901: posts the ante 625
Proosty2: posts the ante 625
gibbo888: posts the ante 625
DR. ELDAR: posts the ante 625
Proosty2: posts small blind 2500
gibbo888: posts big blind 5000
*** HOLE CARDS ***
DR. ELDAR: folds 
lucaromanoo1: folds 
mobky: folds 
supervaganj: raises 5000 to 10000
Vamoclan: folds 
pj0901: raises 15000 to 25000
Proosty2: folds 
gibbo888: raises 250000 to 275000
supervaganj: folds 
pj0901: folds 
Uncalled bet (250000) returned to gibbo888
gibbo888 collected 67500 from pot
gibbo888: doesn't show hand 
*** SUMMARY ***
Total pot 67500 | Rake 0 
Seat 1: lucaromanoo1 folded before Flop (didn't bet)
Seat 2: mobky folded before Flop (didn't bet)
Seat 3: supervaganj folded before Flop
Seat 4: Vamoclan folded before Flop (didn't bet)
Seat 5: pj0901 (button) folded before Flop
Seat 6: Proosty2 (small blind) folded before Flop
Seat 7: gibbo888 (big blind) collected (67500)
Seat 8: DR. ELDAR folded before Flop (didn't bet)

PokerStars Hand #251207031999: Tournament #3767885527, $40+$10+$5 USD Hold'em No Limit - Level XIX (2500/5000) - 2024/06/26 20:34:17 UTC [2024/06/26 16:34:17 ET]
Table '3767885527 93' 8-max Seat #6 is the button
Seat 1: lucaromanoo1 (222879 in chips) 
Seat 2: mobky (33002 in chips) 
Seat 3: supervaganj (110015 in chips) 
Seat 4: Vamoclan (48724 in chips) 
Seat 5: pj0901 (228867 in chips) 
Seat 6: Proosty2 (52853 in chips) 
Seat 7: gibbo888 (322491 in chips) 
Seat 8: DR. ELDAR (80891 in chips) 
lucaromanoo1: posts the ante 625
mobky: posts the ante 625
supervaganj: posts the ante 625
Vamoclan: posts the ante 625
pj0901: posts the ante 625
Proosty2: posts the ante 625
gibbo888: posts the ante 625
DR. ELDAR: posts the ante 625
gibbo888: posts small blind 2500
DR. ELDAR: posts big blind 5000
*** HOLE CARDS ***
lucaromanoo1: raises 5000 to 10000
mobky: folds 
supervaganj: folds 
Vamoclan: folds 
pj0901: folds 
Proosty2: folds 
gibbo888: folds 
DR. ELDAR: folds 
Uncalled bet (5000) returned to lucaromanoo1
lucaromanoo1 collected 17500 from pot
lucaromanoo1: doesn't show hand 
*** SUMMARY ***
Total pot 17500 | Rake 0 
Seat 1: lucaromanoo1 collected (17500)
Seat 2: mobky folded before Flop (didn't bet)
Seat 3: supervaganj folded before Flop (didn't bet)
Seat 4: Vamoclan folded before Flop (didn't bet)
Seat 5: pj0901 folded before Flop (didn't bet)
Seat 6: Proosty2 (button) folded before Flop (didn't bet)
Seat 7: gibbo888 (small blind) folded before Flop
Seat 8: DR. ELDAR (big blind) folded before Flop

PokerStars Hand #251207037505: Tournament #3767885527, $40+$10+$5 USD Hold'em No Limit - Level XIX (2500/5000) - 2024/06/26 20:34:36 UTC [2024/06/26 16:34:36 ET]
Table '3767885527 93' 8-max Seat #7 is the button
Seat 1: lucaromanoo1 (234754 in chips) 
Seat 2: mobky (32377 in chips) 
Seat 3: supervaganj (109390 in chips) 
Seat 4: Vamoclan (48099 in chips) 
Seat 5: pj0901 (228242 in chips) 
Seat 6: Proosty2 (52228 in chips) 
Seat 7: gibbo888 (319366 in chips) 
Seat 8: DR. ELDAR (75266 in chips) 
lucaromanoo1: posts the ante 625
mobky: posts the ante 625
supervaganj: posts the ante 625
Vamoclan: posts the ante 625
pj0901: posts the ante 625
Proosty2: posts the ante 625
gibbo888: posts the ante 625
DR. ELDAR: posts the ante 625
DR. ELDAR: posts small blind 2500
lucaromanoo1: posts big blind 5000
*** HOLE CARDS ***
mobky: folds 
supervaganj: folds 
Vamoclan: folds 
pj0901: raises 5000 to 10000
Proosty2: folds 
gibbo888: folds 
DR. ELDAR: folds 
lucaromanoo1: calls 5000
*** FLOP *** [Kh 3h 5h]
lucaromanoo1: checks 
pj0901: checks 
*** TURN *** [Kh 3h 5h] [3d]
lucaromanoo1: bets 21175
pj0901: calls 21175
*** RIVER *** [Kh 3h 5h 3d] [2c]
lucaromanoo1: bets 70000
pj0901: calls 70000
*** SHOW DOWN ***
lucaromanoo1: shows [Jh 4h] (a flush, King high)
pj0901: mucks hand 
lucaromanoo1 collected 209850 from pot
*** SUMMARY ***
Total pot 209850 | Rake 0 
Board [Kh 3h 5h 3d 2c]
Seat 1: lucaromanoo1 (big blind) showed [Jh 4h] and won (209850) with a flush, King high
Seat 2: mobky folded before Flop (didn't bet)
Seat 3: supervaganj folded before Flop (didn't bet)
Seat 4: Vamoclan folded before Flop (didn't bet)
Seat 5: pj0901 mucked
Seat 6: Proosty2 folded before Flop (didn't bet)
Seat 7: gibbo888 (button) folded before Flop (didn't bet)
Seat 8: DR. ELDAR (small blind) folded before Flop

PokerStars Hand #251207057855: Tournament #3767885527, $40+$10+$5 USD Hold'em No Limit - Level XIX (2500/5000) - 2024/06/26 20:35:48 UTC [2024/06/26 16:35:48 ET]
Table '3767885527 93' 8-max Seat #8 is the button
Seat 1: lucaromanoo1 (342804 in chips) 
Seat 2: mobky (31752 in chips) 
Seat 3: supervaganj (108765 in chips) 
Seat 4: Vamoclan (47474 in chips) 
Seat 5: pj0901 (126442 in chips) 
Seat 6: Proosty2 (51603 in chips) 
Seat 7: gibbo888 (318741 in chips) 
Seat 8: DR. ELDAR (72141 in chips) 
lucaromanoo1: posts the ante 625
mobky: posts the ante 625
supervaganj: posts the ante 625
Vamoclan: posts the ante 625
pj0901: posts the ante 625
Proosty2: posts the ante 625
gibbo888: posts the ante 625
DR. ELDAR: posts the ante 625
lucaromanoo1: posts small blind 2500
mobky: posts big blind 5000
*** HOLE CARDS ***
supervaganj: folds 
Vamoclan: folds 
pj0901: folds 
Proosty2: folds 
gibbo888: folds 
DR. ELDAR: folds 
lucaromanoo1: raises 337179 to 342179 and is all-in
mobky: calls 26127 and is all-in
Uncalled bet (311052) returned to lucaromanoo1
*** FLOP *** [Td 3c 3s]
*** TURN *** [Td 3c 3s] [Th]
*** RIVER *** [Td 3c 3s Th] [Ks]
*** SHOW DOWN ***
lucaromanoo1: shows [8h Ah] (two pair, Tens and Threes)
mobky: shows [Kh 5h] (two pair, Kings and Tens)
mobky collected 67254 from pot
*** SUMMARY ***
Total pot 67254 | Rake 0 
Board [Td 3c 3s Th Ks]
Seat 1: lucaromanoo1 (small blind) showed [8h Ah] and lost with two pair, Tens and Threes
Seat 2: mobky (big blind) showed [Kh 5h] and won (67254) with two pair, Kings and Tens
Seat 3: supervaganj folded before Flop (didn't bet)
Seat 4: Vamoclan folded before Flop (didn't bet)
Seat 5: pj0901 folded before Flop (didn't bet)
Seat 6: Proosty2 folded before Flop (didn't bet)
Seat 7: gibbo888 folded before Flop (didn't bet)
Seat 8: DR. ELDAR (button) folded before Flop (didn't bet)

PokerStars Hand #251207066741: Tournament #3767885527, $40+$10+$5 USD Hold'em No Limit - Level XX (3000/6000) - 2024/06/26 20:36:19 UTC [2024/06/26 16:36:19 ET]
Table '3767885527 93' 8-max Seat #1 is the button
Seat 1: lucaromanoo1 (311052 in chips) 
Seat 2: mobky (67254 in chips) 
Seat 3: supervaganj (108140 in chips) 
Seat 4: Vamoclan (46849 in chips) 
Seat 5: pj0901 (125817 in chips) 
Seat 6: Proosty2 (50978 in chips) 
Seat 7: gibbo888 (318116 in chips) 
Seat 8: DR. ELDAR (71516 in chips) 
lucaromanoo1: posts the ante 750
mobky: posts the ante 750
supervaganj: posts the ante 750
Vamoclan: posts the ante 750
pj0901: posts the ante 750
Proosty2: posts the ante 750
gibbo888: posts the ante 750
DR. ELDAR: posts the ante 750
mobky: posts small blind 3000
supervaganj: posts big blind 6000
*** HOLE CARDS ***
Vamoclan: folds 
pj0901: folds 
Proosty2: folds 
gibbo888: folds 
DR. ELDAR: folds 
lucaromanoo1: raises 304302 to 310302 and is all-in
mobky: calls 63504 and is all-in
supervaganj: folds 
Uncalled bet (243798) returned to lucaromanoo1
*** FLOP *** [2h Ad 7s]
*** TURN *** [2h Ad 7s] [5s]
*** RIVER *** [2h Ad 7s 5s] [Jh]
*** SHOW DOWN ***
mobky: shows [Kc Ks] (a pair of Kings)
lucaromanoo1: shows [Ah 5c] (two pair, Aces and Fives)
lucaromanoo1 collected 145008 from pot
mobky finished the tournament in 283rd place and received $104.64.
*** SUMMARY ***
Total pot 145008 | Rake 0 
Board [2h Ad 7s 5s Jh]
Seat 1: lucaromanoo1 (button) showed [Ah 5c] and won (145008) with two pair, Aces and Fives
Seat 2: mobky (small blind) showed [Kc Ks] and lost with a pair of Kings
Seat 3: supervaganj (big blind) folded before Flop
Seat 4: Vamoclan folded before Flop (didn't bet)
Seat 5: pj0901 folded before Flop (didn't bet)
Seat 6: Proosty2 folded before Flop (didn't bet)
Seat 7: gibbo888 folded before Flop (didn't bet)
Seat 8: DR. ELDAR folded before Flop (didn't bet)

PokerStars Hand #251207074223: Tournament #3767885527, $40+$10+$5 USD Hold'em No Limit - Level XX (3000/6000) - 2024/06/26 20:36:46 UTC [2024/06/26 16:36:46 ET]
Table '3767885527 93' 8-max Seat #3 is the button
Seat 1: lucaromanoo1 (388806 in chips) 
Seat 3: supervaganj (101390 in chips) 
Seat 4: Vamoclan (46099 in chips) 
Seat 5: pj0901 (125067 in chips) 
Seat 6: Proosty2 (50228 in chips) 
Seat 7: gibbo888 (317366 in chips) 
Seat 8: DR. ELDAR (70766 in chips) 
lucaromanoo1: posts the ante 750
supervaganj: posts the ante 750
Vamoclan: posts the ante 750
pj0901: posts the ante 750
Proosty2: posts the ante 750
gibbo888: posts the ante 750
DR. ELDAR: posts the ante 750
Vamoclan: posts small blind 3000
pj0901: posts big blind 6000
*** HOLE CARDS ***
GUIDAASCANIO is disconnected 
Proosty2: folds 
gibbo888: folds 
DR. ELDAR: raises 64016 to 70016 and is all-in
lucaromanoo1: folds 
supervaganj: folds 
Vamoclan: folds 
pj0901: folds 
Uncalled bet (64016) returned to DR. ELDAR
DR. ELDAR collected 20250 from pot
DR. ELDAR: doesn't show hand 
*** SUMMARY ***
Total pot 20250 | Rake 0 
Seat 1: lucaromanoo1 folded before Flop (didn't bet)
Seat 3: supervaganj (button) folded before Flop (didn't bet)
Seat 4: Vamoclan (small blind) folded before Flop
Seat 5: pj0901 (big blind) folded before Flop
Seat 6: Proosty2 folded before Flop (didn't bet)
Seat 7: gibbo888 folded before Flop (didn't bet)
Seat 8: DR. ELDAR collected (20250)

PokerStars Hand #251207085166: Tournament #3767885527, $40+$10+$5 USD Hold'em No Limit - Level XX (3000/6000) - 2024/06/26 20:37:24 UTC [2024/06/26 16:37:24 ET]
Table '3767885527 93' 8-max Seat #4 is the button
Seat 1: lucaromanoo1 (388056 in chips) 
Seat 2: GUIDAASCANIO (100980 in chips) 
Seat 3: supervaganj (100640 in chips) 
Seat 4: Vamoclan (42349 in chips) 
Seat 5: pj0901 (118317 in chips) 
Seat 6: Proosty2 (49478 in chips) 
Seat 7: gibbo888 (316616 in chips) 
Seat 8: DR. ELDAR (84266 in chips) 
lucaromanoo1: posts the ante 750
GUIDAASCANIO: posts the ante 750
supervaganj: posts the ante 750
Vamoclan: posts the ante 750
pj0901: posts the ante 750
Proosty2: posts the ante 750
gibbo888: posts the ante 750
DR. ELDAR: posts the ante 750
pj0901: posts small blind 3000
Proosty2: posts big blind 6000
*** HOLE CARDS ***
gibbo888: folds 
DR. ELDAR: folds 
lucaromanoo1: folds 
GUIDAASCANIO: folds 
supervaganj: folds 
Vamoclan: raises 35599 to 41599 and is all-in
pj0901: folds 
Proosty2: folds 
Uncalled bet (35599) returned to Vamoclan
Vamoclan collected 21000 from pot
Vamoclan: doesn't show hand 
*** SUMMARY ***
Total pot 21000 | Rake 0 
Seat 1: lucaromanoo1 folded before Flop (didn't bet)
Seat 2: GUIDAASCANIO folded before Flop (didn't bet)
Seat 3: supervaganj folded before Flop (didn't bet)
Seat 4: Vamoclan (button) collected (21000)
Seat 5: pj0901 (small blind) folded before Flop
Seat 6: Proosty2 (big blind) folded before Flop
Seat 7: gibbo888 folded before Flop (didn't bet)
Seat 8: DR. ELDAR folded before Flop (didn't bet)

PokerStars Hand #251207090923: Tournament #3767885527, $40+$10+$5 USD Hold'em No Limit - Level XX (3000/6000) - 2024/06/26 20:37:45 UTC [2024/06/26 16:37:45 ET]
Table '3767885527 93' 8-max Seat #5 is the button
Seat 1: lucaromanoo1 (387306 in chips) 
Seat 2: GUIDAASCANIO (100230 in chips) 
Seat 3: supervaganj (99890 in chips) 
Seat 4: Vamoclan (56599 in chips) 
Seat 5: pj0901 (114567 in chips) 
Seat 6: Proosty2 (42728 in chips) 
Seat 7: gibbo888 (315866 in chips) 
Seat 8: DR. ELDAR (83516 in chips) 
lucaromanoo1: posts the ante 750
GUIDAASCANIO: posts the ante 750
supervaganj: posts the ante 750
Vamoclan: posts the ante 750
pj0901: posts the ante 750
Proosty2: posts the ante 750
gibbo888: posts the ante 750
DR. ELDAR: posts the ante 750
Proosty2: posts small blind 3000
gibbo888: posts big blind 6000
*** HOLE CARDS ***
DR. ELDAR: raises 6600 to 12600
lucaromanoo1: folds 
GUIDAASCANIO: folds 
supervaganj: folds 
Vamoclan: folds 
pj0901: raises 11400 to 24000
Proosty2: folds 
gibbo888: folds 
DR. ELDAR: calls 11400
*** FLOP *** [2d Jc 7h]
DR. ELDAR: checks 
pj0901: bets 6000
DR. ELDAR: calls 6000
*** TURN *** [2d Jc 7h] [7c]
DR. ELDAR: checks 
pj0901: bets 12750
DR. ELDAR: raises 40016 to 52766 and is all-in
pj0901: calls 40016
*** RIVER *** [2d Jc 7h 7c] [3s]
*** SHOW DOWN ***
DR. ELDAR: shows [As 5s] (a pair of Sevens)
pj0901: shows [8c 8s] (two pair, Eights and Sevens)
pj0901 collected 180532 from pot
DR. ELDAR finished the tournament in 267th place and received $104.64.
*** SUMMARY ***
Total pot 180532 | Rake 0 
Board [2d Jc 7h 7c 3s]
Seat 1: lucaromanoo1 folded before Flop (didn't bet)
Seat 2: GUIDAASCANIO folded before Flop (didn't bet)
Seat 3: supervaganj folded before Flop (didn't bet)
Seat 4: Vamoclan folded before Flop (didn't bet)
Seat 5: pj0901 (button) showed [8c 8s] and won (180532) with two pair, Eights and Sevens
Seat 6: Proosty2 (small blind) folded before Flop
Seat 7: gibbo888 (big blind) folded before Flop
Seat 8: DR. ELDAR showed [As 5s] and lost with a pair of Sevens

PokerStars Hand #251207105841: Tournament #3767885527, $40+$10+$5 USD Hold'em No Limit - Level XX (3000/6000) - 2024/06/26 20:38:38 UTC [2024/06/26 16:38:38 ET]
Table '3767885527 93' 8-max Seat #6 is the button
Seat 1: lucaromanoo1 (386556 in chips) 
Seat 2: GUIDAASCANIO (99480 in chips) 
Seat 3: supervaganj (99140 in chips) 
Seat 4: Vamoclan (55849 in chips) 
Seat 5: pj0901 (211583 in chips) 
Seat 6: Proosty2 (38978 in chips) 
Seat 7: gibbo888 (309116 in chips) 
lucaromanoo1: posts the ante 750
GUIDAASCANIO: posts the ante 750
supervaganj: posts the ante 750
Vamoclan: posts the ante 750
pj0901: posts the ante 750
Proosty2: posts the ante 750
gibbo888: posts the ante 750
gibbo888: posts small blind 3000
lucaromanoo1: posts big blind 6000
*** HOLE CARDS ***
GUIDAASCANIO: folds 
supervaganj: folds 
Vamoclan: folds 
pj0901: raises 6000 to 12000
mp5610 is disconnected 
Proosty2: folds 
gibbo888: folds 
lucaromanoo1: calls 6000
*** FLOP *** [Jd 4c 2s]
lucaromanoo1: checks 
pj0901: bets 8063
lucaromanoo1: calls 8063
*** TURN *** [Jd 4c 2s] [4s]
lucaromanoo1: bets 15480
pj0901: calls 15480
*** RIVER *** [Jd 4c 2s 4s] [6c]
lucaromanoo1: checks 
pj0901: checks 
*** SHOW DOWN ***
lucaromanoo1: shows [7c 7d] (two pair, Sevens and Fours)
pj0901: mucks hand 
lucaromanoo1 collected 79336 from pot
*** SUMMARY ***
Total pot 79336 | Rake 0 
Board [Jd 4c 2s 4s 6c]
Seat 1: lucaromanoo1 (big blind) showed [7c 7d] and won (79336) with two pair, Sevens and Fours
Seat 2: GUIDAASCANIO folded before Flop (didn't bet)
Seat 3: supervaganj folded before Flop (didn't bet)
Seat 4: Vamoclan folded before Flop (didn't bet)
Seat 5: pj0901 mucked
Seat 6: Proosty2 (button) folded before Flop (didn't bet)
Seat 7: gibbo888 (small blind) folded before Flop

PokerStars Hand #251207125161: Tournament #3767885527, $40+$10+$5 USD Hold'em No Limit - Level XX (3000/6000) - 2024/06/26 20:39:46 UTC [2024/06/26 16:39:46 ET]
Table '3767885527 93' 8-max Seat #7 is the button
Seat 1: lucaromanoo1 (429599 in chips) 
Seat 2: GUIDAASCANIO (98730 in chips) 
Seat 3: supervaganj (98390 in chips) 
Seat 4: Vamoclan (55099 in chips) 
Seat 5: pj0901 (175290 in chips) 
Seat 6: Proosty2 (38228 in chips) 
Seat 7: gibbo888 (305366 in chips) 
Seat 8: mp5610 (121000 in chips) out of hand (moved from another table into small blind)
mp5610 will be allowed to play after the button
lucaromanoo1: posts the ante 750
GUIDAASCANIO: posts the ante 750
supervaganj: posts the ante 750
Vamoclan: posts the ante 750
pj0901: posts the ante 750
Proosty2: posts the ante 750
gibbo888: posts the ante 750
lucaromanoo1: posts small blind 3000
GUIDAASCANIO: posts big blind 6000
*** HOLE CARDS ***
supervaganj: raises 6000 to 12000
Vamoclan: folds 
pj0901: folds 
Proosty2: folds 
gibbo888: folds 
lucaromanoo1: folds 
GUIDAASCANIO: calls 6000
*** FLOP *** [5d 2s Td]
GUIDAASCANIO: checks 
supervaganj: bets 10643
GUIDAASCANIO: folds 
Uncalled bet (10643) returned to supervaganj
supervaganj collected 32250 from pot
supervaganj: doesn't show hand 
*** SUMMARY ***
Total pot 32250 | Rake 0 
Board [5d 2s Td]
Seat 1: lucaromanoo1 (small blind) folded before Flop
Seat 2: GUIDAASCANIO (big blind) folded on the Flop
Seat 3: supervaganj collected (32250)
Seat 4: Vamoclan folded before Flop (didn't bet)
Seat 5: pj0901 folded before Flop (didn't bet)
Seat 6: Proosty2 folded before Flop (didn't bet)
Seat 7: gibbo888 (button) folded before Flop (didn't bet)

PokerStars Hand #251207133875: Tournament #3767885527, $40+$10+$5 USD Hold'em No Limit - Level XX (3000/6000) - 2024/06/26 20:40:17 UTC [2024/06/26 16:40:17 ET]
Table '3767885527 93' 8-max Seat #1 is the button
Seat 1: lucaromanoo1 (425849 in chips) 
Seat 2: GUIDAASCANIO (85980 in chips) 
Seat 3: supervaganj (117890 in chips) 
Seat 4: Vamoclan (54349 in chips) 
Seat 5: pj0901 (174540 in chips) 
Seat 6: Proosty2 (37478 in chips) 
Seat 7: gibbo888 (304616 in chips) 
Seat 8: mp5610 (121000 in chips) 
lucaromanoo1: posts the ante 750
GUIDAASCANIO: posts the ante 750
supervaganj: posts the ante 750
Vamoclan: posts the ante 750
pj0901: posts the ante 750
Proosty2: posts the ante 750
gibbo888: posts the ante 750
mp5610: posts the ante 750
GUIDAASCANIO: posts small blind 3000
supervaganj: posts big blind 6000
*** HOLE CARDS ***
Vamoclan: folds 
pj0901: raises 6000 to 12000
Proosty2: folds 
gibbo888: folds 
mp5610: folds 
lucaromanoo1: folds 
GUIDAASCANIO: folds 
supervaganj: calls 6000
*** FLOP *** [Th 7s 6h]
supervaganj: checks 
pj0901: bets 8250
supervaganj: calls 8250
*** TURN *** [Th 7s 6h] [Qh]
supervaganj: checks 
pj0901: bets 25800
supervaganj: folds 
Uncalled bet (25800) returned to pj0901
pj0901 collected 49500 from pot
pj0901: doesn't show hand 
*** SUMMARY ***
Total pot 49500 | Rake 0 
Board [Th 7s 6h Qh]
Seat 1: lucaromanoo1 (button) folded before Flop (didn't bet)
Seat 2: GUIDAASCANIO (small blind) folded before Flop
Seat 3: supervaganj (big blind) folded on the Turn
Seat 4: Vamoclan folded before Flop (didn't bet)
Seat 5: pj0901 collected (49500)
Seat 6: Proosty2 folded before Flop (didn't bet)
Seat 7: gibbo888 folded before Flop (didn't bet)
Seat 8: mp5610 folded before Flop (didn't bet)

PokerStars Hand #251207150019: Tournament #3767885527, $40+$10+$5 USD Hold'em No Limit - Level XX (3000/6000) - 2024/06/26 20:41:15 UTC [2024/06/26 16:41:15 ET]
Table '3767885527 93' 8-max Seat #2 is the button
Seat 1: lucaromanoo1 (425099 in chips) 
Seat 2: GUIDAASCANIO (82230 in chips) 
Seat 3: supervaganj (96890 in chips) 
Seat 4: Vamoclan (53599 in chips) 
Seat 5: pj0901 (203040 in chips) 
Seat 6: Proosty2 (36728 in chips) 
Seat 7: gibbo888 (303866 in chips) 
Seat 8: mp5610 (120250 in chips) 
lucaromanoo1: posts the ante 750
GUIDAASCANIO: posts the ante 750
supervaganj: posts the ante 750
Vamoclan: posts the ante 750
pj0901: posts the ante 750
Proosty2: posts the ante 750
gibbo888: posts the ante 750
mp5610: posts the ante 750
supervaganj: posts small blind 3000
Vamoclan: posts big blind 6000
*** HOLE CARDS ***
pj0901 has timed out
pj0901: folds 
pj0901 is sitting out
Proosty2: folds 
gibbo888: raises 6000 to 12000
mp5610: folds 
pj0901 has returned
lucaromanoo1: calls 12000
GUIDAASCANIO: folds 
supervaganj: folds 
Vamoclan: folds 
*** FLOP *** [7d 5d 4d]
gibbo888: bets 26130
lucaromanoo1: calls 26130
*** TURN *** [7d 5d 4d] [Ad]
gibbo888: checks 
lucaromanoo1: checks 
*** RIVER *** [7d 5d 4d Ad] [Kh]
gibbo888: checks 
lucaromanoo1: bets 50193
gibbo888: calls 50193
*** SHOW DOWN ***
lucaromanoo1: shows [Ah Jd] (a flush, Ace high)
gibbo888: mucks hand 
lucaromanoo1 collected 191646 from pot
*** SUMMARY ***
Total pot 191646 | Rake 0 
Board [7d 5d 4d Ad Kh]
Seat 1: lucaromanoo1 showed [Ah Jd] and won (191646) with a flush, Ace high
Seat 2: GUIDAASCANIO (button) folded before Flop (didn't bet)
Seat 3: supervaganj (small blind) folded before Flop
Seat 4: Vamoclan (big blind) folded before Flop
Seat 5: pj0901 folded before Flop (didn't bet)
Seat 6: Proosty2 folded before Flop (didn't bet)
Seat 7: gibbo888 mucked
Seat 8: mp5610 folded before Flop (didn't bet)

PokerStars Hand #251207173831: Tournament #3767885527, $40+$10+$5 USD Hold'em No Limit - Level XX (3000/6000) - 2024/06/26 20:42:41 UTC [2024/06/26 16:42:41 ET]
Table '3767885527 93' 8-max Seat #3 is the button
Seat 1: lucaromanoo1 (527672 in chips) 
Seat 2: GUIDAASCANIO (81480 in chips) 
Seat 3: supervaganj (93140 in chips) 
Seat 4: Vamoclan (46849 in chips) 
Seat 5: pj0901 (202290 in chips) 
Seat 6: Proosty2 (35978 in chips) 
Seat 7: gibbo888 (214793 in chips) 
Seat 8: mp5610 (119500 in chips) 
lucaromanoo1: posts the ante 750
GUIDAASCANIO: posts the ante 750
supervaganj: posts the ante 750
Vamoclan: posts the ante 750
pj0901: posts the ante 750
Proosty2: posts the ante 750
gibbo888: posts the ante 750
mp5610: posts the ante 750
Vamoclan: posts small blind 3000
pj0901: posts big blind 6000
*** HOLE CARDS ***
Proosty2: folds 
gibbo888: folds 
mp5610: folds 
lucaromanoo1: folds 
GUIDAASCANIO: folds 
supervaganj: raises 6000 to 12000
Vamoclan: folds 
pj0901: raises 189540 to 201540 and is all-in
supervaganj: folds 
Uncalled bet (189540) returned to pj0901
pj0901 collected 33000 from pot
pj0901: doesn't show hand 
*** SUMMARY ***
Total pot 33000 | Rake 0 
Seat 1: lucaromanoo1 folded before Flop (didn't bet)
Seat 2: GUIDAASCANIO folded before Flop (didn't bet)
Seat 3: supervaganj (button) folded before Flop
Seat 4: Vamoclan (small blind) folded before Flop
Seat 5: pj0901 (big blind) collected (33000)
Seat 6: Proosty2 folded before Flop (didn't bet)
Seat 7: gibbo888 folded before Flop (didn't bet)
Seat 8: mp5610 folded before Flop (didn't bet)

PokerStars Hand #251207185765: Tournament #3767885527, $40+$10+$5 USD Hold'em No Limit - Level XX (3000/6000) - 2024/06/26 20:43:24 UTC [2024/06/26 16:43:24 ET]
Table '3767885527 93' 8-max Seat #4 is the button
Seat 1: lucaromanoo1 (526922 in chips) 
Seat 2: GUIDAASCANIO (80730 in chips) 
Seat 3: supervaganj (80390 in chips) 
Seat 4: Vamoclan (43099 in chips) 
Seat 5: pj0901 (222540 in chips) 
Seat 6: Proosty2 (35228 in chips) 
Seat 7: gibbo888 (214043 in chips) 
Seat 8: mp5610 (118750 in chips) 
lucaromanoo1: posts the ante 750
GUIDAASCANIO: posts the ante 750
supervaganj: posts the ante 750
Vamoclan: posts the ante 750
pj0901: posts the ante 750
Proosty2: posts the ante 750
gibbo888: posts the ante 750
mp5610: posts the ante 750
pj0901: posts small blind 3000
Proosty2: posts big blind 6000
*** HOLE CARDS ***
gibbo888: folds 
mp5610: folds 
lucaromanoo1: folds 
GUIDAASCANIO: folds 
supervaganj: folds 
Vamoclan: folds 
pj0901: raises 36000 to 42000
Proosty2: calls 28478 and is all-in
Uncalled bet (7522) returned to pj0901
*** FLOP *** [6h Jd 9c]
*** TURN *** [6h Jd 9c] [7c]
*** RIVER *** [6h Jd 9c 7c] [Jh]
*** SHOW DOWN ***
pj0901: shows [3h Kh] (a pair of Jacks)
Proosty2: shows [Qd Qh] (two pair, Queens and Jacks)
Proosty2 collected 74956 from pot
*** SUMMARY ***
Total pot 74956 | Rake 0 
Board [6h Jd 9c 7c Jh]
Seat 1: lucaromanoo1 folded before Flop (didn't bet)
Seat 2: GUIDAASCANIO folded before Flop (didn't bet)
Seat 3: supervaganj folded before Flop (didn't bet)
Seat 4: Vamoclan (button) folded before Flop (didn't bet)
Seat 5: pj0901 (small blind) showed [3h Kh] and lost with a pair of Jacks
Seat 6: Proosty2 (big blind) showed [Qd Qh] and won (74956) with two pair, Queens and Jacks
Seat 7: gibbo888 folded before Flop (didn't bet)
Seat 8: mp5610 folded before Flop (didn't bet)

PokerStars Hand #251207195393: Tournament #3767885527, $40+$10+$5 USD Hold'em No Limit - Level XX (3000/6000) - 2024/06/26 20:44:00 UTC [2024/06/26 16:44:00 ET]
Table '3767885527 93' 8-max Seat #5 is the button
Seat 1: lucaromanoo1 (526172 in chips) 
Seat 2: GUIDAASCANIO (79980 in chips) 
Seat 3: supervaganj (79640 in chips) 
Seat 4: Vamoclan (42349 in chips) 
Seat 5: pj0901 (187312 in chips) 
Seat 6: Proosty2 (74956 in chips) 
Seat 7: gibbo888 (213293 in chips) 
Seat 8: mp5610 (118000 in chips) 
lucaromanoo1: posts the ante 750
GUIDAASCANIO: posts the ante 750
supervaganj: posts the ante 750
Vamoclan: posts the ante 750
pj0901: posts the ante 750
Proosty2: posts the ante 750
gibbo888: posts the ante 750
mp5610: posts the ante 750
Proosty2: posts small blind 3000
gibbo888: posts big blind 6000
*** HOLE CARDS ***
mp5610: folds 
lucaromanoo1: folds 
GUIDAASCANIO: folds 
supervaganj: folds 
Vamoclan: folds 
pj0901: folds 
Proosty2: raises 68206 to 74206 and is all-in
gibbo888: calls 68206
*** FLOP *** [2s Js 9c]
*** TURN *** [2s Js 9c] [Ah]
*** RIVER *** [2s Js 9c Ah] [Jh]
*** SHOW DOWN ***
Proosty2: shows [4c Kd] (a pair of Jacks)
gibbo888: shows [Ac Jc] (a full house, Jacks full of Aces)
gibbo888 collected 154412 from pot
Proosty2 finished the tournament in 226th place and received $115.10.
*** SUMMARY ***
Total pot 154412 | Rake 0 
Board [2s Js 9c Ah Jh]
Seat 1: lucaromanoo1 folded before Flop (didn't bet)
Seat 2: GUIDAASCANIO folded before Flop (didn't bet)
Seat 3: supervaganj folded before Flop (didn't bet)
Seat 4: Vamoclan folded before Flop (didn't bet)
Seat 5: pj0901 (button) folded before Flop (didn't bet)
Seat 6: Proosty2 (small blind) showed [4c Kd] and lost with a pair of Jacks
Seat 7: gibbo888 (big blind) showed [Ac Jc] and won (154412) with a full house, Jacks full of Aces
Seat 8: mp5610 folded before Flop (didn't bet)

PokerStars Hand #251207203599: Tournament #3767885527, $40+$10+$5 USD Hold'em No Limit - Level XX (3000/6000) - 2024/06/26 20:44:30 UTC [2024/06/26 16:44:30 ET]
Table '3767885527 93' 8-max Seat #7 is the button
Seat 1: lucaromanoo1 (525422 in chips) 
Seat 2: GUIDAASCANIO (79230 in chips) 
Seat 3: supervaganj (78890 in chips) 
Seat 4: Vamoclan (41599 in chips) 
Seat 5: pj0901 (186562 in chips) 
Seat 7: gibbo888 (292749 in chips) 
Seat 8: mp5610 (117250 in chips) 
lucaromanoo1: posts the ante 750
GUIDAASCANIO: posts the ante 750
supervaganj: posts the ante 750
Vamoclan: posts the ante 750
pj0901: posts the ante 750
gibbo888: posts the ante 750
mp5610: posts the ante 750
mp5610: posts small blind 3000
lucaromanoo1: posts big blind 6000
*** HOLE CARDS ***
GUIDAASCANIO: folds 
supervaganj: folds 
Vamoclan: raises 34849 to 40849 and is all-in
pj0901: folds 
gibbo888: folds 
Biguethi339 is disconnected 
mp5610: folds 
lucaromanoo1: folds 
Uncalled bet (34849) returned to Vamoclan
Vamoclan collected 20250 from pot
Vamoclan: doesn't show hand 
*** SUMMARY ***
Total pot 20250 | Rake 0 
Seat 1: lucaromanoo1 (big blind) folded before Flop
Seat 2: GUIDAASCANIO folded before Flop (didn't bet)
Seat 3: supervaganj folded before Flop (didn't bet)
Seat 4: Vamoclan collected (20250)
Seat 5: pj0901 folded before Flop (didn't bet)
Seat 7: gibbo888 (button) folded before Flop (didn't bet)
Seat 8: mp5610 (small blind) folded before Flop

PokerStars Hand #251207210628: Tournament #3767885527, $40+$10+$5 USD Hold'em No Limit - Level XX (3000/6000) - 2024/06/26 20:44:56 UTC [2024/06/26 16:44:56 ET]
Table '3767885527 93' 8-max Seat #8 is the button
Seat 1: lucaromanoo1 (518672 in chips) 
Seat 2: GUIDAASCANIO (78480 in chips) 
Seat 3: supervaganj (78140 in chips) 
Seat 4: Vamoclan (55099 in chips) 
Seat 5: pj0901 (185812 in chips) 
Seat 6: Biguethi339 (231272 in chips) 
Seat 7: gibbo888 (291999 in chips) 
Seat 8: mp5610 (113500 in chips) 
lucaromanoo1: posts the ante 750
GUIDAASCANIO: posts the ante 750
supervaganj: posts the ante 750
Vamoclan: posts the ante 750
pj0901: posts the ante 750
Biguethi339: posts the ante 750
gibbo888: posts the ante 750
mp5610: posts the ante 750
lucaromanoo1: posts small blind 3000
GUIDAASCANIO: posts big blind 6000
*** HOLE CARDS ***
supervaganj: folds 
Vamoclan: raises 48349 to 54349 and is all-in
pj0901: folds 
Biguethi339: folds 
gibbo888: folds 
mp5610 has timed out
mp5610: folds 
mp5610 is sitting out
lucaromanoo1: folds 
mp5610 has returned
GUIDAASCANIO: folds 
Uncalled bet (48349) returned to Vamoclan
Vamoclan collected 21000 from pot
Vamoclan: doesn't show hand 
*** SUMMARY ***
Total pot 21000 | Rake 0 
Seat 1: lucaromanoo1 (small blind) folded before Flop
Seat 2: GUIDAASCANIO (big blind) folded before Flop
Seat 3: supervaganj folded before Flop (didn't bet)
Seat 4: Vamoclan collected (21000)
Seat 5: pj0901 folded before Flop (didn't bet)
Seat 6: Biguethi339 folded before Flop (didn't bet)
Seat 7: gibbo888 folded before Flop (didn't bet)
Seat 8: mp5610 (button) folded before Flop (didn't bet)

PokerStars Hand #251207225080: Tournament #3767885527, $40+$10+$5 USD Hold'em No Limit - Level XX (3000/6000) - 2024/06/26 20:45:48 UTC [2024/06/26 16:45:48 ET]
Table '3767885527 93' 8-max Seat #1 is the button
Seat 1: lucaromanoo1 (514922 in chips) 
Seat 2: GUIDAASCANIO (71730 in chips) 
Seat 3: supervaganj (77390 in chips) 
Seat 4: Vamoclan (69349 in chips) 
Seat 5: pj0901 (185062 in chips) 
Seat 6: Biguethi339 (230522 in chips) 
Seat 7: gibbo888 (291249 in chips) 
Seat 8: mp5610 (112750 in chips) 
lucaromanoo1: posts the ante 750
GUIDAASCANIO: posts the ante 750
supervaganj: posts the ante 750
Vamoclan: posts the ante 750
pj0901: posts the ante 750
Biguethi339: posts the ante 750
gibbo888: posts the ante 750
mp5610: posts the ante 750
GUIDAASCANIO: posts small blind 3000
supervaganj: posts big blind 6000
*** HOLE CARDS ***
Vamoclan: folds 
pj0901: folds 
Biguethi339: folds 
gibbo888: folds 
mp5610: raises 6000 to 12000
lucaromanoo1: raises 502172 to 514172 and is all-in
GUIDAASCANIO: folds 
supervaganj: folds 
mp5610: folds 
Uncalled bet (502172) returned to lucaromanoo1
lucaromanoo1 collected 39000 from pot
lucaromanoo1: doesn't show hand 
*** SUMMARY ***
Total pot 39000 | Rake 0 
Seat 1: lucaromanoo1 (button) collected (39000)
Seat 2: GUIDAASCANIO (small blind) folded before Flop
Seat 3: supervaganj (big blind) folded before Flop
Seat 4: Vamoclan folded before Flop (didn't bet)
Seat 5: pj0901 folded before Flop (didn't bet)
Seat 6: Biguethi339 folded before Flop (didn't bet)
Seat 7: gibbo888 folded before Flop (didn't bet)
Seat 8: mp5610 folded before Flop

PokerStars Hand #251207233575: Tournament #3767885527, $40+$10+$5 USD Hold'em No Limit - Level XXI (3500/7000) - 2024/06/26 20:46:19 UTC [2024/06/26 16:46:19 ET]
Table '3767885527 93' 8-max Seat #2 is the button
Seat 1: lucaromanoo1 (541172 in chips) 
Seat 2: GUIDAASCANIO (67980 in chips) 
Seat 3: supervaganj (70640 in chips) 
Seat 4: Vamoclan (68599 in chips) 
Seat 5: pj0901 (184312 in chips) 
Seat 6: Biguethi339 (229772 in chips) 
Seat 7: gibbo888 (290499 in chips) 
Seat 8: mp5610 (100000 in chips) 
lucaromanoo1: posts the ante 875
GUIDAASCANIO: posts the ante 875
supervaganj: posts the ante 875
Vamoclan: posts the ante 875
pj0901: posts the ante 875
Biguethi339: posts the ante 875
gibbo888: posts the ante 875
mp5610: posts the ante 875
supervaganj: posts small blind 3500
Vamoclan: posts big blind 7000
*** HOLE CARDS ***
pj0901: folds 
Biguethi339: raises 7000 to 14000
gibbo888: folds 
mp5610: folds 
lucaromanoo1: folds 
GUIDAASCANIO: folds 
supervaganj: raises 55765 to 69765 and is all-in
Vamoclan: folds 
Biguethi339: calls 55765
*** FLOP *** [9s 6h Tc]
*** TURN *** [9s 6h Tc] [Ac]
*** RIVER *** [9s 6h Tc Ac] [4s]
*** SHOW DOWN ***
supervaganj: shows [Kc Qd] (high card Ace)
Biguethi339: shows [9d Td] (two pair, Tens and Nines)
Biguethi339 collected 153530 from pot
supervaganj finished the tournament in 211th place and received $115.10.
*** SUMMARY ***
Total pot 153530 | Rake 0 
Board [9s 6h Tc Ac 4s]
Seat 1: lucaromanoo1 folded before Flop (didn't bet)
Seat 2: GUIDAASCANIO (button) folded before Flop (didn't bet)
Seat 3: supervaganj (small blind) showed [Kc Qd] and lost with high card Ace
Seat 4: Vamoclan (big blind) folded before Flop
Seat 5: pj0901 folded before Flop (didn't bet)
Seat 6: Biguethi339 showed [9d Td] and won (153530) with two pair, Tens and Nines
Seat 7: gibbo888 folded before Flop (didn't bet)
Seat 8: mp5610 folded before Flop (didn't bet)

PokerStars Hand #251207250235: Tournament #3767885527, $40+$10+$5 USD Hold'em No Limit - Level XXI (3500/7000) - 2024/06/26 20:47:19 UTC [2024/06/26 16:47:19 ET]
Table '3767885527 93' 8-max Seat #4 is the button
Seat 1: lucaromanoo1 (540297 in chips) 
Seat 2: GUIDAASCANIO (67105 in chips) 
Seat 4: Vamoclan (60724 in chips) 
Seat 5: pj0901 (183437 in chips) 
Seat 6: Biguethi339 (312662 in chips) 
Seat 7: gibbo888 (289624 in chips) 
Seat 8: mp5610 (99125 in chips) 
lucaromanoo1: posts the ante 875
GUIDAASCANIO: posts the ante 875
Vamoclan: posts the ante 875
pj0901: posts the ante 875
Biguethi339: posts the ante 875
gibbo888: posts the ante 875
mp5610: posts the ante 875
pj0901: posts small blind 3500
Biguethi339: posts big blind 7000
*** HOLE CARDS ***
gibbo888: folds 
mp5610: folds 
lucaromanoo1: folds 
GUIDAASCANIO: folds 
Vamoclan: folds 
pj0901: raises 16100 to 23100
Biguethi339: calls 16100
*** FLOP *** [4h 7d 4d]
pj0901: bets 10500
Biguethi339: calls 10500
*** TURN *** [4h 7d 4d] [Ts]
pj0901: checks 
Biguethi339: checks 
*** RIVER *** [4h 7d 4d Ts] [9d]
pj0901: bets 17500
Biguethi339: folds 
Uncalled bet (17500) returned to pj0901
pj0901 collected 73325 from pot
pj0901: doesn't show hand 
*** SUMMARY ***
Total pot 73325 | Rake 0 
Board [4h 7d 4d Ts 9d]
Seat 1: lucaromanoo1 folded before Flop (didn't bet)
Seat 2: GUIDAASCANIO folded before Flop (didn't bet)
Seat 4: Vamoclan (button) folded before Flop (didn't bet)
Seat 5: pj0901 (small blind) collected (73325)
Seat 6: Biguethi339 (big blind) folded on the River
Seat 7: gibbo888 folded before Flop (didn't bet)
Seat 8: mp5610 folded before Flop (didn't bet)

PokerStars Hand #251207275179: Tournament #3767885527, $40+$10+$5 USD Hold'em No Limit - Level XXI (3500/7000) - 2024/06/26 20:48:50 UTC [2024/06/26 16:48:50 ET]
Table '3767885527 93' 8-max Seat #5 is the button
Seat 1: lucaromanoo1 (539422 in chips) 
Seat 2: GUIDAASCANIO (66230 in chips) 
Seat 4: Vamoclan (59849 in chips) 
Seat 5: pj0901 (222287 in chips) 
Seat 6: Biguethi339 (278187 in chips) 
Seat 7: gibbo888 (288749 in chips) 
Seat 8: mp5610 (98250 in chips) 
lucaromanoo1: posts the ante 875
GUIDAASCANIO: posts the ante 875
Vamoclan: posts the ante 875
pj0901: posts the ante 875
Biguethi339: posts the ante 875
gibbo888: posts the ante 875
mp5610: posts the ante 875
Biguethi339: posts small blind 3500
gibbo888: posts big blind 7000
*** HOLE CARDS ***
mp5610: folds 
lucaromanoo1: folds 
GUIDAASCANIO: raises 49000 to 56000
Lenon318 is disconnected 
Vamoclan: folds 
pj0901: folds 
Biguethi339: folds 
gibbo888: folds 
Uncalled bet (49000) returned to GUIDAASCANIO
GUIDAASCANIO collected 23625 from pot
GUIDAASCANIO: doesn't show hand 
*** SUMMARY ***
Total pot 23625 | Rake 0 
Seat 1: lucaromanoo1 folded before Flop (didn't bet)
Seat 2: GUIDAASCANIO collected (23625)
Seat 4: Vamoclan folded before Flop (didn't bet)
Seat 5: pj0901 (button) folded before Flop (didn't bet)
Seat 6: Biguethi339 (small blind) folded before Flop
Seat 7: gibbo888 (big blind) folded before Flop
Seat 8: mp5610 folded before Flop (didn't bet)

PokerStars Hand #251207281379: Tournament #3767885527, $40+$10+$5 USD Hold'em No Limit - Level XXI (3500/7000) - 2024/06/26 20:49:13 UTC [2024/06/26 16:49:13 ET]
Table '3767885527 93' 8-max Seat #6 is the button
Seat 1: lucaromanoo1 (538547 in chips) 
Seat 2: GUIDAASCANIO (81980 in chips) 
Seat 3: Lenon318 (58738 in chips) 
Seat 4: Vamoclan (58974 in chips) 
Seat 5: pj0901 (221412 in chips) 
Seat 6: Biguethi339 (273812 in chips) 
Seat 7: gibbo888 (280874 in chips) 
Seat 8: mp5610 (97375 in chips) 
lucaromanoo1: posts the ante 875
GUIDAASCANIO: posts the ante 875
Lenon318: posts the ante 875
Vamoclan: posts the ante 875
pj0901: posts the ante 875
Biguethi339: posts the ante 875
gibbo888: posts the ante 875
mp5610: posts the ante 875
gibbo888: posts small blind 3500
mp5610: posts big blind 7000
*** HOLE CARDS ***
lucaromanoo1: folds 
GUIDAASCANIO: folds 
Lenon318: folds 
Vamoclan: folds 
pj0901: raises 7000 to 14000
Biguethi339: folds 
gibbo888: folds 
mp5610: raises 82500 to 96500 and is all-in
pj0901: folds 
Uncalled bet (82500) returned to mp5610
mp5610 collected 38500 from pot
*** SUMMARY ***
Total pot 38500 | Rake 0 
Seat 1: lucaromanoo1 folded before Flop (didn't bet)
Seat 2: GUIDAASCANIO folded before Flop (didn't bet)
Seat 3: Lenon318 folded before Flop (didn't bet)
Seat 4: Vamoclan folded before Flop (didn't bet)
Seat 5: pj0901 folded before Flop
Seat 6: Biguethi339 (button) folded before Flop (didn't bet)
Seat 7: gibbo888 (small blind) folded before Flop
Seat 8: mp5610 (big blind) collected (38500)

PokerStars Hand #251207289474: Tournament #3767885527, $40+$10+$5 USD Hold'em No Limit - Level XXI (3500/7000) - 2024/06/26 20:49:42 UTC [2024/06/26 16:49:42 ET]
Table '3767885527 93' 8-max Seat #7 is the button
Seat 1: lucaromanoo1 (537672 in chips) 
Seat 2: GUIDAASCANIO (81105 in chips) 
Seat 3: Lenon318 (57863 in chips) 
Seat 4: Vamoclan (58099 in chips) 
Seat 5: pj0901 (206537 in chips) 
Seat 6: Biguethi339 (272937 in chips) 
Seat 7: gibbo888 (276499 in chips) 
Seat 8: mp5610 (121000 in chips) 
lucaromanoo1: posts the ante 875
GUIDAASCANIO: posts the ante 875
Lenon318: posts the ante 875
Vamoclan: posts the ante 875
pj0901: posts the ante 875
Biguethi339: posts the ante 875
gibbo888: posts the ante 875
mp5610: posts the ante 875
mp5610: posts small blind 3500
lucaromanoo1: posts big blind 7000
*** HOLE CARDS ***
GUIDAASCANIO: folds 
Lenon318: folds 
Vamoclan: folds 
pj0901: raises 7000 to 14000
Biguethi339: raises 24500 to 38500
gibbo888: folds 
mp5610: folds 
lucaromanoo1: folds 
pj0901: raises 167162 to 205662 and is all-in
Biguethi339: calls 167162
*** FLOP *** [4h 6c 3s]
*** TURN *** [4h 6c 3s] [Tc]
*** RIVER *** [4h 6c 3s Tc] [8h]
*** SHOW DOWN ***
pj0901: shows [As Qh] (high card Ace)
Biguethi339: shows [Ks Kh] (a pair of Kings)
Biguethi339 collected 428824 from pot
pj0901 finished the tournament in 203rd place and received $115.10.
*** SUMMARY ***
Total pot 428824 | Rake 0 
Board [4h 6c 3s Tc 8h]
Seat 1: lucaromanoo1 (big blind) folded before Flop
Seat 2: GUIDAASCANIO folded before Flop (didn't bet)
Seat 3: Lenon318 folded before Flop (didn't bet)
Seat 4: Vamoclan folded before Flop (didn't bet)
Seat 5: pj0901 showed [As Qh] and lost with high card Ace
Seat 6: Biguethi339 showed [Ks Kh] and won (428824) with a pair of Kings
Seat 7: gibbo888 (button) folded before Flop (didn't bet)
Seat 8: mp5610 (small blind) folded before Flop

PokerStars Hand #251207302695: Tournament #3767885527, $40+$10+$5 USD Hold'em No Limit - Level XXI (3500/7000) - 2024/06/26 20:50:32 UTC [2024/06/26 16:50:32 ET]
Table '3767885527 93' 8-max Seat #8 is the button
Seat 1: lucaromanoo1 (529797 in chips) 
Seat 2: GUIDAASCANIO (80230 in chips) 
Seat 3: Lenon318 (56988 in chips) 
Seat 4: Vamoclan (57224 in chips) 
Seat 6: Biguethi339 (495224 in chips) 
Seat 7: gibbo888 (275624 in chips) 
Seat 8: mp5610 (116625 in chips) 
lucaromanoo1: posts the ante 875
GUIDAASCANIO: posts the ante 875
Lenon318: posts the ante 875
Vamoclan: posts the ante 875
Biguethi339: posts the ante 875
gibbo888: posts the ante 875
mp5610: posts the ante 875
lucaromanoo1: posts small blind 3500
GUIDAASCANIO: posts big blind 7000
*** HOLE CARDS ***
Lenon318: folds 
Vamoclan: raises 49349 to 56349 and is all-in
Biguethi339: folds 
gibbo888: folds 
mp5610: folds 
lucaromanoo1: raises 49349 to 105698
GUIDAASCANIO: folds 
Uncalled bet (49349) returned to lucaromanoo1
*** FLOP *** [5c As Th]
*** TURN *** [5c As Th] [7c]
*** RIVER *** [5c As Th 7c] [Kc]
*** SHOW DOWN ***
lucaromanoo1: shows [8d Ad] (a pair of Aces)
Vamoclan: shows [Kh Qs] (a pair of Kings)
lucaromanoo1 collected 125823 from pot
Vamoclan finished the tournament in 201st place and received $115.10.
*** SUMMARY ***
Total pot 125823 | Rake 0 
Board [5c As Th 7c Kc]
Seat 1: lucaromanoo1 (small blind) showed [8d Ad] and won (125823) with a pair of Aces
Seat 2: GUIDAASCANIO (big blind) folded before Flop
Seat 3: Lenon318 folded before Flop (didn't bet)
Seat 4: Vamoclan showed [Kh Qs] and lost with a pair of Kings
Seat 6: Biguethi339 folded before Flop (didn't bet)
Seat 7: gibbo888 folded before Flop (didn't bet)
Seat 8: mp5610 (button) folded before Flop (didn't bet)


PokerStars Hand #251205833491: Tournament #3767885527, $40+$10+$5 USD Hold'em No Limit - Level XIII (800/1600) - 2024/06/26 19:21:07 UTC [2024/06/26 15:21:07 ET]
Table '3767885527 92' 8-max Seat #7 is the button
Seat 1: SOUFODAMS (112349 in chips) 
Seat 2: Mr Pay Shent (39982 in chips) 
Seat 3: Pseudo Fruto (57997 in chips) 
Seat 4: RenanToniolo (132439 in chips) 
Seat 5: milkytravis (43402 in chips) 
Seat 6: sunn¥m4nn (44950 in chips) 
Seat 7: podiiii (48875 in chips) 
Seat 8: EDY R44 (36817 in chips) 
SOUFODAMS: posts the ante 200
Mr Pay Shent: posts the ante 200
Pseudo Fruto: posts the ante 200
RenanToniolo: posts the ante 200
milkytravis: posts the ante 200
sunn¥m4nn: posts the ante 200
podiiii: posts the ante 200
EDY R44: posts the ante 200
EDY R44: posts small blind 800
SOUFODAMS: posts big blind 1600
*** HOLE CARDS ***
Mr Pay Shent: folds 
Pseudo Fruto: raises 1600 to 3200
RenanToniolo: folds 
milkytravis: folds 
sunn¥m4nn: folds 
podiiii: folds 
EDY R44: calls 2400
SOUFODAMS: calls 1600
*** FLOP *** [2h Ac Ah]
EDY R44: checks 
SOUFODAMS: checks 
Pseudo Fruto: bets 3024
EDY R44: raises 3024 to 6048
SOUFODAMS: folds 
Pseudo Fruto: raises 5152 to 11200
EDY R44: raises 22217 to 33417 and is all-in
Pseudo Fruto: calls 22217
*** TURN *** [2h Ac Ah] [7d]
*** RIVER *** [2h Ac Ah 7d] [8s]
*** SHOW DOWN ***
EDY R44: shows [6s 7s] (two pair, Aces and Sevens)
Pseudo Fruto: shows [Jc As] (three of a kind, Aces)
Pseudo Fruto collected 78034 from pot
EDY R44 finished the tournament
*** SUMMARY ***
Total pot 78034 | Rake 0 
Board [2h Ac Ah 7d 8s]
Seat 1: SOUFODAMS (big blind) folded on the Flop
Seat 2: Mr Pay Shent folded before Flop (didn't bet)
Seat 3: Pseudo Fruto showed [Jc As] and won (78034) with three of a kind, Aces
Seat 4: RenanToniolo folded before Flop (didn't bet)
Seat 5: milkytravis folded before Flop (didn't bet)
Seat 6: sunn¥m4nn folded before Flop (didn't bet)
Seat 7: podiiii (button) folded before Flop (didn't bet)
Seat 8: EDY R44 (small blind) showed [6s 7s] and lost with two pair, Aces and Sevens

PokerStars Hand #251205863449: Tournament #3767885527, $40+$10+$5 USD Hold'em No Limit - Level XIII (800/1600) - 2024/06/26 19:22:57 UTC [2024/06/26 15:22:57 ET]
Table '3767885527 92' 8-max Seat #1 is the button
Seat 1: SOUFODAMS (108949 in chips) 
Seat 2: Mr Pay Shent (39782 in chips) 
Seat 3: Pseudo Fruto (99214 in chips) 
Seat 4: RenanToniolo (132239 in chips) 
Seat 5: milkytravis (43202 in chips) 
Seat 6: sunn¥m4nn (44750 in chips) 
Seat 7: podiiii (48675 in chips) 
SOUFODAMS: posts the ante 200
Mr Pay Shent: posts the ante 200
Pseudo Fruto: posts the ante 200
RenanToniolo: posts the ante 200
milkytravis: posts the ante 200
sunn¥m4nn: posts the ante 200
podiiii: posts the ante 200
Mr Pay Shent: posts small blind 800
Pseudo Fruto: posts big blind 1600
*** HOLE CARDS ***
RenanToniolo: folds 
milkytravis: folds 
sunn¥m4nn: folds 
podiiii: raises 1600 to 3200
SOUFODAMS: raises 6400 to 9600
Mr Pay Shent: folds 
Pseudo Fruto: folds 
podiiii: folds 
Uncalled bet (6400) returned to SOUFODAMS
SOUFODAMS collected 10200 from pot
SOUFODAMS: doesn't show hand 
*** SUMMARY ***
Total pot 10200 | Rake 0 
Seat 1: SOUFODAMS (button) collected (10200)
Seat 2: Mr Pay Shent (small blind) folded before Flop
Seat 3: Pseudo Fruto (big blind) folded before Flop
Seat 4: RenanToniolo folded before Flop (didn't bet)
Seat 5: milkytravis folded before Flop (didn't bet)
Seat 6: sunn¥m4nn folded before Flop (didn't bet)
Seat 7: podiiii folded before Flop

PokerStars Hand #251205877007: Tournament #3767885527, $40+$10+$5 USD Hold'em No Limit - Level XIII (800/1600) - 2024/06/26 19:23:46 UTC [2024/06/26 15:23:46 ET]
Table '3767885527 92' 8-max Seat #2 is the button
Seat 1: SOUFODAMS (115749 in chips) 
Seat 2: Mr Pay Shent (38782 in chips) 
Seat 3: Pseudo Fruto (97414 in chips) 
Seat 4: RenanToniolo (132039 in chips) 
Seat 5: milkytravis (43002 in chips) 
Seat 6: sunn¥m4nn (44550 in chips) 
Seat 7: podiiii (45275 in chips) 
Seat 8: robertzrc (25000 in chips) 
SOUFODAMS: posts the ante 200
Mr Pay Shent: posts the ante 200
Pseudo Fruto: posts the ante 200
RenanToniolo: posts the ante 200
milkytravis: posts the ante 200
sunn¥m4nn: posts the ante 200
podiiii: posts the ante 200
robertzrc: posts the ante 200
Pseudo Fruto: posts small blind 800
RenanToniolo: posts big blind 1600
*** HOLE CARDS ***
milkytravis: folds 
sunn¥m4nn: raises 1600 to 3200
podiiii: folds 
robertzrc: folds 
SOUFODAMS: folds 
Mr Pay Shent: folds 
Pseudo Fruto: folds 
RenanToniolo: calls 1600
*** FLOP *** [4h As 9h]
RenanToniolo: checks 
sunn¥m4nn: bets 2904
RenanToniolo: calls 2904
*** TURN *** [4h As 9h] [Kh]
RenanToniolo: checks 
sunn¥m4nn: bets 7304
RenanToniolo: calls 7304
*** RIVER *** [4h As 9h Kh] [8c]
RenanToniolo: checks 
sunn¥m4nn: bets 30942 and is all-in
RenanToniolo: calls 30942
*** SHOW DOWN ***
sunn¥m4nn: shows [Th Jh] (a flush, King high)
RenanToniolo: shows [Ah Ad] (three of a kind, Aces)
sunn¥m4nn collected 91100 from pot
*** SUMMARY ***
Total pot 91100 | Rake 0 
Board [4h As 9h Kh 8c]
Seat 1: SOUFODAMS folded before Flop (didn't bet)
Seat 2: Mr Pay Shent (button) folded before Flop (didn't bet)
Seat 3: Pseudo Fruto (small blind) folded before Flop
Seat 4: RenanToniolo (big blind) showed [Ah Ad] and lost with three of a kind, Aces
Seat 5: milkytravis folded before Flop (didn't bet)
Seat 6: sunn¥m4nn showed [Th Jh] and won (91100) with a flush, King high
Seat 7: podiiii folded before Flop (didn't bet)
Seat 8: robertzrc folded before Flop (didn't bet)

PokerStars Hand #251205905698: Tournament #3767885527, $40+$10+$5 USD Hold'em No Limit - Level XIII (800/1600) - 2024/06/26 19:25:30 UTC [2024/06/26 15:25:30 ET]
Table '3767885527 92' 8-max Seat #3 is the button
Seat 1: SOUFODAMS (115549 in chips) 
Seat 2: Mr Pay Shent (38582 in chips) 
Seat 3: Pseudo Fruto (96414 in chips) 
Seat 4: RenanToniolo (87489 in chips) 
Seat 5: milkytravis (42802 in chips) 
Seat 6: sunn¥m4nn (91100 in chips) 
Seat 7: podiiii (45075 in chips) 
Seat 8: robertzrc (24800 in chips) 
SOUFODAMS: posts the ante 200
Mr Pay Shent: posts the ante 200
Pseudo Fruto: posts the ante 200
RenanToniolo: posts the ante 200
milkytravis: posts the ante 200
sunn¥m4nn: posts the ante 200
podiiii: posts the ante 200
robertzrc: posts the ante 200
RenanToniolo: posts small blind 800
milkytravis: posts big blind 1600
*** HOLE CARDS ***
sunn¥m4nn: folds 
podiiii: folds 
robertzrc: folds 
SOUFODAMS: folds 
Mr Pay Shent: folds 
Pseudo Fruto: raises 1600 to 3200
RenanToniolo: folds 
milkytravis: calls 1600
*** FLOP *** [2s Kc 5d]
milkytravis: checks 
Pseudo Fruto: bets 2376
milkytravis: folds 
Uncalled bet (2376) returned to Pseudo Fruto
Pseudo Fruto collected 8800 from pot
Pseudo Fruto: doesn't show hand 
*** SUMMARY ***
Total pot 8800 | Rake 0 
Board [2s Kc 5d]
Seat 1: SOUFODAMS folded before Flop (didn't bet)
Seat 2: Mr Pay Shent folded before Flop (didn't bet)
Seat 3: Pseudo Fruto (button) collected (8800)
Seat 4: RenanToniolo (small blind) folded before Flop
Seat 5: milkytravis (big blind) folded on the Flop
Seat 6: sunn¥m4nn folded before Flop (didn't bet)
Seat 7: podiiii folded before Flop (didn't bet)
Seat 8: robertzrc folded before Flop (didn't bet)

PokerStars Hand #251205915217: Tournament #3767885527, $40+$10+$5 USD Hold'em No Limit - Level XIII (800/1600) - 2024/06/26 19:26:05 UTC [2024/06/26 15:26:05 ET]
Table '3767885527 92' 8-max Seat #4 is the button
Seat 1: SOUFODAMS (115349 in chips) 
Seat 2: Mr Pay Shent (38382 in chips) 
Seat 3: Pseudo Fruto (101814 in chips) 
Seat 4: RenanToniolo (86489 in chips) 
Seat 5: milkytravis (39402 in chips) 
Seat 6: sunn¥m4nn (90900 in chips) 
Seat 7: podiiii (44875 in chips) 
Seat 8: robertzrc (24600 in chips) 
SOUFODAMS: posts the ante 200
Mr Pay Shent: posts the ante 200
Pseudo Fruto: posts the ante 200
RenanToniolo: posts the ante 200
milkytravis: posts the ante 200
sunn¥m4nn: posts the ante 200
podiiii: posts the ante 200
robertzrc: posts the ante 200
milkytravis: posts small blind 800
sunn¥m4nn: posts big blind 1600
*** HOLE CARDS ***
podiiii: folds 
robertzrc: folds 
SOUFODAMS: folds 
Mr Pay Shent: folds 
Pseudo Fruto: folds 
RenanToniolo: raises 1600 to 3200
milkytravis: folds 
sunn¥m4nn: calls 1600
*** FLOP *** [7h 9s 9c]
sunn¥m4nn: checks 
RenanToniolo: checks 
*** TURN *** [7h 9s 9c] [2h]
sunn¥m4nn: checks 
RenanToniolo: bets 2200
sunn¥m4nn: folds 
Uncalled bet (2200) returned to RenanToniolo
RenanToniolo collected 8800 from pot
*** SUMMARY ***
Total pot 8800 | Rake 0 
Board [7h 9s 9c 2h]
Seat 1: SOUFODAMS folded before Flop (didn't bet)
Seat 2: Mr Pay Shent folded before Flop (didn't bet)
Seat 3: Pseudo Fruto folded before Flop (didn't bet)
Seat 4: RenanToniolo (button) collected (8800)
Seat 5: milkytravis (small blind) folded before Flop
Seat 6: sunn¥m4nn (big blind) folded on the Turn
Seat 7: podiiii folded before Flop (didn't bet)
Seat 8: robertzrc folded before Flop (didn't bet)

PokerStars Hand #251205933091: Tournament #3767885527, $40+$10+$5 USD Hold'em No Limit - Level XIII (800/1600) - 2024/06/26 19:27:10 UTC [2024/06/26 15:27:10 ET]
Table '3767885527 92' 8-max Seat #5 is the button
Seat 1: SOUFODAMS (115149 in chips) 
Seat 2: Mr Pay Shent (38182 in chips) 
Seat 3: Pseudo Fruto (101614 in chips) 
Seat 4: RenanToniolo (91889 in chips) 
Seat 5: milkytravis (38402 in chips) 
Seat 6: sunn¥m4nn (87500 in chips) 
Seat 7: podiiii (44675 in chips) 
Seat 8: robertzrc (24400 in chips) 
SOUFODAMS: posts the ante 200
Mr Pay Shent: posts the ante 200
Pseudo Fruto: posts the ante 200
RenanToniolo: posts the ante 200
milkytravis: posts the ante 200
sunn¥m4nn: posts the ante 200
podiiii: posts the ante 200
robertzrc: posts the ante 200
sunn¥m4nn: posts small blind 800
podiiii: posts big blind 1600
*** HOLE CARDS ***
robertzrc: calls 1600
SOUFODAMS: folds 
Mr Pay Shent: folds 
Pseudo Fruto: raises 1600 to 3200
RenanToniolo: folds 
milkytravis: folds 
sunn¥m4nn: folds 
podiiii: folds 
robertzrc: calls 1600
*** FLOP *** [As 8d 3d]
robertzrc: checks 
Pseudo Fruto: bets 2808
robertzrc: folds 
Uncalled bet (2808) returned to Pseudo Fruto
Pseudo Fruto collected 10400 from pot
Pseudo Fruto: doesn't show hand 
*** SUMMARY ***
Total pot 10400 | Rake 0 
Board [As 8d 3d]
Seat 1: SOUFODAMS folded before Flop (didn't bet)
Seat 2: Mr Pay Shent folded before Flop (didn't bet)
Seat 3: Pseudo Fruto collected (10400)
Seat 4: RenanToniolo folded before Flop (didn't bet)
Seat 5: milkytravis (button) folded before Flop (didn't bet)
Seat 6: sunn¥m4nn (small blind) folded before Flop
Seat 7: podiiii (big blind) folded before Flop
Seat 8: robertzrc folded on the Flop

PokerStars Hand #251205948757: Tournament #3767885527, $40+$10+$5 USD Hold'em No Limit - Level XIII (800/1600) - 2024/06/26 19:28:09 UTC [2024/06/26 15:28:09 ET]
Table '3767885527 92' 8-max Seat #6 is the button
Seat 1: SOUFODAMS (114949 in chips) 
Seat 2: Mr Pay Shent (37982 in chips) 
Seat 3: Pseudo Fruto (108614 in chips) 
Seat 4: RenanToniolo (91689 in chips) 
Seat 5: milkytravis (38202 in chips) 
Seat 6: sunn¥m4nn (86500 in chips) 
Seat 7: podiiii (42875 in chips) 
Seat 8: robertzrc (21000 in chips) 
SOUFODAMS: posts the ante 200
Mr Pay Shent: posts the ante 200
Pseudo Fruto: posts the ante 200
RenanToniolo: posts the ante 200
milkytravis: posts the ante 200
sunn¥m4nn: posts the ante 200
podiiii: posts the ante 200
robertzrc: posts the ante 200
podiiii: posts small blind 800
robertzrc: posts big blind 1600
*** HOLE CARDS ***
SOUFODAMS: folds 
Mr Pay Shent: folds 
Pseudo Fruto: folds 
RenanToniolo: raises 1600 to 3200
milkytravis: folds 
sunn¥m4nn: calls 3200
podiiii: folds 
robertzrc: calls 1600
*** FLOP *** [Th 4h 9d]
robertzrc: bets 3200
RenanToniolo: folds 
sunn¥m4nn: calls 3200
*** TURN *** [Th 4h 9d] [Ac]
robertzrc: checks 
sunn¥m4nn: checks 
*** RIVER *** [Th 4h 9d Ac] [8h]
robertzrc: checks 
sunn¥m4nn: checks 
*** SHOW DOWN ***
robertzrc: shows [7c 4c] (a pair of Fours)
sunn¥m4nn: shows [9s Ks] (a pair of Nines)
sunn¥m4nn collected 18400 from pot
*** SUMMARY ***
Total pot 18400 | Rake 0 
Board [Th 4h 9d Ac 8h]
Seat 1: SOUFODAMS folded before Flop (didn't bet)
Seat 2: Mr Pay Shent folded before Flop (didn't bet)
Seat 3: Pseudo Fruto folded before Flop (didn't bet)
Seat 4: RenanToniolo folded on the Flop
Seat 5: milkytravis folded before Flop (didn't bet)
Seat 6: sunn¥m4nn (button) showed [9s Ks] and won (18400) with a pair of Nines
Seat 7: podiiii (small blind) folded before Flop
Seat 8: robertzrc (big blind) showed [7c 4c] and lost with a pair of Fours

PokerStars Hand #251205969714: Tournament #3767885527, $40+$10+$5 USD Hold'em No Limit - Level XIV (1000/2000) - 2024/06/26 19:29:27 UTC [2024/06/26 15:29:27 ET]
Table '3767885527 92' 8-max Seat #7 is the button
Seat 1: SOUFODAMS (114749 in chips) 
Seat 2: Mr Pay Shent (37782 in chips) 
Seat 3: Pseudo Fruto (108414 in chips) 
Seat 4: RenanToniolo (88289 in chips) 
Seat 5: milkytravis (38002 in chips) 
Seat 6: sunn¥m4nn (98300 in chips) 
Seat 7: podiiii (41875 in chips) 
Seat 8: robertzrc (14400 in chips) 
SOUFODAMS: posts the ante 250
Mr Pay Shent: posts the ante 250
Pseudo Fruto: posts the ante 250
RenanToniolo: posts the ante 250
milkytravis: posts the ante 250
sunn¥m4nn: posts the ante 250
podiiii: posts the ante 250
robertzrc: posts the ante 250
robertzrc: posts small blind 1000
SOUFODAMS: posts big blind 2000
*** HOLE CARDS ***
Mr Pay Shent: folds 
Pseudo Fruto: folds 
RenanToniolo: folds 
milkytravis: raises 2000 to 4000
sunn¥m4nn: raises 5000 to 9000
podiiii: folds 
robertzrc: raises 5150 to 14150 and is all-in
SOUFODAMS: folds 
milkytravis: folds 
sunn¥m4nn: calls 5150
*** FLOP *** [7h Qc 5h]
*** TURN *** [7h Qc 5h] [9c]
*** RIVER *** [7h Qc 5h 9c] [7s]
*** SHOW DOWN ***
robertzrc: shows [3s Js] (a pair of Sevens)
sunn¥m4nn: shows [Td As] (a pair of Sevens - Ace kicker)
sunn¥m4nn collected 36300 from pot
robertzrc finished the tournament
*** SUMMARY ***
Total pot 36300 | Rake 0 
Board [7h Qc 5h 9c 7s]
Seat 1: SOUFODAMS (big blind) folded before Flop
Seat 2: Mr Pay Shent folded before Flop (didn't bet)
Seat 3: Pseudo Fruto folded before Flop (didn't bet)
Seat 4: RenanToniolo folded before Flop (didn't bet)
Seat 5: milkytravis folded before Flop
Seat 6: sunn¥m4nn showed [Td As] and won (36300) with a pair of Sevens
Seat 7: podiiii (button) folded before Flop (didn't bet)
Seat 8: robertzrc (small blind) showed [3s Js] and lost with a pair of Sevens

PokerStars Hand #251205985301: Tournament #3767885527, $40+$10+$5 USD Hold'em No Limit - Level XIV (1000/2000) - 2024/06/26 19:30:24 UTC [2024/06/26 15:30:24 ET]
Table '3767885527 92' 8-max Seat #1 is the button
Seat 1: SOUFODAMS (112499 in chips) 
Seat 2: Mr Pay Shent (37532 in chips) 
Seat 3: Pseudo Fruto (108164 in chips) 
Seat 4: RenanToniolo (88039 in chips) 
Seat 5: milkytravis (33752 in chips) 
Seat 6: sunn¥m4nn (120200 in chips) 
Seat 7: podiiii (41625 in chips) 
SOUFODAMS: posts the ante 250
Mr Pay Shent: posts the ante 250
Pseudo Fruto: posts the ante 250
RenanToniolo: posts the ante 250
milkytravis: posts the ante 250
sunn¥m4nn: posts the ante 250
podiiii: posts the ante 250
Mr Pay Shent: posts small blind 1000
Pseudo Fruto: posts big blind 2000
*** HOLE CARDS ***
RenanToniolo: folds 
milkytravis: folds 
sunn¥m4nn: folds 
podiiii: folds 
SOUFODAMS: folds 
drmentrop is disconnected 
Mr Pay Shent: calls 1000
Pseudo Fruto: raises 105914 to 107914 and is all-in
Mr Pay Shent: folds 
Uncalled bet (105914) returned to Pseudo Fruto
Pseudo Fruto collected 5750 from pot
Pseudo Fruto: doesn't show hand 
*** SUMMARY ***
Total pot 5750 | Rake 0 
Seat 1: SOUFODAMS (button) folded before Flop (didn't bet)
Seat 2: Mr Pay Shent (small blind) folded before Flop
Seat 3: Pseudo Fruto (big blind) collected (5750)
Seat 4: RenanToniolo folded before Flop (didn't bet)
Seat 5: milkytravis folded before Flop (didn't bet)
Seat 6: sunn¥m4nn folded before Flop (didn't bet)
Seat 7: podiiii folded before Flop (didn't bet)

PokerStars Hand #251205995437: Tournament #3767885527, $40+$10+$5 USD Hold'em No Limit - Level XIV (1000/2000) - 2024/06/26 19:31:01 UTC [2024/06/26 15:31:01 ET]
Table '3767885527 92' 8-max Seat #2 is the button
Seat 1: SOUFODAMS (112249 in chips) 
Seat 2: Mr Pay Shent (35282 in chips) 
Seat 3: Pseudo Fruto (111664 in chips) 
Seat 4: RenanToniolo (87789 in chips) 
Seat 5: milkytravis (33502 in chips) 
Seat 6: sunn¥m4nn (119950 in chips) 
Seat 7: podiiii (41375 in chips) 
Seat 8: drmentrop (25000 in chips) 
SOUFODAMS: posts the ante 250
Mr Pay Shent: posts the ante 250
Pseudo Fruto: posts the ante 250
RenanToniolo: posts the ante 250
milkytravis: posts the ante 250
sunn¥m4nn: posts the ante 250
podiiii: posts the ante 250
drmentrop: posts the ante 250
Pseudo Fruto: posts small blind 1000
RenanToniolo: posts big blind 2000
*** HOLE CARDS ***
milkytravis: folds 
sunn¥m4nn: folds 
podiiii: folds 
drmentrop: folds 
SOUFODAMS: folds 
Mr Pay Shent: folds 
Pseudo Fruto: folds 
Uncalled bet (1000) returned to RenanToniolo
RenanToniolo collected 4000 from pot
*** SUMMARY ***
Total pot 4000 | Rake 0 
Seat 1: SOUFODAMS folded before Flop (didn't bet)
Seat 2: Mr Pay Shent (button) folded before Flop (didn't bet)
Seat 3: Pseudo Fruto (small blind) folded before Flop
Seat 4: RenanToniolo (big blind) collected (4000)
Seat 5: milkytravis folded before Flop (didn't bet)
Seat 6: sunn¥m4nn folded before Flop (didn't bet)
Seat 7: podiiii folded before Flop (didn't bet)
Seat 8: drmentrop folded before Flop (didn't bet)

PokerStars Hand #251206001748: Tournament #3767885527, $40+$10+$5 USD Hold'em No Limit - Level XIV (1000/2000) - 2024/06/26 19:31:24 UTC [2024/06/26 15:31:24 ET]
Table '3767885527 92' 8-max Seat #3 is the button
Seat 1: SOUFODAMS (111999 in chips) 
Seat 2: Mr Pay Shent (35032 in chips) 
Seat 3: Pseudo Fruto (110414 in chips) 
Seat 4: RenanToniolo (90539 in chips) 
Seat 5: milkytravis (33252 in chips) 
Seat 6: sunn¥m4nn (119700 in chips) 
Seat 7: podiiii (41125 in chips) 
Seat 8: drmentrop (24750 in chips) 
SOUFODAMS: posts the ante 250
Mr Pay Shent: posts the ante 250
Pseudo Fruto: posts the ante 250
RenanToniolo: posts the ante 250
milkytravis: posts the ante 250
sunn¥m4nn: posts the ante 250
podiiii: posts the ante 250
drmentrop: posts the ante 250
RenanToniolo: posts small blind 1000
milkytravis: posts big blind 2000
*** HOLE CARDS ***
sunn¥m4nn: folds 
podiiii: folds 
drmentrop: folds 
SOUFODAMS: folds 
Mr Pay Shent: folds 
Pseudo Fruto: folds 
RenanToniolo: raises 4000 to 6000
milkytravis: raises 27002 to 33002 and is all-in
RenanToniolo: folds 
Uncalled bet (27002) returned to milkytravis
milkytravis collected 14000 from pot
milkytravis: doesn't show hand 
*** SUMMARY ***
Total pot 14000 | Rake 0 
Seat 1: SOUFODAMS folded before Flop (didn't bet)
Seat 2: Mr Pay Shent folded before Flop (didn't bet)
Seat 3: Pseudo Fruto (button) folded before Flop (didn't bet)
Seat 4: RenanToniolo (small blind) folded before Flop
Seat 5: milkytravis (big blind) collected (14000)
Seat 6: sunn¥m4nn folded before Flop (didn't bet)
Seat 7: podiiii folded before Flop (didn't bet)
Seat 8: drmentrop folded before Flop (didn't bet)

PokerStars Hand #251206012555: Tournament #3767885527, $40+$10+$5 USD Hold'em No Limit - Level XIV (1000/2000) - 2024/06/26 19:32:03 UTC [2024/06/26 15:32:03 ET]
Table '3767885527 92' 8-max Seat #4 is the button
Seat 1: SOUFODAMS (111749 in chips) 
Seat 2: Mr Pay Shent (34782 in chips) 
Seat 3: Pseudo Fruto (110164 in chips) 
Seat 4: RenanToniolo (84289 in chips) 
Seat 5: milkytravis (41002 in chips) 
Seat 6: sunn¥m4nn (119450 in chips) 
Seat 7: podiiii (40875 in chips) 
Seat 8: drmentrop (24500 in chips) 
SOUFODAMS: posts the ante 250
Mr Pay Shent: posts the ante 250
Pseudo Fruto: posts the ante 250
RenanToniolo: posts the ante 250
milkytravis: posts the ante 250
sunn¥m4nn: posts the ante 250
podiiii: posts the ante 250
drmentrop: posts the ante 250
milkytravis: posts small blind 1000
sunn¥m4nn: posts big blind 2000
*** HOLE CARDS ***
podiiii: folds 
drmentrop: raises 22250 to 24250 and is all-in
SOUFODAMS: folds 
Mr Pay Shent: folds 
Pseudo Fruto: calls 24250
RenanToniolo: folds 
milkytravis: folds 
sunn¥m4nn: folds 
*** FLOP *** [Jd Th 8c]
*** TURN *** [Jd Th 8c] [As]
*** RIVER *** [Jd Th 8c As] [3s]
*** SHOW DOWN ***
drmentrop: shows [Ah 7c] (a pair of Aces)
Pseudo Fruto: shows [Qc Qh] (a pair of Queens)
drmentrop collected 53500 from pot
*** SUMMARY ***
Total pot 53500 | Rake 0 
Board [Jd Th 8c As 3s]
Seat 1: SOUFODAMS folded before Flop (didn't bet)
Seat 2: Mr Pay Shent folded before Flop (didn't bet)
Seat 3: Pseudo Fruto showed [Qc Qh] and lost with a pair of Queens
Seat 4: RenanToniolo (button) folded before Flop (didn't bet)
Seat 5: milkytravis (small blind) folded before Flop
Seat 6: sunn¥m4nn (big blind) folded before Flop
Seat 7: podiiii folded before Flop (didn't bet)
Seat 8: drmentrop showed [Ah 7c] and won (53500) with a pair of Aces

PokerStars Hand #251206021497: Tournament #3767885527, $40+$10+$5 USD Hold'em No Limit - Level XIV (1000/2000) - 2024/06/26 19:32:35 UTC [2024/06/26 15:32:35 ET]
Table '3767885527 92' 8-max Seat #5 is the button
Seat 2: Mr Pay Shent (34532 in chips) 
Seat 3: Pseudo Fruto (85664 in chips) 
Seat 4: RenanToniolo (84039 in chips) 
Seat 5: milkytravis (39752 in chips) 
Seat 6: sunn¥m4nn (117200 in chips) 
Seat 7: podiiii (40625 in chips) 
Seat 8: drmentrop (53500 in chips) 
Mr Pay Shent: posts the ante 250
Pseudo Fruto: posts the ante 250
RenanToniolo: posts the ante 250
milkytravis: posts the ante 250
sunn¥m4nn: posts the ante 250
podiiii: posts the ante 250
drmentrop: posts the ante 250
sunn¥m4nn: posts small blind 1000
podiiii: posts big blind 2000
*** HOLE CARDS ***
drmentrop: folds 
Mr Pay Shent: folds 
Pseudo Fruto: folds 
RenanToniolo: folds 
milkytravis: folds 
sunn¥m4nn: folds 
Uncalled bet (1000) returned to podiiii
podiiii collected 3750 from pot
*** SUMMARY ***
Total pot 3750 | Rake 0 
Seat 2: Mr Pay Shent folded before Flop (didn't bet)
Seat 3: Pseudo Fruto folded before Flop (didn't bet)
Seat 4: RenanToniolo folded before Flop (didn't bet)
Seat 5: milkytravis (button) folded before Flop (didn't bet)
Seat 6: sunn¥m4nn (small blind) folded before Flop
Seat 7: podiiii (big blind) collected (3750)
Seat 8: drmentrop folded before Flop (didn't bet)

PokerStars Hand #251206026968: Tournament #3767885527, $40+$10+$5 USD Hold'em No Limit - Level XIV (1000/2000) - 2024/06/26 19:32:56 UTC [2024/06/26 15:32:56 ET]
Table '3767885527 92' 8-max Seat #6 is the button
Seat 2: Mr Pay Shent (34282 in chips) 
Seat 3: Pseudo Fruto (85414 in chips) 
Seat 4: RenanToniolo (83789 in chips) 
Seat 5: milkytravis (39502 in chips) 
Seat 6: sunn¥m4nn (115950 in chips) 
Seat 7: podiiii (43125 in chips) 
Seat 8: drmentrop (53250 in chips) 
Mr Pay Shent: posts the ante 250
Pseudo Fruto: posts the ante 250
RenanToniolo: posts the ante 250
milkytravis: posts the ante 250
sunn¥m4nn: posts the ante 250
podiiii: posts the ante 250
drmentrop: posts the ante 250
podiiii: posts small blind 1000
drmentrop: posts big blind 2000
*** HOLE CARDS ***
Mr Pay Shent: raises 2000 to 4000
Pseudo Fruto: raises 6000 to 10000
RenanToniolo: folds 
milkytravis: folds 
sunn¥m4nn: folds 
podiiii: raises 32875 to 42875 and is all-in
drmentrop: folds 
Mr Pay Shent: folds 
Pseudo Fruto: folds 
Uncalled bet (32875) returned to podiiii
podiiii collected 27750 from pot
kbção535 is disconnected 
*** SUMMARY ***
Total pot 27750 | Rake 0 
Seat 2: Mr Pay Shent folded before Flop
Seat 3: Pseudo Fruto folded before Flop
Seat 4: RenanToniolo folded before Flop (didn't bet)
Seat 5: milkytravis folded before Flop (didn't bet)
Seat 6: sunn¥m4nn (button) folded before Flop (didn't bet)
Seat 7: podiiii (small blind) collected (27750)
Seat 8: drmentrop (big blind) folded before Flop

PokerStars Hand #251206039921: Tournament #3767885527, $40+$10+$5 USD Hold'em No Limit - Level XIV (1000/2000) - 2024/06/26 19:33:43 UTC [2024/06/26 15:33:43 ET]
Table '3767885527 92' 8-max Seat #7 is the button
Seat 1: kbção535 (25000 in chips) 
Seat 2: Mr Pay Shent (30032 in chips) 
Seat 3: Pseudo Fruto (75164 in chips) 
Seat 4: RenanToniolo (83539 in chips) 
Seat 5: milkytravis (39252 in chips) 
Seat 6: sunn¥m4nn (115700 in chips) 
Seat 7: podiiii (60625 in chips) 
Seat 8: drmentrop (51000 in chips) 
kbção535: posts the ante 250
Mr Pay Shent: posts the ante 250
Pseudo Fruto: posts the ante 250
RenanToniolo: posts the ante 250
milkytravis: posts the ante 250
sunn¥m4nn: posts the ante 250
podiiii: posts the ante 250
drmentrop: posts the ante 250
drmentrop: posts small blind 1000
kbção535: posts big blind 2000
*** HOLE CARDS ***
Mr Pay Shent: folds 
Pseudo Fruto: folds 
RenanToniolo: raises 2000 to 4000
milkytravis: folds 
sunn¥m4nn: folds 
podiiii: folds 
drmentrop: folds 
kbção535: calls 2000
*** FLOP *** [4c Th Jh]
kbção535: bets 11000
RenanToniolo: folds 
Uncalled bet (11000) returned to kbção535
kbção535 collected 11000 from pot
kbção535: doesn't show hand 
*** SUMMARY ***
Total pot 11000 | Rake 0 
Board [4c Th Jh]
Seat 1: kbção535 (big blind) collected (11000)
Seat 2: Mr Pay Shent folded before Flop (didn't bet)
Seat 3: Pseudo Fruto folded before Flop (didn't bet)
Seat 4: RenanToniolo folded on the Flop
Seat 5: milkytravis folded before Flop (didn't bet)
Seat 6: sunn¥m4nn folded before Flop (didn't bet)
Seat 7: podiiii (button) folded before Flop (didn't bet)
Seat 8: drmentrop (small blind) folded before Flop

PokerStars Hand #251206049415: Tournament #3767885527, $40+$10+$5 USD Hold'em No Limit - Level XIV (1000/2000) - 2024/06/26 19:34:18 UTC [2024/06/26 15:34:18 ET]
Table '3767885527 92' 8-max Seat #8 is the button
Seat 1: kbção535 (31750 in chips) 
Seat 2: Mr Pay Shent (29782 in chips) 
Seat 3: Pseudo Fruto (74914 in chips) 
Seat 4: RenanToniolo (79289 in chips) 
Seat 5: milkytravis (39002 in chips) 
Seat 6: sunn¥m4nn (115450 in chips) 
Seat 7: podiiii (60375 in chips) 
Seat 8: drmentrop (49750 in chips) 
kbção535: posts the ante 250
Mr Pay Shent: posts the ante 250
Pseudo Fruto: posts the ante 250
RenanToniolo: posts the ante 250
milkytravis: posts the ante 250
sunn¥m4nn: posts the ante 250
podiiii: posts the ante 250
drmentrop: posts the ante 250
kbção535: posts small blind 1000
Mr Pay Shent: posts big blind 2000
*** HOLE CARDS ***
Pseudo Fruto: folds 
RenanToniolo: raises 2000 to 4000
milkytravis: raises 34752 to 38752 and is all-in
sunn¥m4nn: folds 
podiiii: folds 
drmentrop: folds 
kbção535: calls 30500 and is all-in
Mr Pay Shent: folds 
RenanToniolo: calls 34752
*** FLOP *** [3h Qs 6s]
*** TURN *** [3h Qs 6s] [7d]
*** RIVER *** [3h Qs 6s 7d] [5d]
*** SHOW DOWN ***
RenanToniolo: shows [Jd Jh] (a pair of Jacks)
milkytravis: shows [9c 9h] (a pair of Nines)
RenanToniolo collected 14504 from side pot
kbção535: shows [Ah 7h] (a pair of Sevens)
RenanToniolo collected 98500 from main pot
milkytravis finished the tournament
kbção535 finished the tournament
caio_pimenta is disconnected 
*** SUMMARY ***
Total pot 113004 Main pot 98500. Side pot 14504. | Rake 0 
Board [3h Qs 6s 7d 5d]
Seat 1: kbção535 (small blind) showed [Ah 7h] and lost with a pair of Sevens
Seat 2: Mr Pay Shent (big blind) folded before Flop
Seat 3: Pseudo Fruto folded before Flop (didn't bet)
Seat 4: RenanToniolo showed [Jd Jh] and won (113004) with a pair of Jacks
Seat 5: milkytravis showed [9c 9h] and lost with a pair of Nines
Seat 6: sunn¥m4nn folded before Flop (didn't bet)
Seat 7: podiiii folded before Flop (didn't bet)
Seat 8: drmentrop (button) folded before Flop (didn't bet)

PokerStars Hand #251206066777: Tournament #3767885527, $40+$10+$5 USD Hold'em No Limit - Level XIV (1000/2000) - 2024/06/26 19:35:21 UTC [2024/06/26 15:35:21 ET]
Table '3767885527 92' 8-max Seat #2 is the button
Seat 2: Mr Pay Shent (27532 in chips) 
Seat 3: Pseudo Fruto (74664 in chips) 
Seat 4: RenanToniolo (153291 in chips) 
Seat 5: caio_pimenta (49407 in chips) 
Seat 6: sunn¥m4nn (115200 in chips) 
Seat 7: podiiii (60125 in chips) 
Seat 8: drmentrop (49500 in chips) 
Mr Pay Shent: posts the ante 250
Pseudo Fruto: posts the ante 250
RenanToniolo: posts the ante 250
caio_pimenta: posts the ante 250
sunn¥m4nn: posts the ante 250
podiiii: posts the ante 250
drmentrop: posts the ante 250
Pseudo Fruto: posts small blind 1000
RenanToniolo: posts big blind 2000
*** HOLE CARDS ***
caio_pimenta: folds 
sunn¥m4nn: folds 
podiiii: raises 2000 to 4000
drmentrop: folds 
Mr Pay Shent: folds 
Pseudo Fruto: folds 
RenanToniolo: calls 2000
*** FLOP *** [9c Kc 8h]
RenanToniolo: checks 
podiiii: bets 6600
RenanToniolo: calls 6600
*** TURN *** [9c Kc 8h] [6c]
RenanToniolo: checks 
podiiii: checks 
*** RIVER *** [9c Kc 8h 6c] [5d]
RenanToniolo: checks 
podiiii: checks 
*** SHOW DOWN ***
RenanToniolo: shows [4d 8d] (a pair of Eights)
podiiii: mucks hand 
RenanToniolo collected 23950 from pot
*** SUMMARY ***
Total pot 23950 | Rake 0 
Board [9c Kc 8h 6c 5d]
Seat 2: Mr Pay Shent (button) folded before Flop (didn't bet)
Seat 3: Pseudo Fruto (small blind) folded before Flop
Seat 4: RenanToniolo (big blind) showed [4d 8d] and won (23950) with a pair of Eights
Seat 5: caio_pimenta folded before Flop (didn't bet)
Seat 6: sunn¥m4nn folded before Flop (didn't bet)
Seat 7: podiiii mucked
Seat 8: drmentrop folded before Flop (didn't bet)

PokerStars Hand #251206092033: Tournament #3767885527, $40+$10+$5 USD Hold'em No Limit - Level XIV (1000/2000) - 2024/06/26 19:36:53 UTC [2024/06/26 15:36:53 ET]
Table '3767885527 92' 8-max Seat #3 is the button
Seat 2: Mr Pay Shent (27282 in chips) 
Seat 3: Pseudo Fruto (73414 in chips) 
Seat 4: RenanToniolo (166391 in chips) 
Seat 5: caio_pimenta (49157 in chips) 
Seat 6: sunn¥m4nn (114950 in chips) 
Seat 7: podiiii (49275 in chips) 
Seat 8: drmentrop (49250 in chips) 
Mr Pay Shent: posts the ante 250
Pseudo Fruto: posts the ante 250
RenanToniolo: posts the ante 250
caio_pimenta: posts the ante 250
sunn¥m4nn: posts the ante 250
podiiii: posts the ante 250
drmentrop: posts the ante 250
RenanToniolo: posts small blind 1000
caio_pimenta: posts big blind 2000
*** HOLE CARDS ***
sunn¥m4nn: folds 
podiiii: folds 
drmentrop: folds 
Mr Pay Shent: raises 6750 to 8750
rabwallace1993 is disconnected 
Pseudo Fruto: folds 
RenanToniolo: folds 
caio_pimenta: calls 6750
*** FLOP *** [Ac 6h 2s]
caio_pimenta: checks 
Mr Pay Shent: bets 18282 and is all-in
caio_pimenta: folds 
Uncalled bet (18282) returned to Mr Pay Shent
Mr Pay Shent collected 20250 from pot
Mr Pay Shent: doesn't show hand 
*** SUMMARY ***
Total pot 20250 | Rake 0 
Board [Ac 6h 2s]
Seat 2: Mr Pay Shent collected (20250)
Seat 3: Pseudo Fruto (button) folded before Flop (didn't bet)
Seat 4: RenanToniolo (small blind) folded before Flop
Seat 5: caio_pimenta (big blind) folded on the Flop
Seat 6: sunn¥m4nn folded before Flop (didn't bet)
Seat 7: podiiii folded before Flop (didn't bet)
Seat 8: drmentrop folded before Flop (didn't bet)

PokerStars Hand #251206102801: Tournament #3767885527, $40+$10+$5 USD Hold'em No Limit - Level XIV (1000/2000) - 2024/06/26 19:37:32 UTC [2024/06/26 15:37:32 ET]
Table '3767885527 92' 8-max Seat #4 is the button
Seat 1: rabwallace1993 (84066 in chips) 
Seat 2: Mr Pay Shent (38532 in chips) 
Seat 3: Pseudo Fruto (73164 in chips) 
Seat 4: RenanToniolo (165141 in chips) 
Seat 5: caio_pimenta (40157 in chips) 
Seat 6: sunn¥m4nn (114700 in chips) 
Seat 7: podiiii (49025 in chips) 
Seat 8: drmentrop (49000 in chips) 
rabwallace1993: posts the ante 250
Mr Pay Shent: posts the ante 250
Pseudo Fruto: posts the ante 250
RenanToniolo: posts the ante 250
caio_pimenta: posts the ante 250
sunn¥m4nn: posts the ante 250
podiiii: posts the ante 250
drmentrop: posts the ante 250
caio_pimenta: posts small blind 1000
sunn¥m4nn: posts big blind 2000
*** HOLE CARDS ***
podiiii: folds 
drmentrop: folds 
rabwallace1993: raises 2000 to 4000
Mr Pay Shent: folds 
Pseudo Fruto: folds 
RenanToniolo: folds 
caio_pimenta: calls 3000
sunn¥m4nn: folds 
*** FLOP *** [Ac 4h 7s]
caio_pimenta: checks 
rabwallace1993: bets 6000
caio_pimenta: folds 
Uncalled bet (6000) returned to rabwallace1993
rabwallace1993 collected 12000 from pot
rabwallace1993: doesn't show hand 
*** SUMMARY ***
Total pot 12000 | Rake 0 
Board [Ac 4h 7s]
Seat 1: rabwallace1993 collected (12000)
Seat 2: Mr Pay Shent folded before Flop (didn't bet)
Seat 3: Pseudo Fruto folded before Flop (didn't bet)
Seat 4: RenanToniolo (button) folded before Flop (didn't bet)
Seat 5: caio_pimenta (small blind) folded on the Flop
Seat 6: sunn¥m4nn (big blind) folded before Flop
Seat 7: podiiii folded before Flop (didn't bet)
Seat 8: drmentrop folded before Flop (didn't bet)

PokerStars Hand #251206114055: Tournament #3767885527, $40+$10+$5 USD Hold'em No Limit - Level XIV (1000/2000) - 2024/06/26 19:38:14 UTC [2024/06/26 15:38:14 ET]
Table '3767885527 92' 8-max Seat #5 is the button
Seat 1: rabwallace1993 (91816 in chips) 
Seat 2: Mr Pay Shent (38282 in chips) 
Seat 3: Pseudo Fruto (72914 in chips) 
Seat 4: RenanToniolo (164891 in chips) 
Seat 5: caio_pimenta (35907 in chips) 
Seat 6: sunn¥m4nn (112450 in chips) 
Seat 7: podiiii (48775 in chips) 
Seat 8: drmentrop (48750 in chips) 
rabwallace1993: posts the ante 250
Mr Pay Shent: posts the ante 250
Pseudo Fruto: posts the ante 250
RenanToniolo: posts the ante 250
caio_pimenta: posts the ante 250
sunn¥m4nn: posts the ante 250
podiiii: posts the ante 250
drmentrop: posts the ante 250
sunn¥m4nn: posts small blind 1000
podiiii: posts big blind 2000
*** HOLE CARDS ***
drmentrop: folds 
rabwallace1993: raises 2000 to 4000
Mr Pay Shent: folds 
Pseudo Fruto: folds 
RenanToniolo: folds 
caio_pimenta: folds 
sunn¥m4nn: calls 3000
podiiii: calls 2000
*** FLOP *** [3h 7c 2d]
sunn¥m4nn: checks 
podiiii: bets 3500
rabwallace1993: calls 3500
sunn¥m4nn: calls 3500
*** TURN *** [3h 7c 2d] [Jh]
sunn¥m4nn: checks 
podiiii: bets 8085
rabwallace1993: raises 10085 to 18170
sunn¥m4nn: folds 
podiiii: raises 22855 to 41025 and is all-in
rabwallace1993: folds 
Uncalled bet (22855) returned to podiiii
podiiii collected 60840 from pot
*** SUMMARY ***
Total pot 60840 | Rake 0 
Board [3h 7c 2d Jh]
Seat 1: rabwallace1993 folded on the Turn
Seat 2: Mr Pay Shent folded before Flop (didn't bet)
Seat 3: Pseudo Fruto folded before Flop (didn't bet)
Seat 4: RenanToniolo folded before Flop (didn't bet)
Seat 5: caio_pimenta (button) folded before Flop (didn't bet)
Seat 6: sunn¥m4nn (small blind) folded on the Turn
Seat 7: podiiii (big blind) collected (60840)
Seat 8: drmentrop folded before Flop (didn't bet)

PokerStars Hand #251206152482: Tournament #3767885527, $40+$10+$5 USD Hold'em No Limit - Level XV (1250/2500) - 2024/06/26 19:40:34 UTC [2024/06/26 15:40:34 ET]
Table '3767885527 92' 8-max Seat #6 is the button
Seat 1: rabwallace1993 (65896 in chips) 
Seat 2: Mr Pay Shent (38032 in chips) 
Seat 3: Pseudo Fruto (72664 in chips) 
Seat 4: RenanToniolo (164641 in chips) 
Seat 5: caio_pimenta (35657 in chips) 
Seat 6: sunn¥m4nn (104700 in chips) 
Seat 7: podiiii (83695 in chips) 
Seat 8: drmentrop (48500 in chips) 
rabwallace1993: posts the ante 325
Mr Pay Shent: posts the ante 325
Pseudo Fruto: posts the ante 325
RenanToniolo: posts the ante 325
caio_pimenta: posts the ante 325
sunn¥m4nn: posts the ante 325
podiiii: posts the ante 325
drmentrop: posts the ante 325
podiiii: posts small blind 1250
drmentrop: posts big blind 2500
*** HOLE CARDS ***
rabwallace1993: folds 
Mr Pay Shent: folds 
Pseudo Fruto: folds 
RenanToniolo: raises 2500 to 5000
caio_pimenta: folds 
sunn¥m4nn: folds 
podiiii: folds 
drmentrop: calls 2500
*** FLOP *** [Kd Js 8h]
drmentrop: checks 
RenanToniolo: bets 3463
drmentrop: calls 3463
*** TURN *** [Kd Js 8h] [Ac]
drmentrop: checks 
RenanToniolo: bets 11856
drmentrop: folds 
Uncalled bet (11856) returned to RenanToniolo
RenanToniolo collected 20776 from pot
*** SUMMARY ***
Total pot 20776 | Rake 0 
Board [Kd Js 8h Ac]
Seat 1: rabwallace1993 folded before Flop (didn't bet)
Seat 2: Mr Pay Shent folded before Flop (didn't bet)
Seat 3: Pseudo Fruto folded before Flop (didn't bet)
Seat 4: RenanToniolo collected (20776)
Seat 5: caio_pimenta folded before Flop (didn't bet)
Seat 6: sunn¥m4nn (button) folded before Flop (didn't bet)
Seat 7: podiiii (small blind) folded before Flop
Seat 8: drmentrop (big blind) folded on the Turn

PokerStars Hand #251206164781: Tournament #3767885527, $40+$10+$5 USD Hold'em No Limit - Level XV (1250/2500) - 2024/06/26 19:41:18 UTC [2024/06/26 15:41:18 ET]
Table '3767885527 92' 8-max Seat #7 is the button
Seat 1: rabwallace1993 (65571 in chips) 
Seat 2: Mr Pay Shent (37707 in chips) 
Seat 3: Pseudo Fruto (72339 in chips) 
Seat 4: RenanToniolo (176629 in chips) 
Seat 5: caio_pimenta (35332 in chips) 
Seat 6: sunn¥m4nn (104375 in chips) 
Seat 7: podiiii (82120 in chips) 
Seat 8: drmentrop (39712 in chips) 
rabwallace1993: posts the ante 325
Mr Pay Shent: posts the ante 325
Pseudo Fruto: posts the ante 325
RenanToniolo: posts the ante 325
caio_pimenta: posts the ante 325
sunn¥m4nn: posts the ante 325
podiiii: posts the ante 325
drmentrop: posts the ante 325
drmentrop: posts small blind 1250
rabwallace1993: posts big blind 2500
*** HOLE CARDS ***
Mr Pay Shent: folds 
Pseudo Fruto: folds 
RenanToniolo: folds 
caio_pimenta: folds 
sunn¥m4nn: folds 
podiiii: raises 2500 to 5000
drmentrop: folds 
rabwallace1993: calls 2500
*** FLOP *** [Qh 7s 2h]
rabwallace1993: checks 
podiiii: bets 4571
rabwallace1993: calls 4571
*** TURN *** [Qh 7s 2h] [2s]
rabwallace1993: checks 
podiiii: checks 
*** RIVER *** [Qh 7s 2h 2s] [As]
rabwallace1993: bets 11496
podiiii: folds 
Uncalled bet (11496) returned to rabwallace1993
rabwallace1993 collected 22992 from pot
rabwallace1993: doesn't show hand 
*** SUMMARY ***
Total pot 22992 | Rake 0 
Board [Qh 7s 2h 2s As]
Seat 1: rabwallace1993 (big blind) collected (22992)
Seat 2: Mr Pay Shent folded before Flop (didn't bet)
Seat 3: Pseudo Fruto folded before Flop (didn't bet)
Seat 4: RenanToniolo folded before Flop (didn't bet)
Seat 5: caio_pimenta folded before Flop (didn't bet)
Seat 6: sunn¥m4nn folded before Flop (didn't bet)
Seat 7: podiiii (button) folded on the River
Seat 8: drmentrop (small blind) folded before Flop

PokerStars Hand #251206187661: Tournament #3767885527, $40+$10+$5 USD Hold'em No Limit - Level XV (1250/2500) - 2024/06/26 19:42:41 UTC [2024/06/26 15:42:41 ET]
Table '3767885527 92' 8-max Seat #8 is the button
Seat 1: rabwallace1993 (78667 in chips) 
Seat 2: Mr Pay Shent (37382 in chips) 
Seat 3: Pseudo Fruto (72014 in chips) 
Seat 4: RenanToniolo (176304 in chips) 
Seat 5: caio_pimenta (35007 in chips) 
Seat 6: sunn¥m4nn (104050 in chips) 
Seat 7: podiiii (72224 in chips) 
Seat 8: drmentrop (38137 in chips) 
rabwallace1993: posts the ante 325
Mr Pay Shent: posts the ante 325
Pseudo Fruto: posts the ante 325
RenanToniolo: posts the ante 325
caio_pimenta: posts the ante 325
sunn¥m4nn: posts the ante 325
podiiii: posts the ante 325
drmentrop: posts the ante 325
rabwallace1993: posts small blind 1250
Mr Pay Shent: posts big blind 2500
*** HOLE CARDS ***
Pseudo Fruto: folds 
RenanToniolo: folds 
caio_pimenta: folds 
sunn¥m4nn: folds 
podiiii: raises 2500 to 5000
drmentrop: folds 
rabwallace1993: calls 3750
Mr Pay Shent: folds 
*** FLOP *** [8c 8d 5h]
rabwallace1993: checks 
podiiii: bets 4750
rabwallace1993: calls 4750
*** TURN *** [8c 8d 5h] [2d]
rabwallace1993: checks 
podiiii: bets 12500
rabwallace1993: calls 12500
*** RIVER *** [8c 8d 5h 2d] [Th]
rabwallace1993: checks 
podiiii: checks 
*** SHOW DOWN ***
rabwallace1993: shows [As 4h] (a pair of Eights)
podiiii: mucks hand 
rabwallace1993 collected 49600 from pot
*** SUMMARY ***
Total pot 49600 | Rake 0 
Board [8c 8d 5h 2d Th]
Seat 1: rabwallace1993 (small blind) showed [As 4h] and won (49600) with a pair of Eights
Seat 2: Mr Pay Shent (big blind) folded before Flop
Seat 3: Pseudo Fruto folded before Flop (didn't bet)
Seat 4: RenanToniolo folded before Flop (didn't bet)
Seat 5: caio_pimenta folded before Flop (didn't bet)
Seat 6: sunn¥m4nn folded before Flop (didn't bet)
Seat 7: podiiii mucked
Seat 8: drmentrop (button) folded before Flop (didn't bet)

PokerStars Hand #251206218987: Tournament #3767885527, $40+$10+$5 USD Hold'em No Limit - Level XV (1250/2500) - 2024/06/26 19:44:36 UTC [2024/06/26 15:44:36 ET]
Table '3767885527 92' 8-max Seat #1 is the button
Seat 1: rabwallace1993 (105692 in chips) 
Seat 2: Mr Pay Shent (34557 in chips) 
Seat 3: Pseudo Fruto (71689 in chips) 
Seat 4: RenanToniolo (175979 in chips) 
Seat 5: caio_pimenta (34682 in chips) 
Seat 6: sunn¥m4nn (103725 in chips) 
Seat 7: podiiii (49649 in chips) 
Seat 8: drmentrop (37812 in chips) 
rabwallace1993: posts the ante 325
Mr Pay Shent: posts the ante 325
Pseudo Fruto: posts the ante 325
RenanToniolo: posts the ante 325
caio_pimenta: posts the ante 325
sunn¥m4nn: posts the ante 325
podiiii: posts the ante 325
drmentrop: posts the ante 325
Mr Pay Shent: posts small blind 1250
Pseudo Fruto: posts big blind 2500
*** HOLE CARDS ***
RenanToniolo: folds 
caio_pimenta: folds 
sunn¥m4nn: folds 
podiiii: folds 
drmentrop: folds 
rabwallace1993: raises 5000 to 7500
Mr Pay Shent: folds 
Pseudo Fruto: folds 
Uncalled bet (5000) returned to rabwallace1993
rabwallace1993 collected 8850 from pot
rabwallace1993: doesn't show hand 
*** SUMMARY ***
Total pot 8850 | Rake 0 
Seat 1: rabwallace1993 (button) collected (8850)
Seat 2: Mr Pay Shent (small blind) folded before Flop
Seat 3: Pseudo Fruto (big blind) folded before Flop
Seat 4: RenanToniolo folded before Flop (didn't bet)
Seat 5: caio_pimenta folded before Flop (didn't bet)
Seat 6: sunn¥m4nn folded before Flop (didn't bet)
Seat 7: podiiii folded before Flop (didn't bet)
Seat 8: drmentrop folded before Flop (didn't bet)

PokerStars Hand #251206227216: Tournament #3767885527, $40+$10+$5 USD Hold'em No Limit - Level XV (1250/2500) - 2024/06/26 19:45:05 UTC [2024/06/26 15:45:05 ET]
Table '3767885527 92' 8-max Seat #2 is the button
Seat 1: rabwallace1993 (111717 in chips) 
Seat 2: Mr Pay Shent (32982 in chips) 
Seat 3: Pseudo Fruto (68864 in chips) 
Seat 4: RenanToniolo (175654 in chips) 
Seat 5: caio_pimenta (34357 in chips) 
Seat 6: sunn¥m4nn (103400 in chips) 
Seat 7: podiiii (49324 in chips) 
Seat 8: drmentrop (37487 in chips) 
rabwallace1993: posts the ante 325
Mr Pay Shent: posts the ante 325
Pseudo Fruto: posts the ante 325
RenanToniolo: posts the ante 325
caio_pimenta: posts the ante 325
sunn¥m4nn: posts the ante 325
podiiii: posts the ante 325
drmentrop: posts the ante 325
Pseudo Fruto: posts small blind 1250
RenanToniolo: posts big blind 2500
*** HOLE CARDS ***
caio_pimenta: folds 
sunn¥m4nn: folds 
podiiii: raises 2500 to 5000
drmentrop: folds 
rabwallace1993: folds 
Mr Pay Shent: folds 
Pseudo Fruto: folds 
RenanToniolo: calls 2500
*** FLOP *** [Qd Th 9d]
RenanToniolo: checks 
podiiii: bets 4571
RenanToniolo: calls 4571
*** TURN *** [Qd Th 9d] [Jd]
RenanToniolo: checks 
podiiii: bets 7587
RenanToniolo: calls 7587
*** RIVER *** [Qd Th 9d Jd] [2s]
RenanToniolo: checks 
podiiii: bets 31841 and is all-in
RenanToniolo: folds 
Uncalled bet (31841) returned to podiiii
podiiii collected 38166 from pot
*** SUMMARY ***
Total pot 38166 | Rake 0 
Board [Qd Th 9d Jd 2s]
Seat 1: rabwallace1993 folded before Flop (didn't bet)
Seat 2: Mr Pay Shent (button) folded before Flop (didn't bet)
Seat 3: Pseudo Fruto (small blind) folded before Flop
Seat 4: RenanToniolo (big blind) folded on the River
Seat 5: caio_pimenta folded before Flop (didn't bet)
Seat 6: sunn¥m4nn folded before Flop (didn't bet)
Seat 7: podiiii collected (38166)
Seat 8: drmentrop folded before Flop (didn't bet)

PokerStars Hand #251206255670: Tournament #3767885527, $40+$10+$5 USD Hold'em No Limit - Level XV (1250/2500) - 2024/06/26 19:46:48 UTC [2024/06/26 15:46:48 ET]
Table '3767885527 92' 8-max Seat #3 is the button
Seat 1: rabwallace1993 (111392 in chips) 
Seat 2: Mr Pay Shent (32657 in chips) 
Seat 3: Pseudo Fruto (67289 in chips) 
Seat 4: RenanToniolo (158171 in chips) 
Seat 5: caio_pimenta (34032 in chips) 
Seat 6: sunn¥m4nn (103075 in chips) 
Seat 7: podiiii (70007 in chips) 
Seat 8: drmentrop (37162 in chips) 
rabwallace1993: posts the ante 325
Mr Pay Shent: posts the ante 325
Pseudo Fruto: posts the ante 325
RenanToniolo: posts the ante 325
caio_pimenta: posts the ante 325
sunn¥m4nn: posts the ante 325
podiiii: posts the ante 325
drmentrop: posts the ante 325
RenanToniolo: posts small blind 1250
caio_pimenta: posts big blind 2500
*** HOLE CARDS ***
sunn¥m4nn: folds 
podiiii: folds 
drmentrop: folds 
rabwallace1993: folds 
Mr Pay Shent: folds 
Pseudo Fruto: raises 2500 to 5000
RenanToniolo: folds 
caio_pimenta: folds 
Uncalled bet (2500) returned to Pseudo Fruto
Pseudo Fruto collected 8850 from pot
Pseudo Fruto: doesn't show hand 
*** SUMMARY ***
Total pot 8850 | Rake 0 
Seat 1: rabwallace1993 folded before Flop (didn't bet)
Seat 2: Mr Pay Shent folded before Flop (didn't bet)
Seat 3: Pseudo Fruto (button) collected (8850)
Seat 4: RenanToniolo (small blind) folded before Flop
Seat 5: caio_pimenta (big blind) folded before Flop
Seat 6: sunn¥m4nn folded before Flop (didn't bet)
Seat 7: podiiii folded before Flop (didn't bet)
Seat 8: drmentrop folded before Flop (didn't bet)

PokerStars Hand #251206262206: Tournament #3767885527, $40+$10+$5 USD Hold'em No Limit - Level XV (1250/2500) - 2024/06/26 19:47:12 UTC [2024/06/26 15:47:12 ET]
Table '3767885527 92' 8-max Seat #4 is the button
Seat 1: rabwallace1993 (111067 in chips) 
Seat 2: Mr Pay Shent (32332 in chips) 
Seat 3: Pseudo Fruto (73314 in chips) 
Seat 4: RenanToniolo (156596 in chips) 
Seat 5: caio_pimenta (31207 in chips) 
Seat 6: sunn¥m4nn (102750 in chips) 
Seat 7: podiiii (69682 in chips) 
Seat 8: drmentrop (36837 in chips) 
rabwallace1993: posts the ante 325
Mr Pay Shent: posts the ante 325
Pseudo Fruto: posts the ante 325
RenanToniolo: posts the ante 325
caio_pimenta: posts the ante 325
sunn¥m4nn: posts the ante 325
podiiii: posts the ante 325
drmentrop: posts the ante 325
caio_pimenta: posts small blind 1250
sunn¥m4nn: posts big blind 2500
*** HOLE CARDS ***
podiiii: folds 
drmentrop: folds 
rabwallace1993: folds 
Mr Pay Shent: folds 
Pseudo Fruto: raises 2500 to 5000
RenanToniolo: folds 
caio_pimenta: raises 25882 to 30882 and is all-in
sunn¥m4nn: folds 
Pseudo Fruto: calls 25882
*** FLOP *** [2h Tc 9s]
*** TURN *** [2h Tc 9s] [5c]
*** RIVER *** [2h Tc 9s 5c] [Td]
*** SHOW DOWN ***
caio_pimenta: shows [Ks Qs] (a pair of Tens)
Pseudo Fruto: shows [4s 4h] (two pair, Tens and Fours)
Pseudo Fruto collected 66864 from pot
caio_pimenta finished the tournament in 504th place
*** SUMMARY ***
Total pot 66864 | Rake 0 
Board [2h Tc 9s 5c Td]
Seat 1: rabwallace1993 folded before Flop (didn't bet)
Seat 2: Mr Pay Shent folded before Flop (didn't bet)
Seat 3: Pseudo Fruto showed [4s 4h] and won (66864) with two pair, Tens and Fours
Seat 4: RenanToniolo (button) folded before Flop (didn't bet)
Seat 5: caio_pimenta (small blind) showed [Ks Qs] and lost with a pair of Tens
Seat 6: sunn¥m4nn (big blind) folded before Flop
Seat 7: podiiii folded before Flop (didn't bet)
Seat 8: drmentrop folded before Flop (didn't bet)

PokerStars Hand #251206274828: Tournament #3767885527, $40+$10+$5 USD Hold'em No Limit - Level XV (1250/2500) - 2024/06/26 19:47:58 UTC [2024/06/26 15:47:58 ET]
Table '3767885527 92' 8-max Seat #6 is the button
Seat 1: rabwallace1993 (110742 in chips) 
Seat 2: Mr Pay Shent (32007 in chips) 
Seat 3: Pseudo Fruto (108971 in chips) 
Seat 4: RenanToniolo (156271 in chips) 
Seat 6: sunn¥m4nn (99925 in chips) 
Seat 7: podiiii (69357 in chips) 
Seat 8: drmentrop (36512 in chips) 
rabwallace1993: posts the ante 325
Mr Pay Shent: posts the ante 325
Pseudo Fruto: posts the ante 325
RenanToniolo: posts the ante 325
sunn¥m4nn: posts the ante 325
podiiii: posts the ante 325
drmentrop: posts the ante 325
podiiii: posts small blind 1250
drmentrop: posts big blind 2500
*** HOLE CARDS ***
rabwallace1993: folds 
Mr Pay Shent: raises 2500 to 5000
Pseudo Fruto: folds 
RenanToniolo: folds 
sunn¥m4nn: folds 
podiiii: folds 
drmentrop: calls 2500
*** FLOP *** [8d Ad Ts]
drmentrop: checks 
Mr Pay Shent: bets 6763
drmentrop: folds 
Uncalled bet (6763) returned to Mr Pay Shent
Mr Pay Shent collected 13525 from pot
Mr Pay Shent: doesn't show hand 
*** SUMMARY ***
Total pot 13525 | Rake 0 
Board [8d Ad Ts]
Seat 1: rabwallace1993 folded before Flop (didn't bet)
Seat 2: Mr Pay Shent collected (13525)
Seat 3: Pseudo Fruto folded before Flop (didn't bet)
Seat 4: RenanToniolo folded before Flop (didn't bet)
Seat 6: sunn¥m4nn (button) folded before Flop (didn't bet)
Seat 7: podiiii (small blind) folded before Flop
Seat 8: drmentrop (big blind) folded on the Flop

PokerStars Hand #251206283465: Tournament #3767885527, $40+$10+$5 USD Hold'em No Limit - Level XV (1250/2500) - 2024/06/26 19:48:30 UTC [2024/06/26 15:48:30 ET]
Table '3767885527 92' 8-max Seat #7 is the button
Seat 1: rabwallace1993 (110417 in chips) 
Seat 2: Mr Pay Shent (40207 in chips) 
Seat 3: Pseudo Fruto (108646 in chips) 
Seat 4: RenanToniolo (155946 in chips) 
Seat 6: sunn¥m4nn (99600 in chips) 
Seat 7: podiiii (67782 in chips) 
Seat 8: drmentrop (31187 in chips) 
rabwallace1993: posts the ante 325
Mr Pay Shent: posts the ante 325
Pseudo Fruto: posts the ante 325
RenanToniolo: posts the ante 325
sunn¥m4nn: posts the ante 325
podiiii: posts the ante 325
drmentrop: posts the ante 325
drmentrop: posts small blind 1250
rabwallace1993: posts big blind 2500
*** HOLE CARDS ***
Mr Pay Shent: folds 
Pseudo Fruto: raises 2500 to 5000
RenanToniolo: folds 
sunn¥m4nn: folds 
podiiii: folds 
S3d3m2 is disconnected 
drmentrop: raises 25862 to 30862 and is all-in
rabwallace1993: folds 
Pseudo Fruto: folds 
Uncalled bet (25862) returned to drmentrop
drmentrop collected 14775 from pot
*** SUMMARY ***
Total pot 14775 | Rake 0 
Seat 1: rabwallace1993 (big blind) folded before Flop
Seat 2: Mr Pay Shent folded before Flop (didn't bet)
Seat 3: Pseudo Fruto folded before Flop
Seat 4: RenanToniolo folded before Flop (didn't bet)
Seat 6: sunn¥m4nn folded before Flop (didn't bet)
Seat 7: podiiii (button) folded before Flop (didn't bet)
Seat 8: drmentrop (small blind) collected (14775)

PokerStars Hand #251206297124: Tournament #3767885527, $40+$10+$5 USD Hold'em No Limit - Level XVI (1500/3000) - 2024/06/26 19:49:19 UTC [2024/06/26 15:49:19 ET]
Table '3767885527 92' 8-max Seat #8 is the button
Seat 1: rabwallace1993 (107592 in chips) 
Seat 2: Mr Pay Shent (39882 in chips) 
Seat 3: Pseudo Fruto (103321 in chips) 
Seat 4: RenanToniolo (155621 in chips) 
Seat 5: S3d3m2 (104819 in chips) 
Seat 6: sunn¥m4nn (99275 in chips) 
Seat 7: podiiii (67457 in chips) 
Seat 8: drmentrop (40637 in chips) 
rabwallace1993: posts the ante 375
Mr Pay Shent: posts the ante 375
Pseudo Fruto: posts the ante 375
RenanToniolo: posts the ante 375
S3d3m2: posts the ante 375
sunn¥m4nn: posts the ante 375
podiiii: posts the ante 375
drmentrop: posts the ante 375
rabwallace1993: posts small blind 1500
Mr Pay Shent: posts big blind 3000
*** HOLE CARDS ***
Pseudo Fruto: raises 3000 to 6000
RenanToniolo: folds 
S3d3m2: folds 
sunn¥m4nn: folds 
podiiii: folds 
drmentrop: raises 34262 to 40262 and is all-in
rabwallace1993: folds 
Mr Pay Shent: folds 
Pseudo Fruto: calls 34262
*** FLOP *** [Ks Tc 9s]
*** TURN *** [Ks Tc 9s] [3d]
*** RIVER *** [Ks Tc 9s 3d] [2d]
*** SHOW DOWN ***
Pseudo Fruto: shows [Ac Jh] (high card Ace)
drmentrop: shows [As 6c] (high card Ace - lower kicker)
Pseudo Fruto collected 88024 from pot
drmentrop finished the tournament in 491st place
*** SUMMARY ***
Total pot 88024 | Rake 0 
Board [Ks Tc 9s 3d 2d]
Seat 1: rabwallace1993 (small blind) folded before Flop
Seat 2: Mr Pay Shent (big blind) folded before Flop
Seat 3: Pseudo Fruto showed [Ac Jh] and won (88024) with high card Ace
Seat 4: RenanToniolo folded before Flop (didn't bet)
Seat 5: S3d3m2 folded before Flop (didn't bet)
Seat 6: sunn¥m4nn folded before Flop (didn't bet)
Seat 7: podiiii folded before Flop (didn't bet)
Seat 8: drmentrop (button) showed [As 6c] and lost with high card Ace

PokerStars Hand #251206308628: Tournament #3767885527, $40+$10+$5 USD Hold'em No Limit - Level XVI (1500/3000) - 2024/06/26 19:50:00 UTC [2024/06/26 15:50:00 ET]
Table '3767885527 92' 8-max Seat #1 is the button
Seat 1: rabwallace1993 (105717 in chips) 
Seat 2: Mr Pay Shent (36507 in chips) 
Seat 3: Pseudo Fruto (150708 in chips) 
Seat 4: RenanToniolo (155246 in chips) 
Seat 5: S3d3m2 (104444 in chips) 
Seat 6: sunn¥m4nn (98900 in chips) 
Seat 7: podiiii (67082 in chips) 
rabwallace1993: posts the ante 375
Mr Pay Shent: posts the ante 375
Pseudo Fruto: posts the ante 375
RenanToniolo: posts the ante 375
S3d3m2: posts the ante 375
sunn¥m4nn: posts the ante 375
podiiii: posts the ante 375
Mr Pay Shent: posts small blind 1500
Pseudo Fruto: posts big blind 3000
*** HOLE CARDS ***
RenanToniolo: folds 
S3d3m2: folds 
sunn¥m4nn: raises 3000 to 6000
BorIska1993 is disconnected 
podiiii: raises 60707 to 66707 and is all-in
rabwallace1993: folds 
Mr Pay Shent: calls 34632 and is all-in
Pseudo Fruto: folds 
sunn¥m4nn: folds 
Uncalled bet (30575) returned to podiiii
*** FLOP *** [Kc 9h Ad]
*** TURN *** [Kc 9h Ad] [8c]
*** RIVER *** [Kc 9h Ad 8c] [As]
*** SHOW DOWN ***
Mr Pay Shent: shows [Qh Ac] (three of a kind, Aces)
podiiii: shows [5d 5c] (two pair, Aces and Fives)
Mr Pay Shent collected 83889 from pot
*** SUMMARY ***
Total pot 83889 | Rake 0 
Board [Kc 9h Ad 8c As]
Seat 1: rabwallace1993 (button) folded before Flop (didn't bet)
Seat 2: Mr Pay Shent (small blind) showed [Qh Ac] and won (83889) with three of a kind, Aces
Seat 3: Pseudo Fruto (big blind) folded before Flop
Seat 4: RenanToniolo folded before Flop (didn't bet)
Seat 5: S3d3m2 folded before Flop (didn't bet)
Seat 6: sunn¥m4nn folded before Flop
Seat 7: podiiii showed [5d 5c] and lost with two pair, Aces and Fives

PokerStars Hand #251206322383: Tournament #3767885527, $40+$10+$5 USD Hold'em No Limit - Level XVI (1500/3000) - 2024/06/26 19:50:49 UTC [2024/06/26 15:50:49 ET]
Table '3767885527 92' 8-max Seat #2 is the button
Seat 1: rabwallace1993 (105342 in chips) 
Seat 2: Mr Pay Shent (83889 in chips) 
Seat 3: Pseudo Fruto (147333 in chips) 
Seat 4: RenanToniolo (154871 in chips) 
Seat 5: S3d3m2 (104069 in chips) 
Seat 6: sunn¥m4nn (92525 in chips) 
Seat 7: podiiii (30575 in chips) 
Seat 8: BorIska1993 (181649 in chips) 
rabwallace1993: posts the ante 375
Mr Pay Shent: posts the ante 375
Pseudo Fruto: posts the ante 375
RenanToniolo: posts the ante 375
S3d3m2: posts the ante 375
sunn¥m4nn: posts the ante 375
podiiii: posts the ante 375
BorIska1993: posts the ante 375
Pseudo Fruto: posts small blind 1500
RenanToniolo: posts big blind 3000
*** HOLE CARDS ***
S3d3m2: raises 3000 to 6000
sunn¥m4nn: folds 
podiiii: folds 
BorIska1993: folds 
rabwallace1993 has timed out
rabwallace1993: folds 
rabwallace1993 is sitting out
Mr Pay Shent: folds 
rabwallace1993 has returned
Pseudo Fruto: raises 16500 to 22500
RenanToniolo: folds 
S3d3m2: raises 81194 to 103694 and is all-in
Pseudo Fruto: calls 81194
*** FLOP *** [5d 8d 7d]
*** TURN *** [5d 8d 7d] [2s]
*** RIVER *** [5d 8d 7d 2s] [Td]
*** SHOW DOWN ***
Pseudo Fruto: shows [Qd Ad] (a flush, Ace high)
S3d3m2: shows [Ah Kd] (a flush, King high)
Pseudo Fruto collected 213388 from pot
S3d3m2 finished the tournament in 467th place
*** SUMMARY ***
Total pot 213388 | Rake 0 
Board [5d 8d 7d 2s Td]
Seat 1: rabwallace1993 folded before Flop (didn't bet)
Seat 2: Mr Pay Shent (button) folded before Flop (didn't bet)
Seat 3: Pseudo Fruto (small blind) showed [Qd Ad] and won (213388) with a flush, Ace high
Seat 4: RenanToniolo (big blind) folded before Flop
Seat 5: S3d3m2 showed [Ah Kd] and lost with a flush, King high
Seat 6: sunn¥m4nn folded before Flop (didn't bet)
Seat 7: podiiii folded before Flop (didn't bet)
Seat 8: BorIska1993 folded before Flop (didn't bet)

PokerStars Hand #251206342528: Tournament #3767885527, $40+$10+$5 USD Hold'em No Limit - Level XVI (1500/3000) - 2024/06/26 19:52:01 UTC [2024/06/26 15:52:01 ET]
Table '3767885527 92' 8-max Seat #3 is the button
Seat 1: rabwallace1993 (104967 in chips) 
Seat 2: Mr Pay Shent (83514 in chips) 
Seat 3: Pseudo Fruto (256652 in chips) 
Seat 4: RenanToniolo (151496 in chips) 
Seat 6: sunn¥m4nn (92150 in chips) 
Seat 7: podiiii (30200 in chips) 
Seat 8: BorIska1993 (181274 in chips) 
rabwallace1993: posts the ante 375
Mr Pay Shent: posts the ante 375
Pseudo Fruto: posts the ante 375
RenanToniolo: posts the ante 375
sunn¥m4nn: posts the ante 375
podiiii: posts the ante 375
BorIska1993: posts the ante 375
RenanToniolo: posts small blind 1500
sunn¥m4nn: posts big blind 3000
*** HOLE CARDS ***
podiiii: folds 
BorIska1993: folds 
rabwallace1993: folds 
Mr Pay Shent: folds 
Pseudo Fruto: raises 3000 to 6000
RenanToniolo: folds 
mv14 is disconnected 
sunn¥m4nn: folds 
Uncalled bet (3000) returned to Pseudo Fruto
Pseudo Fruto collected 10125 from pot
Pseudo Fruto: doesn't show hand 
*** SUMMARY ***
Total pot 10125 | Rake 0 
Seat 1: rabwallace1993 folded before Flop (didn't bet)
Seat 2: Mr Pay Shent folded before Flop (didn't bet)
Seat 3: Pseudo Fruto (button) collected (10125)
Seat 4: RenanToniolo (small blind) folded before Flop
Seat 6: sunn¥m4nn (big blind) folded before Flop
Seat 7: podiiii folded before Flop (didn't bet)
Seat 8: BorIska1993 folded before Flop (didn't bet)

PokerStars Hand #251206348712: Tournament #3767885527, $40+$10+$5 USD Hold'em No Limit - Level XVI (1500/3000) - 2024/06/26 19:52:23 UTC [2024/06/26 15:52:23 ET]
Table '3767885527 92' 8-max Seat #4 is the button
Seat 1: rabwallace1993 (104592 in chips) 
Seat 2: Mr Pay Shent (83139 in chips) 
Seat 3: Pseudo Fruto (263402 in chips) 
Seat 4: RenanToniolo (149621 in chips) 
Seat 5: mv14 (32777 in chips) out of hand (moved from another table into small blind)
Seat 6: sunn¥m4nn (88775 in chips) 
Seat 7: podiiii (29825 in chips) 
Seat 8: BorIska1993 (180899 in chips) 
mv14 will be allowed to play after the button
rabwallace1993: posts the ante 375
Mr Pay Shent: posts the ante 375
Pseudo Fruto: posts the ante 375
RenanToniolo: posts the ante 375
sunn¥m4nn: posts the ante 375
podiiii: posts the ante 375
BorIska1993: posts the ante 375
sunn¥m4nn: posts small blind 1500
podiiii: posts big blind 3000
*** HOLE CARDS ***
BorIska1993: raises 3000 to 6000
rabwallace1993: raises 6000 to 12000
Mr Pay Shent: folds 
Pseudo Fruto: folds 
RenanToniolo: folds 
sunn¥m4nn: folds 
podiiii: folds 
BorIska1993: calls 6000
*** FLOP *** [Qs 6c Tc]
BorIska1993: checks 
rabwallace1993: checks 
*** TURN *** [Qs 6c Tc] [5d]
BorIska1993: bets 21900
rabwallace1993: calls 21900
*** RIVER *** [Qs 6c Tc 5d] [Js]
BorIska1993: checks 
rabwallace1993: bets 40463
BorIska1993: calls 40463
*** SHOW DOWN ***
rabwallace1993: shows [Ks Ah] (a straight, Ten to Ace)
BorIska1993: mucks hand 
rabwallace1993 collected 155851 from pot
*** SUMMARY ***
Total pot 155851 | Rake 0 
Board [Qs 6c Tc 5d Js]
Seat 1: rabwallace1993 showed [Ks Ah] and won (155851) with a straight, Ten to Ace
Seat 2: Mr Pay Shent folded before Flop (didn't bet)
Seat 3: Pseudo Fruto folded before Flop (didn't bet)
Seat 4: RenanToniolo (button) folded before Flop (didn't bet)
Seat 6: sunn¥m4nn (small blind) folded before Flop
Seat 7: podiiii (big blind) folded before Flop
Seat 8: BorIska1993 mucked

PokerStars Hand #251206385232: Tournament #3767885527, $40+$10+$5 USD Hold'em No Limit - Level XVI (1500/3000) - 2024/06/26 19:54:32 UTC [2024/06/26 15:54:32 ET]
Table '3767885527 92' 8-max Seat #6 is the button
Seat 1: rabwallace1993 (185705 in chips) 
Seat 2: Mr Pay Shent (82764 in chips) 
Seat 3: Pseudo Fruto (263027 in chips) 
Seat 4: RenanToniolo (149246 in chips) 
Seat 5: mv14 (32777 in chips) 
Seat 6: sunn¥m4nn (86900 in chips) 
Seat 7: podiiii (26450 in chips) 
Seat 8: BorIska1993 (106161 in chips) 
rabwallace1993: posts the ante 375
Mr Pay Shent: posts the ante 375
Pseudo Fruto: posts the ante 375
RenanToniolo: posts the ante 375
mv14: posts the ante 375
sunn¥m4nn: posts the ante 375
podiiii: posts the ante 375
BorIska1993: posts the ante 375
podiiii: posts small blind 1500
BorIska1993: posts big blind 3000
*** HOLE CARDS ***
rabwallace1993: folds 
Mr Pay Shent: folds 
Pseudo Fruto: raises 3000 to 6000
RenanToniolo: folds 
mv14: folds 
sunn¥m4nn: folds 
podiiii: folds 
BorIska1993: folds 
Uncalled bet (3000) returned to Pseudo Fruto
Pseudo Fruto collected 10500 from pot
Pseudo Fruto: doesn't show hand 
*** SUMMARY ***
Total pot 10500 | Rake 0 
Seat 1: rabwallace1993 folded before Flop (didn't bet)
Seat 2: Mr Pay Shent folded before Flop (didn't bet)
Seat 3: Pseudo Fruto collected (10500)
Seat 4: RenanToniolo folded before Flop (didn't bet)
Seat 5: mv14 folded before Flop (didn't bet)
Seat 6: sunn¥m4nn (button) folded before Flop (didn't bet)
Seat 7: podiiii (small blind) folded before Flop
Seat 8: BorIska1993 (big blind) folded before Flop

PokerStars Hand #251206482751: Tournament #3767885527, $40+$10+$5 USD Hold'em No Limit - Level XVI (1500/3000) - 2024/06/26 20:01:47 UTC [2024/06/26 16:01:47 ET]
Table '3767885527 92' 8-max Seat #7 is the button
Seat 1: rabwallace1993 (185330 in chips) 
Seat 2: Mr Pay Shent (82389 in chips) 
Seat 3: Pseudo Fruto (270152 in chips) 
Seat 4: RenanToniolo (148871 in chips) 
Seat 5: mv14 (32402 in chips) 
Seat 6: sunn¥m4nn (86525 in chips) 
Seat 7: podiiii (24575 in chips) 
Seat 8: BorIska1993 (102786 in chips) 
rabwallace1993: posts the ante 375
Mr Pay Shent: posts the ante 375
Pseudo Fruto: posts the ante 375
RenanToniolo: posts the ante 375
mv14: posts the ante 375
sunn¥m4nn: posts the ante 375
podiiii: posts the ante 375
BorIska1993: posts the ante 375
BorIska1993: posts small blind 1500
rabwallace1993: posts big blind 3000
*** HOLE CARDS ***
Mr Pay Shent: folds 
Pseudo Fruto: folds 
RenanToniolo: folds 
mv14: folds 
sunn¥m4nn: raises 3000 to 6000
podiiii: folds 
BorIska1993: calls 4500
rabwallace1993: calls 3000
*** FLOP *** [5d 7c 2d]
BorIska1993: checks 
rabwallace1993: checks 
sunn¥m4nn: checks 
*** TURN *** [5d 7c 2d] [Jh]
BorIska1993: checks 
rabwallace1993: checks 
sunn¥m4nn: bets 15000
BorIska1993: folds 
rabwallace1993: calls 15000
*** RIVER *** [5d 7c 2d Jh] [Qh]
rabwallace1993: checks 
sunn¥m4nn: checks 
*** SHOW DOWN ***
rabwallace1993: shows [Kh 5s] (a pair of Fives)
sunn¥m4nn: shows [Jd Ks] (a pair of Jacks)
sunn¥m4nn collected 51000 from pot
*** SUMMARY ***
Total pot 51000 | Rake 0 
Board [5d 7c 2d Jh Qh]
Seat 1: rabwallace1993 (big blind) showed [Kh 5s] and lost with a pair of Fives
Seat 2: Mr Pay Shent folded before Flop (didn't bet)
Seat 3: Pseudo Fruto folded before Flop (didn't bet)
Seat 4: RenanToniolo folded before Flop (didn't bet)
Seat 5: mv14 folded before Flop (didn't bet)
Seat 6: sunn¥m4nn showed [Jd Ks] and won (51000) with a pair of Jacks
Seat 7: podiiii (button) folded before Flop (didn't bet)
Seat 8: BorIska1993 (small blind) folded on the Turn

PokerStars Hand #251206518088: Tournament #3767885527, $40+$10+$5 USD Hold'em No Limit - Level XVI (1500/3000) - 2024/06/26 20:03:52 UTC [2024/06/26 16:03:52 ET]
Table '3767885527 92' 8-max Seat #8 is the button
Seat 1: rabwallace1993 (163955 in chips) 
Seat 2: Mr Pay Shent (82014 in chips) 
Seat 3: Pseudo Fruto (269777 in chips) 
Seat 4: RenanToniolo (148496 in chips) 
Seat 5: mv14 (32027 in chips) 
Seat 6: sunn¥m4nn (116150 in chips) 
Seat 7: podiiii (24200 in chips) 
Seat 8: BorIska1993 (96411 in chips) 
rabwallace1993: posts the ante 375
Mr Pay Shent: posts the ante 375
Pseudo Fruto: posts the ante 375
RenanToniolo: posts the ante 375
mv14: posts the ante 375
sunn¥m4nn: posts the ante 375
podiiii: posts the ante 375
BorIska1993: posts the ante 375
rabwallace1993: posts small blind 1500
Mr Pay Shent: posts big blind 3000
*** HOLE CARDS ***
Pseudo Fruto: folds 
RenanToniolo: folds 
mv14: raises 3000 to 6000
sunn¥m4nn: folds 
podiiii: folds 
BorIska1993: folds 
rabwallace1993: folds 
Mr Pay Shent: calls 3000
*** FLOP *** [9d 6h Ac]
Mr Pay Shent: checks 
mv14: bets 5670
Mr Pay Shent: raises 5670 to 11340
mv14: calls 5670
*** TURN *** [9d 6h Ac] [7s]
Mr Pay Shent: bets 39180
mv14: folds 
Uncalled bet (39180) returned to Mr Pay Shent
Mr Pay Shent collected 39180 from pot
Mr Pay Shent: doesn't show hand 
*** SUMMARY ***
Total pot 39180 | Rake 0 
Board [9d 6h Ac 7s]
Seat 1: rabwallace1993 (small blind) folded before Flop
Seat 2: Mr Pay Shent (big blind) collected (39180)
Seat 3: Pseudo Fruto folded before Flop (didn't bet)
Seat 4: RenanToniolo folded before Flop (didn't bet)
Seat 5: mv14 folded on the Turn
Seat 6: sunn¥m4nn folded before Flop (didn't bet)
Seat 7: podiiii folded before Flop (didn't bet)
Seat 8: BorIska1993 (button) folded before Flop (didn't bet)

PokerStars Hand #251206536329: Tournament #3767885527, $40+$10+$5 USD Hold'em No Limit - Level XVI (1500/3000) - 2024/06/26 20:04:56 UTC [2024/06/26 16:04:56 ET]
Table '3767885527 92' 8-max Seat #1 is the button
Seat 1: rabwallace1993 (162080 in chips) 
Seat 2: Mr Pay Shent (103479 in chips) 
Seat 3: Pseudo Fruto (269402 in chips) 
Seat 4: RenanToniolo (148121 in chips) 
Seat 5: mv14 (14312 in chips) 
Seat 6: sunn¥m4nn (115775 in chips) 
Seat 7: podiiii (23825 in chips) 
Seat 8: BorIska1993 (96036 in chips) 
rabwallace1993: posts the ante 375
Mr Pay Shent: posts the ante 375
Pseudo Fruto: posts the ante 375
RenanToniolo: posts the ante 375
mv14: posts the ante 375
sunn¥m4nn: posts the ante 375
podiiii: posts the ante 375
BorIska1993: posts the ante 375
Mr Pay Shent: posts small blind 1500
Pseudo Fruto: posts big blind 3000
*** HOLE CARDS ***
RenanToniolo: raises 3000 to 6000
mv14: folds 
sunn¥m4nn: folds 
podiiii: folds 
BorIska1993: folds 
rabwallace1993: folds 
Mr Pay Shent: folds 
Pseudo Fruto: folds 
Uncalled bet (3000) returned to RenanToniolo
RenanToniolo collected 10500 from pot
*** SUMMARY ***
Total pot 10500 | Rake 0 
Seat 1: rabwallace1993 (button) folded before Flop (didn't bet)
Seat 2: Mr Pay Shent (small blind) folded before Flop
Seat 3: Pseudo Fruto (big blind) folded before Flop
Seat 4: RenanToniolo collected (10500)
Seat 5: mv14 folded before Flop (didn't bet)
Seat 6: sunn¥m4nn folded before Flop (didn't bet)
Seat 7: podiiii folded before Flop (didn't bet)
Seat 8: BorIska1993 folded before Flop (didn't bet)

PokerStars Hand #251206550249: Tournament #3767885527, $40+$10+$5 USD Hold'em No Limit - Level XVI (1500/3000) - 2024/06/26 20:05:44 UTC [2024/06/26 16:05:44 ET]
Table '3767885527 92' 8-max Seat #2 is the button
Seat 1: rabwallace1993 (161705 in chips) 
Seat 2: Mr Pay Shent (101604 in chips) 
Seat 3: Pseudo Fruto (266027 in chips) 
Seat 4: RenanToniolo (155246 in chips) 
Seat 5: mv14 (13937 in chips) 
Seat 6: sunn¥m4nn (115400 in chips) 
Seat 7: podiiii (23450 in chips) 
Seat 8: BorIska1993 (95661 in chips) 
rabwallace1993: posts the ante 375
Mr Pay Shent: posts the ante 375
Pseudo Fruto: posts the ante 375
RenanToniolo: posts the ante 375
mv14: posts the ante 375
sunn¥m4nn: posts the ante 375
podiiii: posts the ante 375
BorIska1993: posts the ante 375
Pseudo Fruto: posts small blind 1500
RenanToniolo: posts big blind 3000
*** HOLE CARDS ***
mv14: folds 
sunn¥m4nn: folds 
podiiii: folds 
BorIska1993: folds 
rabwallace1993: folds 
Mr Pay Shent: folds 
Pseudo Fruto: raises 7500 to 10500
RenanToniolo: calls 7500
*** FLOP *** [Th Ac 8h]
Pseudo Fruto has timed out
Pseudo Fruto: checks 
RenanToniolo: bets 16000
Pseudo Fruto: raises 26000 to 42000
RenanToniolo: folds 
Uncalled bet (26000) returned to Pseudo Fruto
Pseudo Fruto collected 56000 from pot
Pseudo Fruto: doesn't show hand 
*** SUMMARY ***
Total pot 56000 | Rake 0 
Board [Th Ac 8h]
Seat 1: rabwallace1993 folded before Flop (didn't bet)
Seat 2: Mr Pay Shent (button) folded before Flop (didn't bet)
Seat 3: Pseudo Fruto (small blind) collected (56000)
Seat 4: RenanToniolo (big blind) folded on the Flop
Seat 5: mv14 folded before Flop (didn't bet)
Seat 6: sunn¥m4nn folded before Flop (didn't bet)
Seat 7: podiiii folded before Flop (didn't bet)
Seat 8: BorIska1993 folded before Flop (didn't bet)

PokerStars Hand #251206577141: Tournament #3767885527, $40+$10+$5 USD Hold'em No Limit - Level XVII (1750/3500) - 2024/06/26 20:07:18 UTC [2024/06/26 16:07:18 ET]
Table '3767885527 92' 8-max Seat #3 is the button
Seat 1: rabwallace1993 (161330 in chips) 
Seat 2: Mr Pay Shent (101229 in chips) 
Seat 3: Pseudo Fruto (295152 in chips) 
Seat 4: RenanToniolo (128371 in chips) 
Seat 5: mv14 (13562 in chips) 
Seat 6: sunn¥m4nn (115025 in chips) 
Seat 7: podiiii (23075 in chips) 
Seat 8: BorIska1993 (95286 in chips) 
rabwallace1993: posts the ante 450
Mr Pay Shent: posts the ante 450
Pseudo Fruto: posts the ante 450
RenanToniolo: posts the ante 450
mv14: posts the ante 450
sunn¥m4nn: posts the ante 450
podiiii: posts the ante 450
BorIska1993: posts the ante 450
RenanToniolo: posts small blind 1750
mv14: posts big blind 3500
*** HOLE CARDS ***
sunn¥m4nn: folds 
podiiii: folds 
BorIska1993: folds 
rabwallace1993: folds 
Mr Pay Shent: folds 
Pseudo Fruto: folds 
RenanToniolo: raises 12250 to 15750
mv14: calls 9612 and is all-in
Uncalled bet (2638) returned to RenanToniolo
*** FLOP *** [Qd Js 7s]
*** TURN *** [Qd Js 7s] [9h]
*** RIVER *** [Qd Js 7s 9h] [Jh]
*** SHOW DOWN ***
RenanToniolo: shows [6c 5d] (a pair of Jacks)
mv14: shows [4c Jc] (three of a kind, Jacks)
mv14 collected 29824 from pot
*** SUMMARY ***
Total pot 29824 | Rake 0 
Board [Qd Js 7s 9h Jh]
Seat 1: rabwallace1993 folded before Flop (didn't bet)
Seat 2: Mr Pay Shent folded before Flop (didn't bet)
Seat 3: Pseudo Fruto (button) folded before Flop (didn't bet)
Seat 4: RenanToniolo (small blind) showed [6c 5d] and lost with a pair of Jacks
Seat 5: mv14 (big blind) showed [4c Jc] and won (29824) with three of a kind, Jacks
Seat 6: sunn¥m4nn folded before Flop (didn't bet)
Seat 7: podiiii folded before Flop (didn't bet)
Seat 8: BorIska1993 folded before Flop (didn't bet)

PokerStars Hand #251206586348: Tournament #3767885527, $40+$10+$5 USD Hold'em No Limit - Level XVII (1750/3500) - 2024/06/26 20:07:51 UTC [2024/06/26 16:07:51 ET]
Table '3767885527 92' 8-max Seat #4 is the button
Seat 1: rabwallace1993 (160880 in chips) 
Seat 2: Mr Pay Shent (100779 in chips) 
Seat 3: Pseudo Fruto (294702 in chips) 
Seat 4: RenanToniolo (114809 in chips) 
Seat 5: mv14 (29824 in chips) 
Seat 6: sunn¥m4nn (114575 in chips) 
Seat 7: podiiii (22625 in chips) 
Seat 8: BorIska1993 (94836 in chips) 
rabwallace1993: posts the ante 450
Mr Pay Shent: posts the ante 450
Pseudo Fruto: posts the ante 450
RenanToniolo: posts the ante 450
mv14: posts the ante 450
sunn¥m4nn: posts the ante 450
podiiii: posts the ante 450
BorIska1993: posts the ante 450
mv14: posts small blind 1750
sunn¥m4nn: posts big blind 3500
*** HOLE CARDS ***
podiiii: raises 18675 to 22175 and is all-in
BorIska1993: folds 
rabwallace1993: folds 
Mr Pay Shent: folds 
Pseudo Fruto: folds 
RenanToniolo: folds 
mv14: folds 
sunn¥m4nn: calls 18675
*** FLOP *** [4s Ks 7s]
*** TURN *** [4s Ks 7s] [3h]
*** RIVER *** [4s Ks 7s 3h] [7h]
*** SHOW DOWN ***
sunn¥m4nn: shows [Ad Kh] (two pair, Kings and Sevens)
podiiii: shows [9d 9c] (two pair, Nines and Sevens)
sunn¥m4nn collected 49700 from pot
podiiii finished the tournament in 394th place
*** SUMMARY ***
Total pot 49700 | Rake 0 
Board [4s Ks 7s 3h 7h]
Seat 1: rabwallace1993 folded before Flop (didn't bet)
Seat 2: Mr Pay Shent folded before Flop (didn't bet)
Seat 3: Pseudo Fruto folded before Flop (didn't bet)
Seat 4: RenanToniolo (button) folded before Flop (didn't bet)
Seat 5: mv14 (small blind) folded before Flop
Seat 6: sunn¥m4nn (big blind) showed [Ad Kh] and won (49700) with two pair, Kings and Sevens
Seat 7: podiiii showed [9d 9c] and lost with two pair, Nines and Sevens
Seat 8: BorIska1993 folded before Flop (didn't bet)

PokerStars Hand #251206594589: Tournament #3767885527, $40+$10+$5 USD Hold'em No Limit - Level XVII (1750/3500) - 2024/06/26 20:08:20 UTC [2024/06/26 16:08:20 ET]
Table '3767885527 92' 8-max Seat #5 is the button
Seat 1: rabwallace1993 (160430 in chips) 
Seat 2: Mr Pay Shent (100329 in chips) 
Seat 3: Pseudo Fruto (294252 in chips) 
Seat 4: RenanToniolo (114359 in chips) 
Seat 5: mv14 (27624 in chips) 
Seat 6: sunn¥m4nn (141650 in chips) 
Seat 8: BorIska1993 (94386 in chips) 
rabwallace1993: posts the ante 450
Mr Pay Shent: posts the ante 450
Pseudo Fruto: posts the ante 450
RenanToniolo: posts the ante 450
mv14: posts the ante 450
sunn¥m4nn: posts the ante 450
BorIska1993: posts the ante 450
sunn¥m4nn: posts small blind 1750
BorIska1993: posts big blind 3500
*** HOLE CARDS ***
rabwallace1993: folds 
Mr Pay Shent: raises 3500 to 7000
Pseudo Fruto: folds 
RenanToniolo: folds 
mv14: folds 
sunn¥m4nn: folds 
BorIska1993: calls 3500
*** FLOP *** [6c Jd 5s]
BorIska1993: checks 
Mr Pay Shent: checks 
*** TURN *** [6c Jd 5s] [7s]
BorIska1993: bets 6237
Mr Pay Shent: calls 6237
*** RIVER *** [6c Jd 5s 7s] [5d]
BorIska1993: bets 16001
Mr Pay Shent: calls 16001
*** SHOW DOWN ***
BorIska1993: shows [Ad 7d] (two pair, Sevens and Fives)
Mr Pay Shent: mucks hand 
BorIska1993 collected 63376 from pot
*** SUMMARY ***
Total pot 63376 | Rake 0 
Board [6c Jd 5s 7s 5d]
Seat 1: rabwallace1993 folded before Flop (didn't bet)
Seat 2: Mr Pay Shent mucked
Seat 3: Pseudo Fruto folded before Flop (didn't bet)
Seat 4: RenanToniolo folded before Flop (didn't bet)
Seat 5: mv14 (button) folded before Flop (didn't bet)
Seat 6: sunn¥m4nn (small blind) folded before Flop
Seat 8: BorIska1993 (big blind) showed [Ad 7d] and won (63376) with two pair, Sevens and Fives

PokerStars Hand #251206607239: Tournament #3767885527, $40+$10+$5 USD Hold'em No Limit - Level XVII (1750/3500) - 2024/06/26 20:09:04 UTC [2024/06/26 16:09:04 ET]
Table '3767885527 92' 8-max Seat #6 is the button
Seat 1: rabwallace1993 (159980 in chips) 
Seat 2: Mr Pay Shent (70641 in chips) 
Seat 3: Pseudo Fruto (293802 in chips) 
Seat 4: RenanToniolo (113909 in chips) 
Seat 5: mv14 (27174 in chips) 
Seat 6: sunn¥m4nn (139450 in chips) 
Seat 7: esdeathonlol (28675 in chips) out of hand (moved from another table into small blind)
Seat 8: BorIska1993 (128074 in chips) 
esdeathonlol will be allowed to play after the button
rabwallace1993: posts the ante 450
Mr Pay Shent: posts the ante 450
Pseudo Fruto: posts the ante 450
RenanToniolo: posts the ante 450
mv14: posts the ante 450
sunn¥m4nn: posts the ante 450
BorIska1993: posts the ante 450
BorIska1993: posts small blind 1750
rabwallace1993: posts big blind 3500
*** HOLE CARDS ***
Mr Pay Shent: folds 
Pseudo Fruto: folds 
RenanToniolo: folds 
mv14: folds 
sunn¥m4nn: raises 3500 to 7000
BorIska1993: folds 
rabwallace1993: folds 
Uncalled bet (3500) returned to sunn¥m4nn
sunn¥m4nn collected 11900 from pot
sunn¥m4nn: doesn't show hand 
*** SUMMARY ***
Total pot 11900 | Rake 0 
Seat 1: rabwallace1993 (big blind) folded before Flop
Seat 2: Mr Pay Shent folded before Flop (didn't bet)
Seat 3: Pseudo Fruto folded before Flop (didn't bet)
Seat 4: RenanToniolo folded before Flop (didn't bet)
Seat 5: mv14 folded before Flop (didn't bet)
Seat 6: sunn¥m4nn (button) collected (11900)
Seat 8: BorIska1993 (small blind) folded before Flop

PokerStars Hand #251206618581: Tournament #3767885527, $40+$10+$5 USD Hold'em No Limit - Level XVII (1750/3500) - 2024/06/26 20:09:44 UTC [2024/06/26 16:09:44 ET]
Table '3767885527 92' 8-max Seat #8 is the button
Seat 1: rabwallace1993 (156030 in chips) 
Seat 2: Mr Pay Shent (70191 in chips) 
Seat 3: Pseudo Fruto (293352 in chips) 
Seat 4: RenanToniolo (113459 in chips) 
Seat 5: mv14 (26724 in chips) 
Seat 6: sunn¥m4nn (147400 in chips) 
Seat 7: esdeathonlol (28675 in chips) 
Seat 8: BorIska1993 (125874 in chips) 
rabwallace1993: posts the ante 450
Mr Pay Shent: posts the ante 450
Pseudo Fruto: posts the ante 450
RenanToniolo: posts the ante 450
mv14: posts the ante 450
sunn¥m4nn: posts the ante 450
esdeathonlol: posts the ante 450
BorIska1993: posts the ante 450
rabwallace1993: posts small blind 1750
Mr Pay Shent: posts big blind 3500
*** HOLE CARDS ***
Pseudo Fruto: folds 
RenanToniolo: folds 
mv14: folds 
sunn¥m4nn: folds 
esdeathonlol: folds 
BorIska1993: raises 3500 to 7000
rabwallace1993: calls 5250
Mr Pay Shent: calls 3500
*** FLOP *** [2h 6c 6h]
rabwallace1993: checks 
Mr Pay Shent: checks 
BorIska1993: bets 7350
rabwallace1993: calls 7350
Mr Pay Shent: folds 
*** TURN *** [2h 6c 6h] [Ts]
rabwallace1993: checks 
BorIska1993: checks 
*** RIVER *** [2h 6c 6h Ts] [8s]
rabwallace1993: checks 
BorIska1993: checks 
*** SHOW DOWN ***
rabwallace1993: shows [3s As] (a pair of Sixes)
BorIska1993: shows [7s 7h] (two pair, Sevens and Sixes)
BorIska1993 collected 39300 from pot
*** SUMMARY ***
Total pot 39300 | Rake 0 
Board [2h 6c 6h Ts 8s]
Seat 1: rabwallace1993 (small blind) showed [3s As] and lost with a pair of Sixes
Seat 2: Mr Pay Shent (big blind) folded on the Flop
Seat 3: Pseudo Fruto folded before Flop (didn't bet)
Seat 4: RenanToniolo folded before Flop (didn't bet)
Seat 5: mv14 folded before Flop (didn't bet)
Seat 6: sunn¥m4nn folded before Flop (didn't bet)
Seat 7: esdeathonlol folded before Flop (didn't bet)
Seat 8: BorIska1993 (button) showed [7s 7h] and won (39300) with two pair, Sevens and Sixes

PokerStars Hand #251206643533: Tournament #3767885527, $40+$10+$5 USD Hold'em No Limit - Level XVII (1750/3500) - 2024/06/26 20:11:11 UTC [2024/06/26 16:11:11 ET]
Table '3767885527 92' 8-max Seat #1 is the button
Seat 1: rabwallace1993 (141230 in chips) 
Seat 2: Mr Pay Shent (62741 in chips) 
Seat 3: Pseudo Fruto (292902 in chips) 
Seat 4: RenanToniolo (113009 in chips) 
Seat 5: mv14 (26274 in chips) 
Seat 6: sunn¥m4nn (146950 in chips) 
Seat 7: esdeathonlol (28225 in chips) 
Seat 8: BorIska1993 (150374 in chips) 
rabwallace1993: posts the ante 450
Mr Pay Shent: posts the ante 450
Pseudo Fruto: posts the ante 450
RenanToniolo: posts the ante 450
mv14: posts the ante 450
sunn¥m4nn: posts the ante 450
esdeathonlol: posts the ante 450
BorIska1993: posts the ante 450
Mr Pay Shent: posts small blind 1750
Pseudo Fruto: posts big blind 3500
*** HOLE CARDS ***
RenanToniolo: folds 
mv14: folds 
sunn¥m4nn: folds 
esdeathonlol: folds 
BorIska1993: folds 
rabwallace1993: folds 
Mr Pay Shent: folds 
Uncalled bet (1750) returned to Pseudo Fruto
Pseudo Fruto collected 7100 from pot
Pseudo Fruto: doesn't show hand 
*** SUMMARY ***
Total pot 7100 | Rake 0 
Seat 1: rabwallace1993 (button) folded before Flop (didn't bet)
Seat 2: Mr Pay Shent (small blind) folded before Flop
Seat 3: Pseudo Fruto (big blind) collected (7100)
Seat 4: RenanToniolo folded before Flop (didn't bet)
Seat 5: mv14 folded before Flop (didn't bet)
Seat 6: sunn¥m4nn folded before Flop (didn't bet)
Seat 7: esdeathonlol folded before Flop (didn't bet)
Seat 8: BorIska1993 folded before Flop (didn't bet)

PokerStars Hand #251206648845: Tournament #3767885527, $40+$10+$5 USD Hold'em No Limit - Level XVII (1750/3500) - 2024/06/26 20:11:30 UTC [2024/06/26 16:11:30 ET]
Table '3767885527 92' 8-max Seat #2 is the button
Seat 1: rabwallace1993 (140780 in chips) 
Seat 2: Mr Pay Shent (60541 in chips) 
Seat 3: Pseudo Fruto (297802 in chips) 
Seat 4: RenanToniolo (112559 in chips) 
Seat 5: mv14 (25824 in chips) 
Seat 6: sunn¥m4nn (146500 in chips) 
Seat 7: esdeathonlol (27775 in chips) 
Seat 8: BorIska1993 (149924 in chips) 
rabwallace1993: posts the ante 450
Mr Pay Shent: posts the ante 450
Pseudo Fruto: posts the ante 450
RenanToniolo: posts the ante 450
mv14: posts the ante 450
sunn¥m4nn: posts the ante 450
esdeathonlol: posts the ante 450
BorIska1993: posts the ante 450
Pseudo Fruto: posts small blind 1750
RenanToniolo: posts big blind 3500
*** HOLE CARDS ***
mv14: folds 
sunn¥m4nn: folds 
esdeathonlol: folds 
BorIska1993: folds 
rabwallace1993: folds 
Mr Pay Shent: raises 56591 to 60091 and is all-in
Pseudo Fruto: raises 56591 to 116682
RenanToniolo: folds 
Uncalled bet (56591) returned to Pseudo Fruto
*** FLOP *** [Kh 6h 7h]
*** TURN *** [Kh 6h 7h] [3c]
*** RIVER *** [Kh 6h 7h 3c] [Qh]
*** SHOW DOWN ***
Pseudo Fruto: shows [As Kc] (a pair of Kings)
Mr Pay Shent: shows [2d Ac] (high card Ace)
Pseudo Fruto collected 127282 from pot
Mr Pay Shent finished the tournament in 377th place
*** SUMMARY ***
Total pot 127282 | Rake 0 
Board [Kh 6h 7h 3c Qh]
Seat 1: rabwallace1993 folded before Flop (didn't bet)
Seat 2: Mr Pay Shent (button) showed [2d Ac] and lost with high card Ace
Seat 3: Pseudo Fruto (small blind) showed [As Kc] and won (127282) with a pair of Kings
Seat 4: RenanToniolo (big blind) folded before Flop
Seat 5: mv14 folded before Flop (didn't bet)
Seat 6: sunn¥m4nn folded before Flop (didn't bet)
Seat 7: esdeathonlol folded before Flop (didn't bet)
Seat 8: BorIska1993 folded before Flop (didn't bet)


PokerStars Hand #251206987410: Tournament #3767885527, $40+$10+$5 USD Hold'em No Limit - Level XIX (2500/5000) - 2024/06/26 20:31:39 UTC [2024/06/26 16:31:39 ET]
Table '3767885527 63' 8-max Seat #5 is the button
Seat 1: T3RSS1 (51554 in chips) 
Seat 2: Giginis (280251 in chips) 
Seat 3: Antanavinis (74238 in chips) 
Seat 4: BorIska1993 (132514 in chips) 
Seat 5: haitzi1 (30414 in chips) 
Seat 6: Varle84 (86978 in chips) 
Seat 7: RRoleto (39827 in chips) 
Seat 8: Snoopy95_2.0 (135824 in chips) 
T3RSS1: posts the ante 625
Giginis: posts the ante 625
Antanavinis: posts the ante 625
BorIska1993: posts the ante 625
haitzi1: posts the ante 625
Varle84: posts the ante 625
RRoleto: posts the ante 625
Snoopy95_2.0: posts the ante 625
Varle84: posts small blind 2500
RRoleto: posts big blind 5000
*** HOLE CARDS ***
Snoopy95_2.0: folds 
T3RSS1: folds 
Giginis: folds 
Antanavinis: folds 
BorIska1993: folds 
haitzi1: folds 
Varle84: raises 81353 to 86353 and is all-in
RRoleto: folds 
Uncalled bet (81353) returned to Varle84
Varle84 collected 15000 from pot
*** SUMMARY ***
Total pot 15000 | Rake 0 
Seat 1: T3RSS1 folded before Flop (didn't bet)
Seat 2: Giginis folded before Flop (didn't bet)
Seat 3: Antanavinis folded before Flop (didn't bet)
Seat 4: BorIska1993 folded before Flop (didn't bet)
Seat 5: haitzi1 (button) folded before Flop (didn't bet)
Seat 6: Varle84 (small blind) collected (15000)
Seat 7: RRoleto (big blind) folded before Flop
Seat 8: Snoopy95_2.0 folded before Flop (didn't bet)

PokerStars Hand #251206997044: Tournament #3767885527, $40+$10+$5 USD Hold'em No Limit - Level XIX (2500/5000) - 2024/06/26 20:32:13 UTC [2024/06/26 16:32:13 ET]
Table '3767885527 63' 8-max Seat #6 is the button
Seat 1: T3RSS1 (50929 in chips) 
Seat 2: Giginis (279626 in chips) 
Seat 3: Antanavinis (73613 in chips) 
Seat 4: BorIska1993 (131889 in chips) 
Seat 5: haitzi1 (29789 in chips) 
Seat 6: Varle84 (96353 in chips) 
Seat 7: RRoleto (34202 in chips) 
Seat 8: Snoopy95_2.0 (135199 in chips) 
T3RSS1: posts the ante 625
Giginis: posts the ante 625
Antanavinis: posts the ante 625
BorIska1993: posts the ante 625
haitzi1: posts the ante 625
Varle84: posts the ante 625
RRoleto: posts the ante 625
Snoopy95_2.0: posts the ante 625
RRoleto: posts small blind 2500
Snoopy95_2.0: posts big blind 5000
*** HOLE CARDS ***
T3RSS1: folds 
Giginis: raises 5000 to 10000
Antanavinis: raises 62500 to 72500
BorIska1993: folds 
haitzi1: folds 
Varle84: folds 
RRoleto: folds 
Snoopy95_2.0: folds 
Giginis: folds 
Uncalled bet (62500) returned to Antanavinis
Antanavinis collected 32500 from pot
Antanavinis: doesn't show hand 
*** SUMMARY ***
Total pot 32500 | Rake 0 
Seat 1: T3RSS1 folded before Flop (didn't bet)
Seat 2: Giginis folded before Flop
Seat 3: Antanavinis collected (32500)
Seat 4: BorIska1993 folded before Flop (didn't bet)
Seat 5: haitzi1 folded before Flop (didn't bet)
Seat 6: Varle84 (button) folded before Flop (didn't bet)
Seat 7: RRoleto (small blind) folded before Flop
Seat 8: Snoopy95_2.0 (big blind) folded before Flop

PokerStars Hand #251207031980: Tournament #3767885527, $40+$10+$5 USD Hold'em No Limit - Level XIX (2500/5000) - 2024/06/26 20:34:17 UTC [2024/06/26 16:34:17 ET]
Table '3767885527 63' 8-max Seat #7 is the button
Seat 1: T3RSS1 (50304 in chips) 
Seat 2: Giginis (269001 in chips) 
Seat 3: Antanavinis (95488 in chips) 
Seat 4: BorIska1993 (131264 in chips) 
Seat 5: haitzi1 (29164 in chips) 
Seat 6: Varle84 (95728 in chips) 
Seat 7: RRoleto (31077 in chips) 
Seat 8: Snoopy95_2.0 (129574 in chips) 
T3RSS1: posts the ante 625
Giginis: posts the ante 625
Antanavinis: posts the ante 625
BorIska1993: posts the ante 625
haitzi1: posts the ante 625
Varle84: posts the ante 625
RRoleto: posts the ante 625
Snoopy95_2.0: posts the ante 625
Snoopy95_2.0: posts small blind 2500
T3RSS1: posts big blind 5000
*** HOLE CARDS ***
Giginis: folds 
Antanavinis: folds 
BorIska1993: folds 
haitzi1: folds 
Varle84: folds 
RRoleto: folds 
Snoopy95_2.0: raises 123949 to 128949 and is all-in
T3RSS1: folds 
Uncalled bet (123949) returned to Snoopy95_2.0
Snoopy95_2.0 collected 15000 from pot
Snoopy95_2.0: doesn't show hand 
*** SUMMARY ***
Total pot 15000 | Rake 0 
Seat 1: T3RSS1 (big blind) folded before Flop
Seat 2: Giginis folded before Flop (didn't bet)
Seat 3: Antanavinis folded before Flop (didn't bet)
Seat 4: BorIska1993 folded before Flop (didn't bet)
Seat 5: haitzi1 folded before Flop (didn't bet)
Seat 6: Varle84 folded before Flop (didn't bet)
Seat 7: RRoleto (button) folded before Flop (didn't bet)
Seat 8: Snoopy95_2.0 (small blind) collected (15000)

PokerStars Hand #251207041341: Tournament #3767885527, $40+$10+$5 USD Hold'em No Limit - Level XIX (2500/5000) - 2024/06/26 20:34:50 UTC [2024/06/26 16:34:50 ET]
Table '3767885527 63' 8-max Seat #8 is the button
Seat 1: T3RSS1 (44679 in chips) 
Seat 2: Giginis (268376 in chips) 
Seat 3: Antanavinis (94863 in chips) 
Seat 4: BorIska1993 (130639 in chips) 
Seat 5: haitzi1 (28539 in chips) 
Seat 6: Varle84 (95103 in chips) 
Seat 7: RRoleto (30452 in chips) 
Seat 8: Snoopy95_2.0 (138949 in chips) 
T3RSS1: posts the ante 625
Giginis: posts the ante 625
Antanavinis: posts the ante 625
BorIska1993: posts the ante 625
haitzi1: posts the ante 625
Varle84: posts the ante 625
RRoleto: posts the ante 625
Snoopy95_2.0: posts the ante 625
T3RSS1: posts small blind 2500
Giginis: posts big blind 5000
*** HOLE CARDS ***
Antanavinis: folds 
BorIska1993: folds 
haitzi1: folds 
Varle84: folds 
RRoleto: folds 
Snoopy95_2.0: calls 5000
T3RSS1: folds 
Giginis: raises 18000 to 23000
Snoopy95_2.0: folds 
Uncalled bet (18000) returned to Giginis
Giginis collected 17500 from pot
*** SUMMARY ***
Total pot 17500 | Rake 0 
Seat 1: T3RSS1 (small blind) folded before Flop
Seat 2: Giginis (big blind) collected (17500)
Seat 3: Antanavinis folded before Flop (didn't bet)
Seat 4: BorIska1993 folded before Flop (didn't bet)
Seat 5: haitzi1 folded before Flop (didn't bet)
Seat 6: Varle84 folded before Flop (didn't bet)
Seat 7: RRoleto folded before Flop (didn't bet)
Seat 8: Snoopy95_2.0 (button) folded before Flop

PokerStars Hand #251207053943: Tournament #3767885527, $40+$10+$5 USD Hold'em No Limit - Level XIX (2500/5000) - 2024/06/26 20:35:34 UTC [2024/06/26 16:35:34 ET]
Table '3767885527 63' 8-max Seat #1 is the button
Seat 1: T3RSS1 (41554 in chips) 
Seat 2: Giginis (280251 in chips) 
Seat 3: Antanavinis (94238 in chips) 
Seat 4: BorIska1993 (130014 in chips) 
Seat 5: haitzi1 (27914 in chips) 
Seat 6: Varle84 (94478 in chips) 
Seat 7: RRoleto (29827 in chips) 
Seat 8: Snoopy95_2.0 (133324 in chips) 
T3RSS1: posts the ante 625
Giginis: posts the ante 625
Antanavinis: posts the ante 625
BorIska1993: posts the ante 625
haitzi1: posts the ante 625
Varle84: posts the ante 625
RRoleto: posts the ante 625
Snoopy95_2.0: posts the ante 625
Giginis: posts small blind 2500
Antanavinis: posts big blind 5000
*** HOLE CARDS ***
BorIska1993: folds 
haitzi1: raises 22289 to 27289 and is all-in
Varle84: folds 
RRoleto: folds 
Snoopy95_2.0: folds 
T3RSS1: folds 
Giginis: folds 
Antanavinis: folds 
Uncalled bet (22289) returned to haitzi1
haitzi1 collected 17500 from pot
*** SUMMARY ***
Total pot 17500 | Rake 0 
Seat 1: T3RSS1 (button) folded before Flop (didn't bet)
Seat 2: Giginis (small blind) folded before Flop
Seat 3: Antanavinis (big blind) folded before Flop
Seat 4: BorIska1993 folded before Flop (didn't bet)
Seat 5: haitzi1 collected (17500)
Seat 6: Varle84 folded before Flop (didn't bet)
Seat 7: RRoleto folded before Flop (didn't bet)
Seat 8: Snoopy95_2.0 folded before Flop (didn't bet)

PokerStars Hand #251207061403: Tournament #3767885527, $40+$10+$5 USD Hold'em No Limit - Level XX (3000/6000) - 2024/06/26 20:36:01 UTC [2024/06/26 16:36:01 ET]
Table '3767885527 63' 8-max Seat #2 is the button
Seat 1: T3RSS1 (40929 in chips) 
Seat 2: Giginis (277126 in chips) 
Seat 3: Antanavinis (88613 in chips) 
Seat 4: BorIska1993 (129389 in chips) 
Seat 5: haitzi1 (39789 in chips) 
Seat 6: Varle84 (93853 in chips) 
Seat 7: RRoleto (29202 in chips) 
Seat 8: Snoopy95_2.0 (132699 in chips) 
T3RSS1: posts the ante 750
Giginis: posts the ante 750
Antanavinis: posts the ante 750
BorIska1993: posts the ante 750
haitzi1: posts the ante 750
Varle84: posts the ante 750
RRoleto: posts the ante 750
Snoopy95_2.0: posts the ante 750
Antanavinis: posts small blind 3000
BorIska1993: posts big blind 6000
*** HOLE CARDS ***
haitzi1: folds 
Varle84: folds 
RRoleto: folds 
Snoopy95_2.0: folds 
T3RSS1: folds 
Giginis: folds 
Antanavinis: calls 3000
BorIska1993: checks 
*** FLOP *** [Td 6s Tc]
Antanavinis: checks 
BorIska1993: checks 
*** TURN *** [Td 6s Tc] [Th]
Antanavinis: bets 13500
BorIska1993: folds 
Uncalled bet (13500) returned to Antanavinis
Antanavinis collected 18000 from pot
Antanavinis: doesn't show hand 
*** SUMMARY ***
Total pot 18000 | Rake 0 
Board [Td 6s Tc Th]
Seat 1: T3RSS1 folded before Flop (didn't bet)
Seat 2: Giginis (button) folded before Flop (didn't bet)
Seat 3: Antanavinis (small blind) collected (18000)
Seat 4: BorIska1993 (big blind) folded on the Turn
Seat 5: haitzi1 folded before Flop (didn't bet)
Seat 6: Varle84 folded before Flop (didn't bet)
Seat 7: RRoleto folded before Flop (didn't bet)
Seat 8: Snoopy95_2.0 folded before Flop (didn't bet)

PokerStars Hand #251207075694: Tournament #3767885527, $40+$10+$5 USD Hold'em No Limit - Level XX (3000/6000) - 2024/06/26 20:36:51 UTC [2024/06/26 16:36:51 ET]
Table '3767885527 63' 8-max Seat #3 is the button
Seat 1: T3RSS1 (40179 in chips) 
Seat 2: Giginis (276376 in chips) 
Seat 3: Antanavinis (99863 in chips) 
Seat 4: BorIska1993 (122639 in chips) 
Seat 5: haitzi1 (39039 in chips) 
Seat 6: Varle84 (93103 in chips) 
Seat 7: RRoleto (28452 in chips) 
Seat 8: Snoopy95_2.0 (131949 in chips) 
T3RSS1: posts the ante 750
Giginis: posts the ante 750
Antanavinis: posts the ante 750
BorIska1993: posts the ante 750
haitzi1: posts the ante 750
Varle84: posts the ante 750
RRoleto: posts the ante 750
Snoopy95_2.0: posts the ante 750
BorIska1993: posts small blind 3000
haitzi1: posts big blind 6000
*** HOLE CARDS ***
Varle84: folds 
RRoleto: folds 
Snoopy95_2.0: calls 6000
T3RSS1: folds 
Giginis: folds 
Antanavinis: folds 
BorIska1993: calls 3000
haitzi1: checks 
*** FLOP *** [Ad 6h 3h]
BorIska1993: checks 
haitzi1: checks 
Snoopy95_2.0: bets 6000
BorIska1993: folds 
haitzi1: folds 
Uncalled bet (6000) returned to Snoopy95_2.0
Snoopy95_2.0 collected 24000 from pot
Snoopy95_2.0: doesn't show hand 
*** SUMMARY ***
Total pot 24000 | Rake 0 
Board [Ad 6h 3h]
Seat 1: T3RSS1 folded before Flop (didn't bet)
Seat 2: Giginis folded before Flop (didn't bet)
Seat 3: Antanavinis (button) folded before Flop (didn't bet)
Seat 4: BorIska1993 (small blind) folded on the Flop
Seat 5: haitzi1 (big blind) folded on the Flop
Seat 6: Varle84 folded before Flop (didn't bet)
Seat 7: RRoleto folded before Flop (didn't bet)
Seat 8: Snoopy95_2.0 collected (24000)

PokerStars Hand #251207085336: Tournament #3767885527, $40+$10+$5 USD Hold'em No Limit - Level XX (3000/6000) - 2024/06/26 20:37:25 UTC [2024/06/26 16:37:25 ET]
Table '3767885527 63' 8-max Seat #4 is the button
Seat 1: T3RSS1 (39429 in chips) 
Seat 2: Giginis (275626 in chips) 
Seat 3: Antanavinis (99113 in chips) 
Seat 4: BorIska1993 (115889 in chips) 
Seat 5: haitzi1 (32289 in chips) 
Seat 6: Varle84 (92353 in chips) 
Seat 7: RRoleto (27702 in chips) 
Seat 8: Snoopy95_2.0 (149199 in chips) 
T3RSS1: posts the ante 750
Giginis: posts the ante 750
Antanavinis: posts the ante 750
BorIska1993: posts the ante 750
haitzi1: posts the ante 750
Varle84: posts the ante 750
RRoleto: posts the ante 750
Snoopy95_2.0: posts the ante 750
haitzi1: posts small blind 3000
Varle84: posts big blind 6000
*** HOLE CARDS ***
RRoleto: folds 
Snoopy95_2.0: folds 
T3RSS1: folds 
Giginis: folds 
Antanavinis: folds 
BorIska1993: raises 6000 to 12000
haitzi1: folds 
Varle84: raises 79603 to 91603 and is all-in
BorIska1993: folds 
Uncalled bet (79603) returned to Varle84
Varle84 collected 33000 from pot
*** SUMMARY ***
Total pot 33000 | Rake 0 
Seat 1: T3RSS1 folded before Flop (didn't bet)
Seat 2: Giginis folded before Flop (didn't bet)
Seat 3: Antanavinis folded before Flop (didn't bet)
Seat 4: BorIska1993 (button) folded before Flop
Seat 5: haitzi1 (small blind) folded before Flop
Seat 6: Varle84 (big blind) collected (33000)
Seat 7: RRoleto folded before Flop (didn't bet)
Seat 8: Snoopy95_2.0 folded before Flop (didn't bet)

PokerStars Hand #251207100786: Tournament #3767885527, $40+$10+$5 USD Hold'em No Limit - Level XX (3000/6000) - 2024/06/26 20:38:20 UTC [2024/06/26 16:38:20 ET]
Table '3767885527 63' 8-max Seat #5 is the button
Seat 1: T3RSS1 (38679 in chips) 
Seat 2: Giginis (274876 in chips) 
Seat 3: Antanavinis (98363 in chips) 
Seat 4: BorIska1993 (103139 in chips) 
Seat 5: haitzi1 (28539 in chips) 
Seat 6: Varle84 (112603 in chips) 
Seat 7: RRoleto (26952 in chips) 
Seat 8: Snoopy95_2.0 (148449 in chips) 
T3RSS1: posts the ante 750
Giginis: posts the ante 750
Antanavinis: posts the ante 750
BorIska1993: posts the ante 750
haitzi1: posts the ante 750
Varle84: posts the ante 750
RRoleto: posts the ante 750
Snoopy95_2.0: posts the ante 750
Varle84: posts small blind 3000
RRoleto: posts big blind 6000
*** HOLE CARDS ***
Snoopy95_2.0: calls 6000
T3RSS1: raises 31929 to 37929 and is all-in
Giginis: folds 
Antanavinis: folds 
BorIska1993: folds 
haitzi1: folds 
Varle84: folds 
RRoleto: calls 20202 and is all-in
Snoopy95_2.0: calls 31929
*** FLOP *** [2s Ts 9d]
*** TURN *** [2s Ts 9d] [Ah]
*** RIVER *** [2s Ts 9d Ah] [9h]
*** SHOW DOWN ***
Snoopy95_2.0: shows [Tc Jc] (two pair, Tens and Nines)
T3RSS1: shows [Ad Qs] (two pair, Aces and Nines)
T3RSS1 collected 23454 from side pot
RRoleto: shows [2c As] (two pair, Aces and Nines - lower kicker)
T3RSS1 collected 87606 from main pot
RRoleto finished the tournament in 263rd place and received $104.64.
*** SUMMARY ***
Total pot 111060 Main pot 87606. Side pot 23454. | Rake 0 
Board [2s Ts 9d Ah 9h]
Seat 1: T3RSS1 showed [Ad Qs] and won (111060) with two pair, Aces and Nines
Seat 2: Giginis folded before Flop (didn't bet)
Seat 3: Antanavinis folded before Flop (didn't bet)
Seat 4: BorIska1993 folded before Flop (didn't bet)
Seat 5: haitzi1 (button) folded before Flop (didn't bet)
Seat 6: Varle84 (small blind) folded before Flop
Seat 7: RRoleto (big blind) showed [2c As] and lost with two pair, Aces and Nines
Seat 8: Snoopy95_2.0 showed [Tc Jc] and lost with two pair, Tens and Nines

PokerStars Hand #251207113713: Tournament #3767885527, $40+$10+$5 USD Hold'em No Limit - Level XX (3000/6000) - 2024/06/26 20:39:05 UTC [2024/06/26 16:39:05 ET]
Table '3767885527 63' 8-max Seat #6 is the button
Seat 1: T3RSS1 (111060 in chips) 
Seat 2: Giginis (274126 in chips) 
Seat 3: Antanavinis (97613 in chips) 
Seat 4: BorIska1993 (102389 in chips) 
Seat 5: haitzi1 (27789 in chips) 
Seat 6: Varle84 (108853 in chips) 
Seat 8: Snoopy95_2.0 (109770 in chips) 
T3RSS1: posts the ante 750
Giginis: posts the ante 750
Antanavinis: posts the ante 750
BorIska1993: posts the ante 750
haitzi1: posts the ante 750
Varle84: posts the ante 750
Snoopy95_2.0: posts the ante 750
Snoopy95_2.0: posts small blind 3000
T3RSS1: posts big blind 6000
*** HOLE CARDS ***
Giginis: folds 
Antanavinis: folds 
BorIska1993: folds 
VICTOR TXR1 is disconnected 
haitzi1: folds 
Varle84: raises 6000 to 12000
Snoopy95_2.0: calls 9000
T3RSS1: calls 6000
*** FLOP *** [Js 4c 3h]
Snoopy95_2.0: checks 
T3RSS1: checks 
Varle84: bets 12780
Snoopy95_2.0: folds 
T3RSS1: raises 85530 to 98310 and is all-in
Varle84: folds 
Uncalled bet (85530) returned to T3RSS1
T3RSS1 collected 66810 from pot
*** SUMMARY ***
Total pot 66810 | Rake 0 
Board [Js 4c 3h]
Seat 1: T3RSS1 (big blind) collected (66810)
Seat 2: Giginis folded before Flop (didn't bet)
Seat 3: Antanavinis folded before Flop (didn't bet)
Seat 4: BorIska1993 folded before Flop (didn't bet)
Seat 5: haitzi1 folded before Flop (didn't bet)
Seat 6: Varle84 (button) folded on the Flop
Seat 8: Snoopy95_2.0 (small blind) folded on the Flop

PokerStars Hand #251207136075: Tournament #3767885527, $40+$10+$5 USD Hold'em No Limit - Level XX (3000/6000) - 2024/06/26 20:40:25 UTC [2024/06/26 16:40:25 ET]
Table '3767885527 63' 8-max Seat #8 is the button
Seat 1: T3RSS1 (152340 in chips) 
Seat 2: Giginis (273376 in chips) 
Seat 3: Antanavinis (96863 in chips) 
Seat 4: BorIska1993 (101639 in chips) 
Seat 5: haitzi1 (27039 in chips) 
Seat 6: Varle84 (83323 in chips) 
Seat 7: VICTOR TXR1 (122957 in chips) 
Seat 8: Snoopy95_2.0 (97020 in chips) 
T3RSS1: posts the ante 750
Giginis: posts the ante 750
Antanavinis: posts the ante 750
BorIska1993: posts the ante 750
haitzi1: posts the ante 750
Varle84: posts the ante 750
VICTOR TXR1: posts the ante 750
Snoopy95_2.0: posts the ante 750
T3RSS1: posts small blind 3000
Giginis: posts big blind 6000
*** HOLE CARDS ***
Antanavinis: raises 6000 to 12000
BorIska1993: folds 
haitzi1: folds 
Varle84: folds 
VICTOR TXR1: folds 
Snoopy95_2.0: folds 
T3RSS1: folds 
Giginis: calls 6000
*** FLOP *** [7s 6s Qc]
Giginis: checks 
Antanavinis: bets 10890
Giginis: calls 10890
*** TURN *** [7s 6s Qc] [9h]
Giginis: checks 
Antanavinis: bets 25080
Giginis: raises 64920 to 90000
Antanavinis: calls 48143 and is all-in
Uncalled bet (16777) returned to Giginis
*** RIVER *** [7s 6s Qc 9h] [8s]
*** SHOW DOWN ***
Giginis: shows [6h 9s] (two pair, Nines and Sixes)
Antanavinis: shows [Ks Kc] (a pair of Kings)
Giginis collected 201226 from pot
Antanavinis finished the tournament in 240th place and received $115.10.
*** SUMMARY ***
Total pot 201226 | Rake 0 
Board [7s 6s Qc 9h 8s]
Seat 1: T3RSS1 (small blind) folded before Flop
Seat 2: Giginis (big blind) showed [6h 9s] and won (201226) with two pair, Nines and Sixes
Seat 3: Antanavinis showed [Ks Kc] and lost with a pair of Kings
Seat 4: BorIska1993 folded before Flop (didn't bet)
Seat 5: haitzi1 folded before Flop (didn't bet)
Seat 6: Varle84 folded before Flop (didn't bet)
Seat 7: VICTOR TXR1 folded before Flop (didn't bet)
Seat 8: Snoopy95_2.0 (button) folded before Flop (didn't bet)

PokerStars Hand #251207156206: Tournament #3767885527, $40+$10+$5 USD Hold'em No Limit - Level XX (3000/6000) - 2024/06/26 20:41:37 UTC [2024/06/26 16:41:37 ET]
Table '3767885527 63' 8-max Seat #1 is the button
Seat 1: T3RSS1 (148590 in chips) 
Seat 2: Giginis (377739 in chips) 
Seat 4: BorIska1993 (100889 in chips) 
Seat 5: haitzi1 (26289 in chips) 
Seat 6: Varle84 (82573 in chips) 
Seat 7: VICTOR TXR1 (122207 in chips) 
Seat 8: Snoopy95_2.0 (96270 in chips) 
T3RSS1: posts the ante 750
Giginis: posts the ante 750
BorIska1993: posts the ante 750
haitzi1: posts the ante 750
Varle84: posts the ante 750
VICTOR TXR1: posts the ante 750
Snoopy95_2.0: posts the ante 750
Giginis: posts small blind 3000
BorIska1993: posts big blind 6000
*** HOLE CARDS ***
haitzi1: folds 
Varle84: folds 
VICTOR TXR1: raises 6960 to 12960
Snoopy95_2.0: folds 
T3RSS1: folds 
Giginis: folds 
BorIska1993: raises 87179 to 100139 and is all-in
VICTOR TXR1: folds 
Uncalled bet (87179) returned to BorIska1993
BorIska1993 collected 34170 from pot
BorIska1993: doesn't show hand 
*** SUMMARY ***
Total pot 34170 | Rake 0 
Seat 1: T3RSS1 (button) folded before Flop (didn't bet)
Seat 2: Giginis (small blind) folded before Flop
Seat 4: BorIska1993 (big blind) collected (34170)
Seat 5: haitzi1 folded before Flop (didn't bet)
Seat 6: Varle84 folded before Flop (didn't bet)
Seat 7: VICTOR TXR1 folded before Flop
Seat 8: Snoopy95_2.0 folded before Flop (didn't bet)

PokerStars Hand #251207163344: Tournament #3767885527, $40+$10+$5 USD Hold'em No Limit - Level XX (3000/6000) - 2024/06/26 20:42:03 UTC [2024/06/26 16:42:03 ET]
Table '3767885527 63' 8-max Seat #2 is the button
Seat 1: T3RSS1 (147840 in chips) 
Seat 2: Giginis (373989 in chips) 
Seat 4: BorIska1993 (121349 in chips) 
Seat 5: haitzi1 (25539 in chips) 
Seat 6: Varle84 (81823 in chips) 
Seat 7: VICTOR TXR1 (108497 in chips) 
Seat 8: Snoopy95_2.0 (95520 in chips) 
T3RSS1: posts the ante 750
Giginis: posts the ante 750
BorIska1993: posts the ante 750
haitzi1: posts the ante 750
Varle84: posts the ante 750
VICTOR TXR1: posts the ante 750
Snoopy95_2.0: posts the ante 750
BorIska1993: posts small blind 3000
haitzi1: posts big blind 6000
*** HOLE CARDS ***
Varle84: raises 75073 to 81073 and is all-in
VICTOR TXR1: folds 
Snoopy95_2.0: folds 
T3RSS1: folds 
Giginis: folds 
BorIska1993: raises 39526 to 120599 and is all-in
haitzi1: folds 
Uncalled bet (39526) returned to BorIska1993
*** FLOP *** [3s 2s Kc]
*** TURN *** [3s 2s Kc] [4s]
*** RIVER *** [3s 2s Kc 4s] [5s]
*** SHOW DOWN ***
BorIska1993: shows [Tc Ah] (a straight, Ace to Five)
Varle84: shows [Jc Ac] (a straight, Ace to Five)
BorIska1993 collected 86698 from pot
Varle84 collected 86698 from pot
*** SUMMARY ***
Total pot 173396 | Rake 0 
Board [3s 2s Kc 4s 5s]
Seat 1: T3RSS1 folded before Flop (didn't bet)
Seat 2: Giginis (button) folded before Flop (didn't bet)
Seat 4: BorIska1993 (small blind) showed [Tc Ah] and won (86698) with a straight, Ace to Five
Seat 5: haitzi1 (big blind) folded before Flop
Seat 6: Varle84 showed [Jc Ac] and won (86698) with a straight, Ace to Five
Seat 7: VICTOR TXR1 folded before Flop (didn't bet)
Seat 8: Snoopy95_2.0 folded before Flop (didn't bet)

PokerStars Hand #251207172961: Tournament #3767885527, $40+$10+$5 USD Hold'em No Limit - Level XX (3000/6000) - 2024/06/26 20:42:38 UTC [2024/06/26 16:42:38 ET]
Table '3767885527 63' 8-max Seat #4 is the button
Seat 1: T3RSS1 (147090 in chips) 
Seat 2: Giginis (373239 in chips) 
Seat 4: BorIska1993 (126224 in chips) 
Seat 5: haitzi1 (18789 in chips) 
Seat 6: Varle84 (86698 in chips) 
Seat 7: VICTOR TXR1 (107747 in chips) 
Seat 8: Snoopy95_2.0 (94770 in chips) 
T3RSS1: posts the ante 750
Giginis: posts the ante 750
BorIska1993: posts the ante 750
haitzi1: posts the ante 750
Varle84: posts the ante 750
VICTOR TXR1: posts the ante 750
Snoopy95_2.0: posts the ante 750
haitzi1: posts small blind 3000
Varle84: posts big blind 6000
*** HOLE CARDS ***
VICTOR TXR1: folds 
Snoopy95_2.0: calls 6000
T3RSS1: folds 
Giginis: folds 
BorIska1993: folds 
haitzi1: raises 12039 to 18039 and is all-in
Varle84: folds 
Snoopy95_2.0: calls 12039
*** FLOP *** [9h 9d Jd]
*** TURN *** [9h 9d Jd] [5h]
MaCheCazzoFai is disconnected 
*** RIVER *** [9h 9d Jd 5h] [9s]
*** SHOW DOWN ***
haitzi1: shows [8h Qs] (three of a kind, Nines)
Snoopy95_2.0: shows [Ac 7s] (three of a kind, Nines - Ace kicker)
Snoopy95_2.0 collected 47328 from pot
haitzi1 finished the tournament in 231st place and received $115.10.
*** SUMMARY ***
Total pot 47328 | Rake 0 
Board [9h 9d Jd 5h 9s]
Seat 1: T3RSS1 folded before Flop (didn't bet)
Seat 2: Giginis folded before Flop (didn't bet)
Seat 4: BorIska1993 (button) folded before Flop (didn't bet)
Seat 5: haitzi1 (small blind) showed [8h Qs] and lost with three of a kind, Nines
Seat 6: Varle84 (big blind) folded before Flop
Seat 7: VICTOR TXR1 folded before Flop (didn't bet)
Seat 8: Snoopy95_2.0 showed [Ac 7s] and won (47328) with three of a kind, Nines

PokerStars Hand #251207182610: Tournament #3767885527, $40+$10+$5 USD Hold'em No Limit - Level XX (3000/6000) - 2024/06/26 20:43:13 UTC [2024/06/26 16:43:13 ET]
Table '3767885527 63' 8-max Seat #6 is the button
Seat 1: T3RSS1 (146340 in chips) 
Seat 2: Giginis (372489 in chips) 
Seat 3: MaCheCazzoFai (117831 in chips) 
Seat 4: BorIska1993 (125474 in chips) 
Seat 6: Varle84 (79948 in chips) 
Seat 7: VICTOR TXR1 (106997 in chips) 
Seat 8: Snoopy95_2.0 (123309 in chips) 
T3RSS1: posts the ante 750
Giginis: posts the ante 750
MaCheCazzoFai: posts the ante 750
BorIska1993: posts the ante 750
Varle84: posts the ante 750
VICTOR TXR1: posts the ante 750
Snoopy95_2.0: posts the ante 750
VICTOR TXR1: posts small blind 3000
Snoopy95_2.0: posts big blind 6000
*** HOLE CARDS ***
T3RSS1: folds 
Giginis: folds 
MaCheCazzoFai: folds 
BorIska1993: folds 
Varle84: raises 73198 to 79198 and is all-in
VICTOR TXR1: folds 
Snoopy95_2.0: folds 
Uncalled bet (73198) returned to Varle84
Varle84 collected 20250 from pot
*** SUMMARY ***
Total pot 20250 | Rake 0 
Seat 1: T3RSS1 folded before Flop (didn't bet)
Seat 2: Giginis folded before Flop (didn't bet)
Seat 3: MaCheCazzoFai folded before Flop (didn't bet)
Seat 4: BorIska1993 folded before Flop (didn't bet)
Seat 6: Varle84 (button) collected (20250)
Seat 7: VICTOR TXR1 (small blind) folded before Flop
Seat 8: Snoopy95_2.0 (big blind) folded before Flop

PokerStars Hand #251207190264: Tournament #3767885527, $40+$10+$5 USD Hold'em No Limit - Level XX (3000/6000) - 2024/06/26 20:43:41 UTC [2024/06/26 16:43:41 ET]
Table '3767885527 63' 8-max Seat #7 is the button
Seat 1: T3RSS1 (145590 in chips) 
Seat 2: Giginis (371739 in chips) 
Seat 3: MaCheCazzoFai (117081 in chips) 
Seat 4: BorIska1993 (124724 in chips) 
Seat 6: Varle84 (93448 in chips) 
Seat 7: VICTOR TXR1 (103247 in chips) 
Seat 8: Snoopy95_2.0 (116559 in chips) 
T3RSS1: posts the ante 750
Giginis: posts the ante 750
MaCheCazzoFai: posts the ante 750
BorIska1993: posts the ante 750
Varle84: posts the ante 750
VICTOR TXR1: posts the ante 750
Snoopy95_2.0: posts the ante 750
Snoopy95_2.0: posts small blind 3000
T3RSS1: posts big blind 6000
*** HOLE CARDS ***
Giginis: folds 
MaCheCazzoFai: raises 6000 to 12000
BorIska1993: folds 
Varle84: folds 
VICTOR TXR1: folds 
Snoopy95_2.0: folds 
T3RSS1: folds 
Uncalled bet (6000) returned to MaCheCazzoFai
MaCheCazzoFai collected 20250 from pot
MaCheCazzoFai: doesn't show hand 
*** SUMMARY ***
Total pot 20250 | Rake 0 
Seat 1: T3RSS1 (big blind) folded before Flop
Seat 2: Giginis folded before Flop (didn't bet)
Seat 3: MaCheCazzoFai collected (20250)
Seat 4: BorIska1993 folded before Flop (didn't bet)
Seat 6: Varle84 folded before Flop (didn't bet)
Seat 7: VICTOR TXR1 (button) folded before Flop (didn't bet)
Seat 8: Snoopy95_2.0 (small blind) folded before Flop

PokerStars Hand #251207196620: Tournament #3767885527, $40+$10+$5 USD Hold'em No Limit - Level XX (3000/6000) - 2024/06/26 20:44:04 UTC [2024/06/26 16:44:04 ET]
Table '3767885527 63' 8-max Seat #8 is the button
Seat 1: T3RSS1 (138840 in chips) 
Seat 2: Giginis (370989 in chips) 
Seat 3: MaCheCazzoFai (130581 in chips) 
Seat 4: BorIska1993 (123974 in chips) 
Seat 6: Varle84 (92698 in chips) 
Seat 7: VICTOR TXR1 (102497 in chips) 
Seat 8: Snoopy95_2.0 (112809 in chips) 
T3RSS1: posts the ante 750
Giginis: posts the ante 750
MaCheCazzoFai: posts the ante 750
BorIska1993: posts the ante 750
Varle84: posts the ante 750
VICTOR TXR1: posts the ante 750
Snoopy95_2.0: posts the ante 750
T3RSS1: posts small blind 3000
Giginis: posts big blind 6000
*** HOLE CARDS ***
MaCheCazzoFai: folds 
BorIska1993: folds 
Varle84: folds 
VICTOR TXR1: raises 6000 to 12000
Snoopy95_2.0: folds 
T3RSS1: folds 
Giginis: calls 6000
*** FLOP *** [5s 7d Ah]
Giginis: checks 
VICTOR TXR1: bets 9998
Giginis: folds 
Uncalled bet (9998) returned to VICTOR TXR1
VICTOR TXR1 collected 32250 from pot
VICTOR TXR1: doesn't show hand 
*** SUMMARY ***
Total pot 32250 | Rake 0 
Board [5s 7d Ah]
Seat 1: T3RSS1 (small blind) folded before Flop
Seat 2: Giginis (big blind) folded on the Flop
Seat 3: MaCheCazzoFai folded before Flop (didn't bet)
Seat 4: BorIska1993 folded before Flop (didn't bet)
Seat 6: Varle84 folded before Flop (didn't bet)
Seat 7: VICTOR TXR1 collected (32250)
Seat 8: Snoopy95_2.0 (button) folded before Flop (didn't bet)

PokerStars Hand #251207208319: Tournament #3767885527, $40+$10+$5 USD Hold'em No Limit - Level XX (3000/6000) - 2024/06/26 20:44:47 UTC [2024/06/26 16:44:47 ET]
Table '3767885527 63' 8-max Seat #1 is the button
Seat 1: T3RSS1 (135090 in chips) 
Seat 2: Giginis (358239 in chips) 
Seat 3: MaCheCazzoFai (129831 in chips) 
Seat 4: BorIska1993 (123224 in chips) 
Seat 6: Varle84 (91948 in chips) 
Seat 7: VICTOR TXR1 (121997 in chips) 
Seat 8: Snoopy95_2.0 (112059 in chips) 
T3RSS1: posts the ante 750
Giginis: posts the ante 750
MaCheCazzoFai: posts the ante 750
BorIska1993: posts the ante 750
Varle84: posts the ante 750
VICTOR TXR1: posts the ante 750
Snoopy95_2.0: posts the ante 750
Giginis: posts small blind 3000
MaCheCazzoFai: posts big blind 6000
*** HOLE CARDS ***
BorIska1993: folds 
Varle84: folds 
NOEXITNO is disconnected 
VICTOR TXR1: folds 
Snoopy95_2.0: raises 6000 to 12000
T3RSS1: folds 
Giginis: folds 
MaCheCazzoFai: raises 117081 to 129081 and is all-in
Snoopy95_2.0: folds 
Uncalled bet (117081) returned to MaCheCazzoFai
MaCheCazzoFai collected 32250 from pot
MaCheCazzoFai: doesn't show hand 
*** SUMMARY ***
Total pot 32250 | Rake 0 
Seat 1: T3RSS1 (button) folded before Flop (didn't bet)
Seat 2: Giginis (small blind) folded before Flop
Seat 3: MaCheCazzoFai (big blind) collected (32250)
Seat 4: BorIska1993 folded before Flop (didn't bet)
Seat 6: Varle84 folded before Flop (didn't bet)
Seat 7: VICTOR TXR1 folded before Flop (didn't bet)
Seat 8: Snoopy95_2.0 folded before Flop

PokerStars Hand #251207216266: Tournament #3767885527, $40+$10+$5 USD Hold'em No Limit - Level XX (3000/6000) - 2024/06/26 20:45:16 UTC [2024/06/26 16:45:16 ET]
Table '3767885527 63' 8-max Seat #2 is the button
Seat 1: T3RSS1 (134340 in chips) 
Seat 2: Giginis (354489 in chips) 
Seat 3: MaCheCazzoFai (149331 in chips) 
Seat 4: BorIska1993 (122474 in chips) 
Seat 5: NOEXITNO (69770 in chips) 
Seat 6: Varle84 (91198 in chips) 
Seat 7: VICTOR TXR1 (121247 in chips) 
Seat 8: Snoopy95_2.0 (99309 in chips) 
T3RSS1: posts the ante 750
Giginis: posts the ante 750
MaCheCazzoFai: posts the ante 750
BorIska1993: posts the ante 750
NOEXITNO: posts the ante 750
Varle84: posts the ante 750
VICTOR TXR1: posts the ante 750
Snoopy95_2.0: posts the ante 750
MaCheCazzoFai: posts small blind 3000
BorIska1993: posts big blind 6000
*** HOLE CARDS ***
NOEXITNO: folds 
Varle84: raises 6000 to 12000
VICTOR TXR1: folds 
Snoopy95_2.0: folds 
T3RSS1: folds 
Giginis: folds 
MaCheCazzoFai: folds 
BorIska1993: calls 6000
*** FLOP *** [5c 2d 7s]
BorIska1993: checks 
Varle84: bets 17160
BorIska1993: folds 
Uncalled bet (17160) returned to Varle84
Varle84 collected 33000 from pot
*** SUMMARY ***
Total pot 33000 | Rake 0 
Board [5c 2d 7s]
Seat 1: T3RSS1 folded before Flop (didn't bet)
Seat 2: Giginis (button) folded before Flop (didn't bet)
Seat 3: MaCheCazzoFai (small blind) folded before Flop
Seat 4: BorIska1993 (big blind) folded on the Flop
Seat 5: NOEXITNO folded before Flop (didn't bet)
Seat 6: Varle84 collected (33000)
Seat 7: VICTOR TXR1 folded before Flop (didn't bet)
Seat 8: Snoopy95_2.0 folded before Flop (didn't bet)

PokerStars Hand #251207230533: Tournament #3767885527, $40+$10+$5 USD Hold'em No Limit - Level XXI (3500/7000) - 2024/06/26 20:46:08 UTC [2024/06/26 16:46:08 ET]
Table '3767885527 63' 8-max Seat #3 is the button
Seat 1: T3RSS1 (133590 in chips) 
Seat 2: Giginis (353739 in chips) 
Seat 3: MaCheCazzoFai (145581 in chips) 
Seat 4: BorIska1993 (109724 in chips) 
Seat 5: NOEXITNO (69020 in chips) 
Seat 6: Varle84 (111448 in chips) 
Seat 7: VICTOR TXR1 (120497 in chips) 
Seat 8: Snoopy95_2.0 (98559 in chips) 
T3RSS1: posts the ante 875
Giginis: posts the ante 875
MaCheCazzoFai: posts the ante 875
BorIska1993: posts the ante 875
NOEXITNO: posts the ante 875
Varle84: posts the ante 875
VICTOR TXR1: posts the ante 875
Snoopy95_2.0: posts the ante 875
BorIska1993: posts small blind 3500
NOEXITNO: posts big blind 7000
*** HOLE CARDS ***
Varle84: folds 
VICTOR TXR1: folds 
Snoopy95_2.0: folds 
T3RSS1: raises 125715 to 132715 and is all-in
Giginis: folds 
MaCheCazzoFai: folds 
BorIska1993: calls 105349 and is all-in
NOEXITNO: calls 61145 and is all-in
Uncalled bet (23866) returned to T3RSS1
*** FLOP *** [Kh 3c 6c]
*** TURN *** [Kh 3c 6c] [3h]
*** RIVER *** [Kh 3c 6c 3h] [Ts]
*** SHOW DOWN ***
BorIska1993: shows [8c 8d] (two pair, Eights and Threes)
T3RSS1: shows [Ad Kc] (two pair, Kings and Threes)
T3RSS1 collected 81408 from side pot
NOEXITNO: shows [Jd Jc] (two pair, Jacks and Threes)
T3RSS1 collected 211435 from main pot
BorIska1993 finished the tournament in 213th place and received $115.10.
NOEXITNO finished the tournament in 214th place and received $115.10.
*** SUMMARY ***
Total pot 292843 Main pot 211435. Side pot 81408. | Rake 0 
Board [Kh 3c 6c 3h Ts]
Seat 1: T3RSS1 showed [Ad Kc] and won (292843) with two pair, Kings and Threes
Seat 2: Giginis folded before Flop (didn't bet)
Seat 3: MaCheCazzoFai (button) folded before Flop (didn't bet)
Seat 4: BorIska1993 (small blind) showed [8c 8d] and lost with two pair, Eights and Threes
Seat 5: NOEXITNO (big blind) showed [Jd Jc] and lost with two pair, Jacks and Threes
Seat 6: Varle84 folded before Flop (didn't bet)
Seat 7: VICTOR TXR1 folded before Flop (didn't bet)
Seat 8: Snoopy95_2.0 folded before Flop (didn't bet)

PokerStars Hand #251207242317: Tournament #3767885527, $40+$10+$5 USD Hold'em No Limit - Level XXI (3500/7000) - 2024/06/26 20:46:51 UTC [2024/06/26 16:46:51 ET]
Table '3767885527 63' 8-max Seat #6 is the button
Seat 1: T3RSS1 (316709 in chips) 
Seat 2: Giginis (352864 in chips) 
Seat 3: MaCheCazzoFai (144706 in chips) 
Seat 6: Varle84 (110573 in chips) 
Seat 7: VICTOR TXR1 (119622 in chips) 
Seat 8: Snoopy95_2.0 (97684 in chips) 
T3RSS1: posts the ante 875
Giginis: posts the ante 875
MaCheCazzoFai: posts the ante 875
Varle84: posts the ante 875
VICTOR TXR1: posts the ante 875
Snoopy95_2.0: posts the ante 875
VICTOR TXR1: posts small blind 3500
Snoopy95_2.0: posts big blind 7000
*** HOLE CARDS ***
T3RSS1: folds 
Billionai8 is disconnected 
Giginis: raises 7000 to 14000
MaCheCazzoFai: folds 
Varle84: folds 
VICTOR TXR1: folds 
Snoopy95_2.0: folds 
Uncalled bet (7000) returned to Giginis
Giginis collected 22750 from pot
*** SUMMARY ***
Total pot 22750 | Rake 0 
Seat 1: T3RSS1 folded before Flop (didn't bet)
Seat 2: Giginis collected (22750)
Seat 3: MaCheCazzoFai folded before Flop (didn't bet)
Seat 6: Varle84 (button) folded before Flop (didn't bet)
Seat 7: VICTOR TXR1 (small blind) folded before Flop
Seat 8: Snoopy95_2.0 (big blind) folded before Flop

PokerStars Hand #251207250608: Tournament #3767885527, $40+$10+$5 USD Hold'em No Limit - Level XXI (3500/7000) - 2024/06/26 20:47:21 UTC [2024/06/26 16:47:21 ET]
Table '3767885527 63' 8-max Seat #7 is the button
Seat 1: T3RSS1 (315834 in chips) 
Seat 2: Giginis (367739 in chips) 
Seat 3: MaCheCazzoFai (143831 in chips) 
Seat 4: Billionai8 (474062 in chips) 
Seat 6: Varle84 (109698 in chips) 
Seat 7: VICTOR TXR1 (115247 in chips) 
Seat 8: Snoopy95_2.0 (89809 in chips) 
T3RSS1: posts the ante 875
Giginis: posts the ante 875
MaCheCazzoFai: posts the ante 875
Billionai8: posts the ante 875
Varle84: posts the ante 875
VICTOR TXR1: posts the ante 875
Snoopy95_2.0: posts the ante 875
Snoopy95_2.0: posts small blind 3500
T3RSS1: posts big blind 7000
*** HOLE CARDS ***
Giginis: folds 
MaCheCazzoFai: folds 
Billionai8: raises 7000 to 14000
Varle84: raises 94823 to 108823 and is all-in
VICTOR TXR1: folds 
Snoopy95_2.0: folds 
T3RSS1: folds 
Billionai8: folds 
Uncalled bet (94823) returned to Varle84
Varle84 collected 44625 from pot
*** SUMMARY ***
Total pot 44625 | Rake 0 
Seat 1: T3RSS1 (big blind) folded before Flop
Seat 2: Giginis folded before Flop (didn't bet)
Seat 3: MaCheCazzoFai folded before Flop (didn't bet)
Seat 4: Billionai8 folded before Flop
Seat 6: Varle84 collected (44625)
Seat 7: VICTOR TXR1 (button) folded before Flop (didn't bet)
Seat 8: Snoopy95_2.0 (small blind) folded before Flop

PokerStars Hand #251207258684: Tournament #3767885527, $40+$10+$5 USD Hold'em No Limit - Level XXI (3500/7000) - 2024/06/26 20:47:50 UTC [2024/06/26 16:47:50 ET]
Table '3767885527 63' 8-max Seat #8 is the button
Seat 1: T3RSS1 (307959 in chips) 
Seat 2: Giginis (366864 in chips) 
Seat 3: MaCheCazzoFai (142956 in chips) 
Seat 4: Billionai8 (459187 in chips) 
Seat 6: Varle84 (139448 in chips) 
Seat 7: VICTOR TXR1 (114372 in chips) 
Seat 8: Snoopy95_2.0 (85434 in chips) 
T3RSS1: posts the ante 875
Giginis: posts the ante 875
MaCheCazzoFai: posts the ante 875
Billionai8: posts the ante 875
Varle84: posts the ante 875
VICTOR TXR1: posts the ante 875
Snoopy95_2.0: posts the ante 875
T3RSS1: posts small blind 3500
Giginis: posts big blind 7000
*** HOLE CARDS ***
MaCheCazzoFai: folds 
Billionai8: folds 
Varle84: raises 7000 to 14000
VICTOR TXR1: folds 
Snoopy95_2.0: folds 
T3RSS1: folds 
Giginis: calls 7000
*** FLOP *** [8s 7d 6h]
Giginis: checks 
Varle84: bets 25200
Giginis: folds 
Uncalled bet (25200) returned to Varle84
Varle84 collected 37625 from pot
*** SUMMARY ***
Total pot 37625 | Rake 0 
Board [8s 7d 6h]
Seat 1: T3RSS1 (small blind) folded before Flop
Seat 2: Giginis (big blind) folded on the Flop
Seat 3: MaCheCazzoFai folded before Flop (didn't bet)
Seat 4: Billionai8 folded before Flop (didn't bet)
Seat 6: Varle84 collected (37625)
Seat 7: VICTOR TXR1 folded before Flop (didn't bet)
Seat 8: Snoopy95_2.0 (button) folded before Flop (didn't bet)

PokerStars Hand #251207277085: Tournament #3767885527, $40+$10+$5 USD Hold'em No Limit - Level XXI (3500/7000) - 2024/06/26 20:48:57 UTC [2024/06/26 16:48:57 ET]
Table '3767885527 63' 8-max Seat #1 is the button
Seat 1: T3RSS1 (303584 in chips) 
Seat 2: Giginis (351989 in chips) 
Seat 3: MaCheCazzoFai (142081 in chips) 
Seat 4: Billionai8 (458312 in chips) 
Seat 6: Varle84 (162198 in chips) 
Seat 7: VICTOR TXR1 (113497 in chips) 
Seat 8: Snoopy95_2.0 (84559 in chips) 
T3RSS1: posts the ante 875
Giginis: posts the ante 875
MaCheCazzoFai: posts the ante 875
Billionai8: posts the ante 875
Varle84: posts the ante 875
VICTOR TXR1: posts the ante 875
Snoopy95_2.0: posts the ante 875
Giginis: posts small blind 3500
MaCheCazzoFai: posts big blind 7000
*** HOLE CARDS ***
Billionai8: raises 7000 to 14000
Varle84: folds 
VICTOR TXR1: folds 
Snoopy95_2.0: folds 
T3RSS1: folds 
Giginis: folds 
MaCheCazzoFai: raises 127206 to 141206 and is all-in
Billionai8: calls 127206
*** FLOP *** [4h Ks Qh]
*** TURN *** [4h Ks Qh] [2s]
*** RIVER *** [4h Ks Qh 2s] [7h]
*** SHOW DOWN ***
MaCheCazzoFai: shows [Kd Ah] (a pair of Kings)
Billionai8: shows [3d 3s] (a pair of Threes)
MaCheCazzoFai collected 292037 from pot
*** SUMMARY ***
Total pot 292037 | Rake 0 
Board [4h Ks Qh 2s 7h]
Seat 1: T3RSS1 (button) folded before Flop (didn't bet)
Seat 2: Giginis (small blind) folded before Flop
Seat 3: MaCheCazzoFai (big blind) showed [Kd Ah] and won (292037) with a pair of Kings
Seat 4: Billionai8 showed [3d 3s] and lost with a pair of Threes
Seat 6: Varle84 folded before Flop (didn't bet)
Seat 7: VICTOR TXR1 folded before Flop (didn't bet)
Seat 8: Snoopy95_2.0 folded before Flop (didn't bet)

PokerStars Hand #251207286056: Tournament #3767885527, $40+$10+$5 USD Hold'em No Limit - Level XXI (3500/7000) - 2024/06/26 20:49:30 UTC [2024/06/26 16:49:30 ET]
Table '3767885527 63' 8-max Seat #2 is the button
Seat 1: T3RSS1 (302709 in chips) 
Seat 2: Giginis (347614 in chips) 
Seat 3: MaCheCazzoFai (292037 in chips) 
Seat 4: Billionai8 (316231 in chips) 
Seat 5: Joes38 (228746 in chips) 
Seat 6: Varle84 (161323 in chips) 
Seat 7: VICTOR TXR1 (112622 in chips) 
Seat 8: Snoopy95_2.0 (83684 in chips) 
T3RSS1: posts the ante 875
Giginis: posts the ante 875
MaCheCazzoFai: posts the ante 875
Billionai8: posts the ante 875
Joes38: posts the ante 875
Varle84: posts the ante 875
VICTOR TXR1: posts the ante 875
Snoopy95_2.0: posts the ante 875
MaCheCazzoFai: posts small blind 3500
Billionai8: posts big blind 7000
*** HOLE CARDS ***
Joes38: folds 
Varle84: folds 
VICTOR TXR1: folds 
Snoopy95_2.0: folds 
T3RSS1: folds 
Giginis: raises 7000 to 14000
MaCheCazzoFai: raises 42000 to 56000
Billionai8: folds 
Giginis: folds 
Uncalled bet (42000) returned to MaCheCazzoFai
MaCheCazzoFai collected 42000 from pot
MaCheCazzoFai: doesn't show hand 
*** SUMMARY ***
Total pot 42000 | Rake 0 
Seat 1: T3RSS1 folded before Flop (didn't bet)
Seat 2: Giginis (button) folded before Flop
Seat 3: MaCheCazzoFai (small blind) collected (42000)
Seat 4: Billionai8 (big blind) folded before Flop
Seat 5: Joes38 folded before Flop (didn't bet)
Seat 6: Varle84 folded before Flop (didn't bet)
Seat 7: VICTOR TXR1 folded before Flop (didn't bet)
Seat 8: Snoopy95_2.0 folded before Flop (didn't bet)

PokerStars Hand #251207294998: Tournament #3767885527, $40+$10+$5 USD Hold'em No Limit - Level XXI (3500/7000) - 2024/06/26 20:50:03 UTC [2024/06/26 16:50:03 ET]
Table '3767885527 63' 8-max Seat #3 is the button
Seat 1: T3RSS1 (301834 in chips) 
Seat 2: Giginis (332739 in chips) 
Seat 3: MaCheCazzoFai (319162 in chips) 
Seat 4: Billionai8 (308356 in chips) 
Seat 5: Joes38 (227871 in chips) 
Seat 6: Varle84 (160448 in chips) 
Seat 7: VICTOR TXR1 (111747 in chips) 
Seat 8: Snoopy95_2.0 (82809 in chips) 
T3RSS1: posts the ante 875
Giginis: posts the ante 875
MaCheCazzoFai: posts the ante 875
Billionai8: posts the ante 875
Joes38: posts the ante 875
Varle84: posts the ante 875
VICTOR TXR1: posts the ante 875
Snoopy95_2.0: posts the ante 875
Billionai8: posts small blind 3500
Joes38: posts big blind 7000
*** HOLE CARDS ***
Varle84: folds 
VICTOR TXR1: folds 
Snoopy95_2.0: folds 
T3RSS1: raises 7000 to 14000
Giginis: folds 
MaCheCazzoFai: folds 
Billionai8: folds 
Joes38: folds 
Uncalled bet (7000) returned to T3RSS1
T3RSS1 collected 24500 from pot
*** SUMMARY ***
Total pot 24500 | Rake 0 
Seat 1: T3RSS1 collected (24500)
Seat 2: Giginis folded before Flop (didn't bet)
Seat 3: MaCheCazzoFai (button) folded before Flop (didn't bet)
Seat 4: Billionai8 (small blind) folded before Flop
Seat 5: Joes38 (big blind) folded before Flop
Seat 6: Varle84 folded before Flop (didn't bet)
Seat 7: VICTOR TXR1 folded before Flop (didn't bet)
Seat 8: Snoopy95_2.0 folded before Flop (didn't bet)

PokerStars Hand #251207302119: Tournament #3767885527, $40+$10+$5 USD Hold'em No Limit - Level XXI (3500/7000) - 2024/06/26 20:50:29 UTC [2024/06/26 16:50:29 ET]
Table '3767885527 63' 8-max Seat #4 is the button
Seat 1: T3RSS1 (318459 in chips) 
Seat 3: MaCheCazzoFai (318287 in chips) 
Seat 4: Billionai8 (303981 in chips) 
Seat 5: Joes38 (219996 in chips) 
Seat 6: Varle84 (159573 in chips) 
Seat 7: VICTOR TXR1 (110872 in chips) 
Seat 8: Snoopy95_2.0 (81934 in chips) 
T3RSS1: posts the ante 875
MaCheCazzoFai: posts the ante 875
Billionai8: posts the ante 875
Joes38: posts the ante 875
Varle84: posts the ante 875
VICTOR TXR1: posts the ante 875
Snoopy95_2.0: posts the ante 875
Joes38: posts small blind 3500
Varle84: posts big blind 7000
*** HOLE CARDS ***
VICTOR TXR1: folds 
Snoopy95_2.0: folds 
T3RSS1: folds 
MaCheCazzoFai: folds 
Billionai8: folds 
Joes38: folds 
Uncalled bet (3500) returned to Varle84
Varle84 collected 13125 from pot
*** SUMMARY ***
Total pot 13125 | Rake 0 
Seat 1: T3RSS1 folded before Flop (didn't bet)
Seat 3: MaCheCazzoFai folded before Flop (didn't bet)
Seat 4: Billionai8 (button) folded before Flop (didn't bet)
Seat 5: Joes38 (small blind) folded before Flop
Seat 6: Varle84 (big blind) collected (13125)
Seat 7: VICTOR TXR1 folded before Flop (didn't bet)
Seat 8: Snoopy95_2.0 folded before Flop (didn't bet)

PokerStars Hand #251207305894: Tournament #3767885527, $40+$10+$5 USD Hold'em No Limit - Level XXI (3500/7000) - 2024/06/26 20:50:43 UTC [2024/06/26 16:50:43 ET]
Table '3767885527 63' 8-max Seat #5 is the button
Seat 1: T3RSS1 (317584 in chips) 
Seat 3: MaCheCazzoFai (317412 in chips) 
Seat 4: Billionai8 (303106 in chips) 
Seat 5: Joes38 (215621 in chips) 
Seat 6: Varle84 (168323 in chips) 
Seat 7: VICTOR TXR1 (109997 in chips) 
Seat 8: Snoopy95_2.0 (81059 in chips) 
T3RSS1: posts the ante 875
MaCheCazzoFai: posts the ante 875
Billionai8: posts the ante 875
Joes38: posts the ante 875
Varle84: posts the ante 875
VICTOR TXR1: posts the ante 875
Snoopy95_2.0: posts the ante 875
Varle84: posts small blind 3500
VICTOR TXR1: posts big blind 7000
*** HOLE CARDS ***
Snoopy95_2.0: folds 
T3RSS1: raises 7000 to 14000
MaCheCazzoFai: raises 28000 to 42000
Billionai8: folds 
Joes38: folds 
Varle84: folds 
VICTOR TXR1: folds 
T3RSS1: folds 
Uncalled bet (28000) returned to MaCheCazzoFai
gibbo888 is disconnected 
MaCheCazzoFai collected 44625 from pot
MaCheCazzoFai: doesn't show hand 
*** SUMMARY ***
Total pot 44625 | Rake 0 
Seat 1: T3RSS1 folded before Flop
Seat 3: MaCheCazzoFai collected (44625)
Seat 4: Billionai8 folded before Flop (didn't bet)
Seat 5: Joes38 (button) folded before Flop (didn't bet)
Seat 6: Varle84 (small blind) folded before Flop
Seat 7: VICTOR TXR1 (big blind) folded before Flop
Seat 8: Snoopy95_2.0 folded before Flop (didn't bet)

PokerStars Hand #251207311364: Tournament #3767885527, $40+$10+$5 USD Hold'em No Limit - Level XXI (3500/7000) - 2024/06/26 20:51:03 UTC [2024/06/26 16:51:03 ET]
Table '3767885527 63' 8-max Seat #6 is the button
Seat 1: T3RSS1 (302709 in chips) 
Seat 2: gibbo888 (274749 in chips) 
Seat 3: MaCheCazzoFai (347162 in chips) 
Seat 4: Billionai8 (302231 in chips) 
Seat 5: Joes38 (214746 in chips) 
Seat 6: Varle84 (163948 in chips) 
Seat 7: VICTOR TXR1 (102122 in chips) 
Seat 8: Snoopy95_2.0 (80184 in chips) 
T3RSS1: posts the ante 875
gibbo888: posts the ante 875
MaCheCazzoFai: posts the ante 875
Billionai8: posts the ante 875
Joes38: posts the ante 875
Varle84: posts the ante 875
VICTOR TXR1: posts the ante 875
Snoopy95_2.0: posts the ante 875
VICTOR TXR1: posts small blind 3500
Snoopy95_2.0: posts big blind 7000
*** HOLE CARDS ***
T3RSS1 is disconnected 
T3RSS1 is connected 
T3RSS1 is disconnected 
T3RSS1 is connected 
T3RSS1: raises 7700 to 14700
gibbo888: folds 
MaCheCazzoFai: folds 
Billionai8: folds 
Joes38: folds 
Varle84: folds 
VICTOR TXR1: folds 
Snoopy95_2.0: calls 7700
*** FLOP *** [3h Ac 5h]
Snoopy95_2.0: checks 
T3RSS1: bets 20349
Snoopy95_2.0: raises 44260 to 64609 and is all-in
T3RSS1: calls 44260
*** TURN *** [3h Ac 5h] [9c]
*** RIVER *** [3h Ac 5h 9c] [7h]
*** SHOW DOWN ***
Snoopy95_2.0: shows [4c 5d] (a pair of Fives)
T3RSS1: shows [Ad Qc] (a pair of Aces)
T3RSS1 collected 169118 from pot
Snoopy95_2.0 finished the tournament in 196th place and received $115.10.
*** SUMMARY ***
Total pot 169118 | Rake 0 
Board [3h Ac 5h 9c 7h]
Seat 1: T3RSS1 showed [Ad Qc] and won (169118) with a pair of Aces
Seat 2: gibbo888 folded before Flop (didn't bet)
Seat 3: MaCheCazzoFai folded before Flop (didn't bet)
Seat 4: Billionai8 folded before Flop (didn't bet)
Seat 5: Joes38 folded before Flop (didn't bet)
Seat 6: Varle84 (button) folded before Flop (didn't bet)
Seat 7: VICTOR TXR1 (small blind) folded before Flop
Seat 8: Snoopy95_2.0 (big blind) showed [4c 5d] and lost with a pair of Fives

PokerStars Hand #251207323587: Tournament #3767885527, $40+$10+$5 USD Hold'em No Limit - Level XXI (3500/7000) - 2024/06/26 20:51:48 UTC [2024/06/26 16:51:48 ET]
Table '3767885527 63' 8-max Seat #7 is the button
Seat 1: T3RSS1 (391643 in chips) 
Seat 2: gibbo888 (273874 in chips) 
Seat 3: MaCheCazzoFai (346287 in chips) 
Seat 4: Billionai8 (301356 in chips) 
Seat 5: Joes38 (213871 in chips) 
Seat 6: Varle84 (163073 in chips) 
Seat 7: VICTOR TXR1 (97747 in chips) 
T3RSS1: posts the ante 875
gibbo888: posts the ante 875
MaCheCazzoFai: posts the ante 875
Billionai8: posts the ante 875
Joes38: posts the ante 875
Varle84: posts the ante 875
VICTOR TXR1: posts the ante 875
T3RSS1: posts small blind 3500
gibbo888: posts big blind 7000
*** HOLE CARDS ***
MaCheCazzoFai: folds 
Billionai8: folds 
Joes38: folds 
Varle84: raises 7000 to 14000
VICTOR TXR1: folds 
T3RSS1: folds 
gibbo888: calls 7000
*** FLOP *** [8h 2c Qd]
gibbo888: checks 
Varle84: bets 11620
GuyFromGipsy is disconnected 
gibbo888: raises 19880 to 31500
Varle84: calls 19880
*** TURN *** [8h 2c Qd] [8s]
gibbo888: checks 
Varle84: bets 22680
gibbo888: folds 
Uncalled bet (22680) returned to Varle84
Varle84 collected 100625 from pot
*** SUMMARY ***
Total pot 100625 | Rake 0 
Board [8h 2c Qd 8s]
Seat 1: T3RSS1 (small blind) folded before Flop
Seat 2: gibbo888 (big blind) folded on the Turn
Seat 3: MaCheCazzoFai folded before Flop (didn't bet)
Seat 4: Billionai8 folded before Flop (didn't bet)
Seat 5: Joes38 folded before Flop (didn't bet)
Seat 6: Varle84 collected (100625)
Seat 7: VICTOR TXR1 (button) folded before Flop (didn't bet)

PokerStars Hand #251207343174: Tournament #3767885527, $40+$10+$5 USD Hold'em No Limit - Level XXI (3500/7000) - 2024/06/26 20:53:01 UTC [2024/06/26 16:53:01 ET]
Table '3767885527 63' 8-max Seat #1 is the button
Seat 1: T3RSS1 (387268 in chips) 
Seat 2: gibbo888 (227499 in chips) 
Seat 3: MaCheCazzoFai (345412 in chips) 
Seat 4: Billionai8 (300481 in chips) 
Seat 5: Joes38 (212996 in chips) 
Seat 6: Varle84 (217323 in chips) 
Seat 7: VICTOR TXR1 (96872 in chips) 
Seat 8: GuyFromGipsy (228893 in chips) 
T3RSS1: posts the ante 875
gibbo888: posts the ante 875
MaCheCazzoFai: posts the ante 875
Billionai8: posts the ante 875
Joes38: posts the ante 875
Varle84: posts the ante 875
VICTOR TXR1: posts the ante 875
GuyFromGipsy: posts the ante 875
gibbo888: posts small blind 3500
MaCheCazzoFai: posts big blind 7000
*** HOLE CARDS ***
Billionai8: folds 
Joes38: folds 
Varle84: folds 
VICTOR TXR1: folds 
GuyFromGipsy: folds 
T3RSS1: raises 7700 to 14700
gibbo888: folds 
MaCheCazzoFai: calls 7700
*** FLOP *** [Qc 5c Ac]
MaCheCazzoFai: checks 
T3RSS1: bets 13167
MaCheCazzoFai: raises 16559 to 29726
T3RSS1: calls 16559
*** TURN *** [Qc 5c Ac] [Jc]
MaCheCazzoFai: checks 
T3RSS1: checks 
*** RIVER *** [Qc 5c Ac Jc] [Td]
MaCheCazzoFai: checks 
T3RSS1: checks 
*** SHOW DOWN ***
MaCheCazzoFai: shows [Kc 6c] (a flush, Ace high)
T3RSS1: mucks hand 
MaCheCazzoFai collected 99352 from pot
*** SUMMARY ***
Total pot 99352 | Rake 0 
Board [Qc 5c Ac Jc Td]
Seat 1: T3RSS1 (button) mucked
Seat 2: gibbo888 (small blind) folded before Flop
Seat 3: MaCheCazzoFai (big blind) showed [Kc 6c] and won (99352) with a flush, Ace high
Seat 4: Billionai8 folded before Flop (didn't bet)
Seat 5: Joes38 folded before Flop (didn't bet)
Seat 6: Varle84 folded before Flop (didn't bet)
Seat 7: VICTOR TXR1 folded before Flop (didn't bet)
Seat 8: GuyFromGipsy folded before Flop (didn't bet)

PokerStars Hand #251207361275: Tournament #3767885527, $40+$10+$5 USD Hold'em No Limit - Level XXI (3500/7000) - 2024/06/26 20:54:09 UTC [2024/06/26 16:54:09 ET]
Table '3767885527 63' 8-max Seat #2 is the button
Seat 1: T3RSS1 (341967 in chips) 
Seat 2: gibbo888 (223124 in chips) 
Seat 3: MaCheCazzoFai (399463 in chips) 
Seat 4: Billionai8 (299606 in chips) 
Seat 5: Joes38 (212121 in chips) 
Seat 6: Varle84 (216448 in chips) 
Seat 7: VICTOR TXR1 (95997 in chips) 
Seat 8: GuyFromGipsy (228018 in chips) 
T3RSS1: posts the ante 875
gibbo888: posts the ante 875
MaCheCazzoFai: posts the ante 875
Billionai8: posts the ante 875
Joes38: posts the ante 875
Varle84: posts the ante 875
VICTOR TXR1: posts the ante 875
GuyFromGipsy: posts the ante 875
MaCheCazzoFai: posts small blind 3500
Billionai8: posts big blind 7000
*** HOLE CARDS ***
Joes38: raises 8400 to 15400
Varle84: folds 
VICTOR TXR1: folds 
GuyFromGipsy: folds 
T3RSS1: folds 
gibbo888: folds 
MaCheCazzoFai: folds 
Billionai8: folds 
Uncalled bet (8400) returned to Joes38
Joes38 collected 24500 from pot
*** SUMMARY ***
Total pot 24500 | Rake 0 
Seat 1: T3RSS1 folded before Flop (didn't bet)
Seat 2: gibbo888 (button) folded before Flop (didn't bet)
Seat 3: MaCheCazzoFai (small blind) folded before Flop
Seat 4: Billionai8 (big blind) folded before Flop
Seat 5: Joes38 collected (24500)
Seat 6: Varle84 folded before Flop (didn't bet)
Seat 7: VICTOR TXR1 folded before Flop (didn't bet)
Seat 8: GuyFromGipsy folded before Flop (didn't bet)

PokerStars Hand #251207367304: Tournament #3767885527, $40+$10+$5 USD Hold'em No Limit - Level XXI (3500/7000) - 2024/06/26 20:54:32 UTC [2024/06/26 16:54:32 ET]
Table '3767885527 63' 8-max Seat #3 is the button
Seat 1: T3RSS1 (341092 in chips) 
Seat 2: gibbo888 (222249 in chips) 
Seat 3: MaCheCazzoFai (395088 in chips) 
Seat 4: Billionai8 (291731 in chips) 
Seat 5: Joes38 (228746 in chips) 
Seat 6: Varle84 (215573 in chips) 
Seat 7: VICTOR TXR1 (95122 in chips) 
Seat 8: GuyFromGipsy (227143 in chips) 
T3RSS1: posts the ante 875
gibbo888: posts the ante 875
MaCheCazzoFai: posts the ante 875
Billionai8: posts the ante 875
Joes38: posts the ante 875
Varle84: posts the ante 875
VICTOR TXR1: posts the ante 875
GuyFromGipsy: posts the ante 875
Billionai8: posts small blind 3500
Joes38: posts big blind 7000
*** HOLE CARDS ***
Varle84: raises 7000 to 14000
VICTOR TXR1: folds 
GuyFromGipsy: folds 
T3RSS1: folds 
gibbo888: folds 
MaCheCazzoFai: folds 
Billionai8: folds 
Joes38: folds 
Uncalled bet (7000) returned to Varle84
Varle84 collected 24500 from pot
*** SUMMARY ***
Total pot 24500 | Rake 0 
Seat 1: T3RSS1 folded before Flop (didn't bet)
Seat 2: gibbo888 folded before Flop (didn't bet)
Seat 3: MaCheCazzoFai (button) folded before Flop (didn't bet)
Seat 4: Billionai8 (small blind) folded before Flop
Seat 5: Joes38 (big blind) folded before Flop
Seat 6: Varle84 collected (24500)
Seat 7: VICTOR TXR1 folded before Flop (didn't bet)
Seat 8: GuyFromGipsy folded before Flop (didn't bet)

PokerStars Hand #251207373646: Tournament #3767885527, $40+$10+$5 USD Hold'em No Limit - Level XXI (3500/7000) - 2024/06/26 20:54:55 UTC [2024/06/26 16:54:55 ET]
Table '3767885527 63' 8-max Seat #4 is the button
Seat 1: T3RSS1 (340217 in chips) 
Seat 2: gibbo888 (221374 in chips) 
Seat 3: MaCheCazzoFai (394213 in chips) 
Seat 4: Billionai8 (287356 in chips) 
Seat 5: Joes38 (220871 in chips) 
Seat 6: Varle84 (232198 in chips) 
Seat 7: VICTOR TXR1 (94247 in chips) 
Seat 8: GuyFromGipsy (226268 in chips) 
T3RSS1: posts the ante 875
gibbo888: posts the ante 875
MaCheCazzoFai: posts the ante 875
Billionai8: posts the ante 875
Joes38: posts the ante 875
Varle84: posts the ante 875
VICTOR TXR1: posts the ante 875
GuyFromGipsy: posts the ante 875
Joes38: posts small blind 3500
Varle84: posts big blind 7000
*** HOLE CARDS ***
VICTOR TXR1: folds 
GuyFromGipsy: folds 
T3RSS1: folds 
gibbo888: raises 7000 to 14000
MaCheCazzoFai: folds 
Billionai8: raises 28000 to 42000
Joes38: folds 
Varle84: folds 
gibbo888: calls 28000
*** FLOP *** [5d 8s 4d]
gibbo888: checks 
Billionai8: checks 
*** TURN *** [5d 8s 4d] [Td]
gibbo888: checks 
Billionai8: checks 
*** RIVER *** [5d 8s 4d Td] [Js]
gibbo888: checks 
Billionai8: checks 
*** SHOW DOWN ***
gibbo888: shows [Qd Kc] (high card King)
Billionai8: shows [4h Kh] (a pair of Fours)
Billionai8 collected 101500 from pot
*** SUMMARY ***
Total pot 101500 | Rake 0 
Board [5d 8s 4d Td Js]
Seat 1: T3RSS1 folded before Flop (didn't bet)
Seat 2: gibbo888 showed [Qd Kc] and lost with high card King
Seat 3: MaCheCazzoFai folded before Flop (didn't bet)
Seat 4: Billionai8 (button) showed [4h Kh] and won (101500) with a pair of Fours
Seat 5: Joes38 (small blind) folded before Flop
Seat 6: Varle84 (big blind) folded before Flop
Seat 7: VICTOR TXR1 folded before Flop (didn't bet)
Seat 8: GuyFromGipsy folded before Flop (didn't bet)

PokerStars Hand #251207474919: Tournament #3767885527, $40+$10+$5 USD Hold'em No Limit - Level XXI (3500/7000) - 2024/06/26 21:02:48 UTC [2024/06/26 17:02:48 ET]
Table '3767885527 63' 8-max Seat #5 is the button
Seat 1: T3RSS1 (339342 in chips) 
Seat 2: gibbo888 (178499 in chips) 
Seat 3: MaCheCazzoFai (393338 in chips) 
Seat 4: Billionai8 (345981 in chips) 
Seat 5: Joes38 (216496 in chips) 
Seat 6: Varle84 (224323 in chips) 
Seat 7: VICTOR TXR1 (93372 in chips) 
Seat 8: GuyFromGipsy (225393 in chips) 
T3RSS1: posts the ante 875
gibbo888: posts the ante 875
MaCheCazzoFai: posts the ante 875
Billionai8: posts the ante 875
Joes38: posts the ante 875
Varle84: posts the ante 875
VICTOR TXR1: posts the ante 875
GuyFromGipsy: posts the ante 875
Varle84: posts small blind 3500
VICTOR TXR1: posts big blind 7000
*** HOLE CARDS ***
GuyFromGipsy: folds 
T3RSS1: folds 
gibbo888: raises 7000 to 14000
MaCheCazzoFai: folds 
Billionai8: folds 
Joes38: folds 
Varle84: folds 
VICTOR TXR1: folds 
Uncalled bet (7000) returned to gibbo888
gibbo888 collected 24500 from pot
*** SUMMARY ***
Total pot 24500 | Rake 0 
Seat 1: T3RSS1 folded before Flop (didn't bet)
Seat 2: gibbo888 collected (24500)
Seat 3: MaCheCazzoFai folded before Flop (didn't bet)
Seat 4: Billionai8 folded before Flop (didn't bet)
Seat 5: Joes38 (button) folded before Flop (didn't bet)
Seat 6: Varle84 (small blind) folded before Flop
Seat 7: VICTOR TXR1 (big blind) folded before Flop
Seat 8: GuyFromGipsy folded before Flop (didn't bet)

PokerStars Hand #251207480591: Tournament #3767885527, $40+$10+$5 USD Hold'em No Limit - Level XXI (3500/7000) - 2024/06/26 21:03:09 UTC [2024/06/26 17:03:09 ET]
Table '3767885527 63' 8-max Seat #6 is the button
Seat 1: T3RSS1 (338467 in chips) 
Seat 2: gibbo888 (195124 in chips) 
Seat 3: MaCheCazzoFai (392463 in chips) 
Seat 4: Billionai8 (345106 in chips) 
Seat 5: Joes38 (215621 in chips) 
Seat 6: Varle84 (219948 in chips) 
Seat 7: VICTOR TXR1 (85497 in chips) 
Seat 8: GuyFromGipsy (224518 in chips) 
T3RSS1: posts the ante 875
gibbo888: posts the ante 875
MaCheCazzoFai: posts the ante 875
Billionai8: posts the ante 875
Joes38: posts the ante 875
Varle84: posts the ante 875
VICTOR TXR1: posts the ante 875
GuyFromGipsy: posts the ante 875
VICTOR TXR1: posts small blind 3500
GuyFromGipsy: posts big blind 7000
*** HOLE CARDS ***
T3RSS1: folds 
gibbo888: folds 
MaCheCazzoFai: folds 
Billionai8: folds 
Joes38: folds 
Varle84: folds 
VICTOR TXR1: calls 3500
GuyFromGipsy: raises 216643 to 223643 and is all-in
VICTOR TXR1: folds 
Uncalled bet (216643) returned to GuyFromGipsy
GuyFromGipsy collected 21000 from pot
GuyFromGipsy: doesn't show hand 
*** SUMMARY ***
Total pot 21000 | Rake 0 
Seat 1: T3RSS1 folded before Flop (didn't bet)
Seat 2: gibbo888 folded before Flop (didn't bet)
Seat 3: MaCheCazzoFai folded before Flop (didn't bet)
Seat 4: Billionai8 folded before Flop (didn't bet)
Seat 5: Joes38 folded before Flop (didn't bet)
Seat 6: Varle84 (button) folded before Flop (didn't bet)
Seat 7: VICTOR TXR1 (small blind) folded before Flop
Seat 8: GuyFromGipsy (big blind) collected (21000)

PokerStars Hand #251207500261: Tournament #3767885527, $40+$10+$5 USD Hold'em No Limit - Level XXII (4000/8000) - 2024/06/26 21:04:21 UTC [2024/06/26 17:04:21 ET]
Table '3767885527 63' 8-max Seat #7 is the button
Seat 1: T3RSS1 (337592 in chips) 
Seat 2: gibbo888 (194249 in chips) 
Seat 3: MaCheCazzoFai (391588 in chips) 
Seat 4: Billionai8 (344231 in chips) 
Seat 5: Joes38 (214746 in chips) 
Seat 6: Varle84 (219073 in chips) 
Seat 7: VICTOR TXR1 (77622 in chips) 
Seat 8: GuyFromGipsy (237643 in chips) 
T3RSS1: posts the ante 1000
gibbo888: posts the ante 1000
MaCheCazzoFai: posts the ante 1000
Billionai8: posts the ante 1000
Joes38: posts the ante 1000
Varle84: posts the ante 1000
VICTOR TXR1: posts the ante 1000
GuyFromGipsy: posts the ante 1000
GuyFromGipsy: posts small blind 4000
T3RSS1: posts big blind 8000
*** HOLE CARDS ***
gibbo888: folds 
MaCheCazzoFai: folds 
Billionai8: folds 
Joes38: folds 
Varle84: raises 8000 to 16000
VICTOR TXR1: folds 
GuyFromGipsy: raises 32000 to 48000
T3RSS1: folds 
Varle84: folds 
Uncalled bet (32000) returned to GuyFromGipsy
GuyFromGipsy collected 48000 from pot
GuyFromGipsy: doesn't show hand 
*** SUMMARY ***
Total pot 48000 | Rake 0 
Seat 1: T3RSS1 (big blind) folded before Flop
Seat 2: gibbo888 folded before Flop (didn't bet)
Seat 3: MaCheCazzoFai folded before Flop (didn't bet)
Seat 4: Billionai8 folded before Flop (didn't bet)
Seat 5: Joes38 folded before Flop (didn't bet)
Seat 6: Varle84 folded before Flop
Seat 7: VICTOR TXR1 (button) folded before Flop (didn't bet)
Seat 8: GuyFromGipsy (small blind) collected (48000)

PokerStars Hand #251207512232: Tournament #3767885527, $40+$10+$5 USD Hold'em No Limit - Level XXII (4000/8000) - 2024/06/26 21:05:06 UTC [2024/06/26 17:05:06 ET]
Table '3767885527 63' 8-max Seat #8 is the button
Seat 1: T3RSS1 (328592 in chips) 
Seat 2: gibbo888 (193249 in chips) 
Seat 3: MaCheCazzoFai (390588 in chips) 
Seat 4: Billionai8 (343231 in chips) 
Seat 5: Joes38 (213746 in chips) 
Seat 6: Varle84 (202073 in chips) 
Seat 7: VICTOR TXR1 (76622 in chips) 
Seat 8: GuyFromGipsy (268643 in chips) 
T3RSS1: posts the ante 1000
gibbo888: posts the ante 1000
MaCheCazzoFai: posts the ante 1000
Billionai8: posts the ante 1000
Joes38: posts the ante 1000
Varle84: posts the ante 1000
VICTOR TXR1: posts the ante 1000
GuyFromGipsy: posts the ante 1000
T3RSS1: posts small blind 4000
gibbo888: posts big blind 8000
*** HOLE CARDS ***
MaCheCazzoFai: raises 8000 to 16000
Billionai8: folds 
Joes38: folds 
Varle84: folds 
VICTOR TXR1: folds 
GuyFromGipsy: folds 
T3RSS1: folds 
gibbo888: folds 
Uncalled bet (8000) returned to MaCheCazzoFai
MaCheCazzoFai collected 28000 from pot
MaCheCazzoFai: doesn't show hand 
*** SUMMARY ***
Total pot 28000 | Rake 0 
Seat 1: T3RSS1 (small blind) folded before Flop
Seat 2: gibbo888 (big blind) folded before Flop
Seat 3: MaCheCazzoFai collected (28000)
Seat 4: Billionai8 folded before Flop (didn't bet)
Seat 5: Joes38 folded before Flop (didn't bet)
Seat 6: Varle84 folded before Flop (didn't bet)
Seat 7: VICTOR TXR1 folded before Flop (didn't bet)
Seat 8: GuyFromGipsy (button) folded before Flop (didn't bet)

PokerStars Hand #251207523520: Tournament #3767885527, $40+$10+$5 USD Hold'em No Limit - Level XXII (4000/8000) - 2024/06/26 21:05:43 UTC [2024/06/26 17:05:43 ET]
Table '3767885527 63' 8-max Seat #1 is the button
Seat 1: T3RSS1 (323592 in chips) 
Seat 2: gibbo888 (184249 in chips) 
Seat 3: MaCheCazzoFai (409588 in chips) 
Seat 4: Billionai8 (342231 in chips) 
Seat 6: Varle84 (201073 in chips) 
Seat 7: VICTOR TXR1 (75622 in chips) 
Seat 8: GuyFromGipsy (267643 in chips) 
T3RSS1: posts the ante 1000
gibbo888: posts the ante 1000
MaCheCazzoFai: posts the ante 1000
Billionai8: posts the ante 1000
Varle84: posts the ante 1000
VICTOR TXR1: posts the ante 1000
GuyFromGipsy: posts the ante 1000
gibbo888: posts small blind 4000
MaCheCazzoFai: posts big blind 8000
*** HOLE CARDS ***
Billionai8: folds 
Varle84: folds 
Juicy_J_93 is disconnected 
VICTOR TXR1: folds 
GuyFromGipsy: folds 
T3RSS1: folds 
gibbo888: folds 
Uncalled bet (4000) returned to MaCheCazzoFai
MaCheCazzoFai collected 15000 from pot
MaCheCazzoFai: doesn't show hand 
*** SUMMARY ***
Total pot 15000 | Rake 0 
Seat 1: T3RSS1 (button) folded before Flop (didn't bet)
Seat 2: gibbo888 (small blind) folded before Flop
Seat 3: MaCheCazzoFai (big blind) collected (15000)
Seat 4: Billionai8 folded before Flop (didn't bet)
Seat 6: Varle84 folded before Flop (didn't bet)
Seat 7: VICTOR TXR1 folded before Flop (didn't bet)
Seat 8: GuyFromGipsy folded before Flop (didn't bet)

PokerStars Hand #251207530156: Tournament #3767885527, $40+$10+$5 USD Hold'em No Limit - Level XXII (4000/8000) - 2024/06/26 21:06:05 UTC [2024/06/26 17:06:05 ET]
Table '3767885527 63' 8-max Seat #2 is the button
Seat 1: T3RSS1 (322592 in chips) 
Seat 2: gibbo888 (179249 in chips) 
Seat 3: MaCheCazzoFai (419588 in chips) 
Seat 4: Billionai8 (341231 in chips) 
Seat 5: Juicy_J_93 (166051 in chips) 
Seat 6: Varle84 (200073 in chips) 
Seat 7: VICTOR TXR1 (74622 in chips) 
Seat 8: GuyFromGipsy (266643 in chips) 
T3RSS1: posts the ante 1000
gibbo888: posts the ante 1000
MaCheCazzoFai: posts the ante 1000
Billionai8: posts the ante 1000
Juicy_J_93: posts the ante 1000
Varle84: posts the ante 1000
VICTOR TXR1: posts the ante 1000
GuyFromGipsy: posts the ante 1000
MaCheCazzoFai: posts small blind 4000
Billionai8: posts big blind 8000
*** HOLE CARDS ***
Juicy_J_93: folds 
Varle84: folds 
VICTOR TXR1: folds 
GuyFromGipsy: folds 
T3RSS1: folds 
gibbo888: folds 
MaCheCazzoFai: calls 4000
Billionai8: checks 
*** FLOP *** [8d 9h 5h]
MaCheCazzoFai: checks 
Billionai8: checks 
*** TURN *** [8d 9h 5h] [Qh]
MaCheCazzoFai: bets 16000
Billionai8: folds 
Uncalled bet (16000) returned to MaCheCazzoFai
MaCheCazzoFai collected 24000 from pot
MaCheCazzoFai: doesn't show hand 
*** SUMMARY ***
Total pot 24000 | Rake 0 
Board [8d 9h 5h Qh]
Seat 1: T3RSS1 folded before Flop (didn't bet)
Seat 2: gibbo888 (button) folded before Flop (didn't bet)
Seat 3: MaCheCazzoFai (small blind) collected (24000)
Seat 4: Billionai8 (big blind) folded on the Turn
Seat 5: Juicy_J_93 folded before Flop (didn't bet)
Seat 6: Varle84 folded before Flop (didn't bet)
Seat 7: VICTOR TXR1 folded before Flop (didn't bet)
Seat 8: GuyFromGipsy folded before Flop (didn't bet)

PokerStars Hand #251207543368: Tournament #3767885527, $40+$10+$5 USD Hold'em No Limit - Level XXII (4000/8000) - 2024/06/26 21:06:49 UTC [2024/06/26 17:06:49 ET]
Table '3767885527 63' 8-max Seat #3 is the button
Seat 1: T3RSS1 (321592 in chips) 
Seat 2: gibbo888 (178249 in chips) 
Seat 3: MaCheCazzoFai (434588 in chips) 
Seat 4: Billionai8 (332231 in chips) 
Seat 5: Juicy_J_93 (165051 in chips) 
Seat 6: Varle84 (199073 in chips) 
Seat 7: VICTOR TXR1 (73622 in chips) 
Seat 8: GuyFromGipsy (265643 in chips) 
T3RSS1: posts the ante 1000
gibbo888: posts the ante 1000
MaCheCazzoFai: posts the ante 1000
Billionai8: posts the ante 1000
Juicy_J_93: posts the ante 1000
Varle84: posts the ante 1000
VICTOR TXR1: posts the ante 1000
GuyFromGipsy: posts the ante 1000
Billionai8: posts small blind 4000
Juicy_J_93: posts big blind 8000
*** HOLE CARDS ***
Varle84: folds 
VICTOR TXR1: folds 
GuyFromGipsy: folds 
T3RSS1: folds 
gibbo888: folds 
MaCheCazzoFai: folds 
Billionai8: raises 323231 to 331231 and is all-in
Juicy_J_93: folds 
Uncalled bet (323231) returned to Billionai8
Billionai8 collected 24000 from pot
Billionai8: doesn't show hand 
*** SUMMARY ***
Total pot 24000 | Rake 0 
Seat 1: T3RSS1 folded before Flop (didn't bet)
Seat 2: gibbo888 folded before Flop (didn't bet)
Seat 3: MaCheCazzoFai (button) folded before Flop (didn't bet)
Seat 4: Billionai8 (small blind) collected (24000)
Seat 5: Juicy_J_93 (big blind) folded before Flop
Seat 6: Varle84 folded before Flop (didn't bet)
Seat 7: VICTOR TXR1 folded before Flop (didn't bet)
Seat 8: GuyFromGipsy folded before Flop (didn't bet)

PokerStars Hand #251207552217: Tournament #3767885527, $40+$10+$5 USD Hold'em No Limit - Level XXII (4000/8000) - 2024/06/26 21:07:19 UTC [2024/06/26 17:07:19 ET]
Table '3767885527 63' 8-max Seat #4 is the button
Seat 1: T3RSS1 (320592 in chips) 
Seat 2: gibbo888 (177249 in chips) 
Seat 3: MaCheCazzoFai (433588 in chips) 
Seat 4: Billionai8 (347231 in chips) 
Seat 5: Juicy_J_93 (156051 in chips) 
Seat 6: Varle84 (198073 in chips) 
Seat 7: VICTOR TXR1 (72622 in chips) 
Seat 8: GuyFromGipsy (264643 in chips) 
T3RSS1: posts the ante 1000
gibbo888: posts the ante 1000
MaCheCazzoFai: posts the ante 1000
Billionai8: posts the ante 1000
Juicy_J_93: posts the ante 1000
Varle84: posts the ante 1000
VICTOR TXR1: posts the ante 1000
GuyFromGipsy: posts the ante 1000
Juicy_J_93: posts small blind 4000
Varle84: posts big blind 8000
*** HOLE CARDS ***
VICTOR TXR1: raises 63622 to 71622 and is all-in
GuyFromGipsy: folds 
T3RSS1: folds 
gibbo888: folds 
MaCheCazzoFai: folds 
Billionai8: folds 
Juicy_J_93: folds 
Varle84: folds 
Uncalled bet (63622) returned to VICTOR TXR1
VICTOR TXR1 collected 28000 from pot
VICTOR TXR1: doesn't show hand 
*** SUMMARY ***
Total pot 28000 | Rake 0 
Seat 1: T3RSS1 folded before Flop (didn't bet)
Seat 2: gibbo888 folded before Flop (didn't bet)
Seat 3: MaCheCazzoFai folded before Flop (didn't bet)
Seat 4: Billionai8 (button) folded before Flop (didn't bet)
Seat 5: Juicy_J_93 (small blind) folded before Flop
Seat 6: Varle84 (big blind) folded before Flop
Seat 7: VICTOR TXR1 collected (28000)
Seat 8: GuyFromGipsy folded before Flop (didn't bet)

PokerStars Hand #251207562158: Tournament #3767885527, $40+$10+$5 USD Hold'em No Limit - Level XXII (4000/8000) - 2024/06/26 21:07:52 UTC [2024/06/26 17:07:52 ET]
Table '3767885527 63' 8-max Seat #5 is the button
Seat 1: T3RSS1 (319592 in chips) 
Seat 2: gibbo888 (176249 in chips) 
Seat 3: MaCheCazzoFai (432588 in chips) 
Seat 4: Billionai8 (346231 in chips) 
Seat 5: Juicy_J_93 (151051 in chips) 
Seat 6: Varle84 (189073 in chips) 
Seat 7: VICTOR TXR1 (91622 in chips) 
Seat 8: GuyFromGipsy (263643 in chips) 
T3RSS1: posts the ante 1000
gibbo888: posts the ante 1000
MaCheCazzoFai: posts the ante 1000
Billionai8: posts the ante 1000
Juicy_J_93: posts the ante 1000
Varle84: posts the ante 1000
VICTOR TXR1: posts the ante 1000
GuyFromGipsy: posts the ante 1000
Varle84: posts small blind 4000
VICTOR TXR1: posts big blind 8000
*** HOLE CARDS ***
GuyFromGipsy: folds 
T3RSS1: folds 
gibbo888: folds 
MaCheCazzoFai: folds 
Billionai8: folds 
Juicy_J_93: raises 8000 to 16000
Varle84: folds 
VICTOR TXR1: folds 
Uncalled bet (8000) returned to Juicy_J_93
Juicy_J_93 collected 28000 from pot
Juicy_J_93: doesn't show hand 
*** SUMMARY ***
Total pot 28000 | Rake 0 
Seat 1: T3RSS1 folded before Flop (didn't bet)
Seat 2: gibbo888 folded before Flop (didn't bet)
Seat 3: MaCheCazzoFai folded before Flop (didn't bet)
Seat 4: Billionai8 folded before Flop (didn't bet)
Seat 5: Juicy_J_93 (button) collected (28000)
Seat 6: Varle84 (small blind) folded before Flop
Seat 7: VICTOR TXR1 (big blind) folded before Flop
Seat 8: GuyFromGipsy folded before Flop (didn't bet)

PokerStars Hand #251207571153: Tournament #3767885527, $40+$10+$5 USD Hold'em No Limit - Level XXII (4000/8000) - 2024/06/26 21:08:21 UTC [2024/06/26 17:08:21 ET]
Table '3767885527 63' 8-max Seat #6 is the button
Seat 1: T3RSS1 (318592 in chips) 
Seat 2: gibbo888 (175249 in chips) 
Seat 3: MaCheCazzoFai (431588 in chips) 
Seat 4: Billionai8 (345231 in chips) 
Seat 5: Juicy_J_93 (170051 in chips) 
Seat 6: Varle84 (184073 in chips) 
Seat 7: VICTOR TXR1 (82622 in chips) 
Seat 8: GuyFromGipsy (262643 in chips) 
T3RSS1: posts the ante 1000
gibbo888: posts the ante 1000
MaCheCazzoFai: posts the ante 1000
Billionai8: posts the ante 1000
Juicy_J_93: posts the ante 1000
Varle84: posts the ante 1000
VICTOR TXR1: posts the ante 1000
GuyFromGipsy: posts the ante 1000
VICTOR TXR1: posts small blind 4000
GuyFromGipsy: posts big blind 8000
*** HOLE CARDS ***
T3RSS1: folds 
gibbo888: folds 
MaCheCazzoFai: folds 
Billionai8: folds 
Juicy_J_93: folds 
Varle84: folds 
VICTOR TXR1: folds 
Uncalled bet (4000) returned to GuyFromGipsy
GuyFromGipsy collected 16000 from pot
GuyFromGipsy: doesn't show hand 
*** SUMMARY ***
Total pot 16000 | Rake 0 
Seat 1: T3RSS1 folded before Flop (didn't bet)
Seat 2: gibbo888 folded before Flop (didn't bet)
Seat 3: MaCheCazzoFai folded before Flop (didn't bet)
Seat 4: Billionai8 folded before Flop (didn't bet)
Seat 5: Juicy_J_93 folded before Flop (didn't bet)
Seat 6: Varle84 (button) folded before Flop (didn't bet)
Seat 7: VICTOR TXR1 (small blind) folded before Flop
Seat 8: GuyFromGipsy (big blind) collected (16000)

PokerStars Hand #251207576231: Tournament #3767885527, $40+$10+$5 USD Hold'em No Limit - Level XXII (4000/8000) - 2024/06/26 21:08:38 UTC [2024/06/26 17:08:38 ET]
Table '3767885527 63' 8-max Seat #7 is the button
Seat 1: T3RSS1 (317592 in chips) 
Seat 2: gibbo888 (174249 in chips) 
Seat 3: MaCheCazzoFai (430588 in chips) 
Seat 4: Billionai8 (344231 in chips) 
Seat 5: Juicy_J_93 (169051 in chips) 
Seat 6: Varle84 (183073 in chips) 
Seat 7: VICTOR TXR1 (77622 in chips) 
Seat 8: GuyFromGipsy (273643 in chips) 
T3RSS1: posts the ante 1000
gibbo888: posts the ante 1000
MaCheCazzoFai: posts the ante 1000
Billionai8: posts the ante 1000
Juicy_J_93: posts the ante 1000
Varle84: posts the ante 1000
VICTOR TXR1: posts the ante 1000
GuyFromGipsy: posts the ante 1000
GuyFromGipsy: posts small blind 4000
T3RSS1: posts big blind 8000
*** HOLE CARDS ***
gibbo888: folds 
MaCheCazzoFai: folds 
Billionai8: raises 8000 to 16000
Juicy_J_93: folds 
Varle84: raises 166073 to 182073 and is all-in
VICTOR TXR1: folds 
GuyFromGipsy: folds 
T3RSS1: folds 
Billionai8: folds 
Uncalled bet (166073) returned to Varle84
Varle84 collected 52000 from pot
*** SUMMARY ***
Total pot 52000 | Rake 0 
Seat 1: T3RSS1 (big blind) folded before Flop
Seat 2: gibbo888 folded before Flop (didn't bet)
Seat 3: MaCheCazzoFai folded before Flop (didn't bet)
Seat 4: Billionai8 folded before Flop
Seat 5: Juicy_J_93 folded before Flop (didn't bet)
Seat 6: Varle84 collected (52000)
Seat 7: VICTOR TXR1 (button) folded before Flop (didn't bet)
Seat 8: GuyFromGipsy (small blind) folded before Flop

PokerStars Hand #251207591755: Tournament #3767885527, $40+$10+$5 USD Hold'em No Limit - Level XXII (4000/8000) - 2024/06/26 21:09:29 UTC [2024/06/26 17:09:29 ET]
Table '3767885527 63' 8-max Seat #8 is the button
Seat 1: T3RSS1 (308592 in chips) 
Seat 2: gibbo888 (173249 in chips) 
Seat 3: MaCheCazzoFai (429588 in chips) 
Seat 4: Billionai8 (327231 in chips) 
Seat 5: Juicy_J_93 (168051 in chips) 
Seat 6: Varle84 (218073 in chips) 
Seat 7: VICTOR TXR1 (76622 in chips) 
Seat 8: GuyFromGipsy (268643 in chips) 
T3RSS1: posts the ante 1000
gibbo888: posts the ante 1000
MaCheCazzoFai: posts the ante 1000
Billionai8: posts the ante 1000
Juicy_J_93: posts the ante 1000
Varle84: posts the ante 1000
VICTOR TXR1: posts the ante 1000
GuyFromGipsy: posts the ante 1000
T3RSS1: posts small blind 4000
gibbo888: posts big blind 8000
*** HOLE CARDS ***
MaCheCazzoFai: folds 
Billionai8: folds 
Juicy_J_93: folds 
Varle84: folds 
VICTOR TXR1: raises 67622 to 75622 and is all-in
GuyFromGipsy has timed out
GuyFromGipsy: folds 
GuyFromGipsy is sitting out
T3RSS1: raises 231970 to 307592 and is all-in
gibbo888: folds 
Uncalled bet (231970) returned to T3RSS1
*** FLOP *** [6d Kd Qd]
GuyFromGipsy has returned
*** TURN *** [6d Kd Qd] [Qs]
*** RIVER *** [6d Kd Qd Qs] [6s]
*** SHOW DOWN ***
T3RSS1: shows [Ks Ad] (two pair, Kings and Queens)
VICTOR TXR1: shows [As 4d] (two pair, Queens and Sixes)
T3RSS1 collected 167244 from pot
VICTOR TXR1 finished the tournament in 160th place and received $126.61.
*** SUMMARY ***
Total pot 167244 | Rake 0 
Board [6d Kd Qd Qs 6s]
Seat 1: T3RSS1 (small blind) showed [Ks Ad] and won (167244) with two pair, Kings and Queens
Seat 2: gibbo888 (big blind) folded before Flop
Seat 3: MaCheCazzoFai folded before Flop (didn't bet)
Seat 4: Billionai8 folded before Flop (didn't bet)
Seat 5: Juicy_J_93 folded before Flop (didn't bet)
Seat 6: Varle84 folded before Flop (didn't bet)
Seat 7: VICTOR TXR1 showed [As 4d] and lost with two pair, Queens and Sixes
Seat 8: GuyFromGipsy (button) folded before Flop (didn't bet)

PokerStars Hand #251207602298: Tournament #3767885527, $40+$10+$5 USD Hold'em No Limit - Level XXII (4000/8000) - 2024/06/26 21:10:03 UTC [2024/06/26 17:10:03 ET]
Table '3767885527 63' 8-max Seat #1 is the button
Seat 1: T3RSS1 (399214 in chips) 
Seat 2: gibbo888 (164249 in chips) 
Seat 3: MaCheCazzoFai (428588 in chips) 
Seat 4: Billionai8 (326231 in chips) 
Seat 5: Juicy_J_93 (167051 in chips) 
Seat 6: Varle84 (217073 in chips) 
Seat 8: GuyFromGipsy (267643 in chips) 
T3RSS1: posts the ante 1000
gibbo888: posts the ante 1000
MaCheCazzoFai: posts the ante 1000
Billionai8: posts the ante 1000
Juicy_J_93: posts the ante 1000
Varle84: posts the ante 1000
GuyFromGipsy: posts the ante 1000
gibbo888: posts small blind 4000
MaCheCazzoFai: posts big blind 8000
*** HOLE CARDS ***
Billionai8: folds 
Juicy_J_93: folds 
Varle84: folds 
GuyFromGipsy: raises 8000 to 16000
T3RSS1: folds 
gibbo888: folds 
MaCheCazzoFai: raises 40000 to 56000
GuyFromGipsy: raises 210643 to 266643 and is all-in
MaCheCazzoFai: folds 
Uncalled bet (210643) returned to GuyFromGipsy
GuyFromGipsy collected 123000 from pot
GuyFromGipsy: doesn't show hand 
*** SUMMARY ***
Total pot 123000 | Rake 0 
Seat 1: T3RSS1 (button) folded before Flop (didn't bet)
Seat 2: gibbo888 (small blind) folded before Flop
Seat 3: MaCheCazzoFai (big blind) folded before Flop
Seat 4: Billionai8 folded before Flop (didn't bet)
Seat 5: Juicy_J_93 folded before Flop (didn't bet)
Seat 6: Varle84 folded before Flop (didn't bet)
Seat 8: GuyFromGipsy collected (123000)

PokerStars Hand #251207612875: Tournament #3767885527, $40+$10+$5 USD Hold'em No Limit - Level XXII (4000/8000) - 2024/06/26 21:10:38 UTC [2024/06/26 17:10:38 ET]
Table '3767885527 63' 8-max Seat #2 is the button
Seat 1: T3RSS1 (398214 in chips) 
Seat 2: gibbo888 (159249 in chips) 
Seat 3: MaCheCazzoFai (371588 in chips) 
Seat 4: Billionai8 (325231 in chips) 
Seat 5: Juicy_J_93 (166051 in chips) 
Seat 6: Varle84 (216073 in chips) 
Seat 8: GuyFromGipsy (333643 in chips) 
T3RSS1: posts the ante 1000
gibbo888: posts the ante 1000
MaCheCazzoFai: posts the ante 1000
Billionai8: posts the ante 1000
Juicy_J_93: posts the ante 1000
Varle84: posts the ante 1000
GuyFromGipsy: posts the ante 1000
MaCheCazzoFai: posts small blind 4000
Billionai8: posts big blind 8000
*** HOLE CARDS ***
Juicy_J_93: folds 
Varle84: folds 
GuyFromGipsy: folds 
T3RSS1: folds 
gibbo888: folds 
MaCheCazzoFai: calls 4000
Billionai8: raises 20000 to 28000
MaCheCazzoFai: folds 
Uncalled bet (20000) returned to Billionai8
Billionai8 collected 23000 from pot
Billionai8: doesn't show hand 
*** SUMMARY ***
Total pot 23000 | Rake 0 
Seat 1: T3RSS1 folded before Flop (didn't bet)
Seat 2: gibbo888 (button) folded before Flop (didn't bet)
Seat 3: MaCheCazzoFai (small blind) folded before Flop
Seat 4: Billionai8 (big blind) collected (23000)
Seat 5: Juicy_J_93 folded before Flop (didn't bet)
Seat 6: Varle84 folded before Flop (didn't bet)
Seat 8: GuyFromGipsy folded before Flop (didn't bet)

PokerStars Hand #251207624603: Tournament #3767885527, $40+$10+$5 USD Hold'em No Limit - Level XXII (4000/8000) - 2024/06/26 21:11:16 UTC [2024/06/26 17:11:16 ET]
Table '3767885527 63' 8-max Seat #3 is the button
Seat 1: T3RSS1 (397214 in chips) 
Seat 2: gibbo888 (158249 in chips) 
Seat 3: MaCheCazzoFai (362588 in chips) 
Seat 4: Billionai8 (339231 in chips) 
Seat 5: Juicy_J_93 (165051 in chips) 
Seat 6: Varle84 (215073 in chips) 
Seat 8: GuyFromGipsy (332643 in chips) 
T3RSS1: posts the ante 1000
gibbo888: posts the ante 1000
MaCheCazzoFai: posts the ante 1000
Billionai8: posts the ante 1000
Juicy_J_93: posts the ante 1000
Varle84: posts the ante 1000
GuyFromGipsy: posts the ante 1000
Billionai8: posts small blind 4000
Juicy_J_93: posts big blind 8000
*** HOLE CARDS ***
Varle84: folds 
GuyFromGipsy: folds 
T3RSS1: raises 8800 to 16800
gibbo888: folds 
MaCheCazzoFai: calls 16800
Billionai8: calls 12800
JAYJOEEEEE is disconnected 
Juicy_J_93: calls 8800
*** FLOP *** [6h 4c 6s]
Billionai8: checks 
Juicy_J_93: checks 
T3RSS1: checks 
MaCheCazzoFai: checks 
*** TURN *** [6h 4c 6s] [9d]
Billionai8: checks 
Juicy_J_93: checks 
T3RSS1: checks 
MaCheCazzoFai: bets 37100
Billionai8: folds 
Juicy_J_93: folds 
T3RSS1: folds 
Uncalled bet (37100) returned to MaCheCazzoFai
MaCheCazzoFai collected 74200 from pot
MaCheCazzoFai: doesn't show hand 
*** SUMMARY ***
Total pot 74200 | Rake 0 
Board [6h 4c 6s 9d]
Seat 1: T3RSS1 folded on the Turn
Seat 2: gibbo888 folded before Flop (didn't bet)
Seat 3: MaCheCazzoFai (button) collected (74200)
Seat 4: Billionai8 (small blind) folded on the Turn
Seat 5: Juicy_J_93 (big blind) folded on the Turn
Seat 6: Varle84 folded before Flop (didn't bet)
Seat 8: GuyFromGipsy folded before Flop (didn't bet)

PokerStars Hand #251207653615: Tournament #3767885527, $40+$10+$5 USD Hold'em No Limit - Level XXII (4000/8000) - 2024/06/26 21:12:51 UTC [2024/06/26 17:12:51 ET]
Table '3767885527 63' 8-max Seat #4 is the button
Seat 1: T3RSS1 (379414 in chips) 
Seat 2: gibbo888 (157249 in chips) 
Seat 3: MaCheCazzoFai (418988 in chips) 
Seat 4: Billionai8 (321431 in chips) 
Seat 5: Juicy_J_93 (147251 in chips) 
Seat 6: Varle84 (214073 in chips) 
Seat 7: JAYJOEEEEE (372572 in chips) 
Seat 8: GuyFromGipsy (331643 in chips) 
T3RSS1: posts the ante 1000
gibbo888: posts the ante 1000
MaCheCazzoFai: posts the ante 1000
Billionai8: posts the ante 1000
Juicy_J_93: posts the ante 1000
Varle84: posts the ante 1000
JAYJOEEEEE: posts the ante 1000
GuyFromGipsy: posts the ante 1000
Juicy_J_93: posts small blind 4000
Varle84: posts big blind 8000
*** HOLE CARDS ***
JAYJOEEEEE: raises 9600 to 17600
GuyFromGipsy: folds 
T3RSS1: folds 
gibbo888: folds 
MaCheCazzoFai: calls 17600
Billionai8: folds 
Juicy_J_93: folds 
Varle84: calls 9600
*** FLOP *** [Td 3d 6c]
Varle84: checks 
JAYJOEEEEE: bets 19440
MaCheCazzoFai: calls 19440
Varle84: folds 
*** TURN *** [Td 3d 6c] [Qc]
JAYJOEEEEE: bets 46656
MaCheCazzoFai: raises 98496 to 145152
JAYJOEEEEE: calls 98496
*** RIVER *** [Td 3d 6c Qc] [9d]
JAYJOEEEEE: checks 
MaCheCazzoFai: checks 
*** SHOW DOWN ***
JAYJOEEEEE: shows [Qs Kh] (a pair of Queens)
MaCheCazzoFai: shows [Ts Tc] (three of a kind, Tens)
MaCheCazzoFai collected 393984 from pot
*** SUMMARY ***
Total pot 393984 | Rake 0 
Board [Td 3d 6c Qc 9d]
Seat 1: T3RSS1 folded before Flop (didn't bet)
Seat 2: gibbo888 folded before Flop (didn't bet)
Seat 3: MaCheCazzoFai showed [Ts Tc] and won (393984) with three of a kind, Tens
Seat 4: Billionai8 (button) folded before Flop (didn't bet)
Seat 5: Juicy_J_93 (small blind) folded before Flop
Seat 6: Varle84 (big blind) folded on the Flop
Seat 7: JAYJOEEEEE showed [Qs Kh] and lost with a pair of Queens
Seat 8: GuyFromGipsy folded before Flop (didn't bet)

PokerStars Hand #251207684806: Tournament #3767885527, $40+$10+$5 USD Hold'em No Limit - Level XXIII (5000/10000) - 2024/06/26 21:14:32 UTC [2024/06/26 17:14:32 ET]
Table '3767885527 63' 8-max Seat #5 is the button
Seat 1: T3RSS1 (378414 in chips) 
Seat 2: gibbo888 (156249 in chips) 
Seat 3: MaCheCazzoFai (629780 in chips) 
Seat 4: Billionai8 (320431 in chips) 
Seat 5: Juicy_J_93 (142251 in chips) 
Seat 6: Varle84 (195473 in chips) 
Seat 7: JAYJOEEEEE (189380 in chips) 
Seat 8: GuyFromGipsy (330643 in chips) 
T3RSS1: posts the ante 1250
gibbo888: posts the ante 1250
MaCheCazzoFai: posts the ante 1250
Billionai8: posts the ante 1250
Juicy_J_93: posts the ante 1250
Varle84: posts the ante 1250
JAYJOEEEEE: posts the ante 1250
GuyFromGipsy: posts the ante 1250
Varle84: posts small blind 5000
JAYJOEEEEE: posts big blind 10000
*** HOLE CARDS ***
GuyFromGipsy: folds 
T3RSS1: raises 11000 to 21000
gibbo888: folds 
MaCheCazzoFai: folds 
Billionai8: calls 21000
Juicy_J_93: folds 
Varle84: folds 
JAYJOEEEEE: folds 
*** FLOP *** [Qd 6s 7h]
T3RSS1: bets 22110
Billionai8: calls 22110
*** TURN *** [Qd 6s 7h] [Ts]
T3RSS1: bets 56722
Billionai8: calls 56722
*** RIVER *** [Qd 6s 7h Ts] [8d]
T3RSS1: checks 
Billionai8: checks 
*** SHOW DOWN ***
T3RSS1: shows [As 9s] (a straight, Six to Ten)
Billionai8: mucks hand 
T3RSS1 collected 224664 from pot
*** SUMMARY ***
Total pot 224664 | Rake 0 
Board [Qd 6s 7h Ts 8d]
Seat 1: T3RSS1 showed [As 9s] and won (224664) with a straight, Six to Ten
Seat 2: gibbo888 folded before Flop (didn't bet)
Seat 3: MaCheCazzoFai folded before Flop (didn't bet)
Seat 4: Billionai8 mucked
Seat 5: Juicy_J_93 (button) folded before Flop (didn't bet)
Seat 6: Varle84 (small blind) folded before Flop
Seat 7: JAYJOEEEEE (big blind) folded before Flop
Seat 8: GuyFromGipsy folded before Flop (didn't bet)

PokerStars Hand #251207716607: Tournament #3767885527, $40+$10+$5 USD Hold'em No Limit - Level XXIII (5000/10000) - 2024/06/26 21:16:15 UTC [2024/06/26 17:16:15 ET]
Table '3767885527 63' 8-max Seat #6 is the button
Seat 1: T3RSS1 (501996 in chips) 
Seat 2: gibbo888 (154999 in chips) 
Seat 3: MaCheCazzoFai (628530 in chips) 
Seat 4: Billionai8 (219349 in chips) 
Seat 5: Juicy_J_93 (141001 in chips) 
Seat 6: Varle84 (189223 in chips) 
Seat 7: JAYJOEEEEE (178130 in chips) 
Seat 8: GuyFromGipsy (329393 in chips) 
T3RSS1: posts the ante 1250
gibbo888: posts the ante 1250
MaCheCazzoFai: posts the ante 1250
Billionai8: posts the ante 1250
Juicy_J_93: posts the ante 1250
Varle84: posts the ante 1250
JAYJOEEEEE: posts the ante 1250
GuyFromGipsy: posts the ante 1250
JAYJOEEEEE: posts small blind 5000
GuyFromGipsy: posts big blind 10000
*** HOLE CARDS ***
T3RSS1: folds 
gibbo888: raises 12000 to 22000
MaCheCazzoFai: folds 
Billionai8: folds 
Juicy_J_93: folds 
Varle84: folds 
JAYJOEEEEE: folds 
GuyFromGipsy: calls 12000
*** FLOP *** [Kh 2c 7d]
GuyFromGipsy: checks 
gibbo888: bets 131749 and is all-in
GuyFromGipsy: folds 
Uncalled bet (131749) returned to gibbo888
gibbo888 collected 59000 from pot
gibbo888: doesn't show hand 
*** SUMMARY ***
Total pot 59000 | Rake 0 
Board [Kh 2c 7d]
Seat 1: T3RSS1 folded before Flop (didn't bet)
Seat 2: gibbo888 collected (59000)
Seat 3: MaCheCazzoFai folded before Flop (didn't bet)
Seat 4: Billionai8 folded before Flop (didn't bet)
Seat 5: Juicy_J_93 folded before Flop (didn't bet)
Seat 6: Varle84 (button) folded before Flop (didn't bet)
Seat 7: JAYJOEEEEE (small blind) folded before Flop
Seat 8: GuyFromGipsy (big blind) folded on the Flop

PokerStars Hand #251207733118: Tournament #3767885527, $40+$10+$5 USD Hold'em No Limit - Level XXIII (5000/10000) - 2024/06/26 21:17:09 UTC [2024/06/26 17:17:09 ET]
Table '3767885527 63' 8-max Seat #7 is the button
Seat 1: T3RSS1 (500746 in chips) 
Seat 2: gibbo888 (190749 in chips) 
Seat 3: MaCheCazzoFai (627280 in chips) 
Seat 4: Billionai8 (218099 in chips) 
Seat 5: Juicy_J_93 (139751 in chips) 
Seat 6: Varle84 (187973 in chips) 
Seat 7: JAYJOEEEEE (171880 in chips) 
Seat 8: GuyFromGipsy (306143 in chips) 
T3RSS1: posts the ante 1250
gibbo888: posts the ante 1250
MaCheCazzoFai: posts the ante 1250
Billionai8: posts the ante 1250
Juicy_J_93: posts the ante 1250
Varle84: posts the ante 1250
JAYJOEEEEE: posts the ante 1250
GuyFromGipsy: posts the ante 1250
GuyFromGipsy: posts small blind 5000
T3RSS1: posts big blind 10000
*** HOLE CARDS ***
gibbo888: folds 
MaCheCazzoFai: folds 
Billionai8: folds 
Juicy_J_93: folds 
Varle84: folds 
JAYJOEEEEE: folds 
GuyFromGipsy: folds 
Uncalled bet (5000) returned to T3RSS1
T3RSS1 collected 20000 from pot
T3RSS1: doesn't show hand 
*** SUMMARY ***
Total pot 20000 | Rake 0 
Seat 1: T3RSS1 (big blind) collected (20000)
Seat 2: gibbo888 folded before Flop (didn't bet)
Seat 3: MaCheCazzoFai folded before Flop (didn't bet)
Seat 4: Billionai8 folded before Flop (didn't bet)
Seat 5: Juicy_J_93 folded before Flop (didn't bet)
Seat 6: Varle84 folded before Flop (didn't bet)
Seat 7: JAYJOEEEEE (button) folded before Flop (didn't bet)
Seat 8: GuyFromGipsy (small blind) folded before Flop

PokerStars Hand #251207738507: Tournament #3767885527, $40+$10+$5 USD Hold'em No Limit - Level XXIII (5000/10000) - 2024/06/26 21:17:26 UTC [2024/06/26 17:17:26 ET]
Table '3767885527 63' 8-max Seat #8 is the button
Seat 1: T3RSS1 (514496 in chips) 
Seat 2: gibbo888 (189499 in chips) 
Seat 3: MaCheCazzoFai (626030 in chips) 
Seat 4: Billionai8 (216849 in chips) 
Seat 5: Juicy_J_93 (138501 in chips) 
Seat 6: Varle84 (186723 in chips) 
Seat 7: JAYJOEEEEE (170630 in chips) 
Seat 8: GuyFromGipsy (299893 in chips) 
T3RSS1: posts the ante 1250
gibbo888: posts the ante 1250
MaCheCazzoFai: posts the ante 1250
Billionai8: posts the ante 1250
Juicy_J_93: posts the ante 1250
Varle84: posts the ante 1250
JAYJOEEEEE: posts the ante 1250
GuyFromGipsy: posts the ante 1250
T3RSS1: posts small blind 5000
gibbo888: posts big blind 10000
*** HOLE CARDS ***
MaCheCazzoFai: raises 10000 to 20000
Billionai8: folds 
Juicy_J_93: folds 
Varle84: folds 
JAYJOEEEEE: raises 149380 to 169380 and is all-in
GuyFromGipsy: folds 
T3RSS1: folds 
gibbo888: folds 
MaCheCazzoFai: folds 
Uncalled bet (149380) returned to JAYJOEEEEE
JAYJOEEEEE collected 65000 from pot
JAYJOEEEEE: doesn't show hand 
*** SUMMARY ***
Total pot 65000 | Rake 0 
Seat 1: T3RSS1 (small blind) folded before Flop
Seat 2: gibbo888 (big blind) folded before Flop
Seat 3: MaCheCazzoFai folded before Flop
Seat 4: Billionai8 folded before Flop (didn't bet)
Seat 5: Juicy_J_93 folded before Flop (didn't bet)
Seat 6: Varle84 folded before Flop (didn't bet)
Seat 7: JAYJOEEEEE collected (65000)
Seat 8: GuyFromGipsy (button) folded before Flop (didn't bet)

PokerStars Hand #251207748778: Tournament #3767885527, $40+$10+$5 USD Hold'em No Limit - Level XXIII (5000/10000) - 2024/06/26 21:17:59 UTC [2024/06/26 17:17:59 ET]
Table '3767885527 63' 8-max Seat #1 is the button
Seat 1: T3RSS1 (508246 in chips) 
Seat 2: gibbo888 (178249 in chips) 
Seat 3: MaCheCazzoFai (604780 in chips) 
Seat 4: Billionai8 (215599 in chips) 
Seat 5: Juicy_J_93 (137251 in chips) 
Seat 6: Varle84 (185473 in chips) 
Seat 7: JAYJOEEEEE (214380 in chips) 
Seat 8: GuyFromGipsy (298643 in chips) 
T3RSS1: posts the ante 1250
gibbo888: posts the ante 1250
MaCheCazzoFai: posts the ante 1250
Billionai8: posts the ante 1250
Juicy_J_93: posts the ante 1250
Varle84: posts the ante 1250
JAYJOEEEEE: posts the ante 1250
GuyFromGipsy: posts the ante 1250
gibbo888: posts small blind 5000
MaCheCazzoFai: posts big blind 10000
*** HOLE CARDS ***
Billionai8: folds 
Juicy_J_93: folds 
Varle84: raises 174223 to 184223 and is all-in
JAYJOEEEEE: folds 
GuyFromGipsy: folds 
T3RSS1: folds 
gibbo888: calls 171999 and is all-in
MaCheCazzoFai: folds 
Uncalled bet (7224) returned to Varle84
*** FLOP *** [As Ks Ad]
*** TURN *** [As Ks Ad] [4c]
*** RIVER *** [As Ks Ad 4c] [6h]
*** SHOW DOWN ***
gibbo888: shows [Ah Ac] (four of a kind, Aces)
Varle84: shows [8c 8s] (two pair, Aces and Eights)
gibbo888 collected 373998 from pot
*** SUMMARY ***
Total pot 373998 | Rake 0 
Board [As Ks Ad 4c 6h]
Seat 1: T3RSS1 (button) folded before Flop (didn't bet)
Seat 2: gibbo888 (small blind) showed [Ah Ac] and won (373998) with four of a kind, Aces
Seat 3: MaCheCazzoFai (big blind) folded before Flop
Seat 4: Billionai8 folded before Flop (didn't bet)
Seat 5: Juicy_J_93 folded before Flop (didn't bet)
Seat 6: Varle84 showed [8c 8s] and lost with two pair, Aces and Eights
Seat 7: JAYJOEEEEE folded before Flop (didn't bet)
Seat 8: GuyFromGipsy folded before Flop (didn't bet)

PokerStars Hand #251207761006: Tournament #3767885527, $40+$10+$5 USD Hold'em No Limit - Level XXIII (5000/10000) - 2024/06/26 21:18:39 UTC [2024/06/26 17:18:39 ET]
Table '3767885527 63' 8-max Seat #2 is the button
Seat 1: T3RSS1 (506996 in chips) 
Seat 2: gibbo888 (373998 in chips) 
Seat 3: MaCheCazzoFai (593530 in chips) 
Seat 4: Billionai8 (214349 in chips) 
Seat 5: Juicy_J_93 (136001 in chips) 
Seat 6: Varle84 (7224 in chips) 
Seat 7: JAYJOEEEEE (213130 in chips) 
Seat 8: GuyFromGipsy (297393 in chips) 
T3RSS1: posts the ante 1250
gibbo888: posts the ante 1250
MaCheCazzoFai: posts the ante 1250
Billionai8: posts the ante 1250
Juicy_J_93: posts the ante 1250
Varle84: posts the ante 1250
JAYJOEEEEE: posts the ante 1250
GuyFromGipsy: posts the ante 1250
MaCheCazzoFai: posts small blind 5000
Billionai8: posts big blind 10000
*** HOLE CARDS ***
Juicy_J_93: folds 
Varle84: calls 5974 and is all-in
JAYJOEEEEE: folds 
GuyFromGipsy: folds 
T3RSS1: folds 
gibbo888: folds 
MaCheCazzoFai: folds 
Uncalled bet (4026) returned to Billionai8
*** FLOP *** [Qc 2s Js]
*** TURN *** [Qc 2s Js] [5c]
*** RIVER *** [Qc 2s Js 5c] [3s]
*** SHOW DOWN ***
Billionai8: shows [5d Jd] (two pair, Jacks and Fives)
Varle84: shows [9c 3c] (a pair of Threes)
Billionai8 collected 26948 from pot
Varle84 finished the tournament in 137th place and received $139.27.
*** SUMMARY ***
Total pot 26948 | Rake 0 
Board [Qc 2s Js 5c 3s]
Seat 1: T3RSS1 folded before Flop (didn't bet)
Seat 2: gibbo888 (button) folded before Flop (didn't bet)
Seat 3: MaCheCazzoFai (small blind) folded before Flop
Seat 4: Billionai8 (big blind) showed [5d Jd] and won (26948) with two pair, Jacks and Fives
Seat 5: Juicy_J_93 folded before Flop (didn't bet)
Seat 6: Varle84 showed [9c 3c] and lost with a pair of Threes
Seat 7: JAYJOEEEEE folded before Flop (didn't bet)
Seat 8: GuyFromGipsy folded before Flop (didn't bet)


PokerStars Hand #251205405838: Tournament #3767885527, $40+$10+$5 USD Hold'em No Limit - Level XI (600/1200) - 2024/06/26 18:52:41 UTC [2024/06/26 14:52:41 ET]
Table '3767885527 61' 8-max Seat #7 is the button
Seat 1: ipayou (27075 in chips) 
Seat 2: MezuuÜuuT (13245 in chips) 
Seat 3: Hjerterdame1 (87216 in chips) 
Seat 4: ederpalasson (54943 in chips) 
Seat 6: ThalleSx (20480 in chips) 
Seat 7: fournn (59435 in chips) 
Seat 8: vagoyras (49499 in chips) 
ipayou: posts the ante 150
MezuuÜuuT: posts the ante 150
Hjerterdame1: posts the ante 150
ederpalasson: posts the ante 150
ThalleSx: posts the ante 150
fournn: posts the ante 150
vagoyras: posts the ante 150
vagoyras: posts small blind 600
ipayou: posts big blind 1200
*** HOLE CARDS ***
nacho2390 is disconnected 
MezuuÜuuT: folds 
Hjerterdame1: folds 
ederpalasson: raises 1200 to 2400
ThalleSx: folds 
fournn: folds 
vagoyras: folds 
ipayou: folds 
Uncalled bet (1200) returned to ederpalasson
ederpalasson collected 4050 from pot
ederpalasson: doesn't show hand 
*** SUMMARY ***
Total pot 4050 | Rake 0 
Seat 1: ipayou (big blind) folded before Flop
Seat 2: MezuuÜuuT folded before Flop (didn't bet)
Seat 3: Hjerterdame1 folded before Flop (didn't bet)
Seat 4: ederpalasson collected (4050)
Seat 6: ThalleSx folded before Flop (didn't bet)
Seat 7: fournn (button) folded before Flop (didn't bet)
Seat 8: vagoyras (small blind) folded before Flop

PokerStars Hand #251205418986: Tournament #3767885527, $40+$10+$5 USD Hold'em No Limit - Level XI (600/1200) - 2024/06/26 18:53:31 UTC [2024/06/26 14:53:31 ET]
Table '3767885527 61' 8-max Seat #8 is the button
Seat 1: ipayou (25725 in chips) 
Seat 2: MezuuÜuuT (13095 in chips) 
Seat 3: Hjerterdame1 (87066 in chips) 
Seat 4: ederpalasson (57643 in chips) 
Seat 5: nacho2390 (25000 in chips) 
Seat 6: ThalleSx (20330 in chips) 
Seat 7: fournn (59285 in chips) 
Seat 8: vagoyras (48749 in chips) 
ipayou: posts the ante 150
MezuuÜuuT: posts the ante 150
Hjerterdame1: posts the ante 150
ederpalasson: posts the ante 150
nacho2390: posts the ante 150
ThalleSx: posts the ante 150
fournn: posts the ante 150
vagoyras: posts the ante 150
ipayou: posts small blind 600
MezuuÜuuT: posts big blind 1200
*** HOLE CARDS ***
Hjerterdame1: raises 2000 to 3200
ederpalasson: folds 
nacho2390: raises 21650 to 24850 and is all-in
ThalleSx: folds 
fournn: folds 
vagoyras: folds 
ipayou: folds 
MezuuÜuuT: folds 
Hjerterdame1: folds [As]
Uncalled bet (21650) returned to nacho2390
nacho2390 collected 9400 from pot
nacho2390: doesn't show hand 
*** SUMMARY ***
Total pot 9400 | Rake 0 
Seat 1: ipayou (small blind) folded before Flop
Seat 2: MezuuÜuuT (big blind) folded before Flop
Seat 3: Hjerterdame1 folded before Flop
Seat 4: ederpalasson folded before Flop (didn't bet)
Seat 5: nacho2390 collected (9400)
Seat 6: ThalleSx folded before Flop (didn't bet)
Seat 7: fournn folded before Flop (didn't bet)
Seat 8: vagoyras (button) folded before Flop (didn't bet)

PokerStars Hand #251205436927: Tournament #3767885527, $40+$10+$5 USD Hold'em No Limit - Level XI (600/1200) - 2024/06/26 18:54:39 UTC [2024/06/26 14:54:39 ET]
Table '3767885527 61' 8-max Seat #1 is the button
Seat 1: ipayou (24975 in chips) 
Seat 2: MezuuÜuuT (11745 in chips) 
Seat 3: Hjerterdame1 (83716 in chips) 
Seat 4: ederpalasson (57493 in chips) 
Seat 5: nacho2390 (31050 in chips) 
Seat 6: ThalleSx (20180 in chips) 
Seat 7: fournn (59135 in chips) 
Seat 8: vagoyras (48599 in chips) 
ipayou: posts the ante 150
MezuuÜuuT: posts the ante 150
Hjerterdame1: posts the ante 150
ederpalasson: posts the ante 150
nacho2390: posts the ante 150
ThalleSx: posts the ante 150
fournn: posts the ante 150
vagoyras: posts the ante 150
MezuuÜuuT: posts small blind 600
Hjerterdame1: posts big blind 1200
*** HOLE CARDS ***
ederpalasson: raises 1200 to 2400
nacho2390: folds 
ThalleSx: folds 
fournn: folds 
vagoyras: folds 
ipayou: folds 
MezuuÜuuT: raises 9195 to 11595 and is all-in
Hjerterdame1: folds 
ederpalasson: calls 9195
*** FLOP *** [5s Qs 4h]
*** TURN *** [5s Qs 4h] [8s]
*** RIVER *** [5s Qs 4h 8s] [Ks]
*** SHOW DOWN ***
MezuuÜuuT: shows [Jh Ah] (high card Ace)
ederpalasson: shows [Tc 9c] (high card King)
MezuuÜuuT collected 25590 from pot
*** SUMMARY ***
Total pot 25590 | Rake 0 
Board [5s Qs 4h 8s Ks]
Seat 1: ipayou (button) folded before Flop (didn't bet)
Seat 2: MezuuÜuuT (small blind) showed [Jh Ah] and won (25590) with high card Ace
Seat 3: Hjerterdame1 (big blind) folded before Flop
Seat 4: ederpalasson showed [Tc 9c] and lost with high card King
Seat 5: nacho2390 folded before Flop (didn't bet)
Seat 6: ThalleSx folded before Flop (didn't bet)
Seat 7: fournn folded before Flop (didn't bet)
Seat 8: vagoyras folded before Flop (didn't bet)

PokerStars Hand #251205528139: Tournament #3767885527, $40+$10+$5 USD Hold'em No Limit - Level XI (600/1200) - 2024/06/26 19:02:04 UTC [2024/06/26 15:02:04 ET]
Table '3767885527 61' 8-max Seat #2 is the button
Seat 1: ipayou (24825 in chips) 
Seat 2: MezuuÜuuT (25590 in chips) 
Seat 3: Hjerterdame1 (82366 in chips) 
Seat 4: ederpalasson (45748 in chips) 
Seat 5: nacho2390 (30900 in chips) 
Seat 6: ThalleSx (20030 in chips) 
Seat 7: fournn (58985 in chips) 
Seat 8: vagoyras (48449 in chips) 
ipayou: posts the ante 150
MezuuÜuuT: posts the ante 150
Hjerterdame1: posts the ante 150
ederpalasson: posts the ante 150
nacho2390: posts the ante 150
ThalleSx: posts the ante 150
fournn: posts the ante 150
vagoyras: posts the ante 150
Hjerterdame1: posts small blind 600
ederpalasson: posts big blind 1200
*** HOLE CARDS ***
nacho2390: folds 
ThalleSx: folds 
fournn: folds 
vagoyras: folds 
ipayou: folds 
MezuuÜuuT: raises 1440 to 2640
Hjerterdame1: calls 2040
ederpalasson: folds 
*** FLOP *** [3h Ad 8c]
Hjerterdame1: checks 
MezuuÜuuT: checks 
*** TURN *** [3h Ad 8c] [5d]
Hjerterdame1: checks 
MezuuÜuuT: checks 
*** RIVER *** [3h Ad 8c 5d] [As]
Hjerterdame1: bets 3840
MezuuÜuuT: raises 5160 to 9000
Hjerterdame1: calls 5160
*** SHOW DOWN ***
MezuuÜuuT: shows [6c Ah] (three of a kind, Aces)
Hjerterdame1: shows [Ac 9h] (three of a kind, Aces - Nine kicker)
Hjerterdame1 collected 25680 from pot
*** SUMMARY ***
Total pot 25680 | Rake 0 
Board [3h Ad 8c 5d As]
Seat 1: ipayou folded before Flop (didn't bet)
Seat 2: MezuuÜuuT (button) showed [6c Ah] and lost with three of a kind, Aces
Seat 3: Hjerterdame1 (small blind) showed [Ac 9h] and won (25680) with three of a kind, Aces
Seat 4: ederpalasson (big blind) folded before Flop
Seat 5: nacho2390 folded before Flop (didn't bet)
Seat 6: ThalleSx folded before Flop (didn't bet)
Seat 7: fournn folded before Flop (didn't bet)
Seat 8: vagoyras folded before Flop (didn't bet)

PokerStars Hand #251205548705: Tournament #3767885527, $40+$10+$5 USD Hold'em No Limit - Level XI (600/1200) - 2024/06/26 19:03:27 UTC [2024/06/26 15:03:27 ET]
Table '3767885527 61' 8-max Seat #3 is the button
Seat 1: ipayou (24675 in chips) 
Seat 2: MezuuÜuuT (13800 in chips) 
Seat 3: Hjerterdame1 (96256 in chips) 
Seat 4: ederpalasson (44398 in chips) 
Seat 5: nacho2390 (30750 in chips) 
Seat 6: ThalleSx (19880 in chips) 
Seat 7: fournn (58835 in chips) 
Seat 8: vagoyras (48299 in chips) 
ipayou: posts the ante 150
MezuuÜuuT: posts the ante 150
Hjerterdame1: posts the ante 150
ederpalasson: posts the ante 150
nacho2390: posts the ante 150
ThalleSx: posts the ante 150
fournn: posts the ante 150
vagoyras: posts the ante 150
ederpalasson: posts small blind 600
nacho2390: posts big blind 1200
*** HOLE CARDS ***
ThalleSx: folds 
fournn: folds 
vagoyras: folds 
ipayou: raises 1200 to 2400
MezuuÜuuT: folds 
Hjerterdame1: folds 
ederpalasson: folds 
nacho2390: raises 28200 to 30600 and is all-in
ipayou: folds 
Uncalled bet (28200) returned to nacho2390
nacho2390 collected 6600 from pot
nacho2390: doesn't show hand 
*** SUMMARY ***
Total pot 6600 | Rake 0 
Seat 1: ipayou folded before Flop
Seat 2: MezuuÜuuT folded before Flop (didn't bet)
Seat 3: Hjerterdame1 (button) folded before Flop (didn't bet)
Seat 4: ederpalasson (small blind) folded before Flop
Seat 5: nacho2390 (big blind) collected (6600)
Seat 6: ThalleSx folded before Flop (didn't bet)
Seat 7: fournn folded before Flop (didn't bet)
Seat 8: vagoyras folded before Flop (didn't bet)

PokerStars Hand #251205556518: Tournament #3767885527, $40+$10+$5 USD Hold'em No Limit - Level XI (600/1200) - 2024/06/26 19:03:58 UTC [2024/06/26 15:03:58 ET]
Table '3767885527 61' 8-max Seat #4 is the button
Seat 1: ipayou (22125 in chips) 
Seat 2: MezuuÜuuT (13650 in chips) 
Seat 3: Hjerterdame1 (96106 in chips) 
Seat 4: ederpalasson (43648 in chips) 
Seat 5: nacho2390 (34800 in chips) 
Seat 6: ThalleSx (19730 in chips) 
Seat 7: fournn (58685 in chips) 
Seat 8: vagoyras (48149 in chips) 
ipayou: posts the ante 150
MezuuÜuuT: posts the ante 150
Hjerterdame1: posts the ante 150
ederpalasson: posts the ante 150
nacho2390: posts the ante 150
ThalleSx: posts the ante 150
fournn: posts the ante 150
vagoyras: posts the ante 150
nacho2390: posts small blind 600
ThalleSx: posts big blind 1200
*** HOLE CARDS ***
fournn: folds 
vagoyras: folds 
ipayou: folds 
MezuuÜuuT: folds 
Hjerterdame1: folds 
ederpalasson: folds 
nacho2390: folds 
Uncalled bet (600) returned to ThalleSx
ThalleSx collected 2400 from pot
ThalleSx: doesn't show hand 
*** SUMMARY ***
Total pot 2400 | Rake 0 
Seat 1: ipayou folded before Flop (didn't bet)
Seat 2: MezuuÜuuT folded before Flop (didn't bet)
Seat 3: Hjerterdame1 folded before Flop (didn't bet)
Seat 4: ederpalasson (button) folded before Flop (didn't bet)
Seat 5: nacho2390 (small blind) folded before Flop
Seat 6: ThalleSx (big blind) collected (2400)
Seat 7: fournn folded before Flop (didn't bet)
Seat 8: vagoyras folded before Flop (didn't bet)

PokerStars Hand #251205563690: Tournament #3767885527, $40+$10+$5 USD Hold'em No Limit - Level XI (600/1200) - 2024/06/26 19:04:26 UTC [2024/06/26 15:04:26 ET]
Table '3767885527 61' 8-max Seat #5 is the button
Seat 1: ipayou (21975 in chips) 
Seat 2: MezuuÜuuT (13500 in chips) 
Seat 3: Hjerterdame1 (95956 in chips) 
Seat 4: ederpalasson (43498 in chips) 
Seat 5: nacho2390 (34050 in chips) 
Seat 6: ThalleSx (21380 in chips) 
Seat 7: fournn (58535 in chips) 
Seat 8: vagoyras (47999 in chips) 
ipayou: posts the ante 150
MezuuÜuuT: posts the ante 150
Hjerterdame1: posts the ante 150
ederpalasson: posts the ante 150
nacho2390: posts the ante 150
ThalleSx: posts the ante 150
fournn: posts the ante 150
vagoyras: posts the ante 150
ThalleSx: posts small blind 600
fournn: posts big blind 1200
*** HOLE CARDS ***
vagoyras: folds 
ipayou: raises 1200 to 2400
MezuuÜuuT: folds 
Hjerterdame1: folds 
ederpalasson: raises 3000 to 5400
nacho2390: folds 
ThalleSx: folds 
fournn: folds 
ipayou: raises 16425 to 21825 and is all-in
ederpalasson: folds 
Uncalled bet (16425) returned to ipayou
ipayou collected 13800 from pot
*** SUMMARY ***
Total pot 13800 | Rake 0 
Seat 1: ipayou collected (13800)
Seat 2: MezuuÜuuT folded before Flop (didn't bet)
Seat 3: Hjerterdame1 folded before Flop (didn't bet)
Seat 4: ederpalasson folded before Flop
Seat 5: nacho2390 (button) folded before Flop (didn't bet)
Seat 6: ThalleSx (small blind) folded before Flop
Seat 7: fournn (big blind) folded before Flop
Seat 8: vagoyras folded before Flop (didn't bet)

PokerStars Hand #251205582065: Tournament #3767885527, $40+$10+$5 USD Hold'em No Limit - Level XI (600/1200) - 2024/06/26 19:05:36 UTC [2024/06/26 15:05:36 ET]
Table '3767885527 61' 8-max Seat #6 is the button
Seat 1: ipayou (30225 in chips) 
Seat 2: MezuuÜuuT (13350 in chips) 
Seat 3: Hjerterdame1 (95806 in chips) 
Seat 4: ederpalasson (37948 in chips) 
Seat 5: nacho2390 (33900 in chips) 
Seat 6: ThalleSx (20630 in chips) 
Seat 7: fournn (57185 in chips) 
Seat 8: vagoyras (47849 in chips) 
ipayou: posts the ante 150
MezuuÜuuT: posts the ante 150
Hjerterdame1: posts the ante 150
ederpalasson: posts the ante 150
nacho2390: posts the ante 150
ThalleSx: posts the ante 150
fournn: posts the ante 150
vagoyras: posts the ante 150
fournn: posts small blind 600
vagoyras: posts big blind 1200
*** HOLE CARDS ***
ipayou: folds 
MezuuÜuuT: folds 
Hjerterdame1: folds 
ederpalasson: folds 
nacho2390: folds 
ThalleSx: raises 19280 to 20480 and is all-in
fournn: folds 
vagoyras: folds 
Uncalled bet (19280) returned to ThalleSx
ThalleSx collected 4200 from pot
ThalleSx: doesn't show hand 
*** SUMMARY ***
Total pot 4200 | Rake 0 
Seat 1: ipayou folded before Flop (didn't bet)
Seat 2: MezuuÜuuT folded before Flop (didn't bet)
Seat 3: Hjerterdame1 folded before Flop (didn't bet)
Seat 4: ederpalasson folded before Flop (didn't bet)
Seat 5: nacho2390 folded before Flop (didn't bet)
Seat 6: ThalleSx (button) collected (4200)
Seat 7: fournn (small blind) folded before Flop
Seat 8: vagoyras (big blind) folded before Flop

PokerStars Hand #251205596018: Tournament #3767885527, $40+$10+$5 USD Hold'em No Limit - Level XI (600/1200) - 2024/06/26 19:06:29 UTC [2024/06/26 15:06:29 ET]
Table '3767885527 61' 8-max Seat #7 is the button
Seat 1: ipayou (30075 in chips) 
Seat 2: MezuuÜuuT (13200 in chips) 
Seat 3: Hjerterdame1 (95656 in chips) 
Seat 4: ederpalasson (37798 in chips) 
Seat 5: nacho2390 (33750 in chips) 
Seat 6: ThalleSx (23480 in chips) 
Seat 7: fournn (56435 in chips) 
Seat 8: vagoyras (46499 in chips) 
ipayou: posts the ante 150
MezuuÜuuT: posts the ante 150
Hjerterdame1: posts the ante 150
ederpalasson: posts the ante 150
nacho2390: posts the ante 150
ThalleSx: posts the ante 150
fournn: posts the ante 150
vagoyras: posts the ante 150
vagoyras: posts small blind 600
ipayou: posts big blind 1200
*** HOLE CARDS ***
MezuuÜuuT: folds 
Hjerterdame1: folds 
ederpalasson: folds 
nacho2390: raises 1320 to 2520
ThalleSx: folds 
fournn: folds 
vagoyras: folds 
ipayou: calls 1320
*** FLOP *** [3s 7h Ah]
ipayou: checks 
nacho2390: bets 1800
ipayou: raises 3480 to 5280
nacho2390: calls 3480
*** TURN *** [3s 7h Ah] [7c]
ipayou: bets 7800
nacho2390: calls 7800
*** RIVER *** [3s 7h Ah 7c] [9d]
ipayou: bets 14325 and is all-in
nacho2390: calls 14325
*** SHOW DOWN ***
ipayou: shows [Ad Ts] (two pair, Aces and Sevens)
nacho2390: shows [Qs Qc] (two pair, Queens and Sevens)
ipayou collected 61650 from pot
*** SUMMARY ***
Total pot 61650 | Rake 0 
Board [3s 7h Ah 7c 9d]
Seat 1: ipayou (big blind) showed [Ad Ts] and won (61650) with two pair, Aces and Sevens
Seat 2: MezuuÜuuT folded before Flop (didn't bet)
Seat 3: Hjerterdame1 folded before Flop (didn't bet)
Seat 4: ederpalasson folded before Flop (didn't bet)
Seat 5: nacho2390 showed [Qs Qc] and lost with two pair, Queens and Sevens
Seat 6: ThalleSx folded before Flop (didn't bet)
Seat 7: fournn (button) folded before Flop (didn't bet)
Seat 8: vagoyras (small blind) folded before Flop

PokerStars Hand #251205629947: Tournament #3767885527, $40+$10+$5 USD Hold'em No Limit - Level XI (600/1200) - 2024/06/26 19:08:36 UTC [2024/06/26 15:08:36 ET]
Table '3767885527 61' 8-max Seat #8 is the button
Seat 1: ipayou (61650 in chips) 
Seat 2: MezuuÜuuT (13050 in chips) 
Seat 3: Hjerterdame1 (95506 in chips) 
Seat 4: ederpalasson (37648 in chips) 
Seat 5: nacho2390 (3675 in chips) 
Seat 6: ThalleSx (23330 in chips) 
Seat 7: fournn (56285 in chips) 
Seat 8: vagoyras (45749 in chips) 
ipayou: posts the ante 150
MezuuÜuuT: posts the ante 150
Hjerterdame1: posts the ante 150
ederpalasson: posts the ante 150
nacho2390: posts the ante 150
ThalleSx: posts the ante 150
fournn: posts the ante 150
vagoyras: posts the ante 150
ipayou: posts small blind 600
MezuuÜuuT: posts big blind 1200
*** HOLE CARDS ***
Hjerterdame1: folds 
ederpalasson: folds 
nacho2390: folds 
ThalleSx: folds 
fournn: folds 
vagoyras: folds 
ipayou: raises 1320 to 2520
MezuuÜuuT: calls 1320
*** FLOP *** [Qh Kd 7c]
ipayou: checks 
MezuuÜuuT: checks 
*** TURN *** [Qh Kd 7c] [9h]
ipayou: bets 1800
MezuuÜuuT: folds 
Uncalled bet (1800) returned to ipayou
ipayou collected 6240 from pot
*** SUMMARY ***
Total pot 6240 | Rake 0 
Board [Qh Kd 7c 9h]
Seat 1: ipayou (small blind) collected (6240)
Seat 2: MezuuÜuuT (big blind) folded on the Turn
Seat 3: Hjerterdame1 folded before Flop (didn't bet)
Seat 4: ederpalasson folded before Flop (didn't bet)
Seat 5: nacho2390 folded before Flop (didn't bet)
Seat 6: ThalleSx folded before Flop (didn't bet)
Seat 7: fournn folded before Flop (didn't bet)
Seat 8: vagoyras (button) folded before Flop (didn't bet)

PokerStars Hand #251205645549: Tournament #3767885527, $40+$10+$5 USD Hold'em No Limit - Level XII (700/1400) - 2024/06/26 19:09:35 UTC [2024/06/26 15:09:35 ET]
Table '3767885527 61' 8-max Seat #1 is the button
Seat 1: ipayou (65220 in chips) 
Seat 2: MezuuÜuuT (10380 in chips) 
Seat 3: Hjerterdame1 (95356 in chips) 
Seat 4: ederpalasson (37498 in chips) 
Seat 5: nacho2390 (3525 in chips) 
Seat 6: ThalleSx (23180 in chips) 
Seat 7: fournn (56135 in chips) 
Seat 8: vagoyras (45599 in chips) 
ipayou: posts the ante 175
MezuuÜuuT: posts the ante 175
Hjerterdame1: posts the ante 175
ederpalasson: posts the ante 175
nacho2390: posts the ante 175
ThalleSx: posts the ante 175
fournn: posts the ante 175
vagoyras: posts the ante 175
MezuuÜuuT: posts small blind 700
Hjerterdame1: posts big blind 1400
*** HOLE CARDS ***
ederpalasson: folds 
nacho2390: folds 
ThalleSx: folds 
fournn: raises 1680 to 3080
vagoyras: folds 
ipayou: folds 
MezuuÜuuT: folds 
Hjerterdame1: folds 
Uncalled bet (1680) returned to fournn
fournn collected 4900 from pot
fournn: doesn't show hand 
*** SUMMARY ***
Total pot 4900 | Rake 0 
Seat 1: ipayou (button) folded before Flop (didn't bet)
Seat 2: MezuuÜuuT (small blind) folded before Flop
Seat 3: Hjerterdame1 (big blind) folded before Flop
Seat 4: ederpalasson folded before Flop (didn't bet)
Seat 5: nacho2390 folded before Flop (didn't bet)
Seat 6: ThalleSx folded before Flop (didn't bet)
Seat 7: fournn collected (4900)
Seat 8: vagoyras folded before Flop (didn't bet)

PokerStars Hand #251205652198: Tournament #3767885527, $40+$10+$5 USD Hold'em No Limit - Level XII (700/1400) - 2024/06/26 19:09:59 UTC [2024/06/26 15:09:59 ET]
Table '3767885527 61' 8-max Seat #2 is the button
Seat 1: ipayou (65045 in chips) 
Seat 2: MezuuÜuuT (9505 in chips) 
Seat 3: Hjerterdame1 (93781 in chips) 
Seat 4: ederpalasson (37323 in chips) 
Seat 5: nacho2390 (3350 in chips) 
Seat 6: ThalleSx (23005 in chips) 
Seat 7: fournn (59460 in chips) 
Seat 8: vagoyras (45424 in chips) 
ipayou: posts the ante 175
MezuuÜuuT: posts the ante 175
Hjerterdame1: posts the ante 175
ederpalasson: posts the ante 175
nacho2390: posts the ante 175
ThalleSx: posts the ante 175
fournn: posts the ante 175
vagoyras: posts the ante 175
Hjerterdame1: posts small blind 700
ederpalasson: posts big blind 1400
*** HOLE CARDS ***
nacho2390: folds 
ThalleSx: folds 
fournn: folds 
vagoyras: folds 
ipayou: folds 
MezuuÜuuT: folds 
Hjerterdame1: raises 2800 to 4200
ederpalasson: raises 6300 to 10500
Hjerterdame1: calls 6300
*** FLOP *** [Jc 2h 9d]
Hjerterdame1: bets 11200
ederpalasson: folds 
Uncalled bet (11200) returned to Hjerterdame1
Hjerterdame1 collected 22400 from pot
Hjerterdame1: doesn't show hand 
*** SUMMARY ***
Total pot 22400 | Rake 0 
Board [Jc 2h 9d]
Seat 1: ipayou folded before Flop (didn't bet)
Seat 2: MezuuÜuuT (button) folded before Flop (didn't bet)
Seat 3: Hjerterdame1 (small blind) collected (22400)
Seat 4: ederpalasson (big blind) folded on the Flop
Seat 5: nacho2390 folded before Flop (didn't bet)
Seat 6: ThalleSx folded before Flop (didn't bet)
Seat 7: fournn folded before Flop (didn't bet)
Seat 8: vagoyras folded before Flop (didn't bet)

PokerStars Hand #251205669543: Tournament #3767885527, $40+$10+$5 USD Hold'em No Limit - Level XII (700/1400) - 2024/06/26 19:11:04 UTC [2024/06/26 15:11:04 ET]
Table '3767885527 61' 8-max Seat #3 is the button
Seat 1: ipayou (64870 in chips) 
Seat 2: MezuuÜuuT (9330 in chips) 
Seat 3: Hjerterdame1 (105506 in chips) 
Seat 4: ederpalasson (26648 in chips) 
Seat 5: nacho2390 (3175 in chips) 
Seat 6: ThalleSx (22830 in chips) 
Seat 7: fournn (59285 in chips) 
Seat 8: vagoyras (45249 in chips) 
ipayou: posts the ante 175
MezuuÜuuT: posts the ante 175
Hjerterdame1: posts the ante 175
ederpalasson: posts the ante 175
nacho2390: posts the ante 175
ThalleSx: posts the ante 175
fournn: posts the ante 175
vagoyras: posts the ante 175
ederpalasson: posts small blind 700
nacho2390: posts big blind 1400
*** HOLE CARDS ***
ThalleSx: folds 
fournn: folds 
vagoyras: folds 
ipayou: folds 
MezuuÜuuT: folds 
Hjerterdame1: folds 
ederpalasson: raises 2800 to 4200
nacho2390: calls 1600 and is all-in
Uncalled bet (1200) returned to ederpalasson
*** FLOP *** [Ks 7h Jh]
*** TURN *** [Ks 7h Jh] [Kh]
*** RIVER *** [Ks 7h Jh Kh] [Ah]
*** SHOW DOWN ***
ederpalasson: shows [As Jc] (two pair, Aces and Kings)
nacho2390: shows [3h 2s] (a flush, Ace high)
nacho2390 collected 7400 from pot
*** SUMMARY ***
Total pot 7400 | Rake 0 
Board [Ks 7h Jh Kh Ah]
Seat 1: ipayou folded before Flop (didn't bet)
Seat 2: MezuuÜuuT folded before Flop (didn't bet)
Seat 3: Hjerterdame1 (button) folded before Flop (didn't bet)
Seat 4: ederpalasson (small blind) showed [As Jc] and lost with two pair, Aces and Kings
Seat 5: nacho2390 (big blind) showed [3h 2s] and won (7400) with a flush, Ace high
Seat 6: ThalleSx folded before Flop (didn't bet)
Seat 7: fournn folded before Flop (didn't bet)
Seat 8: vagoyras folded before Flop (didn't bet)

PokerStars Hand #251205680094: Tournament #3767885527, $40+$10+$5 USD Hold'em No Limit - Level XII (700/1400) - 2024/06/26 19:11:43 UTC [2024/06/26 15:11:43 ET]
Table '3767885527 61' 8-max Seat #4 is the button
Seat 1: ipayou (64695 in chips) 
Seat 2: MezuuÜuuT (9155 in chips) 
Seat 3: Hjerterdame1 (105331 in chips) 
Seat 4: ederpalasson (23473 in chips) 
Seat 5: nacho2390 (7400 in chips) 
Seat 6: ThalleSx (22655 in chips) 
Seat 7: fournn (59110 in chips) 
Seat 8: vagoyras (45074 in chips) 
ipayou: posts the ante 175
MezuuÜuuT: posts the ante 175
Hjerterdame1: posts the ante 175
ederpalasson: posts the ante 175
nacho2390: posts the ante 175
ThalleSx: posts the ante 175
fournn: posts the ante 175
vagoyras: posts the ante 175
nacho2390: posts small blind 700
ThalleSx: posts big blind 1400
*** HOLE CARDS ***
fournn: folds 
vagoyras: folds 
ipayou: folds 
MezuuÜuuT: folds 
Hjerterdame1: folds 
ederpalasson: folds 
nacho2390: raises 5825 to 7225 and is all-in
ThalleSx: calls 5825
*** FLOP *** [Qc 6c Ad]
*** TURN *** [Qc 6c Ad] [6h]
*** RIVER *** [Qc 6c Ad 6h] [9c]
*** SHOW DOWN ***
nacho2390: shows [Kh Qh] (two pair, Queens and Sixes)
ThalleSx: shows [5c Td] (a pair of Sixes)
nacho2390 collected 15850 from pot
*** SUMMARY ***
Total pot 15850 | Rake 0 
Board [Qc 6c Ad 6h 9c]
Seat 1: ipayou folded before Flop (didn't bet)
Seat 2: MezuuÜuuT folded before Flop (didn't bet)
Seat 3: Hjerterdame1 folded before Flop (didn't bet)
Seat 4: ederpalasson (button) folded before Flop (didn't bet)
Seat 5: nacho2390 (small blind) showed [Kh Qh] and won (15850) with two pair, Queens and Sixes
Seat 6: ThalleSx (big blind) showed [5c Td] and lost with a pair of Sixes
Seat 7: fournn folded before Flop (didn't bet)
Seat 8: vagoyras folded before Flop (didn't bet)

PokerStars Hand #251205691552: Tournament #3767885527, $40+$10+$5 USD Hold'em No Limit - Level XII (700/1400) - 2024/06/26 19:12:25 UTC [2024/06/26 15:12:25 ET]
Table '3767885527 61' 8-max Seat #5 is the button
Seat 1: ipayou (64520 in chips) 
Seat 2: MezuuÜuuT (8980 in chips) 
Seat 3: Hjerterdame1 (105156 in chips) 
Seat 4: ederpalasson (23298 in chips) 
Seat 5: nacho2390 (15850 in chips) 
Seat 6: ThalleSx (15255 in chips) 
Seat 7: fournn (58935 in chips) 
Seat 8: vagoyras (44899 in chips) 
ipayou: posts the ante 175
MezuuÜuuT: posts the ante 175
Hjerterdame1: posts the ante 175
ederpalasson: posts the ante 175
nacho2390: posts the ante 175
ThalleSx: posts the ante 175
fournn: posts the ante 175
vagoyras: posts the ante 175
ThalleSx: posts small blind 700
fournn: posts big blind 1400
*** HOLE CARDS ***
vagoyras: raises 1400 to 2800
ipayou: folds 
MezuuÜuuT: folds 
Hjerterdame1: folds 
ederpalasson: folds 
nacho2390: folds 
ThalleSx: raises 12280 to 15080 and is all-in
fournn: raises 43680 to 58760 and is all-in
vagoyras: folds 
Uncalled bet (43680) returned to fournn
*** FLOP *** [5s 3c 9d]
*** TURN *** [5s 3c 9d] [Ah]
*** RIVER *** [5s 3c 9d Ah] [Jd]
*** SHOW DOWN ***
ThalleSx: shows [Kh Ac] (a pair of Aces)
fournn: shows [Qd As] (a pair of Aces - lower kicker)
ThalleSx collected 34360 from pot
*** SUMMARY ***
Total pot 34360 | Rake 0 
Board [5s 3c 9d Ah Jd]
Seat 1: ipayou folded before Flop (didn't bet)
Seat 2: MezuuÜuuT folded before Flop (didn't bet)
Seat 3: Hjerterdame1 folded before Flop (didn't bet)
Seat 4: ederpalasson folded before Flop (didn't bet)
Seat 5: nacho2390 (button) folded before Flop (didn't bet)
Seat 6: ThalleSx (small blind) showed [Kh Ac] and won (34360) with a pair of Aces
Seat 7: fournn (big blind) showed [Qd As] and lost with a pair of Aces
Seat 8: vagoyras folded before Flop

PokerStars Hand #251205706826: Tournament #3767885527, $40+$10+$5 USD Hold'em No Limit - Level XII (700/1400) - 2024/06/26 19:13:21 UTC [2024/06/26 15:13:21 ET]
Table '3767885527 61' 8-max Seat #6 is the button
Seat 1: ipayou (64345 in chips) 
Seat 2: MezuuÜuuT (8805 in chips) 
Seat 3: Hjerterdame1 (104981 in chips) 
Seat 4: ederpalasson (23123 in chips) 
Seat 5: nacho2390 (15675 in chips) 
Seat 6: ThalleSx (34360 in chips) 
Seat 7: fournn (43680 in chips) 
Seat 8: vagoyras (41924 in chips) 
ipayou: posts the ante 175
MezuuÜuuT: posts the ante 175
Hjerterdame1: posts the ante 175
ederpalasson: posts the ante 175
nacho2390: posts the ante 175
ThalleSx: posts the ante 175
fournn: posts the ante 175
vagoyras: posts the ante 175
fournn: posts small blind 700
vagoyras: posts big blind 1400
*** HOLE CARDS ***
ipayou: folds 
MezuuÜuuT: folds 
Hjerterdame1: folds 
ederpalasson: raises 1400 to 2800
nacho2390: folds 
ThalleSx: folds 
fournn: folds 
vagoyras: folds 
Uncalled bet (1400) returned to ederpalasson
ederpalasson collected 4900 from pot
ederpalasson: doesn't show hand 
*** SUMMARY ***
Total pot 4900 | Rake 0 
Seat 1: ipayou folded before Flop (didn't bet)
Seat 2: MezuuÜuuT folded before Flop (didn't bet)
Seat 3: Hjerterdame1 folded before Flop (didn't bet)
Seat 4: ederpalasson collected (4900)
Seat 5: nacho2390 folded before Flop (didn't bet)
Seat 6: ThalleSx (button) folded before Flop (didn't bet)
Seat 7: fournn (small blind) folded before Flop
Seat 8: vagoyras (big blind) folded before Flop

PokerStars Hand #251205714150: Tournament #3767885527, $40+$10+$5 USD Hold'em No Limit - Level XII (700/1400) - 2024/06/26 19:13:49 UTC [2024/06/26 15:13:49 ET]
Table '3767885527 61' 8-max Seat #7 is the button
Seat 2: MezuuÜuuT (8630 in chips) 
Seat 3: Hjerterdame1 (104806 in chips) 
Seat 4: ederpalasson (26448 in chips) 
Seat 5: nacho2390 (15500 in chips) 
Seat 6: ThalleSx (34185 in chips) 
Seat 7: fournn (42805 in chips) 
Seat 8: vagoyras (40349 in chips) 
MezuuÜuuT: posts the ante 175
Hjerterdame1: posts the ante 175
ederpalasson: posts the ante 175
nacho2390: posts the ante 175
ThalleSx: posts the ante 175
fournn: posts the ante 175
vagoyras: posts the ante 175
vagoyras: posts small blind 700
MezuuÜuuT: posts big blind 1400
*** HOLE CARDS ***
Hjerterdame1: folds 
ederpalasson: raises 1400 to 2800
nacho2390: folds 
ThalleSx: folds 
fournn: folds 
vagoyras: folds 
MezuuÜuuT: calls 1400
*** FLOP *** [Qs 2d 5c]
MezuuÜuuT: checks 
ederpalasson: bets 7000
MezuuÜuuT: calls 5655 and is all-in
Uncalled bet (1345) returned to ederpalasson
*** TURN *** [Qs 2d 5c] [9h]
*** RIVER *** [Qs 2d 5c 9h] [2c]
*** SHOW DOWN ***
MezuuÜuuT: shows [5h Ah] (two pair, Fives and Deuces)
ederpalasson: shows [Kc Jc] (a pair of Deuces)
MezuuÜuuT collected 18835 from pot
*** SUMMARY ***
Total pot 18835 | Rake 0 
Board [Qs 2d 5c 9h 2c]
Seat 2: MezuuÜuuT (big blind) showed [5h Ah] and won (18835) with two pair, Fives and Deuces
Seat 3: Hjerterdame1 folded before Flop (didn't bet)
Seat 4: ederpalasson showed [Kc Jc] and lost with a pair of Deuces
Seat 5: nacho2390 folded before Flop (didn't bet)
Seat 6: ThalleSx folded before Flop (didn't bet)
Seat 7: fournn (button) folded before Flop (didn't bet)
Seat 8: vagoyras (small blind) folded before Flop

PokerStars Hand #251205733267: Tournament #3767885527, $40+$10+$5 USD Hold'em No Limit - Level XII (700/1400) - 2024/06/26 19:14:59 UTC [2024/06/26 15:14:59 ET]
Table '3767885527 61' 8-max Seat #8 is the button
Seat 2: MezuuÜuuT (18835 in chips) 
Seat 3: Hjerterdame1 (104631 in chips) 
Seat 4: ederpalasson (17818 in chips) 
Seat 5: nacho2390 (15325 in chips) 
Seat 6: ThalleSx (34010 in chips) 
Seat 7: fournn (42630 in chips) 
Seat 8: vagoyras (39474 in chips) 
MezuuÜuuT: posts the ante 175
Hjerterdame1: posts the ante 175
ederpalasson: posts the ante 175
nacho2390: posts the ante 175
ThalleSx: posts the ante 175
fournn: posts the ante 175
vagoyras: posts the ante 175
MezuuÜuuT: posts small blind 700
Hjerterdame1: posts big blind 1400
*** HOLE CARDS ***
ederpalasson: folds 
nacho2390: folds 
ThalleSx: raises 1400 to 2800
MyOnlyMemory is disconnected 
fournn: folds 
vagoyras: folds 
MezuuÜuuT: folds 
Hjerterdame1: folds 
Uncalled bet (1400) returned to ThalleSx
ThalleSx collected 4725 from pot
ThalleSx: doesn't show hand 
*** SUMMARY ***
Total pot 4725 | Rake 0 
Seat 2: MezuuÜuuT (small blind) folded before Flop
Seat 3: Hjerterdame1 (big blind) folded before Flop
Seat 4: ederpalasson folded before Flop (didn't bet)
Seat 5: nacho2390 folded before Flop (didn't bet)
Seat 6: ThalleSx collected (4725)
Seat 7: fournn folded before Flop (didn't bet)
Seat 8: vagoyras (button) folded before Flop (didn't bet)

PokerStars Hand #251205741477: Tournament #3767885527, $40+$10+$5 USD Hold'em No Limit - Level XII (700/1400) - 2024/06/26 19:15:29 UTC [2024/06/26 15:15:29 ET]
Table '3767885527 61' 8-max Seat #2 is the button
Seat 1: MyOnlyMemory (25000 in chips) 
Seat 2: MezuuÜuuT (17960 in chips) 
Seat 3: Hjerterdame1 (103056 in chips) 
Seat 4: ederpalasson (17643 in chips) 
Seat 5: nacho2390 (15150 in chips) 
Seat 6: ThalleSx (37160 in chips) 
Seat 7: fournn (42455 in chips) 
Seat 8: vagoyras (39299 in chips) 
MyOnlyMemory: posts the ante 175
MezuuÜuuT: posts the ante 175
Hjerterdame1: posts the ante 175
ederpalasson: posts the ante 175
nacho2390: posts the ante 175
ThalleSx: posts the ante 175
fournn: posts the ante 175
vagoyras: posts the ante 175
Hjerterdame1: posts small blind 700
ederpalasson: posts big blind 1400
*** HOLE CARDS ***
nacho2390: folds 
ThalleSx: folds 
fournn: folds 
vagoyras: folds 
MyOnlyMemory: raises 23425 to 24825 and is all-in
MezuuÜuuT: folds 
Hjerterdame1 has timed out
Hjerterdame1: folds 
Hjerterdame1 is sitting out
ederpalasson: folds 
Uncalled bet (23425) returned to MyOnlyMemory
MyOnlyMemory collected 4900 from pot
*** SUMMARY ***
Total pot 4900 | Rake 0 
Seat 1: MyOnlyMemory collected (4900)
Seat 2: MezuuÜuuT (button) folded before Flop (didn't bet)
Seat 3: Hjerterdame1 (small blind) folded before Flop
Seat 4: ederpalasson (big blind) folded before Flop
Seat 5: nacho2390 folded before Flop (didn't bet)
Seat 6: ThalleSx folded before Flop (didn't bet)
Seat 7: fournn folded before Flop (didn't bet)
Seat 8: vagoyras folded before Flop (didn't bet)

PokerStars Hand #251205775063: Tournament #3767885527, $40+$10+$5 USD Hold'em No Limit - Level XII (700/1400) - 2024/06/26 19:17:33 UTC [2024/06/26 15:17:33 ET]
Table '3767885527 61' 8-max Seat #3 is the button
Seat 1: MyOnlyMemory (28325 in chips) 
Seat 2: MezuuÜuuT (17785 in chips) 
Seat 3: Hjerterdame1 (102181 in chips) is sitting out
Seat 4: ederpalasson (16068 in chips) 
Seat 5: nacho2390 (14975 in chips) 
Seat 6: ThalleSx (36985 in chips) 
Seat 7: fournn (42280 in chips) 
Seat 8: vagoyras (39124 in chips) 
MyOnlyMemory: posts the ante 175
MezuuÜuuT: posts the ante 175
Hjerterdame1: posts the ante 175
ederpalasson: posts the ante 175
nacho2390: posts the ante 175
ThalleSx: posts the ante 175
fournn: posts the ante 175
vagoyras: posts the ante 175
ederpalasson: posts small blind 700
nacho2390: posts big blind 1400
*** HOLE CARDS ***
ThalleSx: folds 
fournn: folds 
vagoyras: folds 
MyOnlyMemory: folds 
MezuuÜuuT: raises 16210 to 17610 and is all-in
Hjerterdame1: folds 
ederpalasson: folds 
nacho2390: folds 
Uncalled bet (16210) returned to MezuuÜuuT
MezuuÜuuT collected 4900 from pot
MezuuÜuuT: doesn't show hand 
*** SUMMARY ***
Total pot 4900 | Rake 0 
Seat 1: MyOnlyMemory folded before Flop (didn't bet)
Seat 2: MezuuÜuuT collected (4900)
Seat 3: Hjerterdame1 (button) folded before Flop (didn't bet)
Seat 4: ederpalasson (small blind) folded before Flop
Seat 5: nacho2390 (big blind) folded before Flop
Seat 6: ThalleSx folded before Flop (didn't bet)
Seat 7: fournn folded before Flop (didn't bet)
Seat 8: vagoyras folded before Flop (didn't bet)

PokerStars Hand #251205782758: Tournament #3767885527, $40+$10+$5 USD Hold'em No Limit - Level XII (700/1400) - 2024/06/26 19:18:01 UTC [2024/06/26 15:18:01 ET]
Table '3767885527 61' 8-max Seat #4 is the button
Seat 1: MyOnlyMemory (28150 in chips) 
Seat 2: MezuuÜuuT (21110 in chips) 
Seat 3: Hjerterdame1 (102006 in chips) is sitting out
Seat 4: ederpalasson (15193 in chips) 
Seat 5: nacho2390 (13400 in chips) 
Seat 6: ThalleSx (36810 in chips) 
Seat 7: fournn (42105 in chips) 
Seat 8: vagoyras (38949 in chips) 
MyOnlyMemory: posts the ante 175
MezuuÜuuT: posts the ante 175
Hjerterdame1: posts the ante 175
ederpalasson: posts the ante 175
nacho2390: posts the ante 175
ThalleSx: posts the ante 175
fournn: posts the ante 175
vagoyras: posts the ante 175
nacho2390: posts small blind 700
ThalleSx: posts big blind 1400
*** HOLE CARDS ***
fournn: folds 
vagoyras: folds 
MyOnlyMemory: folds 
MezuuÜuuT: folds 
Hjerterdame1: folds 
ederpalasson: raises 13618 to 15018 and is all-in
nacho2390: folds 
ThalleSx: folds 
Uncalled bet (13618) returned to ederpalasson
ederpalasson collected 4900 from pot
ederpalasson: doesn't show hand 
*** SUMMARY ***
Total pot 4900 | Rake 0 
Seat 1: MyOnlyMemory folded before Flop (didn't bet)
Seat 2: MezuuÜuuT folded before Flop (didn't bet)
Seat 3: Hjerterdame1 folded before Flop (didn't bet)
Seat 4: ederpalasson (button) collected (4900)
Seat 5: nacho2390 (small blind) folded before Flop
Seat 6: ThalleSx (big blind) folded before Flop
Seat 7: fournn folded before Flop (didn't bet)
Seat 8: vagoyras folded before Flop (didn't bet)

PokerStars Hand #251205791259: Tournament #3767885527, $40+$10+$5 USD Hold'em No Limit - Level XII (700/1400) - 2024/06/26 19:18:32 UTC [2024/06/26 15:18:32 ET]
Table '3767885527 61' 8-max Seat #5 is the button
Seat 1: MyOnlyMemory (27975 in chips) 
Seat 2: MezuuÜuuT (20935 in chips) 
Seat 3: Hjerterdame1 (101831 in chips) is sitting out
Seat 4: ederpalasson (18518 in chips) 
Seat 5: nacho2390 (12525 in chips) 
Seat 6: ThalleSx (35235 in chips) 
Seat 7: fournn (41930 in chips) 
Seat 8: vagoyras (38774 in chips) 
MyOnlyMemory: posts the ante 175
MezuuÜuuT: posts the ante 175
Hjerterdame1: posts the ante 175
ederpalasson: posts the ante 175
nacho2390: posts the ante 175
ThalleSx: posts the ante 175
fournn: posts the ante 175
vagoyras: posts the ante 175
ThalleSx: posts small blind 700
fournn: posts big blind 1400
*** HOLE CARDS ***
vagoyras: folds 
Hjerterdame1 has returned
MyOnlyMemory: raises 1400 to 2800
MezuuÜuuT: folds 
Hjerterdame1: calls 2800
ederpalasson: folds 
nacho2390: folds 
ThalleSx: folds 
fournn: calls 1400
*** FLOP *** [Th 2s Ad]
fournn: checks 
MyOnlyMemory: checks 
Hjerterdame1: bets 4200
fournn: folds 
MyOnlyMemory: folds 
Uncalled bet (4200) returned to Hjerterdame1
Hjerterdame1 collected 10500 from pot
Hjerterdame1: doesn't show hand 
*** SUMMARY ***
Total pot 10500 | Rake 0 
Board [Th 2s Ad]
Seat 1: MyOnlyMemory folded on the Flop
Seat 2: MezuuÜuuT folded before Flop (didn't bet)
Seat 3: Hjerterdame1 collected (10500)
Seat 4: ederpalasson folded before Flop (didn't bet)
Seat 5: nacho2390 (button) folded before Flop (didn't bet)
Seat 6: ThalleSx (small blind) folded before Flop
Seat 7: fournn (big blind) folded on the Flop
Seat 8: vagoyras folded before Flop (didn't bet)

PokerStars Hand #251205815348: Tournament #3767885527, $40+$10+$5 USD Hold'em No Limit - Level XIII (800/1600) - 2024/06/26 19:20:00 UTC [2024/06/26 15:20:00 ET]
Table '3767885527 61' 8-max Seat #6 is the button
Seat 1: MyOnlyMemory (25000 in chips) 
Seat 2: MezuuÜuuT (20760 in chips) 
Seat 3: Hjerterdame1 (109356 in chips) 
Seat 4: ederpalasson (18343 in chips) 
Seat 5: nacho2390 (12350 in chips) 
Seat 6: ThalleSx (34360 in chips) 
Seat 7: fournn (38955 in chips) 
Seat 8: vagoyras (38599 in chips) 
MyOnlyMemory: posts the ante 200
MezuuÜuuT: posts the ante 200
Hjerterdame1: posts the ante 200
ederpalasson: posts the ante 200
nacho2390: posts the ante 200
ThalleSx: posts the ante 200
fournn: posts the ante 200
vagoyras: posts the ante 200
fournn: posts small blind 800
vagoyras: posts big blind 1600
*** HOLE CARDS ***
MyOnlyMemory: folds 
MezuuÜuuT: folds 
Hjerterdame1: folds 
ederpalasson: folds 
nacho2390: raises 10550 to 12150 and is all-in
ThalleSx: folds 
fournn: raises 26605 to 38755 and is all-in
vagoyras: folds 
Uncalled bet (26605) returned to fournn
*** FLOP *** [Qs 4c 9d]
*** TURN *** [Qs 4c 9d] [Jd]
*** RIVER *** [Qs 4c 9d Jd] [7c]
*** SHOW DOWN ***
fournn: shows [9s Ad] (a pair of Nines)
nacho2390: shows [Ah Jc] (a pair of Jacks)
nacho2390 collected 27500 from pot
*** SUMMARY ***
Total pot 27500 | Rake 0 
Board [Qs 4c 9d Jd 7c]
Seat 1: MyOnlyMemory folded before Flop (didn't bet)
Seat 2: MezuuÜuuT folded before Flop (didn't bet)
Seat 3: Hjerterdame1 folded before Flop (didn't bet)
Seat 4: ederpalasson folded before Flop (didn't bet)
Seat 5: nacho2390 showed [Ah Jc] and won (27500) with a pair of Jacks
Seat 6: ThalleSx (button) folded before Flop (didn't bet)
Seat 7: fournn (small blind) showed [9s Ad] and lost with a pair of Nines
Seat 8: vagoyras (big blind) folded before Flop

PokerStars Hand #251205827390: Tournament #3767885527, $40+$10+$5 USD Hold'em No Limit - Level XIII (800/1600) - 2024/06/26 19:20:45 UTC [2024/06/26 15:20:45 ET]
Table '3767885527 61' 8-max Seat #7 is the button
Seat 1: MyOnlyMemory (24800 in chips) 
Seat 2: MezuuÜuuT (20560 in chips) 
Seat 3: Hjerterdame1 (109156 in chips) 
Seat 4: ederpalasson (18143 in chips) 
Seat 5: nacho2390 (27500 in chips) 
Seat 6: ThalleSx (34160 in chips) 
Seat 7: fournn (26605 in chips) 
Seat 8: vagoyras (36799 in chips) 
MyOnlyMemory: posts the ante 200
MezuuÜuuT: posts the ante 200
Hjerterdame1: posts the ante 200
ederpalasson: posts the ante 200
nacho2390: posts the ante 200
ThalleSx: posts the ante 200
fournn: posts the ante 200
vagoyras: posts the ante 200
vagoyras: posts small blind 800
MyOnlyMemory: posts big blind 1600
*** HOLE CARDS ***
MezuuÜuuT: folds 
Hjerterdame1: folds 
ederpalasson: folds 
nacho2390: calls 1600
ThalleSx: folds 
fournn: folds 
vagoyras: raises 4000 to 5600
MyOnlyMemory: folds 
nacho2390: folds 
Uncalled bet (4000) returned to vagoyras
vagoyras collected 6400 from pot
vagoyras: doesn't show hand 
*** SUMMARY ***
Total pot 6400 | Rake 0 
Seat 1: MyOnlyMemory (big blind) folded before Flop
Seat 2: MezuuÜuuT folded before Flop (didn't bet)
Seat 3: Hjerterdame1 folded before Flop (didn't bet)
Seat 4: ederpalasson folded before Flop (didn't bet)
Seat 5: nacho2390 folded before Flop
Seat 6: ThalleSx folded before Flop (didn't bet)
Seat 7: fournn (button) folded before Flop (didn't bet)
Seat 8: vagoyras (small blind) collected (6400)

PokerStars Hand #251205846835: Tournament #3767885527, $40+$10+$5 USD Hold'em No Limit - Level XIII (800/1600) - 2024/06/26 19:21:56 UTC [2024/06/26 15:21:56 ET]
Table '3767885527 61' 8-max Seat #8 is the button
Seat 1: MyOnlyMemory (23000 in chips) 
Seat 2: MezuuÜuuT (20360 in chips) 
Seat 3: Hjerterdame1 (108956 in chips) 
Seat 4: ederpalasson (17943 in chips) 
Seat 5: nacho2390 (25700 in chips) 
Seat 6: ThalleSx (33960 in chips) 
Seat 7: fournn (26405 in chips) 
Seat 8: vagoyras (41399 in chips) 
MyOnlyMemory: posts the ante 200
MezuuÜuuT: posts the ante 200
Hjerterdame1: posts the ante 200
ederpalasson: posts the ante 200
nacho2390: posts the ante 200
ThalleSx: posts the ante 200
fournn: posts the ante 200
vagoyras: posts the ante 200
MyOnlyMemory: posts small blind 800
MezuuÜuuT: posts big blind 1600
*** HOLE CARDS ***
Hjerterdame1: raises 1600 to 3200
ederpalasson: folds 
nacho2390: folds 
ThalleSx: folds 
fournn: folds 
vagoyras: folds 
MyOnlyMemory: raises 19600 to 22800 and is all-in
MezuuÜuuT: folds 
Hjerterdame1: folds [Ah]
Uncalled bet (19600) returned to MyOnlyMemory
MyOnlyMemory collected 9600 from pot
*** SUMMARY ***
Total pot 9600 | Rake 0 
Seat 1: MyOnlyMemory (small blind) collected (9600)
Seat 2: MezuuÜuuT (big blind) folded before Flop
Seat 3: Hjerterdame1 folded before Flop
Seat 4: ederpalasson folded before Flop (didn't bet)
Seat 5: nacho2390 folded before Flop (didn't bet)
Seat 6: ThalleSx folded before Flop (didn't bet)
Seat 7: fournn folded before Flop (didn't bet)
Seat 8: vagoyras (button) folded before Flop (didn't bet)

PokerStars Hand #251205858889: Tournament #3767885527, $40+$10+$5 USD Hold'em No Limit - Level XIII (800/1600) - 2024/06/26 19:22:40 UTC [2024/06/26 15:22:40 ET]
Table '3767885527 61' 8-max Seat #1 is the button
Seat 1: MyOnlyMemory (29200 in chips) 
Seat 2: MezuuÜuuT (18560 in chips) 
Seat 3: Hjerterdame1 (105556 in chips) 
Seat 4: ederpalasson (17743 in chips) 
Seat 5: nacho2390 (25500 in chips) 
Seat 6: ThalleSx (33760 in chips) 
Seat 7: fournn (26205 in chips) 
Seat 8: vagoyras (41199 in chips) 
MyOnlyMemory: posts the ante 200
MezuuÜuuT: posts the ante 200
Hjerterdame1: posts the ante 200
ederpalasson: posts the ante 200
nacho2390: posts the ante 200
ThalleSx: posts the ante 200
fournn: posts the ante 200
vagoyras: posts the ante 200
MezuuÜuuT: posts small blind 800
Hjerterdame1: posts big blind 1600
*** HOLE CARDS ***
ederpalasson: raises 1600 to 3200
nacho2390: folds 
ThalleSx: folds 
fournn: folds 
vagoyras: folds 
MyOnlyMemory: folds 
MezuuÜuuT: folds 
Hjerterdame1: folds 
Uncalled bet (1600) returned to ederpalasson
ederpalasson collected 5600 from pot
ederpalasson: doesn't show hand 
*** SUMMARY ***
Total pot 5600 | Rake 0 
Seat 1: MyOnlyMemory (button) folded before Flop (didn't bet)
Seat 2: MezuuÜuuT (small blind) folded before Flop
Seat 3: Hjerterdame1 (big blind) folded before Flop
Seat 4: ederpalasson collected (5600)
Seat 5: nacho2390 folded before Flop (didn't bet)
Seat 6: ThalleSx folded before Flop (didn't bet)
Seat 7: fournn folded before Flop (didn't bet)
Seat 8: vagoyras folded before Flop (didn't bet)

PokerStars Hand #251205863876: Tournament #3767885527, $40+$10+$5 USD Hold'em No Limit - Level XIII (800/1600) - 2024/06/26 19:22:58 UTC [2024/06/26 15:22:58 ET]
Table '3767885527 61' 8-max Seat #2 is the button
Seat 1: MyOnlyMemory (29000 in chips) 
Seat 2: MezuuÜuuT (17560 in chips) 
Seat 3: Hjerterdame1 (103756 in chips) 
Seat 4: ederpalasson (21543 in chips) 
Seat 5: nacho2390 (25300 in chips) 
Seat 6: ThalleSx (33560 in chips) 
Seat 7: fournn (26005 in chips) 
Seat 8: vagoyras (40999 in chips) 
MyOnlyMemory: posts the ante 200
MezuuÜuuT: posts the ante 200
Hjerterdame1: posts the ante 200
ederpalasson: posts the ante 200
nacho2390: posts the ante 200
ThalleSx: posts the ante 200
fournn: posts the ante 200
vagoyras: posts the ante 200
Hjerterdame1: posts small blind 800
ederpalasson: posts big blind 1600
*** HOLE CARDS ***
nacho2390: folds 
ThalleSx: folds 
fournn: folds 
vagoyras: raises 1600 to 3200
MyOnlyMemory: folds 
MezuuÜuuT: folds 
Hjerterdame1: folds 
ederpalasson: calls 1600
*** FLOP *** [Jc 7c 4d]
ederpalasson: checks 
vagoyras: bets 2904
ederpalasson: folds 
Uncalled bet (2904) returned to vagoyras
vagoyras collected 8800 from pot
vagoyras: doesn't show hand 
*** SUMMARY ***
Total pot 8800 | Rake 0 
Board [Jc 7c 4d]
Seat 1: MyOnlyMemory folded before Flop (didn't bet)
Seat 2: MezuuÜuuT (button) folded before Flop (didn't bet)
Seat 3: Hjerterdame1 (small blind) folded before Flop
Seat 4: ederpalasson (big blind) folded on the Flop
Seat 5: nacho2390 folded before Flop (didn't bet)
Seat 6: ThalleSx folded before Flop (didn't bet)
Seat 7: fournn folded before Flop (didn't bet)
Seat 8: vagoyras collected (8800)

PokerStars Hand #251205889213: Tournament #3767885527, $40+$10+$5 USD Hold'em No Limit - Level XIII (800/1600) - 2024/06/26 19:24:31 UTC [2024/06/26 15:24:31 ET]
Table '3767885527 61' 8-max Seat #3 is the button
Seat 1: MyOnlyMemory (28800 in chips) 
Seat 2: MezuuÜuuT (17360 in chips) 
Seat 3: Hjerterdame1 (102756 in chips) 
Seat 4: ederpalasson (18143 in chips) 
Seat 5: nacho2390 (25100 in chips) 
Seat 6: ThalleSx (33360 in chips) 
Seat 7: fournn (25805 in chips) 
Seat 8: vagoyras (46399 in chips) 
MyOnlyMemory: posts the ante 200
MezuuÜuuT: posts the ante 200
Hjerterdame1: posts the ante 200
ederpalasson: posts the ante 200
nacho2390: posts the ante 200
ThalleSx: posts the ante 200
fournn: posts the ante 200
vagoyras: posts the ante 200
ederpalasson: posts small blind 800
nacho2390: posts big blind 1600
*** HOLE CARDS ***
ThalleSx: folds 
fournn: folds 
vagoyras: folds 
MyOnlyMemory: folds 
MezuuÜuuT: raises 15560 to 17160 and is all-in
Hjerterdame1: folds 
ederpalasson: folds 
nacho2390: folds 
Uncalled bet (15560) returned to MezuuÜuuT
MezuuÜuuT collected 5600 from pot
MezuuÜuuT: doesn't show hand 
*** SUMMARY ***
Total pot 5600 | Rake 0 
Seat 1: MyOnlyMemory folded before Flop (didn't bet)
Seat 2: MezuuÜuuT collected (5600)
Seat 3: Hjerterdame1 (button) folded before Flop (didn't bet)
Seat 4: ederpalasson (small blind) folded before Flop
Seat 5: nacho2390 (big blind) folded before Flop
Seat 6: ThalleSx folded before Flop (didn't bet)
Seat 7: fournn folded before Flop (didn't bet)
Seat 8: vagoyras folded before Flop (didn't bet)

PokerStars Hand #251205901575: Tournament #3767885527, $40+$10+$5 USD Hold'em No Limit - Level XIII (800/1600) - 2024/06/26 19:25:15 UTC [2024/06/26 15:25:15 ET]
Table '3767885527 61' 8-max Seat #4 is the button
Seat 1: MyOnlyMemory (28600 in chips) 
Seat 2: MezuuÜuuT (21160 in chips) 
Seat 3: Hjerterdame1 (102556 in chips) 
Seat 4: ederpalasson (17143 in chips) 
Seat 5: nacho2390 (23300 in chips) 
Seat 6: ThalleSx (33160 in chips) 
Seat 7: fournn (25605 in chips) 
Seat 8: vagoyras (46199 in chips) 
MyOnlyMemory: posts the ante 200
MezuuÜuuT: posts the ante 200
Hjerterdame1: posts the ante 200
ederpalasson: posts the ante 200
nacho2390: posts the ante 200
ThalleSx: posts the ante 200
fournn: posts the ante 200
vagoyras: posts the ante 200
nacho2390: posts small blind 800
ThalleSx: posts big blind 1600
*** HOLE CARDS ***
fournn: folds 
vagoyras: folds 
MyOnlyMemory: folds 
MezuuÜuuT: folds 
Hjerterdame1: folds 
ederpalasson: folds 
nacho2390: raises 21500 to 23100 and is all-in
ThalleSx: folds 
Uncalled bet (21500) returned to nacho2390
nacho2390 collected 4800 from pot
nacho2390: doesn't show hand 
*** SUMMARY ***
Total pot 4800 | Rake 0 
Seat 1: MyOnlyMemory folded before Flop (didn't bet)
Seat 2: MezuuÜuuT folded before Flop (didn't bet)
Seat 3: Hjerterdame1 folded before Flop (didn't bet)
Seat 4: ederpalasson (button) folded before Flop (didn't bet)
Seat 5: nacho2390 (small blind) collected (4800)
Seat 6: ThalleSx (big blind) folded before Flop
Seat 7: fournn folded before Flop (didn't bet)
Seat 8: vagoyras folded before Flop (didn't bet)

PokerStars Hand #251205909946: Tournament #3767885527, $40+$10+$5 USD Hold'em No Limit - Level XIII (800/1600) - 2024/06/26 19:25:46 UTC [2024/06/26 15:25:46 ET]
Table '3767885527 61' 8-max Seat #5 is the button
Seat 1: MyOnlyMemory (28400 in chips) 
Seat 2: MezuuÜuuT (20960 in chips) 
Seat 3: Hjerterdame1 (102356 in chips) 
Seat 4: ederpalasson (16943 in chips) 
Seat 5: nacho2390 (26300 in chips) 
Seat 6: ThalleSx (31360 in chips) 
Seat 7: fournn (25405 in chips) 
Seat 8: vagoyras (45999 in chips) 
MyOnlyMemory: posts the ante 200
MezuuÜuuT: posts the ante 200
Hjerterdame1: posts the ante 200
ederpalasson: posts the ante 200
nacho2390: posts the ante 200
ThalleSx: posts the ante 200
fournn: posts the ante 200
vagoyras: posts the ante 200
ThalleSx: posts small blind 800
fournn: posts big blind 1600
*** HOLE CARDS ***
vagoyras: folds 
MyOnlyMemory: folds 
MezuuÜuuT: folds 
Hjerterdame1: folds 
ederpalasson: folds 
nacho2390: raises 24500 to 26100 and is all-in
ThalleSx: folds 
fournn: folds 
Uncalled bet (24500) returned to nacho2390
nacho2390 collected 5600 from pot
nacho2390: doesn't show hand 
*** SUMMARY ***
Total pot 5600 | Rake 0 
Seat 1: MyOnlyMemory folded before Flop (didn't bet)
Seat 2: MezuuÜuuT folded before Flop (didn't bet)
Seat 3: Hjerterdame1 folded before Flop (didn't bet)
Seat 4: ederpalasson folded before Flop (didn't bet)
Seat 5: nacho2390 (button) collected (5600)
Seat 6: ThalleSx (small blind) folded before Flop
Seat 7: fournn (big blind) folded before Flop
Seat 8: vagoyras folded before Flop (didn't bet)

PokerStars Hand #251205922095: Tournament #3767885527, $40+$10+$5 USD Hold'em No Limit - Level XIII (800/1600) - 2024/06/26 19:26:30 UTC [2024/06/26 15:26:30 ET]
Table '3767885527 61' 8-max Seat #6 is the button
Seat 1: MyOnlyMemory (28200 in chips) 
Seat 2: MezuuÜuuT (20760 in chips) 
Seat 3: Hjerterdame1 (102156 in chips) 
Seat 4: ederpalasson (16743 in chips) 
Seat 5: nacho2390 (30100 in chips) 
Seat 6: ThalleSx (30360 in chips) 
Seat 7: fournn (23605 in chips) 
Seat 8: vagoyras (45799 in chips) 
MyOnlyMemory: posts the ante 200
MezuuÜuuT: posts the ante 200
Hjerterdame1: posts the ante 200
ederpalasson: posts the ante 200
nacho2390: posts the ante 200
ThalleSx: posts the ante 200
fournn: posts the ante 200
vagoyras: posts the ante 200
fournn: posts small blind 800
vagoyras: posts big blind 1600
*** HOLE CARDS ***
MyOnlyMemory: folds 
MezuuÜuuT: folds 
Hjerterdame1: raises 1600 to 3200
ederpalasson: folds 
nacho2390: folds 
ThalleSx: folds 
fournn: calls 2400
vagoyras: raises 8800 to 12000
Hjerterdame1: folds 
fournn: folds 
Uncalled bet (8800) returned to vagoyras
vagoyras collected 11200 from pot
vagoyras: doesn't show hand 
*** SUMMARY ***
Total pot 11200 | Rake 0 
Seat 1: MyOnlyMemory folded before Flop (didn't bet)
Seat 2: MezuuÜuuT folded before Flop (didn't bet)
Seat 3: Hjerterdame1 folded before Flop
Seat 4: ederpalasson folded before Flop (didn't bet)
Seat 5: nacho2390 folded before Flop (didn't bet)
Seat 6: ThalleSx (button) folded before Flop (didn't bet)
Seat 7: fournn (small blind) folded before Flop
Seat 8: vagoyras (big blind) collected (11200)

PokerStars Hand #251205934739: Tournament #3767885527, $40+$10+$5 USD Hold'em No Limit - Level XIII (800/1600) - 2024/06/26 19:27:17 UTC [2024/06/26 15:27:17 ET]
Table '3767885527 61' 8-max Seat #7 is the button
Seat 1: MyOnlyMemory (28000 in chips) 
Seat 2: MezuuÜuuT (20560 in chips) 
Seat 3: Hjerterdame1 (98756 in chips) 
Seat 4: ederpalasson (16543 in chips) 
Seat 5: nacho2390 (29900 in chips) 
Seat 6: ThalleSx (30160 in chips) 
Seat 7: fournn (20205 in chips) 
Seat 8: vagoyras (53599 in chips) 
MyOnlyMemory: posts the ante 200
MezuuÜuuT: posts the ante 200
Hjerterdame1: posts the ante 200
ederpalasson: posts the ante 200
nacho2390: posts the ante 200
ThalleSx: posts the ante 200
fournn: posts the ante 200
vagoyras: posts the ante 200
vagoyras: posts small blind 800
MyOnlyMemory: posts big blind 1600
*** HOLE CARDS ***
MezuuÜuuT: folds 
Hjerterdame1: folds 
ederpalasson: raises 14400 to 16000
nacho2390: folds 
ThalleSx: folds 
fournn: raises 4005 to 20005 and is all-in
vagoyras: folds 
MyOnlyMemory: folds 
ederpalasson: calls 343 and is all-in
Uncalled bet (3662) returned to fournn
*** FLOP *** [8s Td 5d]
*** TURN *** [8s Td 5d] [As]
*** RIVER *** [8s Td 5d As] [4d]
*** SHOW DOWN ***
ederpalasson: shows [5s 5c] (three of a kind, Fives)
fournn: shows [Ac Qc] (a pair of Aces)
ederpalasson collected 36686 from pot
*** SUMMARY ***
Total pot 36686 | Rake 0 
Board [8s Td 5d As 4d]
Seat 1: MyOnlyMemory (big blind) folded before Flop
Seat 2: MezuuÜuuT folded before Flop (didn't bet)
Seat 3: Hjerterdame1 folded before Flop (didn't bet)
Seat 4: ederpalasson showed [5s 5c] and won (36686) with three of a kind, Fives
Seat 5: nacho2390 folded before Flop (didn't bet)
Seat 6: ThalleSx folded before Flop (didn't bet)
Seat 7: fournn (button) showed [Ac Qc] and lost with a pair of Aces
Seat 8: vagoyras (small blind) folded before Flop

PokerStars Hand #251205945216: Tournament #3767885527, $40+$10+$5 USD Hold'em No Limit - Level XIII (800/1600) - 2024/06/26 19:27:56 UTC [2024/06/26 15:27:56 ET]
Table '3767885527 61' 8-max Seat #8 is the button
Seat 1: MyOnlyMemory (26200 in chips) 
Seat 2: MezuuÜuuT (20360 in chips) 
Seat 3: Hjerterdame1 (98556 in chips) 
Seat 4: ederpalasson (36686 in chips) 
Seat 5: nacho2390 (29700 in chips) 
Seat 6: ThalleSx (29960 in chips) 
Seat 7: fournn (3662 in chips) 
Seat 8: vagoyras (52599 in chips) 
MyOnlyMemory: posts the ante 200
MezuuÜuuT: posts the ante 200
Hjerterdame1: posts the ante 200
ederpalasson: posts the ante 200
nacho2390: posts the ante 200
ThalleSx: posts the ante 200
fournn: posts the ante 200
vagoyras: posts the ante 200
MyOnlyMemory: posts small blind 800
MezuuÜuuT: posts big blind 1600
*** HOLE CARDS ***
Hjerterdame1: calls 1600
ederpalasson: folds 
nacho2390: folds 
ThalleSx: raises 3200 to 4800
fournn: folds 
vagoyras: folds 
MyOnlyMemory: folds 
MezuuÜuuT: folds 
Hjerterdame1: calls 3200
*** FLOP *** [6h 9c 2s]
Hjerterdame1: checks 
ThalleSx: bets 4160
Hjerterdame1: raises 10960 to 15120
ThalleSx: raises 9840 to 24960 and is all-in
Hjerterdame1: calls 9840
*** TURN *** [6h 9c 2s] [8s]
*** RIVER *** [6h 9c 2s 8s] [7h]
*** SHOW DOWN ***
Hjerterdame1: shows [9d Td] (a straight, Six to Ten)
ThalleSx: shows [Jd Js] (a pair of Jacks)
Hjerterdame1 collected 63520 from pot
ThalleSx finished the tournament
*** SUMMARY ***
Total pot 63520 | Rake 0 
Board [6h 9c 2s 8s 7h]
Seat 1: MyOnlyMemory (small blind) folded before Flop
Seat 2: MezuuÜuuT (big blind) folded before Flop
Seat 3: Hjerterdame1 showed [9d Td] and won (63520) with a straight, Six to Ten
Seat 4: ederpalasson folded before Flop (didn't bet)
Seat 5: nacho2390 folded before Flop (didn't bet)
Seat 6: ThalleSx showed [Jd Js] and lost with a pair of Jacks
Seat 7: fournn folded before Flop (didn't bet)
Seat 8: vagoyras (button) folded before Flop (didn't bet)

PokerStars Hand #251205964100: Tournament #3767885527, $40+$10+$5 USD Hold'em No Limit - Level XIII (800/1600) - 2024/06/26 19:29:07 UTC [2024/06/26 15:29:07 ET]
Table '3767885527 61' 8-max Seat #1 is the button
Seat 1: MyOnlyMemory (25200 in chips) 
Seat 2: MezuuÜuuT (18560 in chips) 
Seat 3: Hjerterdame1 (132116 in chips) 
Seat 4: ederpalasson (36486 in chips) 
Seat 5: nacho2390 (29500 in chips) 
Seat 7: fournn (3462 in chips) 
Seat 8: vagoyras (52399 in chips) 
MyOnlyMemory: posts the ante 200
MezuuÜuuT: posts the ante 200
Hjerterdame1: posts the ante 200
ederpalasson: posts the ante 200
nacho2390: posts the ante 200
fournn: posts the ante 200
vagoyras: posts the ante 200
MezuuÜuuT: posts small blind 800
Hjerterdame1: posts big blind 1600
*** HOLE CARDS ***
ederpalasson: folds 
nacho2390: raises 1600 to 3200
fournn: folds 
vagoyras: folds 
MyOnlyMemory: folds 
MezuuÜuuT: folds 
Hjerterdame1: folds 
Uncalled bet (1600) returned to nacho2390
nacho2390 collected 5400 from pot
nacho2390: doesn't show hand 
*** SUMMARY ***
Total pot 5400 | Rake 0 
Seat 1: MyOnlyMemory (button) folded before Flop (didn't bet)
Seat 2: MezuuÜuuT (small blind) folded before Flop
Seat 3: Hjerterdame1 (big blind) folded before Flop
Seat 4: ederpalasson folded before Flop (didn't bet)
Seat 5: nacho2390 collected (5400)
Seat 7: fournn folded before Flop (didn't bet)
Seat 8: vagoyras folded before Flop (didn't bet)

PokerStars Hand #251205972453: Tournament #3767885527, $40+$10+$5 USD Hold'em No Limit - Level XIV (1000/2000) - 2024/06/26 19:29:37 UTC [2024/06/26 15:29:37 ET]
Table '3767885527 61' 8-max Seat #2 is the button
Seat 1: MyOnlyMemory (25000 in chips) 
Seat 2: MezuuÜuuT (17560 in chips) 
Seat 3: Hjerterdame1 (130316 in chips) 
Seat 4: ederpalasson (36286 in chips) 
Seat 5: nacho2390 (33100 in chips) 
Seat 7: fournn (3262 in chips) 
Seat 8: vagoyras (52199 in chips) 
MyOnlyMemory: posts the ante 250
MezuuÜuuT: posts the ante 250
Hjerterdame1: posts the ante 250
ederpalasson: posts the ante 250
nacho2390: posts the ante 250
fournn: posts the ante 250
vagoyras: posts the ante 250
Hjerterdame1: posts small blind 1000
ederpalasson: posts big blind 2000
*** HOLE CARDS ***
nacho2390: folds 
XARANDROS is disconnected 
fournn: folds 
vagoyras: raises 2000 to 4000
MyOnlyMemory: raises 20750 to 24750 and is all-in
MezuuÜuuT: folds 
Hjerterdame1: folds 
ederpalasson: folds 
vagoyras: folds 
Uncalled bet (20750) returned to MyOnlyMemory
MyOnlyMemory collected 12750 from pot
*** SUMMARY ***
Total pot 12750 | Rake 0 
Seat 1: MyOnlyMemory collected (12750)
Seat 2: MezuuÜuuT (button) folded before Flop (didn't bet)
Seat 3: Hjerterdame1 (small blind) folded before Flop
Seat 4: ederpalasson (big blind) folded before Flop
Seat 5: nacho2390 folded before Flop (didn't bet)
Seat 7: fournn folded before Flop (didn't bet)
Seat 8: vagoyras folded before Flop

PokerStars Hand #251205985005: Tournament #3767885527, $40+$10+$5 USD Hold'em No Limit - Level XIV (1000/2000) - 2024/06/26 19:30:23 UTC [2024/06/26 15:30:23 ET]
Table '3767885527 61' 8-max Seat #3 is the button
Seat 1: MyOnlyMemory (33500 in chips) 
Seat 2: MezuuÜuuT (17310 in chips) 
Seat 3: Hjerterdame1 (129066 in chips) 
Seat 4: ederpalasson (34036 in chips) 
Seat 5: nacho2390 (32850 in chips) 
Seat 6: XARANDROS (25000 in chips) 
Seat 7: fournn (3012 in chips) 
Seat 8: vagoyras (47949 in chips) 
MyOnlyMemory: posts the ante 250
MezuuÜuuT: posts the ante 250
Hjerterdame1: posts the ante 250
ederpalasson: posts the ante 250
nacho2390: posts the ante 250
XARANDROS: posts the ante 250
fournn: posts the ante 250
vagoyras: posts the ante 250
ederpalasson: posts small blind 1000
nacho2390: posts big blind 2000
*** HOLE CARDS ***
XARANDROS: raises 7000 to 9000
fournn: folds 
vagoyras: folds 
MyOnlyMemory: folds 
MezuuÜuuT: folds 
Hjerterdame1: folds 
ederpalasson: folds 
nacho2390: folds 
Uncalled bet (7000) returned to XARANDROS
XARANDROS collected 7000 from pot
*** SUMMARY ***
Total pot 7000 | Rake 0 
Seat 1: MyOnlyMemory folded before Flop (didn't bet)
Seat 2: MezuuÜuuT folded before Flop (didn't bet)
Seat 3: Hjerterdame1 (button) folded before Flop (didn't bet)
Seat 4: ederpalasson (small blind) folded before Flop
Seat 5: nacho2390 (big blind) folded before Flop
Seat 6: XARANDROS collected (7000)
Seat 7: fournn folded before Flop (didn't bet)
Seat 8: vagoyras folded before Flop (didn't bet)

PokerStars Hand #251205996344: Tournament #3767885527, $40+$10+$5 USD Hold'em No Limit - Level XIV (1000/2000) - 2024/06/26 19:31:04 UTC [2024/06/26 15:31:04 ET]
Table '3767885527 61' 8-max Seat #4 is the button
Seat 1: MyOnlyMemory (33250 in chips) 
Seat 2: MezuuÜuuT (17060 in chips) 
Seat 3: Hjerterdame1 (128816 in chips) 
Seat 4: ederpalasson (32786 in chips) 
Seat 5: nacho2390 (30600 in chips) 
Seat 6: XARANDROS (29750 in chips) 
Seat 7: fournn (2762 in chips) 
Seat 8: vagoyras (47699 in chips) 
MyOnlyMemory: posts the ante 250
MezuuÜuuT: posts the ante 250
Hjerterdame1: posts the ante 250
ederpalasson: posts the ante 250
nacho2390: posts the ante 250
XARANDROS: posts the ante 250
fournn: posts the ante 250
vagoyras: posts the ante 250
nacho2390: posts small blind 1000
XARANDROS: posts big blind 2000
*** HOLE CARDS ***
fournn: folds 
vagoyras: folds 
MyOnlyMemory: folds 
MezuuÜuuT: folds 
Hjerterdame1: raises 4000 to 6000
ederpalasson: folds 
nacho2390: folds 
XARANDROS: calls 4000
*** FLOP *** [9h As 3h]
XARANDROS: checks 
Hjerterdame1: bets 6000
XARANDROS: folds 
Uncalled bet (6000) returned to Hjerterdame1
Hjerterdame1 collected 15000 from pot
Hjerterdame1: doesn't show hand 
*** SUMMARY ***
Total pot 15000 | Rake 0 
Board [9h As 3h]
Seat 1: MyOnlyMemory folded before Flop (didn't bet)
Seat 2: MezuuÜuuT folded before Flop (didn't bet)
Seat 3: Hjerterdame1 collected (15000)
Seat 4: ederpalasson (button) folded before Flop (didn't bet)
Seat 5: nacho2390 (small blind) folded before Flop
Seat 6: XARANDROS (big blind) folded on the Flop
Seat 7: fournn folded before Flop (didn't bet)
Seat 8: vagoyras folded before Flop (didn't bet)

PokerStars Hand #251206018648: Tournament #3767885527, $40+$10+$5 USD Hold'em No Limit - Level XIV (1000/2000) - 2024/06/26 19:32:25 UTC [2024/06/26 15:32:25 ET]
Table '3767885527 61' 8-max Seat #5 is the button
Seat 1: MyOnlyMemory (33000 in chips) 
Seat 2: MezuuÜuuT (16810 in chips) 
Seat 3: Hjerterdame1 (137566 in chips) 
Seat 4: ederpalasson (32536 in chips) 
Seat 5: nacho2390 (29350 in chips) 
Seat 6: XARANDROS (23500 in chips) 
Seat 7: fournn (2512 in chips) 
Seat 8: vagoyras (47449 in chips) 
MyOnlyMemory: posts the ante 250
MezuuÜuuT: posts the ante 250
Hjerterdame1: posts the ante 250
ederpalasson: posts the ante 250
nacho2390: posts the ante 250
XARANDROS: posts the ante 250
fournn: posts the ante 250
vagoyras: posts the ante 250
XARANDROS: posts small blind 1000
fournn: posts big blind 2000
*** HOLE CARDS ***
vagoyras: folds 
MyOnlyMemory: raises 2000 to 4000
MezuuÜuuT: folds 
Hjerterdame1: calls 4000
ederpalasson: calls 4000
nacho2390: raises 25100 to 29100 and is all-in
XARANDROS: folds 
fournn: calls 262 and is all-in
MyOnlyMemory: raises 3650 to 32750 and is all-in
Hjerterdame1: folds 
ederpalasson: folds 
Uncalled bet (3650) returned to MyOnlyMemory
*** FLOP *** [Ad 6d 8h]
*** TURN *** [Ad 6d 8h] [3d]
*** RIVER *** [Ad 6d 8h 3d] [3h]
*** SHOW DOWN ***
MyOnlyMemory: shows [5c 5h] (two pair, Fives and Threes)
nacho2390: shows [Ac Jh] (two pair, Aces and Threes)
nacho2390 collected 57152 from side pot
fournn: shows [Qd 4d] (a flush, Ace high)
fournn collected 14310 from main pot
*** SUMMARY ***
Total pot 71462 Main pot 14310. Side pot 57152. | Rake 0 
Board [Ad 6d 8h 3d 3h]
Seat 1: MyOnlyMemory showed [5c 5h] and lost with two pair, Fives and Threes
Seat 2: MezuuÜuuT folded before Flop (didn't bet)
Seat 3: Hjerterdame1 folded before Flop
Seat 4: ederpalasson folded before Flop
Seat 5: nacho2390 (button) showed [Ac Jh] and won (57152) with two pair, Aces and Threes
Seat 6: XARANDROS (small blind) folded before Flop
Seat 7: fournn (big blind) showed [Qd 4d] and won (14310) with a flush, Ace high
Seat 8: vagoyras folded before Flop (didn't bet)

PokerStars Hand #251206037259: Tournament #3767885527, $40+$10+$5 USD Hold'em No Limit - Level XIV (1000/2000) - 2024/06/26 19:33:33 UTC [2024/06/26 15:33:33 ET]
Table '3767885527 61' 8-max Seat #6 is the button
Seat 1: MyOnlyMemory (3650 in chips) 
Seat 2: MezuuÜuuT (16560 in chips) 
Seat 3: Hjerterdame1 (133316 in chips) 
Seat 4: ederpalasson (28286 in chips) 
Seat 5: nacho2390 (57152 in chips) 
Seat 6: XARANDROS (22250 in chips) 
Seat 7: fournn (14310 in chips) 
Seat 8: vagoyras (47199 in chips) 
MyOnlyMemory: posts the ante 250
MezuuÜuuT: posts the ante 250
Hjerterdame1: posts the ante 250
ederpalasson: posts the ante 250
nacho2390: posts the ante 250
XARANDROS: posts the ante 250
fournn: posts the ante 250
vagoyras: posts the ante 250
fournn: posts small blind 1000
vagoyras: posts big blind 2000
*** HOLE CARDS ***
MyOnlyMemory: folds 
MezuuÜuuT: folds 
Hjerterdame1: raises 4000 to 6000
ederpalasson: folds 
nacho2390: folds 
XARANDROS: folds 
fournn: folds 
vagoyras: folds 
Uncalled bet (4000) returned to Hjerterdame1
Hjerterdame1 collected 7000 from pot
Hjerterdame1: doesn't show hand 
*** SUMMARY ***
Total pot 7000 | Rake 0 
Seat 1: MyOnlyMemory folded before Flop (didn't bet)
Seat 2: MezuuÜuuT folded before Flop (didn't bet)
Seat 3: Hjerterdame1 collected (7000)
Seat 4: ederpalasson folded before Flop (didn't bet)
Seat 5: nacho2390 folded before Flop (didn't bet)
Seat 6: XARANDROS (button) folded before Flop (didn't bet)
Seat 7: fournn (small blind) folded before Flop
Seat 8: vagoyras (big blind) folded before Flop

PokerStars Hand #251206052041: Tournament #3767885527, $40+$10+$5 USD Hold'em No Limit - Level XIV (1000/2000) - 2024/06/26 19:34:27 UTC [2024/06/26 15:34:27 ET]
Table '3767885527 61' 8-max Seat #7 is the button
Seat 1: MyOnlyMemory (3400 in chips) 
Seat 2: MezuuÜuuT (16310 in chips) 
Seat 3: Hjerterdame1 (138066 in chips) 
Seat 4: ederpalasson (28036 in chips) 
Seat 5: nacho2390 (56902 in chips) 
Seat 6: XARANDROS (22000 in chips) 
Seat 7: fournn (13060 in chips) 
Seat 8: vagoyras (44949 in chips) 
MyOnlyMemory: posts the ante 250
MezuuÜuuT: posts the ante 250
Hjerterdame1: posts the ante 250
ederpalasson: posts the ante 250
nacho2390: posts the ante 250
XARANDROS: posts the ante 250
fournn: posts the ante 250
vagoyras: posts the ante 250
vagoyras: posts small blind 1000
MyOnlyMemory: posts big blind 2000
*** HOLE CARDS ***
MezuuÜuuT: folds 
Hjerterdame1: folds 
ederpalasson: raises 2000 to 4000
nacho2390: folds 
XARANDROS: folds 
fournn: raises 8810 to 12810 and is all-in
vagoyras: folds 
MyOnlyMemory: calls 1150 and is all-in
ederpalasson: calls 8810
*** FLOP *** [Tc 9s 6c]
*** TURN *** [Tc 9s 6c] [Js]
*** RIVER *** [Tc 9s 6c Js] [9d]
*** SHOW DOWN ***
ederpalasson: shows [Qh As] (a pair of Nines)
fournn: shows [Ac Ts] (two pair, Tens and Nines)
fournn collected 19320 from side pot
MyOnlyMemory: shows [5d 6h] (two pair, Nines and Sixes)
fournn collected 12450 from main pot
MyOnlyMemory is sitting out
MyOnlyMemory finished the tournament
*** SUMMARY ***
Total pot 31770 Main pot 12450. Side pot 19320. | Rake 0 
Board [Tc 9s 6c Js 9d]
Seat 1: MyOnlyMemory (big blind) showed [5d 6h] and lost with two pair, Nines and Sixes
Seat 2: MezuuÜuuT folded before Flop (didn't bet)
Seat 3: Hjerterdame1 folded before Flop (didn't bet)
Seat 4: ederpalasson showed [Qh As] and lost with a pair of Nines
Seat 5: nacho2390 folded before Flop (didn't bet)
Seat 6: XARANDROS folded before Flop (didn't bet)
Seat 7: fournn (button) showed [Ac Ts] and won (31770) with two pair, Tens and Nines
Seat 8: vagoyras (small blind) folded before Flop


PokerStars Hand #251205109405: Tournament #3767885527, $40+$10+$5 USD Hold'em No Limit - Level IX (400/800) - 2024/06/26 18:33:44 UTC [2024/06/26 14:33:44 ET]
Table '3767885527 60' 8-max Seat #3 is the button
Seat 1: BerriSwEEE27 (25193 in chips) 
Seat 2: billisrd350 (27642 in chips) 
Seat 3: Amandaraujo (48387 in chips) 
Seat 4: kuenne71 (91409 in chips) 
Seat 5: Godfather_RJ (7105 in chips) 
Seat 6: Jayda26 (4412 in chips) 
Seat 7: DrawinDead321 (36369 in chips) 
Seat 8: TamTam93AT (81898 in chips) 
BerriSwEEE27: posts the ante 100
billisrd350: posts the ante 100
Amandaraujo: posts the ante 100
kuenne71: posts the ante 100
Godfather_RJ: posts the ante 100
Jayda26: posts the ante 100
DrawinDead321: posts the ante 100
TamTam93AT: posts the ante 100
kuenne71: posts small blind 400
Godfather_RJ: posts big blind 800
*** HOLE CARDS ***
Jayda26: folds 
DrawinDead321: raises 800 to 1600
TamTam93AT: folds 
BerriSwEEE27: folds 
billisrd350: folds 
Amandaraujo: calls 1600
kuenne71: folds 
Godfather_RJ: calls 800
*** FLOP *** [Ah 2h Jh]
Godfather_RJ: checks 
DrawinDead321: bets 3800
Amandaraujo: folds 
Godfather_RJ: folds 
Uncalled bet (3800) returned to DrawinDead321
DrawinDead321 collected 6000 from pot
*** SUMMARY ***
Total pot 6000 | Rake 0 
Board [Ah 2h Jh]
Seat 1: BerriSwEEE27 folded before Flop (didn't bet)
Seat 2: billisrd350 folded before Flop (didn't bet)
Seat 3: Amandaraujo (button) folded on the Flop
Seat 4: kuenne71 (small blind) folded before Flop
Seat 5: Godfather_RJ (big blind) folded on the Flop
Seat 6: Jayda26 folded before Flop (didn't bet)
Seat 7: DrawinDead321 collected (6000)
Seat 8: TamTam93AT folded before Flop (didn't bet)

PokerStars Hand #251205119056: Tournament #3767885527, $40+$10+$5 USD Hold'em No Limit - Level IX (400/800) - 2024/06/26 18:34:22 UTC [2024/06/26 14:34:22 ET]
Table '3767885527 60' 8-max Seat #4 is the button
Seat 1: BerriSwEEE27 (25093 in chips) 
Seat 2: billisrd350 (27542 in chips) 
Seat 3: Amandaraujo (46687 in chips) 
Seat 4: kuenne71 (90909 in chips) 
Seat 5: Godfather_RJ (5405 in chips) 
Seat 6: Jayda26 (4312 in chips) 
Seat 7: DrawinDead321 (40669 in chips) 
Seat 8: TamTam93AT (81798 in chips) 
BerriSwEEE27: posts the ante 100
billisrd350: posts the ante 100
Amandaraujo: posts the ante 100
kuenne71: posts the ante 100
Godfather_RJ: posts the ante 100
Jayda26: posts the ante 100
DrawinDead321: posts the ante 100
TamTam93AT: posts the ante 100
Godfather_RJ: posts small blind 400
Jayda26: posts big blind 800
*** HOLE CARDS ***
DrawinDead321: raises 800 to 1600
TamTam93AT: folds 
BerriSwEEE27: folds 
billisrd350: calls 1600
Amandaraujo: raises 2400 to 4000
kuenne71: folds 
Godfather_RJ: folds 
Jayda26: raises 212 to 4212 and is all-in
DrawinDead321: raises 36357 to 40569 and is all-in
billisrd350: folds 
Amandaraujo: folds 
Uncalled bet (36357) returned to DrawinDead321
*** FLOP *** [Ad Qs 4c]
*** TURN *** [Ad Qs 4c] [7s]
*** RIVER *** [Ad Qs 4c 7s] [8s]
*** SHOW DOWN ***
Jayda26: shows [9h Ac] (a pair of Aces)
DrawinDead321: shows [Kc As] (a pair of Aces - King kicker)
DrawinDead321 collected 15224 from pot
Jayda26 finished the tournament
*** SUMMARY ***
Total pot 15224 | Rake 0 
Board [Ad Qs 4c 7s 8s]
Seat 1: BerriSwEEE27 folded before Flop (didn't bet)
Seat 2: billisrd350 folded before Flop
Seat 3: Amandaraujo folded before Flop
Seat 4: kuenne71 (button) folded before Flop (didn't bet)
Seat 5: Godfather_RJ (small blind) folded before Flop
Seat 6: Jayda26 (big blind) showed [9h Ac] and lost with a pair of Aces
Seat 7: DrawinDead321 showed [Kc As] and won (15224) with a pair of Aces
Seat 8: TamTam93AT folded before Flop (didn't bet)

PokerStars Hand #251205129609: Tournament #3767885527, $40+$10+$5 USD Hold'em No Limit - Level IX (400/800) - 2024/06/26 18:35:03 UTC [2024/06/26 14:35:03 ET]
Table '3767885527 60' 8-max Seat #5 is the button
Seat 1: BerriSwEEE27 (24993 in chips) 
Seat 2: billisrd350 (25842 in chips) 
Seat 3: Amandaraujo (42587 in chips) 
Seat 4: kuenne71 (90809 in chips) 
Seat 5: Godfather_RJ (4905 in chips) 
Seat 7: DrawinDead321 (51581 in chips) 
Seat 8: TamTam93AT (81698 in chips) 
BerriSwEEE27: posts the ante 100
billisrd350: posts the ante 100
Amandaraujo: posts the ante 100
kuenne71: posts the ante 100
Godfather_RJ: posts the ante 100
DrawinDead321: posts the ante 100
TamTam93AT: posts the ante 100
DrawinDead321: posts small blind 400
TamTam93AT: posts big blind 800
*** HOLE CARDS ***
BerriSwEEE27: raises 880 to 1680
billisrd350: folds 
Amandaraujo: raises 1680 to 3360
kuenne71: folds 
Godfather_RJ: folds 
DrawinDead321: folds 
TamTam93AT: folds 
BerriSwEEE27: raises 21533 to 24893 and is all-in
Amandaraujo: folds 
Uncalled bet (21533) returned to BerriSwEEE27
BerriSwEEE27 collected 8620 from pot
*** SUMMARY ***
Total pot 8620 | Rake 0 
Seat 1: BerriSwEEE27 collected (8620)
Seat 2: billisrd350 folded before Flop (didn't bet)
Seat 3: Amandaraujo folded before Flop
Seat 4: kuenne71 folded before Flop (didn't bet)
Seat 5: Godfather_RJ (button) folded before Flop (didn't bet)
Seat 7: DrawinDead321 (small blind) folded before Flop
Seat 8: TamTam93AT (big blind) folded before Flop

PokerStars Hand #251205136323: Tournament #3767885527, $40+$10+$5 USD Hold'em No Limit - Level IX (400/800) - 2024/06/26 18:35:30 UTC [2024/06/26 14:35:30 ET]
Table '3767885527 60' 8-max Seat #7 is the button
Seat 1: BerriSwEEE27 (30153 in chips) 
Seat 2: billisrd350 (25742 in chips) 
Seat 3: Amandaraujo (39127 in chips) 
Seat 4: kuenne71 (90709 in chips) 
Seat 5: Godfather_RJ (4805 in chips) 
Seat 7: DrawinDead321 (51081 in chips) 
Seat 8: TamTam93AT (80798 in chips) 
BerriSwEEE27: posts the ante 100
billisrd350: posts the ante 100
Amandaraujo: posts the ante 100
kuenne71: posts the ante 100
Godfather_RJ: posts the ante 100
DrawinDead321: posts the ante 100
TamTam93AT: posts the ante 100
TamTam93AT: posts small blind 400
BerriSwEEE27: posts big blind 800
*** HOLE CARDS ***
billisrd350: folds 
Amandaraujo: raises 2700 to 3500
kuenne71: folds 
Godfather_RJ: folds 
DrawinDead321: folds 
TamTam93AT: folds 
BerriSwEEE27: folds 
Uncalled bet (2700) returned to Amandaraujo
Amandaraujo collected 2700 from pot
*** SUMMARY ***
Total pot 2700 | Rake 0 
Seat 1: BerriSwEEE27 (big blind) folded before Flop
Seat 2: billisrd350 folded before Flop (didn't bet)
Seat 3: Amandaraujo collected (2700)
Seat 4: kuenne71 folded before Flop (didn't bet)
Seat 5: Godfather_RJ folded before Flop (didn't bet)
Seat 7: DrawinDead321 (button) folded before Flop (didn't bet)
Seat 8: TamTam93AT (small blind) folded before Flop

PokerStars Hand #251205145676: Tournament #3767885527, $40+$10+$5 USD Hold'em No Limit - Level IX (400/800) - 2024/06/26 18:36:06 UTC [2024/06/26 14:36:06 ET]
Table '3767885527 60' 8-max Seat #8 is the button
Seat 1: BerriSwEEE27 (29253 in chips) 
Seat 2: billisrd350 (25642 in chips) 
Seat 3: Amandaraujo (40927 in chips) 
Seat 4: kuenne71 (90609 in chips) 
Seat 5: Godfather_RJ (4705 in chips) 
Seat 7: DrawinDead321 (50981 in chips) 
Seat 8: TamTam93AT (80298 in chips) 
BerriSwEEE27: posts the ante 100
billisrd350: posts the ante 100
Amandaraujo: posts the ante 100
kuenne71: posts the ante 100
Godfather_RJ: posts the ante 100
DrawinDead321: posts the ante 100
TamTam93AT: posts the ante 100
BerriSwEEE27: posts small blind 400
billisrd350: posts big blind 800
*** HOLE CARDS ***
Amandaraujo: raises 800 to 1600
kuenne71: folds 
Godfather_RJ: folds 
DrawinDead321: folds 
TamTam93AT: folds 
BerriSwEEE27: folds 
billisrd350: calls 800
*** FLOP *** [Ac 3s Kd]
billisrd350: checks 
Amandaraujo: bets 2150
billisrd350: calls 2150
*** TURN *** [Ac 3s Kd] [Jh]
billisrd350: checks 
Amandaraujo: bets 3200
billisrd350: calls 3200
*** RIVER *** [Ac 3s Kd Jh] [4h]
billisrd350: checks 
Amandaraujo: bets 7500
billisrd350: calls 7500
*** SHOW DOWN ***
Amandaraujo: shows [Qs 5h] (high card Ace)
billisrd350: shows [7s As] (a pair of Aces)
billisrd350 collected 30000 from pot
*** SUMMARY ***
Total pot 30000 | Rake 0 
Board [Ac 3s Kd Jh 4h]
Seat 1: BerriSwEEE27 (small blind) folded before Flop
Seat 2: billisrd350 (big blind) showed [7s As] and won (30000) with a pair of Aces
Seat 3: Amandaraujo showed [Qs 5h] and lost with high card Ace
Seat 4: kuenne71 folded before Flop (didn't bet)
Seat 5: Godfather_RJ folded before Flop (didn't bet)
Seat 7: DrawinDead321 folded before Flop (didn't bet)
Seat 8: TamTam93AT (button) folded before Flop (didn't bet)

PokerStars Hand #251205163720: Tournament #3767885527, $40+$10+$5 USD Hold'em No Limit - Level IX (400/800) - 2024/06/26 18:37:16 UTC [2024/06/26 14:37:16 ET]
Table '3767885527 60' 8-max Seat #1 is the button
Seat 1: BerriSwEEE27 (28753 in chips) 
Seat 2: billisrd350 (41092 in chips) 
Seat 3: Amandaraujo (26377 in chips) 
Seat 4: kuenne71 (90509 in chips) 
Seat 5: Godfather_RJ (4605 in chips) 
Seat 6: Teddygram902 (25000 in chips) 
Seat 7: DrawinDead321 (50881 in chips) 
Seat 8: TamTam93AT (80198 in chips) 
BerriSwEEE27: posts the ante 100
billisrd350: posts the ante 100
Amandaraujo: posts the ante 100
kuenne71: posts the ante 100
Godfather_RJ: posts the ante 100
Teddygram902: posts the ante 100
DrawinDead321: posts the ante 100
TamTam93AT: posts the ante 100
billisrd350: posts small blind 400
Amandaraujo: posts big blind 800
*** HOLE CARDS ***
kuenne71: folds 
Godfather_RJ: folds 
Teddygram902: folds 
DrawinDead321: folds 
TamTam93AT: folds 
BerriSwEEE27: folds 
billisrd350: calls 400
Amandaraujo: raises 2400 to 3200
billisrd350: raises 37792 to 40992 and is all-in
Amandaraujo: calls 23077 and is all-in
Uncalled bet (14715) returned to billisrd350
*** FLOP *** [Ad 9h 2c]
*** TURN *** [Ad 9h 2c] [Qs]
*** RIVER *** [Ad 9h 2c Qs] [5s]
*** SHOW DOWN ***
billisrd350: shows [6s 6c] (a pair of Sixes)
Amandaraujo: shows [Ts 9d] (a pair of Nines)
Amandaraujo collected 53354 from pot
*** SUMMARY ***
Total pot 53354 | Rake 0 
Board [Ad 9h 2c Qs 5s]
Seat 1: BerriSwEEE27 (button) folded before Flop (didn't bet)
Seat 2: billisrd350 (small blind) showed [6s 6c] and lost with a pair of Sixes
Seat 3: Amandaraujo (big blind) showed [Ts 9d] and won (53354) with a pair of Nines
Seat 4: kuenne71 folded before Flop (didn't bet)
Seat 5: Godfather_RJ folded before Flop (didn't bet)
Seat 6: Teddygram902 folded before Flop (didn't bet)
Seat 7: DrawinDead321 folded before Flop (didn't bet)
Seat 8: TamTam93AT folded before Flop (didn't bet)

PokerStars Hand #251205177588: Tournament #3767885527, $40+$10+$5 USD Hold'em No Limit - Level IX (400/800) - 2024/06/26 18:38:10 UTC [2024/06/26 14:38:10 ET]
Table '3767885527 60' 8-max Seat #2 is the button
Seat 1: BerriSwEEE27 (28653 in chips) 
Seat 2: billisrd350 (14715 in chips) 
Seat 3: Amandaraujo (53354 in chips) 
Seat 4: kuenne71 (90409 in chips) 
Seat 5: Godfather_RJ (4505 in chips) 
Seat 6: Teddygram902 (24900 in chips) 
Seat 7: DrawinDead321 (50781 in chips) 
Seat 8: TamTam93AT (80098 in chips) 
BerriSwEEE27: posts the ante 100
billisrd350: posts the ante 100
Amandaraujo: posts the ante 100
kuenne71: posts the ante 100
Godfather_RJ: posts the ante 100
Teddygram902: posts the ante 100
DrawinDead321: posts the ante 100
TamTam93AT: posts the ante 100
Amandaraujo: posts small blind 400
kuenne71: posts big blind 800
*** HOLE CARDS ***
Godfather_RJ: folds 
Teddygram902: folds 
DrawinDead321: folds 
TamTam93AT: folds 
BerriSwEEE27: raises 880 to 1680
billisrd350: raises 12935 to 14615 and is all-in
Amandaraujo: folds 
kuenne71: folds 
BerriSwEEE27: folds 
Uncalled bet (12935) returned to billisrd350
billisrd350 collected 5360 from pot
billisrd350: doesn't show hand 
*** SUMMARY ***
Total pot 5360 | Rake 0 
Seat 1: BerriSwEEE27 folded before Flop
Seat 2: billisrd350 (button) collected (5360)
Seat 3: Amandaraujo (small blind) folded before Flop
Seat 4: kuenne71 (big blind) folded before Flop
Seat 5: Godfather_RJ folded before Flop (didn't bet)
Seat 6: Teddygram902 folded before Flop (didn't bet)
Seat 7: DrawinDead321 folded before Flop (didn't bet)
Seat 8: TamTam93AT folded before Flop (didn't bet)

PokerStars Hand #251205182901: Tournament #3767885527, $40+$10+$5 USD Hold'em No Limit - Level IX (400/800) - 2024/06/26 18:38:30 UTC [2024/06/26 14:38:30 ET]
Table '3767885527 60' 8-max Seat #3 is the button
Seat 1: BerriSwEEE27 (26873 in chips) 
Seat 2: billisrd350 (18295 in chips) 
Seat 3: Amandaraujo (52854 in chips) 
Seat 4: kuenne71 (89509 in chips) 
Seat 5: Godfather_RJ (4405 in chips) 
Seat 6: Teddygram902 (24800 in chips) 
Seat 7: DrawinDead321 (50681 in chips) 
Seat 8: TamTam93AT (79998 in chips) 
BerriSwEEE27: posts the ante 100
billisrd350: posts the ante 100
Amandaraujo: posts the ante 100
kuenne71: posts the ante 100
Godfather_RJ: posts the ante 100
Teddygram902: posts the ante 100
DrawinDead321: posts the ante 100
TamTam93AT: posts the ante 100
kuenne71: posts small blind 400
Godfather_RJ: posts big blind 800
*** HOLE CARDS ***
Teddygram902: folds 
DrawinDead321: folds 
TamTam93AT: raises 880 to 1680
BerriSwEEE27: folds 
billisrd350: calls 1680
Amandaraujo: calls 1680
kuenne71: calls 1280
Godfather_RJ: calls 880
*** FLOP *** [Jd 5c Qh]
kuenne71: checks 
Godfather_RJ: checks 
TamTam93AT: checks 
billisrd350: checks 
Amandaraujo: checks 
*** TURN *** [Jd 5c Qh] [Ad]
kuenne71: checks 
Godfather_RJ: checks 
TamTam93AT: bets 2300
billisrd350: folds 
Amandaraujo: folds 
kuenne71: folds 
Godfather_RJ: folds 
Uncalled bet (2300) returned to TamTam93AT
TamTam93AT collected 9200 from pot
TamTam93AT: doesn't show hand 
*** SUMMARY ***
Total pot 9200 | Rake 0 
Board [Jd 5c Qh Ad]
Seat 1: BerriSwEEE27 folded before Flop (didn't bet)
Seat 2: billisrd350 folded on the Turn
Seat 3: Amandaraujo (button) folded on the Turn
Seat 4: kuenne71 (small blind) folded on the Turn
Seat 5: Godfather_RJ (big blind) folded on the Turn
Seat 6: Teddygram902 folded before Flop (didn't bet)
Seat 7: DrawinDead321 folded before Flop (didn't bet)
Seat 8: TamTam93AT collected (9200)

PokerStars Hand #251205199305: Tournament #3767885527, $40+$10+$5 USD Hold'em No Limit - Level IX (400/800) - 2024/06/26 18:39:34 UTC [2024/06/26 14:39:34 ET]
Table '3767885527 60' 8-max Seat #4 is the button
Seat 1: BerriSwEEE27 (26773 in chips) 
Seat 2: billisrd350 (16515 in chips) 
Seat 3: Amandaraujo (51074 in chips) 
Seat 4: kuenne71 (87729 in chips) 
Seat 5: Godfather_RJ (2625 in chips) 
Seat 6: Teddygram902 (24700 in chips) 
Seat 7: DrawinDead321 (50581 in chips) 
Seat 8: TamTam93AT (87418 in chips) 
BerriSwEEE27: posts the ante 100
billisrd350: posts the ante 100
Amandaraujo: posts the ante 100
kuenne71: posts the ante 100
Godfather_RJ: posts the ante 100
Teddygram902: posts the ante 100
DrawinDead321: posts the ante 100
TamTam93AT: posts the ante 100
Godfather_RJ: posts small blind 400
Teddygram902: posts big blind 800
*** HOLE CARDS ***
DrawinDead321: folds 
TamTam93AT: raises 960 to 1760
BerriSwEEE27: folds 
billisrd350: folds 
Amandaraujo: calls 1760
kuenne71: folds 
Godfather_RJ: folds 
Teddygram902: folds 
*** FLOP *** [Qh Jd 7h]
DrawinDead321 is disconnected 
DrawinDead321 is disconnected 
TamTam93AT: bets 3864
Amandaraujo: calls 3864
*** TURN *** [Qh Jd 7h] [5h]
TamTam93AT: checks 
Amandaraujo: checks 
*** RIVER *** [Qh Jd 7h 5h] [7d]
TamTam93AT: bets 9274
Amandaraujo: calls 9274
*** SHOW DOWN ***
TamTam93AT: shows [Ad Ac] (two pair, Aces and Sevens)
Amandaraujo: mucks hand 
TamTam93AT collected 31796 from pot
*** SUMMARY ***
Total pot 31796 | Rake 0 
Board [Qh Jd 7h 5h 7d]
Seat 1: BerriSwEEE27 folded before Flop (didn't bet)
Seat 2: billisrd350 folded before Flop (didn't bet)
Seat 3: Amandaraujo mucked
Seat 4: kuenne71 (button) folded before Flop (didn't bet)
Seat 5: Godfather_RJ (small blind) folded before Flop
Seat 6: Teddygram902 (big blind) folded before Flop
Seat 7: DrawinDead321 folded before Flop (didn't bet)
Seat 8: TamTam93AT showed [Ad Ac] and won (31796) with two pair, Aces and Sevens

PokerStars Hand #251205215342: Tournament #3767885527, $40+$10+$5 USD Hold'em No Limit - Level IX (400/800) - 2024/06/26 18:40:35 UTC [2024/06/26 14:40:35 ET]
Table '3767885527 60' 8-max Seat #5 is the button
Seat 1: BerriSwEEE27 (26673 in chips) 
Seat 2: billisrd350 (16415 in chips) 
Seat 3: Amandaraujo (36076 in chips) 
Seat 4: kuenne71 (87629 in chips) 
Seat 5: Godfather_RJ (2125 in chips) 
Seat 6: Teddygram902 (23800 in chips) 
Seat 7: DrawinDead321 (50481 in chips) 
Seat 8: TamTam93AT (104216 in chips) 
BerriSwEEE27: posts the ante 100
billisrd350: posts the ante 100
Amandaraujo: posts the ante 100
kuenne71: posts the ante 100
Godfather_RJ: posts the ante 100
Teddygram902: posts the ante 100
DrawinDead321: posts the ante 100
TamTam93AT: posts the ante 100
Teddygram902: posts small blind 400
DrawinDead321: posts big blind 800
*** HOLE CARDS ***
TamTam93AT: folds 
BerriSwEEE27: raises 880 to 1680
billisrd350: folds 
Amandaraujo: folds 
kuenne71: folds 
Godfather_RJ: folds 
Teddygram902: folds 
DrawinDead321: calls 880
*** FLOP *** [Tc 2c 6h]
DrawinDead321: checks 
BerriSwEEE27: bets 1144
DrawinDead321: calls 1144
*** TURN *** [Tc 2c 6h] [5d]
DrawinDead321: checks 
BerriSwEEE27: bets 5200
DrawinDead321: calls 5200
*** RIVER *** [Tc 2c 6h 5d] [Ad]
DrawinDead321: checks 
BerriSwEEE27: bets 18549 and is all-in
DrawinDead321: folds 
Uncalled bet (18549) returned to BerriSwEEE27
BerriSwEEE27 collected 17248 from pot
*** SUMMARY ***
Total pot 17248 | Rake 0 
Board [Tc 2c 6h 5d Ad]
Seat 1: BerriSwEEE27 collected (17248)
Seat 2: billisrd350 folded before Flop (didn't bet)
Seat 3: Amandaraujo folded before Flop (didn't bet)
Seat 4: kuenne71 folded before Flop (didn't bet)
Seat 5: Godfather_RJ (button) folded before Flop (didn't bet)
Seat 6: Teddygram902 (small blind) folded before Flop
Seat 7: DrawinDead321 (big blind) folded on the River
Seat 8: TamTam93AT folded before Flop (didn't bet)

PokerStars Hand #251205233752: Tournament #3767885527, $40+$10+$5 USD Hold'em No Limit - Level IX (400/800) - 2024/06/26 18:41:46 UTC [2024/06/26 14:41:46 ET]
Table '3767885527 60' 8-max Seat #6 is the button
Seat 1: BerriSwEEE27 (35797 in chips) 
Seat 2: billisrd350 (16315 in chips) 
Seat 3: Amandaraujo (35976 in chips) 
Seat 4: kuenne71 (87529 in chips) 
Seat 5: Godfather_RJ (2025 in chips) 
Seat 6: Teddygram902 (23300 in chips) 
Seat 7: DrawinDead321 (42357 in chips) 
Seat 8: TamTam93AT (104116 in chips) 
BerriSwEEE27: posts the ante 100
billisrd350: posts the ante 100
Amandaraujo: posts the ante 100
kuenne71: posts the ante 100
Godfather_RJ: posts the ante 100
Teddygram902: posts the ante 100
DrawinDead321: posts the ante 100
TamTam93AT: posts the ante 100
DrawinDead321: posts small blind 400
TamTam93AT: posts big blind 800
*** HOLE CARDS ***
BerriSwEEE27: raises 880 to 1680
billisrd350: folds 
Amandaraujo: calls 1680
kuenne71: calls 1680
Godfather_RJ: folds 
Teddygram902: raises 21520 to 23200 and is all-in
DrawinDead321: folds 
TamTam93AT: folds 
BerriSwEEE27: raises 12497 to 35697 and is all-in
Amandaraujo: folds 
kuenne71: folds 
Uncalled bet (12497) returned to BerriSwEEE27
*** FLOP *** [2d 6h As]
*** TURN *** [2d 6h As] [7d]
*** RIVER *** [2d 6h As 7d] [5c]
*** SHOW DOWN ***
BerriSwEEE27: shows [Ks Ad] (a pair of Aces)
Teddygram902: shows [Qs Ah] (a pair of Aces - lower kicker)
BerriSwEEE27 collected 51760 from pot
Teddygram902 finished the tournament
*** SUMMARY ***
Total pot 51760 | Rake 0 
Board [2d 6h As 7d 5c]
Seat 1: BerriSwEEE27 showed [Ks Ad] and won (51760) with a pair of Aces
Seat 2: billisrd350 folded before Flop (didn't bet)
Seat 3: Amandaraujo folded before Flop
Seat 4: kuenne71 folded before Flop
Seat 5: Godfather_RJ folded before Flop (didn't bet)
Seat 6: Teddygram902 (button) showed [Qs Ah] and lost with a pair of Aces
Seat 7: DrawinDead321 (small blind) folded before Flop
Seat 8: TamTam93AT (big blind) folded before Flop


PokerStars Hand #251205110414: Tournament #3767885527, $40+$10+$5 USD Hold'em No Limit - Level IX (400/800) - 2024/06/26 18:33:48 UTC [2024/06/26 14:33:48 ET]
Table '3767885527 59' 8-max Seat #7 is the button
Seat 1: vitor762 (22998 in chips) 
Seat 2: mikilool (24820 in chips) 
Seat 3: DaDumon (44609 in chips) 
Seat 4: Pkrscott1992 (70539 in chips) 
Seat 5: SkemGeeMan (25405 in chips) 
Seat 6: JACKPOT786 (30981 in chips) 
Seat 7: sandarobert1 (105968 in chips) 
Seat 8: thrasher71 (44724 in chips) 
vitor762: posts the ante 100
mikilool: posts the ante 100
DaDumon: posts the ante 100
Pkrscott1992: posts the ante 100
SkemGeeMan: posts the ante 100
JACKPOT786: posts the ante 100
sandarobert1: posts the ante 100
thrasher71: posts the ante 100
thrasher71: posts small blind 400
vitor762: posts big blind 800
*** HOLE CARDS ***
mikilool: folds 
DaDumon: folds 
Pkrscott1992: raises 800 to 1600
SkemGeeMan: folds 
JACKPOT786: folds 
sandarobert1: calls 1600
thrasher71: calls 1200
vitor762: calls 800
*** FLOP *** [8c Qh 5h]
thrasher71: checks 
vitor762: checks 
Pkrscott1992: checks 
sandarobert1: checks 
*** TURN *** [8c Qh 5h] [9c]
thrasher71: checks 
vitor762: checks 
Pkrscott1992: checks 
sandarobert1: bets 2520
thrasher71: raises 6280 to 8800
vitor762: folds 
Pkrscott1992: folds 
sandarobert1: folds 
Uncalled bet (6280) returned to thrasher71
thrasher71 collected 12240 from pot
thrasher71: doesn't show hand 
*** SUMMARY ***
Total pot 12240 | Rake 0 
Board [8c Qh 5h 9c]
Seat 1: vitor762 (big blind) folded on the Turn
Seat 2: mikilool folded before Flop (didn't bet)
Seat 3: DaDumon folded before Flop (didn't bet)
Seat 4: Pkrscott1992 folded on the Turn
Seat 5: SkemGeeMan folded before Flop (didn't bet)
Seat 6: JACKPOT786 folded before Flop (didn't bet)
Seat 7: sandarobert1 (button) folded on the Turn
Seat 8: thrasher71 (small blind) collected (12240)

PokerStars Hand #251205156405: Tournament #3767885527, $40+$10+$5 USD Hold'em No Limit - Level IX (400/800) - 2024/06/26 18:36:48 UTC [2024/06/26 14:36:48 ET]
Table '3767885527 59' 8-max Seat #8 is the button
Seat 1: vitor762 (21298 in chips) 
Seat 2: mikilool (24720 in chips) 
Seat 3: DaDumon (44509 in chips) 
Seat 4: Pkrscott1992 (68839 in chips) 
Seat 5: SkemGeeMan (25305 in chips) 
Seat 6: JACKPOT786 (30881 in chips) 
Seat 7: sandarobert1 (101748 in chips) 
Seat 8: thrasher71 (52744 in chips) 
vitor762: posts the ante 100
mikilool: posts the ante 100
DaDumon: posts the ante 100
Pkrscott1992: posts the ante 100
SkemGeeMan: posts the ante 100
JACKPOT786: posts the ante 100
sandarobert1: posts the ante 100
thrasher71: posts the ante 100
vitor762: posts small blind 400
mikilool: posts big blind 800
*** HOLE CARDS ***
DaDumon: folds 
Pkrscott1992: folds 
SkemGeeMan: folds 
JACKPOT786 has timed out
JACKPOT786: folds 
JACKPOT786 is sitting out
sandarobert1: folds 
JACKPOT786 has returned
thrasher71 has timed out
thrasher71: folds 
thrasher71 is sitting out
thrasher71 has returned
vitor762: calls 400
mikilool: raises 2000 to 2800
vitor762: folds 
Uncalled bet (2000) returned to mikilool
mikilool collected 2400 from pot
mikilool: doesn't show hand 
*** SUMMARY ***
Total pot 2400 | Rake 0 
Seat 1: vitor762 (small blind) folded before Flop
Seat 2: mikilool (big blind) collected (2400)
Seat 3: DaDumon folded before Flop (didn't bet)
Seat 4: Pkrscott1992 folded before Flop (didn't bet)
Seat 5: SkemGeeMan folded before Flop (didn't bet)
Seat 6: JACKPOT786 folded before Flop (didn't bet)
Seat 7: sandarobert1 folded before Flop (didn't bet)
Seat 8: thrasher71 (button) folded before Flop (didn't bet)

PokerStars Hand #251205181794: Tournament #3767885527, $40+$10+$5 USD Hold'em No Limit - Level IX (400/800) - 2024/06/26 18:38:26 UTC [2024/06/26 14:38:26 ET]
Table '3767885527 59' 8-max Seat #1 is the button
Seat 1: vitor762 (20398 in chips) 
Seat 2: mikilool (26220 in chips) 
Seat 3: DaDumon (44409 in chips) 
Seat 4: Pkrscott1992 (68739 in chips) 
Seat 5: SkemGeeMan (25205 in chips) 
Seat 6: JACKPOT786 (30781 in chips) 
Seat 7: sandarobert1 (101648 in chips) 
Seat 8: thrasher71 (52644 in chips) 
vitor762: posts the ante 100
mikilool: posts the ante 100
DaDumon: posts the ante 100
Pkrscott1992: posts the ante 100
SkemGeeMan: posts the ante 100
JACKPOT786: posts the ante 100
sandarobert1: posts the ante 100
thrasher71: posts the ante 100
mikilool: posts small blind 400
DaDumon: posts big blind 800
*** HOLE CARDS ***
Pkrscott1992: folds 
SkemGeeMan: folds 
JACKPOT786: folds 
sandarobert1: folds 
thrasher71: raises 800 to 1600
vitor762: folds 
mikilool: folds 
DaDumon: calls 800
*** FLOP *** [6c Kh 7h]
DaDumon: checks 
thrasher71: checks 
*** TURN *** [6c Kh 7h] [8c]
DaDumon: checks 
thrasher71: bets 1320
DaDumon: calls 1320
*** RIVER *** [6c Kh 7h 8c] [6s]
DaDumon: checks 
thrasher71: bets 5280
DaDumon: folds 
Uncalled bet (5280) returned to thrasher71
thrasher71 collected 7040 from pot
thrasher71: doesn't show hand 
*** SUMMARY ***
Total pot 7040 | Rake 0 
Board [6c Kh 7h 8c 6s]
Seat 1: vitor762 (button) folded before Flop (didn't bet)
Seat 2: mikilool (small blind) folded before Flop
Seat 3: DaDumon (big blind) folded on the River
Seat 4: Pkrscott1992 folded before Flop (didn't bet)
Seat 5: SkemGeeMan folded before Flop (didn't bet)
Seat 6: JACKPOT786 folded before Flop (didn't bet)
Seat 7: sandarobert1 folded before Flop (didn't bet)
Seat 8: thrasher71 collected (7040)

PokerStars Hand #251205208539: Tournament #3767885527, $40+$10+$5 USD Hold'em No Limit - Level IX (400/800) - 2024/06/26 18:40:09 UTC [2024/06/26 14:40:09 ET]
Table '3767885527 59' 8-max Seat #2 is the button
Seat 1: vitor762 (20298 in chips) 
Seat 2: mikilool (25720 in chips) 
Seat 3: DaDumon (41389 in chips) 
Seat 4: Pkrscott1992 (68639 in chips) 
Seat 5: SkemGeeMan (25105 in chips) 
Seat 6: JACKPOT786 (30681 in chips) 
Seat 7: sandarobert1 (101548 in chips) 
Seat 8: thrasher71 (56664 in chips) 
vitor762: posts the ante 100
mikilool: posts the ante 100
DaDumon: posts the ante 100
Pkrscott1992: posts the ante 100
SkemGeeMan: posts the ante 100
JACKPOT786: posts the ante 100
sandarobert1: posts the ante 100
thrasher71: posts the ante 100
DaDumon: posts small blind 400
Pkrscott1992: posts big blind 800
*** HOLE CARDS ***
SkemGeeMan: folds 
JACKPOT786: folds 
sandarobert1: raises 960 to 1760
thrasher71 has timed out
thrasher71: folds 
thrasher71 is sitting out
thrasher71 has returned
vitor762: raises 2640 to 4400
mikilool: folds 
DaDumon: folds 
Pkrscott1992: folds 
sandarobert1: calls 2640
*** FLOP *** [Qs Ks Kc]
sandarobert1: checks 
vitor762: bets 3200
sandarobert1: calls 3200
*** TURN *** [Qs Ks Kc] [9h]
sandarobert1: checks 
vitor762: checks 
*** RIVER *** [Qs Ks Kc 9h] [Td]
sandarobert1: bets 13416
vitor762: folds 
Uncalled bet (13416) returned to sandarobert1
sandarobert1 collected 17200 from pot
*** SUMMARY ***
Total pot 17200 | Rake 0 
Board [Qs Ks Kc 9h Td]
Seat 1: vitor762 folded on the River
Seat 2: mikilool (button) folded before Flop (didn't bet)
Seat 3: DaDumon (small blind) folded before Flop
Seat 4: Pkrscott1992 (big blind) folded before Flop
Seat 5: SkemGeeMan folded before Flop (didn't bet)
Seat 6: JACKPOT786 folded before Flop (didn't bet)
Seat 7: sandarobert1 collected (17200)
Seat 8: thrasher71 folded before Flop (didn't bet)

PokerStars Hand #251205246561: Tournament #3767885527, $40+$10+$5 USD Hold'em No Limit - Level X (500/1000) - 2024/06/26 18:42:35 UTC [2024/06/26 14:42:35 ET]
Table '3767885527 59' 8-max Seat #3 is the button
Seat 1: vitor762 (12598 in chips) 
Seat 2: mikilool (25620 in chips) 
Seat 3: DaDumon (40889 in chips) 
Seat 4: Pkrscott1992 (67739 in chips) 
Seat 5: SkemGeeMan (25005 in chips) 
Seat 6: JACKPOT786 (30581 in chips) 
Seat 7: sandarobert1 (111048 in chips) 
Seat 8: thrasher71 (56564 in chips) 
vitor762: posts the ante 125
mikilool: posts the ante 125
DaDumon: posts the ante 125
Pkrscott1992: posts the ante 125
SkemGeeMan: posts the ante 125
JACKPOT786: posts the ante 125
sandarobert1: posts the ante 125
thrasher71: posts the ante 125
Pkrscott1992: posts small blind 500
SkemGeeMan: posts big blind 1000
*** HOLE CARDS ***
JACKPOT786: folds 
sandarobert1: folds 
thrasher71: folds 
vitor762: folds 
mikilool: folds 
DaDumon: raises 1000 to 2000
Pkrscott1992: folds 
SkemGeeMan: calls 1000
*** FLOP *** [6h 8d Qd]
SkemGeeMan: checks 
DaDumon: bets 3020
SkemGeeMan: folds 
Uncalled bet (3020) returned to DaDumon
DaDumon collected 5500 from pot
DaDumon: doesn't show hand 
*** SUMMARY ***
Total pot 5500 | Rake 0 
Board [6h 8d Qd]
Seat 1: vitor762 folded before Flop (didn't bet)
Seat 2: mikilool folded before Flop (didn't bet)
Seat 3: DaDumon (button) collected (5500)
Seat 4: Pkrscott1992 (small blind) folded before Flop
Seat 5: SkemGeeMan (big blind) folded on the Flop
Seat 6: JACKPOT786 folded before Flop (didn't bet)
Seat 7: sandarobert1 folded before Flop (didn't bet)
Seat 8: thrasher71 folded before Flop (didn't bet)

PokerStars Hand #251205272142: Tournament #3767885527, $40+$10+$5 USD Hold'em No Limit - Level X (500/1000) - 2024/06/26 18:44:13 UTC [2024/06/26 14:44:13 ET]
Table '3767885527 59' 8-max Seat #4 is the button
Seat 1: vitor762 (12473 in chips) 
Seat 2: mikilool (25495 in chips) 
Seat 3: DaDumon (44264 in chips) 
Seat 4: Pkrscott1992 (67114 in chips) 
Seat 5: SkemGeeMan (22880 in chips) 
Seat 6: JACKPOT786 (30456 in chips) 
Seat 7: sandarobert1 (110923 in chips) 
Seat 8: thrasher71 (56439 in chips) 
vitor762: posts the ante 125
mikilool: posts the ante 125
DaDumon: posts the ante 125
Pkrscott1992: posts the ante 125
SkemGeeMan: posts the ante 125
JACKPOT786: posts the ante 125
sandarobert1: posts the ante 125
thrasher71: posts the ante 125
SkemGeeMan: posts small blind 500
JACKPOT786: posts big blind 1000
*** HOLE CARDS ***
sandarobert1: raises 1200 to 2200
thrasher71: folds 
vitor762: folds 
mikilool: folds 
DaDumon: folds 
Pkrscott1992: calls 2200
SkemGeeMan: folds 
JACKPOT786: calls 1200
*** FLOP *** [5s Qh 8c]
JACKPOT786: checks 
sandarobert1: bets 2835
Pkrscott1992: calls 2835
JACKPOT786: calls 2835
*** TURN *** [5s Qh 8c] [2s]
JACKPOT786: checks 
sandarobert1: checks 
Pkrscott1992: bets 9000
JACKPOT786: folds 
sandarobert1: folds 
Uncalled bet (9000) returned to Pkrscott1992
Pkrscott1992 collected 16605 from pot
Pkrscott1992: doesn't show hand 
*** SUMMARY ***
Total pot 16605 | Rake 0 
Board [5s Qh 8c 2s]
Seat 1: vitor762 folded before Flop (didn't bet)
Seat 2: mikilool folded before Flop (didn't bet)
Seat 3: DaDumon folded before Flop (didn't bet)
Seat 4: Pkrscott1992 (button) collected (16605)
Seat 5: SkemGeeMan (small blind) folded before Flop
Seat 6: JACKPOT786 (big blind) folded on the Turn
Seat 7: sandarobert1 folded on the Turn
Seat 8: thrasher71 folded before Flop (didn't bet)

PokerStars Hand #251205290523: Tournament #3767885527, $40+$10+$5 USD Hold'em No Limit - Level X (500/1000) - 2024/06/26 18:45:22 UTC [2024/06/26 14:45:22 ET]
Table '3767885527 59' 8-max Seat #5 is the button
Seat 1: vitor762 (12348 in chips) 
Seat 2: mikilool (25370 in chips) 
Seat 3: DaDumon (44139 in chips) 
Seat 4: Pkrscott1992 (78559 in chips) 
Seat 5: SkemGeeMan (22255 in chips) 
Seat 6: JACKPOT786 (25296 in chips) 
Seat 7: sandarobert1 (105763 in chips) 
Seat 8: thrasher71 (56314 in chips) 
vitor762: posts the ante 125
mikilool: posts the ante 125
DaDumon: posts the ante 125
Pkrscott1992: posts the ante 125
SkemGeeMan: posts the ante 125
JACKPOT786: posts the ante 125
sandarobert1: posts the ante 125
thrasher71: posts the ante 125
JACKPOT786: posts small blind 500
sandarobert1: posts big blind 1000
*** HOLE CARDS ***
thrasher71: folds 
vitor762: folds 
mikilool: folds 
DaDumon: folds 
Pkrscott1992: raises 1000 to 2000
SkemGeeMan: folds 
JACKPOT786: folds 
sandarobert1: calls 1000
*** FLOP *** [2h 9c Qs]
sandarobert1: checks 
Pkrscott1992: bets 2000
sandarobert1: calls 2000
*** TURN *** [2h 9c Qs] [Ah]
sandarobert1: checks 
Pkrscott1992: bets 5000
sandarobert1: folds 
Uncalled bet (5000) returned to Pkrscott1992
Pkrscott1992 collected 9500 from pot
Pkrscott1992: doesn't show hand 
*** SUMMARY ***
Total pot 9500 | Rake 0 
Board [2h 9c Qs Ah]
Seat 1: vitor762 folded before Flop (didn't bet)
Seat 2: mikilool folded before Flop (didn't bet)
Seat 3: DaDumon folded before Flop (didn't bet)
Seat 4: Pkrscott1992 collected (9500)
Seat 5: SkemGeeMan (button) folded before Flop (didn't bet)
Seat 6: JACKPOT786 (small blind) folded before Flop
Seat 7: sandarobert1 (big blind) folded on the Turn
Seat 8: thrasher71 folded before Flop (didn't bet)

PokerStars Hand #251205306333: Tournament #3767885527, $40+$10+$5 USD Hold'em No Limit - Level X (500/1000) - 2024/06/26 18:46:21 UTC [2024/06/26 14:46:21 ET]
Table '3767885527 59' 8-max Seat #6 is the button
Seat 1: vitor762 (12223 in chips) 
Seat 2: mikilool (25245 in chips) 
Seat 3: DaDumon (44014 in chips) 
Seat 5: SkemGeeMan (22130 in chips) 
Seat 6: JACKPOT786 (24671 in chips) 
Seat 7: sandarobert1 (101638 in chips) 
Seat 8: thrasher71 (56189 in chips) 
vitor762: posts the ante 125
mikilool: posts the ante 125
DaDumon: posts the ante 125
SkemGeeMan: posts the ante 125
JACKPOT786: posts the ante 125
sandarobert1: posts the ante 125
thrasher71: posts the ante 125
sandarobert1: posts small blind 500
thrasher71: posts big blind 1000
*** HOLE CARDS ***
vitor762: raises 1000 to 2000
mikilool: folds 
DaDumon: folds 
SkemGeeMan: raises 20005 to 22005 and is all-in
JACKPOT786: folds 
sandarobert1: folds 
Brauliocsp is disconnected 
thrasher71 has timed out
thrasher71: folds 
thrasher71 is sitting out
thrasher71 has returned
vitor762: folds 
Uncalled bet (20005) returned to SkemGeeMan
SkemGeeMan collected 6375 from pot
SkemGeeMan: doesn't show hand 
*** SUMMARY ***
Total pot 6375 | Rake 0 
Seat 1: vitor762 folded before Flop
Seat 2: mikilool folded before Flop (didn't bet)
Seat 3: DaDumon folded before Flop (didn't bet)
Seat 5: SkemGeeMan collected (6375)
Seat 6: JACKPOT786 (button) folded before Flop (didn't bet)
Seat 7: sandarobert1 (small blind) folded before Flop
Seat 8: thrasher71 (big blind) folded before Flop

PokerStars Hand #251205319416: Tournament #3767885527, $40+$10+$5 USD Hold'em No Limit - Level X (500/1000) - 2024/06/26 18:47:11 UTC [2024/06/26 14:47:11 ET]
Table '3767885527 59' 8-max Seat #7 is the button
Seat 1: vitor762 (10098 in chips) 
Seat 2: mikilool (25120 in chips) 
Seat 3: DaDumon (43889 in chips) 
Seat 4: Brauliocsp (25000 in chips) 
Seat 5: SkemGeeMan (26380 in chips) 
Seat 6: JACKPOT786 (24546 in chips) 
Seat 7: sandarobert1 (101013 in chips) 
Seat 8: thrasher71 (55064 in chips) 
vitor762: posts the ante 125
mikilool: posts the ante 125
DaDumon: posts the ante 125
Brauliocsp: posts the ante 125
SkemGeeMan: posts the ante 125
JACKPOT786: posts the ante 125
sandarobert1: posts the ante 125
thrasher71: posts the ante 125
thrasher71: posts small blind 500
vitor762: posts big blind 1000
*** HOLE CARDS ***
mikilool: raises 1000 to 2000
DaDumon: folds 
Brauliocsp: folds 
SkemGeeMan: folds 
JACKPOT786: folds 
sandarobert1: folds 
thrasher71 has timed out
thrasher71: folds 
thrasher71 is sitting out
thrasher71 has returned
vitor762: raises 7973 to 9973 and is all-in
mikilool: calls 7973
*** FLOP *** [9h 3c Js]
*** TURN *** [9h 3c Js] [6s]
*** RIVER *** [9h 3c Js 6s] [Td]
*** SHOW DOWN ***
vitor762: shows [9c 9d] (three of a kind, Nines)
mikilool: shows [As Qs] (high card Ace)
vitor762 collected 21446 from pot
*** SUMMARY ***
Total pot 21446 | Rake 0 
Board [9h 3c Js 6s Td]
Seat 1: vitor762 (big blind) showed [9c 9d] and won (21446) with three of a kind, Nines
Seat 2: mikilool showed [As Qs] and lost with high card Ace
Seat 3: DaDumon folded before Flop (didn't bet)
Seat 4: Brauliocsp folded before Flop (didn't bet)
Seat 5: SkemGeeMan folded before Flop (didn't bet)
Seat 6: JACKPOT786 folded before Flop (didn't bet)
Seat 7: sandarobert1 (button) folded before Flop (didn't bet)
Seat 8: thrasher71 (small blind) folded before Flop

PokerStars Hand #251205332711: Tournament #3767885527, $40+$10+$5 USD Hold'em No Limit - Level X (500/1000) - 2024/06/26 18:48:02 UTC [2024/06/26 14:48:02 ET]
Table '3767885527 59' 8-max Seat #8 is the button
Seat 1: vitor762 (21446 in chips) 
Seat 2: mikilool (15022 in chips) 
Seat 3: DaDumon (43764 in chips) 
Seat 4: Brauliocsp (24875 in chips) 
Seat 5: SkemGeeMan (26255 in chips) 
Seat 6: JACKPOT786 (24421 in chips) 
Seat 7: sandarobert1 (100888 in chips) 
Seat 8: thrasher71 (54439 in chips) 
vitor762: posts the ante 125
mikilool: posts the ante 125
DaDumon: posts the ante 125
Brauliocsp: posts the ante 125
SkemGeeMan: posts the ante 125
JACKPOT786: posts the ante 125
sandarobert1: posts the ante 125
thrasher71: posts the ante 125
vitor762: posts small blind 500
mikilool: posts big blind 1000
*** HOLE CARDS ***
DaDumon: raises 1000 to 2000
Brauliocsp: folds 
SkemGeeMan: folds 
JACKPOT786: folds 
sandarobert1: folds 
thrasher71: folds 
vitor762: folds 
mikilool: folds 
Uncalled bet (1000) returned to DaDumon
DaDumon collected 3500 from pot
DaDumon: doesn't show hand 
*** SUMMARY ***
Total pot 3500 | Rake 0 
Seat 1: vitor762 (small blind) folded before Flop
Seat 2: mikilool (big blind) folded before Flop
Seat 3: DaDumon collected (3500)
Seat 4: Brauliocsp folded before Flop (didn't bet)
Seat 5: SkemGeeMan folded before Flop (didn't bet)
Seat 6: JACKPOT786 folded before Flop (didn't bet)
Seat 7: sandarobert1 folded before Flop (didn't bet)
Seat 8: thrasher71 (button) folded before Flop (didn't bet)

PokerStars Hand #251205344455: Tournament #3767885527, $40+$10+$5 USD Hold'em No Limit - Level X (500/1000) - 2024/06/26 18:48:46 UTC [2024/06/26 14:48:46 ET]
Table '3767885527 59' 8-max Seat #1 is the button
Seat 1: vitor762 (20821 in chips) 
Seat 2: mikilool (13897 in chips) 
Seat 3: DaDumon (46139 in chips) 
Seat 4: Brauliocsp (24750 in chips) 
Seat 5: SkemGeeMan (26130 in chips) 
Seat 6: JACKPOT786 (24296 in chips) 
Seat 7: sandarobert1 (100763 in chips) 
Seat 8: thrasher71 (54314 in chips) 
vitor762: posts the ante 125
mikilool: posts the ante 125
DaDumon: posts the ante 125
Brauliocsp: posts the ante 125
SkemGeeMan: posts the ante 125
JACKPOT786: posts the ante 125
sandarobert1: posts the ante 125
thrasher71: posts the ante 125
mikilool: posts small blind 500
DaDumon: posts big blind 1000
*** HOLE CARDS ***
Brauliocsp: folds 
SkemGeeMan has timed out
SkemGeeMan: folds 
SkemGeeMan is sitting out
JACKPOT786: folds 
sandarobert1: folds 
SkemGeeMan has returned
thrasher71 has timed out
thrasher71: folds 
thrasher71 is sitting out
thrasher71 has returned
vitor762: folds 
mikilool: folds 
Uncalled bet (500) returned to DaDumon
DaDumon collected 2000 from pot
DaDumon: doesn't show hand 
*** SUMMARY ***
Total pot 2000 | Rake 0 
Seat 1: vitor762 (button) folded before Flop (didn't bet)
Seat 2: mikilool (small blind) folded before Flop
Seat 3: DaDumon (big blind) collected (2000)
Seat 4: Brauliocsp folded before Flop (didn't bet)
Seat 5: SkemGeeMan folded before Flop (didn't bet)
Seat 6: JACKPOT786 folded before Flop (didn't bet)
Seat 7: sandarobert1 folded before Flop (didn't bet)
Seat 8: thrasher71 folded before Flop (didn't bet)

PokerStars Hand #251205363134: Tournament #3767885527, $40+$10+$5 USD Hold'em No Limit - Level X (500/1000) - 2024/06/26 18:49:58 UTC [2024/06/26 14:49:58 ET]
Table '3767885527 59' 8-max Seat #2 is the button
Seat 1: vitor762 (20696 in chips) 
Seat 2: mikilool (13272 in chips) 
Seat 3: DaDumon (47514 in chips) 
Seat 4: Brauliocsp (24625 in chips) 
Seat 5: SkemGeeMan (26005 in chips) 
Seat 6: JACKPOT786 (24171 in chips) 
Seat 7: sandarobert1 (100638 in chips) 
Seat 8: thrasher71 (54189 in chips) 
vitor762: posts the ante 125
mikilool: posts the ante 125
DaDumon: posts the ante 125
Brauliocsp: posts the ante 125
SkemGeeMan: posts the ante 125
JACKPOT786: posts the ante 125
sandarobert1: posts the ante 125
thrasher71: posts the ante 125
DaDumon: posts small blind 500
Brauliocsp: posts big blind 1000
*** HOLE CARDS ***
SkemGeeMan: folds 
JACKPOT786: folds 
sandarobert1: raises 1000 to 2000
thrasher71: folds 
vitor762: folds 
mikilool: folds 
DaDumon: folds 
Brauliocsp: calls 1000
*** FLOP *** [3s Qc 9h]
Brauliocsp: checks 
sandarobert1: bets 1925
Brauliocsp: folds 
Uncalled bet (1925) returned to sandarobert1
sandarobert1 collected 5500 from pot
*** SUMMARY ***
Total pot 5500 | Rake 0 
Board [3s Qc 9h]
Seat 1: vitor762 folded before Flop (didn't bet)
Seat 2: mikilool (button) folded before Flop (didn't bet)
Seat 3: DaDumon (small blind) folded before Flop
Seat 4: Brauliocsp (big blind) folded on the Flop
Seat 5: SkemGeeMan folded before Flop (didn't bet)
Seat 6: JACKPOT786 folded before Flop (didn't bet)
Seat 7: sandarobert1 collected (5500)
Seat 8: thrasher71 folded before Flop (didn't bet)

PokerStars Hand #251205378621: Tournament #3767885527, $40+$10+$5 USD Hold'em No Limit - Level X (500/1000) - 2024/06/26 18:50:57 UTC [2024/06/26 14:50:57 ET]
Table '3767885527 59' 8-max Seat #3 is the button
Seat 1: vitor762 (20571 in chips) 
Seat 2: mikilool (13147 in chips) 
Seat 3: DaDumon (46889 in chips) 
Seat 4: Brauliocsp (22500 in chips) 
Seat 5: SkemGeeMan (25880 in chips) 
Seat 6: JACKPOT786 (24046 in chips) 
Seat 7: sandarobert1 (104013 in chips) 
Seat 8: thrasher71 (54064 in chips) 
vitor762: posts the ante 125
mikilool: posts the ante 125
DaDumon: posts the ante 125
Brauliocsp: posts the ante 125
SkemGeeMan: posts the ante 125
JACKPOT786: posts the ante 125
sandarobert1: posts the ante 125
thrasher71: posts the ante 125
Brauliocsp: posts small blind 500
SkemGeeMan: posts big blind 1000
*** HOLE CARDS ***
JACKPOT786: folds 
sandarobert1: folds 
thrasher71: raises 1000 to 2000
vitor762: folds 
mikilool: folds 
DaDumon: folds 
Brauliocsp: folds 
SkemGeeMan: folds 
Uncalled bet (1000) returned to thrasher71
thrasher71 collected 3500 from pot
thrasher71: doesn't show hand 
*** SUMMARY ***
Total pot 3500 | Rake 0 
Seat 1: vitor762 folded before Flop (didn't bet)
Seat 2: mikilool folded before Flop (didn't bet)
Seat 3: DaDumon (button) folded before Flop (didn't bet)
Seat 4: Brauliocsp (small blind) folded before Flop
Seat 5: SkemGeeMan (big blind) folded before Flop
Seat 6: JACKPOT786 folded before Flop (didn't bet)
Seat 7: sandarobert1 folded before Flop (didn't bet)
Seat 8: thrasher71 collected (3500)

PokerStars Hand #251205387982: Tournament #3767885527, $40+$10+$5 USD Hold'em No Limit - Level X (500/1000) - 2024/06/26 18:51:33 UTC [2024/06/26 14:51:33 ET]
Table '3767885527 59' 8-max Seat #4 is the button
Seat 1: vitor762 (20446 in chips) 
Seat 2: mikilool (13022 in chips) 
Seat 3: DaDumon (46764 in chips) 
Seat 4: Brauliocsp (21875 in chips) 
Seat 5: SkemGeeMan (24755 in chips) 
Seat 6: JACKPOT786 (23921 in chips) 
Seat 7: sandarobert1 (103888 in chips) 
Seat 8: thrasher71 (56439 in chips) 
vitor762: posts the ante 125
mikilool: posts the ante 125
DaDumon: posts the ante 125
Brauliocsp: posts the ante 125
SkemGeeMan: posts the ante 125
JACKPOT786: posts the ante 125
sandarobert1: posts the ante 125
thrasher71: posts the ante 125
SkemGeeMan: posts small blind 500
JACKPOT786: posts big blind 1000
*** HOLE CARDS ***
sandarobert1: raises 1000 to 2000
thrasher71: folds 
vitor762: folds 
mikilool: folds 
DaDumon: calls 2000
Brauliocsp: raises 19750 to 21750 and is all-in
SkemGeeMan: folds 
JACKPOT786: folds 
sandarobert1: folds 
DaDumon: calls 19750
*** FLOP *** [Qh 2s 2h]
*** TURN *** [Qh 2s 2h] [As]
*** RIVER *** [Qh 2s 2h As] [Ts]
*** SHOW DOWN ***
DaDumon: shows [3s 3d] (two pair, Threes and Deuces)
Brauliocsp: shows [Jd Js] (two pair, Jacks and Deuces)
Brauliocsp collected 48000 from pot
*** SUMMARY ***
Total pot 48000 | Rake 0 
Board [Qh 2s 2h As Ts]
Seat 1: vitor762 folded before Flop (didn't bet)
Seat 2: mikilool folded before Flop (didn't bet)
Seat 3: DaDumon showed [3s 3d] and lost with two pair, Threes and Deuces
Seat 4: Brauliocsp (button) showed [Jd Js] and won (48000) with two pair, Jacks and Deuces
Seat 5: SkemGeeMan (small blind) folded before Flop
Seat 6: JACKPOT786 (big blind) folded before Flop
Seat 7: sandarobert1 folded before Flop
Seat 8: thrasher71 folded before Flop (didn't bet)

PokerStars Hand #251205408563: Tournament #3767885527, $40+$10+$5 USD Hold'em No Limit - Level XI (600/1200) - 2024/06/26 18:52:51 UTC [2024/06/26 14:52:51 ET]
Table '3767885527 59' 8-max Seat #5 is the button
Seat 1: vitor762 (20321 in chips) 
Seat 2: mikilool (12897 in chips) 
Seat 3: DaDumon (24889 in chips) 
Seat 4: Brauliocsp (48000 in chips) 
Seat 5: SkemGeeMan (24130 in chips) 
Seat 6: JACKPOT786 (22796 in chips) 
Seat 7: sandarobert1 (101763 in chips) 
Seat 8: thrasher71 (56314 in chips) 
vitor762: posts the ante 150
mikilool: posts the ante 150
DaDumon: posts the ante 150
Brauliocsp: posts the ante 150
SkemGeeMan: posts the ante 150
JACKPOT786: posts the ante 150
sandarobert1: posts the ante 150
thrasher71: posts the ante 150
JACKPOT786: posts small blind 600
sandarobert1: posts big blind 1200
*** HOLE CARDS ***
thrasher71 has timed out
thrasher71: folds 
thrasher71 is sitting out
thrasher71 has returned
vitor762: folds 
mikilool: raises 11547 to 12747 and is all-in
DaDumon: folds 
Brauliocsp: folds 
SkemGeeMan: folds 
JACKPOT786: raises 9899 to 22646 and is all-in
sandarobert1: folds 
Uncalled bet (9899) returned to JACKPOT786
*** FLOP *** [2s 5h 4h]
*** TURN *** [2s 5h 4h] [6s]
*** RIVER *** [2s 5h 4h 6s] [Qd]
*** SHOW DOWN ***
JACKPOT786: shows [Ks Ad] (high card Ace)
mikilool: shows [Td As] (high card Ace - lower kicker)
JACKPOT786 collected 27894 from pot
mikilool finished the tournament
*** SUMMARY ***
Total pot 27894 | Rake 0 
Board [2s 5h 4h 6s Qd]
Seat 1: vitor762 folded before Flop (didn't bet)
Seat 2: mikilool showed [Td As] and lost with high card Ace
Seat 3: DaDumon folded before Flop (didn't bet)
Seat 4: Brauliocsp folded before Flop (didn't bet)
Seat 5: SkemGeeMan (button) folded before Flop (didn't bet)
Seat 6: JACKPOT786 (small blind) showed [Ks Ad] and won (27894) with high card Ace
Seat 7: sandarobert1 (big blind) folded before Flop
Seat 8: thrasher71 folded before Flop (didn't bet)


PokerStars Hand #251205536182: Tournament #3767885527, $40+$10+$5 USD Hold'em No Limit - Level XI (600/1200) - 2024/06/26 19:02:37 UTC [2024/06/26 15:02:37 ET]
Table '3767885527 58' 8-max Seat #1 is the button
Seat 1: krumbumbuli (17400 in chips) 
Seat 2: Philipoune (50891 in chips) 
Seat 3: Defence_BOMB (32394 in chips) 
Seat 4: alushi6 (24400 in chips) 
Seat 6: conradofpg (42390 in chips) 
Seat 7: jammy1875 (71068 in chips) 
Seat 8: DRY BLECKBERRY (54168 in chips) 
krumbumbuli: posts the ante 150
Philipoune: posts the ante 150
Defence_BOMB: posts the ante 150
alushi6: posts the ante 150
conradofpg: posts the ante 150
jammy1875: posts the ante 150
DRY BLECKBERRY: posts the ante 150
Philipoune: posts small blind 600
Defence_BOMB: posts big blind 1200
*** HOLE CARDS ***
alushi6: folds 
conradofpg: folds 
jammy1875: raises 1200 to 2400
DRY BLECKBERRY: raises 4800 to 7200
krumbumbuli: folds 
Philipoune: folds 
Defence_BOMB: folds 
MTTSharkSnG is disconnected 
jammy1875: calls 4800
*** FLOP *** [Kh 2d 8h]
jammy1875: checks 
DRY BLECKBERRY: bets 4800
jammy1875: calls 4800
*** TURN *** [Kh 2d 8h] [4s]
jammy1875: checks 
DRY BLECKBERRY: checks 
*** RIVER *** [Kh 2d 8h 4s] [3h]
jammy1875: bets 15825
DRY BLECKBERRY: folds 
Uncalled bet (15825) returned to jammy1875
jammy1875 collected 26850 from pot
*** SUMMARY ***
Total pot 26850 | Rake 0 
Board [Kh 2d 8h 4s 3h]
Seat 1: krumbumbuli (button) folded before Flop (didn't bet)
Seat 2: Philipoune (small blind) folded before Flop
Seat 3: Defence_BOMB (big blind) folded before Flop
Seat 4: alushi6 folded before Flop (didn't bet)
Seat 6: conradofpg folded before Flop (didn't bet)
Seat 7: jammy1875 collected (26850)
Seat 8: DRY BLECKBERRY folded on the River

PokerStars Hand #251205553975: Tournament #3767885527, $40+$10+$5 USD Hold'em No Limit - Level XI (600/1200) - 2024/06/26 19:03:48 UTC [2024/06/26 15:03:48 ET]
Table '3767885527 58' 8-max Seat #2 is the button
Seat 1: krumbumbuli (17250 in chips) 
Seat 2: Philipoune (50141 in chips) 
Seat 3: Defence_BOMB (31044 in chips) 
Seat 4: alushi6 (24250 in chips) 
Seat 5: MTTSharkSnG (25000 in chips) 
Seat 6: conradofpg (42240 in chips) 
Seat 7: jammy1875 (85768 in chips) 
Seat 8: DRY BLECKBERRY (42018 in chips) 
krumbumbuli: posts the ante 150
Philipoune: posts the ante 150
Defence_BOMB: posts the ante 150
alushi6: posts the ante 150
MTTSharkSnG: posts the ante 150
conradofpg: posts the ante 150
jammy1875: posts the ante 150
DRY BLECKBERRY: posts the ante 150
Defence_BOMB: posts small blind 600
alushi6: posts big blind 1200
*** HOLE CARDS ***
MTTSharkSnG: folds 
conradofpg: folds 
jammy1875: folds 
DRY BLECKBERRY: raises 1200 to 2400
krumbumbuli: folds 
Philipoune: folds 
Defence_BOMB: raises 28494 to 30894 and is all-in
alushi6: folds 
DRY BLECKBERRY: folds 
Uncalled bet (28494) returned to Defence_BOMB
Defence_BOMB collected 7200 from pot
Defence_BOMB: doesn't show hand 
*** SUMMARY ***
Total pot 7200 | Rake 0 
Seat 1: krumbumbuli folded before Flop (didn't bet)
Seat 2: Philipoune (button) folded before Flop (didn't bet)
Seat 3: Defence_BOMB (small blind) collected (7200)
Seat 4: alushi6 (big blind) folded before Flop
Seat 5: MTTSharkSnG folded before Flop (didn't bet)
Seat 6: conradofpg folded before Flop (didn't bet)
Seat 7: jammy1875 folded before Flop (didn't bet)
Seat 8: DRY BLECKBERRY folded before Flop

PokerStars Hand #251205561952: Tournament #3767885527, $40+$10+$5 USD Hold'em No Limit - Level XI (600/1200) - 2024/06/26 19:04:19 UTC [2024/06/26 15:04:19 ET]
Table '3767885527 58' 8-max Seat #3 is the button
Seat 1: krumbumbuli (17100 in chips) 
Seat 2: Philipoune (49991 in chips) 
Seat 3: Defence_BOMB (35694 in chips) 
Seat 4: alushi6 (22900 in chips) 
Seat 5: MTTSharkSnG (24850 in chips) 
Seat 6: conradofpg (42090 in chips) 
Seat 7: jammy1875 (85618 in chips) 
Seat 8: DRY BLECKBERRY (39468 in chips) 
krumbumbuli: posts the ante 150
Philipoune: posts the ante 150
Defence_BOMB: posts the ante 150
alushi6: posts the ante 150
MTTSharkSnG: posts the ante 150
conradofpg: posts the ante 150
jammy1875: posts the ante 150
DRY BLECKBERRY: posts the ante 150
alushi6: posts small blind 600
MTTSharkSnG: posts big blind 1200
*** HOLE CARDS ***
conradofpg: folds 
jammy1875: folds 
DRY BLECKBERRY: folds 
krumbumbuli: folds 
Philipoune: folds 
Defence_BOMB: folds 
alushi6: calls 600
MTTSharkSnG: raises 23500 to 24700 and is all-in
alushi6: folds 
Uncalled bet (23500) returned to MTTSharkSnG
MTTSharkSnG collected 3600 from pot
MTTSharkSnG: doesn't show hand 
*** SUMMARY ***
Total pot 3600 | Rake 0 
Seat 1: krumbumbuli folded before Flop (didn't bet)
Seat 2: Philipoune folded before Flop (didn't bet)
Seat 3: Defence_BOMB (button) folded before Flop (didn't bet)
Seat 4: alushi6 (small blind) folded before Flop
Seat 5: MTTSharkSnG (big blind) collected (3600)
Seat 6: conradofpg folded before Flop (didn't bet)
Seat 7: jammy1875 folded before Flop (didn't bet)
Seat 8: DRY BLECKBERRY folded before Flop (didn't bet)

PokerStars Hand #251205570283: Tournament #3767885527, $40+$10+$5 USD Hold'em No Limit - Level XI (600/1200) - 2024/06/26 19:04:52 UTC [2024/06/26 15:04:52 ET]
Table '3767885527 58' 8-max Seat #4 is the button
Seat 1: krumbumbuli (16950 in chips) 
Seat 2: Philipoune (49841 in chips) 
Seat 3: Defence_BOMB (35544 in chips) 
Seat 4: alushi6 (21550 in chips) 
Seat 5: MTTSharkSnG (27100 in chips) 
Seat 6: conradofpg (41940 in chips) 
Seat 7: jammy1875 (85468 in chips) 
Seat 8: DRY BLECKBERRY (39318 in chips) 
krumbumbuli: posts the ante 150
Philipoune: posts the ante 150
Defence_BOMB: posts the ante 150
alushi6: posts the ante 150
MTTSharkSnG: posts the ante 150
conradofpg: posts the ante 150
jammy1875: posts the ante 150
DRY BLECKBERRY: posts the ante 150
MTTSharkSnG: posts small blind 600
conradofpg: posts big blind 1200
*** HOLE CARDS ***
jammy1875: folds 
DRY BLECKBERRY: raises 1200 to 2400
krumbumbuli: folds 
Philipoune: folds 
Defence_BOMB: folds 
alushi6: folds 
MTTSharkSnG: raises 6000 to 8400
conradofpg has timed out
conradofpg: folds 
conradofpg is sitting out
DRY BLECKBERRY: folds 
Uncalled bet (6000) returned to MTTSharkSnG
conradofpg has returned
MTTSharkSnG collected 7200 from pot
MTTSharkSnG: doesn't show hand 
*** SUMMARY ***
Total pot 7200 | Rake 0 
Seat 1: krumbumbuli folded before Flop (didn't bet)
Seat 2: Philipoune folded before Flop (didn't bet)
Seat 3: Defence_BOMB folded before Flop (didn't bet)
Seat 4: alushi6 (button) folded before Flop (didn't bet)
Seat 5: MTTSharkSnG (small blind) collected (7200)
Seat 6: conradofpg (big blind) folded before Flop
Seat 7: jammy1875 folded before Flop (didn't bet)
Seat 8: DRY BLECKBERRY folded before Flop

PokerStars Hand #251205581428: Tournament #3767885527, $40+$10+$5 USD Hold'em No Limit - Level XI (600/1200) - 2024/06/26 19:05:34 UTC [2024/06/26 15:05:34 ET]
Table '3767885527 58' 8-max Seat #5 is the button
Seat 1: krumbumbuli (16800 in chips) 
Seat 2: Philipoune (49691 in chips) 
Seat 3: Defence_BOMB (35394 in chips) 
Seat 4: alushi6 (21400 in chips) 
Seat 5: MTTSharkSnG (31750 in chips) 
Seat 6: conradofpg (40590 in chips) 
Seat 7: jammy1875 (85318 in chips) 
Seat 8: DRY BLECKBERRY (36768 in chips) 
krumbumbuli: posts the ante 150
Philipoune: posts the ante 150
Defence_BOMB: posts the ante 150
alushi6: posts the ante 150
MTTSharkSnG: posts the ante 150
conradofpg: posts the ante 150
jammy1875: posts the ante 150
DRY BLECKBERRY: posts the ante 150
conradofpg: posts small blind 600
jammy1875: posts big blind 1200
*** HOLE CARDS ***
DRY BLECKBERRY: folds 
krumbumbuli: folds 
Philipoune: folds 
Defence_BOMB: folds 
alushi6: folds 
MTTSharkSnG: folds 
conradofpg: folds 
Uncalled bet (600) returned to jammy1875
jammy1875 collected 2400 from pot
*** SUMMARY ***
Total pot 2400 | Rake 0 
Seat 1: krumbumbuli folded before Flop (didn't bet)
Seat 2: Philipoune folded before Flop (didn't bet)
Seat 3: Defence_BOMB folded before Flop (didn't bet)
Seat 4: alushi6 folded before Flop (didn't bet)
Seat 5: MTTSharkSnG (button) folded before Flop (didn't bet)
Seat 6: conradofpg (small blind) folded before Flop
Seat 7: jammy1875 (big blind) collected (2400)
Seat 8: DRY BLECKBERRY folded before Flop (didn't bet)

PokerStars Hand #251205586748: Tournament #3767885527, $40+$10+$5 USD Hold'em No Limit - Level XI (600/1200) - 2024/06/26 19:05:54 UTC [2024/06/26 15:05:54 ET]
Table '3767885527 58' 8-max Seat #6 is the button
Seat 1: krumbumbuli (16650 in chips) 
Seat 2: Philipoune (49541 in chips) 
Seat 3: Defence_BOMB (35244 in chips) 
Seat 4: alushi6 (21250 in chips) 
Seat 5: MTTSharkSnG (31600 in chips) 
Seat 6: conradofpg (39840 in chips) 
Seat 7: jammy1875 (86968 in chips) 
Seat 8: DRY BLECKBERRY (36618 in chips) 
krumbumbuli: posts the ante 150
Philipoune: posts the ante 150
Defence_BOMB: posts the ante 150
alushi6: posts the ante 150
MTTSharkSnG: posts the ante 150
conradofpg: posts the ante 150
jammy1875: posts the ante 150
DRY BLECKBERRY: posts the ante 150
jammy1875: posts small blind 600
DRY BLECKBERRY: posts big blind 1200
*** HOLE CARDS ***
krumbumbuli: raises 15300 to 16500 and is all-in
Philipoune: folds 
Defence_BOMB: folds 
alushi6: folds 
MTTSharkSnG: folds 
conradofpg: folds 
jammy1875 has timed out
jammy1875: folds 
jammy1875 is sitting out
DRY BLECKBERRY: folds 
Uncalled bet (15300) returned to krumbumbuli
krumbumbuli collected 4200 from pot
krumbumbuli: doesn't show hand 
*** SUMMARY ***
Total pot 4200 | Rake 0 
Seat 1: krumbumbuli collected (4200)
Seat 2: Philipoune folded before Flop (didn't bet)
Seat 3: Defence_BOMB folded before Flop (didn't bet)
Seat 4: alushi6 folded before Flop (didn't bet)
Seat 5: MTTSharkSnG folded before Flop (didn't bet)
Seat 6: conradofpg (button) folded before Flop (didn't bet)
Seat 7: jammy1875 (small blind) folded before Flop
Seat 8: DRY BLECKBERRY (big blind) folded before Flop

PokerStars Hand #251205599329: Tournament #3767885527, $40+$10+$5 USD Hold'em No Limit - Level XI (600/1200) - 2024/06/26 19:06:41 UTC [2024/06/26 15:06:41 ET]
Table '3767885527 58' 8-max Seat #7 is the button
Seat 1: krumbumbuli (19500 in chips) 
Seat 2: Philipoune (49391 in chips) 
Seat 3: Defence_BOMB (35094 in chips) 
Seat 4: alushi6 (21100 in chips) 
Seat 5: MTTSharkSnG (31450 in chips) 
Seat 6: conradofpg (39690 in chips) 
Seat 7: jammy1875 (86218 in chips) is sitting out
Seat 8: DRY BLECKBERRY (35268 in chips) 
krumbumbuli: posts the ante 150
Philipoune: posts the ante 150
Defence_BOMB: posts the ante 150
alushi6: posts the ante 150
MTTSharkSnG: posts the ante 150
conradofpg: posts the ante 150
jammy1875: posts the ante 150
DRY BLECKBERRY: posts the ante 150
DRY BLECKBERRY: posts small blind 600
krumbumbuli: posts big blind 1200
*** HOLE CARDS ***
Philipoune: folds 
jammy1875 has returned
Defence_BOMB: folds 
alushi6: raises 1200 to 2400
MTTSharkSnG: folds 
conradofpg: folds 
jammy1875: calls 2400
DRY BLECKBERRY: folds 
krumbumbuli: calls 1200
*** FLOP *** [6d Qd As]
krumbumbuli: checks 
alushi6: checks 
jammy1875: bets 3600
krumbumbuli: calls 3600
alushi6: folds 
*** TURN *** [6d Qd As] [6s]
krumbumbuli: checks 
jammy1875: bets 16200
krumbumbuli: folds 
Uncalled bet (16200) returned to jammy1875
jammy1875 collected 16200 from pot
*** SUMMARY ***
Total pot 16200 | Rake 0 
Board [6d Qd As 6s]
Seat 1: krumbumbuli (big blind) folded on the Turn
Seat 2: Philipoune folded before Flop (didn't bet)
Seat 3: Defence_BOMB folded before Flop (didn't bet)
Seat 4: alushi6 folded on the Flop
Seat 5: MTTSharkSnG folded before Flop (didn't bet)
Seat 6: conradofpg folded before Flop (didn't bet)
Seat 7: jammy1875 (button) collected (16200)
Seat 8: DRY BLECKBERRY (small blind) folded before Flop

PokerStars Hand #251205616568: Tournament #3767885527, $40+$10+$5 USD Hold'em No Limit - Level XI (600/1200) - 2024/06/26 19:07:46 UTC [2024/06/26 15:07:46 ET]
Table '3767885527 58' 8-max Seat #8 is the button
Seat 1: krumbumbuli (13350 in chips) 
Seat 2: Philipoune (49241 in chips) 
Seat 3: Defence_BOMB (34944 in chips) 
Seat 4: alushi6 (18550 in chips) 
Seat 5: MTTSharkSnG (31300 in chips) 
Seat 6: conradofpg (39540 in chips) 
Seat 7: jammy1875 (96268 in chips) 
Seat 8: DRY BLECKBERRY (34518 in chips) 
krumbumbuli: posts the ante 150
Philipoune: posts the ante 150
Defence_BOMB: posts the ante 150
alushi6: posts the ante 150
MTTSharkSnG: posts the ante 150
conradofpg: posts the ante 150
jammy1875: posts the ante 150
DRY BLECKBERRY: posts the ante 150
krumbumbuli: posts small blind 600
Philipoune: posts big blind 1200
*** HOLE CARDS ***
Defence_BOMB: folds 
alushi6: folds 
MTTSharkSnG: folds 
conradofpg: raises 1200 to 2400
jammy1875: calls 2400
DRY BLECKBERRY: folds 
krumbumbuli: calls 1800
Philipoune: raises 46691 to 49091 and is all-in
conradofpg: folds 
jammy1875: folds 
krumbumbuli: calls 10800 and is all-in
Uncalled bet (35891) returned to Philipoune
*** FLOP *** [Qs 2c Kh]
*** TURN *** [Qs 2c Kh] [As]
*** RIVER *** [Qs 2c Kh As] [2d]
*** SHOW DOWN ***
krumbumbuli: shows [6d 9d] (a pair of Deuces)
Philipoune: shows [Jd Kc] (two pair, Kings and Deuces)
Philipoune collected 32400 from pot
krumbumbuli finished the tournament
*** SUMMARY ***
Total pot 32400 | Rake 0 
Board [Qs 2c Kh As 2d]
Seat 1: krumbumbuli (small blind) showed [6d 9d] and lost with a pair of Deuces
Seat 2: Philipoune (big blind) showed [Jd Kc] and won (32400) with two pair, Kings and Deuces
Seat 3: Defence_BOMB folded before Flop (didn't bet)
Seat 4: alushi6 folded before Flop (didn't bet)
Seat 5: MTTSharkSnG folded before Flop (didn't bet)
Seat 6: conradofpg folded before Flop
Seat 7: jammy1875 folded before Flop
Seat 8: DRY BLECKBERRY (button) folded before Flop (didn't bet)

PokerStars Hand #251205630096: Tournament #3767885527, $40+$10+$5 USD Hold'em No Limit - Level XI (600/1200) - 2024/06/26 19:08:37 UTC [2024/06/26 15:08:37 ET]
Table '3767885527 58' 8-max Seat #2 is the button
Seat 2: Philipoune (68291 in chips) 
Seat 3: Defence_BOMB (34794 in chips) 
Seat 4: alushi6 (18400 in chips) 
Seat 5: MTTSharkSnG (31150 in chips) 
Seat 6: conradofpg (36990 in chips) 
Seat 7: jammy1875 (93718 in chips) 
Seat 8: DRY BLECKBERRY (34368 in chips) 
Philipoune: posts the ante 150
Defence_BOMB: posts the ante 150
alushi6: posts the ante 150
MTTSharkSnG: posts the ante 150
conradofpg: posts the ante 150
jammy1875: posts the ante 150
DRY BLECKBERRY: posts the ante 150
Defence_BOMB: posts small blind 600
alushi6: posts big blind 1200
*** HOLE CARDS ***
MTTSharkSnG: folds 
conradofpg: folds 
jammy1875: raises 1200 to 2400
DRY BLECKBERRY: folds 
Philipoune: folds 
Defence_BOMB: folds 
leitalopez is disconnected 
alushi6: calls 1200
*** FLOP *** [8h 7c Kc]
alushi6: checks 
jammy1875: bets 3600
alushi6: calls 3600
*** TURN *** [8h 7c Kc] [Qs]
alushi6: checks 
jammy1875: bets 4800
alushi6: folds 
Uncalled bet (4800) returned to jammy1875
jammy1875 collected 13650 from pot
*** SUMMARY ***
Total pot 13650 | Rake 0 
Board [8h 7c Kc Qs]
Seat 2: Philipoune (button) folded before Flop (didn't bet)
Seat 3: Defence_BOMB (small blind) folded before Flop
Seat 4: alushi6 (big blind) folded on the Turn
Seat 5: MTTSharkSnG folded before Flop (didn't bet)
Seat 6: conradofpg folded before Flop (didn't bet)
Seat 7: jammy1875 collected (13650)
Seat 8: DRY BLECKBERRY folded before Flop (didn't bet)

PokerStars Hand #251205652099: Tournament #3767885527, $40+$10+$5 USD Hold'em No Limit - Level XII (700/1400) - 2024/06/26 19:09:59 UTC [2024/06/26 15:09:59 ET]
Table '3767885527 58' 8-max Seat #3 is the button
Seat 1: leitalopez (25000 in chips) 
Seat 2: Philipoune (68141 in chips) 
Seat 3: Defence_BOMB (34044 in chips) 
Seat 4: alushi6 (12250 in chips) 
Seat 5: MTTSharkSnG (31000 in chips) 
Seat 6: conradofpg (36840 in chips) 
Seat 7: jammy1875 (101218 in chips) 
Seat 8: DRY BLECKBERRY (34218 in chips) 
leitalopez: posts the ante 175
Philipoune: posts the ante 175
Defence_BOMB: posts the ante 175
alushi6: posts the ante 175
MTTSharkSnG: posts the ante 175
conradofpg: posts the ante 175
jammy1875: posts the ante 175
DRY BLECKBERRY: posts the ante 175
alushi6: posts small blind 700
MTTSharkSnG: posts big blind 1400
*** HOLE CARDS ***
conradofpg: folds 
jammy1875: raises 1400 to 2800
DRY BLECKBERRY: folds 
leitalopez: folds 
Philipoune: folds 
Defence_BOMB: folds 
alushi6: raises 9275 to 12075 and is all-in
MTTSharkSnG: folds 
jammy1875: calls 9275
*** FLOP *** [Ac Th Qh]
*** TURN *** [Ac Th Qh] [5d]
*** RIVER *** [Ac Th Qh 5d] [Ad]
*** SHOW DOWN ***
alushi6: shows [Kh Ah] (three of a kind, Aces)
jammy1875: shows [As 4h] (three of a kind, Aces - lower kicker)
alushi6 collected 26950 from pot
*** SUMMARY ***
Total pot 26950 | Rake 0 
Board [Ac Th Qh 5d Ad]
Seat 1: leitalopez folded before Flop (didn't bet)
Seat 2: Philipoune folded before Flop (didn't bet)
Seat 3: Defence_BOMB (button) folded before Flop (didn't bet)
Seat 4: alushi6 (small blind) showed [Kh Ah] and won (26950) with three of a kind, Aces
Seat 5: MTTSharkSnG (big blind) folded before Flop
Seat 6: conradofpg folded before Flop (didn't bet)
Seat 7: jammy1875 showed [As 4h] and lost with three of a kind, Aces
Seat 8: DRY BLECKBERRY folded before Flop (didn't bet)

PokerStars Hand #251205662045: Tournament #3767885527, $40+$10+$5 USD Hold'em No Limit - Level XII (700/1400) - 2024/06/26 19:10:36 UTC [2024/06/26 15:10:36 ET]
Table '3767885527 58' 8-max Seat #4 is the button
Seat 1: leitalopez (24825 in chips) 
Seat 2: Philipoune (67966 in chips) 
Seat 3: Defence_BOMB (33869 in chips) 
Seat 4: alushi6 (26950 in chips) 
Seat 5: MTTSharkSnG (29425 in chips) 
Seat 6: conradofpg (36665 in chips) 
Seat 7: jammy1875 (88968 in chips) 
Seat 8: DRY BLECKBERRY (34043 in chips) 
leitalopez: posts the ante 175
Philipoune: posts the ante 175
Defence_BOMB: posts the ante 175
alushi6: posts the ante 175
MTTSharkSnG: posts the ante 175
conradofpg: posts the ante 175
jammy1875: posts the ante 175
DRY BLECKBERRY: posts the ante 175
MTTSharkSnG: posts small blind 700
conradofpg: posts big blind 1400
*** HOLE CARDS ***
jammy1875: raises 1400 to 2800
DRY BLECKBERRY: folds 
leitalopez: raises 21850 to 24650 and is all-in
Philipoune: folds 
Defence_BOMB: folds 
alushi6: folds 
MTTSharkSnG: folds 
conradofpg: folds 
jammy1875: folds 
Uncalled bet (21850) returned to leitalopez
leitalopez collected 9100 from pot
leitalopez: doesn't show hand 
*** SUMMARY ***
Total pot 9100 | Rake 0 
Seat 1: leitalopez collected (9100)
Seat 2: Philipoune folded before Flop (didn't bet)
Seat 3: Defence_BOMB folded before Flop (didn't bet)
Seat 4: alushi6 (button) folded before Flop (didn't bet)
Seat 5: MTTSharkSnG (small blind) folded before Flop
Seat 6: conradofpg (big blind) folded before Flop
Seat 7: jammy1875 folded before Flop
Seat 8: DRY BLECKBERRY folded before Flop (didn't bet)

PokerStars Hand #251205672029: Tournament #3767885527, $40+$10+$5 USD Hold'em No Limit - Level XII (700/1400) - 2024/06/26 19:11:13 UTC [2024/06/26 15:11:13 ET]
Table '3767885527 58' 8-max Seat #5 is the button
Seat 1: leitalopez (30950 in chips) 
Seat 2: Philipoune (67791 in chips) 
Seat 3: Defence_BOMB (33694 in chips) 
Seat 4: alushi6 (26775 in chips) 
Seat 5: MTTSharkSnG (28550 in chips) 
Seat 6: conradofpg (35090 in chips) 
Seat 7: jammy1875 (85993 in chips) 
Seat 8: DRY BLECKBERRY (33868 in chips) 
leitalopez: posts the ante 175
Philipoune: posts the ante 175
Defence_BOMB: posts the ante 175
alushi6: posts the ante 175
MTTSharkSnG: posts the ante 175
conradofpg: posts the ante 175
jammy1875: posts the ante 175
DRY BLECKBERRY: posts the ante 175
conradofpg: posts small blind 700
jammy1875: posts big blind 1400
*** HOLE CARDS ***
DRY BLECKBERRY: folds 
leitalopez: folds 
Philipoune: folds 
Defence_BOMB: folds 
alushi6: raises 1400 to 2800
MTTSharkSnG: raises 25575 to 28375 and is all-in
conradofpg: folds 
jammy1875: folds 
alushi6: calls 23800 and is all-in
Uncalled bet (1775) returned to MTTSharkSnG
*** FLOP *** [As Qd 4c]
*** TURN *** [As Qd 4c] [7h]
*** RIVER *** [As Qd 4c 7h] [7s]
*** SHOW DOWN ***
alushi6: shows [Td Ts] (two pair, Tens and Sevens)
MTTSharkSnG: shows [Tc Th] (two pair, Tens and Sevens)
alushi6 collected 28350 from pot
MTTSharkSnG collected 28350 from pot
*** SUMMARY ***
Total pot 56700 | Rake 0 
Board [As Qd 4c 7h 7s]
Seat 1: leitalopez folded before Flop (didn't bet)
Seat 2: Philipoune folded before Flop (didn't bet)
Seat 3: Defence_BOMB folded before Flop (didn't bet)
Seat 4: alushi6 showed [Td Ts] and won (28350) with two pair, Tens and Sevens
Seat 5: MTTSharkSnG (button) showed [Tc Th] and won (28350) with two pair, Tens and Sevens
Seat 6: conradofpg (small blind) folded before Flop
Seat 7: jammy1875 (big blind) folded before Flop
Seat 8: DRY BLECKBERRY folded before Flop (didn't bet)

PokerStars Hand #251205681985: Tournament #3767885527, $40+$10+$5 USD Hold'em No Limit - Level XII (700/1400) - 2024/06/26 19:11:50 UTC [2024/06/26 15:11:50 ET]
Table '3767885527 58' 8-max Seat #6 is the button
Seat 1: leitalopez (30775 in chips) 
Seat 2: Philipoune (67616 in chips) 
Seat 3: Defence_BOMB (33519 in chips) 
Seat 4: alushi6 (28350 in chips) 
Seat 5: MTTSharkSnG (30125 in chips) 
Seat 6: conradofpg (34215 in chips) 
Seat 7: jammy1875 (84418 in chips) 
Seat 8: DRY BLECKBERRY (33693 in chips) 
leitalopez: posts the ante 175
Philipoune: posts the ante 175
Defence_BOMB: posts the ante 175
alushi6: posts the ante 175
MTTSharkSnG: posts the ante 175
conradofpg: posts the ante 175
jammy1875: posts the ante 175
DRY BLECKBERRY: posts the ante 175
jammy1875: posts small blind 700
DRY BLECKBERRY: posts big blind 1400
*** HOLE CARDS ***
leitalopez: raises 1400 to 2800
Philipoune: folds 
Defence_BOMB: folds 
alushi6: folds 
MTTSharkSnG: folds 
conradofpg: folds 
jammy1875: calls 2100
DRY BLECKBERRY: folds 
*** FLOP *** [4d 6s Qh]
jammy1875: checks 
leitalopez: bets 2772
jammy1875: calls 2772
*** TURN *** [4d 6s Qh] [Jc]
jammy1875: checks 
leitalopez: bets 4602
jammy1875: calls 4602
*** RIVER *** [4d 6s Qh Jc] [Kc]
jammy1875: checks 
leitalopez: checks 
*** SHOW DOWN ***
jammy1875: shows [5s 3s] (high card King)
leitalopez: shows [Kd Td] (a pair of Kings)
leitalopez collected 23148 from pot
*** SUMMARY ***
Total pot 23148 | Rake 0 
Board [4d 6s Qh Jc Kc]
Seat 1: leitalopez showed [Kd Td] and won (23148) with a pair of Kings
Seat 2: Philipoune folded before Flop (didn't bet)
Seat 3: Defence_BOMB folded before Flop (didn't bet)
Seat 4: alushi6 folded before Flop (didn't bet)
Seat 5: MTTSharkSnG folded before Flop (didn't bet)
Seat 6: conradofpg (button) folded before Flop (didn't bet)
Seat 7: jammy1875 (small blind) showed [5s 3s] and lost with high card King
Seat 8: DRY BLECKBERRY (big blind) folded before Flop

PokerStars Hand #251205698362: Tournament #3767885527, $40+$10+$5 USD Hold'em No Limit - Level XII (700/1400) - 2024/06/26 19:12:50 UTC [2024/06/26 15:12:50 ET]
Table '3767885527 58' 8-max Seat #7 is the button
Seat 1: leitalopez (43574 in chips) 
Seat 2: Philipoune (67441 in chips) 
Seat 3: Defence_BOMB (33344 in chips) 
Seat 4: alushi6 (28175 in chips) 
Seat 5: MTTSharkSnG (29950 in chips) 
Seat 6: conradofpg (34040 in chips) 
Seat 7: jammy1875 (74069 in chips) 
Seat 8: DRY BLECKBERRY (32118 in chips) 
leitalopez: posts the ante 175
Philipoune: posts the ante 175
Defence_BOMB: posts the ante 175
alushi6: posts the ante 175
MTTSharkSnG: posts the ante 175
conradofpg: posts the ante 175
jammy1875: posts the ante 175
DRY BLECKBERRY: posts the ante 175
DRY BLECKBERRY: posts small blind 700
leitalopez: posts big blind 1400
*** HOLE CARDS ***
Philipoune: folds 
Defence_BOMB: folds 
alushi6: folds 
MTTSharkSnG: raises 28375 to 29775 and is all-in
conradofpg: folds 
jammy1875: folds 
DRY BLECKBERRY: folds 
leitalopez: folds 
Uncalled bet (28375) returned to MTTSharkSnG
MTTSharkSnG collected 4900 from pot
MTTSharkSnG: doesn't show hand 
*** SUMMARY ***
Total pot 4900 | Rake 0 
Seat 1: leitalopez (big blind) folded before Flop
Seat 2: Philipoune folded before Flop (didn't bet)
Seat 3: Defence_BOMB folded before Flop (didn't bet)
Seat 4: alushi6 folded before Flop (didn't bet)
Seat 5: MTTSharkSnG collected (4900)
Seat 6: conradofpg folded before Flop (didn't bet)
Seat 7: jammy1875 (button) folded before Flop (didn't bet)
Seat 8: DRY BLECKBERRY (small blind) folded before Flop

PokerStars Hand #251205704639: Tournament #3767885527, $40+$10+$5 USD Hold'em No Limit - Level XII (700/1400) - 2024/06/26 19:13:13 UTC [2024/06/26 15:13:13 ET]
Table '3767885527 58' 8-max Seat #8 is the button
Seat 1: leitalopez (41999 in chips) 
Seat 2: Philipoune (67266 in chips) 
Seat 3: Defence_BOMB (33169 in chips) 
Seat 4: alushi6 (28000 in chips) 
Seat 5: MTTSharkSnG (33275 in chips) 
Seat 6: conradofpg (33865 in chips) 
Seat 7: jammy1875 (73894 in chips) 
Seat 8: DRY BLECKBERRY (31243 in chips) 
leitalopez: posts the ante 175
Philipoune: posts the ante 175
Defence_BOMB: posts the ante 175
alushi6: posts the ante 175
MTTSharkSnG: posts the ante 175
conradofpg: posts the ante 175
jammy1875: posts the ante 175
DRY BLECKBERRY: posts the ante 175
leitalopez: posts small blind 700
Philipoune: posts big blind 1400
*** HOLE CARDS ***
Defence_BOMB: folds 
alushi6: folds 
MTTSharkSnG: folds 
conradofpg: folds 
jammy1875: folds 
DRY BLECKBERRY: folds 
leitalopez: calls 700
Philipoune: checks 
*** FLOP *** [4s 9s Qd]
leitalopez: checks 
Philipoune: checks 
*** TURN *** [4s 9s Qd] [Jd]
leitalopez: bets 1400
Philipoune: folds 
Uncalled bet (1400) returned to leitalopez
leitalopez collected 4200 from pot
leitalopez: doesn't show hand 
*** SUMMARY ***
Total pot 4200 | Rake 0 
Board [4s 9s Qd Jd]
Seat 1: leitalopez (small blind) collected (4200)
Seat 2: Philipoune (big blind) folded on the Turn
Seat 3: Defence_BOMB folded before Flop (didn't bet)
Seat 4: alushi6 folded before Flop (didn't bet)
Seat 5: MTTSharkSnG folded before Flop (didn't bet)
Seat 6: conradofpg folded before Flop (didn't bet)
Seat 7: jammy1875 folded before Flop (didn't bet)
Seat 8: DRY BLECKBERRY (button) folded before Flop (didn't bet)

PokerStars Hand #251205716057: Tournament #3767885527, $40+$10+$5 USD Hold'em No Limit - Level XII (700/1400) - 2024/06/26 19:13:56 UTC [2024/06/26 15:13:56 ET]
Table '3767885527 58' 8-max Seat #1 is the button
Seat 1: leitalopez (44624 in chips) 
Seat 2: Philipoune (65691 in chips) 
Seat 3: Defence_BOMB (32994 in chips) 
Seat 4: alushi6 (27825 in chips) 
Seat 5: MTTSharkSnG (33100 in chips) 
Seat 6: conradofpg (33690 in chips) 
Seat 7: jammy1875 (73719 in chips) 
Seat 8: DRY BLECKBERRY (31068 in chips) 
leitalopez: posts the ante 175
Philipoune: posts the ante 175
Defence_BOMB: posts the ante 175
alushi6: posts the ante 175
MTTSharkSnG: posts the ante 175
conradofpg: posts the ante 175
jammy1875: posts the ante 175
DRY BLECKBERRY: posts the ante 175
Philipoune: posts small blind 700
Defence_BOMB: posts big blind 1400
*** HOLE CARDS ***
alushi6: raises 1400 to 2800
MTTSharkSnG: folds 
conradofpg: folds 
jammy1875: folds 
DRY BLECKBERRY: raises 4200 to 7000
leitalopez: folds 
Philipoune: folds 
Defence_BOMB: folds 
alushi6: raises 20650 to 27650 and is all-in
DRY BLECKBERRY: calls 20650
*** FLOP *** [7s 4d 5s]
*** TURN *** [7s 4d 5s] [Qh]
*** RIVER *** [7s 4d 5s Qh] [Ah]
*** SHOW DOWN ***
alushi6: shows [Kd Ad] (a pair of Aces)
DRY BLECKBERRY: shows [Ks As] (a pair of Aces)
alushi6 collected 29400 from pot
DRY BLECKBERRY collected 29400 from pot
*** SUMMARY ***
Total pot 58800 | Rake 0 
Board [7s 4d 5s Qh Ah]
Seat 1: leitalopez (button) folded before Flop (didn't bet)
Seat 2: Philipoune (small blind) folded before Flop
Seat 3: Defence_BOMB (big blind) folded before Flop
Seat 4: alushi6 showed [Kd Ad] and won (29400) with a pair of Aces
Seat 5: MTTSharkSnG folded before Flop (didn't bet)
Seat 6: conradofpg folded before Flop (didn't bet)
Seat 7: jammy1875 folded before Flop (didn't bet)
Seat 8: DRY BLECKBERRY showed [Ks As] and won (29400) with a pair of Aces

PokerStars Hand #251205730536: Tournament #3767885527, $40+$10+$5 USD Hold'em No Limit - Level XII (700/1400) - 2024/06/26 19:14:49 UTC [2024/06/26 15:14:49 ET]
Table '3767885527 58' 8-max Seat #2 is the button
Seat 1: leitalopez (44449 in chips) 
Seat 2: Philipoune (64816 in chips) 
Seat 3: Defence_BOMB (31419 in chips) 
Seat 4: alushi6 (29400 in chips) 
Seat 5: MTTSharkSnG (32925 in chips) 
Seat 6: conradofpg (33515 in chips) 
Seat 7: jammy1875 (73544 in chips) 
Seat 8: DRY BLECKBERRY (32643 in chips) 
leitalopez: posts the ante 175
Philipoune: posts the ante 175
Defence_BOMB: posts the ante 175
alushi6: posts the ante 175
MTTSharkSnG: posts the ante 175
conradofpg: posts the ante 175
jammy1875: posts the ante 175
DRY BLECKBERRY: posts the ante 175
Defence_BOMB: posts small blind 700
alushi6: posts big blind 1400
*** HOLE CARDS ***
MTTSharkSnG: folds 
conradofpg: folds 
jammy1875: folds 
DRY BLECKBERRY: raises 1400 to 2800
leitalopez: folds 
Philipoune: folds 
Defence_BOMB: folds 
alushi6: folds 
Uncalled bet (1400) returned to DRY BLECKBERRY
DRY BLECKBERRY collected 4900 from pot
DRY BLECKBERRY: doesn't show hand 
*** SUMMARY ***
Total pot 4900 | Rake 0 
Seat 1: leitalopez folded before Flop (didn't bet)
Seat 2: Philipoune (button) folded before Flop (didn't bet)
Seat 3: Defence_BOMB (small blind) folded before Flop
Seat 4: alushi6 (big blind) folded before Flop
Seat 5: MTTSharkSnG folded before Flop (didn't bet)
Seat 6: conradofpg folded before Flop (didn't bet)
Seat 7: jammy1875 folded before Flop (didn't bet)
Seat 8: DRY BLECKBERRY collected (4900)

PokerStars Hand #251205739557: Tournament #3767885527, $40+$10+$5 USD Hold'em No Limit - Level XII (700/1400) - 2024/06/26 19:15:22 UTC [2024/06/26 15:15:22 ET]
Table '3767885527 58' 8-max Seat #3 is the button
Seat 1: leitalopez (44274 in chips) 
Seat 2: Philipoune (64641 in chips) 
Seat 3: Defence_BOMB (30544 in chips) 
Seat 4: alushi6 (27825 in chips) 
Seat 5: MTTSharkSnG (32750 in chips) 
Seat 6: conradofpg (33340 in chips) 
Seat 7: jammy1875 (73369 in chips) 
Seat 8: DRY BLECKBERRY (35968 in chips) 
leitalopez: posts the ante 175
Philipoune: posts the ante 175
Defence_BOMB: posts the ante 175
alushi6: posts the ante 175
MTTSharkSnG: posts the ante 175
conradofpg: posts the ante 175
jammy1875: posts the ante 175
DRY BLECKBERRY: posts the ante 175
alushi6: posts small blind 700
MTTSharkSnG: posts big blind 1400
*** HOLE CARDS ***
conradofpg: folds 
jammy1875: folds 
DRY BLECKBERRY: raises 1400 to 2800
leitalopez: folds 
Philipoune: folds 
Defence_BOMB: folds 
alushi6: raises 24850 to 27650 and is all-in
MTTSharkSnG: raises 4925 to 32575 and is all-in
DRY BLECKBERRY: calls 29775
*** FLOP *** [3d 2d 7s]
*** TURN *** [3d 2d 7s] [8d]
*** RIVER *** [3d 2d 7s 8d] [Js]
*** SHOW DOWN ***
MTTSharkSnG: shows [Jc Ac] (a pair of Jacks)
DRY BLECKBERRY: shows [Kh Ah] (high card Ace)
MTTSharkSnG collected 9850 from side pot
alushi6: shows [Ks Qs] (high card King)
MTTSharkSnG collected 84350 from main pot
alushi6 finished the tournament
*** SUMMARY ***
Total pot 94200 Main pot 84350. Side pot 9850. | Rake 0 
Board [3d 2d 7s 8d Js]
Seat 1: leitalopez folded before Flop (didn't bet)
Seat 2: Philipoune folded before Flop (didn't bet)
Seat 3: Defence_BOMB (button) folded before Flop (didn't bet)
Seat 4: alushi6 (small blind) showed [Ks Qs] and lost with high card King
Seat 5: MTTSharkSnG (big blind) showed [Jc Ac] and won (94200) with a pair of Jacks
Seat 6: conradofpg folded before Flop (didn't bet)
Seat 7: jammy1875 folded before Flop (didn't bet)
Seat 8: DRY BLECKBERRY showed [Kh Ah] and lost with high card Ace

PokerStars Hand #251205752366: Tournament #3767885527, $40+$10+$5 USD Hold'em No Limit - Level XII (700/1400) - 2024/06/26 19:16:09 UTC [2024/06/26 15:16:09 ET]
Table '3767885527 58' 8-max Seat #5 is the button
Seat 1: leitalopez (44099 in chips) 
Seat 2: Philipoune (64466 in chips) 
Seat 3: Defence_BOMB (30369 in chips) 
Seat 5: MTTSharkSnG (94200 in chips) 
Seat 6: conradofpg (33165 in chips) 
Seat 7: jammy1875 (73194 in chips) 
Seat 8: DRY BLECKBERRY (3218 in chips) 
leitalopez: posts the ante 175
Philipoune: posts the ante 175
Defence_BOMB: posts the ante 175
MTTSharkSnG: posts the ante 175
conradofpg: posts the ante 175
jammy1875: posts the ante 175
DRY BLECKBERRY: posts the ante 175
conradofpg: posts small blind 700
jammy1875: posts big blind 1400
*** HOLE CARDS ***
DRY BLECKBERRY: folds 
leitalopez: folds 
Philipoune: folds 
Defence_BOMB: folds 
MTTSharkSnG: raises 1400 to 2800
conradofpg: folds 
jammy1875: raises 4200 to 7000
KingDugdale is disconnected 
MTTSharkSnG: calls 4200
*** FLOP *** [6h 5c 2s]
jammy1875: bets 5600
MTTSharkSnG: calls 5600
*** TURN *** [6h 5c 2s] [Qc]
jammy1875: bets 12163
MTTSharkSnG: folds 
Uncalled bet (12163) returned to jammy1875
jammy1875 collected 27125 from pot
*** SUMMARY ***
Total pot 27125 | Rake 0 
Board [6h 5c 2s Qc]
Seat 1: leitalopez folded before Flop (didn't bet)
Seat 2: Philipoune folded before Flop (didn't bet)
Seat 3: Defence_BOMB folded before Flop (didn't bet)
Seat 5: MTTSharkSnG (button) folded on the Turn
Seat 6: conradofpg (small blind) folded before Flop
Seat 7: jammy1875 (big blind) collected (27125)
Seat 8: DRY BLECKBERRY folded before Flop (didn't bet)

PokerStars Hand #251205773369: Tournament #3767885527, $40+$10+$5 USD Hold'em No Limit - Level XII (700/1400) - 2024/06/26 19:17:27 UTC [2024/06/26 15:17:27 ET]
Table '3767885527 58' 8-max Seat #6 is the button
Seat 1: leitalopez (43924 in chips) 
Seat 2: Philipoune (64291 in chips) 
Seat 3: Defence_BOMB (30194 in chips) 
Seat 4: KingDugdale (25000 in chips) 
Seat 5: MTTSharkSnG (81425 in chips) 
Seat 6: conradofpg (32290 in chips) 
Seat 7: jammy1875 (87544 in chips) 
Seat 8: DRY BLECKBERRY (3043 in chips) 
leitalopez: posts the ante 175
Philipoune: posts the ante 175
Defence_BOMB: posts the ante 175
KingDugdale: posts the ante 175
MTTSharkSnG: posts the ante 175
conradofpg: posts the ante 175
jammy1875: posts the ante 175
DRY BLECKBERRY: posts the ante 175
jammy1875: posts small blind 700
DRY BLECKBERRY: posts big blind 1400
*** HOLE CARDS ***
leitalopez: raises 1400 to 2800
Philipoune: folds 
Defence_BOMB: raises 4200 to 7000
KingDugdale: folds 
MTTSharkSnG: folds 
conradofpg: folds 
jammy1875: folds 
DRY BLECKBERRY: calls 1468 and is all-in
leitalopez: folds 
Uncalled bet (4132) returned to Defence_BOMB
*** FLOP *** [3d Th 7c]
*** TURN *** [3d Th 7c] [Kh]
*** RIVER *** [3d Th 7c Kh] [6h]
*** SHOW DOWN ***
DRY BLECKBERRY: shows [Tc As] (a pair of Tens)
Defence_BOMB: shows [Kc Ad] (a pair of Kings)
Defence_BOMB collected 10636 from pot
DRY BLECKBERRY finished the tournament
*** SUMMARY ***
Total pot 10636 | Rake 0 
Board [3d Th 7c Kh 6h]
Seat 1: leitalopez folded before Flop
Seat 2: Philipoune folded before Flop (didn't bet)
Seat 3: Defence_BOMB showed [Kc Ad] and won (10636) with a pair of Kings
Seat 4: KingDugdale folded before Flop (didn't bet)
Seat 5: MTTSharkSnG folded before Flop (didn't bet)
Seat 6: conradofpg (button) folded before Flop (didn't bet)
Seat 7: jammy1875 (small blind) folded before Flop
Seat 8: DRY BLECKBERRY (big blind) showed [Tc As] and lost with a pair of Tens

PokerStars Hand #251205785433: Tournament #3767885527, $40+$10+$5 USD Hold'em No Limit - Level XII (700/1400) - 2024/06/26 19:18:11 UTC [2024/06/26 15:18:11 ET]
Table '3767885527 58' 8-max Seat #7 is the button
Seat 1: leitalopez (40949 in chips) 
Seat 2: Philipoune (64116 in chips) 
Seat 3: Defence_BOMB (37787 in chips) 
Seat 4: KingDugdale (24825 in chips) 
Seat 5: MTTSharkSnG (81250 in chips) 
Seat 6: conradofpg (32115 in chips) 
Seat 7: jammy1875 (86669 in chips) 
leitalopez: posts the ante 175
Philipoune: posts the ante 175
Defence_BOMB: posts the ante 175
KingDugdale: posts the ante 175
MTTSharkSnG: posts the ante 175
conradofpg: posts the ante 175
jammy1875: posts the ante 175
leitalopez: posts small blind 700
Philipoune: posts big blind 1400
*** HOLE CARDS ***
Defence_BOMB: folds 
KingDugdale: folds 
MTTSharkSnG: folds 
conradofpg: folds 
jammy1875: folds 
leitalopez: calls 700
Philipoune: raises 62541 to 63941 and is all-in
leitalopez: folds 
Uncalled bet (62541) returned to Philipoune
Philipoune collected 4025 from pot
Philipoune: doesn't show hand 
*** SUMMARY ***
Total pot 4025 | Rake 0 
Seat 1: leitalopez (small blind) folded before Flop
Seat 2: Philipoune (big blind) collected (4025)
Seat 3: Defence_BOMB folded before Flop (didn't bet)
Seat 4: KingDugdale folded before Flop (didn't bet)
Seat 5: MTTSharkSnG folded before Flop (didn't bet)
Seat 6: conradofpg folded before Flop (didn't bet)
Seat 7: jammy1875 (button) folded before Flop (didn't bet)

PokerStars Hand #251205793783: Tournament #3767885527, $40+$10+$5 USD Hold'em No Limit - Level XII (700/1400) - 2024/06/26 19:18:41 UTC [2024/06/26 15:18:41 ET]
Table '3767885527 58' 8-max Seat #1 is the button
Seat 1: leitalopez (39374 in chips) 
Seat 2: Philipoune (66566 in chips) 
Seat 3: Defence_BOMB (37612 in chips) 
Seat 4: KingDugdale (24650 in chips) 
Seat 5: MTTSharkSnG (81075 in chips) 
Seat 6: conradofpg (31940 in chips) 
Seat 7: jammy1875 (86494 in chips) 
leitalopez: posts the ante 175
Philipoune: posts the ante 175
Defence_BOMB: posts the ante 175
KingDugdale: posts the ante 175
MTTSharkSnG: posts the ante 175
conradofpg: posts the ante 175
jammy1875: posts the ante 175
Philipoune: posts small blind 700
Defence_BOMB: posts big blind 1400
*** HOLE CARDS ***
KingDugdale: folds 
MTTSharkSnG: folds 
conradofpg: raises 1400 to 2800
jammy1875: raises 8400 to 11200
leitalopez: folds 
Philipoune: folds 
oO-HaiRoller-Oo is disconnected 
Defence_BOMB: folds 
conradofpg: folds 
Uncalled bet (8400) returned to jammy1875
jammy1875 collected 8925 from pot
*** SUMMARY ***
Total pot 8925 | Rake 0 
Seat 1: leitalopez (button) folded before Flop (didn't bet)
Seat 2: Philipoune (small blind) folded before Flop
Seat 3: Defence_BOMB (big blind) folded before Flop
Seat 4: KingDugdale folded before Flop (didn't bet)
Seat 5: MTTSharkSnG folded before Flop (didn't bet)
Seat 6: conradofpg folded before Flop
Seat 7: jammy1875 collected (8925)

PokerStars Hand #251205806355: Tournament #3767885527, $40+$10+$5 USD Hold'em No Limit - Level XIII (800/1600) - 2024/06/26 19:19:27 UTC [2024/06/26 15:19:27 ET]
Table '3767885527 58' 8-max Seat #2 is the button
Seat 1: leitalopez (39199 in chips) 
Seat 2: Philipoune (65691 in chips) 
Seat 3: Defence_BOMB (36037 in chips) 
Seat 4: KingDugdale (24475 in chips) 
Seat 5: MTTSharkSnG (80900 in chips) 
Seat 6: conradofpg (28965 in chips) 
Seat 7: jammy1875 (92444 in chips) 
Seat 8: oO-HaiRoller-Oo (25000 in chips) 
leitalopez: posts the ante 200
Philipoune: posts the ante 200
Defence_BOMB: posts the ante 200
KingDugdale: posts the ante 200
MTTSharkSnG: posts the ante 200
conradofpg: posts the ante 200
jammy1875: posts the ante 200
oO-HaiRoller-Oo: posts the ante 200
Defence_BOMB: posts small blind 800
KingDugdale: posts big blind 1600
*** HOLE CARDS ***
MTTSharkSnG: folds 
conradofpg: folds 
jammy1875: raises 1600 to 3200
oO-HaiRoller-Oo: folds 
leitalopez: raises 35799 to 38999 and is all-in
Philipoune: folds 
Defence_BOMB: folds 
KingDugdale: folds 
jammy1875: folds 
Uncalled bet (35799) returned to leitalopez
leitalopez collected 10400 from pot
leitalopez: doesn't show hand 
*** SUMMARY ***
Total pot 10400 | Rake 0 
Seat 1: leitalopez collected (10400)
Seat 2: Philipoune (button) folded before Flop (didn't bet)
Seat 3: Defence_BOMB (small blind) folded before Flop
Seat 4: KingDugdale (big blind) folded before Flop
Seat 5: MTTSharkSnG folded before Flop (didn't bet)
Seat 6: conradofpg folded before Flop (didn't bet)
Seat 7: jammy1875 folded before Flop
Seat 8: oO-HaiRoller-Oo folded before Flop (didn't bet)

PokerStars Hand #251205813172: Tournament #3767885527, $40+$10+$5 USD Hold'em No Limit - Level XIII (800/1600) - 2024/06/26 19:19:52 UTC [2024/06/26 15:19:52 ET]
Table '3767885527 58' 8-max Seat #3 is the button
Seat 1: leitalopez (46199 in chips) 
Seat 2: Philipoune (65491 in chips) 
Seat 3: Defence_BOMB (35037 in chips) 
Seat 4: KingDugdale (22675 in chips) 
Seat 5: MTTSharkSnG (80700 in chips) 
Seat 6: conradofpg (28765 in chips) 
Seat 7: jammy1875 (89044 in chips) 
Seat 8: oO-HaiRoller-Oo (24800 in chips) 
leitalopez: posts the ante 200
Philipoune: posts the ante 200
Defence_BOMB: posts the ante 200
KingDugdale: posts the ante 200
MTTSharkSnG: posts the ante 200
conradofpg: posts the ante 200
jammy1875: posts the ante 200
oO-HaiRoller-Oo: posts the ante 200
KingDugdale: posts small blind 800
MTTSharkSnG: posts big blind 1600
*** HOLE CARDS ***
conradofpg: raises 1600 to 3200
jammy1875: calls 3200
oO-HaiRoller-Oo: folds 
leitalopez: folds 
Philipoune: folds 
Defence_BOMB: folds 
KingDugdale: folds 
MTTSharkSnG: folds 
*** FLOP *** [2s 7h 6c]
conradofpg: checks 
jammy1875: checks 
*** TURN *** [2s 7h 6c] [Kh]
conradofpg: checks 
jammy1875: bets 4800
conradofpg: calls 4800
*** RIVER *** [2s 7h 6c Kh] [Qs]
conradofpg: checks 
jammy1875: bets 8400
conradofpg: folds 
Uncalled bet (8400) returned to jammy1875
jammy1875 collected 20000 from pot
*** SUMMARY ***
Total pot 20000 | Rake 0 
Board [2s 7h 6c Kh Qs]
Seat 1: leitalopez folded before Flop (didn't bet)
Seat 2: Philipoune folded before Flop (didn't bet)
Seat 3: Defence_BOMB (button) folded before Flop (didn't bet)
Seat 4: KingDugdale (small blind) folded before Flop
Seat 5: MTTSharkSnG (big blind) folded before Flop
Seat 6: conradofpg folded on the River
Seat 7: jammy1875 collected (20000)
Seat 8: oO-HaiRoller-Oo folded before Flop (didn't bet)

PokerStars Hand #251205843603: Tournament #3767885527, $40+$10+$5 USD Hold'em No Limit - Level XIII (800/1600) - 2024/06/26 19:21:44 UTC [2024/06/26 15:21:44 ET]
Table '3767885527 58' 8-max Seat #4 is the button
Seat 1: leitalopez (45999 in chips) 
Seat 2: Philipoune (65291 in chips) 
Seat 3: Defence_BOMB (34837 in chips) 
Seat 4: KingDugdale (21675 in chips) 
Seat 5: MTTSharkSnG (78900 in chips) 
Seat 6: conradofpg (20565 in chips) 
Seat 7: jammy1875 (100844 in chips) 
Seat 8: oO-HaiRoller-Oo (24600 in chips) 
leitalopez: posts the ante 200
Philipoune: posts the ante 200
Defence_BOMB: posts the ante 200
KingDugdale: posts the ante 200
MTTSharkSnG: posts the ante 200
conradofpg: posts the ante 200
jammy1875: posts the ante 200
oO-HaiRoller-Oo: posts the ante 200
MTTSharkSnG: posts small blind 800
conradofpg: posts big blind 1600
*** HOLE CARDS ***
jammy1875: folds 
oO-HaiRoller-Oo: raises 22800 to 24400 and is all-in
leitalopez: folds 
Philipoune: folds 
Defence_BOMB: folds 
KingDugdale: folds 
MTTSharkSnG: folds 
conradofpg: folds 
Uncalled bet (22800) returned to oO-HaiRoller-Oo
oO-HaiRoller-Oo collected 5600 from pot
oO-HaiRoller-Oo: doesn't show hand 
*** SUMMARY ***
Total pot 5600 | Rake 0 
Seat 1: leitalopez folded before Flop (didn't bet)
Seat 2: Philipoune folded before Flop (didn't bet)
Seat 3: Defence_BOMB folded before Flop (didn't bet)
Seat 4: KingDugdale (button) folded before Flop (didn't bet)
Seat 5: MTTSharkSnG (small blind) folded before Flop
Seat 6: conradofpg (big blind) folded before Flop
Seat 7: jammy1875 folded before Flop (didn't bet)
Seat 8: oO-HaiRoller-Oo collected (5600)

PokerStars Hand #251205850436: Tournament #3767885527, $40+$10+$5 USD Hold'em No Limit - Level XIII (800/1600) - 2024/06/26 19:22:09 UTC [2024/06/26 15:22:09 ET]
Table '3767885527 58' 8-max Seat #5 is the button
Seat 1: leitalopez (45799 in chips) 
Seat 2: Philipoune (65091 in chips) 
Seat 3: Defence_BOMB (34637 in chips) 
Seat 4: KingDugdale (21475 in chips) 
Seat 5: MTTSharkSnG (77900 in chips) 
Seat 6: conradofpg (18765 in chips) 
Seat 7: jammy1875 (100644 in chips) 
Seat 8: oO-HaiRoller-Oo (28400 in chips) 
leitalopez: posts the ante 200
Philipoune: posts the ante 200
Defence_BOMB: posts the ante 200
KingDugdale: posts the ante 200
MTTSharkSnG: posts the ante 200
conradofpg: posts the ante 200
jammy1875: posts the ante 200
oO-HaiRoller-Oo: posts the ante 200
conradofpg: posts small blind 800
jammy1875: posts big blind 1600
*** HOLE CARDS ***
oO-HaiRoller-Oo: folds 
leitalopez: folds 
Philipoune: folds 
Defence_BOMB: folds 
KingDugdale: raises 19675 to 21275 and is all-in
MTTSharkSnG: folds 
conradofpg: folds 
jammy1875: calls 19675
*** FLOP *** [Qh Qc Js]
*** TURN *** [Qh Qc Js] [Jh]
*** RIVER *** [Qh Qc Js Jh] [5h]
*** SHOW DOWN ***
jammy1875: shows [9s Ac] (two pair, Queens and Jacks)
KingDugdale: shows [Kc 9c] (two pair, Queens and Jacks - lower kicker)
jammy1875 collected 44950 from pot
KingDugdale finished the tournament
*** SUMMARY ***
Total pot 44950 | Rake 0 
Board [Qh Qc Js Jh 5h]
Seat 1: leitalopez folded before Flop (didn't bet)
Seat 2: Philipoune folded before Flop (didn't bet)
Seat 3: Defence_BOMB folded before Flop (didn't bet)
Seat 4: KingDugdale showed [Kc 9c] and lost with two pair, Queens and Jacks
Seat 5: MTTSharkSnG (button) folded before Flop (didn't bet)
Seat 6: conradofpg (small blind) folded before Flop
Seat 7: jammy1875 (big blind) showed [9s Ac] and won (44950) with two pair, Queens and Jacks
Seat 8: oO-HaiRoller-Oo folded before Flop (didn't bet)

PokerStars Hand #251205859502: Tournament #3767885527, $40+$10+$5 USD Hold'em No Limit - Level XIII (800/1600) - 2024/06/26 19:22:42 UTC [2024/06/26 15:22:42 ET]
Table '3767885527 58' 8-max Seat #6 is the button
Seat 1: leitalopez (45599 in chips) 
Seat 2: Philipoune (64891 in chips) 
Seat 3: Defence_BOMB (34437 in chips) 
Seat 5: MTTSharkSnG (77700 in chips) 
Seat 6: conradofpg (17765 in chips) 
Seat 7: jammy1875 (124119 in chips) 
Seat 8: oO-HaiRoller-Oo (28200 in chips) 
leitalopez: posts the ante 200
Philipoune: posts the ante 200
Defence_BOMB: posts the ante 200
MTTSharkSnG: posts the ante 200
conradofpg: posts the ante 200
jammy1875: posts the ante 200
oO-HaiRoller-Oo: posts the ante 200
jammy1875: posts small blind 800
oO-HaiRoller-Oo: posts big blind 1600
*** HOLE CARDS ***
leitalopez: folds 
Philipoune: folds 
Defence_BOMB: folds 
MTTSharkSnG: folds 
conradofpg: folds 
jammy1875: raises 1600 to 3200
oO-HaiRoller-Oo: calls 1600
*** FLOP *** [Jc 9d 5d]
jammy1875: bets 3200
oO-HaiRoller-Oo: calls 3200
*** TURN *** [Jc 9d 5d] [2h]
jammy1875: checks 
oO-HaiRoller-Oo: bets 21600 and is all-in
jammy1875: folds 
Uncalled bet (21600) returned to oO-HaiRoller-Oo
oO-HaiRoller-Oo collected 14200 from pot
oO-HaiRoller-Oo: doesn't show hand 
*** SUMMARY ***
Total pot 14200 | Rake 0 
Board [Jc 9d 5d 2h]
Seat 1: leitalopez folded before Flop (didn't bet)
Seat 2: Philipoune folded before Flop (didn't bet)
Seat 3: Defence_BOMB folded before Flop (didn't bet)
Seat 5: MTTSharkSnG folded before Flop (didn't bet)
Seat 6: conradofpg (button) folded before Flop (didn't bet)
Seat 7: jammy1875 (small blind) folded on the Turn
Seat 8: oO-HaiRoller-Oo (big blind) collected (14200)

PokerStars Hand #251205874752: Tournament #3767885527, $40+$10+$5 USD Hold'em No Limit - Level XIII (800/1600) - 2024/06/26 19:23:38 UTC [2024/06/26 15:23:38 ET]
Table '3767885527 58' 8-max Seat #7 is the button
Seat 1: leitalopez (45399 in chips) 
Seat 2: Philipoune (64691 in chips) 
Seat 3: Defence_BOMB (34237 in chips) 
Seat 4: Renailmatto (25000 in chips) 
Seat 5: MTTSharkSnG (77500 in chips) 
Seat 6: conradofpg (17565 in chips) 
Seat 7: jammy1875 (117519 in chips) 
Seat 8: oO-HaiRoller-Oo (35800 in chips) 
leitalopez: posts the ante 200
Philipoune: posts the ante 200
Defence_BOMB: posts the ante 200
Renailmatto: posts the ante 200
MTTSharkSnG: posts the ante 200
conradofpg: posts the ante 200
jammy1875: posts the ante 200
oO-HaiRoller-Oo: posts the ante 200
oO-HaiRoller-Oo: posts small blind 800
leitalopez: posts big blind 1600
*** HOLE CARDS ***
Philipoune: folds 
Defence_BOMB: folds 
Renailmatto: raises 1600 to 3200
MTTSharkSnG: folds 
conradofpg: folds 
jammy1875: folds 
oO-HaiRoller-Oo: calls 2400
leitalopez: calls 1600
*** FLOP *** [9h Kd Qs]
oO-HaiRoller-Oo: checks 
leitalopez: checks 
Renailmatto: bets 5600
oO-HaiRoller-Oo: calls 5600
leitalopez: folds 
*** TURN *** [9h Kd Qs] [Ts]
oO-HaiRoller-Oo: checks 
Renailmatto: checks 
*** RIVER *** [9h Kd Qs Ts] [6c]
oO-HaiRoller-Oo: bets 26800 and is all-in
Renailmatto: folds 
Uncalled bet (26800) returned to oO-HaiRoller-Oo
oO-HaiRoller-Oo collected 22400 from pot
oO-HaiRoller-Oo: doesn't show hand 
*** SUMMARY ***
Total pot 22400 | Rake 0 
Board [9h Kd Qs Ts 6c]
Seat 1: leitalopez (big blind) folded on the Flop
Seat 2: Philipoune folded before Flop (didn't bet)
Seat 3: Defence_BOMB folded before Flop (didn't bet)
Seat 4: Renailmatto folded on the River
Seat 5: MTTSharkSnG folded before Flop (didn't bet)
Seat 6: conradofpg folded before Flop (didn't bet)
Seat 7: jammy1875 (button) folded before Flop (didn't bet)
Seat 8: oO-HaiRoller-Oo (small blind) collected (22400)

PokerStars Hand #251205891218: Tournament #3767885527, $40+$10+$5 USD Hold'em No Limit - Level XIII (800/1600) - 2024/06/26 19:24:38 UTC [2024/06/26 15:24:38 ET]
Table '3767885527 58' 8-max Seat #8 is the button
Seat 1: leitalopez (41999 in chips) 
Seat 2: Philipoune (64491 in chips) 
Seat 3: Defence_BOMB (34037 in chips) 
Seat 4: Renailmatto (16000 in chips) 
Seat 5: MTTSharkSnG (77300 in chips) 
Seat 6: conradofpg (17365 in chips) 
Seat 7: jammy1875 (117319 in chips) 
Seat 8: oO-HaiRoller-Oo (49200 in chips) 
leitalopez: posts the ante 200
Philipoune: posts the ante 200
Defence_BOMB: posts the ante 200
Renailmatto: posts the ante 200
MTTSharkSnG: posts the ante 200
conradofpg: posts the ante 200
jammy1875: posts the ante 200
oO-HaiRoller-Oo: posts the ante 200
leitalopez: posts small blind 800
Philipoune: posts big blind 1600
*** HOLE CARDS ***
Defence_BOMB: folds 
Renailmatto: raises 14200 to 15800 and is all-in
MTTSharkSnG: folds 
conradofpg: folds 
jammy1875: folds 
oO-HaiRoller-Oo: folds 
leitalopez: folds 
Philipoune: folds 
Uncalled bet (14200) returned to Renailmatto
Renailmatto collected 5600 from pot
*** SUMMARY ***
Total pot 5600 | Rake 0 
Seat 1: leitalopez (small blind) folded before Flop
Seat 2: Philipoune (big blind) folded before Flop
Seat 3: Defence_BOMB folded before Flop (didn't bet)
Seat 4: Renailmatto collected (5600)
Seat 5: MTTSharkSnG folded before Flop (didn't bet)
Seat 6: conradofpg folded before Flop (didn't bet)
Seat 7: jammy1875 folded before Flop (didn't bet)
Seat 8: oO-HaiRoller-Oo (button) folded before Flop (didn't bet)

PokerStars Hand #251205896482: Tournament #3767885527, $40+$10+$5 USD Hold'em No Limit - Level XIII (800/1600) - 2024/06/26 19:24:57 UTC [2024/06/26 15:24:57 ET]
Table '3767885527 58' 8-max Seat #1 is the button
Seat 1: leitalopez (40999 in chips) 
Seat 2: Philipoune (62691 in chips) 
Seat 3: Defence_BOMB (33837 in chips) 
Seat 4: Renailmatto (19800 in chips) 
Seat 5: MTTSharkSnG (77100 in chips) 
Seat 6: conradofpg (17165 in chips) 
Seat 7: jammy1875 (117119 in chips) 
Seat 8: oO-HaiRoller-Oo (49000 in chips) 
leitalopez: posts the ante 200
Philipoune: posts the ante 200
Defence_BOMB: posts the ante 200
Renailmatto: posts the ante 200
MTTSharkSnG: posts the ante 200
conradofpg: posts the ante 200
jammy1875: posts the ante 200
oO-HaiRoller-Oo: posts the ante 200
Philipoune: posts small blind 800
Defence_BOMB: posts big blind 1600
*** HOLE CARDS ***
Renailmatto: folds 
MTTSharkSnG: folds 
conradofpg: folds 
jammy1875: folds 
oO-HaiRoller-Oo: folds 
leitalopez: raises 1600 to 3200
Philipoune: folds 
Defence_BOMB: folds 
Uncalled bet (1600) returned to leitalopez
leitalopez collected 5600 from pot
leitalopez: doesn't show hand 
*** SUMMARY ***
Total pot 5600 | Rake 0 
Seat 1: leitalopez (button) collected (5600)
Seat 2: Philipoune (small blind) folded before Flop
Seat 3: Defence_BOMB (big blind) folded before Flop
Seat 4: Renailmatto folded before Flop (didn't bet)
Seat 5: MTTSharkSnG folded before Flop (didn't bet)
Seat 6: conradofpg folded before Flop (didn't bet)
Seat 7: jammy1875 folded before Flop (didn't bet)
Seat 8: oO-HaiRoller-Oo folded before Flop (didn't bet)

PokerStars Hand #251205903815: Tournament #3767885527, $40+$10+$5 USD Hold'em No Limit - Level XIII (800/1600) - 2024/06/26 19:25:23 UTC [2024/06/26 15:25:23 ET]
Table '3767885527 58' 8-max Seat #2 is the button
Seat 1: leitalopez (44799 in chips) 
Seat 2: Philipoune (61691 in chips) 
Seat 3: Defence_BOMB (32037 in chips) 
Seat 4: Renailmatto (19600 in chips) 
Seat 5: MTTSharkSnG (76900 in chips) 
Seat 6: conradofpg (16965 in chips) 
Seat 7: jammy1875 (116919 in chips) 
Seat 8: oO-HaiRoller-Oo (48800 in chips) 
leitalopez: posts the ante 200
Philipoune: posts the ante 200
Defence_BOMB: posts the ante 200
Renailmatto: posts the ante 200
MTTSharkSnG: posts the ante 200
conradofpg: posts the ante 200
jammy1875: posts the ante 200
oO-HaiRoller-Oo: posts the ante 200
Defence_BOMB: posts small blind 800
Renailmatto: posts big blind 1600
*** HOLE CARDS ***
MTTSharkSnG: folds 
conradofpg: raises 15165 to 16765 and is all-in
jammy1875: raises 19965 to 36730
oO-HaiRoller-Oo: folds 
leitalopez: folds 
Philipoune: folds 
Defence_BOMB: folds 
Renailmatto: folds 
Uncalled bet (19965) returned to jammy1875
*** FLOP *** [3c Qh 2c]
*** TURN *** [3c Qh 2c] [9d]
*** RIVER *** [3c Qh 2c 9d] [2s]
*** SHOW DOWN ***
conradofpg: shows [Jh Js] (two pair, Jacks and Deuces)
jammy1875: shows [9s 9h] (a full house, Nines full of Deuces)
jammy1875 collected 37530 from pot
conradofpg finished the tournament
*** SUMMARY ***
Total pot 37530 | Rake 0 
Board [3c Qh 2c 9d 2s]
Seat 1: leitalopez folded before Flop (didn't bet)
Seat 2: Philipoune (button) folded before Flop (didn't bet)
Seat 3: Defence_BOMB (small blind) folded before Flop
Seat 4: Renailmatto (big blind) folded before Flop
Seat 5: MTTSharkSnG folded before Flop (didn't bet)
Seat 6: conradofpg showed [Jh Js] and lost with two pair, Jacks and Deuces
Seat 7: jammy1875 showed [9s 9h] and won (37530) with a full house, Nines full of Deuces
Seat 8: oO-HaiRoller-Oo folded before Flop (didn't bet)

PokerStars Hand #251205913936: Tournament #3767885527, $40+$10+$5 USD Hold'em No Limit - Level XIII (800/1600) - 2024/06/26 19:26:00 UTC [2024/06/26 15:26:00 ET]
Table '3767885527 58' 8-max Seat #3 is the button
Seat 1: leitalopez (44599 in chips) 
Seat 2: Philipoune (61491 in chips) 
Seat 3: Defence_BOMB (31037 in chips) 
Seat 4: Renailmatto (17800 in chips) 
Seat 5: MTTSharkSnG (76700 in chips) 
Seat 7: jammy1875 (137484 in chips) 
Seat 8: oO-HaiRoller-Oo (48600 in chips) 
leitalopez: posts the ante 200
Philipoune: posts the ante 200
Defence_BOMB: posts the ante 200
Renailmatto: posts the ante 200
MTTSharkSnG: posts the ante 200
jammy1875: posts the ante 200
oO-HaiRoller-Oo: posts the ante 200
Renailmatto: posts small blind 800
MTTSharkSnG: posts big blind 1600
*** HOLE CARDS ***
jammy1875: folds 
oO-HaiRoller-Oo: folds 
leitalopez: raises 1600 to 3200
Philipoune: folds 
Defence_BOMB: raises 27637 to 30837 and is all-in
Renailmatto: folds 
MTTSharkSnG: folds 
leitalopez: folds 
Uncalled bet (27637) returned to Defence_BOMB
Defence_BOMB collected 10200 from pot
Defence_BOMB: doesn't show hand 
*** SUMMARY ***
Total pot 10200 | Rake 0 
Seat 1: leitalopez folded before Flop
Seat 2: Philipoune folded before Flop (didn't bet)
Seat 3: Defence_BOMB (button) collected (10200)
Seat 4: Renailmatto (small blind) folded before Flop
Seat 5: MTTSharkSnG (big blind) folded before Flop
Seat 7: jammy1875 folded before Flop (didn't bet)
Seat 8: oO-HaiRoller-Oo folded before Flop (didn't bet)

PokerStars Hand #251205920621: Tournament #3767885527, $40+$10+$5 USD Hold'em No Limit - Level XIII (800/1600) - 2024/06/26 19:26:25 UTC [2024/06/26 15:26:25 ET]
Table '3767885527 58' 8-max Seat #4 is the button
Seat 1: leitalopez (41199 in chips) 
Seat 2: Philipoune (61291 in chips) 
Seat 3: Defence_BOMB (37837 in chips) 
Seat 4: Renailmatto (16800 in chips) 
Seat 5: MTTSharkSnG (74900 in chips) 
Seat 7: jammy1875 (137284 in chips) 
Seat 8: oO-HaiRoller-Oo (48400 in chips) 
leitalopez: posts the ante 200
Philipoune: posts the ante 200
Defence_BOMB: posts the ante 200
Renailmatto: posts the ante 200
MTTSharkSnG: posts the ante 200
jammy1875: posts the ante 200
oO-HaiRoller-Oo: posts the ante 200
MTTSharkSnG: posts small blind 800
jammy1875: posts big blind 1600
*** HOLE CARDS ***
oO-HaiRoller-Oo: folds 
leitalopez: folds 
Philipoune: raises 1600 to 3200
Defence_BOMB: folds 
Renailmatto: folds 
MTTSharkSnG: folds 
jammy1875: folds 
Uncalled bet (1600) returned to Philipoune
Philipoune collected 5400 from pot
Philipoune: doesn't show hand 
*** SUMMARY ***
Total pot 5400 | Rake 0 
Seat 1: leitalopez folded before Flop (didn't bet)
Seat 2: Philipoune collected (5400)
Seat 3: Defence_BOMB folded before Flop (didn't bet)
Seat 4: Renailmatto (button) folded before Flop (didn't bet)
Seat 5: MTTSharkSnG (small blind) folded before Flop
Seat 7: jammy1875 (big blind) folded before Flop
Seat 8: oO-HaiRoller-Oo folded before Flop (didn't bet)

PokerStars Hand #251205929066: Tournament #3767885527, $40+$10+$5 USD Hold'em No Limit - Level XIII (800/1600) - 2024/06/26 19:26:56 UTC [2024/06/26 15:26:56 ET]
Table '3767885527 58' 8-max Seat #5 is the button
Seat 1: leitalopez (40999 in chips) 
Seat 2: Philipoune (64891 in chips) 
Seat 3: Defence_BOMB (37637 in chips) 
Seat 4: Renailmatto (16600 in chips) 
Seat 5: MTTSharkSnG (73900 in chips) 
Seat 7: jammy1875 (135484 in chips) 
Seat 8: oO-HaiRoller-Oo (48200 in chips) 
leitalopez: posts the ante 200
Philipoune: posts the ante 200
Defence_BOMB: posts the ante 200
Renailmatto: posts the ante 200
MTTSharkSnG: posts the ante 200
jammy1875: posts the ante 200
oO-HaiRoller-Oo: posts the ante 200
jammy1875: posts small blind 800
oO-HaiRoller-Oo: posts big blind 1600
*** HOLE CARDS ***
JovemPromessa is disconnected 
leitalopez: folds 
Philipoune: raises 1600 to 3200
Defence_BOMB: folds 
Renailmatto: folds 
MTTSharkSnG: folds 
jammy1875: raises 8000 to 11200
oO-HaiRoller-Oo: folds 
Philipoune: calls 8000
*** FLOP *** [9s 2s 8c]
jammy1875: bets 9600
Philipoune: calls 9600
*** TURN *** [9s 2s 8c] [5c]
jammy1875: bets 44600
Philipoune: calls 43891 and is all-in
Uncalled bet (709) returned to jammy1875
*** RIVER *** [9s 2s 8c 5c] [As]
*** SHOW DOWN ***
jammy1875: shows [7d 7s] (a pair of Sevens)
Philipoune: shows [9h 9d] (three of a kind, Nines)
Philipoune collected 132382 from pot
*** SUMMARY ***
Total pot 132382 | Rake 0 
Board [9s 2s 8c 5c As]
Seat 1: leitalopez folded before Flop (didn't bet)
Seat 2: Philipoune showed [9h 9d] and won (132382) with three of a kind, Nines
Seat 3: Defence_BOMB folded before Flop (didn't bet)
Seat 4: Renailmatto folded before Flop (didn't bet)
Seat 5: MTTSharkSnG (button) folded before Flop (didn't bet)
Seat 7: jammy1875 (small blind) showed [7d 7s] and lost with a pair of Sevens
Seat 8: oO-HaiRoller-Oo (big blind) folded before Flop

PokerStars Hand #251205954734: Tournament #3767885527, $40+$10+$5 USD Hold'em No Limit - Level XIII (800/1600) - 2024/06/26 19:28:32 UTC [2024/06/26 15:28:32 ET]
Table '3767885527 58' 8-max Seat #7 is the button
Seat 1: leitalopez (40799 in chips) 
Seat 2: Philipoune (132382 in chips) 
Seat 3: Defence_BOMB (37437 in chips) 
Seat 4: Renailmatto (16400 in chips) 
Seat 5: MTTSharkSnG (73700 in chips) 
Seat 6: JovemPromessa (25000 in chips) 
Seat 7: jammy1875 (70593 in chips) 
Seat 8: oO-HaiRoller-Oo (46400 in chips) 
leitalopez: posts the ante 200
Philipoune: posts the ante 200
Defence_BOMB: posts the ante 200
Renailmatto: posts the ante 200
MTTSharkSnG: posts the ante 200
JovemPromessa: posts the ante 200
jammy1875: posts the ante 200
oO-HaiRoller-Oo: posts the ante 200
oO-HaiRoller-Oo: posts small blind 800
leitalopez: posts big blind 1600
*** HOLE CARDS ***
Philipoune: folds 
Defence_BOMB: raises 1920 to 3520
Renailmatto: calls 3520
MTTSharkSnG: folds 
JovemPromessa: raises 20480 to 24000
jammy1875: folds 
oO-HaiRoller-Oo: folds 
leitalopez: folds 
Defence_BOMB: folds 
Renailmatto: calls 12680 and is all-in
Uncalled bet (7800) returned to JovemPromessa
*** FLOP *** [Ac Qh 4s]
*** TURN *** [Ac Qh 4s] [7h]
*** RIVER *** [Ac Qh 4s 7h] [Kh]
*** SHOW DOWN ***
Renailmatto: shows [Th 9h] (a flush, King high)
JovemPromessa: shows [Jh As] (a pair of Aces)
Renailmatto collected 39920 from pot
*** SUMMARY ***
Total pot 39920 | Rake 0 
Board [Ac Qh 4s 7h Kh]
Seat 1: leitalopez (big blind) folded before Flop
Seat 2: Philipoune folded before Flop (didn't bet)
Seat 3: Defence_BOMB folded before Flop
Seat 4: Renailmatto showed [Th 9h] and won (39920) with a flush, King high
Seat 5: MTTSharkSnG folded before Flop (didn't bet)
Seat 6: JovemPromessa showed [Jh As] and lost with a pair of Aces
Seat 7: jammy1875 (button) folded before Flop (didn't bet)
Seat 8: oO-HaiRoller-Oo (small blind) folded before Flop

PokerStars Hand #251205965990: Tournament #3767885527, $40+$10+$5 USD Hold'em No Limit - Level XIV (1000/2000) - 2024/06/26 19:29:14 UTC [2024/06/26 15:29:14 ET]
Table '3767885527 58' 8-max Seat #8 is the button
Seat 1: leitalopez (38999 in chips) 
Seat 2: Philipoune (132182 in chips) 
Seat 3: Defence_BOMB (33717 in chips) 
Seat 4: Renailmatto (39920 in chips) 
Seat 5: MTTSharkSnG (73500 in chips) 
Seat 6: JovemPromessa (8600 in chips) 
Seat 7: jammy1875 (70393 in chips) 
Seat 8: oO-HaiRoller-Oo (45400 in chips) 
leitalopez: posts the ante 250
Philipoune: posts the ante 250
Defence_BOMB: posts the ante 250
Renailmatto: posts the ante 250
MTTSharkSnG: posts the ante 250
JovemPromessa: posts the ante 250
jammy1875: posts the ante 250
oO-HaiRoller-Oo: posts the ante 250
leitalopez: posts small blind 1000
Philipoune: posts big blind 2000
*** HOLE CARDS ***
Defence_BOMB: folds 
Renailmatto: folds 
MTTSharkSnG: folds 
JovemPromessa: folds 
jammy1875: folds 
oO-HaiRoller-Oo: raises 2200 to 4200
leitalopez: raises 34549 to 38749 and is all-in
Philipoune: folds 
oO-HaiRoller-Oo: folds [Kc]
Uncalled bet (34549) returned to leitalopez
leitalopez collected 12400 from pot
leitalopez: doesn't show hand 
*** SUMMARY ***
Total pot 12400 | Rake 0 
Seat 1: leitalopez (small blind) collected (12400)
Seat 2: Philipoune (big blind) folded before Flop
Seat 3: Defence_BOMB folded before Flop (didn't bet)
Seat 4: Renailmatto folded before Flop (didn't bet)
Seat 5: MTTSharkSnG folded before Flop (didn't bet)
Seat 6: JovemPromessa folded before Flop (didn't bet)
Seat 7: jammy1875 folded before Flop (didn't bet)
Seat 8: oO-HaiRoller-Oo (button) folded before Flop

PokerStars Hand #251205979313: Tournament #3767885527, $40+$10+$5 USD Hold'em No Limit - Level XIV (1000/2000) - 2024/06/26 19:30:02 UTC [2024/06/26 15:30:02 ET]
Table '3767885527 58' 8-max Seat #1 is the button
Seat 1: leitalopez (46949 in chips) 
Seat 2: Philipoune (129932 in chips) 
Seat 3: Defence_BOMB (33467 in chips) 
Seat 4: Renailmatto (39670 in chips) 
Seat 5: MTTSharkSnG (73250 in chips) 
Seat 6: JovemPromessa (8350 in chips) 
Seat 7: jammy1875 (70143 in chips) 
Seat 8: oO-HaiRoller-Oo (40950 in chips) 
leitalopez: posts the ante 250
Philipoune: posts the ante 250
Defence_BOMB: posts the ante 250
Renailmatto: posts the ante 250
MTTSharkSnG: posts the ante 250
JovemPromessa: posts the ante 250
jammy1875: posts the ante 250
oO-HaiRoller-Oo: posts the ante 250
Philipoune: posts small blind 1000
Defence_BOMB: posts big blind 2000
*** HOLE CARDS ***
Renailmatto: folds 
MTTSharkSnG: folds 
JovemPromessa: folds 
jammy1875: raises 2000 to 4000
oO-HaiRoller-Oo: folds 
leitalopez: folds 
Philipoune: folds 
Defence_BOMB: raises 29217 to 33217 and is all-in
jammy1875: calls 29217
*** FLOP *** [Kh 2s Th]
*** TURN *** [Kh 2s Th] [3c]
*** RIVER *** [Kh 2s Th 3c] [Jh]
*** SHOW DOWN ***
Defence_BOMB: shows [5s 5h] (a pair of Fives)
jammy1875: shows [Kc Ts] (two pair, Kings and Tens)
jammy1875 collected 69434 from pot
Defence_BOMB finished the tournament
*** SUMMARY ***
Total pot 69434 | Rake 0 
Board [Kh 2s Th 3c Jh]
Seat 1: leitalopez (button) folded before Flop (didn't bet)
Seat 2: Philipoune (small blind) folded before Flop
Seat 3: Defence_BOMB (big blind) showed [5s 5h] and lost with a pair of Fives
Seat 4: Renailmatto folded before Flop (didn't bet)
Seat 5: MTTSharkSnG folded before Flop (didn't bet)
Seat 6: JovemPromessa folded before Flop (didn't bet)
Seat 7: jammy1875 showed [Kc Ts] and won (69434) with two pair, Kings and Tens
Seat 8: oO-HaiRoller-Oo folded before Flop (didn't bet)

PokerStars Hand #251205991436: Tournament #3767885527, $40+$10+$5 USD Hold'em No Limit - Level XIV (1000/2000) - 2024/06/26 19:30:46 UTC [2024/06/26 15:30:46 ET]
Table '3767885527 58' 8-max Seat #2 is the button
Seat 1: leitalopez (46699 in chips) 
Seat 2: Philipoune (128682 in chips) 
Seat 4: Renailmatto (39420 in chips) 
Seat 5: MTTSharkSnG (73000 in chips) 
Seat 6: JovemPromessa (8100 in chips) 
Seat 7: jammy1875 (106110 in chips) 
Seat 8: oO-HaiRoller-Oo (40700 in chips) 
leitalopez: posts the ante 250
Philipoune: posts the ante 250
Renailmatto: posts the ante 250
MTTSharkSnG: posts the ante 250
JovemPromessa: posts the ante 250
jammy1875: posts the ante 250
oO-HaiRoller-Oo: posts the ante 250
Renailmatto: posts small blind 1000
MTTSharkSnG: posts big blind 2000
*** HOLE CARDS ***
JovemPromessa: raises 4000 to 6000
jammy1875: calls 6000
oO-HaiRoller-Oo: folds 
leitalopez: folds 
Philipoune: raises 122432 to 128432 and is all-in
Renailmatto: folds 
MTTSharkSnG: folds 
JovemPromessa: calls 1850 and is all-in
jammy1875: folds 
Uncalled bet (120582) returned to Philipoune
*** FLOP *** [2d 8d 4c]
*** TURN *** [2d 8d 4c] [5d]
*** RIVER *** [2d 8d 4c 5d] [7h]
*** SHOW DOWN ***
JovemPromessa: shows [Jc Ac] (high card Ace)
Philipoune: shows [9s 9h] (a pair of Nines)
Philipoune collected 26450 from pot
JovemPromessa finished the tournament
*** SUMMARY ***
Total pot 26450 | Rake 0 
Board [2d 8d 4c 5d 7h]
Seat 1: leitalopez folded before Flop (didn't bet)
Seat 2: Philipoune (button) showed [9s 9h] and won (26450) with a pair of Nines
Seat 4: Renailmatto (small blind) folded before Flop
Seat 5: MTTSharkSnG (big blind) folded before Flop
Seat 6: JovemPromessa showed [Jc Ac] and lost with high card Ace
Seat 7: jammy1875 folded before Flop
Seat 8: oO-HaiRoller-Oo folded before Flop (didn't bet)

PokerStars Hand #251205999281: Tournament #3767885527, $40+$10+$5 USD Hold'em No Limit - Level XIV (1000/2000) - 2024/06/26 19:31:15 UTC [2024/06/26 15:31:15 ET]
Table '3767885527 58' 8-max Seat #4 is the button
Seat 1: leitalopez (46449 in chips) 
Seat 2: Philipoune (147032 in chips) 
Seat 4: Renailmatto (38170 in chips) 
Seat 5: MTTSharkSnG (70750 in chips) 
Seat 7: jammy1875 (99860 in chips) 
Seat 8: oO-HaiRoller-Oo (40450 in chips) 
leitalopez: posts the ante 250
Philipoune: posts the ante 250
Renailmatto: posts the ante 250
MTTSharkSnG: posts the ante 250
jammy1875: posts the ante 250
oO-HaiRoller-Oo: posts the ante 250
MTTSharkSnG: posts small blind 1000
jammy1875: posts big blind 2000
*** HOLE CARDS ***
jeyun is disconnected 
oO-HaiRoller-Oo: raises 2200 to 4200
leitalopez: folds 
Philipoune: folds 
Renailmatto: folds 
MTTSharkSnG: folds 
jammy1875: folds 
Uncalled bet (2200) returned to oO-HaiRoller-Oo
oO-HaiRoller-Oo collected 6500 from pot
oO-HaiRoller-Oo: doesn't show hand 
tarantullv is disconnected 
*** SUMMARY ***
Total pot 6500 | Rake 0 
Seat 1: leitalopez folded before Flop (didn't bet)
Seat 2: Philipoune folded before Flop (didn't bet)
Seat 4: Renailmatto (button) folded before Flop (didn't bet)
Seat 5: MTTSharkSnG (small blind) folded before Flop
Seat 7: jammy1875 (big blind) folded before Flop
Seat 8: oO-HaiRoller-Oo collected (6500)

PokerStars Hand #251206003860: Tournament #3767885527, $40+$10+$5 USD Hold'em No Limit - Level XIV (1000/2000) - 2024/06/26 19:31:31 UTC [2024/06/26 15:31:31 ET]
Table '3767885527 58' 8-max Seat #5 is the button
Seat 1: leitalopez (46199 in chips) 
Seat 2: Philipoune (146782 in chips) 
Seat 3: jeyun (38917 in chips) 
Seat 4: Renailmatto (37920 in chips) 
Seat 5: MTTSharkSnG (69500 in chips) 
Seat 6: tarantullv (25000 in chips) out of hand (moved from another table into small blind)
Seat 7: jammy1875 (97610 in chips) 
Seat 8: oO-HaiRoller-Oo (44700 in chips) 
tarantullv will be allowed to play after the button
leitalopez: posts the ante 250
Philipoune: posts the ante 250
jeyun: posts the ante 250
Renailmatto: posts the ante 250
MTTSharkSnG: posts the ante 250
jammy1875: posts the ante 250
oO-HaiRoller-Oo: posts the ante 250
jammy1875: posts small blind 1000
oO-HaiRoller-Oo: posts big blind 2000
*** HOLE CARDS ***
leitalopez: folds 
Philipoune: folds 
jeyun: raises 2000 to 4000
Renailmatto: folds 
MTTSharkSnG: folds 
jammy1875: folds 
oO-HaiRoller-Oo: calls 2000
*** FLOP *** [Td 6s 3s]
oO-HaiRoller-Oo: checks 
jeyun: bets 3548
oO-HaiRoller-Oo: folds 
Uncalled bet (3548) returned to jeyun
jeyun collected 10750 from pot
*** SUMMARY ***
Total pot 10750 | Rake 0 
Board [Td 6s 3s]
Seat 1: leitalopez folded before Flop (didn't bet)
Seat 2: Philipoune folded before Flop (didn't bet)
Seat 3: jeyun collected (10750)
Seat 4: Renailmatto folded before Flop (didn't bet)
Seat 5: MTTSharkSnG (button) folded before Flop (didn't bet)
Seat 7: jammy1875 (small blind) folded before Flop
Seat 8: oO-HaiRoller-Oo (big blind) folded on the Flop

PokerStars Hand #251206017275: Tournament #3767885527, $40+$10+$5 USD Hold'em No Limit - Level XIV (1000/2000) - 2024/06/26 19:32:20 UTC [2024/06/26 15:32:20 ET]
Table '3767885527 58' 8-max Seat #7 is the button
Seat 1: leitalopez (45949 in chips) 
Seat 2: Philipoune (146532 in chips) 
Seat 3: jeyun (45417 in chips) 
Seat 4: Renailmatto (37670 in chips) 
Seat 5: MTTSharkSnG (69250 in chips) 
Seat 6: tarantullv (25000 in chips) 
Seat 7: jammy1875 (96360 in chips) 
Seat 8: oO-HaiRoller-Oo (40450 in chips) 
leitalopez: posts the ante 250
Philipoune: posts the ante 250
jeyun: posts the ante 250
Renailmatto: posts the ante 250
MTTSharkSnG: posts the ante 250
tarantullv: posts the ante 250
jammy1875: posts the ante 250
oO-HaiRoller-Oo: posts the ante 250
oO-HaiRoller-Oo: posts small blind 1000
leitalopez: posts big blind 2000
*** HOLE CARDS ***
Philipoune: folds 
jeyun: folds 
Renailmatto: folds 
MTTSharkSnG: raises 2000 to 4000
tarantullv: raises 20750 to 24750 and is all-in
jammy1875: folds 
oO-HaiRoller-Oo: folds 
leitalopez: folds 
MTTSharkSnG: folds 
Uncalled bet (20750) returned to tarantullv
tarantullv collected 13000 from pot
tarantullv: doesn't show hand 
*** SUMMARY ***
Total pot 13000 | Rake 0 
Seat 1: leitalopez (big blind) folded before Flop
Seat 2: Philipoune folded before Flop (didn't bet)
Seat 3: jeyun folded before Flop (didn't bet)
Seat 4: Renailmatto folded before Flop (didn't bet)
Seat 5: MTTSharkSnG folded before Flop
Seat 6: tarantullv collected (13000)
Seat 7: jammy1875 (button) folded before Flop (didn't bet)
Seat 8: oO-HaiRoller-Oo (small blind) folded before Flop

PokerStars Hand #251206024916: Tournament #3767885527, $40+$10+$5 USD Hold'em No Limit - Level XIV (1000/2000) - 2024/06/26 19:32:48 UTC [2024/06/26 15:32:48 ET]
Table '3767885527 58' 8-max Seat #8 is the button
Seat 1: leitalopez (43699 in chips) 
Seat 2: Philipoune (146282 in chips) 
Seat 3: jeyun (45167 in chips) 
Seat 4: Renailmatto (37420 in chips) 
Seat 5: MTTSharkSnG (65000 in chips) 
Seat 6: tarantullv (33750 in chips) 
Seat 7: jammy1875 (96110 in chips) 
Seat 8: oO-HaiRoller-Oo (39200 in chips) 
leitalopez: posts the ante 250
Philipoune: posts the ante 250
jeyun: posts the ante 250
Renailmatto: posts the ante 250
MTTSharkSnG: posts the ante 250
tarantullv: posts the ante 250
jammy1875: posts the ante 250
oO-HaiRoller-Oo: posts the ante 250
leitalopez: posts small blind 1000
Philipoune: posts big blind 2000
*** HOLE CARDS ***
jeyun: folds 
Renailmatto: folds 
MTTSharkSnG: folds 
tarantullv: folds 
jammy1875: folds 
oO-HaiRoller-Oo: raises 36950 to 38950 and is all-in
leitalopez: folds 
Philipoune: folds 
Uncalled bet (36950) returned to oO-HaiRoller-Oo
oO-HaiRoller-Oo collected 7000 from pot
oO-HaiRoller-Oo: doesn't show hand 
*** SUMMARY ***
Total pot 7000 | Rake 0 
Seat 1: leitalopez (small blind) folded before Flop
Seat 2: Philipoune (big blind) folded before Flop
Seat 3: jeyun folded before Flop (didn't bet)
Seat 4: Renailmatto folded before Flop (didn't bet)
Seat 5: MTTSharkSnG folded before Flop (didn't bet)
Seat 6: tarantullv folded before Flop (didn't bet)
Seat 7: jammy1875 folded before Flop (didn't bet)
Seat 8: oO-HaiRoller-Oo (button) collected (7000)

PokerStars Hand #251206029154: Tournament #3767885527, $40+$10+$5 USD Hold'em No Limit - Level XIV (1000/2000) - 2024/06/26 19:33:04 UTC [2024/06/26 15:33:04 ET]
Table '3767885527 58' 8-max Seat #1 is the button
Seat 1: leitalopez (42449 in chips) 
Seat 2: Philipoune (144032 in chips) 
Seat 3: jeyun (44917 in chips) 
Seat 4: Renailmatto (37170 in chips) 
Seat 5: MTTSharkSnG (64750 in chips) 
Seat 6: tarantullv (33500 in chips) 
Seat 7: jammy1875 (95860 in chips) 
Seat 8: oO-HaiRoller-Oo (43950 in chips) 
leitalopez: posts the ante 250
Philipoune: posts the ante 250
jeyun: posts the ante 250
Renailmatto: posts the ante 250
MTTSharkSnG: posts the ante 250
tarantullv: posts the ante 250
jammy1875: posts the ante 250
oO-HaiRoller-Oo: posts the ante 250
Philipoune: posts small blind 1000
jeyun: posts big blind 2000
*** HOLE CARDS ***
Renailmatto: folds 
MTTSharkSnG: raises 2000 to 4000
tarantullv: folds 
jammy1875: calls 4000
oO-HaiRoller-Oo: folds 
leitalopez: folds 
Philipoune: folds 
jeyun: calls 2000
*** FLOP *** [Ac As 6c]
jeyun: checks 
MTTSharkSnG: bets 4318
jammy1875: calls 4318
jeyun: folds 
*** TURN *** [Ac As 6c] [Qs]
MTTSharkSnG: bets 8758
jammy1875: calls 8758
*** RIVER *** [Ac As 6c Qs] [9c]
MTTSharkSnG: checks 
jammy1875: bets 22576
MTTSharkSnG: folds 
Uncalled bet (22576) returned to jammy1875
jammy1875 collected 41152 from pot
*** SUMMARY ***
Total pot 41152 | Rake 0 
Board [Ac As 6c Qs 9c]
Seat 1: leitalopez (button) folded before Flop (didn't bet)
Seat 2: Philipoune (small blind) folded before Flop
Seat 3: jeyun (big blind) folded on the Flop
Seat 4: Renailmatto folded before Flop (didn't bet)
Seat 5: MTTSharkSnG folded on the River
Seat 6: tarantullv folded before Flop (didn't bet)
Seat 7: jammy1875 collected (41152)
Seat 8: oO-HaiRoller-Oo folded before Flop (didn't bet)

PokerStars Hand #251206061077: Tournament #3767885527, $40+$10+$5 USD Hold'em No Limit - Level XIV (1000/2000) - 2024/06/26 19:35:00 UTC [2024/06/26 15:35:00 ET]
Table '3767885527 58' 8-max Seat #2 is the button
Seat 1: leitalopez (42199 in chips) 
Seat 2: Philipoune (142782 in chips) 
Seat 3: jeyun (40667 in chips) 
Seat 4: Renailmatto (36920 in chips) 
Seat 5: MTTSharkSnG (47424 in chips) 
Seat 6: tarantullv (33250 in chips) 
Seat 7: jammy1875 (119686 in chips) 
Seat 8: oO-HaiRoller-Oo (43700 in chips) 
leitalopez: posts the ante 250
Philipoune: posts the ante 250
jeyun: posts the ante 250
Renailmatto: posts the ante 250
MTTSharkSnG: posts the ante 250
tarantullv: posts the ante 250
jammy1875: posts the ante 250
oO-HaiRoller-Oo: posts the ante 250
jeyun: posts small blind 1000
Renailmatto: posts big blind 2000
*** HOLE CARDS ***
MTTSharkSnG: folds 
tarantullv: folds 
jammy1875: raises 2000 to 4000
oO-HaiRoller-Oo: folds 
leitalopez: folds 
Philipoune: folds 
jeyun: raises 36417 to 40417 and is all-in
Renailmatto: folds 
jammy1875: folds 
Uncalled bet (36417) returned to jeyun
jeyun collected 12000 from pot
*** SUMMARY ***
Total pot 12000 | Rake 0 
Seat 1: leitalopez folded before Flop (didn't bet)
Seat 2: Philipoune (button) folded before Flop (didn't bet)
Seat 3: jeyun (small blind) collected (12000)
Seat 4: Renailmatto (big blind) folded before Flop
Seat 5: MTTSharkSnG folded before Flop (didn't bet)
Seat 6: tarantullv folded before Flop (didn't bet)
Seat 7: jammy1875 folded before Flop
Seat 8: oO-HaiRoller-Oo folded before Flop (didn't bet)

PokerStars Hand #251206071448: Tournament #3767885527, $40+$10+$5 USD Hold'em No Limit - Level XIV (1000/2000) - 2024/06/26 19:35:38 UTC [2024/06/26 15:35:38 ET]
Table '3767885527 58' 8-max Seat #3 is the button
Seat 1: leitalopez (41949 in chips) 
Seat 2: Philipoune (142532 in chips) 
Seat 3: jeyun (48417 in chips) 
Seat 4: Renailmatto (34670 in chips) 
Seat 5: MTTSharkSnG (47174 in chips) 
Seat 6: tarantullv (33000 in chips) 
Seat 7: jammy1875 (115436 in chips) 
Seat 8: oO-HaiRoller-Oo (43450 in chips) 
leitalopez: posts the ante 250
Philipoune: posts the ante 250
jeyun: posts the ante 250
Renailmatto: posts the ante 250
MTTSharkSnG: posts the ante 250
tarantullv: posts the ante 250
jammy1875: posts the ante 250
oO-HaiRoller-Oo: posts the ante 250
Renailmatto: posts small blind 1000
MTTSharkSnG: posts big blind 2000
*** HOLE CARDS ***
tarantullv: folds 
jammy1875: folds 
oO-HaiRoller-Oo: raises 2200 to 4200
leitalopez: folds 
Philipoune: folds 
jeyun: folds 
Renailmatto: calls 3200
MTTSharkSnG: calls 2200
*** FLOP *** [6s Ts Ah]
Renailmatto: checks 
MTTSharkSnG: checks 
oO-HaiRoller-Oo: bets 6000
Renailmatto: folds 
MTTSharkSnG: folds 
Uncalled bet (6000) returned to oO-HaiRoller-Oo
oO-HaiRoller-Oo collected 14600 from pot
oO-HaiRoller-Oo: doesn't show hand 
*** SUMMARY ***
Total pot 14600 | Rake 0 
Board [6s Ts Ah]
Seat 1: leitalopez folded before Flop (didn't bet)
Seat 2: Philipoune folded before Flop (didn't bet)
Seat 3: jeyun (button) folded before Flop (didn't bet)
Seat 4: Renailmatto (small blind) folded on the Flop
Seat 5: MTTSharkSnG (big blind) folded on the Flop
Seat 6: tarantullv folded before Flop (didn't bet)
Seat 7: jammy1875 folded before Flop (didn't bet)
Seat 8: oO-HaiRoller-Oo collected (14600)

PokerStars Hand #251206081406: Tournament #3767885527, $40+$10+$5 USD Hold'em No Limit - Level XIV (1000/2000) - 2024/06/26 19:36:14 UTC [2024/06/26 15:36:14 ET]
Table '3767885527 58' 8-max Seat #4 is the button
Seat 1: leitalopez (41699 in chips) 
Seat 2: Philipoune (142282 in chips) 
Seat 3: jeyun (48167 in chips) 
Seat 4: Renailmatto (30220 in chips) 
Seat 5: MTTSharkSnG (42724 in chips) 
Seat 6: tarantullv (32750 in chips) 
Seat 7: jammy1875 (115186 in chips) 
Seat 8: oO-HaiRoller-Oo (53600 in chips) 
leitalopez: posts the ante 250
Philipoune: posts the ante 250
jeyun: posts the ante 250
Renailmatto: posts the ante 250
MTTSharkSnG: posts the ante 250
tarantullv: posts the ante 250
jammy1875: posts the ante 250
oO-HaiRoller-Oo: posts the ante 250
MTTSharkSnG: posts small blind 1000
tarantullv: posts big blind 2000
*** HOLE CARDS ***
jammy1875: folds 
oO-HaiRoller-Oo: folds 
leitalopez: folds 
Philipoune: folds 
jeyun: folds 
Renailmatto: folds 
MTTSharkSnG: folds 
Uncalled bet (1000) returned to tarantullv
tarantullv collected 4000 from pot
tarantullv: doesn't show hand 
*** SUMMARY ***
Total pot 4000 | Rake 0 
Seat 1: leitalopez folded before Flop (didn't bet)
Seat 2: Philipoune folded before Flop (didn't bet)
Seat 3: jeyun folded before Flop (didn't bet)
Seat 4: Renailmatto (button) folded before Flop (didn't bet)
Seat 5: MTTSharkSnG (small blind) folded before Flop
Seat 6: tarantullv (big blind) collected (4000)
Seat 7: jammy1875 folded before Flop (didn't bet)
Seat 8: oO-HaiRoller-Oo folded before Flop (didn't bet)

PokerStars Hand #251206083960: Tournament #3767885527, $40+$10+$5 USD Hold'em No Limit - Level XIV (1000/2000) - 2024/06/26 19:36:24 UTC [2024/06/26 15:36:24 ET]
Table '3767885527 58' 8-max Seat #5 is the button
Seat 1: leitalopez (41449 in chips) 
Seat 2: Philipoune (142032 in chips) 
Seat 3: jeyun (47917 in chips) 
Seat 4: Renailmatto (29970 in chips) 
Seat 5: MTTSharkSnG (41474 in chips) 
Seat 6: tarantullv (35500 in chips) 
Seat 7: jammy1875 (114936 in chips) 
Seat 8: oO-HaiRoller-Oo (53350 in chips) 
leitalopez: posts the ante 250
Philipoune: posts the ante 250
jeyun: posts the ante 250
Renailmatto: posts the ante 250
MTTSharkSnG: posts the ante 250
tarantullv: posts the ante 250
jammy1875: posts the ante 250
oO-HaiRoller-Oo: posts the ante 250
tarantullv: posts small blind 1000
jammy1875: posts big blind 2000
*** HOLE CARDS ***
oO-HaiRoller-Oo: folds 
leitalopez: raises 2000 to 4000
Philipoune: folds 
jeyun: folds 
Renailmatto: folds 
MTTSharkSnG: folds 
tarantullv: folds 
jammy1875: raises 110686 to 114686 and is all-in
leitalopez: calls 37199 and is all-in
Uncalled bet (73487) returned to jammy1875
*** FLOP *** [Ks 6c 4s]
*** TURN *** [Ks 6c 4s] [3h]
*** RIVER *** [Ks 6c 4s 3h] [2h]
*** SHOW DOWN ***
jammy1875: shows [2d 2c] (three of a kind, Deuces)
leitalopez: shows [Tc Td] (a pair of Tens)
jammy1875 collected 85398 from pot
leitalopez finished the tournament in 645th place
*** SUMMARY ***
Total pot 85398 | Rake 0 
Board [Ks 6c 4s 3h 2h]
Seat 1: leitalopez showed [Tc Td] and lost with a pair of Tens
Seat 2: Philipoune folded before Flop (didn't bet)
Seat 3: jeyun folded before Flop (didn't bet)
Seat 4: Renailmatto folded before Flop (didn't bet)
Seat 5: MTTSharkSnG (button) folded before Flop (didn't bet)
Seat 6: tarantullv (small blind) folded before Flop
Seat 7: jammy1875 (big blind) showed [2d 2c] and won (85398) with three of a kind, Deuces
Seat 8: oO-HaiRoller-Oo folded before Flop (didn't bet)


PokerStars Hand #251206681673: Tournament #3767885527, $40+$10+$5 USD Hold'em No Limit - Level XVII (1750/3500) - 2024/06/26 20:13:26 UTC [2024/06/26 16:13:26 ET]
Table '3767885527 57' 8-max Seat #1 is the button
Seat 1: yaniw777 (117541 in chips) 
Seat 2: LV_Arturs (62787 in chips) 
Seat 3: fellipeschmeil (55233 in chips) 
Seat 4: chuchukat (271199 in chips) 
Seat 5: lftgjc (137479 in chips) 
Seat 6: PavanaTTo23 (28951 in chips) 
Seat 7: drinho2pac (89661 in chips) 
Seat 8: Pedrozadota (111334 in chips) 
yaniw777: posts the ante 450
LV_Arturs: posts the ante 450
fellipeschmeil: posts the ante 450
chuchukat: posts the ante 450
lftgjc: posts the ante 450
PavanaTTo23: posts the ante 450
drinho2pac: posts the ante 450
Pedrozadota: posts the ante 450
LV_Arturs: posts small blind 1750
fellipeschmeil: posts big blind 3500
*** HOLE CARDS ***
chuchukat: raises 3500 to 7000
lftgjc: folds 
PavanaTTo23: folds 
drinho2pac: folds 
Pedrozadota: raises 3500 to 10500
yaniw777: folds 
LV_Arturs: folds 
fellipeschmeil: folds 
chuchukat: raises 260249 to 270749 and is all-in
Pedrozadota: folds 
Uncalled bet (260249) returned to chuchukat
chuchukat collected 29850 from pot
chuchukat: doesn't show hand 
*** SUMMARY ***
Total pot 29850 | Rake 0 
Seat 1: yaniw777 (button) folded before Flop (didn't bet)
Seat 2: LV_Arturs (small blind) folded before Flop
Seat 3: fellipeschmeil (big blind) folded before Flop
Seat 4: chuchukat collected (29850)
Seat 5: lftgjc folded before Flop (didn't bet)
Seat 6: PavanaTTo23 folded before Flop (didn't bet)
Seat 7: drinho2pac folded before Flop (didn't bet)
Seat 8: Pedrozadota folded before Flop

PokerStars Hand #251206693722: Tournament #3767885527, $40+$10+$5 USD Hold'em No Limit - Level XVII (1750/3500) - 2024/06/26 20:14:10 UTC [2024/06/26 16:14:10 ET]
Table '3767885527 57' 8-max Seat #2 is the button
Seat 1: yaniw777 (117091 in chips) 
Seat 2: LV_Arturs (60587 in chips) 
Seat 3: fellipeschmeil (51283 in chips) 
Seat 4: chuchukat (290099 in chips) 
Seat 5: lftgjc (137029 in chips) 
Seat 6: PavanaTTo23 (28501 in chips) 
Seat 7: drinho2pac (89211 in chips) 
Seat 8: Pedrozadota (100384 in chips) 
yaniw777: posts the ante 450
LV_Arturs: posts the ante 450
fellipeschmeil: posts the ante 450
chuchukat: posts the ante 450
lftgjc: posts the ante 450
PavanaTTo23: posts the ante 450
drinho2pac: posts the ante 450
Pedrozadota: posts the ante 450
fellipeschmeil: posts small blind 1750
chuchukat: posts big blind 3500
*** HOLE CARDS ***
lftgjc: folds 
PavanaTTo23: folds 
drinho2pac: raises 3850 to 7350
Pedrozadota: folds 
yaniw777: folds 
LV_Arturs: calls 7350
fellipeschmeil: folds 
chuchukat: folds 
*** FLOP *** [3h 7d 7c]
drinho2pac: checks 
LV_Arturs: checks 
*** TURN *** [3h 7d 7c] [9s]
drinho2pac: checks 
LV_Arturs: bets 7065
drinho2pac: calls 7065
*** RIVER *** [3h 7d 7c 9s] [5s]
drinho2pac: checks 
LV_Arturs: checks 
*** SHOW DOWN ***
drinho2pac: shows [Td Ad] (a pair of Sevens)
LV_Arturs: shows [As 3s] (two pair, Sevens and Threes)
LV_Arturs collected 37680 from pot
*** SUMMARY ***
Total pot 37680 | Rake 0 
Board [3h 7d 7c 9s 5s]
Seat 1: yaniw777 folded before Flop (didn't bet)
Seat 2: LV_Arturs (button) showed [As 3s] and won (37680) with two pair, Sevens and Threes
Seat 3: fellipeschmeil (small blind) folded before Flop
Seat 4: chuchukat (big blind) folded before Flop
Seat 5: lftgjc folded before Flop (didn't bet)
Seat 6: PavanaTTo23 folded before Flop (didn't bet)
Seat 7: drinho2pac showed [Td Ad] and lost with a pair of Sevens
Seat 8: Pedrozadota folded before Flop (didn't bet)

PokerStars Hand #251206715099: Tournament #3767885527, $40+$10+$5 USD Hold'em No Limit - Level XVII (1750/3500) - 2024/06/26 20:15:25 UTC [2024/06/26 16:15:25 ET]
Table '3767885527 57' 8-max Seat #3 is the button
Seat 1: yaniw777 (116641 in chips) 
Seat 2: LV_Arturs (83402 in chips) 
Seat 3: fellipeschmeil (49083 in chips) 
Seat 4: chuchukat (286149 in chips) 
Seat 5: lftgjc (136579 in chips) 
Seat 6: PavanaTTo23 (28051 in chips) 
Seat 7: drinho2pac (74346 in chips) 
Seat 8: Pedrozadota (99934 in chips) 
yaniw777: posts the ante 450
LV_Arturs: posts the ante 450
fellipeschmeil: posts the ante 450
chuchukat: posts the ante 450
lftgjc: posts the ante 450
PavanaTTo23: posts the ante 450
drinho2pac: posts the ante 450
Pedrozadota: posts the ante 450
chuchukat: posts small blind 1750
lftgjc: posts big blind 3500
*** HOLE CARDS ***
PavanaTTo23: folds 
drinho2pac: folds 
Pedrozadota: folds 
yaniw777: folds 
LV_Arturs: raises 3675 to 7175
fellipeschmeil: folds 
chuchukat: folds 
lftgjc: calls 3675
*** FLOP *** [7c 8s Qh]
lftgjc: checks 
LV_Arturs: checks 
*** TURN *** [7c 8s Qh] [Kd]
lftgjc: checks 
LV_Arturs: bets 12250
lftgjc: folds 
Uncalled bet (12250) returned to LV_Arturs
LV_Arturs collected 19700 from pot
*** SUMMARY ***
Total pot 19700 | Rake 0 
Board [7c 8s Qh Kd]
Seat 1: yaniw777 folded before Flop (didn't bet)
Seat 2: LV_Arturs collected (19700)
Seat 3: fellipeschmeil (button) folded before Flop (didn't bet)
Seat 4: chuchukat (small blind) folded before Flop
Seat 5: lftgjc (big blind) folded on the Turn
Seat 6: PavanaTTo23 folded before Flop (didn't bet)
Seat 7: drinho2pac folded before Flop (didn't bet)
Seat 8: Pedrozadota folded before Flop (didn't bet)

PokerStars Hand #251206737415: Tournament #3767885527, $40+$10+$5 USD Hold'em No Limit - Level XVIII (2000/4000) - 2024/06/26 20:16:45 UTC [2024/06/26 16:16:45 ET]
Table '3767885527 57' 8-max Seat #4 is the button
Seat 1: yaniw777 (116191 in chips) 
Seat 2: LV_Arturs (95477 in chips) 
Seat 3: fellipeschmeil (48633 in chips) 
Seat 4: chuchukat (283949 in chips) 
Seat 5: lftgjc (128954 in chips) 
Seat 6: PavanaTTo23 (27601 in chips) 
Seat 7: drinho2pac (73896 in chips) 
Seat 8: Pedrozadota (99484 in chips) 
yaniw777: posts the ante 500
LV_Arturs: posts the ante 500
fellipeschmeil: posts the ante 500
chuchukat: posts the ante 500
lftgjc: posts the ante 500
PavanaTTo23: posts the ante 500
drinho2pac: posts the ante 500
Pedrozadota: posts the ante 500
lftgjc: posts small blind 2000
PavanaTTo23: posts big blind 4000
*** HOLE CARDS ***
drinho2pac: folds 
Pedrozadota: folds 
yaniw777: raises 4400 to 8400
LV_Arturs: folds 
fellipeschmeil: folds 
chuchukat: folds 
lftgjc: folds 
PavanaTTo23: calls 4400
*** FLOP *** [2c Qd 6h]
PavanaTTo23: bets 18701 and is all-in
yaniw777: calls 18701
*** TURN *** [2c Qd 6h] [9h]
*** RIVER *** [2c Qd 6h 9h] [Qs]
*** SHOW DOWN ***
PavanaTTo23: shows [4d 3c] (a pair of Queens)
yaniw777: shows [Ac Js] (a pair of Queens - Ace kicker)
yaniw777 collected 60202 from pot
PavanaTTo23 finished the tournament in 344th place
*** SUMMARY ***
Total pot 60202 | Rake 0 
Board [2c Qd 6h 9h Qs]
Seat 1: yaniw777 showed [Ac Js] and won (60202) with a pair of Queens
Seat 2: LV_Arturs folded before Flop (didn't bet)
Seat 3: fellipeschmeil folded before Flop (didn't bet)
Seat 4: chuchukat (button) folded before Flop (didn't bet)
Seat 5: lftgjc (small blind) folded before Flop
Seat 6: PavanaTTo23 (big blind) showed [4d 3c] and lost with a pair of Queens
Seat 7: drinho2pac folded before Flop (didn't bet)
Seat 8: Pedrozadota folded before Flop (didn't bet)

PokerStars Hand #251206752041: Tournament #3767885527, $40+$10+$5 USD Hold'em No Limit - Level XVIII (2000/4000) - 2024/06/26 20:17:38 UTC [2024/06/26 16:17:38 ET]
Table '3767885527 57' 8-max Seat #5 is the button
Seat 1: yaniw777 (148792 in chips) 
Seat 2: LV_Arturs (94977 in chips) 
Seat 3: fellipeschmeil (48133 in chips) 
Seat 4: chuchukat (283449 in chips) 
Seat 5: lftgjc (126454 in chips) 
Seat 7: drinho2pac (73396 in chips) 
Seat 8: Pedrozadota (98984 in chips) 
yaniw777: posts the ante 500
LV_Arturs: posts the ante 500
fellipeschmeil: posts the ante 500
chuchukat: posts the ante 500
lftgjc: posts the ante 500
drinho2pac: posts the ante 500
Pedrozadota: posts the ante 500
drinho2pac: posts small blind 2000
Pedrozadota: posts big blind 4000
*** HOLE CARDS ***
yaniw777: raises 4400 to 8400
LV_Arturs: folds 
fellipeschmeil: folds 
chuchukat: calls 8400
lftgjc: raises 18000 to 26400
vip_1985Z is disconnected 
drinho2pac: folds 
Pedrozadota: folds 
yaniw777: folds 
chuchukat: folds 
Uncalled bet (18000) returned to lftgjc
lftgjc collected 34700 from pot
lftgjc: doesn't show hand 
*** SUMMARY ***
Total pot 34700 | Rake 0 
Seat 1: yaniw777 folded before Flop
Seat 2: LV_Arturs folded before Flop (didn't bet)
Seat 3: fellipeschmeil folded before Flop (didn't bet)
Seat 4: chuchukat folded before Flop
Seat 5: lftgjc (button) collected (34700)
Seat 7: drinho2pac (small blind) folded before Flop
Seat 8: Pedrozadota (big blind) folded before Flop

PokerStars Hand #251206765771: Tournament #3767885527, $40+$10+$5 USD Hold'em No Limit - Level XVIII (2000/4000) - 2024/06/26 20:18:26 UTC [2024/06/26 16:18:26 ET]
Table '3767885527 57' 8-max Seat #7 is the button
Seat 1: yaniw777 (139892 in chips) 
Seat 2: LV_Arturs (94477 in chips) 
Seat 3: fellipeschmeil (47633 in chips) 
Seat 4: chuchukat (274549 in chips) 
Seat 5: lftgjc (152254 in chips) 
Seat 6: vip_1985Z (36634 in chips) 
Seat 7: drinho2pac (70896 in chips) 
Seat 8: Pedrozadota (94484 in chips) 
yaniw777: posts the ante 500
LV_Arturs: posts the ante 500
fellipeschmeil: posts the ante 500
chuchukat: posts the ante 500
lftgjc: posts the ante 500
vip_1985Z: posts the ante 500
drinho2pac: posts the ante 500
Pedrozadota: posts the ante 500
Pedrozadota: posts small blind 2000
yaniw777: posts big blind 4000
*** HOLE CARDS ***
LV_Arturs: folds 
fellipeschmeil: folds 
chuchukat: folds 
lftgjc: folds 
vip_1985Z: folds 
drinho2pac: raises 4400 to 8400
Pedrozadota: folds 
yaniw777: folds 
Uncalled bet (4400) returned to drinho2pac
drinho2pac collected 14000 from pot
*** SUMMARY ***
Total pot 14000 | Rake 0 
Seat 1: yaniw777 (big blind) folded before Flop
Seat 2: LV_Arturs folded before Flop (didn't bet)
Seat 3: fellipeschmeil folded before Flop (didn't bet)
Seat 4: chuchukat folded before Flop (didn't bet)
Seat 5: lftgjc folded before Flop (didn't bet)
Seat 6: vip_1985Z folded before Flop (didn't bet)
Seat 7: drinho2pac (button) collected (14000)
Seat 8: Pedrozadota (small blind) folded before Flop

PokerStars Hand #251206777375: Tournament #3767885527, $40+$10+$5 USD Hold'em No Limit - Level XVIII (2000/4000) - 2024/06/26 20:19:07 UTC [2024/06/26 16:19:07 ET]
Table '3767885527 57' 8-max Seat #8 is the button
Seat 1: yaniw777 (135392 in chips) 
Seat 2: LV_Arturs (93977 in chips) 
Seat 3: fellipeschmeil (47133 in chips) 
Seat 4: chuchukat (274049 in chips) 
Seat 5: lftgjc (151754 in chips) 
Seat 6: vip_1985Z (36134 in chips) 
Seat 7: drinho2pac (80396 in chips) 
Seat 8: Pedrozadota (91984 in chips) 
yaniw777: posts the ante 500
LV_Arturs: posts the ante 500
fellipeschmeil: posts the ante 500
chuchukat: posts the ante 500
lftgjc: posts the ante 500
vip_1985Z: posts the ante 500
drinho2pac: posts the ante 500
Pedrozadota: posts the ante 500
yaniw777: posts small blind 2000
LV_Arturs: posts big blind 4000
*** HOLE CARDS ***
fellipeschmeil: folds 
chuchukat: folds 
lftgjc: folds 
vip_1985Z: folds 
drinho2pac: folds 
Pedrozadota: folds 
yaniw777: folds 
Uncalled bet (2000) returned to LV_Arturs
LV_Arturs collected 8000 from pot
*** SUMMARY ***
Total pot 8000 | Rake 0 
Seat 1: yaniw777 (small blind) folded before Flop
Seat 2: LV_Arturs (big blind) collected (8000)
Seat 3: fellipeschmeil folded before Flop (didn't bet)
Seat 4: chuchukat folded before Flop (didn't bet)
Seat 5: lftgjc folded before Flop (didn't bet)
Seat 6: vip_1985Z folded before Flop (didn't bet)
Seat 7: drinho2pac folded before Flop (didn't bet)
Seat 8: Pedrozadota (button) folded before Flop (didn't bet)

PokerStars Hand #251206785934: Tournament #3767885527, $40+$10+$5 USD Hold'em No Limit - Level XVIII (2000/4000) - 2024/06/26 20:19:38 UTC [2024/06/26 16:19:38 ET]
Table '3767885527 57' 8-max Seat #1 is the button
Seat 1: yaniw777 (132892 in chips) 
Seat 2: LV_Arturs (99477 in chips) 
Seat 3: fellipeschmeil (46633 in chips) 
Seat 4: chuchukat (273549 in chips) 
Seat 5: lftgjc (151254 in chips) 
Seat 6: vip_1985Z (35634 in chips) 
Seat 7: drinho2pac (79896 in chips) 
Seat 8: Pedrozadota (91484 in chips) 
yaniw777: posts the ante 500
LV_Arturs: posts the ante 500
fellipeschmeil: posts the ante 500
chuchukat: posts the ante 500
lftgjc: posts the ante 500
vip_1985Z: posts the ante 500
drinho2pac: posts the ante 500
Pedrozadota: posts the ante 500
LV_Arturs: posts small blind 2000
fellipeschmeil: posts big blind 4000
*** HOLE CARDS ***
chuchukat: folds 
lftgjc: folds 
vip_1985Z: folds 
drinho2pac: folds 
Pedrozadota: raises 4400 to 8400
yaniw777: folds 
LV_Arturs: folds 
fellipeschmeil: calls 4400
*** FLOP *** [Kh Qs 3s]
fellipeschmeil: checks 
Pedrozadota: bets 4000
fellipeschmeil: folds 
Uncalled bet (4000) returned to Pedrozadota
Pedrozadota collected 22800 from pot
Pedrozadota: doesn't show hand 
*** SUMMARY ***
Total pot 22800 | Rake 0 
Board [Kh Qs 3s]
Seat 1: yaniw777 (button) folded before Flop (didn't bet)
Seat 2: LV_Arturs (small blind) folded before Flop
Seat 3: fellipeschmeil (big blind) folded on the Flop
Seat 4: chuchukat folded before Flop (didn't bet)
Seat 5: lftgjc folded before Flop (didn't bet)
Seat 6: vip_1985Z folded before Flop (didn't bet)
Seat 7: drinho2pac folded before Flop (didn't bet)
Seat 8: Pedrozadota collected (22800)

PokerStars Hand #251206797298: Tournament #3767885527, $40+$10+$5 USD Hold'em No Limit - Level XVIII (2000/4000) - 2024/06/26 20:20:18 UTC [2024/06/26 16:20:18 ET]
Table '3767885527 57' 8-max Seat #2 is the button
Seat 1: yaniw777 (132392 in chips) 
Seat 2: LV_Arturs (96977 in chips) 
Seat 3: fellipeschmeil (37733 in chips) 
Seat 4: chuchukat (273049 in chips) 
Seat 5: lftgjc (150754 in chips) 
Seat 6: vip_1985Z (35134 in chips) 
Seat 7: drinho2pac (79396 in chips) 
Seat 8: Pedrozadota (105384 in chips) 
yaniw777: posts the ante 500
LV_Arturs: posts the ante 500
fellipeschmeil: posts the ante 500
chuchukat: posts the ante 500
lftgjc: posts the ante 500
vip_1985Z: posts the ante 500
drinho2pac: posts the ante 500
Pedrozadota: posts the ante 500
fellipeschmeil: posts small blind 2000
chuchukat: posts big blind 4000
*** HOLE CARDS ***
lftgjc: raises 4000 to 8000
vip_1985Z: folds 
drinho2pac: folds 
Pedrozadota: folds 
yaniw777: folds 
LV_Arturs: folds 
fellipeschmeil: folds 
chuchukat: calls 4000
*** FLOP *** [Td 2s 7s]
chuchukat: checks 
lftgjc: checks 
*** TURN *** [Td 2s 7s] [6d]
chuchukat: bets 8000
lftgjc: calls 8000
*** RIVER *** [Td 2s 7s 6d] [8h]
chuchukat: bets 48000
lftgjc: folds 
Uncalled bet (48000) returned to chuchukat
chuchukat collected 38000 from pot
chuchukat: doesn't show hand 
*** SUMMARY ***
Total pot 38000 | Rake 0 
Board [Td 2s 7s 6d 8h]
Seat 1: yaniw777 folded before Flop (didn't bet)
Seat 2: LV_Arturs (button) folded before Flop (didn't bet)
Seat 3: fellipeschmeil (small blind) folded before Flop
Seat 4: chuchukat (big blind) collected (38000)
Seat 5: lftgjc folded on the River
Seat 6: vip_1985Z folded before Flop (didn't bet)
Seat 7: drinho2pac folded before Flop (didn't bet)
Seat 8: Pedrozadota folded before Flop (didn't bet)

PokerStars Hand #251206817201: Tournament #3767885527, $40+$10+$5 USD Hold'em No Limit - Level XVIII (2000/4000) - 2024/06/26 20:21:28 UTC [2024/06/26 16:21:28 ET]
Table '3767885527 57' 8-max Seat #3 is the button
Seat 1: yaniw777 (131892 in chips) 
Seat 2: LV_Arturs (96477 in chips) 
Seat 3: fellipeschmeil (35233 in chips) 
Seat 4: chuchukat (294549 in chips) 
Seat 5: lftgjc (134254 in chips) 
Seat 6: vip_1985Z (34634 in chips) 
Seat 7: drinho2pac (78896 in chips) 
Seat 8: Pedrozadota (104884 in chips) 
yaniw777: posts the ante 500
LV_Arturs: posts the ante 500
fellipeschmeil: posts the ante 500
chuchukat: posts the ante 500
lftgjc: posts the ante 500
vip_1985Z: posts the ante 500
drinho2pac: posts the ante 500
Pedrozadota: posts the ante 500
chuchukat: posts small blind 2000
lftgjc: posts big blind 4000
*** HOLE CARDS ***
vip_1985Z: folds 
drinho2pac: folds 
Pedrozadota: folds 
yaniw777: folds 
LV_Arturs: folds 
fellipeschmeil: folds 
chuchukat: raises 10000 to 14000
lftgjc: raises 18000 to 32000
chuchukat: folds 
Uncalled bet (18000) returned to lftgjc
lftgjc collected 32000 from pot
lftgjc: doesn't show hand 
*** SUMMARY ***
Total pot 32000 | Rake 0 
Seat 1: yaniw777 folded before Flop (didn't bet)
Seat 2: LV_Arturs folded before Flop (didn't bet)
Seat 3: fellipeschmeil (button) folded before Flop (didn't bet)
Seat 4: chuchukat (small blind) folded before Flop
Seat 5: lftgjc (big blind) collected (32000)
Seat 6: vip_1985Z folded before Flop (didn't bet)
Seat 7: drinho2pac folded before Flop (didn't bet)
Seat 8: Pedrozadota folded before Flop (didn't bet)

PokerStars Hand #251206830495: Tournament #3767885527, $40+$10+$5 USD Hold'em No Limit - Level XVIII (2000/4000) - 2024/06/26 20:22:16 UTC [2024/06/26 16:22:16 ET]
Table '3767885527 57' 8-max Seat #4 is the button
Seat 1: yaniw777 (131392 in chips) 
Seat 2: LV_Arturs (95977 in chips) 
Seat 3: fellipeschmeil (34733 in chips) 
Seat 4: chuchukat (280049 in chips) 
Seat 5: lftgjc (151754 in chips) 
Seat 6: vip_1985Z (34134 in chips) 
Seat 7: drinho2pac (78396 in chips) 
Seat 8: Pedrozadota (104384 in chips) 
yaniw777: posts the ante 500
LV_Arturs: posts the ante 500
fellipeschmeil: posts the ante 500
chuchukat: posts the ante 500
lftgjc: posts the ante 500
vip_1985Z: posts the ante 500
drinho2pac: posts the ante 500
Pedrozadota: posts the ante 500
lftgjc: posts small blind 2000
vip_1985Z: posts big blind 4000
*** HOLE CARDS ***
drinho2pac: folds 
Pedrozadota: folds 
yaniw777: folds 
LV_Arturs: folds 
fellipeschmeil: folds 
chuchukat: raises 4000 to 8000
lftgjc: folds 
vip_1985Z: folds 
Uncalled bet (4000) returned to chuchukat
chuchukat collected 14000 from pot
chuchukat: doesn't show hand 
*** SUMMARY ***
Total pot 14000 | Rake 0 
Seat 1: yaniw777 folded before Flop (didn't bet)
Seat 2: LV_Arturs folded before Flop (didn't bet)
Seat 3: fellipeschmeil folded before Flop (didn't bet)
Seat 4: chuchukat (button) collected (14000)
Seat 5: lftgjc (small blind) folded before Flop
Seat 6: vip_1985Z (big blind) folded before Flop
Seat 7: drinho2pac folded before Flop (didn't bet)
Seat 8: Pedrozadota folded before Flop (didn't bet)

PokerStars Hand #251206840407: Tournament #3767885527, $40+$10+$5 USD Hold'em No Limit - Level XVIII (2000/4000) - 2024/06/26 20:22:51 UTC [2024/06/26 16:22:51 ET]
Table '3767885527 57' 8-max Seat #5 is the button
Seat 1: yaniw777 (130892 in chips) 
Seat 2: LV_Arturs (95477 in chips) 
Seat 3: fellipeschmeil (34233 in chips) 
Seat 4: chuchukat (289549 in chips) 
Seat 5: lftgjc (149254 in chips) 
Seat 6: vip_1985Z (29634 in chips) 
Seat 7: drinho2pac (77896 in chips) 
Seat 8: Pedrozadota (103884 in chips) 
yaniw777: posts the ante 500
LV_Arturs: posts the ante 500
fellipeschmeil: posts the ante 500
chuchukat: posts the ante 500
lftgjc: posts the ante 500
vip_1985Z: posts the ante 500
drinho2pac: posts the ante 500
Pedrozadota: posts the ante 500
vip_1985Z: posts small blind 2000
drinho2pac: posts big blind 4000
*** HOLE CARDS ***
Pedrozadota: folds 
yaniw777: folds 
LV_Arturs: folds 
fellipeschmeil: folds 
chuchukat: raises 4000 to 8000
lftgjc: folds 
vip_1985Z: folds 
drinho2pac: folds 
Uncalled bet (4000) returned to chuchukat
chuchukat collected 14000 from pot
chuchukat: doesn't show hand 
*** SUMMARY ***
Total pot 14000 | Rake 0 
Seat 1: yaniw777 folded before Flop (didn't bet)
Seat 2: LV_Arturs folded before Flop (didn't bet)
Seat 3: fellipeschmeil folded before Flop (didn't bet)
Seat 4: chuchukat collected (14000)
Seat 5: lftgjc (button) folded before Flop (didn't bet)
Seat 6: vip_1985Z (small blind) folded before Flop
Seat 7: drinho2pac (big blind) folded before Flop
Seat 8: Pedrozadota folded before Flop (didn't bet)

PokerStars Hand #251206852851: Tournament #3767885527, $40+$10+$5 USD Hold'em No Limit - Level XVIII (2000/4000) - 2024/06/26 20:23:35 UTC [2024/06/26 16:23:35 ET]
Table '3767885527 57' 8-max Seat #6 is the button
Seat 1: yaniw777 (130392 in chips) 
Seat 2: LV_Arturs (94977 in chips) 
Seat 3: fellipeschmeil (33733 in chips) 
Seat 4: chuchukat (299049 in chips) 
Seat 5: lftgjc (148754 in chips) 
Seat 6: vip_1985Z (27134 in chips) 
Seat 7: drinho2pac (73396 in chips) 
Seat 8: Pedrozadota (103384 in chips) 
yaniw777: posts the ante 500
LV_Arturs: posts the ante 500
fellipeschmeil: posts the ante 500
chuchukat: posts the ante 500
lftgjc: posts the ante 500
vip_1985Z: posts the ante 500
drinho2pac: posts the ante 500
Pedrozadota: posts the ante 500
drinho2pac: posts small blind 2000
Pedrozadota: posts big blind 4000
*** HOLE CARDS ***
yaniw777: raises 4400 to 8400
LV_Arturs: folds 
fellipeschmeil: folds 
chuchukat: folds 
lftgjc: folds 
vip_1985Z: folds 
drinho2pac: folds 
Pedrozadota: folds 
Uncalled bet (4400) returned to yaniw777
yaniw777 collected 14000 from pot
yaniw777: doesn't show hand 
*** SUMMARY ***
Total pot 14000 | Rake 0 
Seat 1: yaniw777 collected (14000)
Seat 2: LV_Arturs folded before Flop (didn't bet)
Seat 3: fellipeschmeil folded before Flop (didn't bet)
Seat 4: chuchukat folded before Flop (didn't bet)
Seat 5: lftgjc folded before Flop (didn't bet)
Seat 6: vip_1985Z (button) folded before Flop (didn't bet)
Seat 7: drinho2pac (small blind) folded before Flop
Seat 8: Pedrozadota (big blind) folded before Flop

PokerStars Hand #251206867419: Tournament #3767885527, $40+$10+$5 USD Hold'em No Limit - Level XVIII (2000/4000) - 2024/06/26 20:24:27 UTC [2024/06/26 16:24:27 ET]
Table '3767885527 57' 8-max Seat #7 is the button
Seat 1: yaniw777 (139892 in chips) 
Seat 2: LV_Arturs (94477 in chips) 
Seat 3: fellipeschmeil (33233 in chips) 
Seat 4: chuchukat (298549 in chips) 
Seat 5: lftgjc (148254 in chips) 
Seat 6: vip_1985Z (26634 in chips) 
Seat 7: drinho2pac (70896 in chips) 
Seat 8: Pedrozadota (98884 in chips) 
yaniw777: posts the ante 500
LV_Arturs: posts the ante 500
fellipeschmeil: posts the ante 500
chuchukat: posts the ante 500
lftgjc: posts the ante 500
vip_1985Z: posts the ante 500
drinho2pac: posts the ante 500
Pedrozadota: posts the ante 500
Pedrozadota: posts small blind 2000
yaniw777: posts big blind 4000
*** HOLE CARDS ***
LV_Arturs: folds 
fellipeschmeil: folds 
chuchukat: folds 
lftgjc: folds 
vip_1985Z: folds 
drinho2pac: folds 
Pedrozadota has timed out
Pedrozadota: folds 
Pedrozadota is sitting out
Uncalled bet (2000) returned to yaniw777
yaniw777 collected 8000 from pot
yaniw777: doesn't show hand 
Pedrozadota has returned
*** SUMMARY ***
Total pot 8000 | Rake 0 
Seat 1: yaniw777 (big blind) collected (8000)
Seat 2: LV_Arturs folded before Flop (didn't bet)
Seat 3: fellipeschmeil folded before Flop (didn't bet)
Seat 4: chuchukat folded before Flop (didn't bet)
Seat 5: lftgjc folded before Flop (didn't bet)
Seat 6: vip_1985Z folded before Flop (didn't bet)
Seat 7: drinho2pac (button) folded before Flop (didn't bet)
Seat 8: Pedrozadota (small blind) folded before Flop

PokerStars Hand #251206880994: Tournament #3767885527, $40+$10+$5 USD Hold'em No Limit - Level XVIII (2000/4000) - 2024/06/26 20:25:15 UTC [2024/06/26 16:25:15 ET]
Table '3767885527 57' 8-max Seat #8 is the button
Seat 1: yaniw777 (145392 in chips) 
Seat 2: LV_Arturs (93977 in chips) 
Seat 3: fellipeschmeil (32733 in chips) 
Seat 4: chuchukat (298049 in chips) 
Seat 5: lftgjc (147754 in chips) 
Seat 6: vip_1985Z (26134 in chips) 
Seat 7: drinho2pac (70396 in chips) 
Seat 8: Pedrozadota (96384 in chips) 
yaniw777: posts the ante 500
LV_Arturs: posts the ante 500
fellipeschmeil: posts the ante 500
chuchukat: posts the ante 500
lftgjc: posts the ante 500
vip_1985Z: posts the ante 500
drinho2pac: posts the ante 500
Pedrozadota: posts the ante 500
yaniw777: posts small blind 2000
LV_Arturs: posts big blind 4000
*** HOLE CARDS ***
fellipeschmeil: folds 
chuchukat: folds 
lftgjc: folds 
vip_1985Z: folds 
drinho2pac: folds 
Pedrozadota: raises 4400 to 8400
yaniw777: folds 
LV_Arturs: raises 85077 to 93477 and is all-in
Pedrozadota: folds 
Uncalled bet (85077) returned to LV_Arturs
LV_Arturs collected 22800 from pot
*** SUMMARY ***
Total pot 22800 | Rake 0 
Seat 1: yaniw777 (small blind) folded before Flop
Seat 2: LV_Arturs (big blind) collected (22800)
Seat 3: fellipeschmeil folded before Flop (didn't bet)
Seat 4: chuchukat folded before Flop (didn't bet)
Seat 5: lftgjc folded before Flop (didn't bet)
Seat 6: vip_1985Z folded before Flop (didn't bet)
Seat 7: drinho2pac folded before Flop (didn't bet)
Seat 8: Pedrozadota (button) folded before Flop

PokerStars Hand #251206897605: Tournament #3767885527, $40+$10+$5 USD Hold'em No Limit - Level XIX (2500/5000) - 2024/06/26 20:26:15 UTC [2024/06/26 16:26:15 ET]
Table '3767885527 57' 8-max Seat #1 is the button
Seat 1: yaniw777 (142892 in chips) 
Seat 2: LV_Arturs (107877 in chips) 
Seat 3: fellipeschmeil (32233 in chips) 
Seat 4: chuchukat (297549 in chips) 
Seat 5: lftgjc (147254 in chips) 
Seat 6: vip_1985Z (25634 in chips) 
Seat 7: drinho2pac (69896 in chips) 
Seat 8: Pedrozadota (87484 in chips) 
yaniw777: posts the ante 625
LV_Arturs: posts the ante 625
fellipeschmeil: posts the ante 625
chuchukat: posts the ante 625
lftgjc: posts the ante 625
vip_1985Z: posts the ante 625
drinho2pac: posts the ante 625
Pedrozadota: posts the ante 625
LV_Arturs: posts small blind 2500
fellipeschmeil: posts big blind 5000
*** HOLE CARDS ***
chuchukat: folds 
lftgjc: folds 
vip_1985Z: raises 20000 to 25000
drinho2pac: folds 
Pedrozadota: folds 
yaniw777: raises 117267 to 142267 and is all-in
LV_Arturs: folds 
fellipeschmeil: folds 
vip_1985Z: calls 9 and is all-in
Uncalled bet (117258) returned to yaniw777
*** FLOP *** [4d Ad Qs]
*** TURN *** [4d Ad Qs] [Ah]
*** RIVER *** [4d Ad Qs Ah] [Tc]
*** SHOW DOWN ***
vip_1985Z: shows [Ks As] (three of a kind, Aces)
yaniw777: shows [6s 6d] (two pair, Aces and Sixes)
vip_1985Z collected 62518 from pot
*** SUMMARY ***
Total pot 62518 | Rake 0 
Board [4d Ad Qs Ah Tc]
Seat 1: yaniw777 (button) showed [6s 6d] and lost with two pair, Aces and Sixes
Seat 2: LV_Arturs (small blind) folded before Flop
Seat 3: fellipeschmeil (big blind) folded before Flop
Seat 4: chuchukat folded before Flop (didn't bet)
Seat 5: lftgjc folded before Flop (didn't bet)
Seat 6: vip_1985Z showed [Ks As] and won (62518) with three of a kind, Aces
Seat 7: drinho2pac folded before Flop (didn't bet)
Seat 8: Pedrozadota folded before Flop (didn't bet)

PokerStars Hand #251206926650: Tournament #3767885527, $40+$10+$5 USD Hold'em No Limit - Level XIX (2500/5000) - 2024/06/26 20:27:59 UTC [2024/06/26 16:27:59 ET]
Table '3767885527 57' 8-max Seat #2 is the button
Seat 1: yaniw777 (117258 in chips) 
Seat 2: LV_Arturs (104752 in chips) 
Seat 3: fellipeschmeil (26608 in chips) 
Seat 4: chuchukat (296924 in chips) 
Seat 5: lftgjc (146629 in chips) 
Seat 6: vip_1985Z (62518 in chips) 
Seat 7: drinho2pac (69271 in chips) 
Seat 8: Pedrozadota (86859 in chips) 
yaniw777: posts the ante 625
LV_Arturs: posts the ante 625
fellipeschmeil: posts the ante 625
chuchukat: posts the ante 625
lftgjc: posts the ante 625
vip_1985Z: posts the ante 625
drinho2pac: posts the ante 625
Pedrozadota: posts the ante 625
fellipeschmeil: posts small blind 2500
chuchukat: posts big blind 5000
*** HOLE CARDS ***
lftgjc: folds 
vip_1985Z: folds 
drinho2pac: folds 
Pedrozadota: folds 
yaniw777: raises 5000 to 10000
LV_Arturs: folds 
fellipeschmeil: folds 
chuchukat: raises 30000 to 40000
yaniw777: folds 
Uncalled bet (30000) returned to chuchukat
chuchukat collected 27500 from pot
chuchukat: doesn't show hand 
*** SUMMARY ***
Total pot 27500 | Rake 0 
Seat 1: yaniw777 folded before Flop
Seat 2: LV_Arturs (button) folded before Flop (didn't bet)
Seat 3: fellipeschmeil (small blind) folded before Flop
Seat 4: chuchukat (big blind) collected (27500)
Seat 5: lftgjc folded before Flop (didn't bet)
Seat 6: vip_1985Z folded before Flop (didn't bet)
Seat 7: drinho2pac folded before Flop (didn't bet)
Seat 8: Pedrozadota folded before Flop (didn't bet)

PokerStars Hand #251206948693: Tournament #3767885527, $40+$10+$5 USD Hold'em No Limit - Level XIX (2500/5000) - 2024/06/26 20:29:19 UTC [2024/06/26 16:29:19 ET]
Table '3767885527 57' 8-max Seat #3 is the button
Seat 1: yaniw777 (106633 in chips) 
Seat 2: LV_Arturs (104127 in chips) 
Seat 3: fellipeschmeil (23483 in chips) 
Seat 4: chuchukat (313799 in chips) 
Seat 5: lftgjc (146004 in chips) 
Seat 6: vip_1985Z (61893 in chips) 
Seat 7: drinho2pac (68646 in chips) 
Seat 8: Pedrozadota (86234 in chips) 
yaniw777: posts the ante 625
LV_Arturs: posts the ante 625
fellipeschmeil: posts the ante 625
chuchukat: posts the ante 625
lftgjc: posts the ante 625
vip_1985Z: posts the ante 625
drinho2pac: posts the ante 625
Pedrozadota: posts the ante 625
chuchukat: posts small blind 2500
lftgjc: posts big blind 5000
*** HOLE CARDS ***
vip_1985Z: folds 
drinho2pac: folds 
Pedrozadota: folds 
yaniw777: folds 
LV_Arturs: raises 5250 to 10250
fellipeschmeil: folds 
chuchukat: folds 
lftgjc: calls 5250
*** FLOP *** [Jd 2c 8s]
lftgjc: checks 
LV_Arturs: bets 9000
lftgjc: folds 
Uncalled bet (9000) returned to LV_Arturs
LV_Arturs collected 28000 from pot
*** SUMMARY ***
Total pot 28000 | Rake 0 
Board [Jd 2c 8s]
Seat 1: yaniw777 folded before Flop (didn't bet)
Seat 2: LV_Arturs collected (28000)
Seat 3: fellipeschmeil (button) folded before Flop (didn't bet)
Seat 4: chuchukat (small blind) folded before Flop
Seat 5: lftgjc (big blind) folded on the Flop
Seat 6: vip_1985Z folded before Flop (didn't bet)
Seat 7: drinho2pac folded before Flop (didn't bet)
Seat 8: Pedrozadota folded before Flop (didn't bet)

PokerStars Hand #251206974963: Tournament #3767885527, $40+$10+$5 USD Hold'em No Limit - Level XIX (2500/5000) - 2024/06/26 20:30:54 UTC [2024/06/26 16:30:54 ET]
Table '3767885527 57' 8-max Seat #4 is the button
Seat 1: yaniw777 (106008 in chips) 
Seat 2: LV_Arturs (121252 in chips) 
Seat 3: fellipeschmeil (22858 in chips) 
Seat 4: chuchukat (310674 in chips) 
Seat 5: lftgjc (135129 in chips) 
Seat 6: vip_1985Z (61268 in chips) 
Seat 7: drinho2pac (68021 in chips) 
Seat 8: Pedrozadota (85609 in chips) 
yaniw777: posts the ante 625
LV_Arturs: posts the ante 625
fellipeschmeil: posts the ante 625
chuchukat: posts the ante 625
lftgjc: posts the ante 625
vip_1985Z: posts the ante 625
drinho2pac: posts the ante 625
Pedrozadota: posts the ante 625
lftgjc: posts small blind 2500
vip_1985Z: posts big blind 5000
*** HOLE CARDS ***
drinho2pac: folds 
Pedrozadota: raises 45000 to 50000
yaniw777: folds 
LV_Arturs: folds 
fellipeschmeil: folds 
chuchukat: folds 
lftgjc: folds 
vip_1985Z: folds 
Uncalled bet (45000) returned to Pedrozadota
Pedrozadota collected 17500 from pot
Pedrozadota: doesn't show hand 
*** SUMMARY ***
Total pot 17500 | Rake 0 
Seat 1: yaniw777 folded before Flop (didn't bet)
Seat 2: LV_Arturs folded before Flop (didn't bet)
Seat 3: fellipeschmeil folded before Flop (didn't bet)
Seat 4: chuchukat (button) folded before Flop (didn't bet)
Seat 5: lftgjc (small blind) folded before Flop
Seat 6: vip_1985Z (big blind) folded before Flop
Seat 7: drinho2pac folded before Flop (didn't bet)
Seat 8: Pedrozadota collected (17500)

PokerStars Hand #251206984965: Tournament #3767885527, $40+$10+$5 USD Hold'em No Limit - Level XIX (2500/5000) - 2024/06/26 20:31:30 UTC [2024/06/26 16:31:30 ET]
Table '3767885527 57' 8-max Seat #5 is the button
Seat 1: yaniw777 (105383 in chips) 
Seat 2: LV_Arturs (120627 in chips) 
Seat 3: fellipeschmeil (22233 in chips) 
Seat 4: chuchukat (310049 in chips) 
Seat 5: lftgjc (132004 in chips) 
Seat 6: vip_1985Z (55643 in chips) 
Seat 7: drinho2pac (67396 in chips) 
Seat 8: Pedrozadota (97484 in chips) 
yaniw777: posts the ante 625
LV_Arturs: posts the ante 625
fellipeschmeil: posts the ante 625
chuchukat: posts the ante 625
lftgjc: posts the ante 625
vip_1985Z: posts the ante 625
drinho2pac: posts the ante 625
Pedrozadota: posts the ante 625
vip_1985Z: posts small blind 2500
drinho2pac: posts big blind 5000
*** HOLE CARDS ***
Pedrozadota: folds 
yaniw777: folds 
LV_Arturs: folds 
fellipeschmeil: folds 
chuchukat: raises 304424 to 309424 and is all-in
lftgjc: folds 
vip_1985Z: folds 
drinho2pac: folds 
Uncalled bet (304424) returned to chuchukat
chuchukat collected 17500 from pot
chuchukat: doesn't show hand 
*** SUMMARY ***
Total pot 17500 | Rake 0 
Seat 1: yaniw777 folded before Flop (didn't bet)
Seat 2: LV_Arturs folded before Flop (didn't bet)
Seat 3: fellipeschmeil folded before Flop (didn't bet)
Seat 4: chuchukat collected (17500)
Seat 5: lftgjc (button) folded before Flop (didn't bet)
Seat 6: vip_1985Z (small blind) folded before Flop
Seat 7: drinho2pac (big blind) folded before Flop
Seat 8: Pedrozadota folded before Flop (didn't bet)

PokerStars Hand #251206999112: Tournament #3767885527, $40+$10+$5 USD Hold'em No Limit - Level XIX (2500/5000) - 2024/06/26 20:32:20 UTC [2024/06/26 16:32:20 ET]
Table '3767885527 57' 8-max Seat #6 is the button
Seat 1: yaniw777 (104758 in chips) 
Seat 2: LV_Arturs (120002 in chips) 
Seat 3: fellipeschmeil (21608 in chips) 
Seat 4: chuchukat (321924 in chips) 
Seat 5: lftgjc (131379 in chips) 
Seat 6: vip_1985Z (52518 in chips) 
Seat 7: drinho2pac (61771 in chips) 
Seat 8: Pedrozadota (96859 in chips) 
yaniw777: posts the ante 625
LV_Arturs: posts the ante 625
fellipeschmeil: posts the ante 625
chuchukat: posts the ante 625
lftgjc: posts the ante 625
vip_1985Z: posts the ante 625
drinho2pac: posts the ante 625
Pedrozadota: posts the ante 625
drinho2pac: posts small blind 2500
Pedrozadota: posts big blind 5000
*** HOLE CARDS ***
yaniw777: raises 5000 to 10000
LV_Arturs: folds 
fellipeschmeil: folds 
chuchukat: folds 
lftgjc: raises 15000 to 25000
vip_1985Z: folds 
drinho2pac: folds 
Pedrozadota: folds 
yaniw777: raises 79133 to 104133 and is all-in
lftgjc: calls 79133
*** FLOP *** [3d Qc 9h]
*** TURN *** [3d Qc 9h] [4s]
*** RIVER *** [3d Qc 9h 4s] [3c]
*** SHOW DOWN ***
yaniw777: shows [Kc Ks] (two pair, Kings and Threes)
lftgjc: shows [Ah As] (two pair, Aces and Threes)
lftgjc collected 220766 from pot
*** SUMMARY ***
Total pot 220766 | Rake 0 
Board [3d Qc 9h 4s 3c]
Seat 1: yaniw777 showed [Kc Ks] and lost with two pair, Kings and Threes
Seat 2: LV_Arturs folded before Flop (didn't bet)
Seat 3: fellipeschmeil folded before Flop (didn't bet)
Seat 4: chuchukat folded before Flop (didn't bet)
Seat 5: lftgjc showed [Ah As] and won (220766) with two pair, Aces and Threes
Seat 6: vip_1985Z (button) folded before Flop (didn't bet)
Seat 7: drinho2pac (small blind) folded before Flop
Seat 8: Pedrozadota (big blind) folded before Flop

PokerStars Hand #251207031976: Tournament #3767885527, $40+$10+$5 USD Hold'em No Limit - Level XIX (2500/5000) - 2024/06/26 20:34:17 UTC [2024/06/26 16:34:17 ET]
Table '3767885527 57' 8-max Seat #7 is the button
Seat 2: LV_Arturs (119377 in chips) 
Seat 3: fellipeschmeil (20983 in chips) 
Seat 4: chuchukat (321299 in chips) 
Seat 5: lftgjc (247387 in chips) 
Seat 6: vip_1985Z (51893 in chips) 
Seat 7: drinho2pac (58646 in chips) 
Seat 8: Pedrozadota (91234 in chips) 
LV_Arturs: posts the ante 625
fellipeschmeil: posts the ante 625
chuchukat: posts the ante 625
lftgjc: posts the ante 625
vip_1985Z: posts the ante 625
drinho2pac: posts the ante 625
Pedrozadota: posts the ante 625
Pedrozadota: posts small blind 2500
LV_Arturs: posts big blind 5000
*** HOLE CARDS ***
fellipeschmeil: raises 15000 to 20000
chuchukat: calls 20000
lftgjc: folds 
vip_1985Z: folds 
drinho2pac: raises 38021 to 58021 and is all-in
Pedrozadota: folds 
LV_Arturs: folds 
fellipeschmeil: calls 358 and is all-in
chuchukat: calls 38021
*** FLOP *** [Ts 2c Ad]
*** TURN *** [Ts 2c Ad] [7h]
*** RIVER *** [Ts 2c Ad 7h] [Ac]
*** SHOW DOWN ***
chuchukat: shows [Ah Jh] (three of a kind, Aces)
drinho2pac: shows [5d 5h] (two pair, Aces and Fives)
Naaarrrr is disconnected 
chuchukat collected 75326 from side pot
fellipeschmeil: shows [Qs As] (three of a kind, Aces - Queen kicker)
fellipeschmeil collected 72949 from main pot
drinho2pac finished the tournament in 295th place and received $104.64.
*** SUMMARY ***
Total pot 148275 Main pot 72949. Side pot 75326. | Rake 0 
Board [Ts 2c Ad 7h Ac]
Seat 2: LV_Arturs (big blind) folded before Flop
Seat 3: fellipeschmeil showed [Qs As] and won (72949) with three of a kind, Aces
Seat 4: chuchukat showed [Ah Jh] and won (75326) with three of a kind, Aces
Seat 5: lftgjc folded before Flop (didn't bet)
Seat 6: vip_1985Z folded before Flop (didn't bet)
Seat 7: drinho2pac (button) showed [5d 5h] and lost with two pair, Aces and Fives
Seat 8: Pedrozadota (small blind) folded before Flop

PokerStars Hand #251207050594: Tournament #3767885527, $40+$10+$5 USD Hold'em No Limit - Level XIX (2500/5000) - 2024/06/26 20:35:22 UTC [2024/06/26 16:35:22 ET]
Table '3767885527 57' 8-max Seat #8 is the button
Seat 1: Naaarrrr (227788 in chips) out of hand (moved from another table into small blind)
Seat 2: LV_Arturs (113752 in chips) 
Seat 3: fellipeschmeil (72949 in chips) 
Seat 4: chuchukat (337979 in chips) 
Seat 5: lftgjc (246762 in chips) 
Seat 6: vip_1985Z (51268 in chips) 
Seat 8: Pedrozadota (88109 in chips) 
Naaarrrr will be allowed to play after the button
LV_Arturs: posts the ante 625
fellipeschmeil: posts the ante 625
chuchukat: posts the ante 625
lftgjc: posts the ante 625
vip_1985Z: posts the ante 625
Pedrozadota: posts the ante 625
LV_Arturs: posts small blind 2500
fellipeschmeil: posts big blind 5000
*** HOLE CARDS ***
chuchukat: folds 
lftgjc: raises 5000 to 10000
vip_1985Z: folds 
Pedrozadota: folds 
LV_Arturs: raises 103127 to 113127 and is all-in
fellipeschmeil: folds 
gomsipjorn is disconnected 
lftgjc: folds 
Uncalled bet (103127) returned to LV_Arturs
LV_Arturs collected 28750 from pot
*** SUMMARY ***
Total pot 28750 | Rake 0 
Seat 2: LV_Arturs (small blind) collected (28750)
Seat 3: fellipeschmeil (big blind) folded before Flop
Seat 4: chuchukat folded before Flop (didn't bet)
Seat 5: lftgjc folded before Flop
Seat 6: vip_1985Z folded before Flop (didn't bet)
Seat 8: Pedrozadota (button) folded before Flop (didn't bet)

PokerStars Hand #251207061607: Tournament #3767885527, $40+$10+$5 USD Hold'em No Limit - Level XX (3000/6000) - 2024/06/26 20:36:01 UTC [2024/06/26 16:36:01 ET]
Table '3767885527 57' 8-max Seat #2 is the button
Seat 1: Naaarrrr (227788 in chips) 
Seat 2: LV_Arturs (131877 in chips) 
Seat 3: fellipeschmeil (67324 in chips) 
Seat 4: chuchukat (337354 in chips) 
Seat 5: lftgjc (236137 in chips) 
Seat 6: vip_1985Z (50643 in chips) 
Seat 7: gomsipjorn (229711 in chips) 
Seat 8: Pedrozadota (87484 in chips) 
Naaarrrr: posts the ante 750
LV_Arturs: posts the ante 750
fellipeschmeil: posts the ante 750
chuchukat: posts the ante 750
lftgjc: posts the ante 750
vip_1985Z: posts the ante 750
gomsipjorn: posts the ante 750
Pedrozadota: posts the ante 750
fellipeschmeil: posts small blind 3000
chuchukat: posts big blind 6000
*** HOLE CARDS ***
lftgjc: folds 
vip_1985Z: folds 
gomsipjorn: raises 7200 to 13200
Pedrozadota: folds 
Naaarrrr: folds 
LV_Arturs: folds 
fellipeschmeil: folds 
chuchukat: raises 37800 to 51000
gomsipjorn: folds 
Uncalled bet (37800) returned to chuchukat
chuchukat collected 35400 from pot
chuchukat: doesn't show hand 
*** SUMMARY ***
Total pot 35400 | Rake 0 
Seat 1: Naaarrrr folded before Flop (didn't bet)
Seat 2: LV_Arturs (button) folded before Flop (didn't bet)
Seat 3: fellipeschmeil (small blind) folded before Flop
Seat 4: chuchukat (big blind) collected (35400)
Seat 5: lftgjc folded before Flop (didn't bet)
Seat 6: vip_1985Z folded before Flop (didn't bet)
Seat 7: gomsipjorn folded before Flop
Seat 8: Pedrozadota folded before Flop (didn't bet)

PokerStars Hand #251207073081: Tournament #3767885527, $40+$10+$5 USD Hold'em No Limit - Level XX (3000/6000) - 2024/06/26 20:36:42 UTC [2024/06/26 16:36:42 ET]
Table '3767885527 57' 8-max Seat #3 is the button
Seat 1: Naaarrrr (227038 in chips) 
Seat 2: LV_Arturs (131127 in chips) 
Seat 3: fellipeschmeil (63574 in chips) 
Seat 4: chuchukat (358804 in chips) 
Seat 5: lftgjc (235387 in chips) 
Seat 6: vip_1985Z (49893 in chips) 
Seat 7: gomsipjorn (215761 in chips) 
Seat 8: Pedrozadota (86734 in chips) 
Naaarrrr: posts the ante 750
LV_Arturs: posts the ante 750
fellipeschmeil: posts the ante 750
chuchukat: posts the ante 750
lftgjc: posts the ante 750
vip_1985Z: posts the ante 750
gomsipjorn: posts the ante 750
Pedrozadota: posts the ante 750
chuchukat: posts small blind 3000
lftgjc: posts big blind 6000
*** HOLE CARDS ***
vip_1985Z: folds 
gomsipjorn: folds 
Pedrozadota: folds 
Naaarrrr: folds 
LV_Arturs: folds 
fellipeschmeil: folds 
chuchukat: raises 15000 to 21000
lftgjc: raises 33000 to 54000
chuchukat: folds 
Uncalled bet (33000) returned to lftgjc
lftgjc collected 48000 from pot
lftgjc: doesn't show hand 
*** SUMMARY ***
Total pot 48000 | Rake 0 
Seat 1: Naaarrrr folded before Flop (didn't bet)
Seat 2: LV_Arturs folded before Flop (didn't bet)
Seat 3: fellipeschmeil (button) folded before Flop (didn't bet)
Seat 4: chuchukat (small blind) folded before Flop
Seat 5: lftgjc (big blind) collected (48000)
Seat 6: vip_1985Z folded before Flop (didn't bet)
Seat 7: gomsipjorn folded before Flop (didn't bet)
Seat 8: Pedrozadota folded before Flop (didn't bet)

PokerStars Hand #251207083107: Tournament #3767885527, $40+$10+$5 USD Hold'em No Limit - Level XX (3000/6000) - 2024/06/26 20:37:17 UTC [2024/06/26 16:37:17 ET]
Table '3767885527 57' 8-max Seat #4 is the button
Seat 1: Naaarrrr (226288 in chips) 
Seat 2: LV_Arturs (130377 in chips) 
Seat 3: fellipeschmeil (62824 in chips) 
Seat 4: chuchukat (337054 in chips) 
Seat 5: lftgjc (261637 in chips) 
Seat 6: vip_1985Z (49143 in chips) 
Seat 7: gomsipjorn (215011 in chips) 
Seat 8: Pedrozadota (85984 in chips) 
Naaarrrr: posts the ante 750
LV_Arturs: posts the ante 750
fellipeschmeil: posts the ante 750
chuchukat: posts the ante 750
lftgjc: posts the ante 750
vip_1985Z: posts the ante 750
gomsipjorn: posts the ante 750
Pedrozadota: posts the ante 750
lftgjc: posts small blind 3000
vip_1985Z: posts big blind 6000
*** HOLE CARDS ***
gomsipjorn: raises 6000 to 12000
Pedrozadota: folds 
Naaarrrr: folds 
LV_Arturs: folds 
fellipeschmeil: folds 
chuchukat: calls 12000
lftgjc: folds 
vip_1985Z: calls 6000
*** FLOP *** [5h Ts 2d]
vip_1985Z: bets 36393 and is all-in
gomsipjorn: folds 
chuchukat: folds 
Uncalled bet (36393) returned to vip_1985Z
vip_1985Z collected 45000 from pot
vip_1985Z: doesn't show hand 
*** SUMMARY ***
Total pot 45000 | Rake 0 
Board [5h Ts 2d]
Seat 1: Naaarrrr folded before Flop (didn't bet)
Seat 2: LV_Arturs folded before Flop (didn't bet)
Seat 3: fellipeschmeil folded before Flop (didn't bet)
Seat 4: chuchukat (button) folded on the Flop
Seat 5: lftgjc (small blind) folded before Flop
Seat 6: vip_1985Z (big blind) collected (45000)
Seat 7: gomsipjorn folded on the Flop
Seat 8: Pedrozadota folded before Flop (didn't bet)

PokerStars Hand #251207097684: Tournament #3767885527, $40+$10+$5 USD Hold'em No Limit - Level XX (3000/6000) - 2024/06/26 20:38:08 UTC [2024/06/26 16:38:08 ET]
Table '3767885527 57' 8-max Seat #5 is the button
Seat 1: Naaarrrr (225538 in chips) 
Seat 2: LV_Arturs (129627 in chips) 
Seat 3: fellipeschmeil (62074 in chips) 
Seat 4: chuchukat (324304 in chips) 
Seat 5: lftgjc (257887 in chips) 
Seat 6: vip_1985Z (81393 in chips) 
Seat 7: gomsipjorn (202261 in chips) 
Seat 8: Pedrozadota (85234 in chips) 
Naaarrrr: posts the ante 750
LV_Arturs: posts the ante 750
fellipeschmeil: posts the ante 750
chuchukat: posts the ante 750
lftgjc: posts the ante 750
vip_1985Z: posts the ante 750
gomsipjorn: posts the ante 750
Pedrozadota: posts the ante 750
vip_1985Z: posts small blind 3000
gomsipjorn: posts big blind 6000
*** HOLE CARDS ***
Pedrozadota: folds 
Naaarrrr: folds 
LV_Arturs: folds 
fellipeschmeil: folds 
chuchukat: raises 6000 to 12000
lftgjc: folds 
vip_1985Z: folds 
gomsipjorn: folds 
Uncalled bet (6000) returned to chuchukat
chuchukat collected 21000 from pot
chuchukat: doesn't show hand 
*** SUMMARY ***
Total pot 21000 | Rake 0 
Seat 1: Naaarrrr folded before Flop (didn't bet)
Seat 2: LV_Arturs folded before Flop (didn't bet)
Seat 3: fellipeschmeil folded before Flop (didn't bet)
Seat 4: chuchukat collected (21000)
Seat 5: lftgjc (button) folded before Flop (didn't bet)
Seat 6: vip_1985Z (small blind) folded before Flop
Seat 7: gomsipjorn (big blind) folded before Flop
Seat 8: Pedrozadota folded before Flop (didn't bet)

PokerStars Hand #251207104273: Tournament #3767885527, $40+$10+$5 USD Hold'em No Limit - Level XX (3000/6000) - 2024/06/26 20:38:32 UTC [2024/06/26 16:38:32 ET]
Table '3767885527 57' 8-max Seat #6 is the button
Seat 1: Naaarrrr (224788 in chips) 
Seat 2: LV_Arturs (128877 in chips) 
Seat 3: fellipeschmeil (61324 in chips) 
Seat 4: chuchukat (338554 in chips) 
Seat 5: lftgjc (257137 in chips) 
Seat 6: vip_1985Z (77643 in chips) 
Seat 7: gomsipjorn (195511 in chips) 
Seat 8: Pedrozadota (84484 in chips) 
Naaarrrr: posts the ante 750
LV_Arturs: posts the ante 750
fellipeschmeil: posts the ante 750
chuchukat: posts the ante 750
lftgjc: posts the ante 750
vip_1985Z: posts the ante 750
gomsipjorn: posts the ante 750
Pedrozadota: posts the ante 750
gomsipjorn: posts small blind 3000
Pedrozadota: posts big blind 6000
*** HOLE CARDS ***
Naaarrrr: folds 
LV_Arturs: folds 
fellipeschmeil: folds 
chuchukat: folds 
lftgjc: folds 
vip_1985Z: folds 
gomsipjorn: calls 3000
Pedrozadota: checks 
*** FLOP *** [4c 7h Qc]
gomsipjorn: checks 
Pedrozadota: bets 6000
gomsipjorn: folds 
Uncalled bet (6000) returned to Pedrozadota
Pedrozadota collected 18000 from pot
Pedrozadota: doesn't show hand 
*** SUMMARY ***
Total pot 18000 | Rake 0 
Board [4c 7h Qc]
Seat 1: Naaarrrr folded before Flop (didn't bet)
Seat 2: LV_Arturs folded before Flop (didn't bet)
Seat 3: fellipeschmeil folded before Flop (didn't bet)
Seat 4: chuchukat folded before Flop (didn't bet)
Seat 5: lftgjc folded before Flop (didn't bet)
Seat 6: vip_1985Z (button) folded before Flop (didn't bet)
Seat 7: gomsipjorn (small blind) folded on the Flop
Seat 8: Pedrozadota (big blind) collected (18000)

PokerStars Hand #251207116119: Tournament #3767885527, $40+$10+$5 USD Hold'em No Limit - Level XX (3000/6000) - 2024/06/26 20:39:14 UTC [2024/06/26 16:39:14 ET]
Table '3767885527 57' 8-max Seat #7 is the button
Seat 1: Naaarrrr (224038 in chips) 
Seat 2: LV_Arturs (128127 in chips) 
Seat 3: fellipeschmeil (60574 in chips) 
Seat 4: chuchukat (337804 in chips) 
Seat 5: lftgjc (256387 in chips) 
Seat 6: vip_1985Z (76893 in chips) 
Seat 7: gomsipjorn (188761 in chips) 
Seat 8: Pedrozadota (95734 in chips) 
Naaarrrr: posts the ante 750
LV_Arturs: posts the ante 750
fellipeschmeil: posts the ante 750
chuchukat: posts the ante 750
lftgjc: posts the ante 750
vip_1985Z: posts the ante 750
gomsipjorn: posts the ante 750
Pedrozadota: posts the ante 750
Pedrozadota: posts small blind 3000
Naaarrrr: posts big blind 6000
*** HOLE CARDS ***
LV_Arturs: folds 
fellipeschmeil: folds 
chuchukat: folds 
lftgjc: folds 
vip_1985Z: folds 
gomsipjorn: folds 
Pedrozadota: raises 88984 to 94984 and is all-in
Naaarrrr: calls 88984
*** FLOP *** [Qh 4h 5s]
*** TURN *** [Qh 4h 5s] [Kc]
*** RIVER *** [Qh 4h 5s Kc] [Qd]
*** SHOW DOWN ***
Pedrozadota: shows [Jc 9c] (a pair of Queens)
Naaarrrr: shows [Ah Tc] (a pair of Queens - Ace kicker)
Naaarrrr collected 195968 from pot
Pedrozadota finished the tournament in 253rd place and received $104.64.
*** SUMMARY ***
Total pot 195968 | Rake 0 
Board [Qh 4h 5s Kc Qd]
Seat 1: Naaarrrr (big blind) showed [Ah Tc] and won (195968) with a pair of Queens
Seat 2: LV_Arturs folded before Flop (didn't bet)
Seat 3: fellipeschmeil folded before Flop (didn't bet)
Seat 4: chuchukat folded before Flop (didn't bet)
Seat 5: lftgjc folded before Flop (didn't bet)
Seat 6: vip_1985Z folded before Flop (didn't bet)
Seat 7: gomsipjorn (button) folded before Flop (didn't bet)
Seat 8: Pedrozadota (small blind) showed [Jc 9c] and lost with a pair of Queens

PokerStars Hand #251207124024: Tournament #3767885527, $40+$10+$5 USD Hold'em No Limit - Level XX (3000/6000) - 2024/06/26 20:39:42 UTC [2024/06/26 16:39:42 ET]
Table '3767885527 57' 8-max Seat #1 is the button
Seat 1: Naaarrrr (324272 in chips) 
Seat 2: LV_Arturs (127377 in chips) 
Seat 3: fellipeschmeil (59824 in chips) 
Seat 4: chuchukat (337054 in chips) 
Seat 5: lftgjc (255637 in chips) 
Seat 6: vip_1985Z (76143 in chips) 
Seat 7: gomsipjorn (188011 in chips) 
Naaarrrr: posts the ante 750
LV_Arturs: posts the ante 750
fellipeschmeil: posts the ante 750
chuchukat: posts the ante 750
lftgjc: posts the ante 750
vip_1985Z: posts the ante 750
gomsipjorn: posts the ante 750
LV_Arturs: posts small blind 3000
fellipeschmeil: posts big blind 6000
*** HOLE CARDS ***
chuchukat: folds 
lftgjc: folds 
vip_1985Z: folds 
gomsipjorn: folds 
Naaarrrr: raises 6000 to 12000
LV_Arturs: folds 
fellipeschmeil: calls 6000
*** FLOP *** [4c Ts 3d]
fellipeschmeil: checks 
Naaarrrr: bets 6000
fellipeschmeil: raises 41074 to 47074 and is all-in
Naaarrrr: calls 41074
*** TURN *** [4c Ts 3d] [5s]
*** RIVER *** [4c Ts 3d 5s] [8h]
*** SHOW DOWN ***
fellipeschmeil: shows [5d 6h] (a pair of Fives)
Naaarrrr: shows [Tc Jc] (a pair of Tens)
Naaarrrr collected 126398 from pot
fellipeschmeil finished the tournament in 249th place and received $104.64.
*** SUMMARY ***
Total pot 126398 | Rake 0 
Board [4c Ts 3d 5s 8h]
Seat 1: Naaarrrr (button) showed [Tc Jc] and won (126398) with a pair of Tens
Seat 2: LV_Arturs (small blind) folded before Flop
Seat 3: fellipeschmeil (big blind) showed [5d 6h] and lost with a pair of Fives
Seat 4: chuchukat folded before Flop (didn't bet)
Seat 5: lftgjc folded before Flop (didn't bet)
Seat 6: vip_1985Z folded before Flop (didn't bet)
Seat 7: gomsipjorn folded before Flop (didn't bet)


PokerStars Hand #251205060848: Tournament #3767885527, $40+$10+$5 USD Hold'em No Limit - Level VIII (350/700) - 2024/06/26 18:30:34 UTC [2024/06/26 14:30:34 ET]
Table '3767885527 37' 8-max Seat #7 is the button
Seat 1: Katwoman0106 (25000 in chips) 
Seat 2: fAArid88 (15471 in chips) 
Seat 3: Sully1993_11 (20248 in chips) 
Seat 4: nahumdj (36537 in chips) 
Seat 5: johnyguedes1 (71457 in chips) 
Seat 6: yuzoyai (10651 in chips) 
Seat 7: junior_re612 (44625 in chips) 
Seat 8: epo9 (33020 in chips) 
Katwoman0106: posts the ante 90
fAArid88: posts the ante 90
Sully1993_11: posts the ante 90
nahumdj: posts the ante 90
johnyguedes1: posts the ante 90
yuzoyai: posts the ante 90
junior_re612: posts the ante 90
epo9: posts the ante 90
epo9: posts small blind 350
Katwoman0106: posts big blind 700
*** HOLE CARDS ***
fAArid88: folds 
Sully1993_11: calls 700
nahumdj: folds 
johnyguedes1: folds 
yuzoyai: folds 
junior_re612: raises 1750 to 2450
epo9: folds 
Katwoman0106: calls 1750
Sully1993_11: calls 1750
*** FLOP *** [3c 5c Ks]
Katwoman0106: checks 
Sully1993_11: checks 
junior_re612: bets 2772
Katwoman0106: folds 
Sully1993_11: folds 
Uncalled bet (2772) returned to junior_re612
junior_re612 collected 8420 from pot
junior_re612: doesn't show hand 
*** SUMMARY ***
Total pot 8420 | Rake 0 
Board [3c 5c Ks]
Seat 1: Katwoman0106 (big blind) folded on the Flop
Seat 2: fAArid88 folded before Flop (didn't bet)
Seat 3: Sully1993_11 folded on the Flop
Seat 4: nahumdj folded before Flop (didn't bet)
Seat 5: johnyguedes1 folded before Flop (didn't bet)
Seat 6: yuzoyai folded before Flop (didn't bet)
Seat 7: junior_re612 (button) collected (8420)
Seat 8: epo9 (small blind) folded before Flop

PokerStars Hand #251205079554: Tournament #3767885527, $40+$10+$5 USD Hold'em No Limit - Level VIII (350/700) - 2024/06/26 18:31:47 UTC [2024/06/26 14:31:47 ET]
Table '3767885527 37' 8-max Seat #8 is the button
Seat 1: Katwoman0106 (22460 in chips) 
Seat 2: fAArid88 (15381 in chips) 
Seat 3: Sully1993_11 (17708 in chips) 
Seat 4: nahumdj (36447 in chips) 
Seat 5: johnyguedes1 (71367 in chips) 
Seat 6: yuzoyai (10561 in chips) 
Seat 7: junior_re612 (50505 in chips) 
Seat 8: epo9 (32580 in chips) 
Katwoman0106: posts the ante 90
fAArid88: posts the ante 90
Sully1993_11: posts the ante 90
nahumdj: posts the ante 90
johnyguedes1: posts the ante 90
yuzoyai: posts the ante 90
junior_re612: posts the ante 90
epo9: posts the ante 90
Katwoman0106: posts small blind 350
fAArid88: posts big blind 700
*** HOLE CARDS ***
Sully1993_11: folds 
nahumdj: folds 
johnyguedes1: folds 
yuzoyai: folds 
junior_re612: raises 700 to 1400
epo9: folds 
Katwoman0106: folds 
fAArid88: folds 
Uncalled bet (700) returned to junior_re612
junior_re612 collected 2470 from pot
junior_re612: doesn't show hand 
*** SUMMARY ***
Total pot 2470 | Rake 0 
Seat 1: Katwoman0106 (small blind) folded before Flop
Seat 2: fAArid88 (big blind) folded before Flop
Seat 3: Sully1993_11 folded before Flop (didn't bet)
Seat 4: nahumdj folded before Flop (didn't bet)
Seat 5: johnyguedes1 folded before Flop (didn't bet)
Seat 6: yuzoyai folded before Flop (didn't bet)
Seat 7: junior_re612 collected (2470)
Seat 8: epo9 (button) folded before Flop (didn't bet)

PokerStars Hand #251205088586: Tournament #3767885527, $40+$10+$5 USD Hold'em No Limit - Level IX (400/800) - 2024/06/26 18:32:23 UTC [2024/06/26 14:32:23 ET]
Table '3767885527 37' 8-max Seat #1 is the button
Seat 1: Katwoman0106 (22020 in chips) 
Seat 2: fAArid88 (14591 in chips) 
Seat 3: Sully1993_11 (17618 in chips) 
Seat 4: nahumdj (36357 in chips) 
Seat 5: johnyguedes1 (71277 in chips) 
Seat 6: yuzoyai (10471 in chips) 
Seat 7: junior_re612 (52185 in chips) 
Seat 8: epo9 (32490 in chips) 
Katwoman0106: posts the ante 100
fAArid88: posts the ante 100
Sully1993_11: posts the ante 100
nahumdj: posts the ante 100
johnyguedes1: posts the ante 100
yuzoyai: posts the ante 100
junior_re612: posts the ante 100
epo9: posts the ante 100
fAArid88: posts small blind 400
Sully1993_11: posts big blind 800
*** HOLE CARDS ***
nahumdj: folds 
johnyguedes1: raises 880 to 1680
yuzoyai: folds 
junior_re612: folds 
epo9: folds 
Katwoman0106: calls 1680
fAArid88: folds 
Sully1993_11: folds 
*** FLOP *** [Ad Ah 9s]
johnyguedes1: checks 
Katwoman0106: checks 
*** TURN *** [Ad Ah 9s] [6h]
johnyguedes1: bets 4449
Katwoman0106: folds 
Uncalled bet (4449) returned to johnyguedes1
johnyguedes1 collected 5360 from pot
johnyguedes1: doesn't show hand 
*** SUMMARY ***
Total pot 5360 | Rake 0 
Board [Ad Ah 9s 6h]
Seat 1: Katwoman0106 (button) folded on the Turn
Seat 2: fAArid88 (small blind) folded before Flop
Seat 3: Sully1993_11 (big blind) folded before Flop
Seat 4: nahumdj folded before Flop (didn't bet)
Seat 5: johnyguedes1 collected (5360)
Seat 6: yuzoyai folded before Flop (didn't bet)
Seat 7: junior_re612 folded before Flop (didn't bet)
Seat 8: epo9 folded before Flop (didn't bet)

PokerStars Hand #251205104056: Tournament #3767885527, $40+$10+$5 USD Hold'em No Limit - Level IX (400/800) - 2024/06/26 18:33:23 UTC [2024/06/26 14:33:23 ET]
Table '3767885527 37' 8-max Seat #2 is the button
Seat 1: Katwoman0106 (20240 in chips) 
Seat 2: fAArid88 (14091 in chips) 
Seat 3: Sully1993_11 (16718 in chips) 
Seat 4: nahumdj (36257 in chips) 
Seat 5: johnyguedes1 (74857 in chips) 
Seat 6: yuzoyai (10371 in chips) 
Seat 7: junior_re612 (52085 in chips) 
Seat 8: epo9 (32390 in chips) 
Katwoman0106: posts the ante 100
fAArid88: posts the ante 100
Sully1993_11: posts the ante 100
nahumdj: posts the ante 100
johnyguedes1: posts the ante 100
yuzoyai: posts the ante 100
junior_re612: posts the ante 100
epo9: posts the ante 100
Sully1993_11: posts small blind 400
nahumdj: posts big blind 800
*** HOLE CARDS ***
johnyguedes1: folds 
yuzoyai: folds 
junior_re612: folds 
epo9: raises 800 to 1600
Katwoman0106: folds 
fAArid88: folds 
Sully1993_11: calls 1200
nahumdj: calls 800
*** FLOP *** [Kc Ad 8d]
Sully1993_11: bets 2800
nahumdj: calls 2800
epo9: calls 2800
*** TURN *** [Kc Ad 8d] [Ks]
Sully1993_11: checks 
nahumdj: checks 
epo9: bets 4000
Sully1993_11: calls 4000
nahumdj: folds 
*** RIVER *** [Kc Ad 8d Ks] [4h]
Sully1993_11: checks 
epo9: checks 
*** SHOW DOWN ***
Sully1993_11: shows [Qh Ah] (two pair, Aces and Kings)
epo9: mucks hand 
Sully1993_11 collected 22000 from pot
*** SUMMARY ***
Total pot 22000 | Rake 0 
Board [Kc Ad 8d Ks 4h]
Seat 1: Katwoman0106 folded before Flop (didn't bet)
Seat 2: fAArid88 (button) folded before Flop (didn't bet)
Seat 3: Sully1993_11 (small blind) showed [Qh Ah] and won (22000) with two pair, Aces and Kings
Seat 4: nahumdj (big blind) folded on the Turn
Seat 5: johnyguedes1 folded before Flop (didn't bet)
Seat 6: yuzoyai folded before Flop (didn't bet)
Seat 7: junior_re612 folded before Flop (didn't bet)
Seat 8: epo9 mucked

PokerStars Hand #251205120323: Tournament #3767885527, $40+$10+$5 USD Hold'em No Limit - Level IX (400/800) - 2024/06/26 18:34:27 UTC [2024/06/26 14:34:27 ET]
Table '3767885527 37' 8-max Seat #3 is the button
Seat 1: Katwoman0106 (20140 in chips) 
Seat 2: fAArid88 (13991 in chips) 
Seat 3: Sully1993_11 (30218 in chips) 
Seat 4: nahumdj (31757 in chips) 
Seat 5: johnyguedes1 (74757 in chips) 
Seat 6: yuzoyai (10271 in chips) 
Seat 7: junior_re612 (51985 in chips) 
Seat 8: epo9 (23890 in chips) 
Katwoman0106: posts the ante 100
fAArid88: posts the ante 100
Sully1993_11: posts the ante 100
nahumdj: posts the ante 100
johnyguedes1: posts the ante 100
yuzoyai: posts the ante 100
junior_re612: posts the ante 100
epo9: posts the ante 100
nahumdj: posts small blind 400
johnyguedes1: posts big blind 800
*** HOLE CARDS ***
yuzoyai: folds 
junior_re612: folds 
epo9: folds 
Katwoman0106: folds 
fAArid88: folds 
Sully1993_11: folds 
nahumdj: folds 
Uncalled bet (400) returned to johnyguedes1
johnyguedes1 collected 1600 from pot
johnyguedes1: doesn't show hand 
*** SUMMARY ***
Total pot 1600 | Rake 0 
Seat 1: Katwoman0106 folded before Flop (didn't bet)
Seat 2: fAArid88 folded before Flop (didn't bet)
Seat 3: Sully1993_11 (button) folded before Flop (didn't bet)
Seat 4: nahumdj (small blind) folded before Flop
Seat 5: johnyguedes1 (big blind) collected (1600)
Seat 6: yuzoyai folded before Flop (didn't bet)
Seat 7: junior_re612 folded before Flop (didn't bet)
Seat 8: epo9 folded before Flop (didn't bet)

PokerStars Hand #251205130850: Tournament #3767885527, $40+$10+$5 USD Hold'em No Limit - Level IX (400/800) - 2024/06/26 18:35:08 UTC [2024/06/26 14:35:08 ET]
Table '3767885527 37' 8-max Seat #4 is the button
Seat 1: Katwoman0106 (20040 in chips) 
Seat 2: fAArid88 (13891 in chips) 
Seat 3: Sully1993_11 (30118 in chips) 
Seat 4: nahumdj (31257 in chips) 
Seat 5: johnyguedes1 (75857 in chips) 
Seat 6: yuzoyai (10171 in chips) 
Seat 7: junior_re612 (51885 in chips) 
Seat 8: epo9 (23790 in chips) 
Katwoman0106: posts the ante 100
fAArid88: posts the ante 100
Sully1993_11: posts the ante 100
nahumdj: posts the ante 100
johnyguedes1: posts the ante 100
yuzoyai: posts the ante 100
junior_re612: posts the ante 100
epo9: posts the ante 100
johnyguedes1: posts small blind 400
yuzoyai: posts big blind 800
*** HOLE CARDS ***
junior_re612: folds 
epo9: folds 
Katwoman0106: folds 
fAArid88: folds 
Sully1993_11: calls 800
nahumdj: folds 
johnyguedes1: raises 2400 to 3200
yuzoyai: raises 6871 to 10071 and is all-in
Sully1993_11: folds 
johnyguedes1: calls 6871
*** FLOP *** [7h 2c Qs]
*** TURN *** [7h 2c Qs] [5h]
*** RIVER *** [7h 2c Qs 5h] [5c]
*** SHOW DOWN ***
johnyguedes1: shows [Tc Jc] (a pair of Fives)
yuzoyai: shows [Ah Qh] (two pair, Queens and Fives)
yuzoyai collected 21742 from pot
*** SUMMARY ***
Total pot 21742 | Rake 0 
Board [7h 2c Qs 5h 5c]
Seat 1: Katwoman0106 folded before Flop (didn't bet)
Seat 2: fAArid88 folded before Flop (didn't bet)
Seat 3: Sully1993_11 folded before Flop
Seat 4: nahumdj (button) folded before Flop (didn't bet)
Seat 5: johnyguedes1 (small blind) showed [Tc Jc] and lost with a pair of Fives
Seat 6: yuzoyai (big blind) showed [Ah Qh] and won (21742) with two pair, Queens and Fives
Seat 7: junior_re612 folded before Flop (didn't bet)
Seat 8: epo9 folded before Flop (didn't bet)

PokerStars Hand #251205149407: Tournament #3767885527, $40+$10+$5 USD Hold'em No Limit - Level IX (400/800) - 2024/06/26 18:36:21 UTC [2024/06/26 14:36:21 ET]
Table '3767885527 37' 8-max Seat #5 is the button
Seat 1: Katwoman0106 (19940 in chips) 
Seat 2: fAArid88 (13791 in chips) 
Seat 3: Sully1993_11 (29218 in chips) 
Seat 4: nahumdj (31157 in chips) 
Seat 5: johnyguedes1 (65686 in chips) 
Seat 6: yuzoyai (21742 in chips) 
Seat 7: junior_re612 (51785 in chips) 
Seat 8: epo9 (23690 in chips) 
Katwoman0106: posts the ante 100
fAArid88: posts the ante 100
Sully1993_11: posts the ante 100
nahumdj: posts the ante 100
johnyguedes1: posts the ante 100
yuzoyai: posts the ante 100
junior_re612: posts the ante 100
epo9: posts the ante 100
yuzoyai: posts small blind 400
junior_re612: posts big blind 800
*** HOLE CARDS ***
epo9: folds 
Katwoman0106: folds 
fAArid88: folds 
Sully1993_11: raises 1600 to 2400
nahumdj: folds 
johnyguedes1: folds 
yuzoyai: folds 
junior_re612: folds 
Uncalled bet (1600) returned to Sully1993_11
Sully1993_11 collected 2800 from pot
Sully1993_11: doesn't show hand 
*** SUMMARY ***
Total pot 2800 | Rake 0 
Seat 1: Katwoman0106 folded before Flop (didn't bet)
Seat 2: fAArid88 folded before Flop (didn't bet)
Seat 3: Sully1993_11 collected (2800)
Seat 4: nahumdj folded before Flop (didn't bet)
Seat 5: johnyguedes1 (button) folded before Flop (didn't bet)
Seat 6: yuzoyai (small blind) folded before Flop
Seat 7: junior_re612 (big blind) folded before Flop
Seat 8: epo9 folded before Flop (didn't bet)

PokerStars Hand #251205158420: Tournament #3767885527, $40+$10+$5 USD Hold'em No Limit - Level IX (400/800) - 2024/06/26 18:36:56 UTC [2024/06/26 14:36:56 ET]
Table '3767885527 37' 8-max Seat #6 is the button
Seat 1: Katwoman0106 (19840 in chips) 
Seat 2: fAArid88 (13691 in chips) 
Seat 3: Sully1993_11 (31118 in chips) 
Seat 4: nahumdj (31057 in chips) 
Seat 5: johnyguedes1 (65586 in chips) 
Seat 6: yuzoyai (21242 in chips) 
Seat 7: junior_re612 (50885 in chips) 
Seat 8: epo9 (23590 in chips) 
Katwoman0106: posts the ante 100
fAArid88: posts the ante 100
Sully1993_11: posts the ante 100
nahumdj: posts the ante 100
johnyguedes1: posts the ante 100
yuzoyai: posts the ante 100
junior_re612: posts the ante 100
epo9: posts the ante 100
junior_re612: posts small blind 400
epo9: posts big blind 800
*** HOLE CARDS ***
Katwoman0106: raises 800 to 1600
fAArid88: folds 
Sully1993_11: folds 
nahumdj: folds 
johnyguedes1: folds 
yuzoyai: folds 
junior_re612: calls 1200
epo9: calls 800
*** FLOP *** [8s 3h Th]
junior_re612: checks 
epo9: bets 2400
Katwoman0106: calls 2400
junior_re612: folds 
*** TURN *** [8s 3h Th] [4c]
epo9: bets 7200
Katwoman0106: raises 8540 to 15740 and is all-in
epo9: calls 8540
*** RIVER *** [8s 3h Th 4c] [Ad]
*** SHOW DOWN ***
epo9: shows [9h Kh] (high card Ace)
Katwoman0106: shows [Td Kd] (a pair of Tens)
Katwoman0106 collected 41880 from pot
*** SUMMARY ***
Total pot 41880 | Rake 0 
Board [8s 3h Th 4c Ad]
Seat 1: Katwoman0106 showed [Td Kd] and won (41880) with a pair of Tens
Seat 2: fAArid88 folded before Flop (didn't bet)
Seat 3: Sully1993_11 folded before Flop (didn't bet)
Seat 4: nahumdj folded before Flop (didn't bet)
Seat 5: johnyguedes1 folded before Flop (didn't bet)
Seat 6: yuzoyai (button) folded before Flop (didn't bet)
Seat 7: junior_re612 (small blind) folded on the Flop
Seat 8: epo9 (big blind) showed [9h Kh] and lost with high card Ace

PokerStars Hand #251205177548: Tournament #3767885527, $40+$10+$5 USD Hold'em No Limit - Level IX (400/800) - 2024/06/26 18:38:09 UTC [2024/06/26 14:38:09 ET]
Table '3767885527 37' 8-max Seat #7 is the button
Seat 1: Katwoman0106 (41880 in chips) 
Seat 2: fAArid88 (13591 in chips) 
Seat 3: Sully1993_11 (31018 in chips) 
Seat 4: nahumdj (30957 in chips) 
Seat 5: johnyguedes1 (65486 in chips) 
Seat 6: yuzoyai (21142 in chips) 
Seat 7: junior_re612 (49185 in chips) 
Seat 8: epo9 (3750 in chips) 
Katwoman0106: posts the ante 100
fAArid88: posts the ante 100
Sully1993_11: posts the ante 100
nahumdj: posts the ante 100
johnyguedes1: posts the ante 100
yuzoyai: posts the ante 100
junior_re612: posts the ante 100
epo9: posts the ante 100
epo9: posts small blind 400
Katwoman0106: posts big blind 800
*** HOLE CARDS ***
fAArid88: folds 
Sully1993_11: calls 800
nahumdj: folds 
johnyguedes1: folds 
yuzoyai: folds 
junior_re612: folds 
epo9: calls 400
Katwoman0106: checks 
*** FLOP *** [3s 6d Jd]
epo9: checks 
Katwoman0106: checks 
Sully1993_11: checks 
*** TURN *** [3s 6d Jd] [Qc]
epo9: bets 2850 and is all-in
Katwoman0106: folds 
Sully1993_11: folds 
Uncalled bet (2850) returned to epo9
epo9 collected 3200 from pot
*** SUMMARY ***
Total pot 3200 | Rake 0 
Board [3s 6d Jd Qc]
Seat 1: Katwoman0106 (big blind) folded on the Turn
Seat 2: fAArid88 folded before Flop (didn't bet)
Seat 3: Sully1993_11 folded on the Turn
Seat 4: nahumdj folded before Flop (didn't bet)
Seat 5: johnyguedes1 folded before Flop (didn't bet)
Seat 6: yuzoyai folded before Flop (didn't bet)
Seat 7: junior_re612 (button) folded before Flop (didn't bet)
Seat 8: epo9 (small blind) collected (3200)

PokerStars Hand #251205191801: Tournament #3767885527, $40+$10+$5 USD Hold'em No Limit - Level IX (400/800) - 2024/06/26 18:39:05 UTC [2024/06/26 14:39:05 ET]
Table '3767885527 37' 8-max Seat #8 is the button
Seat 1: Katwoman0106 (40980 in chips) 
Seat 2: fAArid88 (13491 in chips) 
Seat 3: Sully1993_11 (30118 in chips) 
Seat 4: nahumdj (30857 in chips) 
Seat 5: johnyguedes1 (65386 in chips) 
Seat 6: yuzoyai (21042 in chips) 
Seat 7: junior_re612 (49085 in chips) 
Seat 8: epo9 (6050 in chips) 
Katwoman0106: posts the ante 100
fAArid88: posts the ante 100
Sully1993_11: posts the ante 100
nahumdj: posts the ante 100
johnyguedes1: posts the ante 100
yuzoyai: posts the ante 100
junior_re612: posts the ante 100
epo9: posts the ante 100
Katwoman0106: posts small blind 400
fAArid88: posts big blind 800
*** HOLE CARDS ***
Sully1993_11: folds 
nahumdj: raises 800 to 1600
johnyguedes1: folds 
yuzoyai: folds 
junior_re612: folds 
epo9: folds 
Katwoman0106: folds 
fAArid88: raises 11791 to 13391 and is all-in
nahumdj: calls 11791
*** FLOP *** [4h Kc 2c]
*** TURN *** [4h Kc 2c] [4c]
*** RIVER *** [4h Kc 2c 4c] [8c]
*** SHOW DOWN ***
fAArid88: shows [Tc Ts] (a flush, King high)
nahumdj: shows [9s 9d] (two pair, Nines and Fours)
fAArid88 collected 27982 from pot
*** SUMMARY ***
Total pot 27982 | Rake 0 
Board [4h Kc 2c 4c 8c]
Seat 1: Katwoman0106 (small blind) folded before Flop
Seat 2: fAArid88 (big blind) showed [Tc Ts] and won (27982) with a flush, King high
Seat 3: Sully1993_11 folded before Flop (didn't bet)
Seat 4: nahumdj showed [9s 9d] and lost with two pair, Nines and Fours
Seat 5: johnyguedes1 folded before Flop (didn't bet)
Seat 6: yuzoyai folded before Flop (didn't bet)
Seat 7: junior_re612 folded before Flop (didn't bet)
Seat 8: epo9 (button) folded before Flop (didn't bet)

PokerStars Hand #251205202869: Tournament #3767885527, $40+$10+$5 USD Hold'em No Limit - Level IX (400/800) - 2024/06/26 18:39:48 UTC [2024/06/26 14:39:48 ET]
Table '3767885527 37' 8-max Seat #1 is the button
Seat 1: Katwoman0106 (40480 in chips) 
Seat 2: fAArid88 (27982 in chips) 
Seat 3: Sully1993_11 (30018 in chips) 
Seat 4: nahumdj (17366 in chips) 
Seat 5: johnyguedes1 (65286 in chips) 
Seat 6: yuzoyai (20942 in chips) 
Seat 7: junior_re612 (48985 in chips) 
Seat 8: epo9 (5950 in chips) 
Katwoman0106: posts the ante 100
fAArid88: posts the ante 100
Sully1993_11: posts the ante 100
nahumdj: posts the ante 100
johnyguedes1: posts the ante 100
yuzoyai: posts the ante 100
junior_re612: posts the ante 100
epo9: posts the ante 100
fAArid88: posts small blind 400
Sully1993_11: posts big blind 800
*** HOLE CARDS ***
nahumdj: folds 
johnyguedes1: folds 
yuzoyai: folds 
junior_re612: raises 800 to 1600
epo9: folds 
Katwoman0106: folds 
fAArid88: folds 
Sully1993_11: folds 
Uncalled bet (800) returned to junior_re612
junior_re612 collected 2800 from pot
junior_re612: doesn't show hand 
*** SUMMARY ***
Total pot 2800 | Rake 0 
Seat 1: Katwoman0106 (button) folded before Flop (didn't bet)
Seat 2: fAArid88 (small blind) folded before Flop
Seat 3: Sully1993_11 (big blind) folded before Flop
Seat 4: nahumdj folded before Flop (didn't bet)
Seat 5: johnyguedes1 folded before Flop (didn't bet)
Seat 6: yuzoyai folded before Flop (didn't bet)
Seat 7: junior_re612 collected (2800)
Seat 8: epo9 folded before Flop (didn't bet)

PokerStars Hand #251205212451: Tournament #3767885527, $40+$10+$5 USD Hold'em No Limit - Level IX (400/800) - 2024/06/26 18:40:24 UTC [2024/06/26 14:40:24 ET]
Table '3767885527 37' 8-max Seat #2 is the button
Seat 1: Katwoman0106 (40380 in chips) 
Seat 2: fAArid88 (27482 in chips) 
Seat 3: Sully1993_11 (29118 in chips) 
Seat 4: nahumdj (17266 in chips) 
Seat 5: johnyguedes1 (65186 in chips) 
Seat 6: yuzoyai (20842 in chips) 
Seat 7: junior_re612 (50885 in chips) 
Seat 8: epo9 (5850 in chips) 
Katwoman0106: posts the ante 100
fAArid88: posts the ante 100
Sully1993_11: posts the ante 100
nahumdj: posts the ante 100
johnyguedes1: posts the ante 100
yuzoyai: posts the ante 100
junior_re612: posts the ante 100
epo9: posts the ante 100
Sully1993_11: posts small blind 400
nahumdj: posts big blind 800
*** HOLE CARDS ***
johnyguedes1: folds 
yuzoyai: folds 
junior_re612: raises 800 to 1600
epo9: calls 1600
Katwoman0106: calls 1600
fAArid88: folds 
Sully1993_11: folds 
nahumdj: folds 
*** FLOP *** [Jd 7c 7h]
junior_re612: checks 
epo9: bets 4150 and is all-in
Katwoman0106: calls 4150
junior_re612: folds 
*** TURN *** [Jd 7c 7h] [Ah]
*** RIVER *** [Jd 7c 7h Ah] [Qd]
*** SHOW DOWN ***
epo9: shows [Ks Qs] (two pair, Queens and Sevens)
Katwoman0106: shows [7d 7s] (four of a kind, Sevens)
Katwoman0106 collected 15100 from pot
epo9 finished the tournament
*** SUMMARY ***
Total pot 15100 | Rake 0 
Board [Jd 7c 7h Ah Qd]
Seat 1: Katwoman0106 showed [7d 7s] and won (15100) with four of a kind, Sevens
Seat 2: fAArid88 (button) folded before Flop (didn't bet)
Seat 3: Sully1993_11 (small blind) folded before Flop
Seat 4: nahumdj (big blind) folded before Flop
Seat 5: johnyguedes1 folded before Flop (didn't bet)
Seat 6: yuzoyai folded before Flop (didn't bet)
Seat 7: junior_re612 folded on the Flop
Seat 8: epo9 showed [Ks Qs] and lost with two pair, Queens and Sevens

PokerStars Hand #251205229299: Tournament #3767885527, $40+$10+$5 USD Hold'em No Limit - Level IX (400/800) - 2024/06/26 18:41:29 UTC [2024/06/26 14:41:29 ET]
Table '3767885527 37' 8-max Seat #3 is the button
Seat 1: Katwoman0106 (49630 in chips) 
Seat 2: fAArid88 (27382 in chips) 
Seat 3: Sully1993_11 (28618 in chips) 
Seat 4: nahumdj (16366 in chips) 
Seat 5: johnyguedes1 (65086 in chips) 
Seat 6: yuzoyai (20742 in chips) 
Seat 7: junior_re612 (49185 in chips) 
Katwoman0106: posts the ante 100
fAArid88: posts the ante 100
Sully1993_11: posts the ante 100
nahumdj: posts the ante 100
johnyguedes1: posts the ante 100
yuzoyai: posts the ante 100
junior_re612: posts the ante 100
nahumdj: posts small blind 400
johnyguedes1: posts big blind 800
*** HOLE CARDS ***
yuzoyai: folds 
junior_re612: folds 
Katwoman0106: folds 
fAArid88: folds 
Sully1993_11: folds 
nahumdj: folds 
Uncalled bet (400) returned to johnyguedes1
johnyguedes1 collected 1500 from pot
johnyguedes1: doesn't show hand 
*** SUMMARY ***
Total pot 1500 | Rake 0 
Seat 1: Katwoman0106 folded before Flop (didn't bet)
Seat 2: fAArid88 folded before Flop (didn't bet)
Seat 3: Sully1993_11 (button) folded before Flop (didn't bet)
Seat 4: nahumdj (small blind) folded before Flop
Seat 5: johnyguedes1 (big blind) collected (1500)
Seat 6: yuzoyai folded before Flop (didn't bet)
Seat 7: junior_re612 folded before Flop (didn't bet)

PokerStars Hand #251205233398: Tournament #3767885527, $40+$10+$5 USD Hold'em No Limit - Level IX (400/800) - 2024/06/26 18:41:45 UTC [2024/06/26 14:41:45 ET]
Table '3767885527 37' 8-max Seat #4 is the button
Seat 1: Katwoman0106 (49530 in chips) 
Seat 2: fAArid88 (27282 in chips) 
Seat 3: Sully1993_11 (28518 in chips) 
Seat 4: nahumdj (15866 in chips) 
Seat 5: johnyguedes1 (66086 in chips) 
Seat 6: yuzoyai (20642 in chips) 
Seat 7: junior_re612 (49085 in chips) 
Katwoman0106: posts the ante 100
fAArid88: posts the ante 100
Sully1993_11: posts the ante 100
nahumdj: posts the ante 100
johnyguedes1: posts the ante 100
yuzoyai: posts the ante 100
junior_re612: posts the ante 100
johnyguedes1: posts small blind 400
yuzoyai: posts big blind 800
*** HOLE CARDS ***
junior_re612: raises 800 to 1600
Katwoman0106: folds 
fAArid88: folds 
Sully1993_11: calls 1600
nahumdj: raises 14166 to 15766 and is all-in
johnyguedes1: folds 
yuzoyai: folds 
junior_re612: folds 
Sully1993_11: folds 
Uncalled bet (14166) returned to nahumdj
nahumdj collected 6700 from pot
*** SUMMARY ***
Total pot 6700 | Rake 0 
Seat 1: Katwoman0106 folded before Flop (didn't bet)
Seat 2: fAArid88 folded before Flop (didn't bet)
Seat 3: Sully1993_11 folded before Flop
Seat 4: nahumdj (button) collected (6700)
Seat 5: johnyguedes1 (small blind) folded before Flop
Seat 6: yuzoyai (big blind) folded before Flop
Seat 7: junior_re612 folded before Flop

PokerStars Hand #251205245960: Tournament #3767885527, $40+$10+$5 USD Hold'em No Limit - Level X (500/1000) - 2024/06/26 18:42:33 UTC [2024/06/26 14:42:33 ET]
Table '3767885527 37' 8-max Seat #5 is the button
Seat 1: Katwoman0106 (49430 in chips) 
Seat 2: fAArid88 (27182 in chips) 
Seat 3: Sully1993_11 (26818 in chips) 
Seat 4: nahumdj (20866 in chips) 
Seat 5: johnyguedes1 (65586 in chips) 
Seat 6: yuzoyai (19742 in chips) 
Seat 7: junior_re612 (47385 in chips) 
Seat 8: Amandaraujo (34196 in chips) 
Katwoman0106: posts the ante 125
fAArid88: posts the ante 125
Sully1993_11: posts the ante 125
nahumdj: posts the ante 125
johnyguedes1: posts the ante 125
yuzoyai: posts the ante 125
junior_re612: posts the ante 125
Amandaraujo: posts the ante 125
yuzoyai: posts small blind 500
junior_re612: posts big blind 1000
*** HOLE CARDS ***
Amandaraujo: raises 1000 to 2000
Katwoman0106: folds 
fAArid88: folds 
Sully1993_11: folds 
nahumdj: folds 
johnyguedes1: folds 
yuzoyai: folds 
junior_re612: calls 1000
*** FLOP *** [2h Qs Kc]
junior_re612: checks 
Amandaraujo: bets 3750
junior_re612: folds 
Uncalled bet (3750) returned to Amandaraujo
Amandaraujo collected 5500 from pot
Amandaraujo: doesn't show hand 
*** SUMMARY ***
Total pot 5500 | Rake 0 
Board [2h Qs Kc]
Seat 1: Katwoman0106 folded before Flop (didn't bet)
Seat 2: fAArid88 folded before Flop (didn't bet)
Seat 3: Sully1993_11 folded before Flop (didn't bet)
Seat 4: nahumdj folded before Flop (didn't bet)
Seat 5: johnyguedes1 (button) folded before Flop (didn't bet)
Seat 6: yuzoyai (small blind) folded before Flop
Seat 7: junior_re612 (big blind) folded on the Flop
Seat 8: Amandaraujo collected (5500)

PokerStars Hand #251205263306: Tournament #3767885527, $40+$10+$5 USD Hold'em No Limit - Level X (500/1000) - 2024/06/26 18:43:39 UTC [2024/06/26 14:43:39 ET]
Table '3767885527 37' 8-max Seat #6 is the button
Seat 1: Katwoman0106 (49305 in chips) 
Seat 2: fAArid88 (27057 in chips) 
Seat 3: Sully1993_11 (26693 in chips) 
Seat 4: nahumdj (20741 in chips) 
Seat 5: johnyguedes1 (65461 in chips) 
Seat 6: yuzoyai (19117 in chips) 
Seat 7: junior_re612 (45260 in chips) 
Seat 8: Amandaraujo (37571 in chips) 
Katwoman0106: posts the ante 125
fAArid88: posts the ante 125
Sully1993_11: posts the ante 125
nahumdj: posts the ante 125
johnyguedes1: posts the ante 125
yuzoyai: posts the ante 125
junior_re612: posts the ante 125
Amandaraujo: posts the ante 125
junior_re612: posts small blind 500
Amandaraujo: posts big blind 1000
*** HOLE CARDS ***
Katwoman0106: folds 
fAArid88: raises 1000 to 2000
Sully1993_11: folds 
nahumdj: folds 
johnyguedes1: folds 
yuzoyai: folds 
junior_re612: folds 
Amandaraujo: calls 1000
*** FLOP *** [Ts Qh Qd]
Amandaraujo: checks 
fAArid88: checks 
*** TURN *** [Ts Qh Qd] [4s]
Amandaraujo: checks 
fAArid88: bets 1375
Amandaraujo: calls 1375
*** RIVER *** [Ts Qh Qd 4s] [4d]
Amandaraujo: checks 
fAArid88: checks 
*** SHOW DOWN ***
Amandaraujo: shows [3d 3h] (two pair, Queens and Fours)
fAArid88: shows [Ah 9h] (two pair, Queens and Fours - Ace kicker)
fAArid88 collected 8250 from pot
*** SUMMARY ***
Total pot 8250 | Rake 0 
Board [Ts Qh Qd 4s 4d]
Seat 1: Katwoman0106 folded before Flop (didn't bet)
Seat 2: fAArid88 showed [Ah 9h] and won (8250) with two pair, Queens and Fours
Seat 3: Sully1993_11 folded before Flop (didn't bet)
Seat 4: nahumdj folded before Flop (didn't bet)
Seat 5: johnyguedes1 folded before Flop (didn't bet)
Seat 6: yuzoyai (button) folded before Flop (didn't bet)
Seat 7: junior_re612 (small blind) folded before Flop
Seat 8: Amandaraujo (big blind) showed [3d 3h] and lost with two pair, Queens and Fours

PokerStars Hand #251205277832: Tournament #3767885527, $40+$10+$5 USD Hold'em No Limit - Level X (500/1000) - 2024/06/26 18:44:34 UTC [2024/06/26 14:44:34 ET]
Table '3767885527 37' 8-max Seat #7 is the button
Seat 1: Katwoman0106 (49180 in chips) 
Seat 2: fAArid88 (31807 in chips) 
Seat 3: Sully1993_11 (26568 in chips) 
Seat 4: nahumdj (20616 in chips) 
Seat 5: johnyguedes1 (65336 in chips) 
Seat 6: yuzoyai (18992 in chips) 
Seat 7: junior_re612 (44635 in chips) 
Seat 8: Amandaraujo (34071 in chips) 
Katwoman0106: posts the ante 125
fAArid88: posts the ante 125
Sully1993_11: posts the ante 125
nahumdj: posts the ante 125
johnyguedes1: posts the ante 125
yuzoyai: posts the ante 125
junior_re612: posts the ante 125
Amandaraujo: posts the ante 125
Amandaraujo: posts small blind 500
Katwoman0106: posts big blind 1000
*** HOLE CARDS ***
fAArid88: folds 
Sully1993_11: folds 
nahumdj: folds 
johnyguedes1: folds 
yuzoyai: folds 
junior_re612: raises 1500 to 2500
Amandaraujo: calls 2000
Katwoman0106: calls 1500
*** FLOP *** [5s Qh Js]
Amandaraujo: bets 4250
Katwoman0106: folds 
junior_re612: calls 4250
*** TURN *** [5s Qh Js] [6c]
Amandaraujo: checks 
junior_re612: checks 
*** RIVER *** [5s Qh Js 6c] [5h]
Amandaraujo: checks 
junior_re612: bets 12750
Amandaraujo: folds 
Uncalled bet (12750) returned to junior_re612
junior_re612 collected 17000 from pot
junior_re612: doesn't show hand 
*** SUMMARY ***
Total pot 17000 | Rake 0 
Board [5s Qh Js 6c 5h]
Seat 1: Katwoman0106 (big blind) folded on the Flop
Seat 2: fAArid88 folded before Flop (didn't bet)
Seat 3: Sully1993_11 folded before Flop (didn't bet)
Seat 4: nahumdj folded before Flop (didn't bet)
Seat 5: johnyguedes1 folded before Flop (didn't bet)
Seat 6: yuzoyai folded before Flop (didn't bet)
Seat 7: junior_re612 (button) collected (17000)
Seat 8: Amandaraujo (small blind) folded on the River

PokerStars Hand #251205293414: Tournament #3767885527, $40+$10+$5 USD Hold'em No Limit - Level X (500/1000) - 2024/06/26 18:45:33 UTC [2024/06/26 14:45:33 ET]
Table '3767885527 37' 8-max Seat #8 is the button
Seat 1: Katwoman0106 (46555 in chips) 
Seat 2: fAArid88 (31682 in chips) 
Seat 3: Sully1993_11 (26443 in chips) 
Seat 4: nahumdj (20491 in chips) 
Seat 5: johnyguedes1 (65211 in chips) 
Seat 6: yuzoyai (18867 in chips) 
Seat 7: junior_re612 (54760 in chips) 
Seat 8: Amandaraujo (27196 in chips) 
Katwoman0106: posts the ante 125
fAArid88: posts the ante 125
Sully1993_11: posts the ante 125
nahumdj: posts the ante 125
johnyguedes1: posts the ante 125
yuzoyai: posts the ante 125
junior_re612: posts the ante 125
Amandaraujo: posts the ante 125
Katwoman0106: posts small blind 500
fAArid88: posts big blind 1000
*** HOLE CARDS ***
Sully1993_11: folds 
nahumdj: raises 1000 to 2000
johnyguedes1: folds 
yuzoyai: folds 
junior_re612: calls 2000
Amandaraujo: raises 2000 to 4000
Katwoman0106: folds 
fAArid88: folds 
nahumdj: raises 16366 to 20366 and is all-in
junior_re612: folds 
Amandaraujo: calls 16366
*** FLOP *** [9d 4s 7d]
*** TURN *** [9d 4s 7d] [Ts]
*** RIVER *** [9d 4s 7d Ts] [Td]
*** SHOW DOWN ***
nahumdj: shows [As Kc] (a pair of Tens)
Amandaraujo: shows [Jh 8s] (a straight, Seven to Jack)
Amandaraujo collected 45232 from pot
nahumdj finished the tournament
Naaarrrr is disconnected 
*** SUMMARY ***
Total pot 45232 | Rake 0 
Board [9d 4s 7d Ts Td]
Seat 1: Katwoman0106 (small blind) folded before Flop
Seat 2: fAArid88 (big blind) folded before Flop
Seat 3: Sully1993_11 folded before Flop (didn't bet)
Seat 4: nahumdj showed [As Kc] and lost with a pair of Tens
Seat 5: johnyguedes1 folded before Flop (didn't bet)
Seat 6: yuzoyai folded before Flop (didn't bet)
Seat 7: junior_re612 folded before Flop
Seat 8: Amandaraujo (button) showed [Jh 8s] and won (45232) with a straight, Seven to Jack

PokerStars Hand #251205306343: Tournament #3767885527, $40+$10+$5 USD Hold'em No Limit - Level X (500/1000) - 2024/06/26 18:46:21 UTC [2024/06/26 14:46:21 ET]
Table '3767885527 37' 8-max Seat #1 is the button
Seat 1: Katwoman0106 (45930 in chips) 
Seat 2: fAArid88 (30557 in chips) 
Seat 3: Sully1993_11 (26318 in chips) 
Seat 4: Naaarrrr (25000 in chips) 
Seat 5: johnyguedes1 (65086 in chips) 
Seat 6: yuzoyai (18742 in chips) 
Seat 7: junior_re612 (52635 in chips) 
Seat 8: Amandaraujo (51937 in chips) 
Katwoman0106: posts the ante 125
fAArid88: posts the ante 125
Sully1993_11: posts the ante 125
Naaarrrr: posts the ante 125
johnyguedes1: posts the ante 125
yuzoyai: posts the ante 125
junior_re612: posts the ante 125
Amandaraujo: posts the ante 125
fAArid88: posts small blind 500
Sully1993_11: posts big blind 1000
*** HOLE CARDS ***
Naaarrrr: raises 1000 to 2000
johnyguedes1: folds 
yuzoyai: folds 
junior_re612: folds 
Amandaraujo: calls 2000
Katwoman0106: calls 2000
fAArid88: folds 
Sully1993_11: calls 1000
*** FLOP *** [5s 7s 8c]
Sully1993_11: checks 
Naaarrrr: checks 
Amandaraujo: checks 
Katwoman0106: bets 8333
Sully1993_11: raises 15860 to 24193 and is all-in
Naaarrrr: folds 
Amandaraujo: folds 
Katwoman0106: calls 15860
*** TURN *** [5s 7s 8c] [Th]
*** RIVER *** [5s 7s 8c Th] [Jh]
*** SHOW DOWN ***
Sully1993_11: shows [7h 5h] (two pair, Sevens and Fives)
Katwoman0106: shows [4d 6d] (a straight, Four to Eight)
Katwoman0106 collected 57886 from pot
Sully1993_11 finished the tournament
*** SUMMARY ***
Total pot 57886 | Rake 0 
Board [5s 7s 8c Th Jh]
Seat 1: Katwoman0106 (button) showed [4d 6d] and won (57886) with a straight, Four to Eight
Seat 2: fAArid88 (small blind) folded before Flop
Seat 3: Sully1993_11 (big blind) showed [7h 5h] and lost with two pair, Sevens and Fives
Seat 4: Naaarrrr folded on the Flop
Seat 5: johnyguedes1 folded before Flop (didn't bet)
Seat 6: yuzoyai folded before Flop (didn't bet)
Seat 7: junior_re612 folded before Flop (didn't bet)
Seat 8: Amandaraujo folded on the Flop

PokerStars Hand #251205323229: Tournament #3767885527, $40+$10+$5 USD Hold'em No Limit - Level X (500/1000) - 2024/06/26 18:47:26 UTC [2024/06/26 14:47:26 ET]
Table '3767885527 37' 8-max Seat #2 is the button
Seat 1: Katwoman0106 (77498 in chips) 
Seat 2: fAArid88 (29932 in chips) 
Seat 4: Naaarrrr (22875 in chips) 
Seat 5: johnyguedes1 (64961 in chips) 
Seat 6: yuzoyai (18617 in chips) 
Seat 7: junior_re612 (52510 in chips) 
Seat 8: Amandaraujo (49812 in chips) 
Katwoman0106: posts the ante 125
fAArid88: posts the ante 125
Naaarrrr: posts the ante 125
johnyguedes1: posts the ante 125
yuzoyai: posts the ante 125
junior_re612: posts the ante 125
Amandaraujo: posts the ante 125
Naaarrrr: posts small blind 500
johnyguedes1: posts big blind 1000
*** HOLE CARDS ***
yuzoyai: folds 
junior_re612: folds 
Amandaraujo: raises 1000 to 2000
Katwoman0106: folds 
fAArid88: folds 
Naaarrrr: folds 
paulscot1 is disconnected 
johnyguedes1: calls 1000
*** FLOP *** [Kh Jh 2d]
johnyguedes1: checks 
Amandaraujo: checks 
*** TURN *** [Kh Jh 2d] [6c]
johnyguedes1: checks 
Amandaraujo: checks 
*** RIVER *** [Kh Jh 2d 6c] [8c]
johnyguedes1: checks 
Amandaraujo: checks 
*** SHOW DOWN ***
johnyguedes1: shows [7d 7c] (a pair of Sevens)
Amandaraujo: mucks hand 
johnyguedes1 collected 5375 from pot
*** SUMMARY ***
Total pot 5375 | Rake 0 
Board [Kh Jh 2d 6c 8c]
Seat 1: Katwoman0106 folded before Flop (didn't bet)
Seat 2: fAArid88 (button) folded before Flop (didn't bet)
Seat 4: Naaarrrr (small blind) folded before Flop
Seat 5: johnyguedes1 (big blind) showed [7d 7c] and won (5375) with a pair of Sevens
Seat 6: yuzoyai folded before Flop (didn't bet)
Seat 7: junior_re612 folded before Flop (didn't bet)
Seat 8: Amandaraujo mucked

PokerStars Hand #251205333204: Tournament #3767885527, $40+$10+$5 USD Hold'em No Limit - Level X (500/1000) - 2024/06/26 18:48:04 UTC [2024/06/26 14:48:04 ET]
Table '3767885527 37' 8-max Seat #4 is the button
Seat 1: Katwoman0106 (77373 in chips) 
Seat 2: fAArid88 (29807 in chips) 
Seat 3: paulscot1 (25000 in chips) 
Seat 4: Naaarrrr (22250 in chips) 
Seat 5: johnyguedes1 (68211 in chips) 
Seat 6: yuzoyai (18492 in chips) 
Seat 7: junior_re612 (52385 in chips) 
Seat 8: Amandaraujo (47687 in chips) 
Katwoman0106: posts the ante 125
fAArid88: posts the ante 125
paulscot1: posts the ante 125
Naaarrrr: posts the ante 125
johnyguedes1: posts the ante 125
yuzoyai: posts the ante 125
junior_re612: posts the ante 125
Amandaraujo: posts the ante 125
johnyguedes1: posts small blind 500
yuzoyai: posts big blind 1000
*** HOLE CARDS ***
junior_re612: folds 
Amandaraujo: folds 
Katwoman0106: folds 
fAArid88: folds 
paulscot1: raises 1650 to 2650
Naaarrrr: calls 2650
johnyguedes1: folds 
yuzoyai: folds 
*** FLOP *** [Qs Ts Tc]
paulscot1: bets 2574
Naaarrrr: folds 
Uncalled bet (2574) returned to paulscot1
paulscot1 collected 7800 from pot
paulscot1: doesn't show hand 
*** SUMMARY ***
Total pot 7800 | Rake 0 
Board [Qs Ts Tc]
Seat 1: Katwoman0106 folded before Flop (didn't bet)
Seat 2: fAArid88 folded before Flop (didn't bet)
Seat 3: paulscot1 collected (7800)
Seat 4: Naaarrrr (button) folded on the Flop
Seat 5: johnyguedes1 (small blind) folded before Flop
Seat 6: yuzoyai (big blind) folded before Flop
Seat 7: junior_re612 folded before Flop (didn't bet)
Seat 8: Amandaraujo folded before Flop (didn't bet)

PokerStars Hand #251205342935: Tournament #3767885527, $40+$10+$5 USD Hold'em No Limit - Level X (500/1000) - 2024/06/26 18:48:41 UTC [2024/06/26 14:48:41 ET]
Table '3767885527 37' 8-max Seat #5 is the button
Seat 1: Katwoman0106 (77248 in chips) 
Seat 2: fAArid88 (29682 in chips) 
Seat 3: paulscot1 (30025 in chips) 
Seat 4: Naaarrrr (19475 in chips) 
Seat 5: johnyguedes1 (67586 in chips) 
Seat 6: yuzoyai (17367 in chips) 
Seat 7: junior_re612 (52260 in chips) 
Seat 8: Amandaraujo (47562 in chips) 
Katwoman0106: posts the ante 125
fAArid88: posts the ante 125
paulscot1: posts the ante 125
Naaarrrr: posts the ante 125
johnyguedes1: posts the ante 125
yuzoyai: posts the ante 125
junior_re612: posts the ante 125
Amandaraujo: posts the ante 125
yuzoyai: posts small blind 500
junior_re612: posts big blind 1000
*** HOLE CARDS ***
Amandaraujo: folds 
Katwoman0106: folds 
fAArid88: folds 
paulscot1: folds 
Naaarrrr: raises 1000 to 2000
johnyguedes1: folds 
yuzoyai: folds 
junior_re612: folds 
Uncalled bet (1000) returned to Naaarrrr
Naaarrrr collected 3500 from pot
Naaarrrr: doesn't show hand 
*** SUMMARY ***
Total pot 3500 | Rake 0 
Seat 1: Katwoman0106 folded before Flop (didn't bet)
Seat 2: fAArid88 folded before Flop (didn't bet)
Seat 3: paulscot1 folded before Flop (didn't bet)
Seat 4: Naaarrrr collected (3500)
Seat 5: johnyguedes1 (button) folded before Flop (didn't bet)
Seat 6: yuzoyai (small blind) folded before Flop
Seat 7: junior_re612 (big blind) folded before Flop
Seat 8: Amandaraujo folded before Flop (didn't bet)

PokerStars Hand #251205352104: Tournament #3767885527, $40+$10+$5 USD Hold'em No Limit - Level X (500/1000) - 2024/06/26 18:49:16 UTC [2024/06/26 14:49:16 ET]
Table '3767885527 37' 8-max Seat #6 is the button
Seat 1: Katwoman0106 (77123 in chips) 
Seat 2: fAArid88 (29557 in chips) 
Seat 3: paulscot1 (29900 in chips) 
Seat 4: Naaarrrr (21850 in chips) 
Seat 5: johnyguedes1 (67461 in chips) 
Seat 6: yuzoyai (16742 in chips) 
Seat 7: junior_re612 (51135 in chips) 
Seat 8: Amandaraujo (47437 in chips) 
Katwoman0106: posts the ante 125
fAArid88: posts the ante 125
paulscot1: posts the ante 125
Naaarrrr: posts the ante 125
johnyguedes1: posts the ante 125
yuzoyai: posts the ante 125
junior_re612: posts the ante 125
Amandaraujo: posts the ante 125
junior_re612: posts small blind 500
Amandaraujo: posts big blind 1000
*** HOLE CARDS ***
Katwoman0106: folds 
fAArid88: raises 1000 to 2000
paulscot1: folds 
Naaarrrr: folds 
johnyguedes1: folds 
yuzoyai: calls 2000
junior_re612: folds 
Amandaraujo: calls 1000
*** FLOP *** [8h Qh 2s]
Amandaraujo: checks 
fAArid88: checks 
yuzoyai: bets 1950
Amandaraujo: folds 
fAArid88: raises 12050 to 14000
yuzoyai: raises 617 to 14617 and is all-in
fAArid88: calls 617
*** TURN *** [8h Qh 2s] [2d]
*** RIVER *** [8h Qh 2s 2d] [5c]
*** SHOW DOWN ***
fAArid88: shows [9s 8s] (two pair, Eights and Deuces)
yuzoyai: shows [Td Qd] (two pair, Queens and Deuces)
yuzoyai collected 36734 from pot
*** SUMMARY ***
Total pot 36734 | Rake 0 
Board [8h Qh 2s 2d 5c]
Seat 1: Katwoman0106 folded before Flop (didn't bet)
Seat 2: fAArid88 showed [9s 8s] and lost with two pair, Eights and Deuces
Seat 3: paulscot1 folded before Flop (didn't bet)
Seat 4: Naaarrrr folded before Flop (didn't bet)
Seat 5: johnyguedes1 folded before Flop (didn't bet)
Seat 6: yuzoyai (button) showed [Td Qd] and won (36734) with two pair, Queens and Deuces
Seat 7: junior_re612 (small blind) folded before Flop
Seat 8: Amandaraujo (big blind) folded on the Flop

PokerStars Hand #251205372845: Tournament #3767885527, $40+$10+$5 USD Hold'em No Limit - Level X (500/1000) - 2024/06/26 18:50:35 UTC [2024/06/26 14:50:35 ET]
Table '3767885527 37' 8-max Seat #7 is the button
Seat 1: Katwoman0106 (76998 in chips) 
Seat 2: fAArid88 (12815 in chips) 
Seat 3: paulscot1 (29775 in chips) 
Seat 4: Naaarrrr (21725 in chips) 
Seat 5: johnyguedes1 (67336 in chips) 
Seat 6: yuzoyai (36734 in chips) 
Seat 7: junior_re612 (50510 in chips) 
Seat 8: Amandaraujo (45312 in chips) 
Katwoman0106: posts the ante 125
fAArid88: posts the ante 125
paulscot1: posts the ante 125
Naaarrrr: posts the ante 125
johnyguedes1: posts the ante 125
yuzoyai: posts the ante 125
junior_re612: posts the ante 125
Amandaraujo: posts the ante 125
Amandaraujo: posts small blind 500
Katwoman0106: posts big blind 1000
*** HOLE CARDS ***
fAArid88: raises 11690 to 12690 and is all-in
paulscot1: folds 
Naaarrrr: folds 
johnyguedes1: folds 
yuzoyai: folds 
junior_re612: folds 
Amandaraujo: folds 
Katwoman0106: folds 
Uncalled bet (11690) returned to fAArid88
fAArid88 collected 3500 from pot
fAArid88: doesn't show hand 
*** SUMMARY ***
Total pot 3500 | Rake 0 
Seat 1: Katwoman0106 (big blind) folded before Flop
Seat 2: fAArid88 collected (3500)
Seat 3: paulscot1 folded before Flop (didn't bet)
Seat 4: Naaarrrr folded before Flop (didn't bet)
Seat 5: johnyguedes1 folded before Flop (didn't bet)
Seat 6: yuzoyai folded before Flop (didn't bet)
Seat 7: junior_re612 (button) folded before Flop (didn't bet)
Seat 8: Amandaraujo (small blind) folded before Flop

PokerStars Hand #251205380018: Tournament #3767885527, $40+$10+$5 USD Hold'em No Limit - Level X (500/1000) - 2024/06/26 18:51:03 UTC [2024/06/26 14:51:03 ET]
Table '3767885527 37' 8-max Seat #8 is the button
Seat 1: Katwoman0106 (75873 in chips) 
Seat 2: fAArid88 (15190 in chips) 
Seat 3: paulscot1 (29650 in chips) 
Seat 4: Naaarrrr (21600 in chips) 
Seat 5: johnyguedes1 (67211 in chips) 
Seat 6: yuzoyai (36609 in chips) 
Seat 7: junior_re612 (50385 in chips) 
Seat 8: Amandaraujo (44687 in chips) 
Katwoman0106: posts the ante 125
fAArid88: posts the ante 125
paulscot1: posts the ante 125
Naaarrrr: posts the ante 125
johnyguedes1: posts the ante 125
yuzoyai: posts the ante 125
junior_re612: posts the ante 125
Amandaraujo: posts the ante 125
Katwoman0106: posts small blind 500
fAArid88: posts big blind 1000
*** HOLE CARDS ***
paulscot1: folds 
Naaarrrr: folds 
johnyguedes1: folds 
yuzoyai: folds 
junior_re612: folds 
Amandaraujo: raises 1000 to 2000
Katwoman0106: folds 
fAArid88: folds 
Uncalled bet (1000) returned to Amandaraujo
Amandaraujo collected 3500 from pot
Amandaraujo: doesn't show hand 
*** SUMMARY ***
Total pot 3500 | Rake 0 
Seat 1: Katwoman0106 (small blind) folded before Flop
Seat 2: fAArid88 (big blind) folded before Flop
Seat 3: paulscot1 folded before Flop (didn't bet)
Seat 4: Naaarrrr folded before Flop (didn't bet)
Seat 5: johnyguedes1 folded before Flop (didn't bet)
Seat 6: yuzoyai folded before Flop (didn't bet)
Seat 7: junior_re612 folded before Flop (didn't bet)
Seat 8: Amandaraujo (button) collected (3500)

PokerStars Hand #251205388503: Tournament #3767885527, $40+$10+$5 USD Hold'em No Limit - Level X (500/1000) - 2024/06/26 18:51:35 UTC [2024/06/26 14:51:35 ET]
Table '3767885527 37' 8-max Seat #1 is the button
Seat 1: Katwoman0106 (75248 in chips) 
Seat 2: fAArid88 (14065 in chips) 
Seat 3: paulscot1 (29525 in chips) 
Seat 4: Naaarrrr (21475 in chips) 
Seat 5: johnyguedes1 (67086 in chips) 
Seat 6: yuzoyai (36484 in chips) 
Seat 7: junior_re612 (50260 in chips) 
Seat 8: Amandaraujo (47062 in chips) 
Katwoman0106: posts the ante 125
fAArid88: posts the ante 125
paulscot1: posts the ante 125
Naaarrrr: posts the ante 125
johnyguedes1: posts the ante 125
yuzoyai: posts the ante 125
junior_re612: posts the ante 125
Amandaraujo: posts the ante 125
fAArid88: posts small blind 500
paulscot1: posts big blind 1000
*** HOLE CARDS ***
Naaarrrr: folds 
johnyguedes1: folds 
yuzoyai: folds 
junior_re612: raises 1000 to 2000
Amandaraujo: calls 2000
Katwoman0106: folds 
fAArid88: folds 
paulscot1: folds 
*** FLOP *** [Kc 6d 4d]
junior_re612: bets 2150
Amandaraujo: calls 2150
*** TURN *** [Kc 6d 4d] [8c]
junior_re612: checks 
Amandaraujo: bets 6400
junior_re612: folds 
Uncalled bet (6400) returned to Amandaraujo
Amandaraujo collected 10800 from pot
*** SUMMARY ***
Total pot 10800 | Rake 0 
Board [Kc 6d 4d 8c]
Seat 1: Katwoman0106 (button) folded before Flop (didn't bet)
Seat 2: fAArid88 (small blind) folded before Flop
Seat 3: paulscot1 (big blind) folded before Flop
Seat 4: Naaarrrr folded before Flop (didn't bet)
Seat 5: johnyguedes1 folded before Flop (didn't bet)
Seat 6: yuzoyai folded before Flop (didn't bet)
Seat 7: junior_re612 folded on the Turn
Seat 8: Amandaraujo collected (10800)

PokerStars Hand #251205408535: Tournament #3767885527, $40+$10+$5 USD Hold'em No Limit - Level XI (600/1200) - 2024/06/26 18:52:51 UTC [2024/06/26 14:52:51 ET]
Table '3767885527 37' 8-max Seat #2 is the button
Seat 1: Katwoman0106 (75123 in chips) 
Seat 2: fAArid88 (13440 in chips) 
Seat 3: paulscot1 (28400 in chips) 
Seat 4: Naaarrrr (21350 in chips) 
Seat 5: johnyguedes1 (66961 in chips) 
Seat 6: yuzoyai (36359 in chips) 
Seat 7: junior_re612 (45985 in chips) 
Seat 8: Amandaraujo (53587 in chips) 
Katwoman0106: posts the ante 150
fAArid88: posts the ante 150
paulscot1: posts the ante 150
Naaarrrr: posts the ante 150
johnyguedes1: posts the ante 150
yuzoyai: posts the ante 150
junior_re612: posts the ante 150
Amandaraujo: posts the ante 150
paulscot1: posts small blind 600
Naaarrrr: posts big blind 1200
*** HOLE CARDS ***
johnyguedes1: raises 1320 to 2520
yuzoyai: folds 
junior_re612: folds 
Amandaraujo: calls 2520
Katwoman0106: folds 
fAArid88: calls 2520
paulscot1: folds 
Naaarrrr: calls 1320
*** FLOP *** [Ah 2h Kh]
Naaarrrr: checks 
johnyguedes1: checks 
Amandaraujo: checks 
fAArid88: checks 
*** TURN *** [Ah 2h Kh] [5c]
Naaarrrr: checks 
johnyguedes1: checks 
Amandaraujo: checks 
fAArid88: checks 
*** RIVER *** [Ah 2h Kh 5c] [8d]
Naaarrrr: checks 
johnyguedes1: bets 9860
Amandaraujo: folds 
fAArid88: folds 
Naaarrrr: folds 
Uncalled bet (9860) returned to johnyguedes1
johnyguedes1 collected 11880 from pot
johnyguedes1: doesn't show hand 
*** SUMMARY ***
Total pot 11880 | Rake 0 
Board [Ah 2h Kh 5c 8d]
Seat 1: Katwoman0106 folded before Flop (didn't bet)
Seat 2: fAArid88 (button) folded on the River
Seat 3: paulscot1 (small blind) folded before Flop
Seat 4: Naaarrrr (big blind) folded on the River
Seat 5: johnyguedes1 collected (11880)
Seat 6: yuzoyai folded before Flop (didn't bet)
Seat 7: junior_re612 folded before Flop (didn't bet)
Seat 8: Amandaraujo folded on the River

PokerStars Hand #251205436915: Tournament #3767885527, $40+$10+$5 USD Hold'em No Limit - Level XI (600/1200) - 2024/06/26 18:54:39 UTC [2024/06/26 14:54:39 ET]
Table '3767885527 37' 8-max Seat #3 is the button
Seat 1: Katwoman0106 (74973 in chips) 
Seat 2: fAArid88 (10770 in chips) 
Seat 3: paulscot1 (27650 in chips) 
Seat 4: Naaarrrr (18680 in chips) 
Seat 5: johnyguedes1 (76171 in chips) 
Seat 6: yuzoyai (36209 in chips) 
Seat 7: junior_re612 (45835 in chips) 
Seat 8: Amandaraujo (50917 in chips) 
Katwoman0106: posts the ante 150
fAArid88: posts the ante 150
paulscot1: posts the ante 150
Naaarrrr: posts the ante 150
johnyguedes1: posts the ante 150
yuzoyai: posts the ante 150
junior_re612: posts the ante 150
Amandaraujo: posts the ante 150
Naaarrrr: posts small blind 600
johnyguedes1: posts big blind 1200
*** HOLE CARDS ***
yuzoyai: folds 
junior_re612: folds 
Amandaraujo: folds 
Katwoman0106: folds 
fAArid88: folds 
paulscot1: raises 1440 to 2640
Naaarrrr: folds 
johnyguedes1: calls 1440
*** FLOP *** [6c 4d Kh]
johnyguedes1: checks 
paulscot1: bets 2400
johnyguedes1: raises 4440 to 6840
paulscot1: raises 18020 to 24860 and is all-in
johnyguedes1: folds 
Uncalled bet (18020) returned to paulscot1
paulscot1 collected 20760 from pot
paulscot1: doesn't show hand 
*** SUMMARY ***
Total pot 20760 | Rake 0 
Board [6c 4d Kh]
Seat 1: Katwoman0106 folded before Flop (didn't bet)
Seat 2: fAArid88 folded before Flop (didn't bet)
Seat 3: paulscot1 (button) collected (20760)
Seat 4: Naaarrrr (small blind) folded before Flop
Seat 5: johnyguedes1 (big blind) folded on the Flop
Seat 6: yuzoyai folded before Flop (didn't bet)
Seat 7: junior_re612 folded before Flop (didn't bet)
Seat 8: Amandaraujo folded before Flop (didn't bet)

PokerStars Hand #251205528176: Tournament #3767885527, $40+$10+$5 USD Hold'em No Limit - Level XI (600/1200) - 2024/06/26 19:02:04 UTC [2024/06/26 15:02:04 ET]
Table '3767885527 37' 8-max Seat #4 is the button
Seat 1: Katwoman0106 (74823 in chips) 
Seat 2: fAArid88 (10620 in chips) 
Seat 3: paulscot1 (38780 in chips) 
Seat 4: Naaarrrr (17930 in chips) 
Seat 5: johnyguedes1 (66541 in chips) 
Seat 6: yuzoyai (36059 in chips) 
Seat 7: junior_re612 (45685 in chips) 
Seat 8: Amandaraujo (50767 in chips) 
Katwoman0106: posts the ante 150
fAArid88: posts the ante 150
paulscot1: posts the ante 150
Naaarrrr: posts the ante 150
johnyguedes1: posts the ante 150
yuzoyai: posts the ante 150
junior_re612: posts the ante 150
Amandaraujo: posts the ante 150
johnyguedes1: posts small blind 600
yuzoyai: posts big blind 1200
*** HOLE CARDS ***
junior_re612: folds 
Amandaraujo: raises 1200 to 2400
Katwoman0106: folds 
fAArid88: folds 
paulscot1: folds 
Naaarrrr: folds 
johnyguedes1: folds 
yuzoyai: raises 33509 to 35909 and is all-in
Amandaraujo: folds 
Uncalled bet (33509) returned to yuzoyai
yuzoyai collected 6600 from pot
yuzoyai: doesn't show hand 
*** SUMMARY ***
Total pot 6600 | Rake 0 
Seat 1: Katwoman0106 folded before Flop (didn't bet)
Seat 2: fAArid88 folded before Flop (didn't bet)
Seat 3: paulscot1 folded before Flop (didn't bet)
Seat 4: Naaarrrr (button) folded before Flop (didn't bet)
Seat 5: johnyguedes1 (small blind) folded before Flop
Seat 6: yuzoyai (big blind) collected (6600)
Seat 7: junior_re612 folded before Flop (didn't bet)
Seat 8: Amandaraujo folded before Flop

PokerStars Hand #251205539837: Tournament #3767885527, $40+$10+$5 USD Hold'em No Limit - Level XI (600/1200) - 2024/06/26 19:02:52 UTC [2024/06/26 15:02:52 ET]
Table '3767885527 37' 8-max Seat #5 is the button
Seat 1: Katwoman0106 (74673 in chips) 
Seat 2: fAArid88 (10470 in chips) 
Seat 3: paulscot1 (38630 in chips) 
Seat 4: Naaarrrr (17780 in chips) 
Seat 5: johnyguedes1 (65791 in chips) 
Seat 6: yuzoyai (40109 in chips) 
Seat 7: junior_re612 (45535 in chips) 
Seat 8: Amandaraujo (48217 in chips) 
Katwoman0106: posts the ante 150
fAArid88: posts the ante 150
paulscot1: posts the ante 150
Naaarrrr: posts the ante 150
johnyguedes1: posts the ante 150
yuzoyai: posts the ante 150
junior_re612: posts the ante 150
Amandaraujo: posts the ante 150
yuzoyai: posts small blind 600
junior_re612: posts big blind 1200
*** HOLE CARDS ***
Amandaraujo: calls 1200
Katwoman0106: calls 1200
fAArid88: folds 
paulscot1: folds 
Naaarrrr: folds 
johnyguedes1: calls 1200
yuzoyai: calls 600
junior_re612: checks 
*** FLOP *** [6c 3h Qd]
yuzoyai: bets 2376
junior_re612: calls 2376
Amandaraujo: folds 
Katwoman0106: raises 7164 to 9540
johnyguedes1: folds 
yuzoyai: folds 
junior_re612: raises 34645 to 44185 and is all-in
Katwoman0106: folds [Qh]
Uncalled bet (34645) returned to junior_re612
junior_re612 collected 28656 from pot
junior_re612: doesn't show hand 
*** SUMMARY ***
Total pot 28656 | Rake 0 
Board [6c 3h Qd]
Seat 1: Katwoman0106 folded on the Flop
Seat 2: fAArid88 folded before Flop (didn't bet)
Seat 3: paulscot1 folded before Flop (didn't bet)
Seat 4: Naaarrrr folded before Flop (didn't bet)
Seat 5: johnyguedes1 (button) folded on the Flop
Seat 6: yuzoyai (small blind) folded on the Flop
Seat 7: junior_re612 (big blind) collected (28656)
Seat 8: Amandaraujo folded on the Flop

PokerStars Hand #251205565547: Tournament #3767885527, $40+$10+$5 USD Hold'em No Limit - Level XI (600/1200) - 2024/06/26 19:04:33 UTC [2024/06/26 15:04:33 ET]
Table '3767885527 37' 8-max Seat #6 is the button
Seat 1: Katwoman0106 (63783 in chips) 
Seat 2: fAArid88 (10320 in chips) 
Seat 3: paulscot1 (38480 in chips) 
Seat 4: Naaarrrr (17630 in chips) 
Seat 5: johnyguedes1 (64441 in chips) 
Seat 6: yuzoyai (36383 in chips) 
Seat 7: junior_re612 (63301 in chips) 
Seat 8: Amandaraujo (46867 in chips) 
Katwoman0106: posts the ante 150
fAArid88: posts the ante 150
paulscot1: posts the ante 150
Naaarrrr: posts the ante 150
johnyguedes1: posts the ante 150
yuzoyai: posts the ante 150
junior_re612: posts the ante 150
Amandaraujo: posts the ante 150
junior_re612: posts small blind 600
Amandaraujo: posts big blind 1200
*** HOLE CARDS ***
Katwoman0106: folds 
fAArid88: folds 
paulscot1: raises 1980 to 3180
Naaarrrr: raises 14300 to 17480 and is all-in
johnyguedes1: folds 
yuzoyai: folds 
junior_re612: raises 45671 to 63151 and is all-in
Amandaraujo: folds 
paulscot1: folds 
Uncalled bet (45671) returned to junior_re612
*** FLOP *** [3d Qc Th]
*** TURN *** [3d Qc Th] [7h]
*** RIVER *** [3d Qc Th 7h] [3c]
*** SHOW DOWN ***
junior_re612: shows [Kh Ah] (a pair of Threes)
Naaarrrr: shows [Ks Ad] (a pair of Threes)
junior_re612 collected 20270 from pot
Naaarrrr collected 20270 from pot
*** SUMMARY ***
Total pot 40540 | Rake 0 
Board [3d Qc Th 7h 3c]
Seat 1: Katwoman0106 folded before Flop (didn't bet)
Seat 2: fAArid88 folded before Flop (didn't bet)
Seat 3: paulscot1 folded before Flop
Seat 4: Naaarrrr showed [Ks Ad] and won (20270) with a pair of Threes
Seat 5: johnyguedes1 folded before Flop (didn't bet)
Seat 6: yuzoyai (button) folded before Flop (didn't bet)
Seat 7: junior_re612 (small blind) showed [Kh Ah] and won (20270) with a pair of Threes
Seat 8: Amandaraujo (big blind) folded before Flop

PokerStars Hand #251205578140: Tournament #3767885527, $40+$10+$5 USD Hold'em No Limit - Level XI (600/1200) - 2024/06/26 19:05:21 UTC [2024/06/26 15:05:21 ET]
Table '3767885527 37' 8-max Seat #7 is the button
Seat 1: Katwoman0106 (63633 in chips) 
Seat 2: fAArid88 (10170 in chips) 
Seat 3: paulscot1 (35150 in chips) 
Seat 4: Naaarrrr (20270 in chips) 
Seat 5: johnyguedes1 (64291 in chips) 
Seat 6: yuzoyai (36233 in chips) 
Seat 7: junior_re612 (65941 in chips) 
Seat 8: Amandaraujo (45517 in chips) 
Katwoman0106: posts the ante 150
fAArid88: posts the ante 150
paulscot1: posts the ante 150
Naaarrrr: posts the ante 150
johnyguedes1: posts the ante 150
yuzoyai: posts the ante 150
junior_re612: posts the ante 150
Amandaraujo: posts the ante 150
Amandaraujo: posts small blind 600
Katwoman0106: posts big blind 1200
*** HOLE CARDS ***
fAArid88: folds 
paulscot1: folds 
Naaarrrr: folds 
johnyguedes1: folds 
yuzoyai: raises 1200 to 2400
junior_re612: folds 
Amandaraujo: calls 1800
Katwoman0106: folds 
*** FLOP *** [9c 2s 6d]
Amandaraujo: checks 
yuzoyai: checks 
*** TURN *** [9c 2s 6d] [Js]
Amandaraujo: checks 
yuzoyai: bets 3840
Amandaraujo: calls 3840
*** RIVER *** [9c 2s 6d Js] [6s]
Amandaraujo: checks 
yuzoyai: bets 11918
Amandaraujo: folds 
Uncalled bet (11918) returned to yuzoyai
yuzoyai collected 14880 from pot
yuzoyai: doesn't show hand 
*** SUMMARY ***
Total pot 14880 | Rake 0 
Board [9c 2s 6d Js 6s]
Seat 1: Katwoman0106 (big blind) folded before Flop
Seat 2: fAArid88 folded before Flop (didn't bet)
Seat 3: paulscot1 folded before Flop (didn't bet)
Seat 4: Naaarrrr folded before Flop (didn't bet)
Seat 5: johnyguedes1 folded before Flop (didn't bet)
Seat 6: yuzoyai collected (14880)
Seat 7: junior_re612 (button) folded before Flop (didn't bet)
Seat 8: Amandaraujo (small blind) folded on the River

PokerStars Hand #251205601413: Tournament #3767885527, $40+$10+$5 USD Hold'em No Limit - Level XI (600/1200) - 2024/06/26 19:06:49 UTC [2024/06/26 15:06:49 ET]
Table '3767885527 37' 8-max Seat #8 is the button
Seat 1: Katwoman0106 (62283 in chips) 
Seat 2: fAArid88 (10020 in chips) 
Seat 3: paulscot1 (35000 in chips) 
Seat 4: Naaarrrr (20120 in chips) 
Seat 5: johnyguedes1 (64141 in chips) 
Seat 6: yuzoyai (44723 in chips) 
Seat 7: junior_re612 (65791 in chips) 
Seat 8: Amandaraujo (39127 in chips) 
Katwoman0106: posts the ante 150
fAArid88: posts the ante 150
paulscot1: posts the ante 150
Naaarrrr: posts the ante 150
johnyguedes1: posts the ante 150
yuzoyai: posts the ante 150
junior_re612: posts the ante 150
Amandaraujo: posts the ante 150
Katwoman0106: posts small blind 600
fAArid88: posts big blind 1200
*** HOLE CARDS ***
paulscot1: raises 1440 to 2640
Naaarrrr: folds 
johnyguedes1: folds 
yuzoyai: raises 3960 to 6600
junior_re612: folds 
Amandaraujo: calls 6600
Katwoman0106: folds 
fAArid88: folds 
paulscot1: calls 3960
*** FLOP *** [8c Ts 2s]
paulscot1: checks 
yuzoyai: checks 
Amandaraujo: checks 
*** TURN *** [8c Ts 2s] [Kc]
paulscot1: checks 
yuzoyai: bets 11280
Amandaraujo: folds 
paulscot1: calls 11280
*** RIVER *** [8c Ts 2s Kc] [Jc]
paulscot1: checks 
yuzoyai: checks 
*** SHOW DOWN ***
paulscot1: shows [8s 9s] (a pair of Eights)
yuzoyai: shows [Kh Qs] (a pair of Kings)
yuzoyai collected 45360 from pot
*** SUMMARY ***
Total pot 45360 | Rake 0 
Board [8c Ts 2s Kc Jc]
Seat 1: Katwoman0106 (small blind) folded before Flop
Seat 2: fAArid88 (big blind) folded before Flop
Seat 3: paulscot1 showed [8s 9s] and lost with a pair of Eights
Seat 4: Naaarrrr folded before Flop (didn't bet)
Seat 5: johnyguedes1 folded before Flop (didn't bet)
Seat 6: yuzoyai showed [Kh Qs] and won (45360) with a pair of Kings
Seat 7: junior_re612 folded before Flop (didn't bet)
Seat 8: Amandaraujo (button) folded on the Turn

PokerStars Hand #251205627441: Tournament #3767885527, $40+$10+$5 USD Hold'em No Limit - Level XI (600/1200) - 2024/06/26 19:08:27 UTC [2024/06/26 15:08:27 ET]
Table '3767885527 37' 8-max Seat #1 is the button
Seat 1: Katwoman0106 (61533 in chips) 
Seat 2: fAArid88 (8670 in chips) 
Seat 3: paulscot1 (16970 in chips) 
Seat 4: Naaarrrr (19970 in chips) 
Seat 5: johnyguedes1 (63991 in chips) 
Seat 6: yuzoyai (72053 in chips) 
Seat 7: junior_re612 (65641 in chips) 
Seat 8: Amandaraujo (32377 in chips) 
Katwoman0106: posts the ante 150
fAArid88: posts the ante 150
paulscot1: posts the ante 150
Naaarrrr: posts the ante 150
johnyguedes1: posts the ante 150
yuzoyai: posts the ante 150
junior_re612: posts the ante 150
Amandaraujo: posts the ante 150
fAArid88: posts small blind 600
paulscot1: posts big blind 1200
*** HOLE CARDS ***
Naaarrrr: raises 1200 to 2400
johnyguedes1: folds 
yuzoyai: folds 
junior_re612: folds 
Amandaraujo: raises 2400 to 4800
Katwoman0106: folds 
fAArid88: folds 
paulscot1: folds 
Naaarrrr: raises 15020 to 19820 and is all-in
Amandaraujo: calls 15020
*** FLOP *** [3h Ks Kd]
*** TURN *** [3h Ks Kd] [5h]
*** RIVER *** [3h Ks Kd 5h] [6c]
*** SHOW DOWN ***
Naaarrrr: shows [8d 8s] (two pair, Kings and Eights)
Amandaraujo: shows [Kc Js] (three of a kind, Kings)
Amandaraujo collected 42640 from pot
Naaarrrr finished the tournament
*** SUMMARY ***
Total pot 42640 | Rake 0 
Board [3h Ks Kd 5h 6c]
Seat 1: Katwoman0106 (button) folded before Flop (didn't bet)
Seat 2: fAArid88 (small blind) folded before Flop
Seat 3: paulscot1 (big blind) folded before Flop
Seat 4: Naaarrrr showed [8d 8s] and lost with two pair, Kings and Eights
Seat 5: johnyguedes1 folded before Flop (didn't bet)
Seat 6: yuzoyai folded before Flop (didn't bet)
Seat 7: junior_re612 folded before Flop (didn't bet)
Seat 8: Amandaraujo showed [Kc Js] and won (42640) with three of a kind, Kings

PokerStars Hand #251205641324: Tournament #3767885527, $40+$10+$5 USD Hold'em No Limit - Level XII (700/1400) - 2024/06/26 19:09:19 UTC [2024/06/26 15:09:19 ET]
Table '3767885527 37' 8-max Seat #2 is the button
Seat 1: Katwoman0106 (61383 in chips) 
Seat 2: fAArid88 (7920 in chips) 
Seat 3: paulscot1 (15620 in chips) 
Seat 5: johnyguedes1 (63841 in chips) 
Seat 6: yuzoyai (71903 in chips) 
Seat 7: junior_re612 (65491 in chips) 
Seat 8: Amandaraujo (55047 in chips) 
Katwoman0106: posts the ante 175
fAArid88: posts the ante 175
paulscot1: posts the ante 175
johnyguedes1: posts the ante 175
yuzoyai: posts the ante 175
junior_re612: posts the ante 175
Amandaraujo: posts the ante 175
paulscot1: posts small blind 700
johnyguedes1: posts big blind 1400
*** HOLE CARDS ***
yuzoyai: folds 
SWE_CS is disconnected 
junior_re612: folds 
Amandaraujo: folds 
Katwoman0106: raises 1400 to 2800
fAArid88: raises 4945 to 7745 and is all-in
paulscot1: folds 
johnyguedes1: raises 9145 to 16890
Katwoman0106: folds 
Uncalled bet (9145) returned to johnyguedes1
*** FLOP *** [3d Tc Th]
*** TURN *** [3d Tc Th] [4s]
*** RIVER *** [3d Tc Th 4s] [2h]
*** SHOW DOWN ***
johnyguedes1: shows [Ad 9s] (a pair of Tens)
fAArid88: shows [4d Ah] (two pair, Tens and Fours)
fAArid88 collected 20215 from pot
*** SUMMARY ***
Total pot 20215 | Rake 0 
Board [3d Tc Th 4s 2h]
Seat 1: Katwoman0106 folded before Flop
Seat 2: fAArid88 (button) showed [4d Ah] and won (20215) with two pair, Tens and Fours
Seat 3: paulscot1 (small blind) folded before Flop
Seat 5: johnyguedes1 (big blind) showed [Ad 9s] and lost with a pair of Tens
Seat 6: yuzoyai folded before Flop (didn't bet)
Seat 7: junior_re612 folded before Flop (didn't bet)
Seat 8: Amandaraujo folded before Flop (didn't bet)

PokerStars Hand #251205651552: Tournament #3767885527, $40+$10+$5 USD Hold'em No Limit - Level XII (700/1400) - 2024/06/26 19:09:57 UTC [2024/06/26 15:09:57 ET]
Table '3767885527 37' 8-max Seat #3 is the button
Seat 1: Katwoman0106 (58408 in chips) 
Seat 2: fAArid88 (20215 in chips) 
Seat 3: paulscot1 (14745 in chips) 
Seat 4: SWE_CS (25000 in chips) out of hand (moved from another table into small blind)
Seat 5: johnyguedes1 (55921 in chips) 
Seat 6: yuzoyai (71728 in chips) 
Seat 7: junior_re612 (65316 in chips) 
Seat 8: Amandaraujo (54872 in chips) 
SWE_CS will be allowed to play after the button
Katwoman0106: posts the ante 175
fAArid88: posts the ante 175
paulscot1: posts the ante 175
johnyguedes1: posts the ante 175
yuzoyai: posts the ante 175
junior_re612: posts the ante 175
Amandaraujo: posts the ante 175
johnyguedes1: posts small blind 700
yuzoyai: posts big blind 1400
*** HOLE CARDS ***
junior_re612: folds 
Amandaraujo: folds 
Katwoman0106: folds 
fAArid88: folds 
paulscot1: folds 
johnyguedes1: calls 700
yuzoyai: checks 
*** FLOP *** [3c Ac Js]
johnyguedes1: bets 1400
yuzoyai: raises 2952 to 4352
johnyguedes1: calls 2952
*** TURN *** [3c Ac Js] [6h]
johnyguedes1: checks 
yuzoyai: checks 
*** RIVER *** [3c Ac Js 6h] [4s]
johnyguedes1: bets 10565
yuzoyai: folds 
Uncalled bet (10565) returned to johnyguedes1
johnyguedes1 collected 12729 from pot
johnyguedes1: doesn't show hand 
*** SUMMARY ***
Total pot 12729 | Rake 0 
Board [3c Ac Js 6h 4s]
Seat 1: Katwoman0106 folded before Flop (didn't bet)
Seat 2: fAArid88 folded before Flop (didn't bet)
Seat 3: paulscot1 (button) folded before Flop (didn't bet)
Seat 5: johnyguedes1 (small blind) collected (12729)
Seat 6: yuzoyai (big blind) folded on the River
Seat 7: junior_re612 folded before Flop (didn't bet)
Seat 8: Amandaraujo folded before Flop (didn't bet)

PokerStars Hand #251205673323: Tournament #3767885527, $40+$10+$5 USD Hold'em No Limit - Level XII (700/1400) - 2024/06/26 19:11:18 UTC [2024/06/26 15:11:18 ET]
Table '3767885527 37' 8-max Seat #5 is the button
Seat 1: Katwoman0106 (58233 in chips) 
Seat 2: fAArid88 (20040 in chips) 
Seat 3: paulscot1 (14570 in chips) 
Seat 4: SWE_CS (25000 in chips) 
Seat 5: johnyguedes1 (62723 in chips) 
Seat 6: yuzoyai (65801 in chips) 
Seat 7: junior_re612 (65141 in chips) 
Seat 8: Amandaraujo (54697 in chips) 
Katwoman0106: posts the ante 175
fAArid88: posts the ante 175
paulscot1: posts the ante 175
SWE_CS: posts the ante 175
johnyguedes1: posts the ante 175
yuzoyai: posts the ante 175
junior_re612: posts the ante 175
Amandaraujo: posts the ante 175
yuzoyai: posts small blind 700
junior_re612: posts big blind 1400
*** HOLE CARDS ***
Amandaraujo: folds 
Katwoman0106: folds 
fAArid88: folds 
paulscot1: folds 
SWE_CS: folds 
johnyguedes1: raises 1540 to 2940
yuzoyai: folds 
junior_re612: calls 1540
*** FLOP *** [Js 7d 4h]
junior_re612: checks 
johnyguedes1: bets 2633
junior_re612: folds 
Uncalled bet (2633) returned to johnyguedes1
johnyguedes1 collected 7980 from pot
johnyguedes1: doesn't show hand 
*** SUMMARY ***
Total pot 7980 | Rake 0 
Board [Js 7d 4h]
Seat 1: Katwoman0106 folded before Flop (didn't bet)
Seat 2: fAArid88 folded before Flop (didn't bet)
Seat 3: paulscot1 folded before Flop (didn't bet)
Seat 4: SWE_CS folded before Flop (didn't bet)
Seat 5: johnyguedes1 (button) collected (7980)
Seat 6: yuzoyai (small blind) folded before Flop
Seat 7: junior_re612 (big blind) folded on the Flop
Seat 8: Amandaraujo folded before Flop (didn't bet)

PokerStars Hand #251205684942: Tournament #3767885527, $40+$10+$5 USD Hold'em No Limit - Level XII (700/1400) - 2024/06/26 19:12:01 UTC [2024/06/26 15:12:01 ET]
Table '3767885527 37' 8-max Seat #6 is the button
Seat 1: Katwoman0106 (58058 in chips) 
Seat 2: fAArid88 (19865 in chips) 
Seat 3: paulscot1 (14395 in chips) 
Seat 4: SWE_CS (24825 in chips) 
Seat 5: johnyguedes1 (67588 in chips) 
Seat 6: yuzoyai (64926 in chips) 
Seat 7: junior_re612 (62026 in chips) 
Seat 8: Amandaraujo (54522 in chips) 
Katwoman0106: posts the ante 175
fAArid88: posts the ante 175
paulscot1: posts the ante 175
SWE_CS: posts the ante 175
johnyguedes1: posts the ante 175
yuzoyai: posts the ante 175
junior_re612: posts the ante 175
Amandaraujo: posts the ante 175
junior_re612: posts small blind 700
Amandaraujo: posts big blind 1400
*** HOLE CARDS ***
Katwoman0106: folds 
fAArid88: folds 
paulscot1: raises 12820 to 14220 and is all-in
SWE_CS: folds 
johnyguedes1: folds 
yuzoyai: folds 
junior_re612: folds 
Amandaraujo: folds 
Uncalled bet (12820) returned to paulscot1
paulscot1 collected 4900 from pot
paulscot1: doesn't show hand 
*** SUMMARY ***
Total pot 4900 | Rake 0 
Seat 1: Katwoman0106 folded before Flop (didn't bet)
Seat 2: fAArid88 folded before Flop (didn't bet)
Seat 3: paulscot1 collected (4900)
Seat 4: SWE_CS folded before Flop (didn't bet)
Seat 5: johnyguedes1 folded before Flop (didn't bet)
Seat 6: yuzoyai (button) folded before Flop (didn't bet)
Seat 7: junior_re612 (small blind) folded before Flop
Seat 8: Amandaraujo (big blind) folded before Flop

PokerStars Hand #251205694572: Tournament #3767885527, $40+$10+$5 USD Hold'em No Limit - Level XII (700/1400) - 2024/06/26 19:12:36 UTC [2024/06/26 15:12:36 ET]
Table '3767885527 37' 8-max Seat #7 is the button
Seat 1: Katwoman0106 (57883 in chips) 
Seat 2: fAArid88 (19690 in chips) 
Seat 3: paulscot1 (17720 in chips) 
Seat 4: SWE_CS (24650 in chips) 
Seat 5: johnyguedes1 (67413 in chips) 
Seat 6: yuzoyai (64751 in chips) 
Seat 7: junior_re612 (61151 in chips) 
Seat 8: Amandaraujo (52947 in chips) 
Katwoman0106: posts the ante 175
fAArid88: posts the ante 175
paulscot1: posts the ante 175
SWE_CS: posts the ante 175
johnyguedes1: posts the ante 175
yuzoyai: posts the ante 175
junior_re612: posts the ante 175
Amandaraujo: posts the ante 175
Amandaraujo: posts small blind 700
Katwoman0106: posts big blind 1400
*** HOLE CARDS ***
fAArid88: folds 
paulscot1: folds 
SWE_CS: folds 
johnyguedes1: raises 1540 to 2940
yuzoyai: folds 
junior_re612: calls 2940
Amandaraujo: calls 2240
Katwoman0106: calls 1540
*** FLOP *** [2h Jc 6s]
Amandaraujo: checks 
Katwoman0106: checks 
johnyguedes1: checks 
junior_re612: checks 
*** TURN *** [2h Jc 6s] [Jh]
Amandaraujo: checks 
Katwoman0106: bets 7373
johnyguedes1: folds 
junior_re612: folds 
Amandaraujo: folds 
Uncalled bet (7373) returned to Katwoman0106
Katwoman0106 collected 13160 from pot
Katwoman0106: doesn't show hand 
*** SUMMARY ***
Total pot 13160 | Rake 0 
Board [2h Jc 6s Jh]
Seat 1: Katwoman0106 (big blind) collected (13160)
Seat 2: fAArid88 folded before Flop (didn't bet)
Seat 3: paulscot1 folded before Flop (didn't bet)
Seat 4: SWE_CS folded before Flop (didn't bet)
Seat 5: johnyguedes1 folded on the Turn
Seat 6: yuzoyai folded before Flop (didn't bet)
Seat 7: junior_re612 (button) folded on the Turn
Seat 8: Amandaraujo (small blind) folded on the Turn

PokerStars Hand #251205711410: Tournament #3767885527, $40+$10+$5 USD Hold'em No Limit - Level XII (700/1400) - 2024/06/26 19:13:39 UTC [2024/06/26 15:13:39 ET]
Table '3767885527 37' 8-max Seat #8 is the button
Seat 1: Katwoman0106 (67928 in chips) 
Seat 2: fAArid88 (19515 in chips) 
Seat 3: paulscot1 (17545 in chips) 
Seat 4: SWE_CS (24475 in chips) 
Seat 5: johnyguedes1 (64298 in chips) 
Seat 6: yuzoyai (64576 in chips) 
Seat 7: junior_re612 (58036 in chips) 
Seat 8: Amandaraujo (49832 in chips) 
Katwoman0106: posts the ante 175
fAArid88: posts the ante 175
paulscot1: posts the ante 175
SWE_CS: posts the ante 175
johnyguedes1: posts the ante 175
yuzoyai: posts the ante 175
junior_re612: posts the ante 175
Amandaraujo: posts the ante 175
Katwoman0106: posts small blind 700
fAArid88: posts big blind 1400
*** HOLE CARDS ***
paulscot1: folds 
SWE_CS: folds 
johnyguedes1: folds 
yuzoyai: folds 
junior_re612: folds 
Amandaraujo: folds 
Katwoman0106: folds 
Uncalled bet (700) returned to fAArid88
fAArid88 collected 2800 from pot
fAArid88: doesn't show hand 
*** SUMMARY ***
Total pot 2800 | Rake 0 
Seat 1: Katwoman0106 (small blind) folded before Flop
Seat 2: fAArid88 (big blind) collected (2800)
Seat 3: paulscot1 folded before Flop (didn't bet)
Seat 4: SWE_CS folded before Flop (didn't bet)
Seat 5: johnyguedes1 folded before Flop (didn't bet)
Seat 6: yuzoyai folded before Flop (didn't bet)
Seat 7: junior_re612 folded before Flop (didn't bet)
Seat 8: Amandaraujo (button) folded before Flop (didn't bet)

PokerStars Hand #251205721838: Tournament #3767885527, $40+$10+$5 USD Hold'em No Limit - Level XII (700/1400) - 2024/06/26 19:14:17 UTC [2024/06/26 15:14:17 ET]
Table '3767885527 37' 8-max Seat #1 is the button
Seat 1: Katwoman0106 (67053 in chips) 
Seat 2: fAArid88 (21440 in chips) 
Seat 3: paulscot1 (17370 in chips) 
Seat 4: SWE_CS (24300 in chips) 
Seat 5: johnyguedes1 (64123 in chips) 
Seat 6: yuzoyai (64401 in chips) 
Seat 7: junior_re612 (57861 in chips) 
Seat 8: Amandaraujo (49657 in chips) 
Katwoman0106: posts the ante 175
fAArid88: posts the ante 175
paulscot1: posts the ante 175
SWE_CS: posts the ante 175
johnyguedes1: posts the ante 175
yuzoyai: posts the ante 175
junior_re612: posts the ante 175
Amandaraujo: posts the ante 175
fAArid88: posts small blind 700
paulscot1: posts big blind 1400
*** HOLE CARDS ***
SWE_CS: folds 
johnyguedes1: folds 
yuzoyai: folds 
junior_re612: folds 
Amandaraujo: raises 1400 to 2800
Katwoman0106: calls 2800
fAArid88: raises 18465 to 21265 and is all-in
paulscot1: folds 
Amandaraujo: folds 
Katwoman0106: calls 18465
*** FLOP *** [6d 3h 2h]
*** TURN *** [6d 3h 2h] [Qs]
*** RIVER *** [6d 3h 2h Qs] [5c]
*** SHOW DOWN ***
fAArid88: shows [Qd Ks] (a pair of Queens)
Katwoman0106: shows [Ac 9c] (high card Ace)
fAArid88 collected 48130 from pot
*** SUMMARY ***
Total pot 48130 | Rake 0 
Board [6d 3h 2h Qs 5c]
Seat 1: Katwoman0106 (button) showed [Ac 9c] and lost with high card Ace
Seat 2: fAArid88 (small blind) showed [Qd Ks] and won (48130) with a pair of Queens
Seat 3: paulscot1 (big blind) folded before Flop
Seat 4: SWE_CS folded before Flop (didn't bet)
Seat 5: johnyguedes1 folded before Flop (didn't bet)
Seat 6: yuzoyai folded before Flop (didn't bet)
Seat 7: junior_re612 folded before Flop (didn't bet)
Seat 8: Amandaraujo folded before Flop

PokerStars Hand #251205733111: Tournament #3767885527, $40+$10+$5 USD Hold'em No Limit - Level XII (700/1400) - 2024/06/26 19:14:59 UTC [2024/06/26 15:14:59 ET]
Table '3767885527 37' 8-max Seat #2 is the button
Seat 1: Katwoman0106 (45613 in chips) 
Seat 2: fAArid88 (48130 in chips) 
Seat 3: paulscot1 (15795 in chips) 
Seat 4: SWE_CS (24125 in chips) 
Seat 5: johnyguedes1 (63948 in chips) 
Seat 6: yuzoyai (64226 in chips) 
Seat 7: junior_re612 (57686 in chips) 
Seat 8: Amandaraujo (46682 in chips) 
Katwoman0106: posts the ante 175
fAArid88: posts the ante 175
paulscot1: posts the ante 175
SWE_CS: posts the ante 175
johnyguedes1: posts the ante 175
yuzoyai: posts the ante 175
junior_re612: posts the ante 175
Amandaraujo: posts the ante 175
paulscot1: posts small blind 700
SWE_CS: posts big blind 1400
*** HOLE CARDS ***
johnyguedes1: folds 
yuzoyai: folds 
junior_re612: folds 
Amandaraujo: raises 1400 to 2800
Katwoman0106: calls 2800
fAArid88: folds 
paulscot1: folds 
SWE_CS: folds 
*** FLOP *** [8s 3d 8h]
Amandaraujo: checks 
Katwoman0106: checks 
*** TURN *** [8s 3d 8h] [7s]
Amandaraujo: checks 
Katwoman0106: checks 
*** RIVER *** [8s 3d 8h 7s] [6s]
Amandaraujo: checks 
Katwoman0106: checks 
*** SHOW DOWN ***
Amandaraujo: shows [Qd Jd] (a pair of Eights)
Katwoman0106: shows [2c 2h] (two pair, Eights and Deuces)
Katwoman0106 collected 9100 from pot
*** SUMMARY ***
Total pot 9100 | Rake 0 
Board [8s 3d 8h 7s 6s]
Seat 1: Katwoman0106 showed [2c 2h] and won (9100) with two pair, Eights and Deuces
Seat 2: fAArid88 (button) folded before Flop (didn't bet)
Seat 3: paulscot1 (small blind) folded before Flop
Seat 4: SWE_CS (big blind) folded before Flop
Seat 5: johnyguedes1 folded before Flop (didn't bet)
Seat 6: yuzoyai folded before Flop (didn't bet)
Seat 7: junior_re612 folded before Flop (didn't bet)
Seat 8: Amandaraujo showed [Qd Jd] and lost with a pair of Eights

PokerStars Hand #251205743653: Tournament #3767885527, $40+$10+$5 USD Hold'em No Limit - Level XII (700/1400) - 2024/06/26 19:15:38 UTC [2024/06/26 15:15:38 ET]
Table '3767885527 37' 8-max Seat #3 is the button
Seat 1: Katwoman0106 (51738 in chips) 
Seat 2: fAArid88 (47955 in chips) 
Seat 3: paulscot1 (14920 in chips) 
Seat 4: SWE_CS (22550 in chips) 
Seat 5: johnyguedes1 (63773 in chips) 
Seat 6: yuzoyai (64051 in chips) 
Seat 7: junior_re612 (57511 in chips) 
Seat 8: Amandaraujo (43707 in chips) 
Katwoman0106: posts the ante 175
fAArid88: posts the ante 175
paulscot1: posts the ante 175
SWE_CS: posts the ante 175
johnyguedes1: posts the ante 175
yuzoyai: posts the ante 175
junior_re612: posts the ante 175
Amandaraujo: posts the ante 175
SWE_CS: posts small blind 700
johnyguedes1: posts big blind 1400
*** HOLE CARDS ***
yuzoyai: raises 1400 to 2800
junior_re612: folds 
Amandaraujo: calls 2800
Katwoman0106: folds 
fAArid88: raises 8400 to 11200
paulscot1: folds 
SWE_CS: folds 
johnyguedes1: folds 
yuzoyai: folds 
Amandaraujo: calls 8400
*** FLOP *** [Kc 5d 5s]
Amandaraujo: checks 
fAArid88: checks 
*** TURN *** [Kc 5d 5s] [2h]
Amandaraujo: checks 
fAArid88: checks 
*** RIVER *** [Kc 5d 5s 2h] [6d]
Amandaraujo: checks 
fAArid88: bets 8400
Amandaraujo: raises 8400 to 16800
fAArid88: raises 8400 to 25200
Amandaraujo: raises 7132 to 32332 and is all-in
fAArid88: calls 7132
*** SHOW DOWN ***
Amandaraujo: shows [2s 5c] (a full house, Fives full of Deuces)
fAArid88: shows [Kh Kd] (a full house, Kings full of Fives)
fAArid88 collected 93364 from pot
Amandaraujo finished the tournament
*** SUMMARY ***
Total pot 93364 | Rake 0 
Board [Kc 5d 5s 2h 6d]
Seat 1: Katwoman0106 folded before Flop (didn't bet)
Seat 2: fAArid88 showed [Kh Kd] and won (93364) with a full house, Kings full of Fives
Seat 3: paulscot1 (button) folded before Flop (didn't bet)
Seat 4: SWE_CS (small blind) folded before Flop
Seat 5: johnyguedes1 (big blind) folded before Flop
Seat 6: yuzoyai folded before Flop
Seat 7: junior_re612 folded before Flop (didn't bet)
Seat 8: Amandaraujo showed [2s 5c] and lost with a full house, Fives full of Deuces

PokerStars Hand #251205761850: Tournament #3767885527, $40+$10+$5 USD Hold'em No Limit - Level XII (700/1400) - 2024/06/26 19:16:45 UTC [2024/06/26 15:16:45 ET]
Table '3767885527 37' 8-max Seat #4 is the button
Seat 1: Katwoman0106 (51563 in chips) 
Seat 2: fAArid88 (97612 in chips) 
Seat 3: paulscot1 (14745 in chips) 
Seat 4: SWE_CS (21675 in chips) 
Seat 5: johnyguedes1 (62198 in chips) 
Seat 6: yuzoyai (61076 in chips) 
Seat 7: junior_re612 (57336 in chips) 
Katwoman0106: posts the ante 175
fAArid88: posts the ante 175
paulscot1: posts the ante 175
SWE_CS: posts the ante 175
johnyguedes1: posts the ante 175
yuzoyai: posts the ante 175
junior_re612: posts the ante 175
johnyguedes1: posts small blind 700
yuzoyai: posts big blind 1400
*** HOLE CARDS ***
junior_re612: folds 
Katwoman0106: folds 
fAArid88: folds 
paulscot1: raises 13170 to 14570 and is all-in
SWE_CS: folds 
johnyguedes1: folds 
yuzoyai: folds 
Uncalled bet (13170) returned to paulscot1
paulscot1 collected 4725 from pot
paulscot1: doesn't show hand 
*** SUMMARY ***
Total pot 4725 | Rake 0 
Seat 1: Katwoman0106 folded before Flop (didn't bet)
Seat 2: fAArid88 folded before Flop (didn't bet)
Seat 3: paulscot1 collected (4725)
Seat 4: SWE_CS (button) folded before Flop (didn't bet)
Seat 5: johnyguedes1 (small blind) folded before Flop
Seat 6: yuzoyai (big blind) folded before Flop
Seat 7: junior_re612 folded before Flop (didn't bet)

PokerStars Hand #251205771643: Tournament #3767885527, $40+$10+$5 USD Hold'em No Limit - Level XII (700/1400) - 2024/06/26 19:17:20 UTC [2024/06/26 15:17:20 ET]
Table '3767885527 37' 8-max Seat #5 is the button
Seat 1: Katwoman0106 (51388 in chips) 
Seat 2: fAArid88 (97437 in chips) 
Seat 3: paulscot1 (17895 in chips) 
Seat 4: SWE_CS (21500 in chips) 
Seat 5: johnyguedes1 (61323 in chips) 
Seat 6: yuzoyai (59501 in chips) 
Seat 7: junior_re612 (57161 in chips) 
Katwoman0106: posts the ante 175
fAArid88: posts the ante 175
paulscot1: posts the ante 175
SWE_CS: posts the ante 175
johnyguedes1: posts the ante 175
yuzoyai: posts the ante 175
junior_re612: posts the ante 175
yuzoyai: posts small blind 700
junior_re612: posts big blind 1400
*** HOLE CARDS ***
Katwoman0106: raises 1400 to 2800
fAArid88: folds 
paulscot1: folds 
SWE_CS: folds 
johnyguedes1: folds 
yuzoyai: folds 
junior_re612: folds 
Uncalled bet (1400) returned to Katwoman0106
Katwoman0106 collected 4725 from pot
*** SUMMARY ***
Total pot 4725 | Rake 0 
Seat 1: Katwoman0106 collected (4725)
Seat 2: fAArid88 folded before Flop (didn't bet)
Seat 3: paulscot1 folded before Flop (didn't bet)
Seat 4: SWE_CS folded before Flop (didn't bet)
Seat 5: johnyguedes1 (button) folded before Flop (didn't bet)
Seat 6: yuzoyai (small blind) folded before Flop
Seat 7: junior_re612 (big blind) folded before Flop

PokerStars Hand #251205782195: Tournament #3767885527, $40+$10+$5 USD Hold'em No Limit - Level XII (700/1400) - 2024/06/26 19:17:59 UTC [2024/06/26 15:17:59 ET]
Table '3767885527 37' 8-max Seat #6 is the button
Seat 1: Katwoman0106 (54538 in chips) 
Seat 2: fAArid88 (97262 in chips) 
Seat 3: paulscot1 (17720 in chips) 
Seat 4: SWE_CS (21325 in chips) 
Seat 5: johnyguedes1 (61148 in chips) 
Seat 6: yuzoyai (58626 in chips) 
Seat 7: junior_re612 (55586 in chips) 
Katwoman0106: posts the ante 175
fAArid88: posts the ante 175
paulscot1: posts the ante 175
SWE_CS: posts the ante 175
johnyguedes1: posts the ante 175
yuzoyai: posts the ante 175
junior_re612: posts the ante 175
junior_re612: posts small blind 700
Katwoman0106: posts big blind 1400
*** HOLE CARDS ***
fAArid88: folds 
bashfoc2 is disconnected 
paulscot1: folds 
SWE_CS: folds 
johnyguedes1: folds 
yuzoyai: folds 
junior_re612: folds 
Uncalled bet (700) returned to Katwoman0106
Katwoman0106 collected 2625 from pot
*** SUMMARY ***
Total pot 2625 | Rake 0 
Seat 1: Katwoman0106 (big blind) collected (2625)
Seat 2: fAArid88 folded before Flop (didn't bet)
Seat 3: paulscot1 folded before Flop (didn't bet)
Seat 4: SWE_CS folded before Flop (didn't bet)
Seat 5: johnyguedes1 folded before Flop (didn't bet)
Seat 6: yuzoyai (button) folded before Flop (didn't bet)
Seat 7: junior_re612 (small blind) folded before Flop

PokerStars Hand #251205788415: Tournament #3767885527, $40+$10+$5 USD Hold'em No Limit - Level XII (700/1400) - 2024/06/26 19:18:22 UTC [2024/06/26 15:18:22 ET]
Table '3767885527 37' 8-max Seat #7 is the button
Seat 1: Katwoman0106 (56288 in chips) 
Seat 2: fAArid88 (97087 in chips) 
Seat 3: paulscot1 (17545 in chips) 
Seat 4: SWE_CS (21150 in chips) 
Seat 5: johnyguedes1 (60973 in chips) 
Seat 6: yuzoyai (58451 in chips) 
Seat 7: junior_re612 (54711 in chips) 
Seat 8: bashfoc2 (25000 in chips) out of hand (moved from another table into small blind)
bashfoc2 will be allowed to play after the button
Katwoman0106: posts the ante 175
fAArid88: posts the ante 175
paulscot1: posts the ante 175
SWE_CS: posts the ante 175
johnyguedes1: posts the ante 175
yuzoyai: posts the ante 175
junior_re612: posts the ante 175
Katwoman0106: posts small blind 700
fAArid88: posts big blind 1400
*** HOLE CARDS ***
paulscot1: folds 
SWE_CS: folds 
johnyguedes1: raises 1540 to 2940
yuzoyai: folds 
junior_re612: folds 
Katwoman0106: folds 
fAArid88: calls 1540
*** FLOP *** [6s 2s 3s]
fAArid88: checks 
johnyguedes1: bets 1951
fAArid88: raises 7839 to 9790
johnyguedes1: calls 7839
*** TURN *** [6s 2s 3s] [8s]
fAArid88: bets 9800
johnyguedes1: calls 9800
*** RIVER *** [6s 2s 3s 8s] [9c]
fAArid88: bets 26600
johnyguedes1: calls 26600
*** SHOW DOWN ***
fAArid88: shows [4h As] (a flush, Ace high)
johnyguedes1: mucks hand 
fAArid88 collected 100185 from pot
*** SUMMARY ***
Total pot 100185 | Rake 0 
Board [6s 2s 3s 8s 9c]
Seat 1: Katwoman0106 (small blind) folded before Flop
Seat 2: fAArid88 (big blind) showed [4h As] and won (100185) with a flush, Ace high
Seat 3: paulscot1 folded before Flop (didn't bet)
Seat 4: SWE_CS folded before Flop (didn't bet)
Seat 5: johnyguedes1 mucked
Seat 6: yuzoyai folded before Flop (didn't bet)
Seat 7: junior_re612 (button) folded before Flop (didn't bet)

PokerStars Hand #251205813184: Tournament #3767885527, $40+$10+$5 USD Hold'em No Limit - Level XIII (800/1600) - 2024/06/26 19:19:52 UTC [2024/06/26 15:19:52 ET]
Table '3767885527 37' 8-max Seat #1 is the button
Seat 1: Katwoman0106 (55413 in chips) 
Seat 2: fAArid88 (147967 in chips) 
Seat 3: paulscot1 (17370 in chips) 
Seat 4: SWE_CS (20975 in chips) 
Seat 5: johnyguedes1 (11668 in chips) 
Seat 6: yuzoyai (58276 in chips) 
Seat 7: junior_re612 (54536 in chips) 
Seat 8: bashfoc2 (25000 in chips) 
Katwoman0106: posts the ante 200
fAArid88: posts the ante 200
paulscot1: posts the ante 200
SWE_CS: posts the ante 200
johnyguedes1: posts the ante 200
yuzoyai: posts the ante 200
junior_re612: posts the ante 200
bashfoc2: posts the ante 200
fAArid88: posts small blind 800
paulscot1: posts big blind 1600
*** HOLE CARDS ***
SWE_CS: folds 
johnyguedes1: folds 
yuzoyai: folds 
junior_re612: folds 
bashfoc2: raises 4800 to 6400
Katwoman0106: folds 
fAArid88: folds 
paulscot1: folds 
Uncalled bet (4800) returned to bashfoc2
bashfoc2 collected 5600 from pot
bashfoc2: doesn't show hand 
*** SUMMARY ***
Total pot 5600 | Rake 0 
Seat 1: Katwoman0106 (button) folded before Flop (didn't bet)
Seat 2: fAArid88 (small blind) folded before Flop
Seat 3: paulscot1 (big blind) folded before Flop
Seat 4: SWE_CS folded before Flop (didn't bet)
Seat 5: johnyguedes1 folded before Flop (didn't bet)
Seat 6: yuzoyai folded before Flop (didn't bet)
Seat 7: junior_re612 folded before Flop (didn't bet)
Seat 8: bashfoc2 collected (5600)

PokerStars Hand #251205819663: Tournament #3767885527, $40+$10+$5 USD Hold'em No Limit - Level XIII (800/1600) - 2024/06/26 19:20:16 UTC [2024/06/26 15:20:16 ET]
Table '3767885527 37' 8-max Seat #2 is the button
Seat 1: Katwoman0106 (55213 in chips) 
Seat 2: fAArid88 (146967 in chips) 
Seat 3: paulscot1 (15570 in chips) 
Seat 4: SWE_CS (20775 in chips) 
Seat 5: johnyguedes1 (11468 in chips) 
Seat 6: yuzoyai (58076 in chips) 
Seat 7: junior_re612 (54336 in chips) 
Seat 8: bashfoc2 (28800 in chips) 
Katwoman0106: posts the ante 200
fAArid88: posts the ante 200
paulscot1: posts the ante 200
SWE_CS: posts the ante 200
johnyguedes1: posts the ante 200
yuzoyai: posts the ante 200
junior_re612: posts the ante 200
bashfoc2: posts the ante 200
paulscot1: posts small blind 800
SWE_CS: posts big blind 1600
*** HOLE CARDS ***
johnyguedes1: folds 
yuzoyai: folds 
junior_re612: folds 
bashfoc2: folds 
Katwoman0106: raises 1600 to 3200
fAArid88: folds 
paulscot1: folds 
SWE_CS: calls 1600
*** FLOP *** [Jd Ad 3s]
SWE_CS: checks 
Katwoman0106: checks 
*** TURN *** [Jd Ad 3s] [Kd]
SWE_CS: checks 
Katwoman0106: checks 
*** RIVER *** [Jd Ad 3s Kd] [Qd]
SWE_CS: bets 4400
Katwoman0106: folds [Qs Ks]
Uncalled bet (4400) returned to SWE_CS
SWE_CS collected 8800 from pot
SWE_CS: doesn't show hand 
*** SUMMARY ***
Total pot 8800 | Rake 0 
Board [Jd Ad 3s Kd Qd]
Seat 1: Katwoman0106 folded on the River
Seat 2: fAArid88 (button) folded before Flop (didn't bet)
Seat 3: paulscot1 (small blind) folded before Flop
Seat 4: SWE_CS (big blind) collected (8800)
Seat 5: johnyguedes1 folded before Flop (didn't bet)
Seat 6: yuzoyai folded before Flop (didn't bet)
Seat 7: junior_re612 folded before Flop (didn't bet)
Seat 8: bashfoc2 folded before Flop (didn't bet)

PokerStars Hand #251205832214: Tournament #3767885527, $40+$10+$5 USD Hold'em No Limit - Level XIII (800/1600) - 2024/06/26 19:21:02 UTC [2024/06/26 15:21:02 ET]
Table '3767885527 37' 8-max Seat #3 is the button
Seat 1: Katwoman0106 (51813 in chips) 
Seat 2: fAArid88 (146767 in chips) 
Seat 3: paulscot1 (14570 in chips) 
Seat 4: SWE_CS (26175 in chips) 
Seat 5: johnyguedes1 (11268 in chips) 
Seat 6: yuzoyai (57876 in chips) 
Seat 7: junior_re612 (54136 in chips) 
Seat 8: bashfoc2 (28600 in chips) 
Katwoman0106: posts the ante 200
fAArid88: posts the ante 200
paulscot1: posts the ante 200
SWE_CS: posts the ante 200
johnyguedes1: posts the ante 200
yuzoyai: posts the ante 200
junior_re612: posts the ante 200
bashfoc2: posts the ante 200
SWE_CS: posts small blind 800
johnyguedes1: posts big blind 1600
*** HOLE CARDS ***
yuzoyai: raises 1600 to 3200
junior_re612: folds 
bashfoc2: raises 4800 to 8000
Katwoman0106: folds 
fAArid88: folds 
paulscot1: folds 
SWE_CS: raises 17975 to 25975 and is all-in
johnyguedes1: folds 
yuzoyai: raises 31701 to 57676 and is all-in
bashfoc2: calls 20400 and is all-in
Uncalled bet (29276) returned to yuzoyai
*** FLOP *** [4s 7s Ac]
*** TURN *** [4s 7s Ac] [3h]
*** RIVER *** [4s 7s Ac 3h] [Ad]
*** SHOW DOWN ***
yuzoyai: shows [Kh Kc] (two pair, Aces and Kings)
bashfoc2: shows [As Qd] (three of a kind, Aces)
bashfoc2 collected 4850 from side pot
SWE_CS: shows [Qs Qc] (two pair, Aces and Queens)
bashfoc2 collected 81125 from main pot
SWE_CS finished the tournament
*** SUMMARY ***
Total pot 85975 Main pot 81125. Side pot 4850. | Rake 0 
Board [4s 7s Ac 3h Ad]
Seat 1: Katwoman0106 folded before Flop (didn't bet)
Seat 2: fAArid88 folded before Flop (didn't bet)
Seat 3: paulscot1 (button) folded before Flop (didn't bet)
Seat 4: SWE_CS (small blind) showed [Qs Qc] and lost with two pair, Aces and Queens
Seat 5: johnyguedes1 (big blind) folded before Flop
Seat 6: yuzoyai showed [Kh Kc] and lost with two pair, Aces and Kings
Seat 7: junior_re612 folded before Flop (didn't bet)
Seat 8: bashfoc2 showed [As Qd] and won (85975) with three of a kind, Aces


PokerStars Hand #251205591253: Tournament #3767885527, $40+$10+$5 USD Hold'em No Limit - Level XI (600/1200) - 2024/06/26 19:06:11 UTC [2024/06/26 15:06:11 ET]
Table '3767885527 35' 8-max Seat #1 is the button
Seat 1: hiran bass (33141 in chips) 
Seat 2: Famazaja (33260 in chips) 
Seat 3: atg590 (72411 in chips) 
Seat 4: PhoenixGrind (96000 in chips) 
Seat 5: Johevera (49368 in chips) 
Seat 6: sQuezzeYoU!! (44387 in chips) 
Seat 7: jaimico00793 (8393 in chips) 
Seat 8: gwallgofddyn (102599 in chips) 
hiran bass: posts the ante 150
Famazaja: posts the ante 150
atg590: posts the ante 150
PhoenixGrind: posts the ante 150
Johevera: posts the ante 150
sQuezzeYoU!!: posts the ante 150
jaimico00793: posts the ante 150
gwallgofddyn: posts the ante 150
Famazaja: posts small blind 600
atg590: posts big blind 1200
*** HOLE CARDS ***
PhoenixGrind: folds 
Johevera: folds 
sQuezzeYoU!!: folds 
jaimico00793: folds 
gwallgofddyn: raises 1560 to 2760
hiran bass: calls 2760
Famazaja: folds 
atg590: calls 1560
*** FLOP *** [2d 4d Js]
atg590: checks 
gwallgofddyn: bets 4032
hiran bass: folds 
atg590: calls 4032
*** TURN *** [2d 4d Js] [9h]
atg590: checks 
gwallgofddyn: checks 
*** RIVER *** [2d 4d Js 9h] [5s]
atg590: bets 9072
gwallgofddyn: folds 
Uncalled bet (9072) returned to atg590
atg590 collected 18144 from pot
*** SUMMARY ***
Total pot 18144 | Rake 0 
Board [2d 4d Js 9h 5s]
Seat 1: hiran bass (button) folded on the Flop
Seat 2: Famazaja (small blind) folded before Flop
Seat 3: atg590 (big blind) collected (18144)
Seat 4: PhoenixGrind folded before Flop (didn't bet)
Seat 5: Johevera folded before Flop (didn't bet)
Seat 6: sQuezzeYoU!! folded before Flop (didn't bet)
Seat 7: jaimico00793 folded before Flop (didn't bet)
Seat 8: gwallgofddyn folded on the River

PokerStars Hand #251205606358: Tournament #3767885527, $40+$10+$5 USD Hold'em No Limit - Level XI (600/1200) - 2024/06/26 19:07:07 UTC [2024/06/26 15:07:07 ET]
Table '3767885527 35' 8-max Seat #2 is the button
Seat 1: hiran bass (30231 in chips) 
Seat 2: Famazaja (32510 in chips) 
Seat 3: atg590 (83613 in chips) 
Seat 4: PhoenixGrind (95850 in chips) 
Seat 5: Johevera (49218 in chips) 
Seat 6: sQuezzeYoU!! (44237 in chips) 
Seat 7: jaimico00793 (8243 in chips) 
Seat 8: gwallgofddyn (95657 in chips) 
hiran bass: posts the ante 150
Famazaja: posts the ante 150
atg590: posts the ante 150
PhoenixGrind: posts the ante 150
Johevera: posts the ante 150
sQuezzeYoU!!: posts the ante 150
jaimico00793: posts the ante 150
gwallgofddyn: posts the ante 150
atg590: posts small blind 600
PhoenixGrind: posts big blind 1200
*** HOLE CARDS ***
Johevera: folds 
sQuezzeYoU!!: folds 
jaimico00793: raises 6893 to 8093 and is all-in
gwallgofddyn: folds 
hiran bass: folds 
Famazaja: folds 
atg590: folds 
PhoenixGrind: calls 6893
*** FLOP *** [Qs 9h 5d]
*** TURN *** [Qs 9h 5d] [Ac]
*** RIVER *** [Qs 9h 5d Ac] [8d]
*** SHOW DOWN ***
PhoenixGrind: shows [Kd 3d] (high card Ace)
jaimico00793: shows [Qc Ad] (two pair, Aces and Queens)
jaimico00793 collected 17986 from pot
*** SUMMARY ***
Total pot 17986 | Rake 0 
Board [Qs 9h 5d Ac 8d]
Seat 1: hiran bass folded before Flop (didn't bet)
Seat 2: Famazaja (button) folded before Flop (didn't bet)
Seat 3: atg590 (small blind) folded before Flop
Seat 4: PhoenixGrind (big blind) showed [Kd 3d] and lost with high card Ace
Seat 5: Johevera folded before Flop (didn't bet)
Seat 6: sQuezzeYoU!! folded before Flop (didn't bet)
Seat 7: jaimico00793 showed [Qc Ad] and won (17986) with two pair, Aces and Queens
Seat 8: gwallgofddyn folded before Flop (didn't bet)

PokerStars Hand #251205612998: Tournament #3767885527, $40+$10+$5 USD Hold'em No Limit - Level XI (600/1200) - 2024/06/26 19:07:32 UTC [2024/06/26 15:07:32 ET]
Table '3767885527 35' 8-max Seat #3 is the button
Seat 1: hiran bass (30081 in chips) 
Seat 2: Famazaja (32360 in chips) 
Seat 3: atg590 (82863 in chips) 
Seat 4: PhoenixGrind (87607 in chips) 
Seat 5: Johevera (49068 in chips) 
Seat 6: sQuezzeYoU!! (44087 in chips) 
Seat 7: jaimico00793 (17986 in chips) 
Seat 8: gwallgofddyn (95507 in chips) 
hiran bass: posts the ante 150
Famazaja: posts the ante 150
atg590: posts the ante 150
PhoenixGrind: posts the ante 150
Johevera: posts the ante 150
sQuezzeYoU!!: posts the ante 150
jaimico00793: posts the ante 150
gwallgofddyn: posts the ante 150
PhoenixGrind: posts small blind 600
Johevera: posts big blind 1200
*** HOLE CARDS ***
sQuezzeYoU!!: folds 
jaimico00793: folds 
gwallgofddyn: raises 1560 to 2760
hiran bass: raises 3840 to 6600
Famazaja: folds 
atg590: folds 
PhoenixGrind: folds 
Johevera: folds 
gwallgofddyn: calls 3840
*** FLOP *** [7c Qc Kh]
gwallgofddyn: checks 
hiran bass: checks 
*** TURN *** [7c Qc Kh] [9h]
gwallgofddyn: checks 
hiran bass: checks 
*** RIVER *** [7c Qc Kh 9h] [5c]
gwallgofddyn: bets 6480
hiran bass: folds 
Uncalled bet (6480) returned to gwallgofddyn
gwallgofddyn collected 16200 from pot
gwallgofddyn: doesn't show hand 
*** SUMMARY ***
Total pot 16200 | Rake 0 
Board [7c Qc Kh 9h 5c]
Seat 1: hiran bass folded on the River
Seat 2: Famazaja folded before Flop (didn't bet)
Seat 3: atg590 (button) folded before Flop (didn't bet)
Seat 4: PhoenixGrind (small blind) folded before Flop
Seat 5: Johevera (big blind) folded before Flop
Seat 6: sQuezzeYoU!! folded before Flop (didn't bet)
Seat 7: jaimico00793 folded before Flop (didn't bet)
Seat 8: gwallgofddyn collected (16200)

PokerStars Hand #251205632476: Tournament #3767885527, $40+$10+$5 USD Hold'em No Limit - Level XI (600/1200) - 2024/06/26 19:08:46 UTC [2024/06/26 15:08:46 ET]
Table '3767885527 35' 8-max Seat #4 is the button
Seat 1: hiran bass (23331 in chips) 
Seat 2: Famazaja (32210 in chips) 
Seat 3: atg590 (82713 in chips) 
Seat 4: PhoenixGrind (86857 in chips) 
Seat 5: Johevera (47718 in chips) 
Seat 6: sQuezzeYoU!! (43937 in chips) 
Seat 7: jaimico00793 (17836 in chips) 
Seat 8: gwallgofddyn (104957 in chips) 
hiran bass: posts the ante 150
Famazaja: posts the ante 150
atg590: posts the ante 150
PhoenixGrind: posts the ante 150
Johevera: posts the ante 150
sQuezzeYoU!!: posts the ante 150
jaimico00793: posts the ante 150
gwallgofddyn: posts the ante 150
Johevera: posts small blind 600
sQuezzeYoU!!: posts big blind 1200
*** HOLE CARDS ***
jaimico00793: folds 
gwallgofddyn: folds 
hiran bass: folds 
Famazaja: folds 
atg590: folds 
PhoenixGrind: raises 1800 to 3000
Johevera: folds 
sQuezzeYoU!!: folds 
Uncalled bet (1800) returned to PhoenixGrind
PhoenixGrind collected 4200 from pot
PhoenixGrind: doesn't show hand 
*** SUMMARY ***
Total pot 4200 | Rake 0 
Seat 1: hiran bass folded before Flop (didn't bet)
Seat 2: Famazaja folded before Flop (didn't bet)
Seat 3: atg590 folded before Flop (didn't bet)
Seat 4: PhoenixGrind (button) collected (4200)
Seat 5: Johevera (small blind) folded before Flop
Seat 6: sQuezzeYoU!! (big blind) folded before Flop
Seat 7: jaimico00793 folded before Flop (didn't bet)
Seat 8: gwallgofddyn folded before Flop (didn't bet)

PokerStars Hand #251205637604: Tournament #3767885527, $40+$10+$5 USD Hold'em No Limit - Level XI (600/1200) - 2024/06/26 19:09:05 UTC [2024/06/26 15:09:05 ET]
Table '3767885527 35' 8-max Seat #5 is the button
Seat 1: hiran bass (23181 in chips) 
Seat 2: Famazaja (32060 in chips) 
Seat 3: atg590 (82563 in chips) 
Seat 4: PhoenixGrind (89707 in chips) 
Seat 5: Johevera (46968 in chips) 
Seat 6: sQuezzeYoU!! (42587 in chips) 
Seat 7: jaimico00793 (17686 in chips) 
Seat 8: gwallgofddyn (104807 in chips) 
hiran bass: posts the ante 150
Famazaja: posts the ante 150
atg590: posts the ante 150
PhoenixGrind: posts the ante 150
Johevera: posts the ante 150
sQuezzeYoU!!: posts the ante 150
jaimico00793: posts the ante 150
gwallgofddyn: posts the ante 150
sQuezzeYoU!!: posts small blind 600
jaimico00793: posts big blind 1200
*** HOLE CARDS ***
gwallgofddyn: folds 
hiran bass: folds 
Famazaja: raises 1200 to 2400
atg590: folds 
PhoenixGrind: folds 
Johevera: folds 
sQuezzeYoU!!: calls 1800
jaimico00793: folds 
*** FLOP *** [8c 7c Kh]
sQuezzeYoU!!: checks 
Famazaja: bets 3600
sQuezzeYoU!!: calls 3600
*** TURN *** [8c 7c Kh] [3d]
sQuezzeYoU!!: checks 
Famazaja: checks 
*** RIVER *** [8c 7c Kh 3d] [8h]
sQuezzeYoU!!: bets 8496
Famazaja: folds 
Uncalled bet (8496) returned to sQuezzeYoU!!
sQuezzeYoU!! collected 14400 from pot
sQuezzeYoU!!: doesn't show hand 
*** SUMMARY ***
Total pot 14400 | Rake 0 
Board [8c 7c Kh 3d 8h]
Seat 1: hiran bass folded before Flop (didn't bet)
Seat 2: Famazaja folded on the River
Seat 3: atg590 folded before Flop (didn't bet)
Seat 4: PhoenixGrind folded before Flop (didn't bet)
Seat 5: Johevera (button) folded before Flop (didn't bet)
Seat 6: sQuezzeYoU!! (small blind) collected (14400)
Seat 7: jaimico00793 (big blind) folded before Flop
Seat 8: gwallgofddyn folded before Flop (didn't bet)

PokerStars Hand #251205652966: Tournament #3767885527, $40+$10+$5 USD Hold'em No Limit - Level XII (700/1400) - 2024/06/26 19:10:02 UTC [2024/06/26 15:10:02 ET]
Table '3767885527 35' 8-max Seat #6 is the button
Seat 1: hiran bass (23031 in chips) 
Seat 2: Famazaja (25910 in chips) 
Seat 3: atg590 (82413 in chips) 
Seat 4: PhoenixGrind (89557 in chips) 
Seat 5: Johevera (46818 in chips) 
Seat 6: sQuezzeYoU!! (50837 in chips) 
Seat 7: jaimico00793 (16336 in chips) 
Seat 8: gwallgofddyn (104657 in chips) 
hiran bass: posts the ante 175
Famazaja: posts the ante 175
atg590: posts the ante 175
PhoenixGrind: posts the ante 175
Johevera: posts the ante 175
sQuezzeYoU!!: posts the ante 175
jaimico00793: posts the ante 175
gwallgofddyn: posts the ante 175
jaimico00793: posts small blind 700
gwallgofddyn: posts big blind 1400
*** HOLE CARDS ***
hiran bass: folds 
Famazaja: folds 
atg590: folds 
PhoenixGrind has timed out
PhoenixGrind: folds 
PhoenixGrind is sitting out
Johevera: raises 1540 to 2940
sQuezzeYoU!!: folds 
PhoenixGrind has returned
jaimico00793: folds 
gwallgofddyn: calls 1540
*** FLOP *** [Qd Kc Ts]
gwallgofddyn: checks 
Johevera: bets 5985
gwallgofddyn: calls 5985
*** TURN *** [Qd Kc Ts] [Qh]
gwallgofddyn: checks 
Johevera: checks 
*** RIVER *** [Qd Kc Ts Qh] [2s]
gwallgofddyn: bets 16100
Johevera: folds 
Uncalled bet (16100) returned to gwallgofddyn
gwallgofddyn collected 19950 from pot
gwallgofddyn: doesn't show hand 
*** SUMMARY ***
Total pot 19950 | Rake 0 
Board [Qd Kc Ts Qh 2s]
Seat 1: hiran bass folded before Flop (didn't bet)
Seat 2: Famazaja folded before Flop (didn't bet)
Seat 3: atg590 folded before Flop (didn't bet)
Seat 4: PhoenixGrind folded before Flop (didn't bet)
Seat 5: Johevera folded on the River
Seat 6: sQuezzeYoU!! (button) folded before Flop (didn't bet)
Seat 7: jaimico00793 (small blind) folded before Flop
Seat 8: gwallgofddyn (big blind) collected (19950)

PokerStars Hand #251205674037: Tournament #3767885527, $40+$10+$5 USD Hold'em No Limit - Level XII (700/1400) - 2024/06/26 19:11:21 UTC [2024/06/26 15:11:21 ET]
Table '3767885527 35' 8-max Seat #7 is the button
Seat 1: hiran bass (22856 in chips) 
Seat 2: Famazaja (25735 in chips) 
Seat 3: atg590 (82238 in chips) 
Seat 4: PhoenixGrind (89382 in chips) 
Seat 5: Johevera (37718 in chips) 
Seat 6: sQuezzeYoU!! (50662 in chips) 
Seat 7: jaimico00793 (15461 in chips) 
Seat 8: gwallgofddyn (115507 in chips) 
hiran bass: posts the ante 175
Famazaja: posts the ante 175
atg590: posts the ante 175
PhoenixGrind: posts the ante 175
Johevera: posts the ante 175
sQuezzeYoU!!: posts the ante 175
jaimico00793: posts the ante 175
gwallgofddyn: posts the ante 175
gwallgofddyn: posts small blind 700
hiran bass: posts big blind 1400
*** HOLE CARDS ***
Famazaja: raises 1400 to 2800
atg590: folds 
PhoenixGrind: folds 
Johevera: folds 
sQuezzeYoU!!: raises 5600 to 8400
jaimico00793: folds 
gwallgofddyn: folds 
hiran bass: folds 
Famazaja: folds 
Uncalled bet (5600) returned to sQuezzeYoU!!
sQuezzeYoU!! collected 9100 from pot
sQuezzeYoU!!: doesn't show hand 
*** SUMMARY ***
Total pot 9100 | Rake 0 
Seat 1: hiran bass (big blind) folded before Flop
Seat 2: Famazaja folded before Flop
Seat 3: atg590 folded before Flop (didn't bet)
Seat 4: PhoenixGrind folded before Flop (didn't bet)
Seat 5: Johevera folded before Flop (didn't bet)
Seat 6: sQuezzeYoU!! collected (9100)
Seat 7: jaimico00793 (button) folded before Flop (didn't bet)
Seat 8: gwallgofddyn (small blind) folded before Flop

PokerStars Hand #251205684914: Tournament #3767885527, $40+$10+$5 USD Hold'em No Limit - Level XII (700/1400) - 2024/06/26 19:12:01 UTC [2024/06/26 15:12:01 ET]
Table '3767885527 35' 8-max Seat #8 is the button
Seat 1: hiran bass (21281 in chips) 
Seat 2: Famazaja (22760 in chips) 
Seat 3: atg590 (82063 in chips) 
Seat 4: PhoenixGrind (89207 in chips) 
Seat 5: Johevera (37543 in chips) 
Seat 6: sQuezzeYoU!! (56787 in chips) 
Seat 7: jaimico00793 (15286 in chips) 
Seat 8: gwallgofddyn (114632 in chips) 
hiran bass: posts the ante 175
Famazaja: posts the ante 175
atg590: posts the ante 175
PhoenixGrind: posts the ante 175
Johevera: posts the ante 175
sQuezzeYoU!!: posts the ante 175
jaimico00793: posts the ante 175
gwallgofddyn: posts the ante 175
hiran bass: posts small blind 700
Famazaja: posts big blind 1400
*** HOLE CARDS ***
atg590: folds 
PhoenixGrind: folds 
Johevera: folds 
sQuezzeYoU!!: folds 
jaimico00793: folds 
gwallgofddyn: folds 
hiran bass: raises 19706 to 21106 and is all-in
Famazaja: folds 
Uncalled bet (19706) returned to hiran bass
hiran bass collected 4200 from pot
hiran bass: doesn't show hand 
*** SUMMARY ***
Total pot 4200 | Rake 0 
Seat 1: hiran bass (small blind) collected (4200)
Seat 2: Famazaja (big blind) folded before Flop
Seat 3: atg590 folded before Flop (didn't bet)
Seat 4: PhoenixGrind folded before Flop (didn't bet)
Seat 5: Johevera folded before Flop (didn't bet)
Seat 6: sQuezzeYoU!! folded before Flop (didn't bet)
Seat 7: jaimico00793 folded before Flop (didn't bet)
Seat 8: gwallgofddyn (button) folded before Flop (didn't bet)

PokerStars Hand #251205690421: Tournament #3767885527, $40+$10+$5 USD Hold'em No Limit - Level XII (700/1400) - 2024/06/26 19:12:21 UTC [2024/06/26 15:12:21 ET]
Table '3767885527 35' 8-max Seat #1 is the button
Seat 1: hiran bass (23906 in chips) 
Seat 2: Famazaja (21185 in chips) 
Seat 3: atg590 (81888 in chips) 
Seat 4: PhoenixGrind (89032 in chips) 
Seat 5: Johevera (37368 in chips) 
Seat 6: sQuezzeYoU!! (56612 in chips) 
Seat 7: jaimico00793 (15111 in chips) 
Seat 8: gwallgofddyn (114457 in chips) 
hiran bass: posts the ante 175
Famazaja: posts the ante 175
atg590: posts the ante 175
PhoenixGrind: posts the ante 175
Johevera: posts the ante 175
sQuezzeYoU!!: posts the ante 175
jaimico00793: posts the ante 175
gwallgofddyn: posts the ante 175
Famazaja: posts small blind 700
atg590: posts big blind 1400
*** HOLE CARDS ***
PhoenixGrind: folds 
Johevera: folds 
sQuezzeYoU!!: folds 
jaimico00793: folds 
gwallgofddyn: raises 1820 to 3220
hiran bass: folds 
Famazaja: folds 
atg590: folds 
Uncalled bet (1820) returned to gwallgofddyn
gwallgofddyn collected 4900 from pot
gwallgofddyn: doesn't show hand 
*** SUMMARY ***
Total pot 4900 | Rake 0 
Seat 1: hiran bass (button) folded before Flop (didn't bet)
Seat 2: Famazaja (small blind) folded before Flop
Seat 3: atg590 (big blind) folded before Flop
Seat 4: PhoenixGrind folded before Flop (didn't bet)
Seat 5: Johevera folded before Flop (didn't bet)
Seat 6: sQuezzeYoU!! folded before Flop (didn't bet)
Seat 7: jaimico00793 folded before Flop (didn't bet)
Seat 8: gwallgofddyn collected (4900)

PokerStars Hand #251205696633: Tournament #3767885527, $40+$10+$5 USD Hold'em No Limit - Level XII (700/1400) - 2024/06/26 19:12:44 UTC [2024/06/26 15:12:44 ET]
Table '3767885527 35' 8-max Seat #2 is the button
Seat 1: hiran bass (23731 in chips) 
Seat 2: Famazaja (20310 in chips) 
Seat 3: atg590 (80313 in chips) 
Seat 4: PhoenixGrind (88857 in chips) 
Seat 5: Johevera (37193 in chips) 
Seat 6: sQuezzeYoU!! (56437 in chips) 
Seat 7: jaimico00793 (14936 in chips) 
Seat 8: gwallgofddyn (117782 in chips) 
hiran bass: posts the ante 175
Famazaja: posts the ante 175
atg590: posts the ante 175
PhoenixGrind: posts the ante 175
Johevera: posts the ante 175
sQuezzeYoU!!: posts the ante 175
jaimico00793: posts the ante 175
gwallgofddyn: posts the ante 175
atg590: posts small blind 700
PhoenixGrind: posts big blind 1400
*** HOLE CARDS ***
Johevera: folds 
sQuezzeYoU!!: folds 
jaimico00793: folds 
gwallgofddyn: raises 1820 to 3220
hiran bass: folds 
Famazaja: calls 3220
atg590: folds 
PhoenixGrind: folds 
*** FLOP *** [Kh 6d 3d]
gwallgofddyn: bets 2800
Famazaja: raises 14115 to 16915 and is all-in
gwallgofddyn: calls 14115
*** TURN *** [Kh 6d 3d] [6s]
*** RIVER *** [Kh 6d 3d 6s] [Ac]
*** SHOW DOWN ***
gwallgofddyn: shows [Kc 8c] (two pair, Kings and Sixes)
Famazaja: shows [8d 9d] (a pair of Sixes)
gwallgofddyn collected 43770 from pot
Famazaja finished the tournament
*** SUMMARY ***
Total pot 43770 | Rake 0 
Board [Kh 6d 3d 6s Ac]
Seat 1: hiran bass folded before Flop (didn't bet)
Seat 2: Famazaja (button) showed [8d 9d] and lost with a pair of Sixes
Seat 3: atg590 (small blind) folded before Flop
Seat 4: PhoenixGrind (big blind) folded before Flop
Seat 5: Johevera folded before Flop (didn't bet)
Seat 6: sQuezzeYoU!! folded before Flop (didn't bet)
Seat 7: jaimico00793 folded before Flop (didn't bet)
Seat 8: gwallgofddyn showed [Kc 8c] and won (43770) with two pair, Kings and Sixes

PokerStars Hand #251205716395: Tournament #3767885527, $40+$10+$5 USD Hold'em No Limit - Level XII (700/1400) - 2024/06/26 19:13:57 UTC [2024/06/26 15:13:57 ET]
Table '3767885527 35' 8-max Seat #3 is the button
Seat 1: hiran bass (23556 in chips) 
Seat 3: atg590 (79438 in chips) 
Seat 4: PhoenixGrind (87282 in chips) 
Seat 5: Johevera (37018 in chips) 
Seat 6: sQuezzeYoU!! (56262 in chips) 
Seat 7: jaimico00793 (14761 in chips) 
Seat 8: gwallgofddyn (141242 in chips) 
hiran bass: posts the ante 175
atg590: posts the ante 175
PhoenixGrind: posts the ante 175
Johevera: posts the ante 175
sQuezzeYoU!!: posts the ante 175
jaimico00793: posts the ante 175
gwallgofddyn: posts the ante 175
PhoenixGrind: posts small blind 700
Johevera: posts big blind 1400
*** HOLE CARDS ***
sQuezzeYoU!!: folds 
jaimico00793: raises 13186 to 14586 and is all-in
gwallgofddyn: folds 
hiran bass: folds 
atg590: folds 
PhoenixGrind: folds 
StoraEss is disconnected 
Johevera: folds 
Uncalled bet (13186) returned to jaimico00793
jaimico00793 collected 4725 from pot
jaimico00793: doesn't show hand 
*** SUMMARY ***
Total pot 4725 | Rake 0 
Seat 1: hiran bass folded before Flop (didn't bet)
Seat 3: atg590 (button) folded before Flop (didn't bet)
Seat 4: PhoenixGrind (small blind) folded before Flop
Seat 5: Johevera (big blind) folded before Flop
Seat 6: sQuezzeYoU!! folded before Flop (didn't bet)
Seat 7: jaimico00793 collected (4725)
Seat 8: gwallgofddyn folded before Flop (didn't bet)

PokerStars Hand #251205723452: Tournament #3767885527, $40+$10+$5 USD Hold'em No Limit - Level XII (700/1400) - 2024/06/26 19:14:23 UTC [2024/06/26 15:14:23 ET]
Table '3767885527 35' 8-max Seat #4 is the button
Seat 1: hiran bass (23381 in chips) 
Seat 2: StoraEss (25000 in chips) 
Seat 3: atg590 (79263 in chips) 
Seat 4: PhoenixGrind (86407 in chips) 
Seat 5: Johevera (35443 in chips) 
Seat 6: sQuezzeYoU!! (56087 in chips) 
Seat 7: jaimico00793 (17911 in chips) 
Seat 8: gwallgofddyn (141067 in chips) 
hiran bass: posts the ante 175
StoraEss: posts the ante 175
atg590: posts the ante 175
PhoenixGrind: posts the ante 175
Johevera: posts the ante 175
sQuezzeYoU!!: posts the ante 175
jaimico00793: posts the ante 175
gwallgofddyn: posts the ante 175
Johevera: posts small blind 700
sQuezzeYoU!!: posts big blind 1400
*** HOLE CARDS ***
jaimico00793: folds 
gwallgofddyn: raises 1820 to 3220
hiran bass: folds 
StoraEss: folds 
atg590: calls 3220
PhoenixGrind: folds 
Johevera: folds 
sQuezzeYoU!!: folds 
*** FLOP *** [3d Qh Qc]
gwallgofddyn: checks 
atg590: checks 
*** TURN *** [3d Qh Qc] [Qd]
gwallgofddyn: checks 
atg590: bets 4200
gwallgofddyn: calls 4200
*** RIVER *** [3d Qh Qc Qd] [6d]
gwallgofddyn: checks 
atg590: bets 9170
gwallgofddyn: folds 
Uncalled bet (9170) returned to atg590
atg590 collected 18340 from pot
*** SUMMARY ***
Total pot 18340 | Rake 0 
Board [3d Qh Qc Qd 6d]
Seat 1: hiran bass folded before Flop (didn't bet)
Seat 2: StoraEss folded before Flop (didn't bet)
Seat 3: atg590 collected (18340)
Seat 4: PhoenixGrind (button) folded before Flop (didn't bet)
Seat 5: Johevera (small blind) folded before Flop
Seat 6: sQuezzeYoU!! (big blind) folded before Flop
Seat 7: jaimico00793 folded before Flop (didn't bet)
Seat 8: gwallgofddyn folded on the River

PokerStars Hand #251205738663: Tournament #3767885527, $40+$10+$5 USD Hold'em No Limit - Level XII (700/1400) - 2024/06/26 19:15:19 UTC [2024/06/26 15:15:19 ET]
Table '3767885527 35' 8-max Seat #5 is the button
Seat 1: hiran bass (23206 in chips) 
Seat 2: StoraEss (24825 in chips) 
Seat 3: atg590 (90008 in chips) 
Seat 4: PhoenixGrind (86232 in chips) 
Seat 5: Johevera (34568 in chips) 
Seat 6: sQuezzeYoU!! (54512 in chips) 
Seat 7: jaimico00793 (17736 in chips) 
Seat 8: gwallgofddyn (133472 in chips) 
hiran bass: posts the ante 175
StoraEss: posts the ante 175
atg590: posts the ante 175
PhoenixGrind: posts the ante 175
Johevera: posts the ante 175
sQuezzeYoU!!: posts the ante 175
jaimico00793: posts the ante 175
gwallgofddyn: posts the ante 175
sQuezzeYoU!!: posts small blind 700
jaimico00793: posts big blind 1400
*** HOLE CARDS ***
gwallgofddyn: folds 
hiran bass: folds 
StoraEss: folds 
atg590: folds 
PhoenixGrind: raises 2100 to 3500
Johevera: folds 
sQuezzeYoU!!: folds 
jaimico00793: folds 
Uncalled bet (2100) returned to PhoenixGrind
PhoenixGrind collected 4900 from pot
PhoenixGrind: doesn't show hand 
*** SUMMARY ***
Total pot 4900 | Rake 0 
Seat 1: hiran bass folded before Flop (didn't bet)
Seat 2: StoraEss folded before Flop (didn't bet)
Seat 3: atg590 folded before Flop (didn't bet)
Seat 4: PhoenixGrind collected (4900)
Seat 5: Johevera (button) folded before Flop (didn't bet)
Seat 6: sQuezzeYoU!! (small blind) folded before Flop
Seat 7: jaimico00793 (big blind) folded before Flop
Seat 8: gwallgofddyn folded before Flop (didn't bet)

PokerStars Hand #251205745892: Tournament #3767885527, $40+$10+$5 USD Hold'em No Limit - Level XII (700/1400) - 2024/06/26 19:15:46 UTC [2024/06/26 15:15:46 ET]
Table '3767885527 35' 8-max Seat #6 is the button
Seat 1: hiran bass (23031 in chips) 
Seat 2: StoraEss (24650 in chips) 
Seat 3: atg590 (89833 in chips) 
Seat 4: PhoenixGrind (89557 in chips) 
Seat 5: Johevera (34393 in chips) 
Seat 6: sQuezzeYoU!! (53637 in chips) 
Seat 7: jaimico00793 (16161 in chips) 
Seat 8: gwallgofddyn (133297 in chips) 
hiran bass: posts the ante 175
StoraEss: posts the ante 175
atg590: posts the ante 175
PhoenixGrind: posts the ante 175
Johevera: posts the ante 175
sQuezzeYoU!!: posts the ante 175
jaimico00793: posts the ante 175
gwallgofddyn: posts the ante 175
jaimico00793: posts small blind 700
gwallgofddyn: posts big blind 1400
*** HOLE CARDS ***
hiran bass: raises 1400 to 2800
StoraEss: folds 
atg590: folds 
PhoenixGrind: folds 
Johevera: folds 
sQuezzeYoU!!: folds 
jaimico00793: folds 
gwallgofddyn: calls 1400
*** FLOP *** [6s 6h 3s]
gwallgofddyn: checks 
hiran bass: bets 2541
gwallgofddyn: raises 5159 to 7700
hiran bass: folds 
Uncalled bet (5159) returned to gwallgofddyn
gwallgofddyn collected 12782 from pot
gwallgofddyn: doesn't show hand 
*** SUMMARY ***
Total pot 12782 | Rake 0 
Board [6s 6h 3s]
Seat 1: hiran bass folded on the Flop
Seat 2: StoraEss folded before Flop (didn't bet)
Seat 3: atg590 folded before Flop (didn't bet)
Seat 4: PhoenixGrind folded before Flop (didn't bet)
Seat 5: Johevera folded before Flop (didn't bet)
Seat 6: sQuezzeYoU!! (button) folded before Flop (didn't bet)
Seat 7: jaimico00793 (small blind) folded before Flop
Seat 8: gwallgofddyn (big blind) collected (12782)

PokerStars Hand #251205759420: Tournament #3767885527, $40+$10+$5 USD Hold'em No Limit - Level XII (700/1400) - 2024/06/26 19:16:35 UTC [2024/06/26 15:16:35 ET]
Table '3767885527 35' 8-max Seat #7 is the button
Seat 1: hiran bass (17515 in chips) 
Seat 2: StoraEss (24475 in chips) 
Seat 3: atg590 (89658 in chips) 
Seat 4: PhoenixGrind (89382 in chips) 
Seat 5: Johevera (34218 in chips) 
Seat 6: sQuezzeYoU!! (53462 in chips) 
Seat 7: jaimico00793 (15286 in chips) 
Seat 8: gwallgofddyn (140563 in chips) 
hiran bass: posts the ante 175
StoraEss: posts the ante 175
atg590: posts the ante 175
PhoenixGrind: posts the ante 175
Johevera: posts the ante 175
sQuezzeYoU!!: posts the ante 175
jaimico00793: posts the ante 175
gwallgofddyn: posts the ante 175
gwallgofddyn: posts small blind 700
hiran bass: posts big blind 1400
*** HOLE CARDS ***
StoraEss: folds 
atg590: folds 
PhoenixGrind: folds 
Johevera: folds 
sQuezzeYoU!!: folds 
jaimico00793: folds 
gwallgofddyn: raises 138988 to 140388 and is all-in
hiran bass: folds 
Uncalled bet (138988) returned to gwallgofddyn
gwallgofddyn collected 4200 from pot
gwallgofddyn: doesn't show hand 
*** SUMMARY ***
Total pot 4200 | Rake 0 
Seat 1: hiran bass (big blind) folded before Flop
Seat 2: StoraEss folded before Flop (didn't bet)
Seat 3: atg590 folded before Flop (didn't bet)
Seat 4: PhoenixGrind folded before Flop (didn't bet)
Seat 5: Johevera folded before Flop (didn't bet)
Seat 6: sQuezzeYoU!! folded before Flop (didn't bet)
Seat 7: jaimico00793 (button) folded before Flop (didn't bet)
Seat 8: gwallgofddyn (small blind) collected (4200)

PokerStars Hand #251205770206: Tournament #3767885527, $40+$10+$5 USD Hold'em No Limit - Level XII (700/1400) - 2024/06/26 19:17:15 UTC [2024/06/26 15:17:15 ET]
Table '3767885527 35' 8-max Seat #8 is the button
Seat 1: hiran bass (15940 in chips) 
Seat 2: StoraEss (24300 in chips) 
Seat 3: atg590 (89483 in chips) 
Seat 4: PhoenixGrind (89207 in chips) 
Seat 5: Johevera (34043 in chips) 
Seat 6: sQuezzeYoU!! (53287 in chips) 
Seat 7: jaimico00793 (15111 in chips) 
Seat 8: gwallgofddyn (143188 in chips) 
hiran bass: posts the ante 175
StoraEss: posts the ante 175
atg590: posts the ante 175
PhoenixGrind: posts the ante 175
Johevera: posts the ante 175
sQuezzeYoU!!: posts the ante 175
jaimico00793: posts the ante 175
gwallgofddyn: posts the ante 175
hiran bass: posts small blind 700
StoraEss: posts big blind 1400
*** HOLE CARDS ***
atg590: folds 
PhoenixGrind: folds 
Johevera: folds 
sQuezzeYoU!!: folds 
jaimico00793: raises 13536 to 14936 and is all-in
gwallgofddyn: folds 
hiran bass: folds 
StoraEss: folds 
Uncalled bet (13536) returned to jaimico00793
jaimico00793 collected 4900 from pot
jaimico00793: doesn't show hand 
*** SUMMARY ***
Total pot 4900 | Rake 0 
Seat 1: hiran bass (small blind) folded before Flop
Seat 2: StoraEss (big blind) folded before Flop
Seat 3: atg590 folded before Flop (didn't bet)
Seat 4: PhoenixGrind folded before Flop (didn't bet)
Seat 5: Johevera folded before Flop (didn't bet)
Seat 6: sQuezzeYoU!! folded before Flop (didn't bet)
Seat 7: jaimico00793 collected (4900)
Seat 8: gwallgofddyn (button) folded before Flop (didn't bet)

PokerStars Hand #251205775902: Tournament #3767885527, $40+$10+$5 USD Hold'em No Limit - Level XII (700/1400) - 2024/06/26 19:17:36 UTC [2024/06/26 15:17:36 ET]
Table '3767885527 35' 8-max Seat #1 is the button
Seat 1: hiran bass (15065 in chips) 
Seat 2: StoraEss (22725 in chips) 
Seat 3: atg590 (89308 in chips) 
Seat 4: PhoenixGrind (89032 in chips) 
Seat 5: Johevera (33868 in chips) 
Seat 6: sQuezzeYoU!! (53112 in chips) 
Seat 7: jaimico00793 (18436 in chips) 
Seat 8: gwallgofddyn (143013 in chips) 
hiran bass: posts the ante 175
StoraEss: posts the ante 175
atg590: posts the ante 175
PhoenixGrind: posts the ante 175
Johevera: posts the ante 175
sQuezzeYoU!!: posts the ante 175
jaimico00793: posts the ante 175
gwallgofddyn: posts the ante 175
StoraEss: posts small blind 700
atg590: posts big blind 1400
*** HOLE CARDS ***
PhoenixGrind: folds 
Johevera: folds 
sQuezzeYoU!!: folds 
jaimico00793: folds 
gwallgofddyn: raises 1820 to 3220
hiran bass: folds 
StoraEss: raises 19330 to 22550 and is all-in
atg590: folds 
gwallgofddyn: folds 
Uncalled bet (19330) returned to StoraEss
StoraEss collected 9240 from pot
StoraEss: doesn't show hand 
*** SUMMARY ***
Total pot 9240 | Rake 0 
Seat 1: hiran bass (button) folded before Flop (didn't bet)
Seat 2: StoraEss (small blind) collected (9240)
Seat 3: atg590 (big blind) folded before Flop
Seat 4: PhoenixGrind folded before Flop (didn't bet)
Seat 5: Johevera folded before Flop (didn't bet)
Seat 6: sQuezzeYoU!! folded before Flop (didn't bet)
Seat 7: jaimico00793 folded before Flop (didn't bet)
Seat 8: gwallgofddyn folded before Flop

PokerStars Hand #251205782081: Tournament #3767885527, $40+$10+$5 USD Hold'em No Limit - Level XII (700/1400) - 2024/06/26 19:17:59 UTC [2024/06/26 15:17:59 ET]
Table '3767885527 35' 8-max Seat #2 is the button
Seat 1: hiran bass (14890 in chips) 
Seat 2: StoraEss (28570 in chips) 
Seat 3: atg590 (87733 in chips) 
Seat 4: PhoenixGrind (88857 in chips) 
Seat 5: Johevera (33693 in chips) 
Seat 6: sQuezzeYoU!! (52937 in chips) 
Seat 7: jaimico00793 (18261 in chips) 
Seat 8: gwallgofddyn (139618 in chips) 
hiran bass: posts the ante 175
StoraEss: posts the ante 175
atg590: posts the ante 175
PhoenixGrind: posts the ante 175
Johevera: posts the ante 175
sQuezzeYoU!!: posts the ante 175
jaimico00793: posts the ante 175
gwallgofddyn: posts the ante 175
atg590: posts small blind 700
PhoenixGrind: posts big blind 1400
*** HOLE CARDS ***
Johevera: raises 1400 to 2800
sQuezzeYoU!!: folds 
jaimico00793: calls 2800
gwallgofddyn: folds 
hiran bass: folds 
StoraEss: folds 
atg590: folds 
PhoenixGrind: calls 1400
*** FLOP *** [6s Ac 5h]
PhoenixGrind: checks 
Johevera: checks 
jaimico00793: checks 
*** TURN *** [6s Ac 5h] [Kd]
PhoenixGrind: checks 
Johevera: bets 4900
jaimico00793: calls 4900
PhoenixGrind: folds 
*** RIVER *** [6s Ac 5h Kd] [7d]
Johevera: bets 25818 and is all-in
jaimico00793: calls 10386 and is all-in
Uncalled bet (15432) returned to Johevera
*** SHOW DOWN ***
Johevera: shows [As Kc] (two pair, Aces and Kings)
jaimico00793: shows [Ad Ah] (three of a kind, Aces)
jaimico00793 collected 41072 from pot
*** SUMMARY ***
Total pot 41072 | Rake 0 
Board [6s Ac 5h Kd 7d]
Seat 1: hiran bass folded before Flop (didn't bet)
Seat 2: StoraEss (button) folded before Flop (didn't bet)
Seat 3: atg590 (small blind) folded before Flop
Seat 4: PhoenixGrind (big blind) folded on the Turn
Seat 5: Johevera showed [As Kc] and lost with two pair, Aces and Kings
Seat 6: sQuezzeYoU!! folded before Flop (didn't bet)
Seat 7: jaimico00793 showed [Ad Ah] and won (41072) with three of a kind, Aces
Seat 8: gwallgofddyn folded before Flop (didn't bet)

PokerStars Hand #251205812123: Tournament #3767885527, $40+$10+$5 USD Hold'em No Limit - Level XIII (800/1600) - 2024/06/26 19:19:48 UTC [2024/06/26 15:19:48 ET]
Table '3767885527 35' 8-max Seat #3 is the button
Seat 1: hiran bass (14715 in chips) 
Seat 2: StoraEss (28395 in chips) 
Seat 3: atg590 (86858 in chips) 
Seat 4: PhoenixGrind (85882 in chips) 
Seat 5: Johevera (15432 in chips) 
Seat 6: sQuezzeYoU!! (52762 in chips) 
Seat 7: jaimico00793 (41072 in chips) 
Seat 8: gwallgofddyn (139443 in chips) 
hiran bass: posts the ante 200
StoraEss: posts the ante 200
atg590: posts the ante 200
PhoenixGrind: posts the ante 200
Johevera: posts the ante 200
sQuezzeYoU!!: posts the ante 200
jaimico00793: posts the ante 200
gwallgofddyn: posts the ante 200
PhoenixGrind: posts small blind 800
Johevera: posts big blind 1600
*** HOLE CARDS ***
sQuezzeYoU!!: raises 1875 to 3475
jaimico00793: folds 
gwallgofddyn: folds 
hiran bass: folds 
StoraEss: folds 
atg590: folds 
PhoenixGrind: folds 
Johevera: calls 1875
*** FLOP *** [Kh Ts 9d]
Johevera: checks 
sQuezzeYoU!!: bets 2805
Johevera: folds 
Uncalled bet (2805) returned to sQuezzeYoU!!
sQuezzeYoU!! collected 9350 from pot
sQuezzeYoU!!: doesn't show hand 
*** SUMMARY ***
Total pot 9350 | Rake 0 
Board [Kh Ts 9d]
Seat 1: hiran bass folded before Flop (didn't bet)
Seat 2: StoraEss folded before Flop (didn't bet)
Seat 3: atg590 (button) folded before Flop (didn't bet)
Seat 4: PhoenixGrind (small blind) folded before Flop
Seat 5: Johevera (big blind) folded on the Flop
Seat 6: sQuezzeYoU!! collected (9350)
Seat 7: jaimico00793 folded before Flop (didn't bet)
Seat 8: gwallgofddyn folded before Flop (didn't bet)

PokerStars Hand #251205822373: Tournament #3767885527, $40+$10+$5 USD Hold'em No Limit - Level XIII (800/1600) - 2024/06/26 19:20:26 UTC [2024/06/26 15:20:26 ET]
Table '3767885527 35' 8-max Seat #4 is the button
Seat 1: hiran bass (14515 in chips) 
Seat 2: StoraEss (28195 in chips) 
Seat 3: atg590 (86658 in chips) 
Seat 4: PhoenixGrind (84882 in chips) 
Seat 5: Johevera (11757 in chips) 
Seat 6: sQuezzeYoU!! (58437 in chips) 
Seat 7: jaimico00793 (40872 in chips) 
Seat 8: gwallgofddyn (139243 in chips) 
hiran bass: posts the ante 200
StoraEss: posts the ante 200
atg590: posts the ante 200
PhoenixGrind: posts the ante 200
Johevera: posts the ante 200
sQuezzeYoU!!: posts the ante 200
jaimico00793: posts the ante 200
gwallgofddyn: posts the ante 200
Johevera: posts small blind 800
sQuezzeYoU!!: posts big blind 1600
*** HOLE CARDS ***
jaimico00793: folds 
gwallgofddyn: raises 2080 to 3680
hiran bass: raises 10635 to 14315 and is all-in
StoraEss: folds 
atg590: folds 
PhoenixGrind: folds 
Johevera: folds 
sQuezzeYoU!!: folds 
gwallgofddyn: calls 10635
*** FLOP *** [Jc 9c 2c]
*** TURN *** [Jc 9c 2c] [4c]
*** RIVER *** [Jc 9c 2c 4c] [3c]
*** SHOW DOWN ***
gwallgofddyn: shows [Qh Js] (a flush, Jack high)
hiran bass: shows [Ts Tc] (a flush, Jack high - Ten higher)
hiran bass collected 32630 from pot
*** SUMMARY ***
Total pot 32630 | Rake 0 
Board [Jc 9c 2c 4c 3c]
Seat 1: hiran bass showed [Ts Tc] and won (32630) with a flush, Jack high
Seat 2: StoraEss folded before Flop (didn't bet)
Seat 3: atg590 folded before Flop (didn't bet)
Seat 4: PhoenixGrind (button) folded before Flop (didn't bet)
Seat 5: Johevera (small blind) folded before Flop
Seat 6: sQuezzeYoU!! (big blind) folded before Flop
Seat 7: jaimico00793 folded before Flop (didn't bet)
Seat 8: gwallgofddyn showed [Qh Js] and lost with a flush, Jack high

PokerStars Hand #251205830432: Tournament #3767885527, $40+$10+$5 USD Hold'em No Limit - Level XIII (800/1600) - 2024/06/26 19:20:56 UTC [2024/06/26 15:20:56 ET]
Table '3767885527 35' 8-max Seat #5 is the button
Seat 1: hiran bass (32630 in chips) 
Seat 2: StoraEss (27995 in chips) 
Seat 3: atg590 (86458 in chips) 
Seat 4: PhoenixGrind (84682 in chips) 
Seat 5: Johevera (10757 in chips) 
Seat 6: sQuezzeYoU!! (56637 in chips) 
Seat 7: jaimico00793 (40672 in chips) 
Seat 8: gwallgofddyn (124728 in chips) 
hiran bass: posts the ante 200
StoraEss: posts the ante 200
atg590: posts the ante 200
PhoenixGrind: posts the ante 200
Johevera: posts the ante 200
sQuezzeYoU!!: posts the ante 200
jaimico00793: posts the ante 200
gwallgofddyn: posts the ante 200
sQuezzeYoU!!: posts small blind 800
jaimico00793: posts big blind 1600
*** HOLE CARDS ***
gwallgofddyn: folds 
hiran bass: folds 
StoraEss: folds 
atg590: folds 
PhoenixGrind: folds 
Johevera: folds 
sQuezzeYoU!!: raises 3712 to 5312
jaimico00793: folds 
Uncalled bet (3712) returned to sQuezzeYoU!!
sQuezzeYoU!! collected 4800 from pot
sQuezzeYoU!!: doesn't show hand 
*** SUMMARY ***
Total pot 4800 | Rake 0 
Seat 1: hiran bass folded before Flop (didn't bet)
Seat 2: StoraEss folded before Flop (didn't bet)
Seat 3: atg590 folded before Flop (didn't bet)
Seat 4: PhoenixGrind folded before Flop (didn't bet)
Seat 5: Johevera (button) folded before Flop (didn't bet)
Seat 6: sQuezzeYoU!! (small blind) collected (4800)
Seat 7: jaimico00793 (big blind) folded before Flop
Seat 8: gwallgofddyn folded before Flop (didn't bet)

PokerStars Hand #251205839279: Tournament #3767885527, $40+$10+$5 USD Hold'em No Limit - Level XIII (800/1600) - 2024/06/26 19:21:29 UTC [2024/06/26 15:21:29 ET]
Table '3767885527 35' 8-max Seat #6 is the button
Seat 1: hiran bass (32430 in chips) 
Seat 2: StoraEss (27795 in chips) 
Seat 3: atg590 (86258 in chips) 
Seat 4: PhoenixGrind (84482 in chips) 
Seat 5: Johevera (10557 in chips) 
Seat 6: sQuezzeYoU!! (59637 in chips) 
Seat 7: jaimico00793 (38872 in chips) 
Seat 8: gwallgofddyn (124528 in chips) 
hiran bass: posts the ante 200
StoraEss: posts the ante 200
atg590: posts the ante 200
PhoenixGrind: posts the ante 200
Johevera: posts the ante 200
sQuezzeYoU!!: posts the ante 200
jaimico00793: posts the ante 200
gwallgofddyn: posts the ante 200
jaimico00793: posts small blind 800
gwallgofddyn: posts big blind 1600
*** HOLE CARDS ***
hiran bass: folds 
StoraEss: raises 1600 to 3200
atg590: folds 
PhoenixGrind: folds 
Johevera: raises 7157 to 10357 and is all-in
sQuezzeYoU!!: folds 
jaimico00793: folds 
gwallgofddyn: folds 
StoraEss: calls 7157
*** FLOP *** [Ts Ad 5d]
*** TURN *** [Ts Ad 5d] [2h]
*** RIVER *** [Ts Ad 5d 2h] [Jd]
*** SHOW DOWN ***
StoraEss: shows [Js Qs] (a pair of Jacks)
Johevera: shows [8d 9c] (high card Ace)
StoraEss collected 24714 from pot
Johevera finished the tournament
*** SUMMARY ***
Total pot 24714 | Rake 0 
Board [Ts Ad 5d 2h Jd]
Seat 1: hiran bass folded before Flop (didn't bet)
Seat 2: StoraEss showed [Js Qs] and won (24714) with a pair of Jacks
Seat 3: atg590 folded before Flop (didn't bet)
Seat 4: PhoenixGrind folded before Flop (didn't bet)
Seat 5: Johevera showed [8d 9c] and lost with high card Ace
Seat 6: sQuezzeYoU!! (button) folded before Flop (didn't bet)
Seat 7: jaimico00793 (small blind) folded before Flop
Seat 8: gwallgofddyn (big blind) folded before Flop

PokerStars Hand #251205851429: Tournament #3767885527, $40+$10+$5 USD Hold'em No Limit - Level XIII (800/1600) - 2024/06/26 19:22:13 UTC [2024/06/26 15:22:13 ET]
Table '3767885527 35' 8-max Seat #7 is the button
Seat 1: hiran bass (32230 in chips) 
Seat 2: StoraEss (41952 in chips) 
Seat 3: atg590 (86058 in chips) 
Seat 4: PhoenixGrind (84282 in chips) 
Seat 6: sQuezzeYoU!! (59437 in chips) 
Seat 7: jaimico00793 (37872 in chips) 
Seat 8: gwallgofddyn (122728 in chips) 
hiran bass: posts the ante 200
StoraEss: posts the ante 200
atg590: posts the ante 200
PhoenixGrind: posts the ante 200
sQuezzeYoU!!: posts the ante 200
jaimico00793: posts the ante 200
gwallgofddyn: posts the ante 200
gwallgofddyn: posts small blind 800
hiran bass: posts big blind 1600
*** HOLE CARDS ***
StoraEss: raises 1600 to 3200
atg590: folds 
PhoenixGrind: folds 
sQuezzeYoU!!: folds 
jaimico00793: folds 
gwallgofddyn: folds 
hiran bass: calls 1600
*** FLOP *** [7d 5h 9d]
hiran bass: checks 
StoraEss: bets 4800
hiran bass: folds 
Uncalled bet (4800) returned to StoraEss
StoraEss collected 8600 from pot
StoraEss: doesn't show hand 
*** SUMMARY ***
Total pot 8600 | Rake 0 
Board [7d 5h 9d]
Seat 1: hiran bass (big blind) folded on the Flop
Seat 2: StoraEss collected (8600)
Seat 3: atg590 folded before Flop (didn't bet)
Seat 4: PhoenixGrind folded before Flop (didn't bet)
Seat 6: sQuezzeYoU!! folded before Flop (didn't bet)
Seat 7: jaimico00793 (button) folded before Flop (didn't bet)
Seat 8: gwallgofddyn (small blind) folded before Flop

PokerStars Hand #251205865562: Tournament #3767885527, $40+$10+$5 USD Hold'em No Limit - Level XIII (800/1600) - 2024/06/26 19:23:04 UTC [2024/06/26 15:23:04 ET]
Table '3767885527 35' 8-max Seat #8 is the button
Seat 1: hiran bass (28830 in chips) 
Seat 2: StoraEss (47152 in chips) 
Seat 3: atg590 (85858 in chips) 
Seat 4: PhoenixGrind (84082 in chips) 
Seat 6: sQuezzeYoU!! (59237 in chips) 
Seat 7: jaimico00793 (37672 in chips) 
Seat 8: gwallgofddyn (121728 in chips) 
hiran bass: posts the ante 200
StoraEss: posts the ante 200
atg590: posts the ante 200
PhoenixGrind: posts the ante 200
sQuezzeYoU!!: posts the ante 200
jaimico00793: posts the ante 200
gwallgofddyn: posts the ante 200
hiran bass: posts small blind 800
StoraEss: posts big blind 1600
*** HOLE CARDS ***
atg590: folds 
PhoenixGrind: folds 
sQuezzeYoU!!: folds 
jaimico00793: raises 1920 to 3520
gwallgofddyn: folds 
hiran bass: folds 
StoraEss: calls 1920
*** FLOP *** [Ac 7c 5s]
StoraEss: checks 
jaimico00793: bets 2310
StoraEss: folds 
Uncalled bet (2310) returned to jaimico00793
jaimico00793 collected 9240 from pot
jaimico00793: doesn't show hand 
*** SUMMARY ***
Total pot 9240 | Rake 0 
Board [Ac 7c 5s]
Seat 1: hiran bass (small blind) folded before Flop
Seat 2: StoraEss (big blind) folded on the Flop
Seat 3: atg590 folded before Flop (didn't bet)
Seat 4: PhoenixGrind folded before Flop (didn't bet)
Seat 6: sQuezzeYoU!! folded before Flop (didn't bet)
Seat 7: jaimico00793 collected (9240)
Seat 8: gwallgofddyn (button) folded before Flop (didn't bet)

PokerStars Hand #251205874205: Tournament #3767885527, $40+$10+$5 USD Hold'em No Limit - Level XIII (800/1600) - 2024/06/26 19:23:36 UTC [2024/06/26 15:23:36 ET]
Table '3767885527 35' 8-max Seat #1 is the button
Seat 1: hiran bass (27830 in chips) 
Seat 2: StoraEss (43432 in chips) 
Seat 3: atg590 (85658 in chips) 
Seat 4: PhoenixGrind (83882 in chips) 
Seat 5: Khanuman Men (40468 in chips) 
Seat 6: sQuezzeYoU!! (59037 in chips) 
Seat 7: jaimico00793 (43192 in chips) 
Seat 8: gwallgofddyn (121528 in chips) 
hiran bass: posts the ante 200
StoraEss: posts the ante 200
atg590: posts the ante 200
PhoenixGrind: posts the ante 200
Khanuman Men: posts the ante 200
sQuezzeYoU!!: posts the ante 200
jaimico00793: posts the ante 200
gwallgofddyn: posts the ante 200
StoraEss: posts small blind 800
atg590: posts big blind 1600
*** HOLE CARDS ***
PhoenixGrind: folds 
Khanuman Men: folds 
sQuezzeYoU!!: folds 
jaimico00793: raises 1600 to 3200
gwallgofddyn: folds 
hiran bass: folds 
StoraEss: folds 
atg590: raises 4800 to 8000
jaimico00793: folds 
Uncalled bet (4800) returned to atg590
atg590 collected 8800 from pot
*** SUMMARY ***
Total pot 8800 | Rake 0 
Seat 1: hiran bass (button) folded before Flop (didn't bet)
Seat 2: StoraEss (small blind) folded before Flop
Seat 3: atg590 (big blind) collected (8800)
Seat 4: PhoenixGrind folded before Flop (didn't bet)
Seat 5: Khanuman Men folded before Flop (didn't bet)
Seat 6: sQuezzeYoU!! folded before Flop (didn't bet)
Seat 7: jaimico00793 folded before Flop
Seat 8: gwallgofddyn folded before Flop (didn't bet)

PokerStars Hand #251205882429: Tournament #3767885527, $40+$10+$5 USD Hold'em No Limit - Level XIII (800/1600) - 2024/06/26 19:24:06 UTC [2024/06/26 15:24:06 ET]
Table '3767885527 35' 8-max Seat #2 is the button
Seat 1: hiran bass (27630 in chips) 
Seat 2: StoraEss (42432 in chips) 
Seat 3: atg590 (91058 in chips) 
Seat 4: PhoenixGrind (83682 in chips) 
Seat 5: Khanuman Men (40268 in chips) 
Seat 6: sQuezzeYoU!! (58837 in chips) 
Seat 7: jaimico00793 (39792 in chips) 
Seat 8: gwallgofddyn (121328 in chips) 
hiran bass: posts the ante 200
StoraEss: posts the ante 200
atg590: posts the ante 200
PhoenixGrind: posts the ante 200
Khanuman Men: posts the ante 200
sQuezzeYoU!!: posts the ante 200
jaimico00793: posts the ante 200
gwallgofddyn: posts the ante 200
atg590: posts small blind 800
PhoenixGrind: posts big blind 1600
*** HOLE CARDS ***
Khanuman Men: folds 
sQuezzeYoU!!: folds 
jaimico00793: folds 
gwallgofddyn: raises 2080 to 3680
hiran bass: folds 
StoraEss: folds 
atg590: raises 5280 to 8960
PhoenixGrind: folds 
gwallgofddyn: folds 
Uncalled bet (5280) returned to atg590
atg590 collected 10560 from pot
*** SUMMARY ***
Total pot 10560 | Rake 0 
Seat 1: hiran bass folded before Flop (didn't bet)
Seat 2: StoraEss (button) folded before Flop (didn't bet)
Seat 3: atg590 (small blind) collected (10560)
Seat 4: PhoenixGrind (big blind) folded before Flop
Seat 5: Khanuman Men folded before Flop (didn't bet)
Seat 6: sQuezzeYoU!! folded before Flop (didn't bet)
Seat 7: jaimico00793 folded before Flop (didn't bet)
Seat 8: gwallgofddyn folded before Flop

PokerStars Hand #251205889792: Tournament #3767885527, $40+$10+$5 USD Hold'em No Limit - Level XIII (800/1600) - 2024/06/26 19:24:33 UTC [2024/06/26 15:24:33 ET]
Table '3767885527 35' 8-max Seat #3 is the button
Seat 1: hiran bass (27430 in chips) 
Seat 2: StoraEss (42232 in chips) 
Seat 3: atg590 (97738 in chips) 
Seat 4: PhoenixGrind (81882 in chips) 
Seat 5: Khanuman Men (40068 in chips) 
Seat 6: sQuezzeYoU!! (58637 in chips) 
Seat 7: jaimico00793 (39592 in chips) 
Seat 8: gwallgofddyn (117448 in chips) 
hiran bass: posts the ante 200
StoraEss: posts the ante 200
atg590: posts the ante 200
PhoenixGrind: posts the ante 200
Khanuman Men: posts the ante 200
sQuezzeYoU!!: posts the ante 200
jaimico00793: posts the ante 200
gwallgofddyn: posts the ante 200
PhoenixGrind: posts small blind 800
Khanuman Men: posts big blind 1600
*** HOLE CARDS ***
sQuezzeYoU!!: folds 
jaimico00793: folds 
gwallgofddyn: folds 
hiran bass: folds 
StoraEss: folds 
atg590: folds 
PhoenixGrind: calls 800
Khanuman Men: raises 4800 to 6400
PhoenixGrind: calls 4800
*** FLOP *** [3s Ad Ah]
PhoenixGrind: checks 
Khanuman Men: checks 
*** TURN *** [3s Ad Ah] [8c]
PhoenixGrind: checks 
Khanuman Men: bets 4800
PhoenixGrind: calls 4800
*** RIVER *** [3s Ad Ah 8c] [5s]
PhoenixGrind: checks 
Khanuman Men: checks 
*** SHOW DOWN ***
PhoenixGrind: shows [3c Tc] (two pair, Aces and Threes)
Khanuman Men: mucks hand 
PhoenixGrind collected 24000 from pot
*** SUMMARY ***
Total pot 24000 | Rake 0 
Board [3s Ad Ah 8c 5s]
Seat 1: hiran bass folded before Flop (didn't bet)
Seat 2: StoraEss folded before Flop (didn't bet)
Seat 3: atg590 (button) folded before Flop (didn't bet)
Seat 4: PhoenixGrind (small blind) showed [3c Tc] and won (24000) with two pair, Aces and Threes
Seat 5: Khanuman Men (big blind) mucked
Seat 6: sQuezzeYoU!! folded before Flop (didn't bet)
Seat 7: jaimico00793 folded before Flop (didn't bet)
Seat 8: gwallgofddyn folded before Flop (didn't bet)

PokerStars Hand #251205909564: Tournament #3767885527, $40+$10+$5 USD Hold'em No Limit - Level XIII (800/1600) - 2024/06/26 19:25:44 UTC [2024/06/26 15:25:44 ET]
Table '3767885527 35' 8-max Seat #4 is the button
Seat 1: hiran bass (27230 in chips) 
Seat 2: StoraEss (42032 in chips) 
Seat 3: atg590 (97538 in chips) 
Seat 4: PhoenixGrind (94482 in chips) 
Seat 5: Khanuman Men (28668 in chips) 
Seat 6: sQuezzeYoU!! (58437 in chips) 
Seat 7: jaimico00793 (39392 in chips) 
Seat 8: gwallgofddyn (117248 in chips) 
hiran bass: posts the ante 200
StoraEss: posts the ante 200
atg590: posts the ante 200
PhoenixGrind: posts the ante 200
Khanuman Men: posts the ante 200
sQuezzeYoU!!: posts the ante 200
jaimico00793: posts the ante 200
gwallgofddyn: posts the ante 200
Khanuman Men: posts small blind 800
sQuezzeYoU!!: posts big blind 1600
*** HOLE CARDS ***
jaimico00793: folds 
gwallgofddyn: raises 2080 to 3680
hiran bass: raises 23350 to 27030 and is all-in
StoraEss: folds 
atg590: folds 
PhoenixGrind: folds 
Khanuman Men: folds 
sQuezzeYoU!!: folds 
gwallgofddyn: folds 
Uncalled bet (23350) returned to hiran bass
hiran bass collected 11360 from pot
hiran bass: doesn't show hand 
*** SUMMARY ***
Total pot 11360 | Rake 0 
Seat 1: hiran bass collected (11360)
Seat 2: StoraEss folded before Flop (didn't bet)
Seat 3: atg590 folded before Flop (didn't bet)
Seat 4: PhoenixGrind (button) folded before Flop (didn't bet)
Seat 5: Khanuman Men (small blind) folded before Flop
Seat 6: sQuezzeYoU!! (big blind) folded before Flop
Seat 7: jaimico00793 folded before Flop (didn't bet)
Seat 8: gwallgofddyn folded before Flop

PokerStars Hand #251205920011: Tournament #3767885527, $40+$10+$5 USD Hold'em No Limit - Level XIII (800/1600) - 2024/06/26 19:26:22 UTC [2024/06/26 15:26:22 ET]
Table '3767885527 35' 8-max Seat #5 is the button
Seat 1: hiran bass (34710 in chips) 
Seat 2: StoraEss (41832 in chips) 
Seat 3: atg590 (97338 in chips) 
Seat 4: PhoenixGrind (94282 in chips) 
Seat 5: Khanuman Men (27668 in chips) 
Seat 6: sQuezzeYoU!! (56637 in chips) 
Seat 7: jaimico00793 (39192 in chips) 
Seat 8: gwallgofddyn (113368 in chips) 
hiran bass: posts the ante 200
StoraEss: posts the ante 200
atg590: posts the ante 200
PhoenixGrind: posts the ante 200
Khanuman Men: posts the ante 200
sQuezzeYoU!!: posts the ante 200
jaimico00793: posts the ante 200
gwallgofddyn: posts the ante 200
sQuezzeYoU!!: posts small blind 800
jaimico00793: posts big blind 1600
*** HOLE CARDS ***
gwallgofddyn: folds 
hiran bass: folds 
StoraEss: folds 
atg590: folds 
PhoenixGrind: folds 
Khanuman Men: raises 1600 to 3200
sQuezzeYoU!!: folds 
jaimico00793: calls 1600
*** FLOP *** [Jc Js Ac]
jaimico00793: checks 
Khanuman Men: bets 3200
jaimico00793: folds 
Uncalled bet (3200) returned to Khanuman Men
Khanuman Men collected 8800 from pot
*** SUMMARY ***
Total pot 8800 | Rake 0 
Board [Jc Js Ac]
Seat 1: hiran bass folded before Flop (didn't bet)
Seat 2: StoraEss folded before Flop (didn't bet)
Seat 3: atg590 folded before Flop (didn't bet)
Seat 4: PhoenixGrind folded before Flop (didn't bet)
Seat 5: Khanuman Men (button) collected (8800)
Seat 6: sQuezzeYoU!! (small blind) folded before Flop
Seat 7: jaimico00793 (big blind) folded on the Flop
Seat 8: gwallgofddyn folded before Flop (didn't bet)

PokerStars Hand #251205930914: Tournament #3767885527, $40+$10+$5 USD Hold'em No Limit - Level XIII (800/1600) - 2024/06/26 19:27:02 UTC [2024/06/26 15:27:02 ET]
Table '3767885527 35' 8-max Seat #6 is the button
Seat 1: hiran bass (34510 in chips) 
Seat 2: StoraEss (41632 in chips) 
Seat 3: atg590 (97138 in chips) 
Seat 4: PhoenixGrind (94082 in chips) 
Seat 5: Khanuman Men (33068 in chips) 
Seat 6: sQuezzeYoU!! (55637 in chips) 
Seat 7: jaimico00793 (35792 in chips) 
Seat 8: gwallgofddyn (113168 in chips) 
hiran bass: posts the ante 200
StoraEss: posts the ante 200
atg590: posts the ante 200
PhoenixGrind: posts the ante 200
Khanuman Men: posts the ante 200
sQuezzeYoU!!: posts the ante 200
jaimico00793: posts the ante 200
gwallgofddyn: posts the ante 200
jaimico00793: posts small blind 800
gwallgofddyn: posts big blind 1600
*** HOLE CARDS ***
hiran bass: folds 
StoraEss: raises 1600 to 3200
atg590: folds 
PhoenixGrind: folds 
Khanuman Men: folds 
sQuezzeYoU!!: folds 
jaimico00793: folds 
gwallgofddyn: folds 
Uncalled bet (1600) returned to StoraEss
StoraEss collected 5600 from pot
StoraEss: doesn't show hand 
*** SUMMARY ***
Total pot 5600 | Rake 0 
Seat 1: hiran bass folded before Flop (didn't bet)
Seat 2: StoraEss collected (5600)
Seat 3: atg590 folded before Flop (didn't bet)
Seat 4: PhoenixGrind folded before Flop (didn't bet)
Seat 5: Khanuman Men folded before Flop (didn't bet)
Seat 6: sQuezzeYoU!! (button) folded before Flop (didn't bet)
Seat 7: jaimico00793 (small blind) folded before Flop
Seat 8: gwallgofddyn (big blind) folded before Flop

PokerStars Hand #251205943397: Tournament #3767885527, $40+$10+$5 USD Hold'em No Limit - Level XIII (800/1600) - 2024/06/26 19:27:49 UTC [2024/06/26 15:27:49 ET]
Table '3767885527 35' 8-max Seat #7 is the button
Seat 1: hiran bass (34310 in chips) 
Seat 2: StoraEss (45432 in chips) 
Seat 3: atg590 (96938 in chips) 
Seat 4: PhoenixGrind (93882 in chips) 
Seat 5: Khanuman Men (32868 in chips) 
Seat 6: sQuezzeYoU!! (55437 in chips) 
Seat 7: jaimico00793 (34792 in chips) 
Seat 8: gwallgofddyn (111368 in chips) 
hiran bass: posts the ante 200
StoraEss: posts the ante 200
atg590: posts the ante 200
PhoenixGrind: posts the ante 200
Khanuman Men: posts the ante 200
sQuezzeYoU!!: posts the ante 200
jaimico00793: posts the ante 200
gwallgofddyn: posts the ante 200
gwallgofddyn: posts small blind 800
hiran bass: posts big blind 1600
*** HOLE CARDS ***
StoraEss: folds 
atg590: folds 
PhoenixGrind: folds 
Khanuman Men: folds 
sQuezzeYoU!!: folds 
jaimico00793: raises 1600 to 3200
gwallgofddyn: folds 
hiran bass: calls 1600
*** FLOP *** [8s 7c Jd]
hiran bass: checks 
jaimico00793: bets 2200
hiran bass: calls 2200
*** TURN *** [8s 7c Jd] [5d]
hiran bass: checks 
jaimico00793: bets 6960
hiran bass: calls 6960
*** RIVER *** [8s 7c Jd 5d] [As]
hiran bass: checks 
jaimico00793: checks 
*** SHOW DOWN ***
hiran bass: shows [6d 8c] (a pair of Eights)
jaimico00793: shows [7d Ad] (two pair, Aces and Sevens)
jaimico00793 collected 27120 from pot
*** SUMMARY ***
Total pot 27120 | Rake 0 
Board [8s 7c Jd 5d As]
Seat 1: hiran bass (big blind) showed [6d 8c] and lost with a pair of Eights
Seat 2: StoraEss folded before Flop (didn't bet)
Seat 3: atg590 folded before Flop (didn't bet)
Seat 4: PhoenixGrind folded before Flop (didn't bet)
Seat 5: Khanuman Men folded before Flop (didn't bet)
Seat 6: sQuezzeYoU!! folded before Flop (didn't bet)
Seat 7: jaimico00793 (button) showed [7d Ad] and won (27120) with two pair, Aces and Sevens
Seat 8: gwallgofddyn (small blind) folded before Flop

PokerStars Hand #251205967644: Tournament #3767885527, $40+$10+$5 USD Hold'em No Limit - Level XIV (1000/2000) - 2024/06/26 19:29:20 UTC [2024/06/26 15:29:20 ET]
Table '3767885527 35' 8-max Seat #8 is the button
Seat 1: hiran bass (21750 in chips) 
Seat 2: StoraEss (45232 in chips) 
Seat 3: atg590 (96738 in chips) 
Seat 4: PhoenixGrind (93682 in chips) 
Seat 5: Khanuman Men (32668 in chips) 
Seat 6: sQuezzeYoU!! (55237 in chips) 
Seat 7: jaimico00793 (49352 in chips) 
Seat 8: gwallgofddyn (110368 in chips) 
hiran bass: posts the ante 250
StoraEss: posts the ante 250
atg590: posts the ante 250
PhoenixGrind: posts the ante 250
Khanuman Men: posts the ante 250
sQuezzeYoU!!: posts the ante 250
jaimico00793: posts the ante 250
gwallgofddyn: posts the ante 250
hiran bass: posts small blind 1000
StoraEss: posts big blind 2000
*** HOLE CARDS ***
atg590: folds 
PhoenixGrind: folds 
Khanuman Men: raises 30418 to 32418 and is all-in
sQuezzeYoU!!: folds 
jaimico00793: folds 
gwallgofddyn: folds 
hiran bass: folds 
StoraEss: folds 
Uncalled bet (30418) returned to Khanuman Men
Khanuman Men collected 7000 from pot
*** SUMMARY ***
Total pot 7000 | Rake 0 
Seat 1: hiran bass (small blind) folded before Flop
Seat 2: StoraEss (big blind) folded before Flop
Seat 3: atg590 folded before Flop (didn't bet)
Seat 4: PhoenixGrind folded before Flop (didn't bet)
Seat 5: Khanuman Men collected (7000)
Seat 6: sQuezzeYoU!! folded before Flop (didn't bet)
Seat 7: jaimico00793 folded before Flop (didn't bet)
Seat 8: gwallgofddyn (button) folded before Flop (didn't bet)

PokerStars Hand #251205972493: Tournament #3767885527, $40+$10+$5 USD Hold'em No Limit - Level XIV (1000/2000) - 2024/06/26 19:29:37 UTC [2024/06/26 15:29:37 ET]
Table '3767885527 35' 8-max Seat #1 is the button
Seat 1: hiran bass (20500 in chips) 
Seat 2: StoraEss (42982 in chips) 
Seat 3: atg590 (96488 in chips) 
Seat 4: PhoenixGrind (93432 in chips) 
Seat 5: Khanuman Men (37418 in chips) 
Seat 6: sQuezzeYoU!! (54987 in chips) 
Seat 7: jaimico00793 (49102 in chips) 
Seat 8: gwallgofddyn (110118 in chips) 
hiran bass: posts the ante 250
StoraEss: posts the ante 250
atg590: posts the ante 250
PhoenixGrind: posts the ante 250
Khanuman Men: posts the ante 250
sQuezzeYoU!!: posts the ante 250
jaimico00793: posts the ante 250
gwallgofddyn: posts the ante 250
StoraEss: posts small blind 1000
atg590: posts big blind 2000
*** HOLE CARDS ***
PhoenixGrind: raises 3000 to 5000
Khanuman Men: folds 
sQuezzeYoU!!: raises 8000 to 13000
jaimico00793: folds 
gwallgofddyn: folds 
hiran bass: folds 
StoraEss: folds 
atg590: folds 
PhoenixGrind: raises 80182 to 93182 and is all-in
sQuezzeYoU!!: calls 41737 and is all-in
Uncalled bet (38445) returned to PhoenixGrind
*** FLOP *** [2s 5h Js]
*** TURN *** [2s 5h Js] [Qc]
*** RIVER *** [2s 5h Js Qc] [8c]
*** SHOW DOWN ***
PhoenixGrind: shows [Kd Kh] (a pair of Kings)
sQuezzeYoU!!: shows [Ac As] (a pair of Aces)
sQuezzeYoU!! collected 114474 from pot
*** SUMMARY ***
Total pot 114474 | Rake 0 
Board [2s 5h Js Qc 8c]
Seat 1: hiran bass (button) folded before Flop (didn't bet)
Seat 2: StoraEss (small blind) folded before Flop
Seat 3: atg590 (big blind) folded before Flop
Seat 4: PhoenixGrind showed [Kd Kh] and lost with a pair of Kings
Seat 5: Khanuman Men folded before Flop (didn't bet)
Seat 6: sQuezzeYoU!! showed [Ac As] and won (114474) with a pair of Aces
Seat 7: jaimico00793 folded before Flop (didn't bet)
Seat 8: gwallgofddyn folded before Flop (didn't bet)

PokerStars Hand #251205985418: Tournament #3767885527, $40+$10+$5 USD Hold'em No Limit - Level XIV (1000/2000) - 2024/06/26 19:30:24 UTC [2024/06/26 15:30:24 ET]
Table '3767885527 35' 8-max Seat #2 is the button
Seat 1: hiran bass (20250 in chips) 
Seat 2: StoraEss (41732 in chips) 
Seat 3: atg590 (94238 in chips) 
Seat 4: PhoenixGrind (38445 in chips) 
Seat 5: Khanuman Men (37168 in chips) 
Seat 6: sQuezzeYoU!! (114474 in chips) 
Seat 7: jaimico00793 (48852 in chips) 
Seat 8: gwallgofddyn (109868 in chips) 
hiran bass: posts the ante 250
StoraEss: posts the ante 250
atg590: posts the ante 250
PhoenixGrind: posts the ante 250
Khanuman Men: posts the ante 250
sQuezzeYoU!!: posts the ante 250
jaimico00793: posts the ante 250
gwallgofddyn: posts the ante 250
atg590: posts small blind 1000
PhoenixGrind: posts big blind 2000
*** HOLE CARDS ***
Khanuman Men: folds 
sQuezzeYoU!!: folds 
jaimico00793: folds 
gwallgofddyn: raises 2200 to 4200
hiran bass: folds 
StoraEss: calls 4200
atg590: calls 3200
PhoenixGrind: folds 
*** FLOP *** [6s 5h 2d]
atg590: checks 
gwallgofddyn: checks 
StoraEss: checks 
*** TURN *** [6s 5h 2d] [9s]
atg590: checks 
gwallgofddyn: bets 6640
StoraEss: calls 6640
atg590: folds 
*** RIVER *** [6s 5h 2d 9s] [8d]
gwallgofddyn: checks 
StoraEss: checks 
*** SHOW DOWN ***
gwallgofddyn: shows [9c Kc] (a pair of Nines)
StoraEss: mucks hand 
gwallgofddyn collected 29880 from pot
*** SUMMARY ***
Total pot 29880 | Rake 0 
Board [6s 5h 2d 9s 8d]
Seat 1: hiran bass folded before Flop (didn't bet)
Seat 2: StoraEss (button) mucked
Seat 3: atg590 (small blind) folded on the Turn
Seat 4: PhoenixGrind (big blind) folded before Flop
Seat 5: Khanuman Men folded before Flop (didn't bet)
Seat 6: sQuezzeYoU!! folded before Flop (didn't bet)
Seat 7: jaimico00793 folded before Flop (didn't bet)
Seat 8: gwallgofddyn showed [9c Kc] and won (29880) with a pair of Nines

PokerStars Hand #251206002315: Tournament #3767885527, $40+$10+$5 USD Hold'em No Limit - Level XIV (1000/2000) - 2024/06/26 19:31:26 UTC [2024/06/26 15:31:26 ET]
Table '3767885527 35' 8-max Seat #3 is the button
Seat 1: hiran bass (20000 in chips) 
Seat 2: StoraEss (30642 in chips) 
Seat 3: atg590 (89788 in chips) 
Seat 4: PhoenixGrind (36195 in chips) 
Seat 5: Khanuman Men (36918 in chips) 
Seat 6: sQuezzeYoU!! (114224 in chips) 
Seat 7: jaimico00793 (48602 in chips) 
Seat 8: gwallgofddyn (128658 in chips) 
hiran bass: posts the ante 250
StoraEss: posts the ante 250
atg590: posts the ante 250
PhoenixGrind: posts the ante 250
Khanuman Men: posts the ante 250
sQuezzeYoU!!: posts the ante 250
jaimico00793: posts the ante 250
gwallgofddyn: posts the ante 250
PhoenixGrind: posts small blind 1000
Khanuman Men: posts big blind 2000
*** HOLE CARDS ***
sQuezzeYoU!!: folds 
jaimico00793: folds 
gwallgofddyn: folds 
hiran bass: folds 
StoraEss: folds 
atg590: folds 
PhoenixGrind: raises 3000 to 5000
Khanuman Men: raises 31668 to 36668 and is all-in
PhoenixGrind: calls 30945 and is all-in
Uncalled bet (723) returned to Khanuman Men
*** FLOP *** [Ks Ac 3c]
*** TURN *** [Ks Ac 3c] [3s]
*** RIVER *** [Ks Ac 3c 3s] [8s]
*** SHOW DOWN ***
PhoenixGrind: shows [Tc Ts] (two pair, Tens and Threes)
Khanuman Men: shows [Jh Js] (two pair, Jacks and Threes)
Khanuman Men collected 73890 from pot
PhoenixGrind finished the tournament
*** SUMMARY ***
Total pot 73890 | Rake 0 
Board [Ks Ac 3c 3s 8s]
Seat 1: hiran bass folded before Flop (didn't bet)
Seat 2: StoraEss folded before Flop (didn't bet)
Seat 3: atg590 (button) folded before Flop (didn't bet)
Seat 4: PhoenixGrind (small blind) showed [Tc Ts] and lost with two pair, Tens and Threes
Seat 5: Khanuman Men (big blind) showed [Jh Js] and won (73890) with two pair, Jacks and Threes
Seat 6: sQuezzeYoU!! folded before Flop (didn't bet)
Seat 7: jaimico00793 folded before Flop (didn't bet)
Seat 8: gwallgofddyn folded before Flop (didn't bet)

PokerStars Hand #251206010011: Tournament #3767885527, $40+$10+$5 USD Hold'em No Limit - Level XIV (1000/2000) - 2024/06/26 19:31:54 UTC [2024/06/26 15:31:54 ET]
Table '3767885527 35' 8-max Seat #5 is the button
Seat 1: hiran bass (19750 in chips) 
Seat 2: StoraEss (30392 in chips) 
Seat 3: atg590 (89538 in chips) 
Seat 5: Khanuman Men (74613 in chips) 
Seat 6: sQuezzeYoU!! (113974 in chips) 
Seat 7: jaimico00793 (48352 in chips) 
Seat 8: gwallgofddyn (128408 in chips) 
hiran bass: posts the ante 250
StoraEss: posts the ante 250
atg590: posts the ante 250
Khanuman Men: posts the ante 250
sQuezzeYoU!!: posts the ante 250
jaimico00793: posts the ante 250
gwallgofddyn: posts the ante 250
sQuezzeYoU!!: posts small blind 1000
jaimico00793: posts big blind 2000
*** HOLE CARDS ***
gwallgofddyn: folds 
hiran bass: folds 
StoraEss: folds 
atg590: folds 
Khanuman Men: folds 
sQuezzeYoU!!: calls 1000
jaimico00793: checks 
*** FLOP *** [Kh 4s Js]
sQuezzeYoU!!: bets 2121
Dih21 is disconnected 
jaimico00793: folds 
Uncalled bet (2121) returned to sQuezzeYoU!!
sQuezzeYoU!! collected 5750 from pot
sQuezzeYoU!!: doesn't show hand 
*** SUMMARY ***
Total pot 5750 | Rake 0 
Board [Kh 4s Js]
Seat 1: hiran bass folded before Flop (didn't bet)
Seat 2: StoraEss folded before Flop (didn't bet)
Seat 3: atg590 folded before Flop (didn't bet)
Seat 5: Khanuman Men (button) folded before Flop (didn't bet)
Seat 6: sQuezzeYoU!! (small blind) collected (5750)
Seat 7: jaimico00793 (big blind) folded on the Flop
Seat 8: gwallgofddyn folded before Flop (didn't bet)

PokerStars Hand #251206020088: Tournament #3767885527, $40+$10+$5 USD Hold'em No Limit - Level XIV (1000/2000) - 2024/06/26 19:32:30 UTC [2024/06/26 15:32:30 ET]
Table '3767885527 35' 8-max Seat #6 is the button
Seat 1: hiran bass (19500 in chips) 
Seat 2: StoraEss (30142 in chips) 
Seat 3: atg590 (89288 in chips) 
Seat 4: Dih21 (25000 in chips) 
Seat 5: Khanuman Men (74363 in chips) 
Seat 6: sQuezzeYoU!! (117474 in chips) 
Seat 7: jaimico00793 (46102 in chips) 
Seat 8: gwallgofddyn (128158 in chips) 
hiran bass: posts the ante 250
StoraEss: posts the ante 250
atg590: posts the ante 250
Dih21: posts the ante 250
Khanuman Men: posts the ante 250
sQuezzeYoU!!: posts the ante 250
jaimico00793: posts the ante 250
gwallgofddyn: posts the ante 250
jaimico00793: posts small blind 1000
gwallgofddyn: posts big blind 2000
*** HOLE CARDS ***
hiran bass: raises 17250 to 19250 and is all-in
StoraEss: folds 
atg590: folds 
Dih21: folds 
Khanuman Men: folds 
sQuezzeYoU!!: folds 
jaimico00793: folds 
gwallgofddyn: folds 
Uncalled bet (17250) returned to hiran bass
hiran bass collected 7000 from pot
hiran bass: doesn't show hand 
*** SUMMARY ***
Total pot 7000 | Rake 0 
Seat 1: hiran bass collected (7000)
Seat 2: StoraEss folded before Flop (didn't bet)
Seat 3: atg590 folded before Flop (didn't bet)
Seat 4: Dih21 folded before Flop (didn't bet)
Seat 5: Khanuman Men folded before Flop (didn't bet)
Seat 6: sQuezzeYoU!! (button) folded before Flop (didn't bet)
Seat 7: jaimico00793 (small blind) folded before Flop
Seat 8: gwallgofddyn (big blind) folded before Flop

PokerStars Hand #251206027954: Tournament #3767885527, $40+$10+$5 USD Hold'em No Limit - Level XIV (1000/2000) - 2024/06/26 19:32:59 UTC [2024/06/26 15:32:59 ET]
Table '3767885527 35' 8-max Seat #7 is the button
Seat 1: hiran bass (24250 in chips) 
Seat 2: StoraEss (29892 in chips) 
Seat 3: atg590 (89038 in chips) 
Seat 4: Dih21 (24750 in chips) 
Seat 5: Khanuman Men (74113 in chips) 
Seat 6: sQuezzeYoU!! (117224 in chips) 
Seat 7: jaimico00793 (44852 in chips) 
Seat 8: gwallgofddyn (125908 in chips) 
hiran bass: posts the ante 250
StoraEss: posts the ante 250
atg590: posts the ante 250
Dih21: posts the ante 250
Khanuman Men: posts the ante 250
sQuezzeYoU!!: posts the ante 250
jaimico00793: posts the ante 250
gwallgofddyn: posts the ante 250
gwallgofddyn: posts small blind 1000
hiran bass: posts big blind 2000
*** HOLE CARDS ***
StoraEss: folds 
atg590: folds 
Dih21: raises 22500 to 24500 and is all-in
Khanuman Men: folds 
sQuezzeYoU!!: folds 
jaimico00793: folds 
gwallgofddyn: folds 
hiran bass: folds 
Uncalled bet (22500) returned to Dih21
Dih21 collected 7000 from pot
Dih21: doesn't show hand 
*** SUMMARY ***
Total pot 7000 | Rake 0 
Seat 1: hiran bass (big blind) folded before Flop
Seat 2: StoraEss folded before Flop (didn't bet)
Seat 3: atg590 folded before Flop (didn't bet)
Seat 4: Dih21 collected (7000)
Seat 5: Khanuman Men folded before Flop (didn't bet)
Seat 6: sQuezzeYoU!! folded before Flop (didn't bet)
Seat 7: jaimico00793 (button) folded before Flop (didn't bet)
Seat 8: gwallgofddyn (small blind) folded before Flop

PokerStars Hand #251206034295: Tournament #3767885527, $40+$10+$5 USD Hold'em No Limit - Level XIV (1000/2000) - 2024/06/26 19:33:22 UTC [2024/06/26 15:33:22 ET]
Table '3767885527 35' 8-max Seat #8 is the button
Seat 1: hiran bass (22000 in chips) 
Seat 2: StoraEss (29642 in chips) 
Seat 3: atg590 (88788 in chips) 
Seat 4: Dih21 (29500 in chips) 
Seat 5: Khanuman Men (73863 in chips) 
Seat 6: sQuezzeYoU!! (116974 in chips) 
Seat 7: jaimico00793 (44602 in chips) 
Seat 8: gwallgofddyn (124658 in chips) 
hiran bass: posts the ante 250
StoraEss: posts the ante 250
atg590: posts the ante 250
Dih21: posts the ante 250
Khanuman Men: posts the ante 250
sQuezzeYoU!!: posts the ante 250
jaimico00793: posts the ante 250
gwallgofddyn: posts the ante 250
hiran bass: posts small blind 1000
StoraEss: posts big blind 2000
*** HOLE CARDS ***
atg590: folds 
Dih21: folds 
Khanuman Men: raises 2000 to 4000
sQuezzeYoU!!: folds 
jaimico00793: folds 
gwallgofddyn: calls 4000
hiran bass: folds 
StoraEss: raises 25392 to 29392 and is all-in
Khanuman Men: calls 25392
gwallgofddyn: calls 25392
*** FLOP *** [Ad 2h Kd]
Khanuman Men: checks 
gwallgofddyn: checks 
*** TURN *** [Ad 2h Kd] [2c]
Khanuman Men: bets 12000
gwallgofddyn: folds 
Uncalled bet (12000) returned to Khanuman Men
*** RIVER *** [Ad 2h Kd 2c] [8c]
*** SHOW DOWN ***
StoraEss: shows [7h Td] (a pair of Deuces)
Khanuman Men: shows [As Ac] (a full house, Aces full of Deuces)
Khanuman Men collected 91176 from pot
StoraEss finished the tournament
*** SUMMARY ***
Total pot 91176 | Rake 0 
Board [Ad 2h Kd 2c 8c]
Seat 1: hiran bass (small blind) folded before Flop
Seat 2: StoraEss (big blind) showed [7h Td] and lost with a pair of Deuces
Seat 3: atg590 folded before Flop (didn't bet)
Seat 4: Dih21 folded before Flop (didn't bet)
Seat 5: Khanuman Men showed [As Ac] and won (91176) with a full house, Aces full of Deuces
Seat 6: sQuezzeYoU!! folded before Flop (didn't bet)
Seat 7: jaimico00793 folded before Flop (didn't bet)
Seat 8: gwallgofddyn (button) folded on the Turn

PokerStars Hand #251206053476: Tournament #3767885527, $40+$10+$5 USD Hold'em No Limit - Level XIV (1000/2000) - 2024/06/26 19:34:32 UTC [2024/06/26 15:34:32 ET]
Table '3767885527 35' 8-max Seat #1 is the button
Seat 1: hiran bass (20750 in chips) 
Seat 3: atg590 (88538 in chips) 
Seat 4: Dih21 (29250 in chips) 
Seat 5: Khanuman Men (135397 in chips) 
Seat 6: sQuezzeYoU!! (116724 in chips) 
Seat 7: jaimico00793 (44352 in chips) 
Seat 8: gwallgofddyn (95016 in chips) 
hiran bass: posts the ante 250
atg590: posts the ante 250
Dih21: posts the ante 250
Khanuman Men: posts the ante 250
sQuezzeYoU!!: posts the ante 250
jaimico00793: posts the ante 250
gwallgofddyn: posts the ante 250
atg590: posts small blind 1000
Dih21: posts big blind 2000
*** HOLE CARDS ***
Khanuman Men: folds 
sQuezzeYoU!!: folds 
jaimico00793: folds 
gwallgofddyn: folds 
hiran bass: raises 18500 to 20500 and is all-in
atg590: folds 
Dih21: folds 
Uncalled bet (18500) returned to hiran bass
hiran bass collected 6750 from pot
hiran bass: doesn't show hand 
*** SUMMARY ***
Total pot 6750 | Rake 0 
Seat 1: hiran bass (button) collected (6750)
Seat 3: atg590 (small blind) folded before Flop
Seat 4: Dih21 (big blind) folded before Flop
Seat 5: Khanuman Men folded before Flop (didn't bet)
Seat 6: sQuezzeYoU!! folded before Flop (didn't bet)
Seat 7: jaimico00793 folded before Flop (didn't bet)
Seat 8: gwallgofddyn folded before Flop (didn't bet)

PokerStars Hand #251206059007: Tournament #3767885527, $40+$10+$5 USD Hold'em No Limit - Level XIV (1000/2000) - 2024/06/26 19:34:52 UTC [2024/06/26 15:34:52 ET]
Table '3767885527 35' 8-max Seat #3 is the button
Seat 1: hiran bass (25250 in chips) 
Seat 3: atg590 (87288 in chips) 
Seat 4: Dih21 (27000 in chips) 
Seat 5: Khanuman Men (135147 in chips) 
Seat 6: sQuezzeYoU!! (116474 in chips) 
Seat 7: jaimico00793 (44102 in chips) 
Seat 8: gwallgofddyn (94766 in chips) 
hiran bass: posts the ante 250
atg590: posts the ante 250
Dih21: posts the ante 250
Khanuman Men: posts the ante 250
sQuezzeYoU!!: posts the ante 250
jaimico00793: posts the ante 250
gwallgofddyn: posts the ante 250
Dih21: posts small blind 1000
Khanuman Men: posts big blind 2000
*** HOLE CARDS ***
sQuezzeYoU!!: folds 
jaimico00793: raises 2000 to 4000
gwallgofddyn: folds 
hiran bass: folds 
atg590: folds 
Dih21: raises 22750 to 26750 and is all-in
Khanuman Men: folds 
jaimico00793: calls 22750
*** FLOP *** [5c 8d 9s]
*** TURN *** [5c 8d 9s] [Jd]
*** RIVER *** [5c 8d 9s Jd] [6h]
EugeneShev is disconnected 
*** SHOW DOWN ***
Dih21: shows [As Qh] (high card Ace)
jaimico00793: shows [Qs Qc] (a pair of Queens)
jaimico00793 collected 57250 from pot
Dih21 finished the tournament
*** SUMMARY ***
Total pot 57250 | Rake 0 
Board [5c 8d 9s Jd 6h]
Seat 1: hiran bass folded before Flop (didn't bet)
Seat 3: atg590 (button) folded before Flop (didn't bet)
Seat 4: Dih21 (small blind) showed [As Qh] and lost with high card Ace
Seat 5: Khanuman Men (big blind) folded before Flop
Seat 6: sQuezzeYoU!! folded before Flop (didn't bet)
Seat 7: jaimico00793 showed [Qs Qc] and won (57250) with a pair of Queens
Seat 8: gwallgofddyn folded before Flop (didn't bet)

PokerStars Hand #251206066186: Tournament #3767885527, $40+$10+$5 USD Hold'em No Limit - Level XIV (1000/2000) - 2024/06/26 19:35:19 UTC [2024/06/26 15:35:19 ET]
Table '3767885527 35' 8-max Seat #5 is the button
Seat 1: hiran bass (25000 in chips) 
Seat 2: EugeneShev (25000 in chips) 
Seat 3: atg590 (87038 in chips) 
Seat 5: Khanuman Men (132897 in chips) 
Seat 6: sQuezzeYoU!! (116224 in chips) 
Seat 7: jaimico00793 (74352 in chips) 
Seat 8: gwallgofddyn (94516 in chips) 
hiran bass: posts the ante 250
EugeneShev: posts the ante 250
atg590: posts the ante 250
Khanuman Men: posts the ante 250
sQuezzeYoU!!: posts the ante 250
jaimico00793: posts the ante 250
gwallgofddyn: posts the ante 250
sQuezzeYoU!!: posts small blind 1000
jaimico00793: posts big blind 2000
*** HOLE CARDS ***
gwallgofddyn: folds 
hiran bass: folds 
XARANDROS is disconnected 
EugeneShev: raises 22750 to 24750 and is all-in
atg590: folds 
Khanuman Men: folds 
sQuezzeYoU!!: folds 
jaimico00793: calls 22750
*** FLOP *** [Td Js 6d]
*** TURN *** [Td Js 6d] [2h]
*** RIVER *** [Td Js 6d 2h] [8c]
*** SHOW DOWN ***
jaimico00793: shows [Ks Ac] (high card Ace)
EugeneShev: shows [Kc Qc] (high card King)
jaimico00793 collected 52250 from pot
EugeneShev finished the tournament
*** SUMMARY ***
Total pot 52250 | Rake 0 
Board [Td Js 6d 2h 8c]
Seat 1: hiran bass folded before Flop (didn't bet)
Seat 2: EugeneShev showed [Kc Qc] and lost with high card King
Seat 3: atg590 folded before Flop (didn't bet)
Seat 5: Khanuman Men (button) folded before Flop (didn't bet)
Seat 6: sQuezzeYoU!! (small blind) folded before Flop
Seat 7: jaimico00793 (big blind) showed [Ks Ac] and won (52250) with high card Ace
Seat 8: gwallgofddyn folded before Flop (didn't bet)

PokerStars Hand #251206087350: Tournament #3767885527, $40+$10+$5 USD Hold'em No Limit - Level XIV (1000/2000) - 2024/06/26 19:36:36 UTC [2024/06/26 15:36:36 ET]
Table '3767885527 35' 8-max Seat #6 is the button
Seat 1: hiran bass (24750 in chips) 
Seat 3: atg590 (86788 in chips) 
Seat 4: XARANDROS (21750 in chips) 
Seat 5: Khanuman Men (132647 in chips) 
Seat 6: sQuezzeYoU!! (114974 in chips) 
Seat 7: jaimico00793 (101602 in chips) 
Seat 8: gwallgofddyn (94266 in chips) 
hiran bass: posts the ante 250
atg590: posts the ante 250
XARANDROS: posts the ante 250
Khanuman Men: posts the ante 250
sQuezzeYoU!!: posts the ante 250
jaimico00793: posts the ante 250
gwallgofddyn: posts the ante 250
jaimico00793: posts small blind 1000
gwallgofddyn: posts big blind 2000
*** HOLE CARDS ***
hiran bass: folds 
atg590: raises 4000 to 6000
XARANDROS: folds 
sprase1999 is disconnected 
Khanuman Men: folds 
sQuezzeYoU!!: folds 
jaimico00793: folds 
gwallgofddyn: folds 
Uncalled bet (4000) returned to atg590
atg590 collected 6750 from pot
*** SUMMARY ***
Total pot 6750 | Rake 0 
Seat 1: hiran bass folded before Flop (didn't bet)
Seat 3: atg590 collected (6750)
Seat 4: XARANDROS folded before Flop (didn't bet)
Seat 5: Khanuman Men folded before Flop (didn't bet)
Seat 6: sQuezzeYoU!! (button) folded before Flop (didn't bet)
Seat 7: jaimico00793 (small blind) folded before Flop
Seat 8: gwallgofddyn (big blind) folded before Flop

PokerStars Hand #251206096179: Tournament #3767885527, $40+$10+$5 USD Hold'em No Limit - Level XIV (1000/2000) - 2024/06/26 19:37:08 UTC [2024/06/26 15:37:08 ET]
Table '3767885527 35' 8-max Seat #7 is the button
Seat 1: hiran bass (24500 in chips) 
Seat 2: sprase1999 (44428 in chips) 
Seat 3: atg590 (91288 in chips) 
Seat 4: XARANDROS (21500 in chips) 
Seat 5: Khanuman Men (132397 in chips) 
Seat 6: sQuezzeYoU!! (114724 in chips) 
Seat 7: jaimico00793 (100352 in chips) 
Seat 8: gwallgofddyn (92016 in chips) 
hiran bass: posts the ante 250
sprase1999: posts the ante 250
atg590: posts the ante 250
XARANDROS: posts the ante 250
Khanuman Men: posts the ante 250
sQuezzeYoU!!: posts the ante 250
jaimico00793: posts the ante 250
gwallgofddyn: posts the ante 250
gwallgofddyn: posts small blind 1000
hiran bass: posts big blind 2000
*** HOLE CARDS ***
sprase1999: folds 
atg590: raises 4000 to 6000
XARANDROS: folds 
Khanuman Men: folds 
sQuezzeYoU!!: folds 
jaimico00793: folds 
gwallgofddyn: folds 
hiran bass: folds 
Uncalled bet (4000) returned to atg590
atg590 collected 7000 from pot
*** SUMMARY ***
Total pot 7000 | Rake 0 
Seat 1: hiran bass (big blind) folded before Flop
Seat 2: sprase1999 folded before Flop (didn't bet)
Seat 3: atg590 collected (7000)
Seat 4: XARANDROS folded before Flop (didn't bet)
Seat 5: Khanuman Men folded before Flop (didn't bet)
Seat 6: sQuezzeYoU!! folded before Flop (didn't bet)
Seat 7: jaimico00793 (button) folded before Flop (didn't bet)
Seat 8: gwallgofddyn (small blind) folded before Flop

PokerStars Hand #251206102087: Tournament #3767885527, $40+$10+$5 USD Hold'em No Limit - Level XIV (1000/2000) - 2024/06/26 19:37:29 UTC [2024/06/26 15:37:29 ET]
Table '3767885527 35' 8-max Seat #8 is the button
Seat 1: hiran bass (22250 in chips) 
Seat 2: sprase1999 (44178 in chips) 
Seat 3: atg590 (96038 in chips) 
Seat 4: XARANDROS (21250 in chips) 
Seat 5: Khanuman Men (132147 in chips) 
Seat 6: sQuezzeYoU!! (114474 in chips) 
Seat 7: jaimico00793 (100102 in chips) 
Seat 8: gwallgofddyn (90766 in chips) 
hiran bass: posts the ante 250
sprase1999: posts the ante 250
atg590: posts the ante 250
XARANDROS: posts the ante 250
Khanuman Men: posts the ante 250
sQuezzeYoU!!: posts the ante 250
jaimico00793: posts the ante 250
gwallgofddyn: posts the ante 250
hiran bass: posts small blind 1000
sprase1999: posts big blind 2000
*** HOLE CARDS ***
atg590: folds 
XARANDROS: folds 
Khanuman Men: folds 
sQuezzeYoU!!: folds 
jaimico00793: folds 
gwallgofddyn: folds 
hiran bass: calls 1000
sprase1999: checks 
*** FLOP *** [Qs Qd Jh]
hiran bass: checks 
sprase1999: checks 
*** TURN *** [Qs Qd Jh] [Ts]
hiran bass: bets 2000
sprase1999: calls 2000
*** RIVER *** [Qs Qd Jh Ts] [3d]
hiran bass: bets 8000
sprase1999: folds 
Uncalled bet (8000) returned to hiran bass
hiran bass collected 10000 from pot
hiran bass: doesn't show hand 
*** SUMMARY ***
Total pot 10000 | Rake 0 
Board [Qs Qd Jh Ts 3d]
Seat 1: hiran bass (small blind) collected (10000)
Seat 2: sprase1999 (big blind) folded on the River
Seat 3: atg590 folded before Flop (didn't bet)
Seat 4: XARANDROS folded before Flop (didn't bet)
Seat 5: Khanuman Men folded before Flop (didn't bet)
Seat 6: sQuezzeYoU!! folded before Flop (didn't bet)
Seat 7: jaimico00793 folded before Flop (didn't bet)
Seat 8: gwallgofddyn (button) folded before Flop (didn't bet)

PokerStars Hand #251206116655: Tournament #3767885527, $40+$10+$5 USD Hold'em No Limit - Level XIV (1000/2000) - 2024/06/26 19:38:24 UTC [2024/06/26 15:38:24 ET]
Table '3767885527 35' 8-max Seat #1 is the button
Seat 1: hiran bass (28000 in chips) 
Seat 2: sprase1999 (39928 in chips) 
Seat 3: atg590 (95788 in chips) 
Seat 4: XARANDROS (21000 in chips) 
Seat 5: Khanuman Men (131897 in chips) 
Seat 6: sQuezzeYoU!! (114224 in chips) 
Seat 7: jaimico00793 (99852 in chips) 
Seat 8: gwallgofddyn (90516 in chips) 
hiran bass: posts the ante 250
sprase1999: posts the ante 250
atg590: posts the ante 250
XARANDROS: posts the ante 250
Khanuman Men: posts the ante 250
sQuezzeYoU!!: posts the ante 250
jaimico00793: posts the ante 250
gwallgofddyn: posts the ante 250
sprase1999: posts small blind 1000
atg590: posts big blind 2000
*** HOLE CARDS ***
XARANDROS: folds 
Khanuman Men: folds 
sQuezzeYoU!!: raises 2260 to 4260
jaimico00793: folds 
gwallgofddyn: folds 
hiran bass: folds 
sprase1999: folds 
atg590: calls 2260
*** FLOP *** [3c 5h Kh]
atg590: checks 
sQuezzeYoU!!: bets 3608
atg590: calls 3608
*** TURN *** [3c 5h Kh] [7h]
atg590: checks 
sQuezzeYoU!!: bets 15054
atg590: folds 
Uncalled bet (15054) returned to sQuezzeYoU!!
sQuezzeYoU!! collected 18736 from pot
sQuezzeYoU!!: doesn't show hand 
*** SUMMARY ***
Total pot 18736 | Rake 0 
Board [3c 5h Kh 7h]
Seat 1: hiran bass (button) folded before Flop (didn't bet)
Seat 2: sprase1999 (small blind) folded before Flop
Seat 3: atg590 (big blind) folded on the Turn
Seat 4: XARANDROS folded before Flop (didn't bet)
Seat 5: Khanuman Men folded before Flop (didn't bet)
Seat 6: sQuezzeYoU!! collected (18736)
Seat 7: jaimico00793 folded before Flop (didn't bet)
Seat 8: gwallgofddyn folded before Flop (didn't bet)

PokerStars Hand #251206137234: Tournament #3767885527, $40+$10+$5 USD Hold'em No Limit - Level XV (1250/2500) - 2024/06/26 19:39:39 UTC [2024/06/26 15:39:39 ET]
Table '3767885527 35' 8-max Seat #2 is the button
Seat 1: hiran bass (27750 in chips) 
Seat 2: sprase1999 (38678 in chips) 
Seat 3: atg590 (87670 in chips) 
Seat 4: XARANDROS (20750 in chips) 
Seat 5: Khanuman Men (131647 in chips) 
Seat 6: sQuezzeYoU!! (124842 in chips) 
Seat 7: jaimico00793 (99602 in chips) 
Seat 8: gwallgofddyn (90266 in chips) 
hiran bass: posts the ante 325
sprase1999: posts the ante 325
atg590: posts the ante 325
XARANDROS: posts the ante 325
Khanuman Men: posts the ante 325
sQuezzeYoU!!: posts the ante 325
jaimico00793: posts the ante 325
gwallgofddyn: posts the ante 325
atg590: posts small blind 1250
XARANDROS: posts big blind 2500
*** HOLE CARDS ***
Khanuman Men: folds 
sQuezzeYoU!!: folds 
jaimico00793: folds 
gwallgofddyn: folds 
hiran bass: folds 
sprase1999: raises 2500 to 5000
atg590: calls 3750
XARANDROS: calls 2500
*** FLOP *** [3s 2s As]
atg590: checks 
XARANDROS: checks 
sprase1999: checks 
*** TURN *** [3s 2s As] [2h]
atg590: bets 11300
XARANDROS: folds 
sprase1999: folds 
Uncalled bet (11300) returned to atg590
atg590 collected 17600 from pot
*** SUMMARY ***
Total pot 17600 | Rake 0 
Board [3s 2s As 2h]
Seat 1: hiran bass folded before Flop (didn't bet)
Seat 2: sprase1999 (button) folded on the Turn
Seat 3: atg590 (small blind) collected (17600)
Seat 4: XARANDROS (big blind) folded on the Turn
Seat 5: Khanuman Men folded before Flop (didn't bet)
Seat 6: sQuezzeYoU!! folded before Flop (didn't bet)
Seat 7: jaimico00793 folded before Flop (didn't bet)
Seat 8: gwallgofddyn folded before Flop (didn't bet)

PokerStars Hand #251206155113: Tournament #3767885527, $40+$10+$5 USD Hold'em No Limit - Level XV (1250/2500) - 2024/06/26 19:40:44 UTC [2024/06/26 15:40:44 ET]
Table '3767885527 35' 8-max Seat #3 is the button
Seat 1: hiran bass (27425 in chips) 
Seat 2: sprase1999 (33353 in chips) 
Seat 3: atg590 (99945 in chips) 
Seat 4: XARANDROS (15425 in chips) 
Seat 5: Khanuman Men (131322 in chips) 
Seat 6: sQuezzeYoU!! (124517 in chips) 
Seat 7: jaimico00793 (99277 in chips) 
Seat 8: gwallgofddyn (89941 in chips) 
hiran bass: posts the ante 325
sprase1999: posts the ante 325
atg590: posts the ante 325
XARANDROS: posts the ante 325
Khanuman Men: posts the ante 325
sQuezzeYoU!!: posts the ante 325
jaimico00793: posts the ante 325
gwallgofddyn: posts the ante 325
XARANDROS: posts small blind 1250
Khanuman Men: posts big blind 2500
*** HOLE CARDS ***
sQuezzeYoU!!: folds 
jaimico00793: folds 
gwallgofddyn: folds 
hiran bass: raises 24600 to 27100 and is all-in
sprase1999: raises 5928 to 33028 and is all-in
atg590: folds 
XARANDROS: calls 13850 and is all-in
Khanuman Men: folds 
Uncalled bet (5928) returned to sprase1999
*** FLOP *** [2d Ad 5s]
*** TURN *** [2d Ad 5s] [7h]
*** RIVER *** [2d Ad 5s 7h] [6h]
*** SHOW DOWN ***
hiran bass: shows [2s 2c] (three of a kind, Deuces)
sprase1999: shows [Js Qs] (high card Ace)
hiran bass collected 24000 from side pot
XARANDROS: shows [Kc As] (a pair of Aces)
hiran bass collected 50400 from main pot
XARANDROS finished the tournament in 585th place
*** SUMMARY ***
Total pot 74400 Main pot 50400. Side pot 24000. | Rake 0 
Board [2d Ad 5s 7h 6h]
Seat 1: hiran bass showed [2s 2c] and won (74400) with three of a kind, Deuces
Seat 2: sprase1999 showed [Js Qs] and lost with high card Ace
Seat 3: atg590 (button) folded before Flop (didn't bet)
Seat 4: XARANDROS (small blind) showed [Kc As] and lost with a pair of Aces
Seat 5: Khanuman Men (big blind) folded before Flop
Seat 6: sQuezzeYoU!! folded before Flop (didn't bet)
Seat 7: jaimico00793 folded before Flop (didn't bet)
Seat 8: gwallgofddyn folded before Flop (didn't bet)


PokerStars Hand #251206619955: Tournament #3767885527, $40+$10+$5 USD Hold'em No Limit - Level XVII (1750/3500) - 2024/06/26 20:09:49 UTC [2024/06/26 16:09:49 ET]
Table '3767885527 34' 8-max Seat #5 is the button
Seat 1: Bigprad (46872 in chips) 
Seat 2: martincho186 (79240 in chips) 
Seat 3: kuenne71 (152521 in chips) 
Seat 4: Equinox616 (176866 in chips) 
Seat 5: gladiatore99 (81128 in chips) 
Seat 6: SolidYerna (203657 in chips) 
Seat 7: Dominosu (145930 in chips) 
Seat 8: mazzy4629 (17725 in chips) 
Bigprad: posts the ante 450
martincho186: posts the ante 450
kuenne71: posts the ante 450
Equinox616: posts the ante 450
gladiatore99: posts the ante 450
SolidYerna: posts the ante 450
Dominosu: posts the ante 450
mazzy4629: posts the ante 450
SolidYerna: posts small blind 1750
Dominosu: posts big blind 3500
*** HOLE CARDS ***
mazzy4629: folds 
Bigprad: folds 
martincho186: folds 
kuenne71: folds 
Equinox616: folds 
gladiatore99: raises 3500 to 7000
SolidYerna: raises 196207 to 203207 and is all-in
Dominosu: folds 
gladiatore99: folds 
Uncalled bet (196207) returned to SolidYerna
SolidYerna collected 21100 from pot
SolidYerna: doesn't show hand 
*** SUMMARY ***
Total pot 21100 | Rake 0 
Seat 1: Bigprad folded before Flop (didn't bet)
Seat 2: martincho186 folded before Flop (didn't bet)
Seat 3: kuenne71 folded before Flop (didn't bet)
Seat 4: Equinox616 folded before Flop (didn't bet)
Seat 5: gladiatore99 (button) folded before Flop
Seat 6: SolidYerna (small blind) collected (21100)
Seat 7: Dominosu (big blind) folded before Flop
Seat 8: mazzy4629 folded before Flop (didn't bet)

PokerStars Hand #251206630683: Tournament #3767885527, $40+$10+$5 USD Hold'em No Limit - Level XVII (1750/3500) - 2024/06/26 20:10:26 UTC [2024/06/26 16:10:26 ET]
Table '3767885527 34' 8-max Seat #6 is the button
Seat 1: Bigprad (46422 in chips) 
Seat 2: martincho186 (78790 in chips) 
Seat 3: kuenne71 (152071 in chips) 
Seat 4: Equinox616 (176416 in chips) 
Seat 5: gladiatore99 (73678 in chips) 
Seat 6: SolidYerna (217307 in chips) 
Seat 7: Dominosu (141980 in chips) 
Seat 8: mazzy4629 (17275 in chips) 
Bigprad: posts the ante 450
martincho186: posts the ante 450
kuenne71: posts the ante 450
Equinox616: posts the ante 450
gladiatore99: posts the ante 450
SolidYerna: posts the ante 450
Dominosu: posts the ante 450
mazzy4629: posts the ante 450
Dominosu: posts small blind 1750
mazzy4629: posts big blind 3500
*** HOLE CARDS ***
Bigprad: folds 
martincho186: folds 
kuenne71: folds 
Equinox616: folds 
gladiatore99: folds 
SolidYerna: folds 
Dominosu: folds 
Uncalled bet (1750) returned to mazzy4629
mazzy4629 collected 7100 from pot
*** SUMMARY ***
Total pot 7100 | Rake 0 
Seat 1: Bigprad folded before Flop (didn't bet)
Seat 2: martincho186 folded before Flop (didn't bet)
Seat 3: kuenne71 folded before Flop (didn't bet)
Seat 4: Equinox616 folded before Flop (didn't bet)
Seat 5: gladiatore99 folded before Flop (didn't bet)
Seat 6: SolidYerna (button) folded before Flop (didn't bet)
Seat 7: Dominosu (small blind) folded before Flop
Seat 8: mazzy4629 (big blind) collected (7100)

PokerStars Hand #251206636906: Tournament #3767885527, $40+$10+$5 USD Hold'em No Limit - Level XVII (1750/3500) - 2024/06/26 20:10:48 UTC [2024/06/26 16:10:48 ET]
Table '3767885527 34' 8-max Seat #7 is the button
Seat 1: Bigprad (45972 in chips) 
Seat 2: martincho186 (78340 in chips) 
Seat 3: kuenne71 (151621 in chips) 
Seat 4: Equinox616 (175966 in chips) 
Seat 5: gladiatore99 (73228 in chips) 
Seat 6: SolidYerna (216857 in chips) 
Seat 7: Dominosu (139780 in chips) 
Seat 8: mazzy4629 (22175 in chips) 
Bigprad: posts the ante 450
martincho186: posts the ante 450
kuenne71: posts the ante 450
Equinox616: posts the ante 450
gladiatore99: posts the ante 450
SolidYerna: posts the ante 450
Dominosu: posts the ante 450
mazzy4629: posts the ante 450
mazzy4629: posts small blind 1750
Bigprad: posts big blind 3500
*** HOLE CARDS ***
martincho186: folds 
kuenne71: raises 3500 to 7000
Equinox616: folds 
gladiatore99: folds 
SolidYerna: folds 
Dominosu: folds 
mazzy4629: folds 
Bigprad: calls 3500
*** FLOP *** [2c Js 2h]
Bigprad: checks 
kuenne71: bets 9675
Bigprad: calls 9675
*** TURN *** [2c Js 2h] [5d]
Bigprad: checks 
kuenne71: bets 38700
Bigprad: folds 
Uncalled bet (38700) returned to kuenne71
kuenne71 collected 38700 from pot
kuenne71: doesn't show hand 
*** SUMMARY ***
Total pot 38700 | Rake 0 
Board [2c Js 2h 5d]
Seat 1: Bigprad (big blind) folded on the Turn
Seat 2: martincho186 folded before Flop (didn't bet)
Seat 3: kuenne71 collected (38700)
Seat 4: Equinox616 folded before Flop (didn't bet)
Seat 5: gladiatore99 folded before Flop (didn't bet)
Seat 6: SolidYerna folded before Flop (didn't bet)
Seat 7: Dominosu (button) folded before Flop (didn't bet)
Seat 8: mazzy4629 (small blind) folded before Flop

PokerStars Hand #251206644673: Tournament #3767885527, $40+$10+$5 USD Hold'em No Limit - Level XVII (1750/3500) - 2024/06/26 20:11:15 UTC [2024/06/26 16:11:15 ET]
Table '3767885527 34' 8-max Seat #8 is the button
Seat 1: Bigprad (28847 in chips) 
Seat 2: martincho186 (77890 in chips) 
Seat 3: kuenne71 (173196 in chips) 
Seat 4: Equinox616 (175516 in chips) 
Seat 5: gladiatore99 (72778 in chips) 
Seat 6: SolidYerna (216407 in chips) 
Seat 7: Dominosu (139330 in chips) 
Seat 8: mazzy4629 (19975 in chips) 
Bigprad: posts the ante 450
martincho186: posts the ante 450
kuenne71: posts the ante 450
Equinox616: posts the ante 450
gladiatore99: posts the ante 450
SolidYerna: posts the ante 450
Dominosu: posts the ante 450
mazzy4629: posts the ante 450
Bigprad: posts small blind 1750
martincho186: posts big blind 3500
*** HOLE CARDS ***
kuenne71: folds 
Equinox616: folds 
gladiatore99: folds 
SolidYerna: folds 
Dominosu: raises 3500 to 7000
mazzy4629: folds 
Bigprad: folds 
martincho186: calls 3500
*** FLOP *** [7s 8h 5s]
martincho186: checks 
Dominosu: checks 
*** TURN *** [7s 8h 5s] [4s]
martincho186: checks 
Dominosu: checks 
*** RIVER *** [7s 8h 5s 4s] [Ah]
martincho186: checks 
Dominosu: checks 
*** SHOW DOWN ***
martincho186: shows [Kd 9d] (high card Ace)
Dominosu: shows [7h Kh] (a pair of Sevens)
Dominosu collected 19350 from pot
*** SUMMARY ***
Total pot 19350 | Rake 0 
Board [7s 8h 5s 4s Ah]
Seat 1: Bigprad (small blind) folded before Flop
Seat 2: martincho186 (big blind) showed [Kd 9d] and lost with high card Ace
Seat 3: kuenne71 folded before Flop (didn't bet)
Seat 4: Equinox616 folded before Flop (didn't bet)
Seat 5: gladiatore99 folded before Flop (didn't bet)
Seat 6: SolidYerna folded before Flop (didn't bet)
Seat 7: Dominosu showed [7h Kh] and won (19350) with a pair of Sevens
Seat 8: mazzy4629 (button) folded before Flop (didn't bet)

PokerStars Hand #251206658680: Tournament #3767885527, $40+$10+$5 USD Hold'em No Limit - Level XVII (1750/3500) - 2024/06/26 20:12:05 UTC [2024/06/26 16:12:05 ET]
Table '3767885527 34' 8-max Seat #1 is the button
Seat 1: Bigprad (26647 in chips) 
Seat 2: martincho186 (70440 in chips) 
Seat 3: kuenne71 (172746 in chips) 
Seat 4: Equinox616 (175066 in chips) 
Seat 5: gladiatore99 (72328 in chips) 
Seat 6: SolidYerna (215957 in chips) 
Seat 7: Dominosu (151230 in chips) 
Seat 8: mazzy4629 (19525 in chips) 
Bigprad: posts the ante 450
martincho186: posts the ante 450
kuenne71: posts the ante 450
Equinox616: posts the ante 450
gladiatore99: posts the ante 450
SolidYerna: posts the ante 450
Dominosu: posts the ante 450
mazzy4629: posts the ante 450
martincho186: posts small blind 1750
kuenne71: posts big blind 3500
*** HOLE CARDS ***
Equinox616: folds 
gladiatore99: folds 
SolidYerna: raises 3850 to 7350
Dominosu: folds 
mazzy4629: folds 
Bigprad: raises 18847 to 26197 and is all-in
martincho186: folds 
kuenne71: folds 
SolidYerna: calls 18847
*** FLOP *** [4c 3s 6h]
*** TURN *** [4c 3s 6h] [7s]
*** RIVER *** [4c 3s 6h 7s] [8c]
*** SHOW DOWN ***
SolidYerna: shows [Ac Tc] (high card Ace)
Bigprad: shows [2c 2d] (a pair of Deuces)
Bigprad collected 61244 from pot
*** SUMMARY ***
Total pot 61244 | Rake 0 
Board [4c 3s 6h 7s 8c]
Seat 1: Bigprad (button) showed [2c 2d] and won (61244) with a pair of Deuces
Seat 2: martincho186 (small blind) folded before Flop
Seat 3: kuenne71 (big blind) folded before Flop
Seat 4: Equinox616 folded before Flop (didn't bet)
Seat 5: gladiatore99 folded before Flop (didn't bet)
Seat 6: SolidYerna showed [Ac Tc] and lost with high card Ace
Seat 7: Dominosu folded before Flop (didn't bet)
Seat 8: mazzy4629 folded before Flop (didn't bet)

PokerStars Hand #251206671507: Tournament #3767885527, $40+$10+$5 USD Hold'em No Limit - Level XVII (1750/3500) - 2024/06/26 20:12:50 UTC [2024/06/26 16:12:50 ET]
Table '3767885527 34' 8-max Seat #2 is the button
Seat 1: Bigprad (61244 in chips) 
Seat 2: martincho186 (68240 in chips) 
Seat 3: kuenne71 (168796 in chips) 
Seat 4: Equinox616 (174616 in chips) 
Seat 5: gladiatore99 (71878 in chips) 
Seat 6: SolidYerna (189310 in chips) 
Seat 7: Dominosu (150780 in chips) 
Seat 8: mazzy4629 (19075 in chips) 
Bigprad: posts the ante 450
martincho186: posts the ante 450
kuenne71: posts the ante 450
Equinox616: posts the ante 450
gladiatore99: posts the ante 450
SolidYerna: posts the ante 450
Dominosu: posts the ante 450
mazzy4629: posts the ante 450
kuenne71: posts small blind 1750
Equinox616: posts big blind 3500
*** HOLE CARDS ***
gladiatore99: raises 3500 to 7000
SolidYerna: folds 
Dominosu: folds 
mazzy4629: folds 
Bigprad: folds 
martincho186: folds 
kuenne71: folds 
Equinox616: calls 3500
*** FLOP *** [4s Jh Ts]
Equinox616: checks 
gladiatore99: checks 
*** TURN *** [4s Jh Ts] [4h]
Equinox616: bets 7000
gladiatore99: calls 7000
*** RIVER *** [4s Jh Ts 4h] [8c]
Equinox616: bets 17500
gladiatore99: folds 
Uncalled bet (17500) returned to Equinox616
Equinox616 collected 33350 from pot
Equinox616: doesn't show hand 
*** SUMMARY ***
Total pot 33350 | Rake 0 
Board [4s Jh Ts 4h 8c]
Seat 1: Bigprad folded before Flop (didn't bet)
Seat 2: martincho186 (button) folded before Flop (didn't bet)
Seat 3: kuenne71 (small blind) folded before Flop
Seat 4: Equinox616 (big blind) collected (33350)
Seat 5: gladiatore99 folded on the River
Seat 6: SolidYerna folded before Flop (didn't bet)
Seat 7: Dominosu folded before Flop (didn't bet)
Seat 8: mazzy4629 folded before Flop (didn't bet)

PokerStars Hand #251206692239: Tournament #3767885527, $40+$10+$5 USD Hold'em No Limit - Level XVII (1750/3500) - 2024/06/26 20:14:05 UTC [2024/06/26 16:14:05 ET]
Table '3767885527 34' 8-max Seat #3 is the button
Seat 1: Bigprad (60794 in chips) 
Seat 2: martincho186 (67790 in chips) 
Seat 3: kuenne71 (166596 in chips) 
Seat 4: Equinox616 (193516 in chips) 
Seat 5: gladiatore99 (57428 in chips) 
Seat 6: SolidYerna (188860 in chips) 
Seat 7: Dominosu (150330 in chips) 
Seat 8: mazzy4629 (18625 in chips) 
Bigprad: posts the ante 450
martincho186: posts the ante 450
kuenne71: posts the ante 450
Equinox616: posts the ante 450
gladiatore99: posts the ante 450
SolidYerna: posts the ante 450
Dominosu: posts the ante 450
mazzy4629: posts the ante 450
Equinox616: posts small blind 1750
gladiatore99: posts big blind 3500
*** HOLE CARDS ***
SolidYerna: folds 
Dominosu: raises 4200 to 7700
mazzy4629: folds 
Bigprad: folds 
martincho186: folds 
kuenne71: folds 
Equinox616: folds 
gladiatore99: folds 
Uncalled bet (4200) returned to Dominosu
Dominosu collected 12350 from pot
Dominosu: doesn't show hand 
*** SUMMARY ***
Total pot 12350 | Rake 0 
Seat 1: Bigprad folded before Flop (didn't bet)
Seat 2: martincho186 folded before Flop (didn't bet)
Seat 3: kuenne71 (button) folded before Flop (didn't bet)
Seat 4: Equinox616 (small blind) folded before Flop
Seat 5: gladiatore99 (big blind) folded before Flop
Seat 6: SolidYerna folded before Flop (didn't bet)
Seat 7: Dominosu collected (12350)
Seat 8: mazzy4629 folded before Flop (didn't bet)

PokerStars Hand #251206697297: Tournament #3767885527, $40+$10+$5 USD Hold'em No Limit - Level XVII (1750/3500) - 2024/06/26 20:14:23 UTC [2024/06/26 16:14:23 ET]
Table '3767885527 34' 8-max Seat #4 is the button
Seat 1: Bigprad (60344 in chips) 
Seat 2: martincho186 (67340 in chips) 
Seat 3: kuenne71 (166146 in chips) 
Seat 4: Equinox616 (191316 in chips) 
Seat 5: gladiatore99 (53478 in chips) 
Seat 6: SolidYerna (188410 in chips) 
Seat 7: Dominosu (158730 in chips) 
Seat 8: mazzy4629 (18175 in chips) 
Bigprad: posts the ante 450
martincho186: posts the ante 450
kuenne71: posts the ante 450
Equinox616: posts the ante 450
gladiatore99: posts the ante 450
SolidYerna: posts the ante 450
Dominosu: posts the ante 450
mazzy4629: posts the ante 450
gladiatore99: posts small blind 1750
SolidYerna: posts big blind 3500
*** HOLE CARDS ***
Dominosu: folds 
mazzy4629: folds 
Bigprad: folds 
martincho186: folds 
kuenne71: raises 3500 to 7000
Equinox616: calls 7000
gladiatore99: folds 
SolidYerna: folds 
*** FLOP *** [9s 2h 6d]
kuenne71: checks 
Equinox616: checks 
*** TURN *** [9s 2h 6d] [5s]
kuenne71: checks 
Equinox616: bets 11425
kuenne71: calls 11425
*** RIVER *** [9s 2h 6d 5s] [Kc]
kuenne71: checks 
Equinox616: checks 
*** SHOW DOWN ***
kuenne71: shows [Ac 7s] (high card Ace)
Equinox616: shows [9c Jh] (a pair of Nines)
Equinox616 collected 45700 from pot
*** SUMMARY ***
Total pot 45700 | Rake 0 
Board [9s 2h 6d 5s Kc]
Seat 1: Bigprad folded before Flop (didn't bet)
Seat 2: martincho186 folded before Flop (didn't bet)
Seat 3: kuenne71 showed [Ac 7s] and lost with high card Ace
Seat 4: Equinox616 (button) showed [9c Jh] and won (45700) with a pair of Nines
Seat 5: gladiatore99 (small blind) folded before Flop
Seat 6: SolidYerna (big blind) folded before Flop
Seat 7: Dominosu folded before Flop (didn't bet)
Seat 8: mazzy4629 folded before Flop (didn't bet)

PokerStars Hand #251206715787: Tournament #3767885527, $40+$10+$5 USD Hold'em No Limit - Level XVII (1750/3500) - 2024/06/26 20:15:28 UTC [2024/06/26 16:15:28 ET]
Table '3767885527 34' 8-max Seat #5 is the button
Seat 1: Bigprad (59894 in chips) 
Seat 2: martincho186 (66890 in chips) 
Seat 3: kuenne71 (147271 in chips) 
Seat 4: Equinox616 (218141 in chips) 
Seat 5: gladiatore99 (51278 in chips) 
Seat 6: SolidYerna (184460 in chips) 
Seat 7: Dominosu (158280 in chips) 
Seat 8: mazzy4629 (17725 in chips) 
Bigprad: posts the ante 450
martincho186: posts the ante 450
kuenne71: posts the ante 450
Equinox616: posts the ante 450
gladiatore99: posts the ante 450
SolidYerna: posts the ante 450
Dominosu: posts the ante 450
mazzy4629: posts the ante 450
SolidYerna: posts small blind 1750
Dominosu: posts big blind 3500
*** HOLE CARDS ***
mazzy4629: raises 13775 to 17275 and is all-in
Bigprad: folds 
martincho186: folds 
kuenne71: folds 
Equinox616: folds 
gladiatore99: folds 
SolidYerna: folds 
Dominosu: folds 
Uncalled bet (13775) returned to mazzy4629
mazzy4629 collected 12350 from pot
*** SUMMARY ***
Total pot 12350 | Rake 0 
Seat 1: Bigprad folded before Flop (didn't bet)
Seat 2: martincho186 folded before Flop (didn't bet)
Seat 3: kuenne71 folded before Flop (didn't bet)
Seat 4: Equinox616 folded before Flop (didn't bet)
Seat 5: gladiatore99 (button) folded before Flop (didn't bet)
Seat 6: SolidYerna (small blind) folded before Flop
Seat 7: Dominosu (big blind) folded before Flop
Seat 8: mazzy4629 collected (12350)

PokerStars Hand #251206723933: Tournament #3767885527, $40+$10+$5 USD Hold'em No Limit - Level XVIII (2000/4000) - 2024/06/26 20:15:57 UTC [2024/06/26 16:15:57 ET]
Table '3767885527 34' 8-max Seat #6 is the button
Seat 1: Bigprad (59444 in chips) 
Seat 2: martincho186 (66440 in chips) 
Seat 3: kuenne71 (146821 in chips) 
Seat 4: Equinox616 (217691 in chips) 
Seat 5: gladiatore99 (50828 in chips) 
Seat 6: SolidYerna (182260 in chips) 
Seat 7: Dominosu (154330 in chips) 
Seat 8: mazzy4629 (26125 in chips) 
Bigprad: posts the ante 500
martincho186: posts the ante 500
kuenne71: posts the ante 500
Equinox616: posts the ante 500
gladiatore99: posts the ante 500
SolidYerna: posts the ante 500
Dominosu: posts the ante 500
mazzy4629: posts the ante 500
Dominosu: posts small blind 2000
mazzy4629: posts big blind 4000
*** HOLE CARDS ***
Bigprad: folds 
martincho186: raises 4000 to 8000
kuenne71: folds 
Equinox616: folds 
gladiatore99: folds 
SolidYerna: folds 
Dominosu: folds 
mazzy4629: folds 
Uncalled bet (4000) returned to martincho186
martincho186 collected 14000 from pot
*** SUMMARY ***
Total pot 14000 | Rake 0 
Seat 1: Bigprad folded before Flop (didn't bet)
Seat 2: martincho186 collected (14000)
Seat 3: kuenne71 folded before Flop (didn't bet)
Seat 4: Equinox616 folded before Flop (didn't bet)
Seat 5: gladiatore99 folded before Flop (didn't bet)
Seat 6: SolidYerna (button) folded before Flop (didn't bet)
Seat 7: Dominosu (small blind) folded before Flop
Seat 8: mazzy4629 (big blind) folded before Flop

PokerStars Hand #251206730587: Tournament #3767885527, $40+$10+$5 USD Hold'em No Limit - Level XVIII (2000/4000) - 2024/06/26 20:16:20 UTC [2024/06/26 16:16:20 ET]
Table '3767885527 34' 8-max Seat #7 is the button
Seat 1: Bigprad (58944 in chips) 
Seat 2: martincho186 (75940 in chips) 
Seat 3: kuenne71 (146321 in chips) 
Seat 4: Equinox616 (217191 in chips) 
Seat 5: gladiatore99 (50328 in chips) 
Seat 6: SolidYerna (181760 in chips) 
Seat 7: Dominosu (151830 in chips) 
Seat 8: mazzy4629 (21625 in chips) 
Bigprad: posts the ante 500
martincho186: posts the ante 500
kuenne71: posts the ante 500
Equinox616: posts the ante 500
gladiatore99: posts the ante 500
SolidYerna: posts the ante 500
Dominosu: posts the ante 500
mazzy4629: posts the ante 500
mazzy4629: posts small blind 2000
Bigprad: posts big blind 4000
*** HOLE CARDS ***
martincho186: folds 
kuenne71: folds 
Equinox616: raises 6000 to 10000
gladiatore99: folds 
SolidYerna: folds 
Dominosu: folds 
mazzy4629: folds 
Bigprad: folds 
Uncalled bet (6000) returned to Equinox616
Equinox616 collected 14000 from pot
Equinox616: doesn't show hand 
*** SUMMARY ***
Total pot 14000 | Rake 0 
Seat 1: Bigprad (big blind) folded before Flop
Seat 2: martincho186 folded before Flop (didn't bet)
Seat 3: kuenne71 folded before Flop (didn't bet)
Seat 4: Equinox616 collected (14000)
Seat 5: gladiatore99 folded before Flop (didn't bet)
Seat 6: SolidYerna folded before Flop (didn't bet)
Seat 7: Dominosu (button) folded before Flop (didn't bet)
Seat 8: mazzy4629 (small blind) folded before Flop

PokerStars Hand #251206747254: Tournament #3767885527, $40+$10+$5 USD Hold'em No Limit - Level XVIII (2000/4000) - 2024/06/26 20:17:20 UTC [2024/06/26 16:17:20 ET]
Table '3767885527 34' 8-max Seat #8 is the button
Seat 1: Bigprad (54444 in chips) 
Seat 2: martincho186 (75440 in chips) 
Seat 3: kuenne71 (145821 in chips) 
Seat 4: Equinox616 (226691 in chips) 
Seat 5: gladiatore99 (49828 in chips) 
Seat 6: SolidYerna (181260 in chips) 
Seat 7: Dominosu (151330 in chips) 
Seat 8: mazzy4629 (19125 in chips) 
Bigprad: posts the ante 500
martincho186: posts the ante 500
kuenne71: posts the ante 500
Equinox616: posts the ante 500
gladiatore99: posts the ante 500
SolidYerna: posts the ante 500
Dominosu: posts the ante 500
mazzy4629: posts the ante 500
Bigprad: posts small blind 2000
martincho186: posts big blind 4000
*** HOLE CARDS ***
kuenne71: folds 
Equinox616: folds 
gladiatore99: folds 
SolidYerna: folds 
Dominosu: raises 4800 to 8800
mazzy4629: folds 
Bigprad: folds 
martincho186: folds 
Uncalled bet (4800) returned to Dominosu
Dominosu collected 14000 from pot
Dominosu: doesn't show hand 
*** SUMMARY ***
Total pot 14000 | Rake 0 
Seat 1: Bigprad (small blind) folded before Flop
Seat 2: martincho186 (big blind) folded before Flop
Seat 3: kuenne71 folded before Flop (didn't bet)
Seat 4: Equinox616 folded before Flop (didn't bet)
Seat 5: gladiatore99 folded before Flop (didn't bet)
Seat 6: SolidYerna folded before Flop (didn't bet)
Seat 7: Dominosu collected (14000)
Seat 8: mazzy4629 (button) folded before Flop (didn't bet)

PokerStars Hand #251206752472: Tournament #3767885527, $40+$10+$5 USD Hold'em No Limit - Level XVIII (2000/4000) - 2024/06/26 20:17:39 UTC [2024/06/26 16:17:39 ET]
Table '3767885527 34' 8-max Seat #1 is the button
Seat 1: Bigprad (51944 in chips) 
Seat 2: martincho186 (70940 in chips) 
Seat 3: kuenne71 (145321 in chips) 
Seat 4: Equinox616 (226191 in chips) 
Seat 5: gladiatore99 (49328 in chips) 
Seat 6: SolidYerna (180760 in chips) 
Seat 7: Dominosu (160830 in chips) 
Seat 8: mazzy4629 (18625 in chips) 
Bigprad: posts the ante 500
martincho186: posts the ante 500
kuenne71: posts the ante 500
Equinox616: posts the ante 500
gladiatore99: posts the ante 500
SolidYerna: posts the ante 500
Dominosu: posts the ante 500
mazzy4629: posts the ante 500
martincho186: posts small blind 2000
kuenne71: posts big blind 4000
*** HOLE CARDS ***
Equinox616: raises 4000 to 8000
gladiatore99: folds 
SolidYerna: folds 
Dominosu: raises 14000 to 22000
mazzy4629: folds 
Bigprad: folds 
martincho186: folds 
kuenne71: folds 
Equinox616: calls 14000
*** FLOP *** [6s 6h Qc]
Equinox616: bets 31000
Dominosu: calls 31000
*** TURN *** [6s 6h Qc] [6d]
Equinox616: checks 
Dominosu: checks 
*** RIVER *** [6s 6h Qc 6d] [8s]
Equinox616: bets 32000
Dominosu: raises 75330 to 107330 and is all-in
Equinox616: calls 75330
*** SHOW DOWN ***
Dominosu: shows [Kc Ks] (a full house, Sixes full of Kings)
Equinox616: shows [Qh Kd] (a full house, Sixes full of Queens)
Dominosu collected 330660 from pot
*** SUMMARY ***
Total pot 330660 | Rake 0 
Board [6s 6h Qc 6d 8s]
Seat 1: Bigprad (button) folded before Flop (didn't bet)
Seat 2: martincho186 (small blind) folded before Flop
Seat 3: kuenne71 (big blind) folded before Flop
Seat 4: Equinox616 showed [Qh Kd] and lost with a full house, Sixes full of Queens
Seat 5: gladiatore99 folded before Flop (didn't bet)
Seat 6: SolidYerna folded before Flop (didn't bet)
Seat 7: Dominosu showed [Kc Ks] and won (330660) with a full house, Sixes full of Kings
Seat 8: mazzy4629 folded before Flop (didn't bet)

PokerStars Hand #251206804174: Tournament #3767885527, $40+$10+$5 USD Hold'em No Limit - Level XVIII (2000/4000) - 2024/06/26 20:20:42 UTC [2024/06/26 16:20:42 ET]
Table '3767885527 34' 8-max Seat #2 is the button
Seat 1: Bigprad (51444 in chips) 
Seat 2: martincho186 (68440 in chips) 
Seat 3: kuenne71 (140821 in chips) 
Seat 4: Equinox616 (65361 in chips) 
Seat 5: gladiatore99 (48828 in chips) 
Seat 6: SolidYerna (180260 in chips) 
Seat 7: Dominosu (330660 in chips) 
Seat 8: mazzy4629 (18125 in chips) 
Bigprad: posts the ante 500
martincho186: posts the ante 500
kuenne71: posts the ante 500
Equinox616: posts the ante 500
gladiatore99: posts the ante 500
SolidYerna: posts the ante 500
Dominosu: posts the ante 500
mazzy4629: posts the ante 500
kuenne71: posts small blind 2000
Equinox616: posts big blind 4000
*** HOLE CARDS ***
gladiatore99: folds 
SolidYerna: folds 
Dominosu: raises 4800 to 8800
mazzy4629: folds 
Bigprad: folds 
martincho186: folds 
kuenne71: calls 6800
Equinox616: folds 
*** FLOP *** [Kh 2c Qs]
kuenne71: checks 
Dominosu: checks 
*** TURN *** [Kh 2c Qs] [7s]
kuenne71: checks 
Dominosu: bets 8448
kuenne71: folds 
Uncalled bet (8448) returned to Dominosu
Dominosu collected 25600 from pot
Dominosu: doesn't show hand 
*** SUMMARY ***
Total pot 25600 | Rake 0 
Board [Kh 2c Qs 7s]
Seat 1: Bigprad folded before Flop (didn't bet)
Seat 2: martincho186 (button) folded before Flop (didn't bet)
Seat 3: kuenne71 (small blind) folded on the Turn
Seat 4: Equinox616 (big blind) folded before Flop
Seat 5: gladiatore99 folded before Flop (didn't bet)
Seat 6: SolidYerna folded before Flop (didn't bet)
Seat 7: Dominosu collected (25600)
Seat 8: mazzy4629 folded before Flop (didn't bet)

PokerStars Hand #251206822533: Tournament #3767885527, $40+$10+$5 USD Hold'em No Limit - Level XVIII (2000/4000) - 2024/06/26 20:21:47 UTC [2024/06/26 16:21:47 ET]
Table '3767885527 34' 8-max Seat #3 is the button
Seat 1: Bigprad (50944 in chips) 
Seat 2: martincho186 (67940 in chips) 
Seat 3: kuenne71 (131521 in chips) 
Seat 4: Equinox616 (60861 in chips) 
Seat 5: gladiatore99 (48328 in chips) 
Seat 6: SolidYerna (179760 in chips) 
Seat 7: Dominosu (346960 in chips) 
Seat 8: mazzy4629 (17625 in chips) 
Bigprad: posts the ante 500
martincho186: posts the ante 500
kuenne71: posts the ante 500
Equinox616: posts the ante 500
gladiatore99: posts the ante 500
SolidYerna: posts the ante 500
Dominosu: posts the ante 500
mazzy4629: posts the ante 500
Equinox616: posts small blind 2000
gladiatore99: posts big blind 4000
*** HOLE CARDS ***
SolidYerna: folds 
Dominosu: folds 
mazzy4629: folds 
Bigprad: raises 46444 to 50444 and is all-in
martincho186: folds 
kuenne71: folds 
Equinox616: raises 9917 to 60361 and is all-in
gladiatore99: folds 
Uncalled bet (9917) returned to Equinox616
*** FLOP *** [4h 5d As]
*** TURN *** [4h 5d As] [Qc]
*** RIVER *** [4h 5d As Qc] [5s]
*** SHOW DOWN ***
Equinox616: shows [9h Ac] (two pair, Aces and Fives)
Bigprad: shows [Qh Ah] (two pair, Aces and Queens)
Bigprad collected 108888 from pot
*** SUMMARY ***
Total pot 108888 | Rake 0 
Board [4h 5d As Qc 5s]
Seat 1: Bigprad showed [Qh Ah] and won (108888) with two pair, Aces and Queens
Seat 2: martincho186 folded before Flop (didn't bet)
Seat 3: kuenne71 (button) folded before Flop (didn't bet)
Seat 4: Equinox616 (small blind) showed [9h Ac] and lost with two pair, Aces and Fives
Seat 5: gladiatore99 (big blind) folded before Flop
Seat 6: SolidYerna folded before Flop (didn't bet)
Seat 7: Dominosu folded before Flop (didn't bet)
Seat 8: mazzy4629 folded before Flop (didn't bet)

PokerStars Hand #251206836302: Tournament #3767885527, $40+$10+$5 USD Hold'em No Limit - Level XVIII (2000/4000) - 2024/06/26 20:22:36 UTC [2024/06/26 16:22:36 ET]
Table '3767885527 34' 8-max Seat #4 is the button
Seat 1: Bigprad (108888 in chips) 
Seat 2: martincho186 (67440 in chips) 
Seat 3: kuenne71 (131021 in chips) 
Seat 4: Equinox616 (9917 in chips) 
Seat 5: gladiatore99 (43828 in chips) 
Seat 6: SolidYerna (179260 in chips) 
Seat 7: Dominosu (346460 in chips) 
Seat 8: mazzy4629 (17125 in chips) 
Bigprad: posts the ante 500
martincho186: posts the ante 500
kuenne71: posts the ante 500
Equinox616: posts the ante 500
gladiatore99: posts the ante 500
SolidYerna: posts the ante 500
Dominosu: posts the ante 500
mazzy4629: posts the ante 500
gladiatore99: posts small blind 2000
SolidYerna: posts big blind 4000
*** HOLE CARDS ***
Dominosu: folds 
mazzy4629: folds 
Bigprad: folds 
martincho186: folds 
kuenne71: folds 
Equinox616: raises 5417 to 9417 and is all-in
gladiatore99: calls 7417
SolidYerna: folds 
*** FLOP *** [Qd 4h 9d]
*** TURN *** [Qd 4h 9d] [Qh]
*** RIVER *** [Qd 4h 9d Qh] [8h]
*** SHOW DOWN ***
gladiatore99: shows [Ah Ac] (two pair, Aces and Queens)
Equinox616: shows [6h 7h] (a flush, Queen high)
Equinox616 collected 26834 from pot
*** SUMMARY ***
Total pot 26834 | Rake 0 
Board [Qd 4h 9d Qh 8h]
Seat 1: Bigprad folded before Flop (didn't bet)
Seat 2: martincho186 folded before Flop (didn't bet)
Seat 3: kuenne71 folded before Flop (didn't bet)
Seat 4: Equinox616 (button) showed [6h 7h] and won (26834) with a flush, Queen high
Seat 5: gladiatore99 (small blind) showed [Ah Ac] and lost with two pair, Aces and Queens
Seat 6: SolidYerna (big blind) folded before Flop
Seat 7: Dominosu folded before Flop (didn't bet)
Seat 8: mazzy4629 folded before Flop (didn't bet)

PokerStars Hand #251206847393: Tournament #3767885527, $40+$10+$5 USD Hold'em No Limit - Level XVIII (2000/4000) - 2024/06/26 20:23:16 UTC [2024/06/26 16:23:16 ET]
Table '3767885527 34' 8-max Seat #5 is the button
Seat 1: Bigprad (108388 in chips) 
Seat 2: martincho186 (66940 in chips) 
Seat 3: kuenne71 (130521 in chips) 
Seat 4: Equinox616 (26834 in chips) 
Seat 5: gladiatore99 (33911 in chips) 
Seat 6: SolidYerna (174760 in chips) 
Seat 7: Dominosu (345960 in chips) 
Seat 8: mazzy4629 (16625 in chips) 
Bigprad: posts the ante 500
martincho186: posts the ante 500
kuenne71: posts the ante 500
Equinox616: posts the ante 500
gladiatore99: posts the ante 500
SolidYerna: posts the ante 500
Dominosu: posts the ante 500
mazzy4629: posts the ante 500
SolidYerna: posts small blind 2000
Dominosu: posts big blind 4000
*** HOLE CARDS ***
mazzy4629: raises 12125 to 16125 and is all-in
Bigprad: folds 
martincho186: folds 
kuenne71: folds 
Equinox616: folds 
gladiatore99: folds 
SolidYerna: folds 
Dominosu has timed out
Dominosu: folds 
Dominosu is sitting out
Uncalled bet (12125) returned to mazzy4629
Dominosu has returned
mazzy4629 collected 14000 from pot
*** SUMMARY ***
Total pot 14000 | Rake 0 
Seat 1: Bigprad folded before Flop (didn't bet)
Seat 2: martincho186 folded before Flop (didn't bet)
Seat 3: kuenne71 folded before Flop (didn't bet)
Seat 4: Equinox616 folded before Flop (didn't bet)
Seat 5: gladiatore99 (button) folded before Flop (didn't bet)
Seat 6: SolidYerna (small blind) folded before Flop
Seat 7: Dominosu (big blind) folded before Flop
Seat 8: mazzy4629 collected (14000)

PokerStars Hand #251206856352: Tournament #3767885527, $40+$10+$5 USD Hold'em No Limit - Level XVIII (2000/4000) - 2024/06/26 20:23:48 UTC [2024/06/26 16:23:48 ET]
Table '3767885527 34' 8-max Seat #6 is the button
Seat 1: Bigprad (107888 in chips) 
Seat 2: martincho186 (66440 in chips) 
Seat 3: kuenne71 (130021 in chips) 
Seat 4: Equinox616 (26334 in chips) 
Seat 5: gladiatore99 (33411 in chips) 
Seat 6: SolidYerna (172260 in chips) 
Seat 7: Dominosu (341460 in chips) 
Seat 8: mazzy4629 (26125 in chips) 
Bigprad: posts the ante 500
martincho186: posts the ante 500
kuenne71: posts the ante 500
Equinox616: posts the ante 500
gladiatore99: posts the ante 500
SolidYerna: posts the ante 500
Dominosu: posts the ante 500
mazzy4629: posts the ante 500
Dominosu: posts small blind 2000
mazzy4629: posts big blind 4000
*** HOLE CARDS ***
Bigprad: raises 4000 to 8000
martincho186: folds 
kuenne71: calls 8000
Equinox616: folds 
gladiatore99: folds 
SolidYerna: folds 
Dominosu: folds 
mazzy4629: calls 4000
*** FLOP *** [5d 8c Ah]
mazzy4629: checks 
Bigprad: bets 30000
kuenne71: calls 30000
mazzy4629: folds 
*** TURN *** [5d 8c Ah] [2d]
Bigprad: bets 69388 and is all-in
kuenne71: calls 69388
*** RIVER *** [5d 8c Ah 2d] [Jc]
*** SHOW DOWN ***
Bigprad: shows [5c Ac] (two pair, Aces and Fives)
kuenne71: shows [Td Ad] (a pair of Aces)
Bigprad collected 228776 from pot
*** SUMMARY ***
Total pot 228776 | Rake 0 
Board [5d 8c Ah 2d Jc]
Seat 1: Bigprad showed [5c Ac] and won (228776) with two pair, Aces and Fives
Seat 2: martincho186 folded before Flop (didn't bet)
Seat 3: kuenne71 showed [Td Ad] and lost with a pair of Aces
Seat 4: Equinox616 folded before Flop (didn't bet)
Seat 5: gladiatore99 folded before Flop (didn't bet)
Seat 6: SolidYerna (button) folded before Flop (didn't bet)
Seat 7: Dominosu (small blind) folded before Flop
Seat 8: mazzy4629 (big blind) folded on the Flop

PokerStars Hand #251206868087: Tournament #3767885527, $40+$10+$5 USD Hold'em No Limit - Level XVIII (2000/4000) - 2024/06/26 20:24:29 UTC [2024/06/26 16:24:29 ET]
Table '3767885527 34' 8-max Seat #7 is the button
Seat 1: Bigprad (228776 in chips) 
Seat 2: martincho186 (65940 in chips) 
Seat 3: kuenne71 (22133 in chips) 
Seat 4: Equinox616 (25834 in chips) 
Seat 5: gladiatore99 (32911 in chips) 
Seat 6: SolidYerna (171760 in chips) 
Seat 7: Dominosu (338960 in chips) 
Seat 8: mazzy4629 (17625 in chips) 
Bigprad: posts the ante 500
martincho186: posts the ante 500
kuenne71: posts the ante 500
Equinox616: posts the ante 500
gladiatore99: posts the ante 500
SolidYerna: posts the ante 500
Dominosu: posts the ante 500
mazzy4629: posts the ante 500
mazzy4629: posts small blind 2000
Bigprad: posts big blind 4000
*** HOLE CARDS ***
martincho186: folds 
kuenne71: raises 17633 to 21633 and is all-in
Equinox616: folds 
gladiatore99: folds 
SolidYerna: folds 
Dominosu: folds 
mazzy4629: folds 
Bigprad: calls 17633
*** FLOP *** [Kd 8h 5c]
*** TURN *** [Kd 8h 5c] [6h]
*** RIVER *** [Kd 8h 5c 6h] [9d]
*** SHOW DOWN ***
Bigprad: shows [Ts Td] (a pair of Tens)
kuenne71: shows [Tc Kc] (a pair of Kings)
kuenne71 collected 49266 from pot
*** SUMMARY ***
Total pot 49266 | Rake 0 
Board [Kd 8h 5c 6h 9d]
Seat 1: Bigprad (big blind) showed [Ts Td] and lost with a pair of Tens
Seat 2: martincho186 folded before Flop (didn't bet)
Seat 3: kuenne71 showed [Tc Kc] and won (49266) with a pair of Kings
Seat 4: Equinox616 folded before Flop (didn't bet)
Seat 5: gladiatore99 folded before Flop (didn't bet)
Seat 6: SolidYerna folded before Flop (didn't bet)
Seat 7: Dominosu (button) folded before Flop (didn't bet)
Seat 8: mazzy4629 (small blind) folded before Flop

PokerStars Hand #251206875512: Tournament #3767885527, $40+$10+$5 USD Hold'em No Limit - Level XVIII (2000/4000) - 2024/06/26 20:24:56 UTC [2024/06/26 16:24:56 ET]
Table '3767885527 34' 8-max Seat #8 is the button
Seat 1: Bigprad (206643 in chips) 
Seat 2: martincho186 (65440 in chips) 
Seat 3: kuenne71 (49266 in chips) 
Seat 4: Equinox616 (25334 in chips) 
Seat 5: gladiatore99 (32411 in chips) 
Seat 6: SolidYerna (171260 in chips) 
Seat 7: Dominosu (338460 in chips) 
Seat 8: mazzy4629 (15125 in chips) 
Bigprad: posts the ante 500
martincho186: posts the ante 500
kuenne71: posts the ante 500
Equinox616: posts the ante 500
gladiatore99: posts the ante 500
SolidYerna: posts the ante 500
Dominosu: posts the ante 500
mazzy4629: posts the ante 500
Bigprad: posts small blind 2000
martincho186: posts big blind 4000
*** HOLE CARDS ***
kuenne71: folds 
Equinox616: folds 
gladiatore99: folds 
SolidYerna: folds 
Dominosu: raises 4800 to 8800
mazzy4629: folds 
Bigprad: folds 
martincho186: calls 4800
*** FLOP *** [7s 8d 4h]
martincho186: checks 
Dominosu: bets 7788
martincho186: raises 48352 to 56140 and is all-in
Dominosu: folds 
Uncalled bet (48352) returned to martincho186
martincho186 collected 39176 from pot
*** SUMMARY ***
Total pot 39176 | Rake 0 
Board [7s 8d 4h]
Seat 1: Bigprad (small blind) folded before Flop
Seat 2: martincho186 (big blind) collected (39176)
Seat 3: kuenne71 folded before Flop (didn't bet)
Seat 4: Equinox616 folded before Flop (didn't bet)
Seat 5: gladiatore99 folded before Flop (didn't bet)
Seat 6: SolidYerna folded before Flop (didn't bet)
Seat 7: Dominosu folded on the Flop
Seat 8: mazzy4629 (button) folded before Flop (didn't bet)

PokerStars Hand #251206889937: Tournament #3767885527, $40+$10+$5 USD Hold'em No Limit - Level XVIII (2000/4000) - 2024/06/26 20:25:48 UTC [2024/06/26 16:25:48 ET]
Table '3767885527 34' 8-max Seat #1 is the button
Seat 1: Bigprad (204143 in chips) 
Seat 2: martincho186 (87528 in chips) 
Seat 3: kuenne71 (48766 in chips) 
Seat 4: Equinox616 (24834 in chips) 
Seat 5: gladiatore99 (31911 in chips) 
Seat 6: SolidYerna (170760 in chips) 
Seat 7: Dominosu (321372 in chips) 
Seat 8: mazzy4629 (14625 in chips) 
Bigprad: posts the ante 500
martincho186: posts the ante 500
kuenne71: posts the ante 500
Equinox616: posts the ante 500
gladiatore99: posts the ante 500
SolidYerna: posts the ante 500
Dominosu: posts the ante 500
mazzy4629: posts the ante 500
martincho186: posts small blind 2000
kuenne71: posts big blind 4000
*** HOLE CARDS ***
Equinox616: folds 
gladiatore99: folds 
SolidYerna: raises 4400 to 8400
Dominosu: folds 
mazzy4629: folds 
Bigprad: folds 
martincho186: folds 
kuenne71: calls 4400
*** FLOP *** [6c 4c Jd]
kuenne71: checks 
SolidYerna: checks 
*** TURN *** [6c 4c Jd] [Ad]
kuenne71: checks 
SolidYerna: bets 4000
kuenne71: folds 
Uncalled bet (4000) returned to SolidYerna
SolidYerna collected 22800 from pot
SolidYerna: doesn't show hand 
*** SUMMARY ***
Total pot 22800 | Rake 0 
Board [6c 4c Jd Ad]
Seat 1: Bigprad (button) folded before Flop (didn't bet)
Seat 2: martincho186 (small blind) folded before Flop
Seat 3: kuenne71 (big blind) folded on the Turn
Seat 4: Equinox616 folded before Flop (didn't bet)
Seat 5: gladiatore99 folded before Flop (didn't bet)
Seat 6: SolidYerna collected (22800)
Seat 7: Dominosu folded before Flop (didn't bet)
Seat 8: mazzy4629 folded before Flop (didn't bet)

PokerStars Hand #251206902688: Tournament #3767885527, $40+$10+$5 USD Hold'em No Limit - Level XIX (2500/5000) - 2024/06/26 20:26:33 UTC [2024/06/26 16:26:33 ET]
Table '3767885527 34' 8-max Seat #2 is the button
Seat 1: Bigprad (203643 in chips) 
Seat 2: martincho186 (85028 in chips) 
Seat 3: kuenne71 (39866 in chips) 
Seat 4: Equinox616 (24334 in chips) 
Seat 5: gladiatore99 (31411 in chips) 
Seat 6: SolidYerna (184660 in chips) 
Seat 7: Dominosu (320872 in chips) 
Seat 8: mazzy4629 (14125 in chips) 
Bigprad: posts the ante 625
martincho186: posts the ante 625
kuenne71: posts the ante 625
Equinox616: posts the ante 625
gladiatore99: posts the ante 625
SolidYerna: posts the ante 625
Dominosu: posts the ante 625
mazzy4629: posts the ante 625
kuenne71: posts small blind 2500
Equinox616: posts big blind 5000
*** HOLE CARDS ***
gladiatore99: folds 
SolidYerna: raises 5500 to 10500
Dominosu: folds 
mazzy4629: folds 
Bigprad: folds 
martincho186: folds 
kuenne71: folds 
Equinox616: folds 
Uncalled bet (5500) returned to SolidYerna
SolidYerna collected 17500 from pot
SolidYerna: doesn't show hand 
*** SUMMARY ***
Total pot 17500 | Rake 0 
Seat 1: Bigprad folded before Flop (didn't bet)
Seat 2: martincho186 (button) folded before Flop (didn't bet)
Seat 3: kuenne71 (small blind) folded before Flop
Seat 4: Equinox616 (big blind) folded before Flop
Seat 5: gladiatore99 folded before Flop (didn't bet)
Seat 6: SolidYerna collected (17500)
Seat 7: Dominosu folded before Flop (didn't bet)
Seat 8: mazzy4629 folded before Flop (didn't bet)

PokerStars Hand #251206909304: Tournament #3767885527, $40+$10+$5 USD Hold'em No Limit - Level XIX (2500/5000) - 2024/06/26 20:26:57 UTC [2024/06/26 16:26:57 ET]
Table '3767885527 34' 8-max Seat #3 is the button
Seat 1: Bigprad (203018 in chips) 
Seat 2: martincho186 (84403 in chips) 
Seat 3: kuenne71 (36741 in chips) 
Seat 4: Equinox616 (18709 in chips) 
Seat 5: gladiatore99 (30786 in chips) 
Seat 6: SolidYerna (196535 in chips) 
Seat 7: Dominosu (320247 in chips) 
Seat 8: mazzy4629 (13500 in chips) 
Bigprad: posts the ante 625
martincho186: posts the ante 625
kuenne71: posts the ante 625
Equinox616: posts the ante 625
gladiatore99: posts the ante 625
SolidYerna: posts the ante 625
Dominosu: posts the ante 625
mazzy4629: posts the ante 625
Equinox616: posts small blind 2500
gladiatore99: posts big blind 5000
*** HOLE CARDS ***
SolidYerna: raises 5500 to 10500
Dominosu: folds 
mazzy4629: folds 
Bigprad: folds 
martincho186: folds 
kuenne71: folds 
Equinox616: folds 
gladiatore99: raises 19661 to 30161 and is all-in
SolidYerna: calls 19661
*** FLOP *** [Jc Qd 2s]
*** TURN *** [Jc Qd 2s] [Td]
*** RIVER *** [Jc Qd 2s Td] [5s]
*** SHOW DOWN ***
gladiatore99: shows [As Jh] (a pair of Jacks)
SolidYerna: shows [Ac 5c] (a pair of Fives)
gladiatore99 collected 67822 from pot
*** SUMMARY ***
Total pot 67822 | Rake 0 
Board [Jc Qd 2s Td 5s]
Seat 1: Bigprad folded before Flop (didn't bet)
Seat 2: martincho186 folded before Flop (didn't bet)
Seat 3: kuenne71 (button) folded before Flop (didn't bet)
Seat 4: Equinox616 (small blind) folded before Flop
Seat 5: gladiatore99 (big blind) showed [As Jh] and won (67822) with a pair of Jacks
Seat 6: SolidYerna showed [Ac 5c] and lost with a pair of Fives
Seat 7: Dominosu folded before Flop (didn't bet)
Seat 8: mazzy4629 folded before Flop (didn't bet)

PokerStars Hand #251206922196: Tournament #3767885527, $40+$10+$5 USD Hold'em No Limit - Level XIX (2500/5000) - 2024/06/26 20:27:43 UTC [2024/06/26 16:27:43 ET]
Table '3767885527 34' 8-max Seat #4 is the button
Seat 1: Bigprad (202393 in chips) 
Seat 2: martincho186 (83778 in chips) 
Seat 3: kuenne71 (36116 in chips) 
Seat 4: Equinox616 (15584 in chips) 
Seat 5: gladiatore99 (67822 in chips) 
Seat 6: SolidYerna (165749 in chips) 
Seat 7: Dominosu (319622 in chips) 
Seat 8: mazzy4629 (12875 in chips) 
Bigprad: posts the ante 625
martincho186: posts the ante 625
kuenne71: posts the ante 625
Equinox616: posts the ante 625
gladiatore99: posts the ante 625
SolidYerna: posts the ante 625
Dominosu: posts the ante 625
mazzy4629: posts the ante 625
gladiatore99: posts small blind 2500
SolidYerna: posts big blind 5000
*** HOLE CARDS ***
Dominosu: folds 
mazzy4629: raises 7250 to 12250 and is all-in
Bigprad: folds 
martincho186: folds 
kuenne71: folds 
Equinox616: folds 
gladiatore99: raises 54947 to 67197 and is all-in
SolidYerna: folds 
Uncalled bet (54947) returned to gladiatore99
*** FLOP *** [Qs 6h Tc]
*** TURN *** [Qs 6h Tc] [Qc]
*** RIVER *** [Qs 6h Tc Qc] [Ts]
*** SHOW DOWN ***
gladiatore99: shows [5d Ad] (two pair, Queens and Tens)
mazzy4629: shows [Js Qd] (a full house, Queens full of Tens)
mazzy4629 collected 34500 from pot
*** SUMMARY ***
Total pot 34500 | Rake 0 
Board [Qs 6h Tc Qc Ts]
Seat 1: Bigprad folded before Flop (didn't bet)
Seat 2: martincho186 folded before Flop (didn't bet)
Seat 3: kuenne71 folded before Flop (didn't bet)
Seat 4: Equinox616 (button) folded before Flop (didn't bet)
Seat 5: gladiatore99 (small blind) showed [5d Ad] and lost with two pair, Queens and Tens
Seat 6: SolidYerna (big blind) folded before Flop
Seat 7: Dominosu folded before Flop (didn't bet)
Seat 8: mazzy4629 showed [Js Qd] and won (34500) with a full house, Queens full of Tens

PokerStars Hand #251206930046: Tournament #3767885527, $40+$10+$5 USD Hold'em No Limit - Level XIX (2500/5000) - 2024/06/26 20:28:11 UTC [2024/06/26 16:28:11 ET]
Table '3767885527 34' 8-max Seat #5 is the button
Seat 1: Bigprad (201768 in chips) 
Seat 2: martincho186 (83153 in chips) 
Seat 3: kuenne71 (35491 in chips) 
Seat 4: Equinox616 (14959 in chips) 
Seat 5: gladiatore99 (54947 in chips) 
Seat 6: SolidYerna (160124 in chips) 
Seat 7: Dominosu (318997 in chips) 
Seat 8: mazzy4629 (34500 in chips) 
Bigprad: posts the ante 625
martincho186: posts the ante 625
kuenne71: posts the ante 625
Equinox616: posts the ante 625
gladiatore99: posts the ante 625
SolidYerna: posts the ante 625
Dominosu: posts the ante 625
mazzy4629: posts the ante 625
SolidYerna: posts small blind 2500
Dominosu: posts big blind 5000
*** HOLE CARDS ***
mazzy4629: folds 
Bigprad: raises 5000 to 10000
martincho186: folds 
kuenne71: folds 
Equinox616: folds 
gladiatore99: folds 
SolidYerna: folds 
Dominosu: calls 5000
*** FLOP *** [Kd 3h 8c]
Dominosu: checks 
Bigprad: bets 10000
Dominosu: folds 
Uncalled bet (10000) returned to Bigprad
Bigprad collected 27500 from pot
*** SUMMARY ***
Total pot 27500 | Rake 0 
Board [Kd 3h 8c]
Seat 1: Bigprad collected (27500)
Seat 2: martincho186 folded before Flop (didn't bet)
Seat 3: kuenne71 folded before Flop (didn't bet)
Seat 4: Equinox616 folded before Flop (didn't bet)
Seat 5: gladiatore99 (button) folded before Flop (didn't bet)
Seat 6: SolidYerna (small blind) folded before Flop
Seat 7: Dominosu (big blind) folded on the Flop
Seat 8: mazzy4629 folded before Flop (didn't bet)

PokerStars Hand #251206937030: Tournament #3767885527, $40+$10+$5 USD Hold'em No Limit - Level XIX (2500/5000) - 2024/06/26 20:28:36 UTC [2024/06/26 16:28:36 ET]
Table '3767885527 34' 8-max Seat #6 is the button
Seat 1: Bigprad (218643 in chips) 
Seat 2: martincho186 (82528 in chips) 
Seat 3: kuenne71 (34866 in chips) 
Seat 4: Equinox616 (14334 in chips) 
Seat 5: gladiatore99 (54322 in chips) 
Seat 6: SolidYerna (156999 in chips) 
Seat 7: Dominosu (308372 in chips) 
Seat 8: mazzy4629 (33875 in chips) 
Bigprad: posts the ante 625
martincho186: posts the ante 625
kuenne71: posts the ante 625
Equinox616: posts the ante 625
gladiatore99: posts the ante 625
SolidYerna: posts the ante 625
Dominosu: posts the ante 625
mazzy4629: posts the ante 625
Dominosu: posts small blind 2500
mazzy4629: posts big blind 5000
*** HOLE CARDS ***
Bigprad: folds 
martincho186: folds 
kuenne71: folds 
Equinox616: folds 
gladiatore99: folds 
SolidYerna: raises 7500 to 12500
Dominosu: folds 
mazzy4629: folds 
Uncalled bet (7500) returned to SolidYerna
SolidYerna collected 17500 from pot
SolidYerna: doesn't show hand 
*** SUMMARY ***
Total pot 17500 | Rake 0 
Seat 1: Bigprad folded before Flop (didn't bet)
Seat 2: martincho186 folded before Flop (didn't bet)
Seat 3: kuenne71 folded before Flop (didn't bet)
Seat 4: Equinox616 folded before Flop (didn't bet)
Seat 5: gladiatore99 folded before Flop (didn't bet)
Seat 6: SolidYerna (button) collected (17500)
Seat 7: Dominosu (small blind) folded before Flop
Seat 8: mazzy4629 (big blind) folded before Flop

PokerStars Hand #251206947613: Tournament #3767885527, $40+$10+$5 USD Hold'em No Limit - Level XIX (2500/5000) - 2024/06/26 20:29:15 UTC [2024/06/26 16:29:15 ET]
Table '3767885527 34' 8-max Seat #7 is the button
Seat 1: Bigprad (218018 in chips) 
Seat 2: martincho186 (81903 in chips) 
Seat 3: kuenne71 (34241 in chips) 
Seat 4: Equinox616 (13709 in chips) 
Seat 5: gladiatore99 (53697 in chips) 
Seat 6: SolidYerna (168874 in chips) 
Seat 7: Dominosu (305247 in chips) 
Seat 8: mazzy4629 (28250 in chips) 
Bigprad: posts the ante 625
martincho186: posts the ante 625
kuenne71: posts the ante 625
Equinox616: posts the ante 625
gladiatore99: posts the ante 625
SolidYerna: posts the ante 625
Dominosu: posts the ante 625
mazzy4629: posts the ante 625
mazzy4629: posts small blind 2500
Bigprad: posts big blind 5000
*** HOLE CARDS ***
martincho186: folds 
kuenne71: folds 
Equinox616: folds 
gladiatore99: folds 
SolidYerna: raises 5500 to 10500
Dominosu: folds 
mazzy4629: folds 
Bigprad: folds 
Uncalled bet (5500) returned to SolidYerna
SolidYerna collected 17500 from pot
SolidYerna: doesn't show hand 
*** SUMMARY ***
Total pot 17500 | Rake 0 
Seat 1: Bigprad (big blind) folded before Flop
Seat 2: martincho186 folded before Flop (didn't bet)
Seat 3: kuenne71 folded before Flop (didn't bet)
Seat 4: Equinox616 folded before Flop (didn't bet)
Seat 5: gladiatore99 folded before Flop (didn't bet)
Seat 6: SolidYerna collected (17500)
Seat 7: Dominosu (button) folded before Flop (didn't bet)
Seat 8: mazzy4629 (small blind) folded before Flop

PokerStars Hand #251206952447: Tournament #3767885527, $40+$10+$5 USD Hold'em No Limit - Level XIX (2500/5000) - 2024/06/26 20:29:33 UTC [2024/06/26 16:29:33 ET]
Table '3767885527 34' 8-max Seat #8 is the button
Seat 1: Bigprad (212393 in chips) 
Seat 2: martincho186 (81278 in chips) 
Seat 3: kuenne71 (33616 in chips) 
Seat 4: Equinox616 (13084 in chips) 
Seat 5: gladiatore99 (53072 in chips) 
Seat 6: SolidYerna (180749 in chips) 
Seat 7: Dominosu (304622 in chips) 
Seat 8: mazzy4629 (25125 in chips) 
Bigprad: posts the ante 625
martincho186: posts the ante 625
kuenne71: posts the ante 625
Equinox616: posts the ante 625
gladiatore99: posts the ante 625
SolidYerna: posts the ante 625
Dominosu: posts the ante 625
mazzy4629: posts the ante 625
Bigprad: posts small blind 2500
martincho186: posts big blind 5000
*** HOLE CARDS ***
kuenne71: folds 
Equinox616 has timed out
Equinox616: folds 
Equinox616 is sitting out
gladiatore99: folds 
Equinox616 has returned
SolidYerna: folds 
Dominosu: raises 6000 to 11000
mazzy4629: folds 
Bigprad: folds 
martincho186: folds 
Uncalled bet (6000) returned to Dominosu
Dominosu collected 17500 from pot
Dominosu: doesn't show hand 
*** SUMMARY ***
Total pot 17500 | Rake 0 
Seat 1: Bigprad (small blind) folded before Flop
Seat 2: martincho186 (big blind) folded before Flop
Seat 3: kuenne71 folded before Flop (didn't bet)
Seat 4: Equinox616 folded before Flop (didn't bet)
Seat 5: gladiatore99 folded before Flop (didn't bet)
Seat 6: SolidYerna folded before Flop (didn't bet)
Seat 7: Dominosu collected (17500)
Seat 8: mazzy4629 (button) folded before Flop (didn't bet)

PokerStars Hand #251206974574: Tournament #3767885527, $40+$10+$5 USD Hold'em No Limit - Level XIX (2500/5000) - 2024/06/26 20:30:53 UTC [2024/06/26 16:30:53 ET]
Table '3767885527 34' 8-max Seat #1 is the button
Seat 1: Bigprad (209268 in chips) 
Seat 2: martincho186 (75653 in chips) 
Seat 3: kuenne71 (32991 in chips) 
Seat 4: Equinox616 (12459 in chips) 
Seat 5: gladiatore99 (52447 in chips) 
Seat 6: SolidYerna (180124 in chips) 
Seat 7: Dominosu (316497 in chips) 
Seat 8: mazzy4629 (24500 in chips) 
Bigprad: posts the ante 625
martincho186: posts the ante 625
kuenne71: posts the ante 625
Equinox616: posts the ante 625
gladiatore99: posts the ante 625
SolidYerna: posts the ante 625
Dominosu: posts the ante 625
mazzy4629: posts the ante 625
martincho186: posts small blind 2500
kuenne71: posts big blind 5000
*** HOLE CARDS ***
Equinox616 has timed out
Equinox616: folds 
Equinox616 is sitting out
gladiatore99: folds 
SolidYerna: raises 5500 to 10500
Dominosu: folds 
mazzy4629: folds 
Bigprad: calls 10500
martincho186: folds 
kuenne71: calls 5500
*** FLOP *** [Jd 7d Kc]
kuenne71: checks 
SolidYerna: checks 
Bigprad: checks 
*** TURN *** [Jd 7d Kc] [5c]
kuenne71: checks 
SolidYerna: checks 
Bigprad: checks 
*** RIVER *** [Jd 7d Kc 5c] [2c]
kuenne71: checks 
Equinox616 has returned
SolidYerna: checks 
Bigprad: checks 
*** SHOW DOWN ***
kuenne71: shows [7h 8s] (a pair of Sevens)
SolidYerna: mucks hand 
Bigprad: mucks hand 
kuenne71 collected 39000 from pot
*** SUMMARY ***
Total pot 39000 | Rake 0 
Board [Jd 7d Kc 5c 2c]
Seat 1: Bigprad (button) mucked
Seat 2: martincho186 (small blind) folded before Flop
Seat 3: kuenne71 (big blind) showed [7h 8s] and won (39000) with a pair of Sevens
Seat 4: Equinox616 folded before Flop (didn't bet)
Seat 5: gladiatore99 folded before Flop (didn't bet)
Seat 6: SolidYerna mucked
Seat 7: Dominosu folded before Flop (didn't bet)
Seat 8: mazzy4629 folded before Flop (didn't bet)

PokerStars Hand #251206990927: Tournament #3767885527, $40+$10+$5 USD Hold'em No Limit - Level XIX (2500/5000) - 2024/06/26 20:31:51 UTC [2024/06/26 16:31:51 ET]
Table '3767885527 34' 8-max Seat #2 is the button
Seat 1: Bigprad (198143 in chips) 
Seat 2: martincho186 (72528 in chips) 
Seat 3: kuenne71 (60866 in chips) 
Seat 4: Equinox616 (11834 in chips) 
Seat 5: gladiatore99 (51822 in chips) 
Seat 6: SolidYerna (168999 in chips) 
Seat 7: Dominosu (315872 in chips) 
Seat 8: mazzy4629 (23875 in chips) 
Bigprad: posts the ante 625
martincho186: posts the ante 625
kuenne71: posts the ante 625
Equinox616: posts the ante 625
gladiatore99: posts the ante 625
SolidYerna: posts the ante 625
Dominosu: posts the ante 625
mazzy4629: posts the ante 625
kuenne71: posts small blind 2500
Equinox616: posts big blind 5000
*** HOLE CARDS ***
gladiatore99: folds 
SolidYerna: folds 
Dominosu: folds 
mazzy4629: folds 
Bigprad: folds 
martincho186: folds 
kuenne71: raises 10000 to 15000
Equinox616: calls 6209 and is all-in
Uncalled bet (3791) returned to kuenne71
*** FLOP *** [2h Jc 8s]
*** TURN *** [2h Jc 8s] [Js]
*** RIVER *** [2h Jc 8s Js] [8c]
*** SHOW DOWN ***
kuenne71: shows [Jh Qc] (a full house, Jacks full of Eights)
Equinox616: shows [9c Ac] (two pair, Jacks and Eights)
kuenne71 collected 27418 from pot
Equinox616 finished the tournament in 305th place
*** SUMMARY ***
Total pot 27418 | Rake 0 
Board [2h Jc 8s Js 8c]
Seat 1: Bigprad folded before Flop (didn't bet)
Seat 2: martincho186 (button) folded before Flop (didn't bet)
Seat 3: kuenne71 (small blind) showed [Jh Qc] and won (27418) with a full house, Jacks full of Eights
Seat 4: Equinox616 (big blind) showed [9c Ac] and lost with two pair, Jacks and Eights
Seat 5: gladiatore99 folded before Flop (didn't bet)
Seat 6: SolidYerna folded before Flop (didn't bet)
Seat 7: Dominosu folded before Flop (didn't bet)
Seat 8: mazzy4629 folded before Flop (didn't bet)
