PokerStars Hand #251209365060: Tournament #3769361908, $52.38+$2.62 USD Hold'em No Limit - Level VII (100/200) - 2024/06/26 22:21:25 UTC [2024/06/26 18:21:25 ET]
Table '3769361908 9' 6-max Seat #5 is the button
Seat 1: jerdno0 (10276 in chips) 
Seat 2: Jessigfilho (9920 in chips) 
Seat 3: 77.danielw (10571 in chips) 
Seat 4: quimmixxx (12418 in chips) 
Seat 5: lintumies12 (9315 in chips) 
Seat 6: gwallgofddyn (29191 in chips) 
jerdno0: posts the ante 50
Jessigfilho: posts the ante 50
77.danielw: posts the ante 50
quimmixxx: posts the ante 50
lintumies12: posts the ante 50
gwallgofddyn: posts the ante 50
gwallgofddyn: posts small blind 100
jerdno0: posts big blind 200
*** HOLE CARDS ***
Jessigfilho: raises 200 to 400
77.danielw: raises 1000 to 1400
quimmixxx: folds 
lintumies12: folds 
gwallgofddyn: raises 27741 to 29141 and is all-in
jerdno0: folds 
Jessigfilho: calls 9470 and is all-in
77.danielw: calls 9121 and is all-in
Uncalled bet (18620) returned to gwallgofddyn
*** FLOP *** [5s 7s 6d]
*** TURN *** [5s 7s 6d] [4s]
*** RIVER *** [5s 7s 6d 4s] [Tc]
*** SHOW DOWN ***
gwallgofddyn: shows [Kh As] (high card Ace)
77.danielw: shows [Ks Ad] (high card Ace)
gwallgofddyn collected 651 from side pot
77.danielw collected 651 from side pot
Jessigfilho: shows [Kd Ah] (high card Ace)
gwallgofddyn collected 10037 from main pot
Jessigfilho collected 10037 from main pot
77.danielw collected 10036 from main pot
*** SUMMARY ***
Total pot 31412 Main pot 30110. Side pot 1302. | Rake 0 
Board [5s 7s 6d 4s Tc]
Seat 1: jerdno0 (big blind) folded before Flop
Seat 2: Jessigfilho showed [Kd Ah] and won (10037) with high card Ace
Seat 3: 77.danielw showed [Ks Ad] and won (10687) with high card Ace
Seat 4: quimmixxx folded before Flop (didn't bet)
Seat 5: lintumies12 (button) folded before Flop (didn't bet)
Seat 6: gwallgofddyn (small blind) showed [Kh As] and won (10688) with high card Ace

PokerStars Hand #251209377102: Tournament #3769361908, $52.38+$2.62 USD Hold'em No Limit - Level VII (100/200) - 2024/06/26 22:22:08 UTC [2024/06/26 18:22:08 ET]
Table '3769361908 9' 6-max Seat #6 is the button
Seat 1: jerdno0 (10026 in chips) 
Seat 2: Jessigfilho (10037 in chips) 
Seat 3: 77.danielw (10687 in chips) 
Seat 4: quimmixxx (12368 in chips) 
Seat 5: lintumies12 (9265 in chips) 
Seat 6: gwallgofddyn (29308 in chips) 
jerdno0: posts the ante 50
Jessigfilho: posts the ante 50
77.danielw: posts the ante 50
quimmixxx: posts the ante 50
lintumies12: posts the ante 50
gwallgofddyn: posts the ante 50
jerdno0: posts small blind 100
Jessigfilho: posts big blind 200
*** HOLE CARDS ***
77.danielw: raises 200 to 400
quimmixxx: folds 
lintumies12: folds 
gwallgofddyn: folds 
jerdno0: calls 300
Jessigfilho: calls 200
*** FLOP *** [Kd 8s 9s]
jerdno0: checks 
Jessigfilho: checks 
77.danielw: bets 495
jerdno0: folds 
Jessigfilho: calls 495
*** TURN *** [Kd 8s 9s] [Kh]
Jessigfilho: checks 
77.danielw: bets 1843
Jessigfilho: calls 1843
*** RIVER *** [Kd 8s 9s Kh] [5c]
Jessigfilho: checks 
77.danielw: bets 2838
Jessigfilho: calls 2838
*** SHOW DOWN ***
77.danielw: shows [Kc Qd] (three of a kind, Kings)
Jessigfilho: mucks hand 
77.danielw collected 11852 from pot
*** SUMMARY ***
Total pot 11852 | Rake 0 
Board [Kd 8s 9s Kh 5c]
Seat 1: jerdno0 (small blind) folded on the Flop
Seat 2: Jessigfilho (big blind) mucked
Seat 3: 77.danielw showed [Kc Qd] and won (11852) with three of a kind, Kings
Seat 4: quimmixxx folded before Flop (didn't bet)
Seat 5: lintumies12 folded before Flop (didn't bet)
Seat 6: gwallgofddyn (button) folded before Flop (didn't bet)

PokerStars Hand #251209408560: Tournament #3769361908, $52.38+$2.62 USD Hold'em No Limit - Level VIII (125/250) - 2024/06/26 22:24:01 UTC [2024/06/26 18:24:01 ET]
Table '3769361908 9' 6-max Seat #1 is the button
Seat 1: jerdno0 (9576 in chips) 
Seat 2: Jessigfilho (4411 in chips) 
Seat 3: 77.danielw (16913 in chips) 
Seat 4: quimmixxx (12318 in chips) 
Seat 5: lintumies12 (9215 in chips) 
Seat 6: gwallgofddyn (29258 in chips) 
jerdno0: posts the ante 60
Jessigfilho: posts the ante 60
77.danielw: posts the ante 60
quimmixxx: posts the ante 60
lintumies12: posts the ante 60
gwallgofddyn: posts the ante 60
Jessigfilho: posts small blind 125
77.danielw: posts big blind 250
*** HOLE CARDS ***
quimmixxx: folds 
lintumies12: folds 
gwallgofddyn: folds 
jerdno0: calls 250
Jessigfilho: folds 
77.danielw: checks 
*** FLOP *** [5h As Ks]
77.danielw: checks 
jerdno0: bets 493
77.danielw: folds 
Uncalled bet (493) returned to jerdno0
jerdno0 collected 985 from pot
*** SUMMARY ***
Total pot 985 | Rake 0 
Board [5h As Ks]
Seat 1: jerdno0 (button) collected (985)
Seat 2: Jessigfilho (small blind) folded before Flop
Seat 3: 77.danielw (big blind) folded on the Flop
Seat 4: quimmixxx folded before Flop (didn't bet)
Seat 5: lintumies12 folded before Flop (didn't bet)
Seat 6: gwallgofddyn folded before Flop (didn't bet)

PokerStars Hand #251209420376: Tournament #3769361908, $52.38+$2.62 USD Hold'em No Limit - Level VIII (125/250) - 2024/06/26 22:24:44 UTC [2024/06/26 18:24:44 ET]
Table '3769361908 9' 6-max Seat #2 is the button
Seat 1: jerdno0 (10251 in chips) 
Seat 2: Jessigfilho (4226 in chips) 
Seat 3: 77.danielw (16603 in chips) 
Seat 4: quimmixxx (12258 in chips) 
Seat 5: lintumies12 (9155 in chips) 
Seat 6: gwallgofddyn (29198 in chips) 
jerdno0: posts the ante 60
Jessigfilho: posts the ante 60
77.danielw: posts the ante 60
quimmixxx: posts the ante 60
lintumies12: posts the ante 60
gwallgofddyn: posts the ante 60
77.danielw: posts small blind 125
quimmixxx: posts big blind 250
*** HOLE CARDS ***
lintumies12: folds 
gwallgofddyn: folds 
jerdno0: raises 250 to 500
Jessigfilho: folds 
77.danielw: folds 
quimmixxx: calls 250
*** FLOP *** [5s Qs Th]
quimmixxx: checks 
jerdno0: bets 743
quimmixxx: folds 
Uncalled bet (743) returned to jerdno0
jerdno0 collected 1485 from pot
*** SUMMARY ***
Total pot 1485 | Rake 0 
Board [5s Qs Th]
Seat 1: jerdno0 collected (1485)
Seat 2: Jessigfilho (button) folded before Flop (didn't bet)
Seat 3: 77.danielw (small blind) folded before Flop
Seat 4: quimmixxx (big blind) folded on the Flop
Seat 5: lintumies12 folded before Flop (didn't bet)
Seat 6: gwallgofddyn folded before Flop (didn't bet)

PokerStars Hand #251209431920: Tournament #3769361908, $52.38+$2.62 USD Hold'em No Limit - Level VIII (125/250) - 2024/06/26 22:25:25 UTC [2024/06/26 18:25:25 ET]
Table '3769361908 9' 6-max Seat #3 is the button
Seat 1: jerdno0 (11176 in chips) 
Seat 2: Jessigfilho (4166 in chips) 
Seat 3: 77.danielw (16418 in chips) 
Seat 4: quimmixxx (11698 in chips) 
Seat 5: lintumies12 (9095 in chips) 
Seat 6: gwallgofddyn (29138 in chips) 
jerdno0: posts the ante 60
Jessigfilho: posts the ante 60
77.danielw: posts the ante 60
quimmixxx: posts the ante 60
lintumies12: posts the ante 60
gwallgofddyn: posts the ante 60
quimmixxx: posts small blind 125
lintumies12: posts big blind 250
*** HOLE CARDS ***
gwallgofddyn: folds 
jerdno0: calls 250
Jessigfilho: folds 
77.danielw: folds 
quimmixxx: calls 125
lintumies12: checks 
*** FLOP *** [7c 6d 7h]
quimmixxx: checks 
lintumies12: checks 
jerdno0: bets 555
quimmixxx: folds 
lintumies12: folds 
Uncalled bet (555) returned to jerdno0
jerdno0 collected 1110 from pot
*** SUMMARY ***
Total pot 1110 | Rake 0 
Board [7c 6d 7h]
Seat 1: jerdno0 collected (1110)
Seat 2: Jessigfilho folded before Flop (didn't bet)
Seat 3: 77.danielw (button) folded before Flop (didn't bet)
Seat 4: quimmixxx (small blind) folded on the Flop
Seat 5: lintumies12 (big blind) folded on the Flop
Seat 6: gwallgofddyn folded before Flop (didn't bet)

PokerStars Hand #251209450432: Tournament #3769361908, $52.38+$2.62 USD Hold'em No Limit - Level IX (150/300) - 2024/06/26 22:26:32 UTC [2024/06/26 18:26:32 ET]
Table '3769361908 9' 6-max Seat #4 is the button
Seat 1: jerdno0 (11976 in chips) 
Seat 2: Jessigfilho (4106 in chips) 
Seat 3: 77.danielw (16358 in chips) 
Seat 4: quimmixxx (11388 in chips) 
Seat 5: lintumies12 (8785 in chips) 
Seat 6: gwallgofddyn (29078 in chips) 
jerdno0: posts the ante 75
Jessigfilho: posts the ante 75
77.danielw: posts the ante 75
quimmixxx: posts the ante 75
lintumies12: posts the ante 75
gwallgofddyn: posts the ante 75
lintumies12: posts small blind 150
gwallgofddyn: posts big blind 300
*** HOLE CARDS ***
jerdno0: folds 
Jessigfilho: raises 3731 to 4031 and is all-in
77.danielw: raises 12252 to 16283 and is all-in
quimmixxx: folds 
lintumies12: folds 
gwallgofddyn: folds 
Uncalled bet (12252) returned to 77.danielw
*** FLOP *** [6d 9s 7c]
*** TURN *** [6d 9s 7c] [4c]
*** RIVER *** [6d 9s 7c 4c] [5d]
*** SHOW DOWN ***
Jessigfilho: shows [Kd Jc] (high card King)
77.danielw: shows [Ah Kh] (high card Ace)
77.danielw collected 8962 from pot
Jessigfilho finished the tournament
*** SUMMARY ***
Total pot 8962 | Rake 0 
Board [6d 9s 7c 4c 5d]
Seat 1: jerdno0 folded before Flop (didn't bet)
Seat 2: Jessigfilho showed [Kd Jc] and lost with high card King
Seat 3: 77.danielw showed [Ah Kh] and won (8962) with high card Ace
Seat 4: quimmixxx (button) folded before Flop (didn't bet)
Seat 5: lintumies12 (small blind) folded before Flop
Seat 6: gwallgofddyn (big blind) folded before Flop

PokerStars Hand #251209460465: Tournament #3769361908, $52.38+$2.62 USD Hold'em No Limit - Level IX (150/300) - 2024/06/26 22:27:08 UTC [2024/06/26 18:27:08 ET]
Table '3769361908 9' 6-max Seat #5 is the button
Seat 1: jerdno0 (11901 in chips) 
Seat 3: 77.danielw (21214 in chips) 
Seat 4: quimmixxx (11313 in chips) 
Seat 5: lintumies12 (8560 in chips) 
Seat 6: gwallgofddyn (28703 in chips) 
jerdno0: posts the ante 75
77.danielw: posts the ante 75
quimmixxx: posts the ante 75
lintumies12: posts the ante 75
gwallgofddyn: posts the ante 75
gwallgofddyn: posts small blind 150
jerdno0: posts big blind 300
*** HOLE CARDS ***
77.danielw: raises 300 to 600
quimmixxx: folds 
lintumies12: folds 
gwallgofddyn: folds 
jerdno0: calls 300
*** FLOP *** [Ac Js 7d]
jerdno0: checks 
77.danielw: bets 569
jerdno0: calls 569
*** TURN *** [Ac Js 7d] [Kh]
jerdno0: checks 
77.danielw: checks 
*** RIVER *** [Ac Js 7d Kh] [2c]
jerdno0: checks 
77.danielw: checks 
*** SHOW DOWN ***
jerdno0: shows [4s 4c] (a pair of Fours)
77.danielw: shows [9d 9h] (a pair of Nines)
77.danielw collected 2863 from pot
*** SUMMARY ***
Total pot 2863 | Rake 0 
Board [Ac Js 7d Kh 2c]
Seat 1: jerdno0 (big blind) showed [4s 4c] and lost with a pair of Fours
Seat 3: 77.danielw showed [9d 9h] and won (2863) with a pair of Nines
Seat 4: quimmixxx folded before Flop (didn't bet)
Seat 5: lintumies12 (button) folded before Flop (didn't bet)
Seat 6: gwallgofddyn (small blind) folded before Flop

PokerStars Hand #251209480713: Tournament #3769361908, $52.38+$2.62 USD Hold'em No Limit - Level IX (150/300) - 2024/06/26 22:28:20 UTC [2024/06/26 18:28:20 ET]
Table '3769361908 9' 6-max Seat #6 is the button
Seat 1: jerdno0 (10657 in chips) 
Seat 2: Jessigfilho (10000 in chips) 
Seat 3: 77.danielw (22833 in chips) 
Seat 4: quimmixxx (11238 in chips) 
Seat 5: lintumies12 (8485 in chips) 
Seat 6: gwallgofddyn (28478 in chips) 
jerdno0: posts the ante 75
Jessigfilho: posts the ante 75
77.danielw: posts the ante 75
quimmixxx: posts the ante 75
lintumies12: posts the ante 75
gwallgofddyn: posts the ante 75
jerdno0: posts small blind 150
Jessigfilho: posts big blind 300
*** HOLE CARDS ***
77.danielw: raises 300 to 600
quimmixxx: folds 
lintumies12: folds 
gwallgofddyn: folds 
jerdno0: folds 
Jessigfilho: calls 300
*** FLOP *** [7h 2d 8c]
Jessigfilho: checks 
77.danielw: bets 594
Jessigfilho: calls 594
*** TURN *** [7h 2d 8c] [Ah]
Jessigfilho: checks 
77.danielw: bets 1972
Jessigfilho: folds 
Uncalled bet (1972) returned to 77.danielw
77.danielw collected 2988 from pot
77.danielw: doesn't show hand 
*** SUMMARY ***
Total pot 2988 | Rake 0 
Board [7h 2d 8c Ah]
Seat 1: jerdno0 (small blind) folded before Flop
Seat 2: Jessigfilho (big blind) folded on the Turn
Seat 3: 77.danielw collected (2988)
Seat 4: quimmixxx folded before Flop (didn't bet)
Seat 5: lintumies12 folded before Flop (didn't bet)
Seat 6: gwallgofddyn (button) folded before Flop (didn't bet)

PokerStars Hand #251209501182: Tournament #3769361908, $52.38+$2.62 USD Hold'em No Limit - Level X (200/400) - 2024/06/26 22:29:34 UTC [2024/06/26 18:29:34 ET]
Table '3769361908 9' 6-max Seat #1 is the button
Seat 1: jerdno0 (10432 in chips) 
Seat 2: Jessigfilho (8731 in chips) 
Seat 3: 77.danielw (24552 in chips) 
Seat 4: quimmixxx (11163 in chips) 
Seat 5: lintumies12 (8410 in chips) 
Seat 6: gwallgofddyn (28403 in chips) 
jerdno0: posts the ante 100
Jessigfilho: posts the ante 100
77.danielw: posts the ante 100
quimmixxx: posts the ante 100
lintumies12: posts the ante 100
gwallgofddyn: posts the ante 100
Jessigfilho: posts small blind 200
77.danielw: posts big blind 400
*** HOLE CARDS ***
quimmixxx: folds 
lintumies12: raises 800 to 1200
gwallgofddyn: calls 1200
jerdno0: folds 
Jessigfilho: folds 
77.danielw: folds 
*** FLOP *** [Jh 4c 4s]
lintumies12: bets 2000
gwallgofddyn: folds 
Uncalled bet (2000) returned to lintumies12
lintumies12 collected 3600 from pot
lintumies12: doesn't show hand 
*** SUMMARY ***
Total pot 3600 | Rake 0 
Board [Jh 4c 4s]
Seat 1: jerdno0 (button) folded before Flop (didn't bet)
Seat 2: Jessigfilho (small blind) folded before Flop
Seat 3: 77.danielw (big blind) folded before Flop
Seat 4: quimmixxx folded before Flop (didn't bet)
Seat 5: lintumies12 collected (3600)
Seat 6: gwallgofddyn folded on the Flop

PokerStars Hand #251209523952: Tournament #3769361908, $52.38+$2.62 USD Hold'em No Limit - Level X (200/400) - 2024/06/26 22:30:56 UTC [2024/06/26 18:30:56 ET]
Table '3769361908 9' 6-max Seat #2 is the button
Seat 1: jerdno0 (10332 in chips) 
Seat 2: Jessigfilho (8431 in chips) 
Seat 3: 77.danielw (24052 in chips) 
Seat 4: quimmixxx (11063 in chips) 
Seat 5: lintumies12 (10710 in chips) 
Seat 6: gwallgofddyn (27103 in chips) 
jerdno0: posts the ante 100
Jessigfilho: posts the ante 100
77.danielw: posts the ante 100
quimmixxx: posts the ante 100
lintumies12: posts the ante 100
gwallgofddyn: posts the ante 100
77.danielw: posts small blind 200
quimmixxx: posts big blind 400
*** HOLE CARDS ***
lintumies12: folds 
gwallgofddyn: folds 
jerdno0: folds 
Jessigfilho: raises 400 to 800
77.danielw: folds 
quimmixxx: folds 
Uncalled bet (400) returned to Jessigfilho
Jessigfilho collected 1600 from pot
*** SUMMARY ***
Total pot 1600 | Rake 0 
Seat 1: jerdno0 folded before Flop (didn't bet)
Seat 2: Jessigfilho (button) collected (1600)
Seat 3: 77.danielw (small blind) folded before Flop
Seat 4: quimmixxx (big blind) folded before Flop
Seat 5: lintumies12 folded before Flop (didn't bet)
Seat 6: gwallgofddyn folded before Flop (didn't bet)

PokerStars Hand #251209530430: Tournament #3769361908, $52.38+$2.62 USD Hold'em No Limit - Level X (200/400) - 2024/06/26 22:31:20 UTC [2024/06/26 18:31:20 ET]
Table '3769361908 9' 6-max Seat #3 is the button
Seat 1: jerdno0 (10232 in chips) 
Seat 2: Jessigfilho (9531 in chips) 
Seat 3: 77.danielw (23752 in chips) 
Seat 4: quimmixxx (10563 in chips) 
Seat 5: lintumies12 (10610 in chips) 
Seat 6: gwallgofddyn (27003 in chips) 
jerdno0: posts the ante 100
Jessigfilho: posts the ante 100
77.danielw: posts the ante 100
quimmixxx: posts the ante 100
lintumies12: posts the ante 100
gwallgofddyn: posts the ante 100
quimmixxx: posts small blind 200
lintumies12: posts big blind 400
*** HOLE CARDS ***
gwallgofddyn: raises 520 to 920
jerdno0: calls 920
Jessigfilho: folds 
77.danielw: raises 1880 to 2800
quimmixxx: folds 
lintumies12: folds 
gwallgofddyn: folds 
jerdno0: calls 1880
*** FLOP *** [7h 4c 7s]
jerdno0: checks 
77.danielw: bets 2948
jerdno0: calls 2948
*** TURN *** [7h 4c 7s] [9c]
jerdno0: bets 4384 and is all-in
77.danielw: folds 
Uncalled bet (4384) returned to jerdno0
jerdno0 collected 13616 from pot
*** SUMMARY ***
Total pot 13616 | Rake 0 
Board [7h 4c 7s 9c]
Seat 1: jerdno0 collected (13616)
Seat 2: Jessigfilho folded before Flop (didn't bet)
Seat 3: 77.danielw (button) folded on the Turn
Seat 4: quimmixxx (small blind) folded before Flop
Seat 5: lintumies12 (big blind) folded before Flop
Seat 6: gwallgofddyn folded before Flop

PokerStars Hand #251209563491: Tournament #3769361908, $52.38+$2.62 USD Hold'em No Limit - Level XI (250/500) - 2024/06/26 22:33:21 UTC [2024/06/26 18:33:21 ET]
Table '3769361908 9' 6-max Seat #4 is the button
Seat 1: jerdno0 (18000 in chips) 
Seat 2: Jessigfilho (9431 in chips) 
Seat 3: 77.danielw (17904 in chips) 
Seat 4: quimmixxx (10263 in chips) 
Seat 5: lintumies12 (10110 in chips) 
Seat 6: gwallgofddyn (25983 in chips) 
jerdno0: posts the ante 125
Jessigfilho: posts the ante 125
77.danielw: posts the ante 125
quimmixxx: posts the ante 125
lintumies12: posts the ante 125
gwallgofddyn: posts the ante 125
lintumies12: posts small blind 250
gwallgofddyn: posts big blind 500
*** HOLE CARDS ***
jerdno0: raises 500 to 1000
Jessigfilho: folds 
77.danielw: folds 
quimmixxx: folds 
lintumies12: folds 
gwallgofddyn: calls 500
*** FLOP *** [8d 3c Jd]
gwallgofddyn: checks 
jerdno0: checks 
*** TURN *** [8d 3c Jd] [Ks]
gwallgofddyn: checks 
jerdno0: bets 1500
gwallgofddyn: calls 1500
*** RIVER *** [8d 3c Jd Ks] [Jc]
gwallgofddyn: checks 
jerdno0: bets 3500
gwallgofddyn: folds 
Uncalled bet (3500) returned to jerdno0
jerdno0 collected 6000 from pot
*** SUMMARY ***
Total pot 6000 | Rake 0 
Board [8d 3c Jd Ks Jc]
Seat 1: jerdno0 collected (6000)
Seat 2: Jessigfilho folded before Flop (didn't bet)
Seat 3: 77.danielw folded before Flop (didn't bet)
Seat 4: quimmixxx (button) folded before Flop (didn't bet)
Seat 5: lintumies12 (small blind) folded before Flop
Seat 6: gwallgofddyn (big blind) folded on the River

PokerStars Hand #251209586807: Tournament #3769361908, $52.38+$2.62 USD Hold'em No Limit - Level XI (250/500) - 2024/06/26 22:34:48 UTC [2024/06/26 18:34:48 ET]
Table '3769361908 9' 6-max Seat #5 is the button
Seat 1: jerdno0 (21375 in chips) 
Seat 2: Jessigfilho (9306 in chips) 
Seat 3: 77.danielw (17779 in chips) 
Seat 4: quimmixxx (10138 in chips) 
Seat 5: lintumies12 (9735 in chips) 
Seat 6: gwallgofddyn (23358 in chips) 
jerdno0: posts the ante 125
Jessigfilho: posts the ante 125
77.danielw: posts the ante 125
quimmixxx: posts the ante 125
lintumies12: posts the ante 125
gwallgofddyn: posts the ante 125
gwallgofddyn: posts small blind 250
jerdno0: posts big blind 500
*** HOLE CARDS ***
Jessigfilho: folds 
77.danielw: folds 
quimmixxx: folds 
lintumies12: folds 
gwallgofddyn: calls 250
jerdno0: checks 
*** FLOP *** [Tc 5h 7s]
gwallgofddyn: bets 500
jerdno0: calls 500
*** TURN *** [Tc 5h 7s] [8h]
gwallgofddyn: checks 
jerdno0: bets 1375
gwallgofddyn: folds 
Uncalled bet (1375) returned to jerdno0
jerdno0 collected 2750 from pot
*** SUMMARY ***
Total pot 2750 | Rake 0 
Board [Tc 5h 7s 8h]
Seat 1: jerdno0 (big blind) collected (2750)
Seat 2: Jessigfilho folded before Flop (didn't bet)
Seat 3: 77.danielw folded before Flop (didn't bet)
Seat 4: quimmixxx folded before Flop (didn't bet)
Seat 5: lintumies12 (button) folded before Flop (didn't bet)
Seat 6: gwallgofddyn (small blind) folded on the Turn

PokerStars Hand #251209606613: Tournament #3769361908, $52.38+$2.62 USD Hold'em No Limit - Level XII (300/600) - 2024/06/26 22:36:01 UTC [2024/06/26 18:36:01 ET]
Table '3769361908 9' 6-max Seat #6 is the button
Seat 1: jerdno0 (23000 in chips) 
Seat 2: Jessigfilho (9181 in chips) 
Seat 3: 77.danielw (17654 in chips) 
Seat 4: quimmixxx (10013 in chips) 
Seat 5: lintumies12 (9610 in chips) 
Seat 6: gwallgofddyn (22233 in chips) 
jerdno0: posts the ante 150
Jessigfilho: posts the ante 150
77.danielw: posts the ante 150
quimmixxx: posts the ante 150
lintumies12: posts the ante 150
gwallgofddyn: posts the ante 150
jerdno0: posts small blind 300
Jessigfilho: posts big blind 600
*** HOLE CARDS ***
77.danielw: folds 
quimmixxx: folds 
lintumies12: folds 
gwallgofddyn: raises 600 to 1200
jerdno0: calls 900
Jessigfilho: raises 7831 to 9031 and is all-in
gwallgofddyn: folds 
jerdno0: folds 
Uncalled bet (7831) returned to Jessigfilho
Jessigfilho collected 4500 from pot
*** SUMMARY ***
Total pot 4500 | Rake 0 
Seat 1: jerdno0 (small blind) folded before Flop
Seat 2: Jessigfilho (big blind) collected (4500)
Seat 3: 77.danielw folded before Flop (didn't bet)
Seat 4: quimmixxx folded before Flop (didn't bet)
Seat 5: lintumies12 folded before Flop (didn't bet)
Seat 6: gwallgofddyn (button) folded before Flop

PokerStars Hand #251209624452: Tournament #3769361908, $52.38+$2.62 USD Hold'em No Limit - Level XII (300/600) - 2024/06/26 22:37:09 UTC [2024/06/26 18:37:09 ET]
Table '3769361908 9' 6-max Seat #1 is the button
Seat 1: jerdno0 (21650 in chips) 
Seat 2: Jessigfilho (12331 in chips) 
Seat 3: 77.danielw (17504 in chips) 
Seat 4: quimmixxx (9863 in chips) 
Seat 5: lintumies12 (9460 in chips) 
Seat 6: gwallgofddyn (20883 in chips) 
jerdno0: posts the ante 150
Jessigfilho: posts the ante 150
77.danielw: posts the ante 150
quimmixxx: posts the ante 150
lintumies12: posts the ante 150
gwallgofddyn: posts the ante 150
Jessigfilho: posts small blind 300
77.danielw: posts big blind 600
*** HOLE CARDS ***
quimmixxx: folds 
lintumies12: folds 
gwallgofddyn: folds 
jerdno0: raises 600 to 1200
Jessigfilho: raises 10981 to 12181 and is all-in
77.danielw: folds 
jerdno0: calls 10981
*** FLOP *** [6h Kc 9s]
*** TURN *** [6h Kc 9s] [3h]
*** RIVER *** [6h Kc 9s 3h] [Th]
*** SHOW DOWN ***
Jessigfilho: shows [As Jd] (high card Ace)
jerdno0: shows [Ac Ks] (a pair of Kings)
jerdno0 collected 25862 from pot
Jessigfilho finished the tournament
*** SUMMARY ***
Total pot 25862 | Rake 0 
Board [6h Kc 9s 3h Th]
Seat 1: jerdno0 (button) showed [Ac Ks] and won (25862) with a pair of Kings
Seat 2: Jessigfilho (small blind) showed [As Jd] and lost with high card Ace
Seat 3: 77.danielw (big blind) folded before Flop
Seat 4: quimmixxx folded before Flop (didn't bet)
Seat 5: lintumies12 folded before Flop (didn't bet)
Seat 6: gwallgofddyn folded before Flop (didn't bet)

PokerStars Hand #251209637969: Tournament #3769361908, $52.38+$2.62 USD Hold'em No Limit - Level XII (300/600) - 2024/06/26 22:37:59 UTC [2024/06/26 18:37:59 ET]
Table '3769361908 9' 6-max Seat #3 is the button
Seat 1: jerdno0 (35181 in chips) 
Seat 3: 77.danielw (16754 in chips) 
Seat 4: quimmixxx (9713 in chips) 
Seat 5: lintumies12 (9310 in chips) 
Seat 6: gwallgofddyn (20733 in chips) 
jerdno0: posts the ante 150
77.danielw: posts the ante 150
quimmixxx: posts the ante 150
lintumies12: posts the ante 150
gwallgofddyn: posts the ante 150
quimmixxx: posts small blind 300
lintumies12: posts big blind 600
*** HOLE CARDS ***
gwallgofddyn: folds 
jerdno0: folds 
77.danielw: folds 
quimmixxx: raises 8963 to 9563 and is all-in
lintumies12: calls 8560 and is all-in
Uncalled bet (403) returned to quimmixxx
*** FLOP *** [3s 4d 4c]
*** TURN *** [3s 4d 4c] [5s]
*** RIVER *** [3s 4d 4c 5s] [Ac]
*** SHOW DOWN ***
quimmixxx: shows [Tc 8d] (a pair of Fours)
lintumies12: shows [Td Ts] (two pair, Tens and Fours)
lintumies12 collected 19070 from pot
*** SUMMARY ***
Total pot 19070 | Rake 0 
Board [3s 4d 4c 5s Ac]
Seat 1: jerdno0 folded before Flop (didn't bet)
Seat 3: 77.danielw (button) folded before Flop (didn't bet)
Seat 4: quimmixxx (small blind) showed [Tc 8d] and lost with a pair of Fours
Seat 5: lintumies12 (big blind) showed [Td Ts] and won (19070) with two pair, Tens and Fours
Seat 6: gwallgofddyn folded before Flop (didn't bet)

PokerStars Hand #251209646667: Tournament #3769361908, $52.38+$2.62 USD Hold'em No Limit - Level XIII (400/800) - 2024/06/26 22:38:32 UTC [2024/06/26 18:38:32 ET]
Table '3769361908 9' 6-max Seat #4 is the button
Seat 1: jerdno0 (35031 in chips) 
Seat 3: 77.danielw (16604 in chips) 
Seat 4: quimmixxx (403 in chips) 
Seat 5: lintumies12 (19070 in chips) 
Seat 6: gwallgofddyn (20583 in chips) 
jerdno0: posts the ante 200
77.danielw: posts the ante 200
quimmixxx: posts the ante 200
lintumies12: posts the ante 200
gwallgofddyn: posts the ante 200
lintumies12: posts small blind 400
gwallgofddyn: posts big blind 800
*** HOLE CARDS ***
jerdno0: calls 800
77.danielw: folds 
quimmixxx: calls 203 and is all-in
lintumies12: folds 
gwallgofddyn: checks 
*** FLOP *** [9s 8s 8h]
gwallgofddyn: checks 
jerdno0: bets 1602
gwallgofddyn: folds 
Uncalled bet (1602) returned to jerdno0
*** TURN *** [9s 8s 8h] [2s]
*** RIVER *** [9s 8s 8h 2s] [Qs]
*** SHOW DOWN ***
jerdno0: shows [Jh 7h] (a pair of Eights)
jerdno0 collected 1391 from side pot
quimmixxx: shows [3d 7c] (a pair of Eights - lower kicker)
jerdno0 collected 1812 from main pot
quimmixxx finished the tournament
*** SUMMARY ***
Total pot 3203 Main pot 1812. Side pot 1391. | Rake 0 
Board [9s 8s 8h 2s Qs]
Seat 1: jerdno0 showed [Jh 7h] and won (3203) with a pair of Eights
Seat 3: 77.danielw folded before Flop (didn't bet)
Seat 4: quimmixxx (button) showed [3d 7c] and lost with a pair of Eights
Seat 5: lintumies12 (small blind) folded before Flop
Seat 6: gwallgofddyn (big blind) folded on the Flop

PokerStars Hand #251209659195: Tournament #3769361908, $52.38+$2.62 USD Hold'em No Limit - Level XIII (400/800) - 2024/06/26 22:39:19 UTC [2024/06/26 18:39:19 ET]
Table '3769361908 9' 6-max Seat #5 is the button
Seat 1: jerdno0 (37234 in chips) 
Seat 3: 77.danielw (16404 in chips) 
Seat 5: lintumies12 (18470 in chips) 
Seat 6: gwallgofddyn (19583 in chips) 
jerdno0: posts the ante 200
77.danielw: posts the ante 200
lintumies12: posts the ante 200
gwallgofddyn: posts the ante 200
gwallgofddyn: posts small blind 400
jerdno0: posts big blind 800
*** HOLE CARDS ***
77.danielw: folds 
lintumies12: folds 
gwallgofddyn: calls 400
jerdno0: checks 
*** FLOP *** [9s 8h Kc]
gwallgofddyn: checks 
jerdno0: bets 1200
gwallgofddyn: raises 2400 to 3600
jerdno0: folds 
Uncalled bet (2400) returned to gwallgofddyn
gwallgofddyn collected 4800 from pot
gwallgofddyn: doesn't show hand 
*** SUMMARY ***
Total pot 4800 | Rake 0 
Board [9s 8h Kc]
Seat 1: jerdno0 (big blind) folded on the Flop
Seat 3: 77.danielw folded before Flop (didn't bet)
Seat 5: lintumies12 (button) folded before Flop (didn't bet)
Seat 6: gwallgofddyn (small blind) collected (4800)

PokerStars Hand #251209673169: Tournament #3769361908, $52.38+$2.62 USD Hold'em No Limit - Level XIII (400/800) - 2024/06/26 22:40:11 UTC [2024/06/26 18:40:11 ET]
Table '3769361908 9' 6-max Seat #6 is the button
Seat 1: jerdno0 (35034 in chips) 
Seat 3: 77.danielw (16204 in chips) 
Seat 4: Dazjas (18800 in chips) 
Seat 5: lintumies12 (18270 in chips) 
Seat 6: gwallgofddyn (22183 in chips) 
jerdno0: posts the ante 200
77.danielw: posts the ante 200
Dazjas: posts the ante 200
lintumies12: posts the ante 200
gwallgofddyn: posts the ante 200
jerdno0: posts small blind 400
77.danielw: posts big blind 800
*** HOLE CARDS ***
Dazjas: folds 
lintumies12: folds 
gwallgofddyn: folds 
jerdno0: calls 400
77.danielw: checks 
*** FLOP *** [Jh Ah 7c]
jerdno0: bets 1300
77.danielw: calls 1300
*** TURN *** [Jh Ah 7c] [5c]
jerdno0: checks 
77.danielw: checks 
*** RIVER *** [Jh Ah 7c 5c] [4d]
jerdno0: bets 2600
77.danielw: calls 2600
*** SHOW DOWN ***
jerdno0: shows [4c Js] (two pair, Jacks and Fours)
77.danielw: mucks hand 
jerdno0 collected 10400 from pot
*** SUMMARY ***
Total pot 10400 | Rake 0 
Board [Jh Ah 7c 5c 4d]
Seat 1: jerdno0 (small blind) showed [4c Js] and won (10400) with two pair, Jacks and Fours
Seat 3: 77.danielw (big blind) mucked
Seat 4: Dazjas folded before Flop (didn't bet)
Seat 5: lintumies12 folded before Flop (didn't bet)
Seat 6: gwallgofddyn (button) folded before Flop (didn't bet)

PokerStars Hand #251209691762: Tournament #3769361908, $52.38+$2.62 USD Hold'em No Limit - Level XIV (500/1000) - 2024/06/26 22:41:22 UTC [2024/06/26 18:41:22 ET]
Table '3769361908 9' 6-max Seat #1 is the button
Seat 1: jerdno0 (40534 in chips) 
Seat 3: 77.danielw (11304 in chips) 
Seat 4: Dazjas (18600 in chips) 
Seat 5: lintumies12 (18070 in chips) 
Seat 6: gwallgofddyn (21983 in chips) 
jerdno0: posts the ante 250
77.danielw: posts the ante 250
Dazjas: posts the ante 250
lintumies12: posts the ante 250
gwallgofddyn: posts the ante 250
77.danielw: posts small blind 500
Dazjas: posts big blind 1000
*** HOLE CARDS ***
lintumies12: folds 
gwallgofddyn: folds 
jerdno0: calls 1000
77.danielw: raises 10054 to 11054 and is all-in
Dazjas: folds 
jerdno0: folds 
Uncalled bet (10054) returned to 77.danielw
77.danielw collected 4250 from pot
77.danielw: doesn't show hand 
*** SUMMARY ***
Total pot 4250 | Rake 0 
Seat 1: jerdno0 (button) folded before Flop
Seat 3: 77.danielw (small blind) collected (4250)
Seat 4: Dazjas (big blind) folded before Flop
Seat 5: lintumies12 folded before Flop (didn't bet)
Seat 6: gwallgofddyn folded before Flop (didn't bet)

PokerStars Hand #251209699155: Tournament #3769361908, $52.38+$2.62 USD Hold'em No Limit - Level XIV (500/1000) - 2024/06/26 22:41:51 UTC [2024/06/26 18:41:51 ET]
Table '3769361908 9' 6-max Seat #3 is the button
Seat 1: jerdno0 (39284 in chips) 
Seat 3: 77.danielw (14304 in chips) 
Seat 4: Dazjas (17350 in chips) 
Seat 5: lintumies12 (17820 in chips) 
Seat 6: gwallgofddyn (21733 in chips) 
jerdno0: posts the ante 250
77.danielw: posts the ante 250
Dazjas: posts the ante 250
lintumies12: posts the ante 250
gwallgofddyn: posts the ante 250
Dazjas: posts small blind 500
lintumies12: posts big blind 1000
*** HOLE CARDS ***
gwallgofddyn: raises 1000 to 2000
jerdno0: folds 
77.danielw: raises 12054 to 14054 and is all-in
Dazjas: folds 
lintumies12: folds 
gwallgofddyn: calls 12054
*** FLOP *** [5c Jc 8c]
*** TURN *** [5c Jc 8c] [9c]
*** RIVER *** [5c Jc 8c 9c] [4c]
*** SHOW DOWN ***
gwallgofddyn: shows [8d Ad] (a flush, Jack high)
77.danielw: shows [Jh Kh] (a flush, Jack high)
gwallgofddyn collected 15429 from pot
77.danielw collected 15429 from pot
*** SUMMARY ***
Total pot 30858 | Rake 0 
Board [5c Jc 8c 9c 4c]
Seat 1: jerdno0 folded before Flop (didn't bet)
Seat 3: 77.danielw (button) showed [Jh Kh] and won (15429) with a flush, Jack high
Seat 4: Dazjas (small blind) folded before Flop
Seat 5: lintumies12 (big blind) folded before Flop
Seat 6: gwallgofddyn showed [8d Ad] and won (15429) with a flush, Jack high

PokerStars Hand #251209706708: Tournament #3769361908, $52.38+$2.62 USD Hold'em No Limit - Level XIV (500/1000) - 2024/06/26 22:42:20 UTC [2024/06/26 18:42:20 ET]
Table '3769361908 9' 6-max Seat #4 is the button
Seat 1: jerdno0 (39034 in chips) 
Seat 2: $aymon9 (8482 in chips) 
Seat 3: 77.danielw (15429 in chips) 
Seat 4: Dazjas (16600 in chips) 
Seat 5: lintumies12 (16570 in chips) 
Seat 6: gwallgofddyn (22858 in chips) 
jerdno0: posts the ante 250
$aymon9: posts the ante 250
77.danielw: posts the ante 250
Dazjas: posts the ante 250
lintumies12: posts the ante 250
gwallgofddyn: posts the ante 250
lintumies12: posts small blind 500
gwallgofddyn: posts big blind 1000
*** HOLE CARDS ***
jerdno0: folds 
$aymon9: folds 
77.danielw: folds 
Dazjas: folds 
lintumies12: raises 15320 to 16320 and is all-in
gwallgofddyn: folds 
Uncalled bet (15320) returned to lintumies12
lintumies12 collected 3500 from pot
lintumies12: doesn't show hand 
*** SUMMARY ***
Total pot 3500 | Rake 0 
Seat 1: jerdno0 folded before Flop (didn't bet)
Seat 2: $aymon9 folded before Flop (didn't bet)
Seat 3: 77.danielw folded before Flop (didn't bet)
Seat 4: Dazjas (button) folded before Flop (didn't bet)
Seat 5: lintumies12 (small blind) collected (3500)
Seat 6: gwallgofddyn (big blind) folded before Flop

PokerStars Hand #251209712418: Tournament #3769361908, $52.38+$2.62 USD Hold'em No Limit - Level XIV (500/1000) - 2024/06/26 22:42:42 UTC [2024/06/26 18:42:42 ET]
Table '3769361908 9' 6-max Seat #5 is the button
Seat 1: jerdno0 (38784 in chips) 
Seat 2: $aymon9 (8232 in chips) 
Seat 3: 77.danielw (15179 in chips) 
Seat 4: Dazjas (16350 in chips) 
Seat 5: lintumies12 (18820 in chips) 
Seat 6: gwallgofddyn (21608 in chips) 
jerdno0: posts the ante 250
$aymon9: posts the ante 250
77.danielw: posts the ante 250
Dazjas: posts the ante 250
lintumies12: posts the ante 250
gwallgofddyn: posts the ante 250
gwallgofddyn: posts small blind 500
jerdno0: posts big blind 1000
*** HOLE CARDS ***
$aymon9: folds 
77.danielw: folds 
Dazjas: folds 
lintumies12: raises 17570 to 18570 and is all-in
gwallgofddyn: folds 
jerdno0: folds 
Uncalled bet (17570) returned to lintumies12
lintumies12 collected 4000 from pot
lintumies12: doesn't show hand 
*** SUMMARY ***
Total pot 4000 | Rake 0 
Seat 1: jerdno0 (big blind) folded before Flop
Seat 2: $aymon9 folded before Flop (didn't bet)
Seat 3: 77.danielw folded before Flop (didn't bet)
Seat 4: Dazjas folded before Flop (didn't bet)
Seat 5: lintumies12 (button) collected (4000)
Seat 6: gwallgofddyn (small blind) folded before Flop

PokerStars Hand #251209718874: Tournament #3769361908, $52.38+$2.62 USD Hold'em No Limit - Level XIV (500/1000) - 2024/06/26 22:43:07 UTC [2024/06/26 18:43:07 ET]
Table '3769361908 9' 6-max Seat #6 is the button
Seat 1: jerdno0 (37534 in chips) 
Seat 2: $aymon9 (7982 in chips) 
Seat 3: 77.danielw (14929 in chips) 
Seat 4: Dazjas (16100 in chips) 
Seat 5: lintumies12 (21570 in chips) 
Seat 6: gwallgofddyn (20858 in chips) 
jerdno0: posts the ante 250
$aymon9: posts the ante 250
77.danielw: posts the ante 250
Dazjas: posts the ante 250
lintumies12: posts the ante 250
gwallgofddyn: posts the ante 250
jerdno0: posts small blind 500
$aymon9: posts big blind 1000
*** HOLE CARDS ***
77.danielw: folds 
Dazjas: folds 
lintumies12: folds 
gwallgofddyn: raises 19608 to 20608 and is all-in
jerdno0: folds 
$aymon9: calls 6732 and is all-in
Uncalled bet (12876) returned to gwallgofddyn
*** FLOP *** [Ks 6d Kc]
*** TURN *** [Ks 6d Kc] [8d]
*** RIVER *** [Ks 6d Kc 8d] [7c]
*** SHOW DOWN ***
$aymon9: shows [7d 7h] (a full house, Sevens full of Kings)
gwallgofddyn: shows [Kh Jd] (three of a kind, Kings)
$aymon9 collected 17464 from pot
*** SUMMARY ***
Total pot 17464 | Rake 0 
Board [Ks 6d Kc 8d 7c]
Seat 1: jerdno0 (small blind) folded before Flop
Seat 2: $aymon9 (big blind) showed [7d 7h] and won (17464) with a full house, Sevens full of Kings
Seat 3: 77.danielw folded before Flop (didn't bet)
Seat 4: Dazjas folded before Flop (didn't bet)
Seat 5: lintumies12 folded before Flop (didn't bet)
Seat 6: gwallgofddyn (button) showed [Kh Jd] and lost with three of a kind, Kings

PokerStars Hand #251209726197: Tournament #3769361908, $52.38+$2.62 USD Hold'em No Limit - Level XIV (500/1000) - 2024/06/26 22:43:36 UTC [2024/06/26 18:43:36 ET]
Table '3769361908 9' 6-max Seat #1 is the button
Seat 1: jerdno0 (36784 in chips) 
Seat 2: $aymon9 (17464 in chips) 
Seat 3: 77.danielw (14679 in chips) 
Seat 4: Dazjas (15850 in chips) 
Seat 5: lintumies12 (21320 in chips) 
jerdno0: posts the ante 250
$aymon9: posts the ante 250
77.danielw: posts the ante 250
Dazjas: posts the ante 250
lintumies12: posts the ante 250
$aymon9: posts small blind 500
77.danielw: posts big blind 1000
*** HOLE CARDS ***
Dazjas: folds 
lintumies12: folds 
jerdno0: raises 1000 to 2000
$aymon9: folds 
GlassofWisky is disconnected 
77.danielw: raises 12429 to 14429 and is all-in
jerdno0: folds 
Uncalled bet (12429) returned to 77.danielw
77.danielw collected 5750 from pot
77.danielw: doesn't show hand 
*** SUMMARY ***
Total pot 5750 | Rake 0 
Seat 1: jerdno0 (button) folded before Flop
Seat 2: $aymon9 (small blind) folded before Flop
Seat 3: 77.danielw (big blind) collected (5750)
Seat 4: Dazjas folded before Flop (didn't bet)
Seat 5: lintumies12 folded before Flop (didn't bet)

PokerStars Hand #251209737674: Tournament #3769361908, $52.38+$2.62 USD Hold'em No Limit - Level XV (600/1200) - 2024/06/26 22:44:21 UTC [2024/06/26 18:44:21 ET]
Table '3769361908 9' 6-max Seat #2 is the button
Seat 1: jerdno0 (34534 in chips) 
Seat 2: $aymon9 (16714 in chips) 
Seat 3: 77.danielw (18179 in chips) 
Seat 4: Dazjas (15600 in chips) 
Seat 5: lintumies12 (21070 in chips) 
Seat 6: GlassofWisky (7522 in chips) 
jerdno0: posts the ante 300
$aymon9: posts the ante 300
77.danielw: posts the ante 300
Dazjas: posts the ante 300
lintumies12: posts the ante 300
GlassofWisky: posts the ante 300
77.danielw: posts small blind 600
Dazjas: posts big blind 1200
*** HOLE CARDS ***
lintumies12: folds 
GlassofWisky: folds 
jerdno0: folds 
$aymon9: raises 15214 to 16414 and is all-in
77.danielw: raises 1465 to 17879 and is all-in
Dazjas: folds 
Uncalled bet (1465) returned to 77.danielw
*** FLOP *** [3s 5c 9c]
*** TURN *** [3s 5c 9c] [8h]
*** RIVER *** [3s 5c 9c 8h] [Kd]
*** SHOW DOWN ***
77.danielw: shows [Kc Ad] (a pair of Kings)
$aymon9: shows [Ts Ac] (high card Ace)
77.danielw collected 35828 from pot
$aymon9 finished the tournament
*** SUMMARY ***
Total pot 35828 | Rake 0 
Board [3s 5c 9c 8h Kd]
Seat 1: jerdno0 folded before Flop (didn't bet)
Seat 2: $aymon9 (button) showed [Ts Ac] and lost with high card Ace
Seat 3: 77.danielw (small blind) showed [Kc Ad] and won (35828) with a pair of Kings
Seat 4: Dazjas (big blind) folded before Flop
Seat 5: lintumies12 folded before Flop (didn't bet)
Seat 6: GlassofWisky folded before Flop (didn't bet)

PokerStars Hand #251209749990: Tournament #3769361908, $52.38+$2.62 USD Hold'em No Limit - Level XV (600/1200) - 2024/06/26 22:45:08 UTC [2024/06/26 18:45:08 ET]
Table '3769361908 9' 6-max Seat #3 is the button
Seat 1: jerdno0 (34234 in chips) 
Seat 3: 77.danielw (37293 in chips) 
Seat 4: Dazjas (14100 in chips) 
Seat 6: GlassofWisky (7222 in chips) 
jerdno0: posts the ante 300
77.danielw: posts the ante 300
Dazjas: posts the ante 300
GlassofWisky: posts the ante 300
Dazjas: posts small blind 600
GlassofWisky: posts big blind 1200
*** HOLE CARDS ***
twonior is disconnected 
jerdno0: folds 
77.danielw: folds 
Dazjas: raises 12600 to 13800 and is all-in
GlassofWisky: folds 
Uncalled bet (12600) returned to Dazjas
Dazjas collected 3600 from pot
*** SUMMARY ***
Total pot 3600 | Rake 0 
Seat 1: jerdno0 folded before Flop (didn't bet)
Seat 3: 77.danielw (button) folded before Flop (didn't bet)
Seat 4: Dazjas (small blind) collected (3600)
Seat 6: GlassofWisky (big blind) folded before Flop

PokerStars Hand #251209756125: Tournament #3769361908, $52.38+$2.62 USD Hold'em No Limit - Level XV (600/1200) - 2024/06/26 22:45:32 UTC [2024/06/26 18:45:32 ET]
Table '3769361908 9' 6-max Seat #4 is the button
Seat 1: jerdno0 (33934 in chips) 
Seat 2: twonior (7900 in chips) 
Seat 3: 77.danielw (36993 in chips) 
Seat 4: Dazjas (16200 in chips) 
Seat 6: GlassofWisky (5722 in chips) 
jerdno0: posts the ante 300
twonior: posts the ante 300
77.danielw: posts the ante 300
Dazjas: posts the ante 300
GlassofWisky: posts the ante 300
GlassofWisky: posts small blind 600
jerdno0: posts big blind 1200
*** HOLE CARDS ***
twonior: folds 
77.danielw: raises 1200 to 2400
Dazjas: raises 13500 to 15900 and is all-in
GlassofWisky: folds 
jerdno0: folds 
77.danielw: calls 13500
*** FLOP *** [Qc 7c 5d]
*** TURN *** [Qc 7c 5d] [Ks]
*** RIVER *** [Qc 7c 5d Ks] [Qh]
*** SHOW DOWN ***
77.danielw: shows [Qd Ac] (three of a kind, Queens)
Dazjas: shows [Ah Tc] (a pair of Queens)
77.danielw collected 35100 from pot
Dazjas finished the tournament
*** SUMMARY ***
Total pot 35100 | Rake 0 
Board [Qc 7c 5d Ks Qh]
Seat 1: jerdno0 (big blind) folded before Flop
Seat 2: twonior folded before Flop (didn't bet)
Seat 3: 77.danielw showed [Qd Ac] and won (35100) with three of a kind, Queens
Seat 4: Dazjas (button) showed [Ah Tc] and lost with a pair of Queens
Seat 6: GlassofWisky (small blind) folded before Flop

PokerStars Hand #251209765378: Tournament #3769361908, $52.38+$2.62 USD Hold'em No Limit - Level XV (600/1200) - 2024/06/26 22:46:08 UTC [2024/06/26 18:46:08 ET]
Table '3769361908 9' 6-max Seat #6 is the button
Seat 1: jerdno0 (32434 in chips) 
Seat 2: twonior (7600 in chips) 
Seat 3: 77.danielw (55893 in chips) 
Seat 6: GlassofWisky (4822 in chips) 
jerdno0: posts the ante 300
twonior: posts the ante 300
77.danielw: posts the ante 300
GlassofWisky: posts the ante 300
jerdno0: posts small blind 600
twonior: posts big blind 1200
*** HOLE CARDS ***
Septitank is disconnected 
jvieiradias8 is disconnected 
77.danielw: folds 
GlassofWisky: raises 3000 to 4200
jerdno0: folds 
twonior: folds 
Uncalled bet (3000) returned to GlassofWisky
GlassofWisky collected 4200 from pot
GlassofWisky: doesn't show hand 
*** SUMMARY ***
Total pot 4200 | Rake 0 
Seat 1: jerdno0 (small blind) folded before Flop
Seat 2: twonior (big blind) folded before Flop
Seat 3: 77.danielw folded before Flop (didn't bet)
Seat 6: GlassofWisky (button) collected (4200)

PokerStars Hand #251209774512: Tournament #3769361908, $52.38+$2.62 USD Hold'em No Limit - Level XV (600/1200) - 2024/06/26 22:46:44 UTC [2024/06/26 18:46:44 ET]
Table '3769361908 9' 6-max Seat #1 is the button
Seat 1: jerdno0 (31534 in chips) 
Seat 2: twonior (6100 in chips) 
Seat 3: 77.danielw (55593 in chips) 
Seat 4: Septitank (9400 in chips) 
Seat 5: jvieiradias8 (10000 in chips) 
Seat 6: GlassofWisky (7522 in chips) 
jerdno0: posts the ante 300
twonior: posts the ante 300
77.danielw: posts the ante 300
Septitank: posts the ante 300
jvieiradias8: posts the ante 300
GlassofWisky: posts the ante 300
twonior: posts small blind 600
77.danielw: posts big blind 1200
*** HOLE CARDS ***
Septitank: folds 
jvieiradias8: raises 8500 to 9700 and is all-in
GlassofWisky: folds 
jerdno0: folds 
twonior: calls 5200 and is all-in
77.danielw: folds 
Uncalled bet (3900) returned to jvieiradias8
*** FLOP *** [Qc 3h 9c]
*** TURN *** [Qc 3h 9c] [9d]
*** RIVER *** [Qc 3h 9c 9d] [7c]
*** SHOW DOWN ***
twonior: shows [6d Ac] (a pair of Nines)
jvieiradias8: shows [Ks Qh] (two pair, Queens and Nines)
jvieiradias8 collected 14600 from pot
twonior finished the tournament
*** SUMMARY ***
Total pot 14600 | Rake 0 
Board [Qc 3h 9c 9d 7c]
Seat 1: jerdno0 (button) folded before Flop (didn't bet)
Seat 2: twonior (small blind) showed [6d Ac] and lost with a pair of Nines
Seat 3: 77.danielw (big blind) folded before Flop
Seat 4: Septitank folded before Flop (didn't bet)
Seat 5: jvieiradias8 showed [Ks Qh] and won (14600) with two pair, Queens and Nines
Seat 6: GlassofWisky folded before Flop (didn't bet)

PokerStars Hand #251209785847: Tournament #3769361908, $52.38+$2.62 USD Hold'em No Limit - Level XVI (800/1600) - 2024/06/26 22:47:28 UTC [2024/06/26 18:47:28 ET]
Table '3769361908 9' 6-max Seat #3 is the button
Seat 1: jerdno0 (31234 in chips) 
Seat 3: 77.danielw (54093 in chips) 
Seat 4: Septitank (9100 in chips) 
Seat 5: jvieiradias8 (18500 in chips) 
Seat 6: GlassofWisky (7222 in chips) 
jerdno0: posts the ante 400
77.danielw: posts the ante 400
Septitank: posts the ante 400
jvieiradias8: posts the ante 400
GlassofWisky: posts the ante 400
Septitank: posts small blind 800
jvieiradias8: posts big blind 1600
*** HOLE CARDS ***
GlassofWisky: folds 
jerdno0: folds 
Newmayoche is disconnected 
77.danielw: raises 52093 to 53693 and is all-in
Septitank: folds 
jvieiradias8: folds 
Uncalled bet (52093) returned to 77.danielw
77.danielw collected 6000 from pot
77.danielw: doesn't show hand 
*** SUMMARY ***
Total pot 6000 | Rake 0 
Seat 1: jerdno0 folded before Flop (didn't bet)
Seat 3: 77.danielw (button) collected (6000)
Seat 4: Septitank (small blind) folded before Flop
Seat 5: jvieiradias8 (big blind) folded before Flop
Seat 6: GlassofWisky folded before Flop (didn't bet)

PokerStars Hand #251209793883: Tournament #3769361908, $52.38+$2.62 USD Hold'em No Limit - Level XVI (800/1600) - 2024/06/26 22:48:00 UTC [2024/06/26 18:48:00 ET]
Table '3769361908 9' 6-max Seat #4 is the button
Seat 1: jerdno0 (30834 in chips) 
Seat 2: Newmayoche (15360 in chips) 
Seat 3: 77.danielw (58093 in chips) 
Seat 4: Septitank (7900 in chips) 
Seat 5: jvieiradias8 (16500 in chips) 
Seat 6: GlassofWisky (6822 in chips) 
jerdno0: posts the ante 400
Newmayoche: posts the ante 400
77.danielw: posts the ante 400
Septitank: posts the ante 400
jvieiradias8: posts the ante 400
GlassofWisky: posts the ante 400
jvieiradias8: posts small blind 800
GlassofWisky: posts big blind 1600
*** HOLE CARDS ***
jerdno0: raises 1600 to 3200
Newmayoche: calls 3200
77.danielw: folds 
Septitank: folds 
jvieiradias8: folds 
GlassofWisky: raises 3200 to 6400
jerdno0: calls 3200
Newmayoche: calls 3200
*** FLOP *** [4s 3s Qc]
GlassofWisky: checks 
jerdno0: checks 
Newmayoche: bets 8560 and is all-in
GlassofWisky: calls 22 and is all-in
jerdno0: folds 
Uncalled bet (8538) returned to Newmayoche
*** TURN *** [4s 3s Qc] [6h]
*** RIVER *** [4s 3s Qc 6h] [Jh]
*** SHOW DOWN ***
GlassofWisky: shows [6s As] (a pair of Sixes)
Newmayoche: shows [Kh Qh] (a pair of Queens)
Newmayoche collected 22444 from pot
GlassofWisky finished the tournament in 119th place
*** SUMMARY ***
Total pot 22444 | Rake 0 
Board [4s 3s Qc 6h Jh]
Seat 1: jerdno0 folded on the Flop
Seat 2: Newmayoche showed [Kh Qh] and won (22444) with a pair of Queens
Seat 3: 77.danielw folded before Flop (didn't bet)
Seat 4: Septitank (button) folded before Flop (didn't bet)
Seat 5: jvieiradias8 (small blind) folded before Flop
Seat 6: GlassofWisky (big blind) showed [6s As] and lost with a pair of Sixes

PokerStars Hand #251209815860: Tournament #3769361908, $52.38+$2.62 USD Hold'em No Limit - Level XVI (800/1600) - 2024/06/26 22:49:28 UTC [2024/06/26 18:49:28 ET]
Table '3769361908 9' 6-max Seat #5 is the button
Seat 1: jerdno0 (24034 in chips) 
Seat 2: Newmayoche (30982 in chips) 
Seat 3: 77.danielw (57693 in chips) 
Seat 4: Septitank (7500 in chips) 
Seat 5: jvieiradias8 (15300 in chips) 
jerdno0: posts the ante 400
Newmayoche: posts the ante 400
77.danielw: posts the ante 400
Septitank: posts the ante 400
jvieiradias8: posts the ante 400
jerdno0: posts small blind 800
Newmayoche: posts big blind 1600
*** HOLE CARDS ***
77.danielw: raises 55693 to 57293 and is all-in
Septitank: folds 
jvieiradias8: folds 
jerdno0: folds 
Newmayoche: calls 28982 and is all-in
Uncalled bet (26711) returned to 77.danielw
*** FLOP *** [Kd Ks Ac]
*** TURN *** [Kd Ks Ac] [6h]
*** RIVER *** [Kd Ks Ac 6h] [4s]
*** SHOW DOWN ***
Newmayoche: shows [Qc Qd] (two pair, Kings and Queens)
77.danielw: shows [Kc Jh] (three of a kind, Kings)
77.danielw collected 63964 from pot
Newmayoche finished the tournament in 112th place
*** SUMMARY ***
Total pot 63964 | Rake 0 
Board [Kd Ks Ac 6h 4s]
Seat 1: jerdno0 (small blind) folded before Flop
Seat 2: Newmayoche (big blind) showed [Qc Qd] and lost with two pair, Kings and Queens
Seat 3: 77.danielw showed [Kc Jh] and won (63964) with three of a kind, Kings
Seat 4: Septitank folded before Flop (didn't bet)
Seat 5: jvieiradias8 (button) folded before Flop (didn't bet)

PokerStars Hand #251209823996: Tournament #3769361908, $52.38+$2.62 USD Hold'em No Limit - Level XVI (800/1600) - 2024/06/26 22:50:00 UTC [2024/06/26 18:50:00 ET]
Table '3769361908 9' 6-max Seat #1 is the button
Seat 1: jerdno0 (22834 in chips) 
Seat 3: 77.danielw (90675 in chips) 
Seat 4: Septitank (7100 in chips) 
Seat 5: jvieiradias8 (14900 in chips) 
Seat 6: PIPI tapis! (35966 in chips) 
jerdno0: posts the ante 400
77.danielw: posts the ante 400
Septitank: posts the ante 400
jvieiradias8: posts the ante 400
PIPI tapis!: posts the ante 400
77.danielw: posts small blind 800
Septitank: posts big blind 1600
*** HOLE CARDS ***
jvieiradias8: raises 12900 to 14500 and is all-in
PIPI tapis!: folds 
jerdno0: folds 
77.danielw: folds 
Septitank: folds 
Uncalled bet (12900) returned to jvieiradias8
jvieiradias8 collected 6000 from pot
jvieiradias8: doesn't show hand 
*** SUMMARY ***
Total pot 6000 | Rake 0 
Seat 1: jerdno0 (button) folded before Flop (didn't bet)
Seat 3: 77.danielw (small blind) folded before Flop
Seat 4: Septitank (big blind) folded before Flop
Seat 5: jvieiradias8 collected (6000)
Seat 6: PIPI tapis! folded before Flop (didn't bet)

PokerStars Hand #251209830103: Tournament #3769361908, $52.38+$2.62 USD Hold'em No Limit - Level XVII (1000/2000) - 2024/06/26 22:50:25 UTC [2024/06/26 18:50:25 ET]
Table '3769361908 9' 6-max Seat #3 is the button
Seat 1: jerdno0 (22434 in chips) 
Seat 2: podiiii (35336 in chips) 
Seat 3: 77.danielw (89475 in chips) 
Seat 4: Septitank (5100 in chips) 
Seat 5: jvieiradias8 (18900 in chips) 
Seat 6: PIPI tapis! (35566 in chips) 
jerdno0: posts the ante 500
podiiii: posts the ante 500
77.danielw: posts the ante 500
Septitank: posts the ante 500
jvieiradias8: posts the ante 500
PIPI tapis!: posts the ante 500
Septitank: posts small blind 1000
jvieiradias8: posts big blind 2000
*** HOLE CARDS ***
PIPI tapis!: raises 2000 to 4000
jerdno0: folds 
podiiii: folds 
77.danielw: folds 
Septitank: folds 
jvieiradias8: folds 
Uncalled bet (2000) returned to PIPI tapis!
PIPI tapis! collected 8000 from pot
*** SUMMARY ***
Total pot 8000 | Rake 0 
Seat 1: jerdno0 folded before Flop (didn't bet)
Seat 2: podiiii folded before Flop (didn't bet)
Seat 3: 77.danielw (button) folded before Flop (didn't bet)
Seat 4: Septitank (small blind) folded before Flop
Seat 5: jvieiradias8 (big blind) folded before Flop
Seat 6: PIPI tapis! collected (8000)

PokerStars Hand #251209836255: Tournament #3769361908, $52.38+$2.62 USD Hold'em No Limit - Level XVII (1000/2000) - 2024/06/26 22:50:51 UTC [2024/06/26 18:50:51 ET]
Table '3769361908 9' 6-max Seat #4 is the button
Seat 1: jerdno0 (21934 in chips) 
Seat 2: podiiii (34836 in chips) 
Seat 3: 77.danielw (88975 in chips) 
Seat 4: Septitank (3600 in chips) 
Seat 5: jvieiradias8 (16400 in chips) 
Seat 6: PIPI tapis! (41066 in chips) 
jerdno0: posts the ante 500
podiiii: posts the ante 500
77.danielw: posts the ante 500
Septitank: posts the ante 500
jvieiradias8: posts the ante 500
PIPI tapis!: posts the ante 500
jvieiradias8: posts small blind 1000
PIPI tapis!: posts big blind 2000
*** HOLE CARDS ***
jerdno0: folds 
podiiii: folds 
77.danielw: raises 2000 to 4000
Septitank: folds 
jvieiradias8: folds 
PIPI tapis!: raises 36566 to 40566 and is all-in
77.danielw: calls 36566
*** FLOP *** [Ad Kd 5d]
*** TURN *** [Ad Kd 5d] [7d]
*** RIVER *** [Ad Kd 5d 7d] [3d]
*** SHOW DOWN ***
PIPI tapis!: shows [5s 5c] (a flush, Ace high)
77.danielw: shows [8c 8d] (a flush, Ace high - Eight higher)
77.danielw collected 85132 from pot
PIPI tapis! finished the tournament in 101st place
*** SUMMARY ***
Total pot 85132 | Rake 0 
Board [Ad Kd 5d 7d 3d]
Seat 1: jerdno0 folded before Flop (didn't bet)
Seat 2: podiiii folded before Flop (didn't bet)
Seat 3: 77.danielw showed [8c 8d] and won (85132) with a flush, Ace high
Seat 4: Septitank (button) folded before Flop (didn't bet)
Seat 5: jvieiradias8 (small blind) folded before Flop
Seat 6: PIPI tapis! (big blind) showed [5s 5c] and lost with a flush, Ace high

PokerStars Hand #251209848002: Tournament #3769361908, $52.38+$2.62 USD Hold'em No Limit - Level XVII (1000/2000) - 2024/06/26 22:51:39 UTC [2024/06/26 18:51:39 ET]
Table '3769361908 9' 6-max Seat #5 is the button
Seat 1: jerdno0 (21434 in chips) 
Seat 2: podiiii (34336 in chips) 
Seat 3: 77.danielw (133041 in chips) 
Seat 4: Septitank (3100 in chips) 
Seat 5: jvieiradias8 (14900 in chips) 
jerdno0: posts the ante 500
podiiii: posts the ante 500
77.danielw: posts the ante 500
Septitank: posts the ante 500
jvieiradias8: posts the ante 500
jerdno0: posts small blind 1000
podiiii: posts big blind 2000
*** HOLE CARDS ***
77.danielw: raises 130541 to 132541 and is all-in
Septitank: folds 
jvieiradias8: folds 
jerdno0: folds 
podiiii: folds 
Uncalled bet (130541) returned to 77.danielw
77.danielw collected 7500 from pot
77.danielw: doesn't show hand 
*** SUMMARY ***
Total pot 7500 | Rake 0 
Seat 1: jerdno0 (small blind) folded before Flop
Seat 2: podiiii (big blind) folded before Flop
Seat 3: 77.danielw collected (7500)
Seat 4: Septitank folded before Flop (didn't bet)
Seat 5: jvieiradias8 (button) folded before Flop (didn't bet)

PokerStars Hand #251209855056: Tournament #3769361908, $52.38+$2.62 USD Hold'em No Limit - Level XVII (1000/2000) - 2024/06/26 22:52:08 UTC [2024/06/26 18:52:08 ET]
Table '3769361908 9' 6-max Seat #1 is the button
Seat 1: jerdno0 (19934 in chips) 
Seat 2: podiiii (31836 in chips) 
Seat 3: 77.danielw (138041 in chips) 
Seat 4: Septitank (2600 in chips) 
Seat 5: jvieiradias8 (14400 in chips) 
jerdno0: posts the ante 500
podiiii: posts the ante 500
77.danielw: posts the ante 500
Septitank: posts the ante 500
jvieiradias8: posts the ante 500
podiiii: posts small blind 1000
77.danielw: posts big blind 2000
*** HOLE CARDS ***
Joren500 is disconnected 
Septitank: raises 100 to 2100 and is all-in
jvieiradias8: folds 
jerdno0: folds 
podiiii: calls 1100
77.danielw: raises 135441 to 137541 and is all-in
podiiii: folds 
Uncalled bet (135441) returned to 77.danielw
*** FLOP *** [8h 2d Qh]
*** TURN *** [8h 2d Qh] [2h]
*** RIVER *** [8h 2d Qh 2h] [Ad]
*** SHOW DOWN ***
77.danielw: shows [Ah 6h] (a flush, Ace high)
Septitank: shows [Qc Ts] (two pair, Queens and Deuces)
77.danielw collected 8800 from pot
Septitank finished the tournament in 91st place
*** SUMMARY ***
Total pot 8800 | Rake 0 
Board [8h 2d Qh 2h Ad]
Seat 1: jerdno0 (button) folded before Flop (didn't bet)
Seat 2: podiiii (small blind) folded before Flop
Seat 3: 77.danielw (big blind) showed [Ah 6h] and won (8800) with a flush, Ace high
Seat 4: Septitank showed [Qc Ts] and lost with two pair, Queens and Deuces
Seat 5: jvieiradias8 folded before Flop (didn't bet)





PokerStars Hand #251209432006: Tournament #3769361908, $52.38+$2.62 USD Hold'em No Limit - Level VIII (125/250) - 2024/06/26 22:25:25 UTC [2024/06/26 18:25:25 ET]
Table '3769361908 5' 6-max Seat #3 is the button
Seat 1: assalbi (26362 in chips) is sitting out
Seat 2: marquinhosss (14590 in chips) 
Seat 3: despair515 (12353 in chips) 
Seat 4: AkwasYT (19836 in chips) 
Seat 5: zioeddy2312 (7240 in chips) 
Seat 6: ricardons8 (9880 in chips) 
assalbi: posts the ante 60
marquinhosss: posts the ante 60
despair515: posts the ante 60
AkwasYT: posts the ante 60
zioeddy2312: posts the ante 60
ricardons8: posts the ante 60
AkwasYT: posts small blind 125
zioeddy2312: posts big blind 250
*** HOLE CARDS ***
ricardons8: folds 
assalbi: folds 
marquinhosss: folds 
despair515: folds 
AkwasYT: calls 125
zioeddy2312: checks 
*** FLOP *** [8h 9s 9h]
AkwasYT: checks 
zioeddy2312: checks 
*** TURN *** [8h 9s 9h] [2d]
AkwasYT: checks 
zioeddy2312: checks 
*** RIVER *** [8h 9s 9h 2d] [2c]
AkwasYT: bets 500
zioeddy2312: folds 
Uncalled bet (500) returned to AkwasYT
AkwasYT collected 860 from pot
AkwasYT: doesn't show hand 
*** SUMMARY ***
Total pot 860 | Rake 0 
Board [8h 9s 9h 2d 2c]
Seat 1: assalbi folded before Flop (didn't bet)
Seat 2: marquinhosss folded before Flop (didn't bet)
Seat 3: despair515 (button) folded before Flop (didn't bet)
Seat 4: AkwasYT (small blind) collected (860)
Seat 5: zioeddy2312 (big blind) folded on the River
Seat 6: ricardons8 folded before Flop (didn't bet)

PokerStars Hand #251209440172: Tournament #3769361908, $52.38+$2.62 USD Hold'em No Limit - Level VIII (125/250) - 2024/06/26 22:25:55 UTC [2024/06/26 18:25:55 ET]
Table '3769361908 5' 6-max Seat #4 is the button
Seat 1: assalbi (26302 in chips) is sitting out
Seat 2: marquinhosss (14530 in chips) 
Seat 3: despair515 (12293 in chips) 
Seat 4: AkwasYT (20386 in chips) 
Seat 5: zioeddy2312 (6930 in chips) 
Seat 6: ricardons8 (9820 in chips) 
assalbi: posts the ante 60
marquinhosss: posts the ante 60
despair515: posts the ante 60
AkwasYT: posts the ante 60
zioeddy2312: posts the ante 60
ricardons8: posts the ante 60
zioeddy2312: posts small blind 125
ricardons8: posts big blind 250
*** HOLE CARDS ***
assalbi: folds 
marquinhosss: folds 
despair515: folds 
AkwasYT: folds 
zioeddy2312: calls 125
ricardons8: raises 625 to 875
zioeddy2312: folds 
Uncalled bet (625) returned to ricardons8
ricardons8 collected 860 from pot
ricardons8: doesn't show hand 
*** SUMMARY ***
Total pot 860 | Rake 0 
Seat 1: assalbi folded before Flop (didn't bet)
Seat 2: marquinhosss folded before Flop (didn't bet)
Seat 3: despair515 folded before Flop (didn't bet)
Seat 4: AkwasYT (button) folded before Flop (didn't bet)
Seat 5: zioeddy2312 (small blind) folded before Flop
Seat 6: ricardons8 (big blind) collected (860)

PokerStars Hand #251209447568: Tournament #3769361908, $52.38+$2.62 USD Hold'em No Limit - Level IX (150/300) - 2024/06/26 22:26:22 UTC [2024/06/26 18:26:22 ET]
Table '3769361908 5' 6-max Seat #5 is the button
Seat 1: assalbi (26242 in chips) is sitting out
Seat 2: marquinhosss (14470 in chips) 
Seat 3: despair515 (12233 in chips) 
Seat 4: AkwasYT (20326 in chips) 
Seat 5: zioeddy2312 (6620 in chips) 
Seat 6: ricardons8 (10370 in chips) 
assalbi: posts the ante 75
marquinhosss: posts the ante 75
despair515: posts the ante 75
AkwasYT: posts the ante 75
zioeddy2312: posts the ante 75
ricardons8: posts the ante 75
ricardons8: posts small blind 150
assalbi: posts big blind 300
*** HOLE CARDS ***
marquinhosss: folds 
despair515: folds 
AkwasYT: folds 
zioeddy2312: raises 600 to 900
ricardons8: raises 9395 to 10295 and is all-in
assalbi: folds 
zioeddy2312: calls 5645 and is all-in
Uncalled bet (3750) returned to ricardons8
*** FLOP *** [8d 4h 8s]
*** TURN *** [8d 4h 8s] [Jh]
*** RIVER *** [8d 4h 8s Jh] [Qs]
*** SHOW DOWN ***
ricardons8: shows [Tc As] (a pair of Eights)
zioeddy2312: shows [Jc Qc] (two pair, Queens and Jacks)
zioeddy2312 collected 13840 from pot
*** SUMMARY ***
Total pot 13840 | Rake 0 
Board [8d 4h 8s Jh Qs]
Seat 1: assalbi (big blind) folded before Flop
Seat 2: marquinhosss folded before Flop (didn't bet)
Seat 3: despair515 folded before Flop (didn't bet)
Seat 4: AkwasYT folded before Flop (didn't bet)
Seat 5: zioeddy2312 (button) showed [Jc Qc] and won (13840) with two pair, Queens and Jacks
Seat 6: ricardons8 (small blind) showed [Tc As] and lost with a pair of Eights

PokerStars Hand #251209457991: Tournament #3769361908, $52.38+$2.62 USD Hold'em No Limit - Level IX (150/300) - 2024/06/26 22:26:59 UTC [2024/06/26 18:26:59 ET]
Table '3769361908 5' 6-max Seat #6 is the button
Seat 1: assalbi (25867 in chips) is sitting out
Seat 2: marquinhosss (14395 in chips) 
Seat 3: despair515 (12158 in chips) 
Seat 4: AkwasYT (20251 in chips) 
Seat 5: zioeddy2312 (13840 in chips) 
Seat 6: ricardons8 (3750 in chips) 
assalbi: posts the ante 75
marquinhosss: posts the ante 75
despair515: posts the ante 75
AkwasYT: posts the ante 75
zioeddy2312: posts the ante 75
ricardons8: posts the ante 75
assalbi: posts small blind 150
marquinhosss: posts big blind 300
*** HOLE CARDS ***
despair515: folds 
AkwasYT: raises 300 to 600
zioeddy2312: folds 
ricardons8: raises 3075 to 3675 and is all-in
assalbi: folds 
marquinhosss: folds 
AkwasYT: calls 3075
*** FLOP *** [2d 8h 4d]
*** TURN *** [2d 8h 4d] [3s]
*** RIVER *** [2d 8h 4d 3s] [6d]
*** SHOW DOWN ***
AkwasYT: shows [Qd Qc] (a pair of Queens)
ricardons8: shows [Ah Ks] (high card Ace)
AkwasYT collected 8250 from pot
ricardons8 finished the tournament
*** SUMMARY ***
Total pot 8250 | Rake 0 
Board [2d 8h 4d 3s 6d]
Seat 1: assalbi (small blind) folded before Flop
Seat 2: marquinhosss (big blind) folded before Flop
Seat 3: despair515 folded before Flop (didn't bet)
Seat 4: AkwasYT showed [Qd Qc] and won (8250) with a pair of Queens
Seat 5: zioeddy2312 folded before Flop (didn't bet)
Seat 6: ricardons8 (button) showed [Ah Ks] and lost with high card Ace

PokerStars Hand #251209466510: Tournament #3769361908, $52.38+$2.62 USD Hold'em No Limit - Level IX (150/300) - 2024/06/26 22:27:30 UTC [2024/06/26 18:27:30 ET]
Table '3769361908 5' 6-max Seat #1 is the button
Seat 1: assalbi (25642 in chips) is sitting out
Seat 2: marquinhosss (14020 in chips) 
Seat 4: AkwasYT (24751 in chips) 
Seat 5: zioeddy2312 (13765 in chips) 
assalbi: posts the ante 75
marquinhosss: posts the ante 75
AkwasYT: posts the ante 75
zioeddy2312: posts the ante 75
marquinhosss: posts small blind 150
AkwasYT: posts big blind 300
*** HOLE CARDS ***
zioeddy2312: folds 
assalbi: folds 
burianjpb is disconnected 
marquinhosss: calls 150
AkwasYT: raises 300 to 600
marquinhosss: calls 300
*** FLOP *** [8c 4s 2c]
marquinhosss: checks 
AkwasYT: checks 
*** TURN *** [8c 4s 2c] [Tc]
marquinhosss: bets 495
AkwasYT: calls 495
*** RIVER *** [8c 4s 2c Tc] [Kd]
marquinhosss: bets 822
AkwasYT: folds 
Uncalled bet (822) returned to marquinhosss
marquinhosss collected 2490 from pot
marquinhosss: doesn't show hand 
*** SUMMARY ***
Total pot 2490 | Rake 0 
Board [8c 4s 2c Tc Kd]
Seat 1: assalbi (button) folded before Flop (didn't bet)
Seat 2: marquinhosss (small blind) collected (2490)
Seat 4: AkwasYT (big blind) folded on the River
Seat 5: zioeddy2312 folded before Flop (didn't bet)

PokerStars Hand #251209480145: Tournament #3769361908, $52.38+$2.62 USD Hold'em No Limit - Level IX (150/300) - 2024/06/26 22:28:19 UTC [2024/06/26 18:28:19 ET]
Table '3769361908 5' 6-max Seat #2 is the button
Seat 1: assalbi (25567 in chips) is sitting out
Seat 2: marquinhosss (15340 in chips) 
Seat 3: burianjpb (13090 in chips) out of hand (moved from another table into small blind)
Seat 4: AkwasYT (23581 in chips) 
Seat 5: zioeddy2312 (13690 in chips) 
burianjpb will be allowed to play after the button
assalbi: posts the ante 75
marquinhosss: posts the ante 75
AkwasYT: posts the ante 75
zioeddy2312: posts the ante 75
AkwasYT: posts small blind 150
zioeddy2312: posts big blind 300
*** HOLE CARDS ***
assalbi: folds 
marquinhosss: raises 300 to 600
AkwasYT: calls 450
zioeddy2312: folds 
*** FLOP *** [9s 2d Kd]
AkwasYT: checks 
marquinhosss: bets 594
AkwasYT: calls 594
*** TURN *** [9s 2d Kd] [7h]
AkwasYT: bets 900
marquinhosss: calls 900
*** RIVER *** [9s 2d Kd 7h] [4c]
AkwasYT: checks 
marquinhosss: checks 
*** SHOW DOWN ***
AkwasYT: shows [Kc Th] (a pair of Kings)
marquinhosss: mucks hand 
AkwasYT collected 4788 from pot
*** SUMMARY ***
Total pot 4788 | Rake 0 
Board [9s 2d Kd 7h 4c]
Seat 1: assalbi folded before Flop (didn't bet)
Seat 2: marquinhosss (button) mucked
Seat 4: AkwasYT (small blind) showed [Kc Th] and won (4788) with a pair of Kings
Seat 5: zioeddy2312 (big blind) folded before Flop

PokerStars Hand #251209491052: Tournament #3769361908, $52.38+$2.62 USD Hold'em No Limit - Level IX (150/300) - 2024/06/26 22:28:58 UTC [2024/06/26 18:28:58 ET]
Table '3769361908 5' 6-max Seat #4 is the button
Seat 1: assalbi (25492 in chips) is sitting out
Seat 2: marquinhosss (13171 in chips) 
Seat 3: burianjpb (13090 in chips) 
Seat 4: AkwasYT (26200 in chips) 
Seat 5: zioeddy2312 (13315 in chips) 
assalbi: posts the ante 75
marquinhosss: posts the ante 75
burianjpb: posts the ante 75
AkwasYT: posts the ante 75
zioeddy2312: posts the ante 75
zioeddy2312: posts small blind 150
assalbi: posts big blind 300
*** HOLE CARDS ***
marquinhosss: folds 
burianjpb: folds 
AkwasYT: folds 
zioeddy2312: raises 300 to 600
assalbi: folds 
Uncalled bet (300) returned to zioeddy2312
zioeddy2312 collected 975 from pot
*** SUMMARY ***
Total pot 975 | Rake 0 
Seat 1: assalbi (big blind) folded before Flop
Seat 2: marquinhosss folded before Flop (didn't bet)
Seat 3: burianjpb folded before Flop (didn't bet)
Seat 4: AkwasYT (button) folded before Flop (didn't bet)
Seat 5: zioeddy2312 (small blind) collected (975)

PokerStars Hand #251209497894: Tournament #3769361908, $52.38+$2.62 USD Hold'em No Limit - Level X (200/400) - 2024/06/26 22:29:23 UTC [2024/06/26 18:29:23 ET]
Table '3769361908 5' 6-max Seat #5 is the button
Seat 1: assalbi (25117 in chips) is sitting out
Seat 2: marquinhosss (13096 in chips) 
Seat 3: burianjpb (13015 in chips) 
Seat 4: AkwasYT (26125 in chips) 
Seat 5: zioeddy2312 (13915 in chips) 
assalbi: posts the ante 100
marquinhosss: posts the ante 100
burianjpb: posts the ante 100
AkwasYT: posts the ante 100
zioeddy2312: posts the ante 100
assalbi: posts small blind 200
marquinhosss: posts big blind 400
*** HOLE CARDS ***
burianjpb: folds 
AkwasYT: raises 400 to 800
zioeddy2312: folds 
assalbi: folds 
marquinhosss: calls 400
*** FLOP *** [3h 8c 7s]
marquinhosss: checks 
AkwasYT: checks 
*** TURN *** [3h 8c 7s] [5c]
marquinhosss: checks 
assalbi has returned
AkwasYT: bets 800
marquinhosss: calls 800
*** RIVER *** [3h 8c 7s 5c] [Qs]
marquinhosss: checks 
AkwasYT: bets 1200
marquinhosss: calls 1200
*** SHOW DOWN ***
AkwasYT: shows [Tc Ah] (high card Ace)
marquinhosss: mucks hand 
AkwasYT collected 6300 from pot
*** SUMMARY ***
Total pot 6300 | Rake 0 
Board [3h 8c 7s 5c Qs]
Seat 1: assalbi (small blind) folded before Flop
Seat 2: marquinhosss (big blind) mucked
Seat 3: burianjpb folded before Flop (didn't bet)
Seat 4: AkwasYT showed [Tc Ah] and won (6300) with high card Ace
Seat 5: zioeddy2312 (button) folded before Flop (didn't bet)

PokerStars Hand #251209511634: Tournament #3769361908, $52.38+$2.62 USD Hold'em No Limit - Level X (200/400) - 2024/06/26 22:30:11 UTC [2024/06/26 18:30:11 ET]
Table '3769361908 5' 6-max Seat #1 is the button
Seat 1: assalbi (24817 in chips) 
Seat 2: marquinhosss (10196 in chips) 
Seat 3: burianjpb (12915 in chips) 
Seat 4: AkwasYT (29525 in chips) 
Seat 5: zioeddy2312 (13815 in chips) 
Seat 6: antonisar (10000 in chips) 
assalbi: posts the ante 100
marquinhosss: posts the ante 100
burianjpb: posts the ante 100
AkwasYT: posts the ante 100
zioeddy2312: posts the ante 100
antonisar: posts the ante 100
marquinhosss: posts small blind 200
burianjpb: posts big blind 400
*** HOLE CARDS ***
AkwasYT: folds 
zioeddy2312: folds 
antonisar: folds 
assalbi has timed out
assalbi: folds 
assalbi is sitting out
marquinhosss: calls 200
burianjpb: raises 800 to 1200
marquinhosss: calls 800
*** FLOP *** [7s 5s 3d]
marquinhosss: checks 
burianjpb: checks 
*** TURN *** [7s 5s 3d] [9d]
marquinhosss: checks 
burianjpb: checks 
*** RIVER *** [7s 5s 3d 9d] [2h]
marquinhosss: checks 
burianjpb: checks 
*** SHOW DOWN ***
marquinhosss: shows [3c Ad] (a pair of Threes)
burianjpb: mucks hand 
marquinhosss collected 3000 from pot
*** SUMMARY ***
Total pot 3000 | Rake 0 
Board [7s 5s 3d 9d 2h]
Seat 1: assalbi (button) folded before Flop (didn't bet)
Seat 2: marquinhosss (small blind) showed [3c Ad] and won (3000) with a pair of Threes
Seat 3: burianjpb (big blind) mucked
Seat 4: AkwasYT folded before Flop (didn't bet)
Seat 5: zioeddy2312 folded before Flop (didn't bet)
Seat 6: antonisar folded before Flop (didn't bet)

PokerStars Hand #251209535093: Tournament #3769361908, $52.38+$2.62 USD Hold'em No Limit - Level X (200/400) - 2024/06/26 22:31:37 UTC [2024/06/26 18:31:37 ET]
Table '3769361908 5' 6-max Seat #2 is the button
Seat 1: assalbi (24717 in chips) is sitting out
Seat 2: marquinhosss (11896 in chips) 
Seat 3: burianjpb (11615 in chips) 
Seat 4: AkwasYT (29425 in chips) 
Seat 5: zioeddy2312 (13715 in chips) 
Seat 6: antonisar (9900 in chips) 
assalbi: posts the ante 100
marquinhosss: posts the ante 100
burianjpb: posts the ante 100
AkwasYT: posts the ante 100
zioeddy2312: posts the ante 100
antonisar: posts the ante 100
burianjpb: posts small blind 200
AkwasYT: posts big blind 400
*** HOLE CARDS ***
zioeddy2312: raises 800 to 1200
antonisar: calls 1200
assalbi: folds 
marquinhosss: raises 10596 to 11796 and is all-in
burianjpb: folds 
AkwasYT: folds 
zioeddy2312: folds 
antonisar: calls 8600 and is all-in
Uncalled bet (1996) returned to marquinhosss
*** FLOP *** [Ts Kd Kh]
*** TURN *** [Ts Kd Kh] [5c]
*** RIVER *** [Ts Kd Kh 5c] [9c]
*** SHOW DOWN ***
antonisar: shows [Js Ac] (a pair of Kings)
marquinhosss: shows [Kc As] (three of a kind, Kings)
marquinhosss collected 22000 from pot
antonisar finished the tournament
*** SUMMARY ***
Total pot 22000 | Rake 0 
Board [Ts Kd Kh 5c 9c]
Seat 1: assalbi folded before Flop (didn't bet)
Seat 2: marquinhosss (button) showed [Kc As] and won (22000) with three of a kind, Kings
Seat 3: burianjpb (small blind) folded before Flop
Seat 4: AkwasYT (big blind) folded before Flop
Seat 5: zioeddy2312 folded before Flop
Seat 6: antonisar showed [Js Ac] and lost with a pair of Kings

PokerStars Hand #251209551859: Tournament #3769361908, $52.38+$2.62 USD Hold'em No Limit - Level XI (250/500) - 2024/06/26 22:32:38 UTC [2024/06/26 18:32:38 ET]
Table '3769361908 5' 6-max Seat #3 is the button
Seat 1: assalbi (24617 in chips) is sitting out
Seat 2: marquinhosss (23996 in chips) 
Seat 3: burianjpb (11315 in chips) 
Seat 4: AkwasYT (28925 in chips) 
Seat 5: zioeddy2312 (12415 in chips) 
assalbi: posts the ante 125
marquinhosss: posts the ante 125
burianjpb: posts the ante 125
AkwasYT: posts the ante 125
zioeddy2312: posts the ante 125
AkwasYT: posts small blind 250
zioeddy2312: posts big blind 500
*** HOLE CARDS ***
assalbi: folds 
marquinhosss: folds 
burianjpb: folds 
AkwasYT: calls 250
zioeddy2312: checks 
*** FLOP *** [4d Ah 7c]
AkwasYT: checks 
zioeddy2312: checks 
*** TURN *** [4d Ah 7c] [8h]
AkwasYT: bets 1000
zioeddy2312: calls 1000
*** RIVER *** [4d Ah 7c 8h] [5h]
AkwasYT: checks 
zioeddy2312: bets 2500
AkwasYT: folds 
Uncalled bet (2500) returned to zioeddy2312
zioeddy2312 collected 3625 from pot
*** SUMMARY ***
Total pot 3625 | Rake 0 
Board [4d Ah 7c 8h 5h]
Seat 1: assalbi folded before Flop (didn't bet)
Seat 2: marquinhosss folded before Flop (didn't bet)
Seat 3: burianjpb (button) folded before Flop (didn't bet)
Seat 4: AkwasYT (small blind) folded on the River
Seat 5: zioeddy2312 (big blind) collected (3625)

PokerStars Hand #251209569606: Tournament #3769361908, $52.38+$2.62 USD Hold'em No Limit - Level XI (250/500) - 2024/06/26 22:33:45 UTC [2024/06/26 18:33:45 ET]
Table '3769361908 5' 6-max Seat #4 is the button
Seat 1: assalbi (24492 in chips) is sitting out
Seat 2: marquinhosss (23871 in chips) 
Seat 3: burianjpb (11190 in chips) 
Seat 4: AkwasYT (27300 in chips) 
Seat 5: zioeddy2312 (14415 in chips) 
assalbi: posts the ante 125
marquinhosss: posts the ante 125
burianjpb: posts the ante 125
AkwasYT: posts the ante 125
zioeddy2312: posts the ante 125
zioeddy2312: posts small blind 250
assalbi: posts big blind 500
*** HOLE CARDS ***
marquinhosss: folds 
burianjpb: folds 
AkwasYT: folds 
zioeddy2312: folds 
Uncalled bet (250) returned to assalbi
assalbi collected 1125 from pot
assalbi: doesn't show hand 
*** SUMMARY ***
Total pot 1125 | Rake 0 
Seat 1: assalbi (big blind) collected (1125)
Seat 2: marquinhosss folded before Flop (didn't bet)
Seat 3: burianjpb folded before Flop (didn't bet)
Seat 4: AkwasYT (button) folded before Flop (didn't bet)
Seat 5: zioeddy2312 (small blind) folded before Flop

PokerStars Hand #251209571950: Tournament #3769361908, $52.38+$2.62 USD Hold'em No Limit - Level XI (250/500) - 2024/06/26 22:33:53 UTC [2024/06/26 18:33:53 ET]
Table '3769361908 5' 6-max Seat #5 is the button
Seat 1: assalbi (25242 in chips) is sitting out
Seat 2: marquinhosss (23746 in chips) 
Seat 3: burianjpb (11065 in chips) 
Seat 4: AkwasYT (27175 in chips) 
Seat 5: zioeddy2312 (14040 in chips) 
assalbi: posts the ante 125
marquinhosss: posts the ante 125
burianjpb: posts the ante 125
AkwasYT: posts the ante 125
zioeddy2312: posts the ante 125
assalbi: posts small blind 250
marquinhosss: posts big blind 500
*** HOLE CARDS ***
burianjpb: folds 
AkwasYT: folds 
zioeddy2312: folds 
assalbi: folds 
Uncalled bet (250) returned to marquinhosss
marquinhosss collected 1125 from pot
marquinhosss: doesn't show hand 
*** SUMMARY ***
Total pot 1125 | Rake 0 
Seat 1: assalbi (small blind) folded before Flop
Seat 2: marquinhosss (big blind) collected (1125)
Seat 3: burianjpb folded before Flop (didn't bet)
Seat 4: AkwasYT folded before Flop (didn't bet)
Seat 5: zioeddy2312 (button) folded before Flop (didn't bet)

PokerStars Hand #251209574863: Tournament #3769361908, $52.38+$2.62 USD Hold'em No Limit - Level XI (250/500) - 2024/06/26 22:34:04 UTC [2024/06/26 18:34:04 ET]
Table '3769361908 5' 6-max Seat #1 is the button
Seat 1: assalbi (24867 in chips) is sitting out
Seat 2: marquinhosss (24496 in chips) 
Seat 3: burianjpb (10940 in chips) 
Seat 4: AkwasYT (27050 in chips) 
Seat 5: zioeddy2312 (13915 in chips) 
assalbi: posts the ante 125
marquinhosss: posts the ante 125
burianjpb: posts the ante 125
AkwasYT: posts the ante 125
zioeddy2312: posts the ante 125
marquinhosss: posts small blind 250
burianjpb: posts big blind 500
*** HOLE CARDS ***
AkwasYT: folds 
zioeddy2312: folds 
assalbi: folds 
marquinhosss: calls 250
burianjpb: checks 
*** FLOP *** [Tc 7s Kh]
marquinhosss: bets 500
burianjpb: calls 500
*** TURN *** [Tc 7s Kh] [Td]
marquinhosss: checks 
burianjpb: bets 865
marquinhosss: calls 865
*** RIVER *** [Tc 7s Kh Td] [6h]
marquinhosss: bets 3702
burianjpb: folds 
Uncalled bet (3702) returned to marquinhosss
marquinhosss collected 4355 from pot
marquinhosss: doesn't show hand 
*** SUMMARY ***
Total pot 4355 | Rake 0 
Board [Tc 7s Kh Td 6h]
Seat 1: assalbi (button) folded before Flop (didn't bet)
Seat 2: marquinhosss (small blind) collected (4355)
Seat 3: burianjpb (big blind) folded on the River
Seat 4: AkwasYT folded before Flop (didn't bet)
Seat 5: zioeddy2312 folded before Flop (didn't bet)

PokerStars Hand #251209588156: Tournament #3769361908, $52.38+$2.62 USD Hold'em No Limit - Level XI (250/500) - 2024/06/26 22:34:53 UTC [2024/06/26 18:34:53 ET]
Table '3769361908 5' 6-max Seat #2 is the button
Seat 1: assalbi (24742 in chips) is sitting out
Seat 2: marquinhosss (26861 in chips) 
Seat 3: burianjpb (8950 in chips) 
Seat 4: AkwasYT (26925 in chips) 
Seat 5: zioeddy2312 (13790 in chips) 
Seat 6: adrf1999 (10000 in chips) 
assalbi: posts the ante 125
marquinhosss: posts the ante 125
burianjpb: posts the ante 125
AkwasYT: posts the ante 125
zioeddy2312: posts the ante 125
adrf1999: posts the ante 125
burianjpb: posts small blind 250
AkwasYT: posts big blind 500
*** HOLE CARDS ***
zioeddy2312: folds 
adrf1999: raises 500 to 1000
assalbi: folds 
marquinhosss: folds 
burianjpb: calls 750
AkwasYT: calls 500
*** FLOP *** [4c Td Qc]
burianjpb: checks 
AkwasYT: checks 
adrf1999: bets 1000
burianjpb: calls 1000
AkwasYT: folds 
*** TURN *** [4c Td Qc] [Ks]
burianjpb: checks 
adrf1999: bets 2000
burianjpb: raises 4825 to 6825 and is all-in
adrf1999: calls 4825
*** RIVER *** [4c Td Qc Ks] [Qd]
*** SHOW DOWN ***
burianjpb: shows [Kd 9d] (two pair, Kings and Queens)
adrf1999: shows [4s 4d] (a full house, Fours full of Queens)
adrf1999 collected 19400 from pot
burianjpb finished the tournament
*** SUMMARY ***
Total pot 19400 | Rake 0 
Board [4c Td Qc Ks Qd]
Seat 1: assalbi folded before Flop (didn't bet)
Seat 2: marquinhosss (button) folded before Flop (didn't bet)
Seat 3: burianjpb (small blind) showed [Kd 9d] and lost with two pair, Kings and Queens
Seat 4: AkwasYT (big blind) folded on the Flop
Seat 5: zioeddy2312 folded before Flop (didn't bet)
Seat 6: adrf1999 showed [4s 4d] and won (19400) with a full house, Fours full of Queens

PokerStars Hand #251209607364: Tournament #3769361908, $52.38+$2.62 USD Hold'em No Limit - Level XII (300/600) - 2024/06/26 22:36:04 UTC [2024/06/26 18:36:04 ET]
Table '3769361908 5' 6-max Seat #4 is the button
Seat 1: assalbi (24617 in chips) is sitting out
Seat 2: marquinhosss (26736 in chips) 
Seat 4: AkwasYT (25800 in chips) 
Seat 5: zioeddy2312 (13665 in chips) 
Seat 6: adrf1999 (20450 in chips) 
assalbi: posts the ante 150
marquinhosss: posts the ante 150
AkwasYT: posts the ante 150
zioeddy2312: posts the ante 150
adrf1999: posts the ante 150
zioeddy2312: posts small blind 300
adrf1999: posts big blind 600
*** HOLE CARDS ***
assalbi: folds 
marquinhosss: folds 
AkwasYT: folds 
zioeddy2312: raises 1800 to 2400
adrf1999: raises 17900 to 20300 and is all-in
zioeddy2312: calls 11115 and is all-in
Uncalled bet (6785) returned to adrf1999
assalbi has returned
*** FLOP *** [As 7s Qh]
*** TURN *** [As 7s Qh] [Kd]
*** RIVER *** [As 7s Qh Kd] [6s]
*** SHOW DOWN ***
zioeddy2312: shows [Qd Ah] (two pair, Aces and Queens)
adrf1999: shows [Kh Jc] (a pair of Kings)
zioeddy2312 collected 27780 from pot
*** SUMMARY ***
Total pot 27780 | Rake 0 
Board [As 7s Qh Kd 6s]
Seat 1: assalbi folded before Flop (didn't bet)
Seat 2: marquinhosss folded before Flop (didn't bet)
Seat 4: AkwasYT (button) folded before Flop (didn't bet)
Seat 5: zioeddy2312 (small blind) showed [Qd Ah] and won (27780) with two pair, Aces and Queens
Seat 6: adrf1999 (big blind) showed [Kh Jc] and lost with a pair of Kings

PokerStars Hand #251209616827: Tournament #3769361908, $52.38+$2.62 USD Hold'em No Limit - Level XII (300/600) - 2024/06/26 22:36:40 UTC [2024/06/26 18:36:40 ET]
Table '3769361908 5' 6-max Seat #5 is the button
Seat 1: assalbi (24467 in chips) 
Seat 2: marquinhosss (26586 in chips) 
Seat 4: AkwasYT (25650 in chips) 
Seat 5: zioeddy2312 (27780 in chips) 
Seat 6: adrf1999 (6785 in chips) 
assalbi: posts the ante 150
marquinhosss: posts the ante 150
AkwasYT: posts the ante 150
zioeddy2312: posts the ante 150
adrf1999: posts the ante 150
adrf1999: posts small blind 300
assalbi: posts big blind 600
*** HOLE CARDS ***
marquinhosss: raises 600 to 1200
AkwasYT: folds 
zioeddy2312: folds 
adrf1999: folds 
assalbi: calls 600
*** FLOP *** [Jc 4d 9h]
assalbi: checks 
marquinhosss: bets 1139
assalbi: calls 1139
*** TURN *** [Jc 4d 9h] [8h]
assalbi: checks 
marquinhosss: bets 3780
assalbi: calls 3780
*** RIVER *** [Jc 4d 9h 8h] [6c]
assalbi: checks 
marquinhosss: checks 
*** SHOW DOWN ***
assalbi: shows [Td Kd] (high card King)
marquinhosss: shows [9d 8d] (two pair, Nines and Eights)
marquinhosss collected 13288 from pot
*** SUMMARY ***
Total pot 13288 | Rake 0 
Board [Jc 4d 9h 8h 6c]
Seat 1: assalbi (big blind) showed [Td Kd] and lost with high card King
Seat 2: marquinhosss showed [9d 8d] and won (13288) with two pair, Nines and Eights
Seat 4: AkwasYT folded before Flop (didn't bet)
Seat 5: zioeddy2312 (button) folded before Flop (didn't bet)
Seat 6: adrf1999 (small blind) folded before Flop

PokerStars Hand #251209629572: Tournament #3769361908, $52.38+$2.62 USD Hold'em No Limit - Level XII (300/600) - 2024/06/26 22:37:28 UTC [2024/06/26 18:37:28 ET]
Table '3769361908 5' 6-max Seat #6 is the button
Seat 1: assalbi (18198 in chips) 
Seat 2: marquinhosss (33605 in chips) 
Seat 3: Chuckster388 (10000 in chips) 
Seat 4: AkwasYT (25500 in chips) 
Seat 5: zioeddy2312 (27630 in chips) 
Seat 6: adrf1999 (6335 in chips) 
assalbi: posts the ante 150
marquinhosss: posts the ante 150
Chuckster388: posts the ante 150
AkwasYT: posts the ante 150
zioeddy2312: posts the ante 150
adrf1999: posts the ante 150
assalbi: posts small blind 300
marquinhosss: posts big blind 600
*** HOLE CARDS ***
Chuckster388: folds 
AkwasYT: raises 600 to 1200
zioeddy2312: folds 
adrf1999: folds 
assalbi: folds 
marquinhosss: calls 600
*** FLOP *** [As 7s 5s]
marquinhosss: checks 
AkwasYT: bets 1800
marquinhosss: raises 4500 to 6300
AkwasYT: folds [Kd Kc]
Uncalled bet (4500) returned to marquinhosss
marquinhosss collected 7200 from pot
marquinhosss: doesn't show hand 
*** SUMMARY ***
Total pot 7200 | Rake 0 
Board [As 7s 5s]
Seat 1: assalbi (small blind) folded before Flop
Seat 2: marquinhosss (big blind) collected (7200)
Seat 3: Chuckster388 folded before Flop (didn't bet)
Seat 4: AkwasYT folded on the Flop
Seat 5: zioeddy2312 folded before Flop (didn't bet)
Seat 6: adrf1999 (button) folded before Flop (didn't bet)

PokerStars Hand #251209646196: Tournament #3769361908, $52.38+$2.62 USD Hold'em No Limit - Level XIII (400/800) - 2024/06/26 22:38:30 UTC [2024/06/26 18:38:30 ET]
Table '3769361908 5' 6-max Seat #1 is the button
Seat 1: assalbi (17748 in chips) 
Seat 2: marquinhosss (37655 in chips) 
Seat 3: Chuckster388 (9850 in chips) 
Seat 4: AkwasYT (22350 in chips) 
Seat 5: zioeddy2312 (27480 in chips) 
Seat 6: adrf1999 (6185 in chips) 
assalbi: posts the ante 200
marquinhosss: posts the ante 200
Chuckster388: posts the ante 200
AkwasYT: posts the ante 200
zioeddy2312: posts the ante 200
adrf1999: posts the ante 200
marquinhosss: posts small blind 400
Chuckster388: posts big blind 800
*** HOLE CARDS ***
AkwasYT: folds 
zioeddy2312: raises 1600 to 2400
adrf1999: raises 3585 to 5985 and is all-in
assalbi: folds 
marquinhosss: calls 5585
Chuckster388: folds 
zioeddy2312: folds 
*** FLOP *** [Tc Kh Kc]
*** TURN *** [Tc Kh Kc] [Qc]
*** RIVER *** [Tc Kh Kc Qc] [8d]
*** SHOW DOWN ***
marquinhosss: shows [Ah Jd] (a straight, Ten to Ace)
adrf1999: shows [6c 6h] (two pair, Kings and Sixes)
marquinhosss collected 16370 from pot
adrf1999 finished the tournament
*** SUMMARY ***
Total pot 16370 | Rake 0 
Board [Tc Kh Kc Qc 8d]
Seat 1: assalbi (button) folded before Flop (didn't bet)
Seat 2: marquinhosss (small blind) showed [Ah Jd] and won (16370) with a straight, Ten to Ace
Seat 3: Chuckster388 (big blind) folded before Flop
Seat 4: AkwasYT folded before Flop (didn't bet)
Seat 5: zioeddy2312 folded before Flop
Seat 6: adrf1999 showed [6c 6h] and lost with two pair, Kings and Sixes

PokerStars Hand #251209655542: Tournament #3769361908, $52.38+$2.62 USD Hold'em No Limit - Level XIII (400/800) - 2024/06/26 22:39:05 UTC [2024/06/26 18:39:05 ET]
Table '3769361908 5' 6-max Seat #2 is the button
Seat 1: assalbi (17548 in chips) 
Seat 2: marquinhosss (47840 in chips) 
Seat 3: Chuckster388 (8850 in chips) 
Seat 4: AkwasYT (22150 in chips) 
Seat 5: zioeddy2312 (24880 in chips) 
assalbi: posts the ante 200
marquinhosss: posts the ante 200
Chuckster388: posts the ante 200
AkwasYT: posts the ante 200
zioeddy2312: posts the ante 200
Chuckster388: posts small blind 400
AkwasYT: posts big blind 800
*** HOLE CARDS ***
zioeddy2312: folds 
assalbi: raises 800 to 1600
marquinhosss: folds 
Chuckster388: folds 
AkwasYT: calls 800
*** FLOP *** [Qs Tc Kc]
AkwasYT: bets 2400
assalbi: calls 2400
*** TURN *** [Qs Tc Kc] [8s]
AkwasYT: checks 
assalbi: checks 
*** RIVER *** [Qs Tc Kc 8s] [4h]
AkwasYT: checks 
assalbi: checks 
*** SHOW DOWN ***
AkwasYT: shows [Ts 7c] (a pair of Tens)
assalbi: mucks hand 
AkwasYT collected 9400 from pot
*** SUMMARY ***
Total pot 9400 | Rake 0 
Board [Qs Tc Kc 8s 4h]
Seat 1: assalbi mucked
Seat 2: marquinhosss (button) folded before Flop (didn't bet)
Seat 3: Chuckster388 (small blind) folded before Flop
Seat 4: AkwasYT (big blind) showed [Ts 7c] and won (9400) with a pair of Tens
Seat 5: zioeddy2312 folded before Flop (didn't bet)

PokerStars Hand #251209668666: Tournament #3769361908, $52.38+$2.62 USD Hold'em No Limit - Level XIII (400/800) - 2024/06/26 22:39:54 UTC [2024/06/26 18:39:54 ET]
Table '3769361908 5' 6-max Seat #3 is the button
Seat 1: assalbi (13348 in chips) 
Seat 2: marquinhosss (47640 in chips) 
Seat 3: Chuckster388 (8250 in chips) 
Seat 4: AkwasYT (27350 in chips) 
Seat 5: zioeddy2312 (24680 in chips) 
Seat 6: sinister778 (34396 in chips) 
assalbi: posts the ante 200
marquinhosss: posts the ante 200
Chuckster388: posts the ante 200
AkwasYT: posts the ante 200
zioeddy2312: posts the ante 200
sinister778: posts the ante 200
AkwasYT: posts small blind 400
zioeddy2312: posts big blind 800
*** HOLE CARDS ***
sinister778: raises 800 to 1600
assalbi: folds 
marquinhosss: folds 
Chuckster388: folds 
AkwasYT: folds 
zioeddy2312: calls 800
*** FLOP *** [2c Ad Td]
zioeddy2312: checks 
sinister778: bets 2400
zioeddy2312: calls 2400
*** TURN *** [2c Ad Td] [Ks]
zioeddy2312: checks 
sinister778: bets 5600
zioeddy2312: calls 5600
*** RIVER *** [2c Ad Td Ks] [9c]
zioeddy2312: checks 
sinister778: bets 24596 and is all-in
zioeddy2312: folds 
Uncalled bet (24596) returned to sinister778
sinister778 collected 20800 from pot
*** SUMMARY ***
Total pot 20800 | Rake 0 
Board [2c Ad Td Ks 9c]
Seat 1: assalbi folded before Flop (didn't bet)
Seat 2: marquinhosss folded before Flop (didn't bet)
Seat 3: Chuckster388 (button) folded before Flop (didn't bet)
Seat 4: AkwasYT (small blind) folded before Flop
Seat 5: zioeddy2312 (big blind) folded on the River
Seat 6: sinister778 collected (20800)

PokerStars Hand #251209698479: Tournament #3769361908, $52.38+$2.62 USD Hold'em No Limit - Level XIV (500/1000) - 2024/06/26 22:41:48 UTC [2024/06/26 18:41:48 ET]
Table '3769361908 5' 6-max Seat #4 is the button
Seat 1: assalbi (13148 in chips) 
Seat 2: marquinhosss (47440 in chips) 
Seat 3: Chuckster388 (8050 in chips) 
Seat 4: AkwasYT (26750 in chips) 
Seat 5: zioeddy2312 (14880 in chips) 
Seat 6: sinister778 (45396 in chips) 
assalbi: posts the ante 250
marquinhosss: posts the ante 250
Chuckster388: posts the ante 250
AkwasYT: posts the ante 250
zioeddy2312: posts the ante 250
sinister778: posts the ante 250
zioeddy2312: posts small blind 500
sinister778: posts big blind 1000
*** HOLE CARDS ***
assalbi: folds 
marquinhosss: raises 1000 to 2000
Chuckster388: folds 
AkwasYT: folds 
zioeddy2312: folds 
sinister778: calls 1000
*** FLOP *** [Ad As 2c]
sinister778: checks 
marquinhosss: bets 1500
sinister778: folds 
Uncalled bet (1500) returned to marquinhosss
marquinhosss collected 6000 from pot
marquinhosss: doesn't show hand 
*** SUMMARY ***
Total pot 6000 | Rake 0 
Board [Ad As 2c]
Seat 1: assalbi folded before Flop (didn't bet)
Seat 2: marquinhosss collected (6000)
Seat 3: Chuckster388 folded before Flop (didn't bet)
Seat 4: AkwasYT (button) folded before Flop (didn't bet)
Seat 5: zioeddy2312 (small blind) folded before Flop
Seat 6: sinister778 (big blind) folded on the Flop

PokerStars Hand #251209712105: Tournament #3769361908, $52.38+$2.62 USD Hold'em No Limit - Level XIV (500/1000) - 2024/06/26 22:42:41 UTC [2024/06/26 18:42:41 ET]
Table '3769361908 5' 6-max Seat #5 is the button
Seat 1: assalbi (12898 in chips) 
Seat 2: marquinhosss (51190 in chips) 
Seat 3: Chuckster388 (7800 in chips) 
Seat 4: AkwasYT (26500 in chips) 
Seat 5: zioeddy2312 (14130 in chips) 
Seat 6: sinister778 (43146 in chips) 
assalbi: posts the ante 250
marquinhosss: posts the ante 250
Chuckster388: posts the ante 250
AkwasYT: posts the ante 250
zioeddy2312: posts the ante 250
sinister778: posts the ante 250
sinister778: posts small blind 500
assalbi: posts big blind 1000
*** HOLE CARDS ***
marquinhosss: folds 
Chuckster388: folds 
AkwasYT: raises 1000 to 2000
zioeddy2312: folds 
sinister778: folds 
assalbi: calls 1000
*** FLOP *** [4d 9c As]
assalbi: checks 
AkwasYT: bets 2000
assalbi: folds 
Uncalled bet (2000) returned to AkwasYT
AkwasYT collected 6000 from pot
AkwasYT: doesn't show hand 
*** SUMMARY ***
Total pot 6000 | Rake 0 
Board [4d 9c As]
Seat 1: assalbi (big blind) folded on the Flop
Seat 2: marquinhosss folded before Flop (didn't bet)
Seat 3: Chuckster388 folded before Flop (didn't bet)
Seat 4: AkwasYT collected (6000)
Seat 5: zioeddy2312 (button) folded before Flop (didn't bet)
Seat 6: sinister778 (small blind) folded before Flop

PokerStars Hand #251209721496: Tournament #3769361908, $52.38+$2.62 USD Hold'em No Limit - Level XIV (500/1000) - 2024/06/26 22:43:18 UTC [2024/06/26 18:43:18 ET]
Table '3769361908 5' 6-max Seat #6 is the button
Seat 1: assalbi (10648 in chips) 
Seat 2: marquinhosss (50940 in chips) 
Seat 3: Chuckster388 (7550 in chips) 
Seat 4: AkwasYT (30250 in chips) 
Seat 5: zioeddy2312 (13880 in chips) 
Seat 6: sinister778 (42396 in chips) 
assalbi: posts the ante 250
marquinhosss: posts the ante 250
Chuckster388: posts the ante 250
AkwasYT: posts the ante 250
zioeddy2312: posts the ante 250
sinister778: posts the ante 250
assalbi: posts small blind 500
marquinhosss: posts big blind 1000
*** HOLE CARDS ***
Chuckster388: folds 
AkwasYT: folds 
zioeddy2312: folds 
sinister778: raises 1000 to 2000
assalbi: folds 
marquinhosss: calls 1000
*** FLOP *** [6s Kh 8d]
marquinhosss: checks 
sinister778: bets 2500
marquinhosss: folds 
Uncalled bet (2500) returned to sinister778
sinister778 collected 6000 from pot
*** SUMMARY ***
Total pot 6000 | Rake 0 
Board [6s Kh 8d]
Seat 1: assalbi (small blind) folded before Flop
Seat 2: marquinhosss (big blind) folded on the Flop
Seat 3: Chuckster388 folded before Flop (didn't bet)
Seat 4: AkwasYT folded before Flop (didn't bet)
Seat 5: zioeddy2312 folded before Flop (didn't bet)
Seat 6: sinister778 (button) collected (6000)

PokerStars Hand #251209736206: Tournament #3769361908, $52.38+$2.62 USD Hold'em No Limit - Level XV (600/1200) - 2024/06/26 22:44:15 UTC [2024/06/26 18:44:15 ET]
Table '3769361908 5' 6-max Seat #1 is the button
Seat 1: assalbi (9898 in chips) 
Seat 2: marquinhosss (48690 in chips) 
Seat 3: Chuckster388 (7300 in chips) 
Seat 4: AkwasYT (30000 in chips) 
Seat 5: zioeddy2312 (13630 in chips) 
Seat 6: sinister778 (46146 in chips) 
assalbi: posts the ante 300
marquinhosss: posts the ante 300
Chuckster388: posts the ante 300
AkwasYT: posts the ante 300
zioeddy2312: posts the ante 300
sinister778: posts the ante 300
marquinhosss: posts small blind 600
Chuckster388: posts big blind 1200
*** HOLE CARDS ***
AkwasYT: raises 2400 to 3600
zioeddy2312: folds 
sinister778: folds 
assalbi: folds 
marquinhosss: folds 
Chuckster388: calls 2400
*** FLOP *** [Kh 9s 6c]
Chuckster388: bets 3400 and is all-in
AkwasYT: calls 3400
*** TURN *** [Kh 9s 6c] [5s]
*** RIVER *** [Kh 9s 6c 5s] [2s]
*** SHOW DOWN ***
Chuckster388: shows [6h Ah] (a pair of Sixes)
AkwasYT: shows [Qc As] (high card Ace)
Chuckster388 collected 16400 from pot
*** SUMMARY ***
Total pot 16400 | Rake 0 
Board [Kh 9s 6c 5s 2s]
Seat 1: assalbi (button) folded before Flop (didn't bet)
Seat 2: marquinhosss (small blind) folded before Flop
Seat 3: Chuckster388 (big blind) showed [6h Ah] and won (16400) with a pair of Sixes
Seat 4: AkwasYT showed [Qc As] and lost with high card Ace
Seat 5: zioeddy2312 folded before Flop (didn't bet)
Seat 6: sinister778 folded before Flop (didn't bet)

PokerStars Hand #251209747343: Tournament #3769361908, $52.38+$2.62 USD Hold'em No Limit - Level XV (600/1200) - 2024/06/26 22:44:58 UTC [2024/06/26 18:44:58 ET]
Table '3769361908 5' 6-max Seat #2 is the button
Seat 1: assalbi (9598 in chips) 
Seat 2: marquinhosss (47790 in chips) 
Seat 3: Chuckster388 (16400 in chips) 
Seat 4: AkwasYT (22700 in chips) 
Seat 5: zioeddy2312 (13330 in chips) 
Seat 6: sinister778 (45846 in chips) 
assalbi: posts the ante 300
marquinhosss: posts the ante 300
Chuckster388: posts the ante 300
AkwasYT: posts the ante 300
zioeddy2312: posts the ante 300
sinister778: posts the ante 300
Chuckster388: posts small blind 600
AkwasYT: posts big blind 1200
*** HOLE CARDS ***
zioeddy2312: raises 11830 to 13030 and is all-in
sinister778: folds 
assalbi: folds 
marquinhosss: folds 
Chuckster388: folds 
AkwasYT: folds 
Uncalled bet (11830) returned to zioeddy2312
zioeddy2312 collected 4800 from pot
*** SUMMARY ***
Total pot 4800 | Rake 0 
Seat 1: assalbi folded before Flop (didn't bet)
Seat 2: marquinhosss (button) folded before Flop (didn't bet)
Seat 3: Chuckster388 (small blind) folded before Flop
Seat 4: AkwasYT (big blind) folded before Flop
Seat 5: zioeddy2312 collected (4800)
Seat 6: sinister778 folded before Flop (didn't bet)

PokerStars Hand #251209751443: Tournament #3769361908, $52.38+$2.62 USD Hold'em No Limit - Level XV (600/1200) - 2024/06/26 22:45:14 UTC [2024/06/26 18:45:14 ET]
Table '3769361908 5' 6-max Seat #3 is the button
Seat 1: assalbi (9298 in chips) 
Seat 2: marquinhosss (47490 in chips) 
Seat 3: Chuckster388 (15500 in chips) 
Seat 4: AkwasYT (21200 in chips) 
Seat 5: zioeddy2312 (16630 in chips) 
Seat 6: sinister778 (45546 in chips) 
assalbi: posts the ante 300
marquinhosss: posts the ante 300
Chuckster388: posts the ante 300
AkwasYT: posts the ante 300
zioeddy2312: posts the ante 300
sinister778: posts the ante 300
AkwasYT: posts small blind 600
zioeddy2312: posts big blind 1200
*** HOLE CARDS ***
sinister778: raises 1200 to 2400
assalbi: raises 6598 to 8998 and is all-in
marquinhosss: folds 
Chuckster388: folds 
AkwasYT: raises 11902 to 20900 and is all-in
zioeddy2312: folds 
sinister778: calls 18500
*** FLOP *** [Js 2c Jh]
*** TURN *** [Js 2c Jh] [8h]
*** RIVER *** [Js 2c Jh 8h] [7d]
*** SHOW DOWN ***
AkwasYT: shows [Qd Td] (a pair of Jacks)
sinister778: shows [Ah Kh] (a pair of Jacks - Ace kicker)
sinister778 collected 23804 from side pot
assalbi: shows [Ts Ac] (a pair of Jacks - lower kicker)
sinister778 collected 29994 from main pot
AkwasYT finished the tournament
assalbi finished the tournament
IgorHKR is disconnected 
*** SUMMARY ***
Total pot 53798 Main pot 29994. Side pot 23804. | Rake 0 
Board [Js 2c Jh 8h 7d]
Seat 1: assalbi showed [Ts Ac] and lost with a pair of Jacks
Seat 2: marquinhosss folded before Flop (didn't bet)
Seat 3: Chuckster388 (button) folded before Flop (didn't bet)
Seat 4: AkwasYT (small blind) showed [Qd Td] and lost with a pair of Jacks
Seat 5: zioeddy2312 (big blind) folded before Flop
Seat 6: sinister778 showed [Ah Kh] and won (53798) with a pair of Jacks

PokerStars Hand #251209760768: Tournament #3769361908, $52.38+$2.62 USD Hold'em No Limit - Level XV (600/1200) - 2024/06/26 22:45:50 UTC [2024/06/26 18:45:50 ET]
Table '3769361908 5' 6-max Seat #5 is the button
Seat 1: IgorHKR (10000 in chips) 
Seat 2: marquinhosss (47190 in chips) 
Seat 3: Chuckster388 (15200 in chips) 
Seat 5: zioeddy2312 (15130 in chips) 
Seat 6: sinister778 (78144 in chips) 
IgorHKR: posts the ante 300
marquinhosss: posts the ante 300
Chuckster388: posts the ante 300
zioeddy2312: posts the ante 300
sinister778: posts the ante 300
sinister778: posts small blind 600
IgorHKR: posts big blind 1200
*** HOLE CARDS ***
marquinhosss: folds 
Chuckster388: raises 13700 to 14900 and is all-in
zioeddy2312: folds 
sinister778: folds 
IgorHKR: folds 
Uncalled bet (13700) returned to Chuckster388
Chuckster388 collected 4500 from pot
Chuckster388: doesn't show hand 
*** SUMMARY ***
Total pot 4500 | Rake 0 
Seat 1: IgorHKR (big blind) folded before Flop
Seat 2: marquinhosss folded before Flop (didn't bet)
Seat 3: Chuckster388 collected (4500)
Seat 5: zioeddy2312 (button) folded before Flop (didn't bet)
Seat 6: sinister778 (small blind) folded before Flop

PokerStars Hand #251209764897: Tournament #3769361908, $52.38+$2.62 USD Hold'em No Limit - Level XV (600/1200) - 2024/06/26 22:46:06 UTC [2024/06/26 18:46:06 ET]
Table '3769361908 5' 6-max Seat #6 is the button
Seat 1: IgorHKR (8500 in chips) 
Seat 2: marquinhosss (46890 in chips) 
Seat 3: Chuckster388 (18200 in chips) 
Seat 5: zioeddy2312 (14830 in chips) 
Seat 6: sinister778 (77244 in chips) 
IgorHKR: posts the ante 300
marquinhosss: posts the ante 300
Chuckster388: posts the ante 300
zioeddy2312: posts the ante 300
sinister778: posts the ante 300
IgorHKR: posts small blind 600
marquinhosss: posts big blind 1200
*** HOLE CARDS ***
Theo7171 is disconnected 
Chuckster388: raises 1320 to 2520
zioeddy2312: folds 
sinister778: folds 
IgorHKR: folds 
marquinhosss: folds 
Uncalled bet (1320) returned to Chuckster388
Chuckster388 collected 4500 from pot
Chuckster388: doesn't show hand 
*** SUMMARY ***
Total pot 4500 | Rake 0 
Seat 1: IgorHKR (small blind) folded before Flop
Seat 2: marquinhosss (big blind) folded before Flop
Seat 3: Chuckster388 collected (4500)
Seat 5: zioeddy2312 folded before Flop (didn't bet)
Seat 6: sinister778 (button) folded before Flop (didn't bet)

PokerStars Hand #251209770205: Tournament #3769361908, $52.38+$2.62 USD Hold'em No Limit - Level XV (600/1200) - 2024/06/26 22:46:27 UTC [2024/06/26 18:46:27 ET]
Table '3769361908 5' 6-max Seat #1 is the button
Seat 1: IgorHKR (7600 in chips) 
Seat 2: marquinhosss (45390 in chips) 
Seat 3: Chuckster388 (21200 in chips) 
Seat 4: Theo7171 (10000 in chips) 
Seat 5: zioeddy2312 (14530 in chips) 
Seat 6: sinister778 (76944 in chips) 
IgorHKR: posts the ante 300
marquinhosss: posts the ante 300
Chuckster388: posts the ante 300
Theo7171: posts the ante 300
zioeddy2312: posts the ante 300
sinister778: posts the ante 300
marquinhosss: posts small blind 600
Chuckster388: posts big blind 1200
*** HOLE CARDS ***
Theo7171: folds 
zioeddy2312: folds 
sinister778: folds 
IgorHKR: folds 
marquinhosss: raises 43890 to 45090 and is all-in
Chuckster388: folds 
Uncalled bet (43890) returned to marquinhosss
marquinhosss collected 4200 from pot
marquinhosss: doesn't show hand 
*** SUMMARY ***
Total pot 4200 | Rake 0 
Seat 1: IgorHKR (button) folded before Flop (didn't bet)
Seat 2: marquinhosss (small blind) collected (4200)
Seat 3: Chuckster388 (big blind) folded before Flop
Seat 4: Theo7171 folded before Flop (didn't bet)
Seat 5: zioeddy2312 folded before Flop (didn't bet)
Seat 6: sinister778 folded before Flop (didn't bet)

PokerStars Hand #251209775738: Tournament #3769361908, $52.38+$2.62 USD Hold'em No Limit - Level XV (600/1200) - 2024/06/26 22:46:49 UTC [2024/06/26 18:46:49 ET]
Table '3769361908 5' 6-max Seat #2 is the button
Seat 1: IgorHKR (7300 in chips) 
Seat 2: marquinhosss (48090 in chips) 
Seat 3: Chuckster388 (19700 in chips) 
Seat 4: Theo7171 (9700 in chips) 
Seat 5: zioeddy2312 (14230 in chips) 
Seat 6: sinister778 (76644 in chips) 
IgorHKR: posts the ante 300
marquinhosss: posts the ante 300
Chuckster388: posts the ante 300
Theo7171: posts the ante 300
zioeddy2312: posts the ante 300
sinister778: posts the ante 300
Chuckster388: posts small blind 600
Theo7171: posts big blind 1200
*** HOLE CARDS ***
zioeddy2312: folds 
sinister778: raises 1800 to 3000
IgorHKR: folds 
marquinhosss: folds 
Chuckster388: folds 
Theo7171: calls 1800
*** FLOP *** [9d 8s Ks]
Theo7171: bets 6400 and is all-in
sinister778: calls 6400
*** TURN *** [9d 8s Ks] [5s]
*** RIVER *** [9d 8s Ks 5s] [Tc]
*** SHOW DOWN ***
Theo7171: shows [Th Jd] (a pair of Tens)
sinister778: shows [Ts As] (a flush, Ace high)
sinister778 collected 21200 from pot
Theo7171 finished the tournament
*** SUMMARY ***
Total pot 21200 | Rake 0 
Board [9d 8s Ks 5s Tc]
Seat 1: IgorHKR folded before Flop (didn't bet)
Seat 2: marquinhosss (button) folded before Flop (didn't bet)
Seat 3: Chuckster388 (small blind) folded before Flop
Seat 4: Theo7171 (big blind) showed [Th Jd] and lost with a pair of Tens
Seat 5: zioeddy2312 folded before Flop (didn't bet)
Seat 6: sinister778 showed [Ts As] and won (21200) with a flush, Ace high

PokerStars Hand #251209784941: Tournament #3769361908, $52.38+$2.62 USD Hold'em No Limit - Level XVI (800/1600) - 2024/06/26 22:47:25 UTC [2024/06/26 18:47:25 ET]
Table '3769361908 5' 6-max Seat #3 is the button
Seat 1: IgorHKR (7000 in chips) 
Seat 2: marquinhosss (47790 in chips) 
Seat 3: Chuckster388 (18800 in chips) 
Seat 5: zioeddy2312 (13930 in chips) 
Seat 6: sinister778 (88144 in chips) 
IgorHKR: posts the ante 400
marquinhosss: posts the ante 400
Chuckster388: posts the ante 400
zioeddy2312: posts the ante 400
sinister778: posts the ante 400
zioeddy2312: posts small blind 800
sinister778: posts big blind 1600
*** HOLE CARDS ***
IgorHKR: raises 5000 to 6600 and is all-in
marquinhosss: folds 
Chuckster388: raises 11800 to 18400 and is all-in
zioeddy2312: folds 
sinister778: folds 
Uncalled bet (11800) returned to Chuckster388
*** FLOP *** [9s Jh 6d]
*** TURN *** [9s Jh 6d] [2s]
*** RIVER *** [9s Jh 6d 2s] [3d]
*** SHOW DOWN ***
IgorHKR: shows [8h 8d] (a pair of Eights)
Chuckster388: shows [Kc 9d] (a pair of Nines)
Chuckster388 collected 17600 from pot
IgorHKR finished the tournament
$ubuta1 is disconnected 
*** SUMMARY ***
Total pot 17600 | Rake 0 
Board [9s Jh 6d 2s 3d]
Seat 1: IgorHKR showed [8h 8d] and lost with a pair of Eights
Seat 2: marquinhosss folded before Flop (didn't bet)
Seat 3: Chuckster388 (button) showed [Kc 9d] and won (17600) with a pair of Nines
Seat 5: zioeddy2312 (small blind) folded before Flop
Seat 6: sinister778 (big blind) folded before Flop

PokerStars Hand #251209794496: Tournament #3769361908, $52.38+$2.62 USD Hold'em No Limit - Level XVI (800/1600) - 2024/06/26 22:48:03 UTC [2024/06/26 18:48:03 ET]
Table '3769361908 5' 6-max Seat #5 is the button
Seat 2: marquinhosss (47390 in chips) 
Seat 3: Chuckster388 (29400 in chips) 
Seat 4: $ubuta1 (19448 in chips) 
Seat 5: zioeddy2312 (12730 in chips) 
Seat 6: sinister778 (86144 in chips) 
marquinhosss: posts the ante 400
Chuckster388: posts the ante 400
$ubuta1: posts the ante 400
zioeddy2312: posts the ante 400
sinister778: posts the ante 400
sinister778: posts small blind 800
marquinhosss: posts big blind 1600
*** HOLE CARDS ***
Chuckster388: folds 
$ubuta1: folds 
zioeddy2312: folds 
DeathBrain09 is disconnected 
sinister778: calls 800
marquinhosss: checks 
*** FLOP *** [2d 7h 3s]
sinister778: bets 3200
marquinhosss: raises 8000 to 11200
sinister778: folds 
Uncalled bet (8000) returned to marquinhosss
marquinhosss collected 11600 from pot
marquinhosss: doesn't show hand 
*** SUMMARY ***
Total pot 11600 | Rake 0 
Board [2d 7h 3s]
Seat 2: marquinhosss (big blind) collected (11600)
Seat 3: Chuckster388 folded before Flop (didn't bet)
Seat 4: $ubuta1 folded before Flop (didn't bet)
Seat 5: zioeddy2312 (button) folded before Flop (didn't bet)
Seat 6: sinister778 (small blind) folded on the Flop

PokerStars Hand #251209805603: Tournament #3769361908, $52.38+$2.62 USD Hold'em No Limit - Level XVI (800/1600) - 2024/06/26 22:48:46 UTC [2024/06/26 18:48:46 ET]
Table '3769361908 5' 6-max Seat #6 is the button
Seat 1: DeathBrain09 (28700 in chips) out of hand (moved from another table into small blind)
Seat 2: marquinhosss (53790 in chips) 
Seat 3: Chuckster388 (29000 in chips) 
Seat 4: $ubuta1 (19048 in chips) 
Seat 5: zioeddy2312 (12330 in chips) 
Seat 6: sinister778 (80944 in chips) 
DeathBrain09 will be allowed to play after the button
marquinhosss: posts the ante 400
Chuckster388: posts the ante 400
$ubuta1: posts the ante 400
zioeddy2312: posts the ante 400
sinister778: posts the ante 400
marquinhosss: posts small blind 800
Chuckster388: posts big blind 1600
*** HOLE CARDS ***
$ubuta1: folds 
zioeddy2312: raises 10330 to 11930 and is all-in
sinister778: folds 
marquinhosss: folds 
Chuckster388: calls 10330
*** FLOP *** [As 7d 7h]
*** TURN *** [As 7d 7h] [4h]
*** RIVER *** [As 7d 7h 4h] [Qh]
*** SHOW DOWN ***
Chuckster388: shows [2s Ac] (two pair, Aces and Sevens)
zioeddy2312: shows [6d Ad] (two pair, Aces and Sevens)
Chuckster388 collected 13330 from pot
zioeddy2312 collected 13330 from pot
*** SUMMARY ***
Total pot 26660 | Rake 0 
Board [As 7d 7h 4h Qh]
Seat 2: marquinhosss (small blind) folded before Flop
Seat 3: Chuckster388 (big blind) showed [2s Ac] and won (13330) with two pair, Aces and Sevens
Seat 4: $ubuta1 folded before Flop (didn't bet)
Seat 5: zioeddy2312 showed [6d Ad] and won (13330) with two pair, Aces and Sevens
Seat 6: sinister778 (button) folded before Flop (didn't bet)

PokerStars Hand #251209813181: Tournament #3769361908, $52.38+$2.62 USD Hold'em No Limit - Level XVI (800/1600) - 2024/06/26 22:49:17 UTC [2024/06/26 18:49:17 ET]
Table '3769361908 5' 6-max Seat #2 is the button
Seat 1: DeathBrain09 (28700 in chips) 
Seat 2: marquinhosss (52590 in chips) 
Seat 3: Chuckster388 (30000 in chips) 
Seat 4: $ubuta1 (18648 in chips) 
Seat 5: zioeddy2312 (13330 in chips) 
Seat 6: sinister778 (80544 in chips) 
DeathBrain09: posts the ante 400
marquinhosss: posts the ante 400
Chuckster388: posts the ante 400
$ubuta1: posts the ante 400
zioeddy2312: posts the ante 400
sinister778: posts the ante 400
Chuckster388: posts small blind 800
$ubuta1: posts big blind 1600
*** HOLE CARDS ***
zioeddy2312: raises 11330 to 12930 and is all-in
sinister778: calls 12930
DeathBrain09: folds 
marquinhosss: folds 
Chuckster388: folds 
$ubuta1: folds 
*** FLOP *** [4d 6s Jd]
*** TURN *** [4d 6s Jd] [7s]
*** RIVER *** [4d 6s Jd 7s] [7c]
*** SHOW DOWN ***
zioeddy2312: shows [9d Ah] (a pair of Sevens)
sinister778: shows [Kd Jh] (two pair, Jacks and Sevens)
sinister778 collected 30660 from pot
zioeddy2312 finished the tournament in 116th place
*** SUMMARY ***
Total pot 30660 | Rake 0 
Board [4d 6s Jd 7s 7c]
Seat 1: DeathBrain09 folded before Flop (didn't bet)
Seat 2: marquinhosss (button) folded before Flop (didn't bet)
Seat 3: Chuckster388 (small blind) folded before Flop
Seat 4: $ubuta1 (big blind) folded before Flop
Seat 5: zioeddy2312 showed [9d Ah] and lost with a pair of Sevens
Seat 6: sinister778 showed [Kd Jh] and won (30660) with two pair, Jacks and Sevens

PokerStars Hand #251209820827: Tournament #3769361908, $52.38+$2.62 USD Hold'em No Limit - Level XVI (800/1600) - 2024/06/26 22:49:48 UTC [2024/06/26 18:49:48 ET]
Table '3769361908 5' 6-max Seat #3 is the button
Seat 1: DeathBrain09 (28300 in chips) 
Seat 2: marquinhosss (52190 in chips) 
Seat 3: Chuckster388 (28800 in chips) 
Seat 4: $ubuta1 (16648 in chips) 
Seat 6: sinister778 (97874 in chips) 
DeathBrain09: posts the ante 400
marquinhosss: posts the ante 400
Chuckster388: posts the ante 400
$ubuta1: posts the ante 400
sinister778: posts the ante 400
$ubuta1: posts small blind 800
sinister778: posts big blind 1600
*** HOLE CARDS ***
DeathBrain09: folds 
marquinhosss: folds 
Chuckster388: folds 
$ubuta1: raises 14648 to 16248 and is all-in
sinister778: calls 14648
*** FLOP *** [9h 6c 2h]
*** TURN *** [9h 6c 2h] [9s]
*** RIVER *** [9h 6c 2h 9s] [Kh]
*** SHOW DOWN ***
$ubuta1: shows [6s Ad] (two pair, Nines and Sixes)
sinister778: shows [4c Kd] (two pair, Kings and Nines)
sinister778 collected 34496 from pot
$ubuta1 finished the tournament in 110th place
*** SUMMARY ***
Total pot 34496 | Rake 0 
Board [9h 6c 2h 9s Kh]
Seat 1: DeathBrain09 folded before Flop (didn't bet)
Seat 2: marquinhosss folded before Flop (didn't bet)
Seat 3: Chuckster388 (button) folded before Flop (didn't bet)
Seat 4: $ubuta1 (small blind) showed [6s Ad] and lost with two pair, Nines and Sixes
Seat 6: sinister778 (big blind) showed [4c Kd] and won (34496) with two pair, Kings and Nines

PokerStars Hand #251209830105: Tournament #3769361908, $52.38+$2.62 USD Hold'em No Limit - Level XVII (1000/2000) - 2024/06/26 22:50:25 UTC [2024/06/26 18:50:25 ET]
Table '3769361908 5' 6-max Seat #6 is the button
Seat 1: DeathBrain09 (27900 in chips) 
Seat 2: marquinhosss (51790 in chips) 
Seat 3: Chuckster388 (28400 in chips) 
Seat 4: xxxppp (33800 in chips) 
Seat 5: SicKTHPS (62577 in chips) 
Seat 6: sinister778 (115722 in chips) 
DeathBrain09: posts the ante 500
marquinhosss: posts the ante 500
Chuckster388: posts the ante 500
xxxppp: posts the ante 500
SicKTHPS: posts the ante 500
sinister778: posts the ante 500
DeathBrain09: posts small blind 1000
marquinhosss: posts big blind 2000
*** HOLE CARDS ***
Chuckster388: folds 
xxxppp: folds 
SicKTHPS: raises 2000 to 4000
sinister778: calls 4000
DeathBrain09: folds 
marquinhosss: raises 47290 to 51290 and is all-in
SicKTHPS: folds 
sinister778: folds 
Uncalled bet (47290) returned to marquinhosss
marquinhosss collected 16000 from pot
marquinhosss: doesn't show hand 
*** SUMMARY ***
Total pot 16000 | Rake 0 
Seat 1: DeathBrain09 (small blind) folded before Flop
Seat 2: marquinhosss (big blind) collected (16000)
Seat 3: Chuckster388 folded before Flop (didn't bet)
Seat 4: xxxppp folded before Flop (didn't bet)
Seat 5: SicKTHPS folded before Flop
Seat 6: sinister778 (button) folded before Flop

PokerStars Hand #251209840285: Tournament #3769361908, $52.38+$2.62 USD Hold'em No Limit - Level XVII (1000/2000) - 2024/06/26 22:51:08 UTC [2024/06/26 18:51:08 ET]
Table '3769361908 5' 6-max Seat #1 is the button
Seat 1: DeathBrain09 (26400 in chips) 
Seat 2: marquinhosss (63290 in chips) 
Seat 3: Chuckster388 (27900 in chips) 
Seat 4: xxxppp (33300 in chips) 
Seat 5: SicKTHPS (58077 in chips) 
Seat 6: sinister778 (111222 in chips) 
DeathBrain09: posts the ante 500
marquinhosss: posts the ante 500
Chuckster388: posts the ante 500
xxxppp: posts the ante 500
SicKTHPS: posts the ante 500
sinister778: posts the ante 500
marquinhosss: posts small blind 1000
Chuckster388: posts big blind 2000
*** HOLE CARDS ***
xxxppp: raises 2000 to 4000
SicKTHPS: folds 
sinister778: folds 
DeathBrain09: folds 
marquinhosss: folds 
Chuckster388: calls 2000
*** FLOP *** [5d 7d Qh]
Chuckster388: checks 
xxxppp: bets 4000
Chuckster388: calls 4000
*** TURN *** [5d 7d Qh] [9c]
Chuckster388: checks 
xxxppp: checks 
*** RIVER *** [5d 7d Qh 9c] [5s]
Chuckster388: bets 6000
xxxppp: calls 6000
*** SHOW DOWN ***
Chuckster388: shows [3c Qc] (two pair, Queens and Fives)
xxxppp: mucks hand 
Chuckster388 collected 32000 from pot
*** SUMMARY ***
Total pot 32000 | Rake 0 
Board [5d 7d Qh 9c 5s]
Seat 1: DeathBrain09 (button) folded before Flop (didn't bet)
Seat 2: marquinhosss (small blind) folded before Flop
Seat 3: Chuckster388 (big blind) showed [3c Qc] and won (32000) with two pair, Queens and Fives
Seat 4: xxxppp mucked
Seat 5: SicKTHPS folded before Flop (didn't bet)
Seat 6: sinister778 folded before Flop (didn't bet)

PokerStars Hand #251209848835: Tournament #3769361908, $52.38+$2.62 USD Hold'em No Limit - Level XVII (1000/2000) - 2024/06/26 22:51:42 UTC [2024/06/26 18:51:42 ET]
Table '3769361908 5' 6-max Seat #2 is the button
Seat 1: DeathBrain09 (25900 in chips) 
Seat 2: marquinhosss (61790 in chips) 
Seat 3: Chuckster388 (45400 in chips) 
Seat 4: xxxppp (18800 in chips) 
Seat 5: SicKTHPS (57577 in chips) 
Seat 6: sinister778 (110722 in chips) 
DeathBrain09: posts the ante 500
marquinhosss: posts the ante 500
Chuckster388: posts the ante 500
xxxppp: posts the ante 500
SicKTHPS: posts the ante 500
sinister778: posts the ante 500
Chuckster388: posts small blind 1000
xxxppp: posts big blind 2000
*** HOLE CARDS ***
SicKTHPS: folds 
sinister778: folds 
DeathBrain09: folds 
marquinhosss: raises 2000 to 4000
Chuckster388: folds 
xxxppp: calls 2000
*** FLOP *** [8d 5h Kc]
xxxppp: checks 
marquinhosss: bets 2000
xxxppp: folds 
Uncalled bet (2000) returned to marquinhosss
marquinhosss collected 12000 from pot
marquinhosss: doesn't show hand 
*** SUMMARY ***
Total pot 12000 | Rake 0 
Board [8d 5h Kc]
Seat 1: DeathBrain09 folded before Flop (didn't bet)
Seat 2: marquinhosss (button) collected (12000)
Seat 3: Chuckster388 (small blind) folded before Flop
Seat 4: xxxppp (big blind) folded on the Flop
Seat 5: SicKTHPS folded before Flop (didn't bet)
Seat 6: sinister778 folded before Flop (didn't bet)

PokerStars Hand #251209854597: Tournament #3769361908, $52.38+$2.62 USD Hold'em No Limit - Level XVII (1000/2000) - 2024/06/26 22:52:06 UTC [2024/06/26 18:52:06 ET]
Table '3769361908 5' 6-max Seat #3 is the button
Seat 1: DeathBrain09 (25400 in chips) 
Seat 2: marquinhosss (69290 in chips) 
Seat 3: Chuckster388 (43900 in chips) 
Seat 4: xxxppp (14300 in chips) 
Seat 5: SicKTHPS (57077 in chips) 
Seat 6: sinister778 (110222 in chips) 
DeathBrain09: posts the ante 500
marquinhosss: posts the ante 500
Chuckster388: posts the ante 500
xxxppp: posts the ante 500
SicKTHPS: posts the ante 500
sinister778: posts the ante 500
xxxppp: posts small blind 1000
SicKTHPS: posts big blind 2000
*** HOLE CARDS ***
sinister778: folds 
DeathBrain09: folds 
marquinhosss: raises 2000 to 4000
Chuckster388: folds 
xxxppp: calls 3000
SicKTHPS: folds 
*** FLOP *** [Js 8d 2h]
xxxppp: bets 9800 and is all-in
marquinhosss: calls 9800
*** TURN *** [Js 8d 2h] [Th]
*** RIVER *** [Js 8d 2h Th] [6s]
*** SHOW DOWN ***
xxxppp: shows [Ks 4s] (high card King)
marquinhosss: shows [Tc Kh] (a pair of Tens)
marquinhosss collected 32600 from pot
xxxppp finished the tournament in 93rd place
*** SUMMARY ***
Total pot 32600 | Rake 0 
Board [Js 8d 2h Th 6s]
Seat 1: DeathBrain09 folded before Flop (didn't bet)
Seat 2: marquinhosss showed [Tc Kh] and won (32600) with a pair of Tens
Seat 3: Chuckster388 (button) folded before Flop (didn't bet)
Seat 4: xxxppp (small blind) showed [Ks 4s] and lost with high card King
Seat 5: SicKTHPS (big blind) folded before Flop
Seat 6: sinister778 folded before Flop (didn't bet)

PokerStars Hand #251209862488: Tournament #3769361908, $52.38+$2.62 USD Hold'em No Limit - Level XVII (1000/2000) - 2024/06/26 22:52:38 UTC [2024/06/26 18:52:38 ET]
Table '3769361908 5' 6-max Seat #5 is the button
Seat 1: DeathBrain09 (24900 in chips) 
Seat 2: marquinhosss (87590 in chips) 
Seat 3: Chuckster388 (43400 in chips) 
Seat 5: SicKTHPS (54577 in chips) 
Seat 6: sinister778 (109722 in chips) 
DeathBrain09: posts the ante 500
marquinhosss: posts the ante 500
Chuckster388: posts the ante 500
SicKTHPS: posts the ante 500
sinister778: posts the ante 500
sinister778: posts small blind 1000
DeathBrain09: posts big blind 2000
*** HOLE CARDS ***
marquinhosss: folds 
Chuckster388: raises 2000 to 4000
SicKTHPS: folds 
sinister778: folds 
DeathBrain09: calls 2000
*** FLOP *** [8d 2h 9d]
DeathBrain09: checks 
Chuckster388: checks 
*** TURN *** [8d 2h 9d] [5h]
DeathBrain09: bets 3680
Chuckster388: calls 3680
*** RIVER *** [8d 2h 9d 5h] [4c]
DeathBrain09: bets 16720 and is all-in
Chuckster388: folds 
Uncalled bet (16720) returned to DeathBrain09
DeathBrain09 collected 18860 from pot
*** SUMMARY ***
Total pot 18860 | Rake 0 
Board [8d 2h 9d 5h 4c]
Seat 1: DeathBrain09 (big blind) collected (18860)
Seat 2: marquinhosss folded before Flop (didn't bet)
Seat 3: Chuckster388 folded on the River
Seat 5: SicKTHPS (button) folded before Flop (didn't bet)
Seat 6: sinister778 (small blind) folded before Flop

PokerStars Hand #251209873218: Tournament #3769361908, $52.38+$2.62 USD Hold'em No Limit - Level XVIII (1200/2400) - 2024/06/26 22:53:22 UTC [2024/06/26 18:53:22 ET]
Table '3769361908 5' 6-max Seat #6 is the button
Seat 1: DeathBrain09 (35580 in chips) 
Seat 2: marquinhosss (87090 in chips) 
Seat 3: Chuckster388 (35220 in chips) 
Seat 4: jvieiradias8 (13900 in chips) 
Seat 5: SicKTHPS (54077 in chips) 
Seat 6: sinister778 (108222 in chips) 
DeathBrain09: posts the ante 600
marquinhosss: posts the ante 600
Chuckster388: posts the ante 600
jvieiradias8: posts the ante 600
SicKTHPS: posts the ante 600
sinister778: posts the ante 600
DeathBrain09: posts small blind 1200
marquinhosss: posts big blind 2400
*** HOLE CARDS ***
Chuckster388: folds 
jvieiradias8: raises 10900 to 13300 and is all-in
SicKTHPS: folds 
sinister778: folds 
DeathBrain09: folds 
marquinhosss: folds 
Uncalled bet (10900) returned to jvieiradias8
jvieiradias8 collected 9600 from pot
jvieiradias8: doesn't show hand 
*** SUMMARY ***
Total pot 9600 | Rake 0 
Seat 1: DeathBrain09 (small blind) folded before Flop
Seat 2: marquinhosss (big blind) folded before Flop
Seat 3: Chuckster388 folded before Flop (didn't bet)
Seat 4: jvieiradias8 collected (9600)
Seat 5: SicKTHPS folded before Flop (didn't bet)
Seat 6: sinister778 (button) folded before Flop (didn't bet)

PokerStars Hand #251209879638: Tournament #3769361908, $52.38+$2.62 USD Hold'em No Limit - Level XVIII (1200/2400) - 2024/06/26 22:53:48 UTC [2024/06/26 18:53:48 ET]
Table '3769361908 5' 6-max Seat #1 is the button
Seat 1: DeathBrain09 (33780 in chips) 
Seat 2: marquinhosss (84090 in chips) 
Seat 3: Chuckster388 (34620 in chips) 
Seat 4: jvieiradias8 (20500 in chips) 
Seat 5: SicKTHPS (53477 in chips) 
Seat 6: sinister778 (107622 in chips) 
DeathBrain09: posts the ante 600
marquinhosss: posts the ante 600
Chuckster388: posts the ante 600
jvieiradias8: posts the ante 600
SicKTHPS: posts the ante 600
sinister778: posts the ante 600
marquinhosss: posts small blind 1200
Chuckster388: posts big blind 2400
*** HOLE CARDS ***
jvieiradias8: folds 
SicKTHPS: folds 
sinister778: raises 2400 to 4800
DeathBrain09: folds 
marquinhosss: folds 
Chuckster388: folds 
Uncalled bet (2400) returned to sinister778
sinister778 collected 9600 from pot
*** SUMMARY ***
Total pot 9600 | Rake 0 
Seat 1: DeathBrain09 (button) folded before Flop (didn't bet)
Seat 2: marquinhosss (small blind) folded before Flop
Seat 3: Chuckster388 (big blind) folded before Flop
Seat 4: jvieiradias8 folded before Flop (didn't bet)
Seat 5: SicKTHPS folded before Flop (didn't bet)
Seat 6: sinister778 collected (9600)

PokerStars Hand #251209888555: Tournament #3769361908, $52.38+$2.62 USD Hold'em No Limit - Level XVIII (1200/2400) - 2024/06/26 22:54:25 UTC [2024/06/26 18:54:25 ET]
Table '3769361908 5' 6-max Seat #2 is the button
Seat 1: DeathBrain09 (33180 in chips) 
Seat 2: marquinhosss (82290 in chips) 
Seat 3: Chuckster388 (31620 in chips) 
Seat 4: jvieiradias8 (19900 in chips) 
Seat 5: SicKTHPS (52877 in chips) 
Seat 6: sinister778 (114222 in chips) 
DeathBrain09: posts the ante 600
marquinhosss: posts the ante 600
Chuckster388: posts the ante 600
jvieiradias8: posts the ante 600
SicKTHPS: posts the ante 600
sinister778: posts the ante 600
Chuckster388: posts small blind 1200
jvieiradias8: posts big blind 2400
*** HOLE CARDS ***
SicKTHPS: folds 
sinister778: folds 
DeathBrain09: folds 
marquinhosss: folds 
Chuckster388: raises 28620 to 31020 and is all-in
jvieiradias8: calls 16900 and is all-in
Uncalled bet (11720) returned to Chuckster388
*** FLOP *** [4c Ac 7d]
*** TURN *** [4c Ac 7d] [Tc]
*** RIVER *** [4c Ac 7d Tc] [Qs]
*** SHOW DOWN ***
Chuckster388: shows [2c Jc] (a flush, Ace high)
jvieiradias8: shows [Ah Qd] (two pair, Aces and Queens)
Chuckster388 collected 42200 from pot
jvieiradias8 finished the tournament in 78th place
*** SUMMARY ***
Total pot 42200 | Rake 0 
Board [4c Ac 7d Tc Qs]
Seat 1: DeathBrain09 folded before Flop (didn't bet)
Seat 2: marquinhosss (button) folded before Flop (didn't bet)
Seat 3: Chuckster388 (small blind) showed [2c Jc] and won (42200) with a flush, Ace high
Seat 4: jvieiradias8 (big blind) showed [Ah Qd] and lost with two pair, Aces and Queens
Seat 5: SicKTHPS folded before Flop (didn't bet)
Seat 6: sinister778 folded before Flop (didn't bet)

PokerStars Hand #251209964596: Tournament #3769361908, $52.38+$2.62 USD Hold'em No Limit - Level XVIII (1200/2400) - 2024/06/26 23:01:09 UTC [2024/06/26 19:01:09 ET]
Table '3769361908 5' 6-max Seat #3 is the button
Seat 1: DeathBrain09 (32580 in chips) 
Seat 2: marquinhosss (81690 in chips) 
Seat 3: Chuckster388 (53920 in chips) 
Seat 4: Earl of Poker V (31812 in chips) out of hand (moved from another table into small blind)
Seat 5: SicKTHPS (52277 in chips) 
Seat 6: sinister778 (113622 in chips) 
Earl of Poker V will be allowed to play after the button
DeathBrain09: posts the ante 600
marquinhosss: posts the ante 600
Chuckster388: posts the ante 600
SicKTHPS: posts the ante 600
sinister778: posts the ante 600
SicKTHPS: posts small blind 1200
sinister778: posts big blind 2400
*** HOLE CARDS ***
DeathBrain09: folds 
marquinhosss: raises 2400 to 4800
Chuckster388: folds 
SicKTHPS: folds 
sinister778: folds 
Uncalled bet (2400) returned to marquinhosss
marquinhosss collected 9000 from pot
marquinhosss: doesn't show hand 
*** SUMMARY ***
Total pot 9000 | Rake 0 
Seat 1: DeathBrain09 folded before Flop (didn't bet)
Seat 2: marquinhosss collected (9000)
Seat 3: Chuckster388 (button) folded before Flop (didn't bet)
Seat 5: SicKTHPS (small blind) folded before Flop
Seat 6: sinister778 (big blind) folded before Flop

PokerStars Hand #251209977028: Tournament #3769361908, $52.38+$2.62 USD Hold'em No Limit - Level XVIII (1200/2400) - 2024/06/26 23:02:04 UTC [2024/06/26 19:02:04 ET]
Table '3769361908 5' 6-max Seat #5 is the button
Seat 1: DeathBrain09 (31980 in chips) 
Seat 2: marquinhosss (87690 in chips) 
Seat 3: Chuckster388 (53320 in chips) 
Seat 4: Earl of Poker V (31812 in chips) 
Seat 5: SicKTHPS (50477 in chips) 
Seat 6: sinister778 (110622 in chips) 
DeathBrain09: posts the ante 600
marquinhosss: posts the ante 600
Chuckster388: posts the ante 600
Earl of Poker V: posts the ante 600
SicKTHPS: posts the ante 600
sinister778: posts the ante 600
sinister778: posts small blind 1200
DeathBrain09: posts big blind 2400
*** HOLE CARDS ***
marquinhosss: folds 
Chuckster388: folds 
Earl of Poker V: folds 
SicKTHPS: raises 2400 to 4800
sinister778: folds 
DeathBrain09: calls 2400
*** FLOP *** [Ac 8d 9h]
DeathBrain09: checks 
SicKTHPS: bets 4896
DeathBrain09: raises 4896 to 9792
SicKTHPS: raises 35285 to 45077 and is all-in
DeathBrain09: folds 
Uncalled bet (35285) returned to SicKTHPS
SicKTHPS collected 33984 from pot
SicKTHPS: doesn't show hand 
*** SUMMARY ***
Total pot 33984 | Rake 0 
Board [Ac 8d 9h]
Seat 1: DeathBrain09 (big blind) folded on the Flop
Seat 2: marquinhosss folded before Flop (didn't bet)
Seat 3: Chuckster388 folded before Flop (didn't bet)
Seat 4: Earl of Poker V folded before Flop (didn't bet)
Seat 5: SicKTHPS (button) collected (33984)
Seat 6: sinister778 (small blind) folded before Flop

PokerStars Hand #251209986131: Tournament #3769361908, $52.38+$2.62 USD Hold'em No Limit - Level XIX (1400/2800) - 2024/06/26 23:02:43 UTC [2024/06/26 19:02:43 ET]
Table '3769361908 5' 6-max Seat #6 is the button
Seat 1: DeathBrain09 (16788 in chips) 
Seat 2: marquinhosss (87090 in chips) 
Seat 3: Chuckster388 (52720 in chips) 
Seat 4: Earl of Poker V (31212 in chips) 
Seat 5: SicKTHPS (69269 in chips) 
Seat 6: sinister778 (108822 in chips) 
DeathBrain09: posts the ante 700
marquinhosss: posts the ante 700
Chuckster388: posts the ante 700
Earl of Poker V: posts the ante 700
SicKTHPS: posts the ante 700
sinister778: posts the ante 700
DeathBrain09: posts small blind 1400
marquinhosss: posts big blind 2800
*** HOLE CARDS ***
Chuckster388: raises 4060 to 6860
Earl of Poker V: folds 
SicKTHPS: folds 
sinister778: folds 
DeathBrain09: folds 
marquinhosss: calls 4060
*** FLOP *** [Jc Qs 2c]
marquinhosss: checks 
Chuckster388: bets 6376
marquinhosss: folds 
Uncalled bet (6376) returned to Chuckster388
Chuckster388 collected 19320 from pot
Chuckster388: doesn't show hand 
*** SUMMARY ***
Total pot 19320 | Rake 0 
Board [Jc Qs 2c]
Seat 1: DeathBrain09 (small blind) folded before Flop
Seat 2: marquinhosss (big blind) folded on the Flop
Seat 3: Chuckster388 collected (19320)
Seat 4: Earl of Poker V folded before Flop (didn't bet)
Seat 5: SicKTHPS folded before Flop (didn't bet)
Seat 6: sinister778 (button) folded before Flop (didn't bet)

PokerStars Hand #251209996362: Tournament #3769361908, $52.38+$2.62 USD Hold'em No Limit - Level XIX (1400/2800) - 2024/06/26 23:03:27 UTC [2024/06/26 19:03:27 ET]
Table '3769361908 5' 6-max Seat #1 is the button
Seat 1: DeathBrain09 (14688 in chips) 
Seat 2: marquinhosss (79530 in chips) 
Seat 3: Chuckster388 (64480 in chips) 
Seat 4: Earl of Poker V (30512 in chips) 
Seat 5: SicKTHPS (68569 in chips) 
Seat 6: sinister778 (108122 in chips) 
DeathBrain09: posts the ante 700
marquinhosss: posts the ante 700
Chuckster388: posts the ante 700
Earl of Poker V: posts the ante 700
SicKTHPS: posts the ante 700
sinister778: posts the ante 700
marquinhosss: posts small blind 1400
Chuckster388: posts big blind 2800
*** HOLE CARDS ***
Earl of Poker V: folds 
SicKTHPS: folds 
sinister778: folds 
DeathBrain09: raises 11188 to 13988 and is all-in
marquinhosss: folds 
Chuckster388: folds 
Uncalled bet (11188) returned to DeathBrain09
DeathBrain09 collected 11200 from pot
*** SUMMARY ***
Total pot 11200 | Rake 0 
Seat 1: DeathBrain09 (button) collected (11200)
Seat 2: marquinhosss (small blind) folded before Flop
Seat 3: Chuckster388 (big blind) folded before Flop
Seat 4: Earl of Poker V folded before Flop (didn't bet)
Seat 5: SicKTHPS folded before Flop (didn't bet)
Seat 6: sinister778 folded before Flop (didn't bet)

PokerStars Hand #251210001660: Tournament #3769361908, $52.38+$2.62 USD Hold'em No Limit - Level XIX (1400/2800) - 2024/06/26 23:03:50 UTC [2024/06/26 19:03:50 ET]
Table '3769361908 5' 6-max Seat #2 is the button
Seat 1: DeathBrain09 (22388 in chips) 
Seat 2: marquinhosss (77430 in chips) 
Seat 3: Chuckster388 (60980 in chips) 
Seat 4: Earl of Poker V (29812 in chips) 
Seat 5: SicKTHPS (67869 in chips) 
Seat 6: sinister778 (107422 in chips) 
DeathBrain09: posts the ante 700
marquinhosss: posts the ante 700
Chuckster388: posts the ante 700
Earl of Poker V: posts the ante 700
SicKTHPS: posts the ante 700
sinister778: posts the ante 700
Chuckster388: posts small blind 1400
Earl of Poker V: posts big blind 2800
*** HOLE CARDS ***
SicKTHPS: folds 
sinister778: folds 
DeathBrain09: raises 18888 to 21688 and is all-in
marquinhosss: folds 
Chuckster388: folds 
Earl of Poker V: calls 18888
*** FLOP *** [9c 7h 4d]
*** TURN *** [9c 7h 4d] [5d]
*** RIVER *** [9c 7h 4d 5d] [7d]
*** SHOW DOWN ***
Earl of Poker V: shows [Ac Ts] (a pair of Sevens)
DeathBrain09: shows [Jd Qs] (a pair of Sevens - lower kicker)
Earl of Poker V collected 48976 from pot
DeathBrain09 finished the tournament in 67th place
*** SUMMARY ***
Total pot 48976 | Rake 0 
Board [9c 7h 4d 5d 7d]
Seat 1: DeathBrain09 showed [Jd Qs] and lost with a pair of Sevens
Seat 2: marquinhosss (button) folded before Flop (didn't bet)
Seat 3: Chuckster388 (small blind) folded before Flop
Seat 4: Earl of Poker V (big blind) showed [Ac Ts] and won (48976) with a pair of Sevens
Seat 5: SicKTHPS folded before Flop (didn't bet)
Seat 6: sinister778 folded before Flop (didn't bet)


PokerStars Hand #251209533852: Tournament #3769361908, $52.38+$2.62 USD Hold'em No Limit - Level X (200/400) - 2024/06/26 22:31:32 UTC [2024/06/26 18:31:32 ET]
Table '3769361908 4' 6-max Seat #5 is the button
Seat 1: JamPanamJam (16410 in chips) 
Seat 2: maderinha22 (9060 in chips) 
Seat 3: @tetaschell (10000 in chips) 
Seat 4: muriLLoo.mrL (11077 in chips) 
Seat 5: Everbrun11 (7416 in chips) 
Seat 6: Rochinha2011 (7520 in chips) 
JamPanamJam: posts the ante 100
maderinha22: posts the ante 100
@tetaschell: posts the ante 100
muriLLoo.mrL: posts the ante 100
Everbrun11: posts the ante 100
Rochinha2011: posts the ante 100
Rochinha2011: posts small blind 200
JamPanamJam: posts big blind 400
*** HOLE CARDS ***
maderinha22: folds 
@tetaschell: folds 
muriLLoo.mrL: raises 400 to 800
Everbrun11: raises 6516 to 7316 and is all-in
Rochinha2011: folds 
JamPanamJam: folds 
muriLLoo.mrL: folds 
Uncalled bet (6516) returned to Everbrun11
Everbrun11 collected 2800 from pot
Everbrun11: doesn't show hand 
*** SUMMARY ***
Total pot 2800 | Rake 0 
Seat 1: JamPanamJam (big blind) folded before Flop
Seat 2: maderinha22 folded before Flop (didn't bet)
Seat 3: @tetaschell folded before Flop (didn't bet)
Seat 4: muriLLoo.mrL folded before Flop
Seat 5: Everbrun11 (button) collected (2800)
Seat 6: Rochinha2011 (small blind) folded before Flop

PokerStars Hand #251209541565: Tournament #3769361908, $52.38+$2.62 USD Hold'em No Limit - Level X (200/400) - 2024/06/26 22:32:01 UTC [2024/06/26 18:32:01 ET]
Table '3769361908 4' 6-max Seat #6 is the button
Seat 1: JamPanamJam (15910 in chips) 
Seat 2: maderinha22 (8960 in chips) 
Seat 3: @tetaschell (9900 in chips) 
Seat 4: muriLLoo.mrL (10177 in chips) 
Seat 5: Everbrun11 (9316 in chips) 
Seat 6: Rochinha2011 (7220 in chips) 
JamPanamJam: posts the ante 100
maderinha22: posts the ante 100
@tetaschell: posts the ante 100
muriLLoo.mrL: posts the ante 100
Everbrun11: posts the ante 100
Rochinha2011: posts the ante 100
JamPanamJam: posts small blind 200
maderinha22: posts big blind 400
*** HOLE CARDS ***
@tetaschell: folds 
muriLLoo.mrL: raises 400 to 800
Everbrun11: folds 
Rochinha2011: folds 
JamPanamJam: folds 
maderinha22: calls 400
*** FLOP *** [As 4d 6c]
maderinha22: checks 
muriLLoo.mrL: bets 792
maderinha22: folds 
Uncalled bet (792) returned to muriLLoo.mrL
muriLLoo.mrL collected 2400 from pot
muriLLoo.mrL: doesn't show hand 
*** SUMMARY ***
Total pot 2400 | Rake 0 
Board [As 4d 6c]
Seat 1: JamPanamJam (small blind) folded before Flop
Seat 2: maderinha22 (big blind) folded on the Flop
Seat 3: @tetaschell folded before Flop (didn't bet)
Seat 4: muriLLoo.mrL collected (2400)
Seat 5: Everbrun11 folded before Flop (didn't bet)
Seat 6: Rochinha2011 (button) folded before Flop (didn't bet)

PokerStars Hand #251209559639: Tournament #3769361908, $52.38+$2.62 USD Hold'em No Limit - Level XI (250/500) - 2024/06/26 22:33:07 UTC [2024/06/26 18:33:07 ET]
Table '3769361908 4' 6-max Seat #1 is the button
Seat 1: JamPanamJam (15610 in chips) 
Seat 2: maderinha22 (8060 in chips) 
Seat 3: @tetaschell (9800 in chips) 
Seat 4: muriLLoo.mrL (11677 in chips) 
Seat 5: Everbrun11 (9216 in chips) 
Seat 6: Rochinha2011 (7120 in chips) 
JamPanamJam: posts the ante 125
maderinha22: posts the ante 125
@tetaschell: posts the ante 125
muriLLoo.mrL: posts the ante 125
Everbrun11: posts the ante 125
Rochinha2011: posts the ante 125
maderinha22: posts small blind 250
@tetaschell: posts big blind 500
*** HOLE CARDS ***
muriLLoo.mrL: raises 500 to 1000
Everbrun11: raises 8091 to 9091 and is all-in
Rochinha2011: folds 
JamPanamJam: folds 
maderinha22: folds 
@tetaschell: folds 
muriLLoo.mrL: folds 
Uncalled bet (8091) returned to Everbrun11
Everbrun11 collected 3500 from pot
Everbrun11: doesn't show hand 
*** SUMMARY ***
Total pot 3500 | Rake 0 
Seat 1: JamPanamJam (button) folded before Flop (didn't bet)
Seat 2: maderinha22 (small blind) folded before Flop
Seat 3: @tetaschell (big blind) folded before Flop
Seat 4: muriLLoo.mrL folded before Flop
Seat 5: Everbrun11 collected (3500)
Seat 6: Rochinha2011 folded before Flop (didn't bet)

PokerStars Hand #251209568893: Tournament #3769361908, $52.38+$2.62 USD Hold'em No Limit - Level XI (250/500) - 2024/06/26 22:33:42 UTC [2024/06/26 18:33:42 ET]
Table '3769361908 4' 6-max Seat #2 is the button
Seat 1: JamPanamJam (15485 in chips) 
Seat 2: maderinha22 (7685 in chips) 
Seat 3: @tetaschell (9175 in chips) 
Seat 4: muriLLoo.mrL (10552 in chips) 
Seat 5: Everbrun11 (11591 in chips) 
Seat 6: Rochinha2011 (6995 in chips) 
JamPanamJam: posts the ante 125
maderinha22: posts the ante 125
@tetaschell: posts the ante 125
muriLLoo.mrL: posts the ante 125
Everbrun11: posts the ante 125
Rochinha2011: posts the ante 125
@tetaschell: posts small blind 250
muriLLoo.mrL: posts big blind 500
*** HOLE CARDS ***
Everbrun11: folds 
Rochinha2011: folds 
JamPanamJam: raises 500 to 1000
maderinha22: folds 
@tetaschell: folds 
muriLLoo.mrL: calls 500
*** FLOP *** [Qd Js Th]
muriLLoo.mrL: checks 
JamPanamJam: checks 
*** TURN *** [Qd Js Th] [Kh]
muriLLoo.mrL: checks 
JamPanamJam: bets 2310
muriLLoo.mrL: folds 
Uncalled bet (2310) returned to JamPanamJam
JamPanamJam collected 3000 from pot
JamPanamJam: doesn't show hand 
*** SUMMARY ***
Total pot 3000 | Rake 0 
Board [Qd Js Th Kh]
Seat 1: JamPanamJam collected (3000)
Seat 2: maderinha22 (button) folded before Flop (didn't bet)
Seat 3: @tetaschell (small blind) folded before Flop
Seat 4: muriLLoo.mrL (big blind) folded on the Turn
Seat 5: Everbrun11 folded before Flop (didn't bet)
Seat 6: Rochinha2011 folded before Flop (didn't bet)

PokerStars Hand #251209579019: Tournament #3769361908, $52.38+$2.62 USD Hold'em No Limit - Level XI (250/500) - 2024/06/26 22:34:19 UTC [2024/06/26 18:34:19 ET]
Table '3769361908 4' 6-max Seat #3 is the button
Seat 1: JamPanamJam (17360 in chips) 
Seat 2: maderinha22 (7560 in chips) 
Seat 3: @tetaschell (8800 in chips) 
Seat 4: muriLLoo.mrL (9427 in chips) 
Seat 5: Everbrun11 (11466 in chips) 
Seat 6: Rochinha2011 (6870 in chips) 
JamPanamJam: posts the ante 125
maderinha22: posts the ante 125
@tetaschell: posts the ante 125
muriLLoo.mrL: posts the ante 125
Everbrun11: posts the ante 125
Rochinha2011: posts the ante 125
muriLLoo.mrL: posts small blind 250
Everbrun11: posts big blind 500
*** HOLE CARDS ***
Rochinha2011: folds 
JamPanamJam: folds 
maderinha22: raises 6935 to 7435 and is all-in
@tetaschell: folds 
muriLLoo.mrL: folds 
Everbrun11: calls 6935
*** FLOP *** [2h Td Js]
*** TURN *** [2h Td Js] [6s]
*** RIVER *** [2h Td Js 6s] [9h]
*** SHOW DOWN ***
Everbrun11: shows [As Jd] (a pair of Jacks)
maderinha22: shows [3c 3s] (a pair of Threes)
Everbrun11 collected 15870 from pot
maderinha22 finished the tournament
*** SUMMARY ***
Total pot 15870 | Rake 0 
Board [2h Td Js 6s 9h]
Seat 1: JamPanamJam folded before Flop (didn't bet)
Seat 2: maderinha22 showed [3c 3s] and lost with a pair of Threes
Seat 3: @tetaschell (button) folded before Flop (didn't bet)
Seat 4: muriLLoo.mrL (small blind) folded before Flop
Seat 5: Everbrun11 (big blind) showed [As Jd] and won (15870) with a pair of Jacks
Seat 6: Rochinha2011 folded before Flop (didn't bet)

PokerStars Hand #251209587007: Tournament #3769361908, $52.38+$2.62 USD Hold'em No Limit - Level XI (250/500) - 2024/06/26 22:34:49 UTC [2024/06/26 18:34:49 ET]
Table '3769361908 4' 6-max Seat #4 is the button
Seat 1: JamPanamJam (17235 in chips) 
Seat 3: @tetaschell (8675 in chips) 
Seat 4: muriLLoo.mrL (9052 in chips) 
Seat 5: Everbrun11 (19776 in chips) 
Seat 6: Rochinha2011 (6745 in chips) 
JamPanamJam: posts the ante 125
@tetaschell: posts the ante 125
muriLLoo.mrL: posts the ante 125
Everbrun11: posts the ante 125
Rochinha2011: posts the ante 125
Everbrun11: posts small blind 250
Rochinha2011: posts big blind 500
*** HOLE CARDS ***
JamPanamJam: raises 500 to 1000
@tetaschell: folds 
muriLLoo.mrL: folds 
Everbrun11: folds 
Rochinha2011: folds 
Uncalled bet (500) returned to JamPanamJam
JamPanamJam collected 1875 from pot
JamPanamJam: doesn't show hand 
*** SUMMARY ***
Total pot 1875 | Rake 0 
Seat 1: JamPanamJam collected (1875)
Seat 3: @tetaschell folded before Flop (didn't bet)
Seat 4: muriLLoo.mrL (button) folded before Flop (didn't bet)
Seat 5: Everbrun11 (small blind) folded before Flop
Seat 6: Rochinha2011 (big blind) folded before Flop

PokerStars Hand #251209594770: Tournament #3769361908, $52.38+$2.62 USD Hold'em No Limit - Level XII (300/600) - 2024/06/26 22:35:18 UTC [2024/06/26 18:35:18 ET]
Table '3769361908 4' 6-max Seat #5 is the button
Seat 1: JamPanamJam (18485 in chips) 
Seat 3: @tetaschell (8550 in chips) 
Seat 4: muriLLoo.mrL (8927 in chips) 
Seat 5: Everbrun11 (19401 in chips) 
Seat 6: Rochinha2011 (6120 in chips) 
JamPanamJam: posts the ante 150
@tetaschell: posts the ante 150
muriLLoo.mrL: posts the ante 150
Everbrun11: posts the ante 150
Rochinha2011: posts the ante 150
Rochinha2011: posts small blind 300
JamPanamJam: posts big blind 600
*** HOLE CARDS ***
@tetaschell: folds 
muriLLoo.mrL: folds 
Everbrun11: folds 
Rochinha2011: folds 
Uncalled bet (300) returned to JamPanamJam
JamPanamJam collected 1350 from pot
JamPanamJam: doesn't show hand 
*** SUMMARY ***
Total pot 1350 | Rake 0 
Seat 1: JamPanamJam (big blind) collected (1350)
Seat 3: @tetaschell folded before Flop (didn't bet)
Seat 4: muriLLoo.mrL folded before Flop (didn't bet)
Seat 5: Everbrun11 (button) folded before Flop (didn't bet)
Seat 6: Rochinha2011 (small blind) folded before Flop

PokerStars Hand #251209599762: Tournament #3769361908, $52.38+$2.62 USD Hold'em No Limit - Level XII (300/600) - 2024/06/26 22:35:36 UTC [2024/06/26 18:35:36 ET]
Table '3769361908 4' 6-max Seat #6 is the button
Seat 1: JamPanamJam (19385 in chips) 
Seat 2: alexsarakini (10000 in chips) 
Seat 3: @tetaschell (8400 in chips) 
Seat 4: muriLLoo.mrL (8777 in chips) 
Seat 5: Everbrun11 (19251 in chips) 
Seat 6: Rochinha2011 (5670 in chips) 
JamPanamJam: posts the ante 150
alexsarakini: posts the ante 150
@tetaschell: posts the ante 150
muriLLoo.mrL: posts the ante 150
Everbrun11: posts the ante 150
Rochinha2011: posts the ante 150
JamPanamJam: posts small blind 300
alexsarakini: posts big blind 600
*** HOLE CARDS ***
@tetaschell: folds 
muriLLoo.mrL: folds 
Everbrun11: raises 600 to 1200
Rochinha2011: folds 
JamPanamJam: raises 18035 to 19235 and is all-in
alexsarakini: folds 
Everbrun11: calls 17901 and is all-in
Uncalled bet (134) returned to JamPanamJam
*** FLOP *** [7c 5s 7h]
*** TURN *** [7c 5s 7h] [Jd]
*** RIVER *** [7c 5s 7h Jd] [6h]
*** SHOW DOWN ***
JamPanamJam: shows [8h 8s] (two pair, Eights and Sevens)
Everbrun11: shows [Ts Th] (two pair, Tens and Sevens)
Everbrun11 collected 39702 from pot
*** SUMMARY ***
Total pot 39702 | Rake 0 
Board [7c 5s 7h Jd 6h]
Seat 1: JamPanamJam (small blind) showed [8h 8s] and lost with two pair, Eights and Sevens
Seat 2: alexsarakini (big blind) folded before Flop
Seat 3: @tetaschell folded before Flop (didn't bet)
Seat 4: muriLLoo.mrL folded before Flop (didn't bet)
Seat 5: Everbrun11 showed [Ts Th] and won (39702) with two pair, Tens and Sevens
Seat 6: Rochinha2011 (button) folded before Flop (didn't bet)

PokerStars Hand #251209611279: Tournament #3769361908, $52.38+$2.62 USD Hold'em No Limit - Level XII (300/600) - 2024/06/26 22:36:19 UTC [2024/06/26 18:36:19 ET]
Table '3769361908 4' 6-max Seat #1 is the button
Seat 1: JamPanamJam (134 in chips) 
Seat 2: alexsarakini (9250 in chips) 
Seat 3: @tetaschell (8250 in chips) 
Seat 4: muriLLoo.mrL (8627 in chips) 
Seat 5: Everbrun11 (39702 in chips) 
Seat 6: Rochinha2011 (5520 in chips) 
JamPanamJam: posts the ante 134 and is all-in
alexsarakini: posts the ante 150
@tetaschell: posts the ante 150
muriLLoo.mrL: posts the ante 150
Everbrun11: posts the ante 150
Rochinha2011: posts the ante 150
alexsarakini: posts small blind 300
@tetaschell: posts big blind 600
*** HOLE CARDS ***
muriLLoo.mrL: folds 
Everbrun11: folds 
Rochinha2011: raises 4770 to 5370 and is all-in
alexsarakini: folds 
@tetaschell: calls 4770
*** FLOP *** [2d 7s 5d]
*** TURN *** [2d 7s 5d] [Ks]
*** RIVER *** [2d 7s 5d Ks] [6h]
*** SHOW DOWN ***
@tetaschell: shows [Qc As] (high card Ace)
Rochinha2011: shows [8d Ah] (high card Ace - lower kicker)
@tetaschell collected 11120 from side pot
JamPanamJam: shows [6d 4h] (a pair of Sixes)
JamPanamJam collected 804 from main pot
Rochinha2011 finished the tournament
*** SUMMARY ***
Total pot 11924 Main pot 804. Side pot 11120. | Rake 0 
Board [2d 7s 5d Ks 6h]
Seat 1: JamPanamJam (button) showed [6d 4h] and won (804) with a pair of Sixes
Seat 2: alexsarakini (small blind) folded before Flop
Seat 3: @tetaschell (big blind) showed [Qc As] and won (11120) with high card Ace
Seat 4: muriLLoo.mrL folded before Flop (didn't bet)
Seat 5: Everbrun11 folded before Flop (didn't bet)
Seat 6: Rochinha2011 showed [8d Ah] and lost with high card Ace

PokerStars Hand #251209619225: Tournament #3769361908, $52.38+$2.62 USD Hold'em No Limit - Level XII (300/600) - 2024/06/26 22:36:49 UTC [2024/06/26 18:36:49 ET]
Table '3769361908 4' 6-max Seat #2 is the button
Seat 1: JamPanamJam (804 in chips) 
Seat 2: alexsarakini (8800 in chips) 
Seat 3: @tetaschell (13850 in chips) 
Seat 4: muriLLoo.mrL (8477 in chips) 
Seat 5: Everbrun11 (39552 in chips) 
JamPanamJam: posts the ante 150
alexsarakini: posts the ante 150
@tetaschell: posts the ante 150
muriLLoo.mrL: posts the ante 150
Everbrun11: posts the ante 150
@tetaschell: posts small blind 300
muriLLoo.mrL: posts big blind 600
*** HOLE CARDS ***
Everbrun11: raises 600 to 1200
JamPanamJam: folds 
alexsarakini: calls 1200
@tetaschell: folds 
muriLLoo.mrL: raises 7127 to 8327 and is all-in
Everbrun11: folds 
alexsarakini: folds 
Uncalled bet (7127) returned to muriLLoo.mrL
muriLLoo.mrL collected 4650 from pot
muriLLoo.mrL: doesn't show hand 
*** SUMMARY ***
Total pot 4650 | Rake 0 
Seat 1: JamPanamJam folded before Flop (didn't bet)
Seat 2: alexsarakini (button) folded before Flop
Seat 3: @tetaschell (small blind) folded before Flop
Seat 4: muriLLoo.mrL (big blind) collected (4650)
Seat 5: Everbrun11 folded before Flop

PokerStars Hand #251209624583: Tournament #3769361908, $52.38+$2.62 USD Hold'em No Limit - Level XII (300/600) - 2024/06/26 22:37:09 UTC [2024/06/26 18:37:09 ET]
Table '3769361908 4' 6-max Seat #3 is the button
Seat 1: JamPanamJam (654 in chips) 
Seat 2: alexsarakini (7450 in chips) 
Seat 3: @tetaschell (13400 in chips) 
Seat 4: muriLLoo.mrL (11777 in chips) 
Seat 5: Everbrun11 (38202 in chips) 
JamPanamJam: posts the ante 150
alexsarakini: posts the ante 150
@tetaschell: posts the ante 150
muriLLoo.mrL: posts the ante 150
Everbrun11: posts the ante 150
muriLLoo.mrL: posts small blind 300
Everbrun11: posts big blind 600
*** HOLE CARDS ***
JamPanamJam: calls 504 and is all-in
alexsarakini: folds 
@tetaschell: folds 
muriLLoo.mrL: calls 300
Everbrun11: raises 1200 to 1800
muriLLoo.mrL: folds 
Uncalled bet (1200) returned to Everbrun11
*** FLOP *** [Jc 3s Qc]
*** TURN *** [Jc 3s Qc] [6c]
*** RIVER *** [Jc 3s Qc 6c] [8s]
*** SHOW DOWN ***
Everbrun11: shows [Kc Kd] (a pair of Kings)
Everbrun11 collected 192 from side pot
JamPanamJam: shows [2s 8d] (a pair of Eights)
Everbrun11 collected 2262 from main pot
JamPanamJam finished the tournament
somnamna555 is disconnected 
*** SUMMARY ***
Total pot 2454 Main pot 2262. Side pot 192. | Rake 0 
Board [Jc 3s Qc 6c 8s]
Seat 1: JamPanamJam showed [2s 8d] and lost with a pair of Eights
Seat 2: alexsarakini folded before Flop (didn't bet)
Seat 3: @tetaschell (button) folded before Flop (didn't bet)
Seat 4: muriLLoo.mrL (small blind) folded before Flop
Seat 5: Everbrun11 (big blind) showed [Kc Kd] and won (2454) with a pair of Kings

PokerStars Hand #251209636110: Tournament #3769361908, $52.38+$2.62 USD Hold'em No Limit - Level XII (300/600) - 2024/06/26 22:37:52 UTC [2024/06/26 18:37:52 ET]
Table '3769361908 4' 6-max Seat #4 is the button
Seat 1: somnamna555 (13734 in chips) 
Seat 2: alexsarakini (7300 in chips) 
Seat 3: @tetaschell (13250 in chips) 
Seat 4: muriLLoo.mrL (11027 in chips) 
Seat 5: Everbrun11 (39906 in chips) 
somnamna555: posts the ante 150
alexsarakini: posts the ante 150
@tetaschell: posts the ante 150
muriLLoo.mrL: posts the ante 150
Everbrun11: posts the ante 150
Everbrun11: posts small blind 300
somnamna555: posts big blind 600
*** HOLE CARDS ***
alexsarakini: raises 1200 to 1800
@tetaschell: folds 
muriLLoo.mrL: folds 
Everbrun11: folds 
somnamna555: folds 
Uncalled bet (1200) returned to alexsarakini
alexsarakini collected 2250 from pot
*** SUMMARY ***
Total pot 2250 | Rake 0 
Seat 1: somnamna555 (big blind) folded before Flop
Seat 2: alexsarakini collected (2250)
Seat 3: @tetaschell folded before Flop (didn't bet)
Seat 4: muriLLoo.mrL (button) folded before Flop (didn't bet)
Seat 5: Everbrun11 (small blind) folded before Flop

PokerStars Hand #251209642433: Tournament #3769361908, $52.38+$2.62 USD Hold'em No Limit - Level XIII (400/800) - 2024/06/26 22:38:16 UTC [2024/06/26 18:38:16 ET]
Table '3769361908 4' 6-max Seat #5 is the button
Seat 1: somnamna555 (12984 in chips) 
Seat 2: alexsarakini (8800 in chips) 
Seat 3: @tetaschell (13100 in chips) 
Seat 4: muriLLoo.mrL (10877 in chips) 
Seat 5: Everbrun11 (39456 in chips) 
somnamna555: posts the ante 200
alexsarakini: posts the ante 200
@tetaschell: posts the ante 200
muriLLoo.mrL: posts the ante 200
Everbrun11: posts the ante 200
somnamna555: posts small blind 400
alexsarakini: posts big blind 800
*** HOLE CARDS ***
@tetaschell: folds 
muriLLoo.mrL: folds 
Everbrun11: folds 
somnamna555: folds 
Uncalled bet (400) returned to alexsarakini
alexsarakini collected 1800 from pot
*** SUMMARY ***
Total pot 1800 | Rake 0 
Seat 1: somnamna555 (small blind) folded before Flop
Seat 2: alexsarakini (big blind) collected (1800)
Seat 3: @tetaschell folded before Flop (didn't bet)
Seat 4: muriLLoo.mrL folded before Flop (didn't bet)
Seat 5: Everbrun11 (button) folded before Flop (didn't bet)

PokerStars Hand #251209645550: Tournament #3769361908, $52.38+$2.62 USD Hold'em No Limit - Level XIII (400/800) - 2024/06/26 22:38:28 UTC [2024/06/26 18:38:28 ET]
Table '3769361908 4' 6-max Seat #1 is the button
Seat 1: somnamna555 (12384 in chips) 
Seat 2: alexsarakini (10000 in chips) 
Seat 3: @tetaschell (12900 in chips) 
Seat 4: muriLLoo.mrL (10677 in chips) 
Seat 5: Everbrun11 (39256 in chips) 
somnamna555: posts the ante 200
alexsarakini: posts the ante 200
@tetaschell: posts the ante 200
muriLLoo.mrL: posts the ante 200
Everbrun11: posts the ante 200
alexsarakini: posts small blind 400
@tetaschell: posts big blind 800
*** HOLE CARDS ***
muriLLoo.mrL: folds 
Everbrun11: folds 
somnamna555: folds 
alexsarakini: folds 
Uncalled bet (400) returned to @tetaschell
@tetaschell collected 1800 from pot
@tetaschell: doesn't show hand 
*** SUMMARY ***
Total pot 1800 | Rake 0 
Seat 1: somnamna555 (button) folded before Flop (didn't bet)
Seat 2: alexsarakini (small blind) folded before Flop
Seat 3: @tetaschell (big blind) collected (1800)
Seat 4: muriLLoo.mrL folded before Flop (didn't bet)
Seat 5: Everbrun11 folded before Flop (didn't bet)

PokerStars Hand #251209647964: Tournament #3769361908, $52.38+$2.62 USD Hold'em No Limit - Level XIII (400/800) - 2024/06/26 22:38:37 UTC [2024/06/26 18:38:37 ET]
Table '3769361908 4' 6-max Seat #2 is the button
Seat 1: somnamna555 (12184 in chips) 
Seat 2: alexsarakini (9400 in chips) 
Seat 3: @tetaschell (14100 in chips) 
Seat 4: muriLLoo.mrL (10477 in chips) 
Seat 5: Everbrun11 (39056 in chips) 
somnamna555: posts the ante 200
alexsarakini: posts the ante 200
@tetaschell: posts the ante 200
muriLLoo.mrL: posts the ante 200
Everbrun11: posts the ante 200
@tetaschell: posts small blind 400
muriLLoo.mrL: posts big blind 800
*** HOLE CARDS ***
Everbrun11: folds 
somnamna555: folds 
alexsarakini: raises 800 to 1600
@tetaschell: folds 
muriLLoo.mrL: calls 800
*** FLOP *** [Td 6c 8s]
muriLLoo.mrL: checks 
alexsarakini: bets 1500
muriLLoo.mrL: folds 
Uncalled bet (1500) returned to alexsarakini
alexsarakini collected 4600 from pot
*** SUMMARY ***
Total pot 4600 | Rake 0 
Board [Td 6c 8s]
Seat 1: somnamna555 folded before Flop (didn't bet)
Seat 2: alexsarakini (button) collected (4600)
Seat 3: @tetaschell (small blind) folded before Flop
Seat 4: muriLLoo.mrL (big blind) folded on the Flop
Seat 5: Everbrun11 folded before Flop (didn't bet)

PokerStars Hand #251209658154: Tournament #3769361908, $52.38+$2.62 USD Hold'em No Limit - Level XIII (400/800) - 2024/06/26 22:39:15 UTC [2024/06/26 18:39:15 ET]
Table '3769361908 4' 6-max Seat #3 is the button
Seat 1: somnamna555 (11984 in chips) 
Seat 2: alexsarakini (12200 in chips) 
Seat 3: @tetaschell (13500 in chips) 
Seat 4: muriLLoo.mrL (8677 in chips) 
Seat 5: Everbrun11 (38856 in chips) 
somnamna555: posts the ante 200
alexsarakini: posts the ante 200
@tetaschell: posts the ante 200
muriLLoo.mrL: posts the ante 200
Everbrun11: posts the ante 200
muriLLoo.mrL: posts small blind 400
Everbrun11: posts big blind 800
*** HOLE CARDS ***
somnamna555: folds 
alexsarakini: folds 
@tetaschell: folds 
muriLLoo.mrL: calls 400
Everbrun11: raises 37856 to 38656 and is all-in
muriLLoo.mrL: calls 7677 and is all-in
Uncalled bet (30179) returned to Everbrun11
*** FLOP *** [4c 5h Qd]
*** TURN *** [4c 5h Qd] [9c]
*** RIVER *** [4c 5h Qd 9c] [Jc]
*** SHOW DOWN ***
muriLLoo.mrL: shows [Qc Qh] (three of a kind, Queens)
Everbrun11: shows [Ac 3s] (high card Ace)
muriLLoo.mrL collected 17954 from pot
*** SUMMARY ***
Total pot 17954 | Rake 0 
Board [4c 5h Qd 9c Jc]
Seat 1: somnamna555 folded before Flop (didn't bet)
Seat 2: alexsarakini folded before Flop (didn't bet)
Seat 3: @tetaschell (button) folded before Flop (didn't bet)
Seat 4: muriLLoo.mrL (small blind) showed [Qc Qh] and won (17954) with three of a kind, Queens
Seat 5: Everbrun11 (big blind) showed [Ac 3s] and lost with high card Ace

PokerStars Hand #251209665019: Tournament #3769361908, $52.38+$2.62 USD Hold'em No Limit - Level XIII (400/800) - 2024/06/26 22:39:40 UTC [2024/06/26 18:39:40 ET]
Table '3769361908 4' 6-max Seat #4 is the button
Seat 1: somnamna555 (11784 in chips) 
Seat 2: alexsarakini (12000 in chips) 
Seat 3: @tetaschell (13300 in chips) 
Seat 4: muriLLoo.mrL (17954 in chips) 
Seat 5: Everbrun11 (30179 in chips) 
Seat 6: anth0nypappa (2142 in chips) is sitting out
somnamna555: posts the ante 200
alexsarakini: posts the ante 200
@tetaschell: posts the ante 200
muriLLoo.mrL: posts the ante 200
Everbrun11: posts the ante 200
anth0nypappa: posts the ante 200
Everbrun11: posts small blind 400
anth0nypappa: posts big blind 800
*** HOLE CARDS ***
somnamna555: raises 10784 to 11584 and is all-in
alexsarakini: folds 
@tetaschell: folds 
muriLLoo.mrL: folds 
Everbrun11: folds 
anth0nypappa: folds 
Uncalled bet (10784) returned to somnamna555
somnamna555 collected 3200 from pot
somnamna555: doesn't show hand 
*** SUMMARY ***
Total pot 3200 | Rake 0 
Seat 1: somnamna555 collected (3200)
Seat 2: alexsarakini folded before Flop (didn't bet)
Seat 3: @tetaschell folded before Flop (didn't bet)
Seat 4: muriLLoo.mrL (button) folded before Flop (didn't bet)
Seat 5: Everbrun11 (small blind) folded before Flop
Seat 6: anth0nypappa (big blind) folded before Flop

PokerStars Hand #251209670103: Tournament #3769361908, $52.38+$2.62 USD Hold'em No Limit - Level XIII (400/800) - 2024/06/26 22:39:59 UTC [2024/06/26 18:39:59 ET]
Table '3769361908 4' 6-max Seat #5 is the button
Seat 1: somnamna555 (13984 in chips) 
Seat 2: alexsarakini (11800 in chips) 
Seat 3: @tetaschell (13100 in chips) 
Seat 4: muriLLoo.mrL (17754 in chips) 
Seat 5: Everbrun11 (29579 in chips) 
Seat 6: anth0nypappa (1142 in chips) is sitting out
somnamna555: posts the ante 200
alexsarakini: posts the ante 200
@tetaschell: posts the ante 200
muriLLoo.mrL: posts the ante 200
Everbrun11: posts the ante 200
anth0nypappa: posts the ante 200
anth0nypappa: posts small blind 400
somnamna555: posts big blind 800
*** HOLE CARDS ***
alexsarakini: folds 
@tetaschell: raises 800 to 1600
muriLLoo.mrL: folds 
Everbrun11: folds 
anth0nypappa: folds 
somnamna555: raises 12184 to 13784 and is all-in
@tetaschell: calls 11300 and is all-in
Uncalled bet (884) returned to somnamna555
*** FLOP *** [4h 6c 3h]
*** TURN *** [4h 6c 3h] [7c]
*** RIVER *** [4h 6c 3h 7c] [5d]
*** SHOW DOWN ***
somnamna555: shows [As 9s] (a straight, Three to Seven)
@tetaschell: shows [Qc Ah] (a straight, Three to Seven)
somnamna555 collected 13700 from pot
@tetaschell collected 13700 from pot
*** SUMMARY ***
Total pot 27400 | Rake 0 
Board [4h 6c 3h 7c 5d]
Seat 1: somnamna555 (big blind) showed [As 9s] and won (13700) with a straight, Three to Seven
Seat 2: alexsarakini folded before Flop (didn't bet)
Seat 3: @tetaschell showed [Qc Ah] and won (13700) with a straight, Three to Seven
Seat 4: muriLLoo.mrL folded before Flop (didn't bet)
Seat 5: Everbrun11 (button) folded before Flop (didn't bet)
Seat 6: anth0nypappa (small blind) folded before Flop

PokerStars Hand #251209676974: Tournament #3769361908, $52.38+$2.62 USD Hold'em No Limit - Level XIII (400/800) - 2024/06/26 22:40:25 UTC [2024/06/26 18:40:25 ET]
Table '3769361908 4' 6-max Seat #6 is the button
Seat 1: somnamna555 (14584 in chips) 
Seat 2: alexsarakini (11600 in chips) 
Seat 3: @tetaschell (13700 in chips) 
Seat 4: muriLLoo.mrL (17554 in chips) 
Seat 5: Everbrun11 (29379 in chips) 
Seat 6: anth0nypappa (542 in chips) is sitting out
somnamna555: posts the ante 200
alexsarakini: posts the ante 200
@tetaschell: posts the ante 200
muriLLoo.mrL: posts the ante 200
Everbrun11: posts the ante 200
anth0nypappa: posts the ante 200
somnamna555: posts small blind 400
alexsarakini: posts big blind 800
*** HOLE CARDS ***
@tetaschell: folds 
muriLLoo.mrL: folds 
Everbrun11: folds 
anth0nypappa: folds 
somnamna555: raises 13584 to 14384 and is all-in
alexsarakini: folds 
Uncalled bet (13584) returned to somnamna555
somnamna555 collected 2800 from pot
somnamna555: doesn't show hand 
*** SUMMARY ***
Total pot 2800 | Rake 0 
Seat 1: somnamna555 (small blind) collected (2800)
Seat 2: alexsarakini (big blind) folded before Flop
Seat 3: @tetaschell folded before Flop (didn't bet)
Seat 4: muriLLoo.mrL folded before Flop (didn't bet)
Seat 5: Everbrun11 folded before Flop (didn't bet)
Seat 6: anth0nypappa (button) folded before Flop (didn't bet)

PokerStars Hand #251209681960: Tournament #3769361908, $52.38+$2.62 USD Hold'em No Limit - Level XIII (400/800) - 2024/06/26 22:40:45 UTC [2024/06/26 18:40:45 ET]
Table '3769361908 4' 6-max Seat #1 is the button
Seat 1: somnamna555 (16384 in chips) 
Seat 2: alexsarakini (10600 in chips) 
Seat 3: @tetaschell (13500 in chips) 
Seat 4: muriLLoo.mrL (17354 in chips) 
Seat 5: Everbrun11 (29179 in chips) 
Seat 6: anth0nypappa (342 in chips) is sitting out
somnamna555: posts the ante 200
alexsarakini: posts the ante 200
@tetaschell: posts the ante 200
muriLLoo.mrL: posts the ante 200
Everbrun11: posts the ante 200
anth0nypappa: posts the ante 200
alexsarakini: posts small blind 400
@tetaschell: posts big blind 800
*** HOLE CARDS ***
muriLLoo.mrL: folds 
Everbrun11: raises 800 to 1600
anth0nypappa: folds 
somnamna555: folds 
alexsarakini: folds 
@tetaschell: calls 800
*** FLOP *** [As 8c 6d]
@tetaschell: checks 
Everbrun11: bets 1200
@tetaschell: folds 
Uncalled bet (1200) returned to Everbrun11
Everbrun11 collected 4800 from pot
Everbrun11: doesn't show hand 
*** SUMMARY ***
Total pot 4800 | Rake 0 
Board [As 8c 6d]
Seat 1: somnamna555 (button) folded before Flop (didn't bet)
Seat 2: alexsarakini (small blind) folded before Flop
Seat 3: @tetaschell (big blind) folded on the Flop
Seat 4: muriLLoo.mrL folded before Flop (didn't bet)
Seat 5: Everbrun11 collected (4800)
Seat 6: anth0nypappa folded before Flop (didn't bet)

PokerStars Hand #251209694908: Tournament #3769361908, $52.38+$2.62 USD Hold'em No Limit - Level XIV (500/1000) - 2024/06/26 22:41:34 UTC [2024/06/26 18:41:34 ET]
Table '3769361908 4' 6-max Seat #2 is the button
Seat 1: somnamna555 (16184 in chips) 
Seat 2: alexsarakini (10000 in chips) 
Seat 3: @tetaschell (11700 in chips) 
Seat 4: muriLLoo.mrL (17154 in chips) 
Seat 5: Everbrun11 (32179 in chips) 
Seat 6: anth0nypappa (142 in chips) is sitting out
somnamna555: posts the ante 250
alexsarakini: posts the ante 250
@tetaschell: posts the ante 250
muriLLoo.mrL: posts the ante 250
Everbrun11: posts the ante 250
anth0nypappa: posts the ante 142 and is all-in
@tetaschell: posts small blind 500
muriLLoo.mrL: posts big blind 1000
*** HOLE CARDS ***
Everbrun11: raises 1000 to 2000
anth0nypappa: folds 
somnamna555: folds 
alexsarakini: folds 
@tetaschell: folds 
muriLLoo.mrL: calls 1000
*** FLOP *** [Ad 8h 4h]
muriLLoo.mrL: checks 
Everbrun11: bets 1500
muriLLoo.mrL: raises 13404 to 14904 and is all-in
Everbrun11: folds 
Uncalled bet (13404) returned to muriLLoo.mrL
muriLLoo.mrL collected 8892 from pot
anth0nypappa finished the tournament
muriLLoo.mrL: doesn't show hand 
*** SUMMARY ***
Total pot 8892 | Rake 0 
Board [Ad 8h 4h]
Seat 1: somnamna555 folded before Flop (didn't bet)
Seat 2: alexsarakini (button) folded before Flop (didn't bet)
Seat 3: @tetaschell (small blind) folded before Flop
Seat 4: muriLLoo.mrL (big blind) collected (8892)
Seat 5: Everbrun11 folded on the Flop
Seat 6: anth0nypappa folded before Flop (didn't bet)

PokerStars Hand #251209706683: Tournament #3769361908, $52.38+$2.62 USD Hold'em No Limit - Level XIV (500/1000) - 2024/06/26 22:42:20 UTC [2024/06/26 18:42:20 ET]
Table '3769361908 4' 6-max Seat #3 is the button
Seat 1: somnamna555 (15934 in chips) 
Seat 2: alexsarakini (9750 in chips) 
Seat 3: @tetaschell (10950 in chips) 
Seat 4: muriLLoo.mrL (22296 in chips) 
Seat 5: Everbrun11 (28429 in chips) 
somnamna555: posts the ante 250
alexsarakini: posts the ante 250
@tetaschell: posts the ante 250
muriLLoo.mrL: posts the ante 250
Everbrun11: posts the ante 250
muriLLoo.mrL: posts small blind 500
Everbrun11: posts big blind 1000
*** HOLE CARDS ***
somnamna555: folds 
alexsarakini: folds 
@tetaschell: raises 9700 to 10700 and is all-in
muriLLoo.mrL: folds 
Everbrun11: folds 
Uncalled bet (9700) returned to @tetaschell
@tetaschell collected 3750 from pot
@tetaschell: doesn't show hand 
*** SUMMARY ***
Total pot 3750 | Rake 0 
Seat 1: somnamna555 folded before Flop (didn't bet)
Seat 2: alexsarakini folded before Flop (didn't bet)
Seat 3: @tetaschell (button) collected (3750)
Seat 4: muriLLoo.mrL (small blind) folded before Flop
Seat 5: Everbrun11 (big blind) folded before Flop

PokerStars Hand #251209711927: Tournament #3769361908, $52.38+$2.62 USD Hold'em No Limit - Level XIV (500/1000) - 2024/06/26 22:42:40 UTC [2024/06/26 18:42:40 ET]
Table '3769361908 4' 6-max Seat #4 is the button
Seat 1: somnamna555 (15684 in chips) 
Seat 2: alexsarakini (9500 in chips) 
Seat 3: @tetaschell (13450 in chips) 
Seat 4: muriLLoo.mrL (21546 in chips) 
Seat 5: Everbrun11 (27179 in chips) 
somnamna555: posts the ante 250
alexsarakini: posts the ante 250
@tetaschell: posts the ante 250
muriLLoo.mrL: posts the ante 250
Everbrun11: posts the ante 250
Everbrun11: posts small blind 500
somnamna555: posts big blind 1000
*** HOLE CARDS ***
alexsarakini: folds 
@tetaschell: folds 
muriLLoo.mrL: raises 1000 to 2000
Everbrun11: folds 
somnamna555: folds 
Uncalled bet (1000) returned to muriLLoo.mrL
muriLLoo.mrL collected 3750 from pot
muriLLoo.mrL: doesn't show hand 
*** SUMMARY ***
Total pot 3750 | Rake 0 
Seat 1: somnamna555 (big blind) folded before Flop
Seat 2: alexsarakini folded before Flop (didn't bet)
Seat 3: @tetaschell folded before Flop (didn't bet)
Seat 4: muriLLoo.mrL (button) collected (3750)
Seat 5: Everbrun11 (small blind) folded before Flop

PokerStars Hand #251209717782: Tournament #3769361908, $52.38+$2.62 USD Hold'em No Limit - Level XIV (500/1000) - 2024/06/26 22:43:03 UTC [2024/06/26 18:43:03 ET]
Table '3769361908 4' 6-max Seat #5 is the button
Seat 1: somnamna555 (14434 in chips) 
Seat 2: alexsarakini (9250 in chips) 
Seat 3: @tetaschell (13200 in chips) 
Seat 4: muriLLoo.mrL (24046 in chips) 
Seat 5: Everbrun11 (26429 in chips) 
somnamna555: posts the ante 250
alexsarakini: posts the ante 250
@tetaschell: posts the ante 250
muriLLoo.mrL: posts the ante 250
Everbrun11: posts the ante 250
somnamna555: posts small blind 500
alexsarakini: posts big blind 1000
*** HOLE CARDS ***
@tetaschell: raises 11950 to 12950 and is all-in
muriLLoo.mrL: raises 10846 to 23796 and is all-in
Everbrun11: folds 
somnamna555: folds 
alexsarakini: folds 
Uncalled bet (10846) returned to muriLLoo.mrL
*** FLOP *** [Js Ah 4c]
*** TURN *** [Js Ah 4c] [3c]
*** RIVER *** [Js Ah 4c 3c] [4d]
*** SHOW DOWN ***
@tetaschell: shows [Ks Qd] (a pair of Fours)
muriLLoo.mrL: shows [Ac 7c] (two pair, Aces and Fours)
muriLLoo.mrL collected 28650 from pot
@tetaschell finished the tournament
*** SUMMARY ***
Total pot 28650 | Rake 0 
Board [Js Ah 4c 3c 4d]
Seat 1: somnamna555 (small blind) folded before Flop
Seat 2: alexsarakini (big blind) folded before Flop
Seat 3: @tetaschell showed [Ks Qd] and lost with a pair of Fours
Seat 4: muriLLoo.mrL showed [Ac 7c] and won (28650) with two pair, Aces and Fours
Seat 5: Everbrun11 (button) folded before Flop (didn't bet)

PokerStars Hand #251209725506: Tournament #3769361908, $52.38+$2.62 USD Hold'em No Limit - Level XIV (500/1000) - 2024/06/26 22:43:33 UTC [2024/06/26 18:43:33 ET]
Table '3769361908 4' 6-max Seat #1 is the button
Seat 1: somnamna555 (13684 in chips) 
Seat 2: alexsarakini (8000 in chips) 
Seat 4: muriLLoo.mrL (39496 in chips) 
Seat 5: Everbrun11 (26179 in chips) 
somnamna555: posts the ante 250
alexsarakini: posts the ante 250
muriLLoo.mrL: posts the ante 250
Everbrun11: posts the ante 250
alexsarakini: posts small blind 500
muriLLoo.mrL: posts big blind 1000
*** HOLE CARDS ***
gwallgofddyn is disconnected 
Everbrun11: raises 1000 to 2000
somnamna555: folds 
alexsarakini: folds 
muriLLoo.mrL: calls 1000
*** FLOP *** [9d Qc Td]
muriLLoo.mrL: checks 
Everbrun11: bets 2000
muriLLoo.mrL: calls 2000
*** TURN *** [9d Qc Td] [Ah]
muriLLoo.mrL: checks 
Everbrun11: bets 6000
muriLLoo.mrL: raises 29246 to 35246 and is all-in
Everbrun11: calls 15929 and is all-in
Uncalled bet (13317) returned to muriLLoo.mrL
*** RIVER *** [9d Qc Td Ah] [6d]
*** SHOW DOWN ***
muriLLoo.mrL: shows [Ac 9h] (two pair, Aces and Nines)
Everbrun11: shows [Qs Ad] (two pair, Aces and Queens)
Everbrun11 collected 53358 from pot
*** SUMMARY ***
Total pot 53358 | Rake 0 
Board [9d Qc Td Ah 6d]
Seat 1: somnamna555 (button) folded before Flop (didn't bet)
Seat 2: alexsarakini (small blind) folded before Flop
Seat 4: muriLLoo.mrL (big blind) showed [Ac 9h] and lost with two pair, Aces and Nines
Seat 5: Everbrun11 showed [Qs Ad] and won (53358) with two pair, Aces and Queens

PokerStars Hand #251209736516: Tournament #3769361908, $52.38+$2.62 USD Hold'em No Limit - Level XV (600/1200) - 2024/06/26 22:44:16 UTC [2024/06/26 18:44:16 ET]
Table '3769361908 4' 6-max Seat #2 is the button
Seat 1: somnamna555 (13434 in chips) 
Seat 2: alexsarakini (7250 in chips) 
Seat 3: gwallgofddyn (12876 in chips) out of hand (moved from another table into small blind)
Seat 4: muriLLoo.mrL (13317 in chips) 
Seat 5: Everbrun11 (53358 in chips) 
gwallgofddyn will be allowed to play after the button
somnamna555: posts the ante 300
alexsarakini: posts the ante 300
muriLLoo.mrL: posts the ante 300
Everbrun11: posts the ante 300
muriLLoo.mrL: posts small blind 600
Everbrun11: posts big blind 1200
*** HOLE CARDS ***
somnamna555: folds 
alexsarakini: folds 
muriLLoo.mrL: raises 11817 to 13017 and is all-in
Everbrun11: folds 
Uncalled bet (11817) returned to muriLLoo.mrL
muriLLoo.mrL collected 3600 from pot
muriLLoo.mrL: doesn't show hand 
*** SUMMARY ***
Total pot 3600 | Rake 0 
Seat 1: somnamna555 folded before Flop (didn't bet)
Seat 2: alexsarakini (button) folded before Flop (didn't bet)
Seat 4: muriLLoo.mrL (small blind) collected (3600)
Seat 5: Everbrun11 (big blind) folded before Flop

PokerStars Hand #251209740100: Tournament #3769361908, $52.38+$2.62 USD Hold'em No Limit - Level XV (600/1200) - 2024/06/26 22:44:30 UTC [2024/06/26 18:44:30 ET]
Table '3769361908 4' 6-max Seat #4 is the button
Seat 1: somnamna555 (13134 in chips) 
Seat 2: alexsarakini (6950 in chips) 
Seat 3: gwallgofddyn (12876 in chips) 
Seat 4: muriLLoo.mrL (15417 in chips) 
Seat 5: Everbrun11 (51858 in chips) 
somnamna555: posts the ante 300
alexsarakini: posts the ante 300
gwallgofddyn: posts the ante 300
muriLLoo.mrL: posts the ante 300
Everbrun11: posts the ante 300
Everbrun11: posts small blind 600
somnamna555: posts big blind 1200
*** HOLE CARDS ***
alexsarakini: folds 
gwallgofddyn: raises 1200 to 2400
muriLLoo.mrL: folds 
BernardoDG is disconnected 
Everbrun11: folds 
somnamna555: folds 
Uncalled bet (1200) returned to gwallgofddyn
gwallgofddyn collected 4500 from pot
gwallgofddyn: doesn't show hand 
*** SUMMARY ***
Total pot 4500 | Rake 0 
Seat 1: somnamna555 (big blind) folded before Flop
Seat 2: alexsarakini folded before Flop (didn't bet)
Seat 3: gwallgofddyn collected (4500)
Seat 4: muriLLoo.mrL (button) folded before Flop (didn't bet)
Seat 5: Everbrun11 (small blind) folded before Flop

PokerStars Hand #251209746455: Tournament #3769361908, $52.38+$2.62 USD Hold'em No Limit - Level XV (600/1200) - 2024/06/26 22:44:55 UTC [2024/06/26 18:44:55 ET]
Table '3769361908 4' 6-max Seat #5 is the button
Seat 1: somnamna555 (11634 in chips) 
Seat 2: alexsarakini (6650 in chips) 
Seat 3: gwallgofddyn (15876 in chips) 
Seat 4: muriLLoo.mrL (15117 in chips) 
Seat 5: Everbrun11 (50958 in chips) 
Seat 6: BernardoDG (18951 in chips) out of hand (moved from another table into small blind)
BernardoDG will be allowed to play after the button
somnamna555: posts the ante 300
alexsarakini: posts the ante 300
gwallgofddyn: posts the ante 300
muriLLoo.mrL: posts the ante 300
Everbrun11: posts the ante 300
somnamna555: posts small blind 600
alexsarakini: posts big blind 1200
*** HOLE CARDS ***
gwallgofddyn: folds 
muriLLoo.mrL: raises 1200 to 2400
Everbrun11: folds 
somnamna555: folds 
alexsarakini: folds 
Uncalled bet (1200) returned to muriLLoo.mrL
muriLLoo.mrL collected 4500 from pot
muriLLoo.mrL: doesn't show hand 
*** SUMMARY ***
Total pot 4500 | Rake 0 
Seat 1: somnamna555 (small blind) folded before Flop
Seat 2: alexsarakini (big blind) folded before Flop
Seat 3: gwallgofddyn folded before Flop (didn't bet)
Seat 4: muriLLoo.mrL collected (4500)
Seat 5: Everbrun11 (button) folded before Flop (didn't bet)

PokerStars Hand #251209753640: Tournament #3769361908, $52.38+$2.62 USD Hold'em No Limit - Level XV (600/1200) - 2024/06/26 22:45:23 UTC [2024/06/26 18:45:23 ET]
Table '3769361908 4' 6-max Seat #1 is the button
Seat 1: somnamna555 (10734 in chips) 
Seat 2: alexsarakini (5150 in chips) 
Seat 3: gwallgofddyn (15576 in chips) 
Seat 4: muriLLoo.mrL (18117 in chips) 
Seat 5: Everbrun11 (50658 in chips) 
Seat 6: BernardoDG (18951 in chips) 
somnamna555: posts the ante 300
alexsarakini: posts the ante 300
gwallgofddyn: posts the ante 300
muriLLoo.mrL: posts the ante 300
Everbrun11: posts the ante 300
BernardoDG: posts the ante 300
alexsarakini: posts small blind 600
gwallgofddyn: posts big blind 1200
*** HOLE CARDS ***
muriLLoo.mrL: raises 16617 to 17817 and is all-in
Everbrun11: raises 16617 to 34434
BernardoDG: folds 
somnamna555: folds 
alexsarakini: calls 4250 and is all-in
gwallgofddyn: folds 
Uncalled bet (16617) returned to Everbrun11
*** FLOP *** [As 3s 9h]
*** TURN *** [As 3s 9h] [8h]
*** RIVER *** [As 3s 9h 8h] [4d]
*** SHOW DOWN ***
muriLLoo.mrL: shows [Kh Qs] (high card Ace)
Everbrun11: shows [Ad Jc] (a pair of Aces)
Everbrun11 collected 25934 from side pot
alexsarakini: shows [Ac 6h] (a pair of Aces - lower kicker)
Everbrun11 collected 17550 from main pot
muriLLoo.mrL finished the tournament
alexsarakini finished the tournament
*** SUMMARY ***
Total pot 43484 Main pot 17550. Side pot 25934. | Rake 0 
Board [As 3s 9h 8h 4d]
Seat 1: somnamna555 (button) folded before Flop (didn't bet)
Seat 2: alexsarakini (small blind) showed [Ac 6h] and lost with a pair of Aces
Seat 3: gwallgofddyn (big blind) folded before Flop
Seat 4: muriLLoo.mrL showed [Kh Qs] and lost with high card Ace
Seat 5: Everbrun11 showed [Ad Jc] and won (43484) with a pair of Aces
Seat 6: BernardoDG folded before Flop (didn't bet)

PokerStars Hand #251209759426: Tournament #3769361908, $52.38+$2.62 USD Hold'em No Limit - Level XV (600/1200) - 2024/06/26 22:45:45 UTC [2024/06/26 18:45:45 ET]
Table '3769361908 4' 6-max Seat #3 is the button
Seat 1: somnamna555 (10434 in chips) 
Seat 2: Biguethi339 (7600 in chips) 
Seat 3: gwallgofddyn (14076 in chips) 
Seat 5: Everbrun11 (76025 in chips) 
Seat 6: BernardoDG (18651 in chips) 
somnamna555: posts the ante 300
Biguethi339: posts the ante 300
gwallgofddyn: posts the ante 300
Everbrun11: posts the ante 300
BernardoDG: posts the ante 300
Everbrun11: posts small blind 600
BernardoDG: posts big blind 1200
*** HOLE CARDS ***
Biguethi339 is disconnected 
somnamna555: folds 
Biguethi339: folds 
gwallgofddyn: raises 12576 to 13776 and is all-in
Everbrun11: folds 
BernardoDG: folds 
Uncalled bet (12576) returned to gwallgofddyn
gwallgofddyn collected 4500 from pot
gwallgofddyn: doesn't show hand 
*** SUMMARY ***
Total pot 4500 | Rake 0 
Seat 1: somnamna555 folded before Flop (didn't bet)
Seat 2: Biguethi339 folded before Flop (didn't bet)
Seat 3: gwallgofddyn (button) collected (4500)
Seat 5: Everbrun11 (small blind) folded before Flop
Seat 6: BernardoDG (big blind) folded before Flop

PokerStars Hand #251209764347: Tournament #3769361908, $52.38+$2.62 USD Hold'em No Limit - Level XV (600/1200) - 2024/06/26 22:46:04 UTC [2024/06/26 18:46:04 ET]
Table '3769361908 4' 6-max Seat #5 is the button
Seat 1: somnamna555 (10134 in chips) 
Seat 2: Biguethi339 (7300 in chips) 
Seat 3: gwallgofddyn (17076 in chips) 
Seat 5: Everbrun11 (75125 in chips) 
Seat 6: BernardoDG (17151 in chips) 
somnamna555: posts the ante 300
Biguethi339: posts the ante 300
gwallgofddyn: posts the ante 300
Everbrun11: posts the ante 300
BernardoDG: posts the ante 300
BernardoDG: posts small blind 600
somnamna555: posts big blind 1200
*** HOLE CARDS ***
Biguethi339: folds 
gwallgofddyn: folds 
Everbrun11: folds 
hed777 is disconnected 
BernardoDG: raises 15651 to 16851 and is all-in
somnamna555: folds 
Uncalled bet (15651) returned to BernardoDG
BernardoDG collected 3900 from pot
BernardoDG: doesn't show hand 
*** SUMMARY ***
Total pot 3900 | Rake 0 
Seat 1: somnamna555 (big blind) folded before Flop
Seat 2: Biguethi339 folded before Flop (didn't bet)
Seat 3: gwallgofddyn folded before Flop (didn't bet)
Seat 5: Everbrun11 (button) folded before Flop (didn't bet)
Seat 6: BernardoDG (small blind) collected (3900)

PokerStars Hand #251209769569: Tournament #3769361908, $52.38+$2.62 USD Hold'em No Limit - Level XV (600/1200) - 2024/06/26 22:46:24 UTC [2024/06/26 18:46:24 ET]
Table '3769361908 4' 6-max Seat #6 is the button
Seat 1: somnamna555 (8634 in chips) 
Seat 2: Biguethi339 (7000 in chips) 
Seat 3: gwallgofddyn (16776 in chips) 
Seat 4: hed777 (10000 in chips) 
Seat 5: Everbrun11 (74825 in chips) 
Seat 6: BernardoDG (19551 in chips) 
somnamna555: posts the ante 300
Biguethi339: posts the ante 300
gwallgofddyn: posts the ante 300
hed777: posts the ante 300
Everbrun11: posts the ante 300
BernardoDG: posts the ante 300
somnamna555: posts small blind 600
Biguethi339: posts big blind 1200
*** HOLE CARDS ***
gwallgofddyn: folds 
hed777: folds 
Everbrun11: folds 
BernardoDG: raises 18051 to 19251 and is all-in
somnamna555: folds 
Biguethi339: calls 5500 and is all-in
Uncalled bet (12551) returned to BernardoDG
*** FLOP *** [Qd 3d Qh]
*** TURN *** [Qd 3d Qh] [Kc]
*** RIVER *** [Qd 3d Qh Kc] [2s]
*** SHOW DOWN ***
Biguethi339: shows [Kh 9s] (two pair, Kings and Queens)
BernardoDG: shows [8h 8s] (two pair, Queens and Eights)
Biguethi339 collected 15800 from pot
*** SUMMARY ***
Total pot 15800 | Rake 0 
Board [Qd 3d Qh Kc 2s]
Seat 1: somnamna555 (small blind) folded before Flop
Seat 2: Biguethi339 (big blind) showed [Kh 9s] and won (15800) with two pair, Kings and Queens
Seat 3: gwallgofddyn folded before Flop (didn't bet)
Seat 4: hed777 folded before Flop (didn't bet)
Seat 5: Everbrun11 folded before Flop (didn't bet)
Seat 6: BernardoDG (button) showed [8h 8s] and lost with two pair, Queens and Eights

PokerStars Hand #251209776500: Tournament #3769361908, $52.38+$2.62 USD Hold'em No Limit - Level XV (600/1200) - 2024/06/26 22:46:52 UTC [2024/06/26 18:46:52 ET]
Table '3769361908 4' 6-max Seat #1 is the button
Seat 1: somnamna555 (7734 in chips) 
Seat 2: Biguethi339 (15800 in chips) 
Seat 3: gwallgofddyn (16476 in chips) 
Seat 4: hed777 (9700 in chips) 
Seat 5: Everbrun11 (74525 in chips) 
Seat 6: BernardoDG (12551 in chips) 
somnamna555: posts the ante 300
Biguethi339: posts the ante 300
gwallgofddyn: posts the ante 300
hed777: posts the ante 300
Everbrun11: posts the ante 300
BernardoDG: posts the ante 300
Biguethi339: posts small blind 600
gwallgofddyn: posts big blind 1200
*** HOLE CARDS ***
hed777: folds 
Everbrun11: folds 
BernardoDG: raises 11051 to 12251 and is all-in
somnamna555: folds 
Biguethi339: folds 
gwallgofddyn: folds 
Uncalled bet (11051) returned to BernardoDG
BernardoDG collected 4800 from pot
BernardoDG: doesn't show hand 
*** SUMMARY ***
Total pot 4800 | Rake 0 
Seat 1: somnamna555 (button) folded before Flop (didn't bet)
Seat 2: Biguethi339 (small blind) folded before Flop
Seat 3: gwallgofddyn (big blind) folded before Flop
Seat 4: hed777 folded before Flop (didn't bet)
Seat 5: Everbrun11 folded before Flop (didn't bet)
Seat 6: BernardoDG collected (4800)

PokerStars Hand #251209782529: Tournament #3769361908, $52.38+$2.62 USD Hold'em No Limit - Level XVI (800/1600) - 2024/06/26 22:47:15 UTC [2024/06/26 18:47:15 ET]
Table '3769361908 4' 6-max Seat #2 is the button
Seat 1: somnamna555 (7434 in chips) 
Seat 2: Biguethi339 (14900 in chips) 
Seat 3: gwallgofddyn (14976 in chips) 
Seat 4: hed777 (9400 in chips) 
Seat 5: Everbrun11 (74225 in chips) 
Seat 6: BernardoDG (15851 in chips) 
somnamna555: posts the ante 400
Biguethi339: posts the ante 400
gwallgofddyn: posts the ante 400
hed777: posts the ante 400
Everbrun11: posts the ante 400
BernardoDG: posts the ante 400
gwallgofddyn: posts small blind 800
hed777: posts big blind 1600
*** HOLE CARDS ***
Everbrun11: raises 1600 to 3200
BernardoDG: raises 12251 to 15451 and is all-in
somnamna555: folds 
Biguethi339: folds 
gwallgofddyn: folds 
hed777: folds 
Everbrun11: calls 12251
*** FLOP *** [7c Ks 3c]
*** TURN *** [7c Ks 3c] [2h]
*** RIVER *** [7c Ks 3c 2h] [4s]
*** SHOW DOWN ***
Everbrun11: shows [Ad Ac] (a pair of Aces)
BernardoDG: shows [5c 5h] (a pair of Fives)
Everbrun11 collected 35702 from pot
BernardoDG finished the tournament
*** SUMMARY ***
Total pot 35702 | Rake 0 
Board [7c Ks 3c 2h 4s]
Seat 1: somnamna555 folded before Flop (didn't bet)
Seat 2: Biguethi339 (button) folded before Flop (didn't bet)
Seat 3: gwallgofddyn (small blind) folded before Flop
Seat 4: hed777 (big blind) folded before Flop
Seat 5: Everbrun11 showed [Ad Ac] and won (35702) with a pair of Aces
Seat 6: BernardoDG showed [5c 5h] and lost with a pair of Fives

PokerStars Hand #251209794896: Tournament #3769361908, $52.38+$2.62 USD Hold'em No Limit - Level XVI (800/1600) - 2024/06/26 22:48:04 UTC [2024/06/26 18:48:04 ET]
Table '3769361908 4' 6-max Seat #3 is the button
Seat 1: somnamna555 (7034 in chips) 
Seat 2: Biguethi339 (14500 in chips) 
Seat 3: gwallgofddyn (13776 in chips) 
Seat 4: hed777 (7400 in chips) 
Seat 5: Everbrun11 (94076 in chips) 
somnamna555: posts the ante 400
Biguethi339: posts the ante 400
gwallgofddyn: posts the ante 400
hed777: posts the ante 400
Everbrun11: posts the ante 400
hed777: posts small blind 800
Everbrun11: posts big blind 1600
*** HOLE CARDS ***
Berkowitz33 is disconnected 
somnamna555: raises 5034 to 6634 and is all-in
Biguethi339: folds 
gwallgofddyn: folds 
hed777: folds 
Everbrun11: calls 5034
*** FLOP *** [Qc 7c 2s]
*** TURN *** [Qc 7c 2s] [Jd]
*** RIVER *** [Qc 7c 2s Jd] [Td]
*** SHOW DOWN ***
Everbrun11: shows [6s 9h] (high card Queen)
somnamna555: shows [7h Ah] (a pair of Sevens)
somnamna555 collected 16068 from pot
*** SUMMARY ***
Total pot 16068 | Rake 0 
Board [Qc 7c 2s Jd Td]
Seat 1: somnamna555 showed [7h Ah] and won (16068) with a pair of Sevens
Seat 2: Biguethi339 folded before Flop (didn't bet)
Seat 3: gwallgofddyn (button) folded before Flop (didn't bet)
Seat 4: hed777 (small blind) folded before Flop
Seat 5: Everbrun11 (big blind) showed [6s 9h] and lost with high card Queen

PokerStars Hand #251209803710: Tournament #3769361908, $52.38+$2.62 USD Hold'em No Limit - Level XVI (800/1600) - 2024/06/26 22:48:39 UTC [2024/06/26 18:48:39 ET]
Table '3769361908 4' 6-max Seat #4 is the button
Seat 1: somnamna555 (16068 in chips) 
Seat 2: Biguethi339 (14100 in chips) 
Seat 3: gwallgofddyn (13376 in chips) 
Seat 4: hed777 (6200 in chips) 
Seat 5: Everbrun11 (87042 in chips) 
Seat 6: Berkowitz33 (13666 in chips) 
somnamna555: posts the ante 400
Biguethi339: posts the ante 400
gwallgofddyn: posts the ante 400
hed777: posts the ante 400
Everbrun11: posts the ante 400
Berkowitz33: posts the ante 400
Everbrun11: posts small blind 800
Berkowitz33: posts big blind 1600
*** HOLE CARDS ***
somnamna555: raises 14068 to 15668 and is all-in
Biguethi339: folds 
gwallgofddyn: folds 
hed777: folds 
Everbrun11: folds 
Berkowitz33: folds 
Uncalled bet (14068) returned to somnamna555
somnamna555 collected 6400 from pot
somnamna555: doesn't show hand 
*** SUMMARY ***
Total pot 6400 | Rake 0 
Seat 1: somnamna555 collected (6400)
Seat 2: Biguethi339 folded before Flop (didn't bet)
Seat 3: gwallgofddyn folded before Flop (didn't bet)
Seat 4: hed777 (button) folded before Flop (didn't bet)
Seat 5: Everbrun11 (small blind) folded before Flop
Seat 6: Berkowitz33 (big blind) folded before Flop

PokerStars Hand #251209808170: Tournament #3769361908, $52.38+$2.62 USD Hold'em No Limit - Level XVI (800/1600) - 2024/06/26 22:48:56 UTC [2024/06/26 18:48:56 ET]
Table '3769361908 4' 6-max Seat #5 is the button
Seat 2: Biguethi339 (13700 in chips) 
Seat 3: gwallgofddyn (12976 in chips) 
Seat 4: hed777 (5800 in chips) 
Seat 5: Everbrun11 (85842 in chips) 
Seat 6: Berkowitz33 (11666 in chips) 
Biguethi339: posts the ante 400
gwallgofddyn: posts the ante 400
hed777: posts the ante 400
Everbrun11: posts the ante 400
Berkowitz33: posts the ante 400
Berkowitz33: posts small blind 800
Biguethi339: posts big blind 1600
*** HOLE CARDS ***
gwallgofddyn: folds 
hed777: raises 3800 to 5400 and is all-in
C0rpsbal is disconnected 
Everbrun11: folds 
Berkowitz33: folds 
Biguethi339: calls 3800
*** FLOP *** [Kc 4h 8c]
*** TURN *** [Kc 4h 8c] [9d]
*** RIVER *** [Kc 4h 8c 9d] [3s]
*** SHOW DOWN ***
Biguethi339: shows [Th 7d] (high card King)
hed777: shows [4d As] (a pair of Fours)
hed777 collected 13600 from pot
*** SUMMARY ***
Total pot 13600 | Rake 0 
Board [Kc 4h 8c 9d 3s]
Seat 2: Biguethi339 (big blind) showed [Th 7d] and lost with high card King
Seat 3: gwallgofddyn folded before Flop (didn't bet)
Seat 4: hed777 showed [4d As] and won (13600) with a pair of Fours
Seat 5: Everbrun11 (button) folded before Flop (didn't bet)
Seat 6: Berkowitz33 (small blind) folded before Flop

PokerStars Hand #251209818951: Tournament #3769361908, $52.38+$2.62 USD Hold'em No Limit - Level XVI (800/1600) - 2024/06/26 22:49:40 UTC [2024/06/26 18:49:40 ET]
Table '3769361908 4' 6-max Seat #6 is the button
Seat 1: C0rpsbal (21826 in chips) out of hand (moved from another table into small blind)
Seat 2: Biguethi339 (7900 in chips) 
Seat 3: gwallgofddyn (12576 in chips) 
Seat 4: hed777 (13600 in chips) 
Seat 5: Everbrun11 (85442 in chips) 
Seat 6: Berkowitz33 (10466 in chips) 
C0rpsbal will be allowed to play after the button
Biguethi339: posts the ante 400
gwallgofddyn: posts the ante 400
hed777: posts the ante 400
Everbrun11: posts the ante 400
Berkowitz33: posts the ante 400
Biguethi339: posts small blind 800
gwallgofddyn: posts big blind 1600
*** HOLE CARDS ***
hed777: folds 
Everbrun11: folds 
Berkowitz33: folds 
Biguethi339: folds 
Uncalled bet (800) returned to gwallgofddyn
gwallgofddyn collected 3600 from pot
gwallgofddyn: doesn't show hand 
*** SUMMARY ***
Total pot 3600 | Rake 0 
Seat 2: Biguethi339 (small blind) folded before Flop
Seat 3: gwallgofddyn (big blind) collected (3600)
Seat 4: hed777 folded before Flop (didn't bet)
Seat 5: Everbrun11 folded before Flop (didn't bet)
Seat 6: Berkowitz33 (button) folded before Flop (didn't bet)

PokerStars Hand #251209821256: Tournament #3769361908, $52.38+$2.62 USD Hold'em No Limit - Level XVI (800/1600) - 2024/06/26 22:49:49 UTC [2024/06/26 18:49:49 ET]
Table '3769361908 4' 6-max Seat #2 is the button
Seat 1: C0rpsbal (21826 in chips) 
Seat 2: Biguethi339 (6700 in chips) 
Seat 3: gwallgofddyn (14976 in chips) 
Seat 4: hed777 (13200 in chips) 
Seat 5: Everbrun11 (85042 in chips) 
Seat 6: Berkowitz33 (10066 in chips) 
C0rpsbal: posts the ante 400
Biguethi339: posts the ante 400
gwallgofddyn: posts the ante 400
hed777: posts the ante 400
Everbrun11: posts the ante 400
Berkowitz33: posts the ante 400
gwallgofddyn: posts small blind 800
hed777: posts big blind 1600
*** HOLE CARDS ***
Everbrun11: folds 
Berkowitz33: raises 8066 to 9666 and is all-in
C0rpsbal: folds 
Biguethi339: calls 6300 and is all-in
gwallgofddyn: folds 
hed777: folds 
Uncalled bet (3366) returned to Berkowitz33
*** FLOP *** [6c 7c 9s]
*** TURN *** [6c 7c 9s] [Qs]
*** RIVER *** [6c 7c 9s Qs] [Jc]
*** SHOW DOWN ***
Berkowitz33: shows [Qd Ad] (a pair of Queens)
Biguethi339: shows [Qh Jh] (two pair, Queens and Jacks)
Biguethi339 collected 17400 from pot
*** SUMMARY ***
Total pot 17400 | Rake 0 
Board [6c 7c 9s Qs Jc]
Seat 1: C0rpsbal folded before Flop (didn't bet)
Seat 2: Biguethi339 (button) showed [Qh Jh] and won (17400) with two pair, Queens and Jacks
Seat 3: gwallgofddyn (small blind) folded before Flop
Seat 4: hed777 (big blind) folded before Flop
Seat 5: Everbrun11 folded before Flop (didn't bet)
Seat 6: Berkowitz33 showed [Qd Ad] and lost with a pair of Queens

PokerStars Hand #251209834253: Tournament #3769361908, $52.38+$2.62 USD Hold'em No Limit - Level XVII (1000/2000) - 2024/06/26 22:50:42 UTC [2024/06/26 18:50:42 ET]
Table '3769361908 4' 6-max Seat #3 is the button
Seat 1: C0rpsbal (21426 in chips) 
Seat 2: Biguethi339 (17400 in chips) 
Seat 3: gwallgofddyn (13776 in chips) 
Seat 4: hed777 (11200 in chips) 
Seat 5: Everbrun11 (84642 in chips) 
Seat 6: Berkowitz33 (3366 in chips) 
C0rpsbal: posts the ante 500
Biguethi339: posts the ante 500
gwallgofddyn: posts the ante 500
hed777: posts the ante 500
Everbrun11: posts the ante 500
Berkowitz33: posts the ante 500
hed777: posts small blind 1000
Everbrun11: posts big blind 2000
*** HOLE CARDS ***
Berkowitz33: folds 
C0rpsbal: folds 
Biguethi339: folds 
gwallgofddyn: folds 
hed777: raises 8700 to 10700 and is all-in
Everbrun11: calls 8700
*** FLOP *** [9c 4h Qs]
*** TURN *** [9c 4h Qs] [As]
*** RIVER *** [9c 4h Qs As] [Ac]
*** SHOW DOWN ***
hed777: shows [Jc Ks] (a pair of Aces)
Everbrun11: shows [Th Qc] (two pair, Aces and Queens)
Everbrun11 collected 24400 from pot
hed777 finished the tournament in 105th place
*** SUMMARY ***
Total pot 24400 | Rake 0 
Board [9c 4h Qs As Ac]
Seat 1: C0rpsbal folded before Flop (didn't bet)
Seat 2: Biguethi339 folded before Flop (didn't bet)
Seat 3: gwallgofddyn (button) folded before Flop (didn't bet)
Seat 4: hed777 (small blind) showed [Jc Ks] and lost with a pair of Aces
Seat 5: Everbrun11 (big blind) showed [Th Qc] and won (24400) with two pair, Aces and Queens
Seat 6: Berkowitz33 folded before Flop (didn't bet)

PokerStars Hand #251209841343: Tournament #3769361908, $52.38+$2.62 USD Hold'em No Limit - Level XVII (1000/2000) - 2024/06/26 22:51:12 UTC [2024/06/26 18:51:12 ET]
Table '3769361908 4' 6-max Seat #5 is the button
Seat 1: C0rpsbal (20926 in chips) 
Seat 2: Biguethi339 (16900 in chips) 
Seat 3: gwallgofddyn (13276 in chips) 
Seat 5: Everbrun11 (97842 in chips) 
Seat 6: Berkowitz33 (2866 in chips) 
C0rpsbal: posts the ante 500
Biguethi339: posts the ante 500
gwallgofddyn: posts the ante 500
Everbrun11: posts the ante 500
Berkowitz33: posts the ante 500
Berkowitz33: posts small blind 1000
C0rpsbal: posts big blind 2000
*** HOLE CARDS ***
Biguethi339: folds 
gwallgofddyn: folds 
Everbrun11: folds 
DR. ELDAR is disconnected 
Berkowitz33: raises 366 to 2366 and is all-in
C0rpsbal: calls 366
*** FLOP *** [Qh 9h 4s]
*** TURN *** [Qh 9h 4s] [Ts]
*** RIVER *** [Qh 9h 4s Ts] [Qs]
*** SHOW DOWN ***
Berkowitz33: shows [3s 5d] (a pair of Queens)
C0rpsbal: shows [Qd Jh] (three of a kind, Queens)
C0rpsbal collected 7232 from pot
Berkowitz33 finished the tournament in 102nd place
*** SUMMARY ***
Total pot 7232 | Rake 0 
Board [Qh 9h 4s Ts Qs]
Seat 1: C0rpsbal (big blind) showed [Qd Jh] and won (7232) with three of a kind, Queens
Seat 2: Biguethi339 folded before Flop (didn't bet)
Seat 3: gwallgofddyn folded before Flop (didn't bet)
Seat 5: Everbrun11 (button) folded before Flop (didn't bet)
Seat 6: Berkowitz33 (small blind) showed [3s 5d] and lost with a pair of Queens

PokerStars Hand #251209847215: Tournament #3769361908, $52.38+$2.62 USD Hold'em No Limit - Level XVII (1000/2000) - 2024/06/26 22:51:36 UTC [2024/06/26 18:51:36 ET]
Table '3769361908 4' 6-max Seat #1 is the button
Seat 1: C0rpsbal (25292 in chips) 
Seat 2: Biguethi339 (16400 in chips) 
Seat 3: gwallgofddyn (12776 in chips) 
Seat 4: DR. ELDAR (33745 in chips) 
Seat 5: Everbrun11 (97342 in chips) 
C0rpsbal: posts the ante 500
Biguethi339: posts the ante 500
gwallgofddyn: posts the ante 500
DR. ELDAR: posts the ante 500
Everbrun11: posts the ante 500
Biguethi339: posts small blind 1000
gwallgofddyn: posts big blind 2000
*** HOLE CARDS ***
DR. ELDAR: folds 
Everbrun11: folds 
C0rpsbal: folds 
Biguethi339: raises 13900 to 15900 and is all-in
gwallgofddyn: folds 
Uncalled bet (13900) returned to Biguethi339
Biguethi339 collected 6500 from pot
Biguethi339: doesn't show hand 
*** SUMMARY ***
Total pot 6500 | Rake 0 
Seat 1: C0rpsbal (button) folded before Flop (didn't bet)
Seat 2: Biguethi339 (small blind) collected (6500)
Seat 3: gwallgofddyn (big blind) folded before Flop
Seat 4: DR. ELDAR folded before Flop (didn't bet)
Seat 5: Everbrun11 folded before Flop (didn't bet)

PokerStars Hand #251209851160: Tournament #3769361908, $52.38+$2.62 USD Hold'em No Limit - Level XVII (1000/2000) - 2024/06/26 22:51:52 UTC [2024/06/26 18:51:52 ET]
Table '3769361908 4' 6-max Seat #2 is the button
Seat 1: C0rpsbal (24792 in chips) 
Seat 2: Biguethi339 (20400 in chips) 
Seat 3: gwallgofddyn (10276 in chips) 
Seat 4: DR. ELDAR (33245 in chips) 
Seat 5: Everbrun11 (96842 in chips) 
C0rpsbal: posts the ante 500
Biguethi339: posts the ante 500
gwallgofddyn: posts the ante 500
DR. ELDAR: posts the ante 500
Everbrun11: posts the ante 500
gwallgofddyn: posts small blind 1000
DR. ELDAR: posts big blind 2000
*** HOLE CARDS ***
Everbrun11: folds 
C0rpsbal: raises 2000 to 4000
viniperri is disconnected 
Biguethi339: folds 
gwallgofddyn: raises 5776 to 9776 and is all-in
DR. ELDAR: folds 
C0rpsbal: calls 5776
*** FLOP *** [Jd 2h Ks]
*** TURN *** [Jd 2h Ks] [5d]
*** RIVER *** [Jd 2h Ks 5d] [5s]
*** SHOW DOWN ***
gwallgofddyn: shows [3d Ac] (a pair of Fives)
C0rpsbal: shows [4c Kc] (two pair, Kings and Fives)
C0rpsbal collected 24052 from pot
gwallgofddyn finished the tournament in 94th place
*** SUMMARY ***
Total pot 24052 | Rake 0 
Board [Jd 2h Ks 5d 5s]
Seat 1: C0rpsbal showed [4c Kc] and won (24052) with two pair, Kings and Fives
Seat 2: Biguethi339 (button) folded before Flop (didn't bet)
Seat 3: gwallgofddyn (small blind) showed [3d Ac] and lost with a pair of Fives
Seat 4: DR. ELDAR (big blind) folded before Flop
Seat 5: Everbrun11 folded before Flop (didn't bet)

PokerStars Hand #251209860579: Tournament #3769361908, $52.38+$2.62 USD Hold'em No Limit - Level XVII (1000/2000) - 2024/06/26 22:52:30 UTC [2024/06/26 18:52:30 ET]
Table '3769361908 4' 6-max Seat #4 is the button
Seat 1: C0rpsbal (38568 in chips) 
Seat 2: Biguethi339 (19900 in chips) 
Seat 4: DR. ELDAR (30745 in chips) 
Seat 5: Everbrun11 (96342 in chips) 
Seat 6: viniperri (81901 in chips) 
C0rpsbal: posts the ante 500
Biguethi339: posts the ante 500
DR. ELDAR: posts the ante 500
Everbrun11: posts the ante 500
viniperri: posts the ante 500
Everbrun11: posts small blind 1000
viniperri: posts big blind 2000
*** HOLE CARDS ***
C0rpsbal: folds 
Biguethi339: raises 17400 to 19400 and is all-in
DR. ELDAR: folds 
Everbrun11: folds 
viniperri: folds 
Uncalled bet (17400) returned to Biguethi339
Biguethi339 collected 7500 from pot
Biguethi339: doesn't show hand 
*** SUMMARY ***
Total pot 7500 | Rake 0 
Seat 1: C0rpsbal folded before Flop (didn't bet)
Seat 2: Biguethi339 collected (7500)
Seat 4: DR. ELDAR (button) folded before Flop (didn't bet)
Seat 5: Everbrun11 (small blind) folded before Flop
Seat 6: viniperri (big blind) folded before Flop

PokerStars Hand #251209865684: Tournament #3769361908, $52.38+$2.62 USD Hold'em No Limit - Level XVII (1000/2000) - 2024/06/26 22:52:51 UTC [2024/06/26 18:52:51 ET]
Table '3769361908 4' 6-max Seat #5 is the button
Seat 1: C0rpsbal (38068 in chips) 
Seat 2: Biguethi339 (24900 in chips) 
Seat 3: jerdno0 (19434 in chips) 
Seat 4: DR. ELDAR (30245 in chips) 
Seat 5: Everbrun11 (94842 in chips) 
Seat 6: viniperri (79401 in chips) 
C0rpsbal: posts the ante 500
Biguethi339: posts the ante 500
jerdno0: posts the ante 500
DR. ELDAR: posts the ante 500
Everbrun11: posts the ante 500
viniperri: posts the ante 500
viniperri: posts small blind 1000
C0rpsbal: posts big blind 2000
*** HOLE CARDS ***
Biguethi339: raises 2000 to 4000
jerdno0: folds 
DR. ELDAR: folds 
Everbrun11: folds 
viniperri: folds 
C0rpsbal: calls 2000
*** FLOP *** [Jh Jd 9s]
C0rpsbal: checks 
Biguethi339: bets 2000
C0rpsbal: calls 2000
*** TURN *** [Jh Jd 9s] [Jc]
C0rpsbal: checks 
Biguethi339: bets 3200
C0rpsbal: raises 22400 to 25600
Biguethi339: folds 
Uncalled bet (22400) returned to C0rpsbal
C0rpsbal collected 22400 from pot
C0rpsbal: doesn't show hand 
*** SUMMARY ***
Total pot 22400 | Rake 0 
Board [Jh Jd 9s Jc]
Seat 1: C0rpsbal (big blind) collected (22400)
Seat 2: Biguethi339 folded on the Turn
Seat 3: jerdno0 folded before Flop (didn't bet)
Seat 4: DR. ELDAR folded before Flop (didn't bet)
Seat 5: Everbrun11 (button) folded before Flop (didn't bet)
Seat 6: viniperri (small blind) folded before Flop

PokerStars Hand #251209881021: Tournament #3769361908, $52.38+$2.62 USD Hold'em No Limit - Level XVIII (1200/2400) - 2024/06/26 22:53:54 UTC [2024/06/26 18:53:54 ET]
Table '3769361908 4' 6-max Seat #6 is the button
Seat 1: C0rpsbal (50768 in chips) 
Seat 2: Biguethi339 (15200 in chips) 
Seat 3: jerdno0 (18934 in chips) 
Seat 4: DR. ELDAR (29745 in chips) 
Seat 5: Everbrun11 (94342 in chips) 
Seat 6: viniperri (77901 in chips) 
C0rpsbal: posts the ante 600
Biguethi339: posts the ante 600
jerdno0: posts the ante 600
DR. ELDAR: posts the ante 600
Everbrun11: posts the ante 600
viniperri: posts the ante 600
C0rpsbal: posts small blind 1200
Biguethi339: posts big blind 2400
*** HOLE CARDS ***
jerdno0: folds 
DR. ELDAR: raises 2640 to 5040
Everbrun11: folds 
viniperri: folds 
C0rpsbal: folds 
Biguethi339: folds 
Uncalled bet (2640) returned to DR. ELDAR
DR. ELDAR collected 9600 from pot
DR. ELDAR: doesn't show hand 
*** SUMMARY ***
Total pot 9600 | Rake 0 
Seat 1: C0rpsbal (small blind) folded before Flop
Seat 2: Biguethi339 (big blind) folded before Flop
Seat 3: jerdno0 folded before Flop (didn't bet)
Seat 4: DR. ELDAR collected (9600)
Seat 5: Everbrun11 folded before Flop (didn't bet)
Seat 6: viniperri (button) folded before Flop (didn't bet)

PokerStars Hand #251209888262: Tournament #3769361908, $52.38+$2.62 USD Hold'em No Limit - Level XVIII (1200/2400) - 2024/06/26 22:54:24 UTC [2024/06/26 18:54:24 ET]
Table '3769361908 4' 6-max Seat #1 is the button
Seat 1: C0rpsbal (48968 in chips) 
Seat 2: Biguethi339 (12200 in chips) 
Seat 3: jerdno0 (18334 in chips) 
Seat 5: Everbrun11 (93742 in chips) 
Seat 6: viniperri (77301 in chips) 
C0rpsbal: posts the ante 600
Biguethi339: posts the ante 600
jerdno0: posts the ante 600
Everbrun11: posts the ante 600
viniperri: posts the ante 600
Biguethi339: posts small blind 1200
jerdno0: posts big blind 2400
*** HOLE CARDS ***
Everbrun11: raises 3600 to 6000
viniperri: folds 
C0rpsbal: folds 
Biguethi339: folds 
jerdno0: folds 
Uncalled bet (3600) returned to Everbrun11
Everbrun11 collected 9000 from pot
Everbrun11: doesn't show hand 
*** SUMMARY ***
Total pot 9000 | Rake 0 
Seat 1: C0rpsbal (button) folded before Flop (didn't bet)
Seat 2: Biguethi339 (small blind) folded before Flop
Seat 3: jerdno0 (big blind) folded before Flop
Seat 5: Everbrun11 collected (9000)
Seat 6: viniperri folded before Flop (didn't bet)

PokerStars Hand #251209894287: Tournament #3769361908, $52.38+$2.62 USD Hold'em No Limit - Level XVIII (1200/2400) - 2024/06/26 22:54:49 UTC [2024/06/26 18:54:49 ET]
Table '3769361908 4' 6-max Seat #2 is the button
Seat 1: C0rpsbal (48368 in chips) 
Seat 2: Biguethi339 (10400 in chips) 
Seat 3: jerdno0 (15334 in chips) 
Seat 5: Everbrun11 (99742 in chips) 
Seat 6: viniperri (76701 in chips) 
C0rpsbal: posts the ante 600
Biguethi339: posts the ante 600
jerdno0: posts the ante 600
Everbrun11: posts the ante 600
viniperri: posts the ante 600
jerdno0: posts small blind 1200
Everbrun11: posts big blind 2400
*** HOLE CARDS ***
viniperri: folds 
C0rpsbal: folds 
Biguethi339: folds 
jerdno0: raises 4800 to 7200
Lecher1991 is disconnected 
Everbrun11: raises 9600 to 16800
jerdno0: calls 7534 and is all-in
Uncalled bet (2066) returned to Everbrun11
*** FLOP *** [9s Ks Qh]
*** TURN *** [9s Ks Qh] [9h]
*** RIVER *** [9s Ks Qh 9h] [4d]
*** SHOW DOWN ***
jerdno0: shows [As Ac] (two pair, Aces and Nines)
Everbrun11: shows [Ad Th] (a pair of Nines)
jerdno0 collected 32468 from pot
*** SUMMARY ***
Total pot 32468 | Rake 0 
Board [9s Ks Qh 9h 4d]
Seat 1: C0rpsbal folded before Flop (didn't bet)
Seat 2: Biguethi339 (button) folded before Flop (didn't bet)
Seat 3: jerdno0 (small blind) showed [As Ac] and won (32468) with two pair, Aces and Nines
Seat 5: Everbrun11 (big blind) showed [Ad Th] and lost with a pair of Nines
Seat 6: viniperri folded before Flop (didn't bet)

PokerStars Hand #251209964595: Tournament #3769361908, $52.38+$2.62 USD Hold'em No Limit - Level XVIII (1200/2400) - 2024/06/26 23:01:09 UTC [2024/06/26 19:01:09 ET]
Table '3769361908 4' 6-max Seat #3 is the button
Seat 1: C0rpsbal (47768 in chips) 
Seat 2: Biguethi339 (9800 in chips) 
Seat 3: jerdno0 (32468 in chips) 
Seat 4: Lecher1991 (61456 in chips) out of hand (moved from another table into small blind)
Seat 5: Everbrun11 (84408 in chips) 
Seat 6: viniperri (76101 in chips) 
Lecher1991 will be allowed to play after the button
C0rpsbal: posts the ante 600
Biguethi339: posts the ante 600
jerdno0: posts the ante 600
Everbrun11: posts the ante 600
viniperri: posts the ante 600
Everbrun11: posts small blind 1200
viniperri: posts big blind 2400
*** HOLE CARDS ***
C0rpsbal: folds 
Biguethi339: folds 
jerdno0: folds 
Everbrun11: calls 1200
viniperri: checks 
*** FLOP *** [Qs 2h Td]
Everbrun11: checks 
viniperri: checks 
*** TURN *** [Qs 2h Td] [Kc]
Everbrun11: bets 2400
viniperri: calls 2400
*** RIVER *** [Qs 2h Td Kc] [7s]
Everbrun11: bets 8400
viniperri: folds 
Uncalled bet (8400) returned to Everbrun11
Everbrun11 collected 12600 from pot
Everbrun11: doesn't show hand 
*** SUMMARY ***
Total pot 12600 | Rake 0 
Board [Qs 2h Td Kc 7s]
Seat 1: C0rpsbal folded before Flop (didn't bet)
Seat 2: Biguethi339 folded before Flop (didn't bet)
Seat 3: jerdno0 (button) folded before Flop (didn't bet)
Seat 5: Everbrun11 (small blind) collected (12600)
Seat 6: viniperri (big blind) folded on the River

PokerStars Hand #251209981054: Tournament #3769361908, $52.38+$2.62 USD Hold'em No Limit - Level XIX (1400/2800) - 2024/06/26 23:02:21 UTC [2024/06/26 19:02:21 ET]
Table '3769361908 4' 6-max Seat #5 is the button
Seat 1: C0rpsbal (47168 in chips) 
Seat 2: Biguethi339 (9200 in chips) 
Seat 3: jerdno0 (31868 in chips) 
Seat 4: Lecher1991 (61456 in chips) 
Seat 5: Everbrun11 (91608 in chips) 
Seat 6: viniperri (70701 in chips) 
C0rpsbal: posts the ante 700
Biguethi339: posts the ante 700
jerdno0: posts the ante 700
Lecher1991: posts the ante 700
Everbrun11: posts the ante 700
viniperri: posts the ante 700
viniperri: posts small blind 1400
C0rpsbal: posts big blind 2800
*** HOLE CARDS ***
Biguethi339: raises 5700 to 8500 and is all-in
jerdno0: calls 8500
Lecher1991: folds 
Everbrun11: folds 
viniperri: folds 
C0rpsbal: folds 
*** FLOP *** [Ad Jc Ts]
*** TURN *** [Ad Jc Ts] [8d]
*** RIVER *** [Ad Jc Ts 8d] [3d]
*** SHOW DOWN ***
Biguethi339: shows [Kc Td] (a pair of Tens)
jerdno0: shows [5h Ah] (a pair of Aces)
jerdno0 collected 25400 from pot
Biguethi339 finished the tournament in 70th place
*** SUMMARY ***
Total pot 25400 | Rake 0 
Board [Ad Jc Ts 8d 3d]
Seat 1: C0rpsbal (big blind) folded before Flop
Seat 2: Biguethi339 showed [Kc Td] and lost with a pair of Tens
Seat 3: jerdno0 showed [5h Ah] and won (25400) with a pair of Aces
Seat 4: Lecher1991 folded before Flop (didn't bet)
Seat 5: Everbrun11 (button) folded before Flop (didn't bet)
Seat 6: viniperri (small blind) folded before Flop

PokerStars Hand #251209989190: Tournament #3769361908, $52.38+$2.62 USD Hold'em No Limit - Level XIX (1400/2800) - 2024/06/26 23:02:56 UTC [2024/06/26 19:02:56 ET]
Table '3769361908 4' 6-max Seat #6 is the button
Seat 1: C0rpsbal (43668 in chips) 
Seat 3: jerdno0 (48068 in chips) 
Seat 4: Lecher1991 (60756 in chips) 
Seat 5: Everbrun11 (90908 in chips) 
Seat 6: viniperri (68601 in chips) 
C0rpsbal: posts the ante 700
jerdno0: posts the ante 700
Lecher1991: posts the ante 700
Everbrun11: posts the ante 700
viniperri: posts the ante 700
C0rpsbal: posts small blind 1400
jerdno0: posts big blind 2800
*** HOLE CARDS ***
Lecher1991: folds 
Everbrun11: folds 
viniperri: folds 
C0rpsbal: raises 40168 to 42968 and is all-in
jerdno0: folds 
Uncalled bet (40168) returned to C0rpsbal
C0rpsbal collected 9100 from pot
C0rpsbal: doesn't show hand 
*** SUMMARY ***
Total pot 9100 | Rake 0 
Seat 1: C0rpsbal (small blind) collected (9100)
Seat 3: jerdno0 (big blind) folded before Flop
Seat 4: Lecher1991 folded before Flop (didn't bet)
Seat 5: Everbrun11 folded before Flop (didn't bet)
Seat 6: viniperri (button) folded before Flop (didn't bet)

PokerStars Hand #251209997527: Tournament #3769361908, $52.38+$2.62 USD Hold'em No Limit - Level XIX (1400/2800) - 2024/06/26 23:03:32 UTC [2024/06/26 19:03:32 ET]
Table '3769361908 4' 6-max Seat #1 is the button
Seat 1: C0rpsbal (49268 in chips) 
Seat 3: jerdno0 (44568 in chips) 
Seat 4: Lecher1991 (60056 in chips) 
Seat 5: Everbrun11 (90208 in chips) 
Seat 6: viniperri (67901 in chips) 
C0rpsbal: posts the ante 700
jerdno0: posts the ante 700
Lecher1991: posts the ante 700
Everbrun11: posts the ante 700
viniperri: posts the ante 700
jerdno0: posts small blind 1400
Lecher1991: posts big blind 2800
*** HOLE CARDS ***
Everbrun11: folds 
viniperri: folds 
C0rpsbal: folds 
jerdno0: folds 
Uncalled bet (1400) returned to Lecher1991
Lecher1991 collected 6300 from pot
*** SUMMARY ***
Total pot 6300 | Rake 0 
Seat 1: C0rpsbal (button) folded before Flop (didn't bet)
Seat 3: jerdno0 (small blind) folded before Flop
Seat 4: Lecher1991 (big blind) collected (6300)
Seat 5: Everbrun11 folded before Flop (didn't bet)
Seat 6: viniperri folded before Flop (didn't bet)

PokerStars Hand #251210005825: Tournament #3769361908, $52.38+$2.62 USD Hold'em No Limit - Level XIX (1400/2800) - 2024/06/26 23:04:08 UTC [2024/06/26 19:04:08 ET]
Table '3769361908 4' 6-max Seat #3 is the button
Seat 1: C0rpsbal (48568 in chips) 
Seat 3: jerdno0 (42468 in chips) 
Seat 4: Lecher1991 (64256 in chips) 
Seat 5: Everbrun11 (89508 in chips) 
Seat 6: viniperri (67201 in chips) 
C0rpsbal: posts the ante 700
jerdno0: posts the ante 700
Lecher1991: posts the ante 700
Everbrun11: posts the ante 700
viniperri: posts the ante 700
Lecher1991: posts small blind 1400
Everbrun11: posts big blind 2800
*** HOLE CARDS ***
viniperri: folds 
C0rpsbal: folds 
jerdno0: folds 
Chuckster388 is disconnected 
Lecher1991: folds 
Uncalled bet (1400) returned to Everbrun11
Everbrun11 collected 6300 from pot
Everbrun11: doesn't show hand 
*** SUMMARY ***
Total pot 6300 | Rake 0 
Seat 1: C0rpsbal folded before Flop (didn't bet)
Seat 3: jerdno0 (button) folded before Flop (didn't bet)
Seat 4: Lecher1991 (small blind) folded before Flop
Seat 5: Everbrun11 (big blind) collected (6300)
Seat 6: viniperri folded before Flop (didn't bet)

PokerStars Hand #251210010407: Tournament #3769361908, $52.38+$2.62 USD Hold'em No Limit - Level XIX (1400/2800) - 2024/06/26 23:04:27 UTC [2024/06/26 19:04:27 ET]
Table '3769361908 4' 6-max Seat #4 is the button
Seat 1: C0rpsbal (47868 in chips) 
Seat 2: Chuckster388 (58880 in chips) 
Seat 3: jerdno0 (41768 in chips) 
Seat 4: Lecher1991 (62156 in chips) 
Seat 5: Everbrun11 (93708 in chips) 
Seat 6: viniperri (66501 in chips) 
C0rpsbal: posts the ante 700
Chuckster388: posts the ante 700
jerdno0: posts the ante 700
Lecher1991: posts the ante 700
Everbrun11: posts the ante 700
viniperri: posts the ante 700
Everbrun11: posts small blind 1400
viniperri: posts big blind 2800
*** HOLE CARDS ***
C0rpsbal: folds 
Chuckster388: folds 
jerdno0: folds 
Lecher1991: folds 
Everbrun11: calls 1400
viniperri: checks 
*** FLOP *** [4h Jh 3s]
Everbrun11: bets 2800
viniperri: calls 2800
*** TURN *** [4h Jh 3s] [4d]
Everbrun11: checks 
viniperri: bets 9800
Everbrun11: calls 9800
*** RIVER *** [4h Jh 3s 4d] [9d]
Everbrun11: checks 
viniperri: bets 42000
Everbrun11: folds 
Uncalled bet (42000) returned to viniperri
viniperri collected 35000 from pot
viniperri: doesn't show hand 
*** SUMMARY ***
Total pot 35000 | Rake 0 
Board [4h Jh 3s 4d 9d]
Seat 1: C0rpsbal folded before Flop (didn't bet)
Seat 2: Chuckster388 folded before Flop (didn't bet)
Seat 3: jerdno0 folded before Flop (didn't bet)
Seat 4: Lecher1991 (button) folded before Flop (didn't bet)
Seat 5: Everbrun11 (small blind) folded on the River
Seat 6: viniperri (big blind) collected (35000)

PokerStars Hand #251210037661: Tournament #3769361908, $52.38+$2.62 USD Hold'em No Limit - Level XX (1600/3200) - 2024/06/26 23:06:26 UTC [2024/06/26 19:06:26 ET]
Table '3769361908 4' 6-max Seat #5 is the button
Seat 1: C0rpsbal (47168 in chips) 
Seat 2: Chuckster388 (58180 in chips) 
Seat 3: jerdno0 (41068 in chips) 
Seat 4: Lecher1991 (61456 in chips) 
Seat 5: Everbrun11 (77608 in chips) 
Seat 6: viniperri (85401 in chips) 
C0rpsbal: posts the ante 800
Chuckster388: posts the ante 800
jerdno0: posts the ante 800
Lecher1991: posts the ante 800
Everbrun11: posts the ante 800
viniperri: posts the ante 800
viniperri: posts small blind 1600
C0rpsbal: posts big blind 3200
*** HOLE CARDS ***
Chuckster388: folds 
jerdno0: calls 3200
Lecher1991: folds 
Everbrun11: folds 
viniperri: calls 1600
C0rpsbal: checks 
*** FLOP *** [2s 7h 3h]
viniperri: checks 
C0rpsbal: checks 
jerdno0: bets 4000
viniperri: calls 4000
C0rpsbal: folds 
*** TURN *** [2s 7h 3h] [2d]
viniperri: checks 
jerdno0: bets 8000
viniperri: folds 
Uncalled bet (8000) returned to jerdno0
jerdno0 collected 22400 from pot
*** SUMMARY ***
Total pot 22400 | Rake 0 
Board [2s 7h 3h 2d]
Seat 1: C0rpsbal (big blind) folded on the Flop
Seat 2: Chuckster388 folded before Flop (didn't bet)
Seat 3: jerdno0 collected (22400)
Seat 4: Lecher1991 folded before Flop (didn't bet)
Seat 5: Everbrun11 (button) folded before Flop (didn't bet)
Seat 6: viniperri (small blind) folded on the Turn

PokerStars Hand #251210059333: Tournament #3769361908, $52.38+$2.62 USD Hold'em No Limit - Level XX (1600/3200) - 2024/06/26 23:08:01 UTC [2024/06/26 19:08:01 ET]
Table '3769361908 4' 6-max Seat #6 is the button
Seat 1: C0rpsbal (43168 in chips) 
Seat 2: Chuckster388 (57380 in chips) 
Seat 3: jerdno0 (55468 in chips) 
Seat 4: Lecher1991 (60656 in chips) 
Seat 5: Everbrun11 (76808 in chips) 
Seat 6: viniperri (77401 in chips) 
C0rpsbal: posts the ante 800
Chuckster388: posts the ante 800
jerdno0: posts the ante 800
Lecher1991: posts the ante 800
Everbrun11: posts the ante 800
viniperri: posts the ante 800
C0rpsbal: posts small blind 1600
Chuckster388: posts big blind 3200
*** HOLE CARDS ***
jerdno0: folds 
Lecher1991: folds 
Everbrun11: folds 
viniperri: raises 3200 to 6400
C0rpsbal: folds 
Chuckster388: folds 
Uncalled bet (3200) returned to viniperri
viniperri collected 12800 from pot
viniperri: doesn't show hand 
*** SUMMARY ***
Total pot 12800 | Rake 0 
Seat 1: C0rpsbal (small blind) folded before Flop
Seat 2: Chuckster388 (big blind) folded before Flop
Seat 3: jerdno0 folded before Flop (didn't bet)
Seat 4: Lecher1991 folded before Flop (didn't bet)
Seat 5: Everbrun11 folded before Flop (didn't bet)
Seat 6: viniperri (button) collected (12800)

PokerStars Hand #251210065769: Tournament #3769361908, $52.38+$2.62 USD Hold'em No Limit - Level XXI (1800/3600) - 2024/06/26 23:08:30 UTC [2024/06/26 19:08:30 ET]
Table '3769361908 4' 6-max Seat #1 is the button
Seat 1: C0rpsbal (40768 in chips) 
Seat 2: Chuckster388 (53380 in chips) 
Seat 3: jerdno0 (54668 in chips) 
Seat 4: Lecher1991 (59856 in chips) 
Seat 5: Everbrun11 (76008 in chips) 
Seat 6: viniperri (86201 in chips) 
C0rpsbal: posts the ante 900
Chuckster388: posts the ante 900
jerdno0: posts the ante 900
Lecher1991: posts the ante 900
Everbrun11: posts the ante 900
viniperri: posts the ante 900
Chuckster388: posts small blind 1800
jerdno0: posts big blind 3600
*** HOLE CARDS ***
Lecher1991: folds 
Everbrun11: folds 
viniperri: folds 
C0rpsbal: folds 
Chuckster388: folds 
Uncalled bet (1800) returned to jerdno0
jerdno0 collected 9000 from pot
*** SUMMARY ***
Total pot 9000 | Rake 0 
Seat 1: C0rpsbal (button) folded before Flop (didn't bet)
Seat 2: Chuckster388 (small blind) folded before Flop
Seat 3: jerdno0 (big blind) collected (9000)
Seat 4: Lecher1991 folded before Flop (didn't bet)
Seat 5: Everbrun11 folded before Flop (didn't bet)
Seat 6: viniperri folded before Flop (didn't bet)

PokerStars Hand #251210070463: Tournament #3769361908, $52.38+$2.62 USD Hold'em No Limit - Level XXI (1800/3600) - 2024/06/26 23:08:52 UTC [2024/06/26 19:08:52 ET]
Table '3769361908 4' 6-max Seat #2 is the button
Seat 1: C0rpsbal (39868 in chips) 
Seat 2: Chuckster388 (50680 in chips) 
Seat 3: jerdno0 (60968 in chips) 
Seat 4: Lecher1991 (58956 in chips) 
Seat 5: Everbrun11 (75108 in chips) 
Seat 6: viniperri (85301 in chips) 
C0rpsbal: posts the ante 900
Chuckster388: posts the ante 900
jerdno0: posts the ante 900
Lecher1991: posts the ante 900
Everbrun11: posts the ante 900
viniperri: posts the ante 900
jerdno0: posts small blind 1800
Lecher1991: posts big blind 3600
*** HOLE CARDS ***
Everbrun11: folds 
viniperri: raises 3600 to 7200
C0rpsbal: folds 
Chuckster388: folds 
jerdno0: folds 
Lecher1991: folds 
Uncalled bet (3600) returned to viniperri
viniperri collected 14400 from pot
viniperri: doesn't show hand 
*** SUMMARY ***
Total pot 14400 | Rake 0 
Seat 1: C0rpsbal folded before Flop (didn't bet)
Seat 2: Chuckster388 (button) folded before Flop (didn't bet)
Seat 3: jerdno0 (small blind) folded before Flop
Seat 4: Lecher1991 (big blind) folded before Flop
Seat 5: Everbrun11 folded before Flop (didn't bet)
Seat 6: viniperri collected (14400)

PokerStars Hand #251210077169: Tournament #3769361908, $52.38+$2.62 USD Hold'em No Limit - Level XXI (1800/3600) - 2024/06/26 23:09:22 UTC [2024/06/26 19:09:22 ET]
Table '3769361908 4' 6-max Seat #3 is the button
Seat 1: C0rpsbal (38968 in chips) 
Seat 2: Chuckster388 (49780 in chips) 
Seat 3: jerdno0 (58268 in chips) 
Seat 4: Lecher1991 (54456 in chips) 
Seat 5: Everbrun11 (74208 in chips) 
Seat 6: viniperri (95201 in chips) 
C0rpsbal: posts the ante 900
Chuckster388: posts the ante 900
jerdno0: posts the ante 900
Lecher1991: posts the ante 900
Everbrun11: posts the ante 900
viniperri: posts the ante 900
Lecher1991: posts small blind 1800
Everbrun11: posts big blind 3600
*** HOLE CARDS ***
viniperri: folds 
C0rpsbal: folds 
Chuckster388: folds 
jerdno0: calls 3600
Lecher1991: calls 1800
Everbrun11: checks 
*** FLOP *** [2h 6d 3c]
Lecher1991: checks 
Everbrun11: bets 5346
jerdno0: folds 
Lecher1991: folds 
Uncalled bet (5346) returned to Everbrun11
Everbrun11 collected 16200 from pot
Everbrun11: doesn't show hand 
*** SUMMARY ***
Total pot 16200 | Rake 0 
Board [2h 6d 3c]
Seat 1: C0rpsbal folded before Flop (didn't bet)
Seat 2: Chuckster388 folded before Flop (didn't bet)
Seat 3: jerdno0 (button) folded on the Flop
Seat 4: Lecher1991 (small blind) folded on the Flop
Seat 5: Everbrun11 (big blind) collected (16200)
Seat 6: viniperri folded before Flop (didn't bet)

PokerStars Hand #251210090872: Tournament #3769361908, $52.38+$2.62 USD Hold'em No Limit - Level XXI (1800/3600) - 2024/06/26 23:10:24 UTC [2024/06/26 19:10:24 ET]
Table '3769361908 4' 6-max Seat #4 is the button
Seat 1: C0rpsbal (38068 in chips) 
Seat 2: Chuckster388 (48880 in chips) 
Seat 3: jerdno0 (53768 in chips) 
Seat 4: Lecher1991 (49956 in chips) 
Seat 5: Everbrun11 (85908 in chips) 
Seat 6: viniperri (94301 in chips) 
C0rpsbal: posts the ante 900
Chuckster388: posts the ante 900
jerdno0: posts the ante 900
Lecher1991: posts the ante 900
Everbrun11: posts the ante 900
viniperri: posts the ante 900
Everbrun11: posts small blind 1800
viniperri: posts big blind 3600
*** HOLE CARDS ***
C0rpsbal: folds 
Chuckster388: folds 
jerdno0: calls 3600
Lecher1991: folds 
Everbrun11: calls 1800
viniperri: checks 
*** FLOP *** [Qs 2h 6s]
Everbrun11: checks 
viniperri: checks 
jerdno0: bets 8100
Everbrun11: folds 
viniperri: folds 
Uncalled bet (8100) returned to jerdno0
jerdno0 collected 16200 from pot
*** SUMMARY ***
Total pot 16200 | Rake 0 
Board [Qs 2h 6s]
Seat 1: C0rpsbal folded before Flop (didn't bet)
Seat 2: Chuckster388 folded before Flop (didn't bet)
Seat 3: jerdno0 collected (16200)
Seat 4: Lecher1991 (button) folded before Flop (didn't bet)
Seat 5: Everbrun11 (small blind) folded on the Flop
Seat 6: viniperri (big blind) folded on the Flop

PokerStars Hand #251210105836: Tournament #3769361908, $52.38+$2.62 USD Hold'em No Limit - Level XXII (2000/4000) - 2024/06/26 23:11:32 UTC [2024/06/26 19:11:32 ET]
Table '3769361908 4' 6-max Seat #5 is the button
Seat 1: C0rpsbal (37168 in chips) 
Seat 2: Chuckster388 (47980 in chips) 
Seat 3: jerdno0 (65468 in chips) 
Seat 4: Lecher1991 (49056 in chips) 
Seat 5: Everbrun11 (81408 in chips) 
Seat 6: viniperri (89801 in chips) 
C0rpsbal: posts the ante 1000
Chuckster388: posts the ante 1000
jerdno0: posts the ante 1000
Lecher1991: posts the ante 1000
Everbrun11: posts the ante 1000
viniperri: posts the ante 1000
viniperri: posts small blind 2000
C0rpsbal: posts big blind 4000
*** HOLE CARDS ***
Chuckster388: folds 
jerdno0: folds 
Lecher1991: folds 
Everbrun11: folds 
viniperri: raises 84801 to 88801 and is all-in
C0rpsbal: folds 
Uncalled bet (84801) returned to viniperri
viniperri collected 14000 from pot
viniperri: doesn't show hand 
*** SUMMARY ***
Total pot 14000 | Rake 0 
Seat 1: C0rpsbal (big blind) folded before Flop
Seat 2: Chuckster388 folded before Flop (didn't bet)
Seat 3: jerdno0 folded before Flop (didn't bet)
Seat 4: Lecher1991 folded before Flop (didn't bet)
Seat 5: Everbrun11 (button) folded before Flop (didn't bet)
Seat 6: viniperri (small blind) collected (14000)

PokerStars Hand #251210113056: Tournament #3769361908, $52.38+$2.62 USD Hold'em No Limit - Level XXII (2000/4000) - 2024/06/26 23:12:06 UTC [2024/06/26 19:12:06 ET]
Table '3769361908 4' 6-max Seat #6 is the button
Seat 1: C0rpsbal (32168 in chips) 
Seat 2: Chuckster388 (46980 in chips) 
Seat 3: jerdno0 (64468 in chips) 
Seat 4: Lecher1991 (48056 in chips) 
Seat 5: Everbrun11 (80408 in chips) 
Seat 6: viniperri (98801 in chips) 
C0rpsbal: posts the ante 1000
Chuckster388: posts the ante 1000
jerdno0: posts the ante 1000
Lecher1991: posts the ante 1000
Everbrun11: posts the ante 1000
viniperri: posts the ante 1000
C0rpsbal: posts small blind 2000
Chuckster388: posts big blind 4000
*** HOLE CARDS ***
jerdno0: folds 
Lecher1991: folds 
Everbrun11: raises 4000 to 8000
viniperri: folds 
C0rpsbal: folds 
Chuckster388: calls 4000
*** FLOP *** [2c Kd 9s]
Chuckster388: checks 
Everbrun11: bets 6000
Chuckster388: calls 6000
*** TURN *** [2c Kd 9s] [5s]
Chuckster388: checks 
Everbrun11: bets 12000
Chuckster388: folds 
Uncalled bet (12000) returned to Everbrun11
Everbrun11 collected 36000 from pot
Everbrun11: doesn't show hand 
*** SUMMARY ***
Total pot 36000 | Rake 0 
Board [2c Kd 9s 5s]
Seat 1: C0rpsbal (small blind) folded before Flop
Seat 2: Chuckster388 (big blind) folded on the Turn
Seat 3: jerdno0 folded before Flop (didn't bet)
Seat 4: Lecher1991 folded before Flop (didn't bet)
Seat 5: Everbrun11 collected (36000)
Seat 6: viniperri (button) folded before Flop (didn't bet)

PokerStars Hand #251210129602: Tournament #3769361908, $52.38+$2.62 USD Hold'em No Limit - Level XXII (2000/4000) - 2024/06/26 23:13:22 UTC [2024/06/26 19:13:22 ET]
Table '3769361908 4' 6-max Seat #1 is the button
Seat 1: C0rpsbal (29168 in chips) 
Seat 2: Chuckster388 (31980 in chips) 
Seat 3: jerdno0 (63468 in chips) 
Seat 4: Lecher1991 (47056 in chips) 
Seat 5: Everbrun11 (101408 in chips) 
Seat 6: viniperri (97801 in chips) 
C0rpsbal: posts the ante 1000
Chuckster388: posts the ante 1000
jerdno0: posts the ante 1000
Lecher1991: posts the ante 1000
Everbrun11: posts the ante 1000
viniperri: posts the ante 1000
Chuckster388: posts small blind 2000
jerdno0: posts big blind 4000
*** HOLE CARDS ***
Lecher1991: folds 
Everbrun11: folds 
viniperri: raises 4000 to 8000
C0rpsbal: folds 
Chuckster388: raises 22980 to 30980 and is all-in
jerdno0: folds 
viniperri: calls 22980
*** FLOP *** [Jc 3h 8d]
*** TURN *** [Jc 3h 8d] [Tc]
*** RIVER *** [Jc 3h 8d Tc] [Ks]
*** SHOW DOWN ***
Chuckster388: shows [5c Ac] (high card Ace)
viniperri: shows [6h Ad] (high card Ace)
Chuckster388 collected 35980 from pot
viniperri collected 35980 from pot
*** SUMMARY ***
Total pot 71960 | Rake 0 
Board [Jc 3h 8d Tc Ks]
Seat 1: C0rpsbal (button) folded before Flop (didn't bet)
Seat 2: Chuckster388 (small blind) showed [5c Ac] and won (35980) with high card Ace
Seat 3: jerdno0 (big blind) folded before Flop
Seat 4: Lecher1991 folded before Flop (didn't bet)
Seat 5: Everbrun11 folded before Flop (didn't bet)
Seat 6: viniperri showed [6h Ad] and won (35980) with high card Ace

PokerStars Hand #251210139144: Tournament #3769361908, $52.38+$2.62 USD Hold'em No Limit - Level XXII (2000/4000) - 2024/06/26 23:14:07 UTC [2024/06/26 19:14:07 ET]
Table '3769361908 4' 6-max Seat #2 is the button
Seat 1: C0rpsbal (28168 in chips) 
Seat 2: Chuckster388 (35980 in chips) 
Seat 3: jerdno0 (58468 in chips) 
Seat 4: Lecher1991 (46056 in chips) 
Seat 5: Everbrun11 (100408 in chips) 
Seat 6: viniperri (101801 in chips) 
C0rpsbal: posts the ante 1000
Chuckster388: posts the ante 1000
jerdno0: posts the ante 1000
Lecher1991: posts the ante 1000
Everbrun11: posts the ante 1000
viniperri: posts the ante 1000
jerdno0: posts small blind 2000
Lecher1991: posts big blind 4000
*** HOLE CARDS ***
Everbrun11: folds 
viniperri: folds 
C0rpsbal: folds 
Chuckster388: folds 
jerdno0: folds 
Uncalled bet (2000) returned to Lecher1991
Lecher1991 collected 10000 from pot
*** SUMMARY ***
Total pot 10000 | Rake 0 
Seat 1: C0rpsbal folded before Flop (didn't bet)
Seat 2: Chuckster388 (button) folded before Flop (didn't bet)
Seat 3: jerdno0 (small blind) folded before Flop
Seat 4: Lecher1991 (big blind) collected (10000)
Seat 5: Everbrun11 folded before Flop (didn't bet)
Seat 6: viniperri folded before Flop (didn't bet)

PokerStars Hand #251210143376: Tournament #3769361908, $52.38+$2.62 USD Hold'em No Limit - Level XXIII (2500/5000) - 2024/06/26 23:14:26 UTC [2024/06/26 19:14:26 ET]
Table '3769361908 4' 6-max Seat #3 is the button
Seat 1: C0rpsbal (27168 in chips) 
Seat 2: Chuckster388 (34980 in chips) 
Seat 3: jerdno0 (55468 in chips) 
Seat 4: Lecher1991 (53056 in chips) 
Seat 5: Everbrun11 (99408 in chips) 
Seat 6: viniperri (100801 in chips) 
C0rpsbal: posts the ante 1250
Chuckster388: posts the ante 1250
jerdno0: posts the ante 1250
Lecher1991: posts the ante 1250
Everbrun11: posts the ante 1250
viniperri: posts the ante 1250
Lecher1991: posts small blind 2500
Everbrun11: posts big blind 5000
*** HOLE CARDS ***
viniperri: raises 5000 to 10000
C0rpsbal: folds 
Chuckster388: folds 
jerdno0: folds 
Lecher1991: folds 
Everbrun11: calls 5000
*** FLOP *** [Qs Jh Ks]
Everbrun11: checks 
viniperri: bets 7500
Everbrun11: calls 7500
*** TURN *** [Qs Jh Ks] [7d]
Everbrun11: checks 
viniperri: checks 
*** RIVER *** [Qs Jh Ks 7d] [4d]
Everbrun11: bets 15000
viniperri: calls 15000
*** SHOW DOWN ***
Everbrun11: shows [Ts Ah] (a straight, Ten to Ace)
viniperri: mucks hand 
Everbrun11 collected 75000 from pot
*** SUMMARY ***
Total pot 75000 | Rake 0 
Board [Qs Jh Ks 7d 4d]
Seat 1: C0rpsbal folded before Flop (didn't bet)
Seat 2: Chuckster388 folded before Flop (didn't bet)
Seat 3: jerdno0 (button) folded before Flop (didn't bet)
Seat 4: Lecher1991 (small blind) folded before Flop
Seat 5: Everbrun11 (big blind) showed [Ts Ah] and won (75000) with a straight, Ten to Ace
Seat 6: viniperri mucked

PokerStars Hand #251210158020: Tournament #3769361908, $52.38+$2.62 USD Hold'em No Limit - Level XXIII (2500/5000) - 2024/06/26 23:15:35 UTC [2024/06/26 19:15:35 ET]
Table '3769361908 4' 6-max Seat #4 is the button
Seat 1: C0rpsbal (25918 in chips) 
Seat 2: Chuckster388 (33730 in chips) 
Seat 3: jerdno0 (54218 in chips) 
Seat 4: Lecher1991 (49306 in chips) 
Seat 5: Everbrun11 (140658 in chips) 
Seat 6: viniperri (67051 in chips) 
C0rpsbal: posts the ante 1250
Chuckster388: posts the ante 1250
jerdno0: posts the ante 1250
Lecher1991: posts the ante 1250
Everbrun11: posts the ante 1250
viniperri: posts the ante 1250
Everbrun11: posts small blind 2500
viniperri: posts big blind 5000
*** HOLE CARDS ***
C0rpsbal: folds 
Chuckster388: raises 27480 to 32480 and is all-in
jerdno0: folds 
Lecher1991: folds 
Everbrun11: folds 
viniperri: calls 27480
*** FLOP *** [Qc 3c 3s]
*** TURN *** [Qc 3c 3s] [7s]
*** RIVER *** [Qc 3c 3s 7s] [9h]
*** SHOW DOWN ***
viniperri: shows [Ad 4h] (a pair of Threes)
Chuckster388: shows [2c 2s] (two pair, Threes and Deuces)
Chuckster388 collected 74960 from pot
*** SUMMARY ***
Total pot 74960 | Rake 0 
Board [Qc 3c 3s 7s 9h]
Seat 1: C0rpsbal folded before Flop (didn't bet)
Seat 2: Chuckster388 showed [2c 2s] and won (74960) with two pair, Threes and Deuces
Seat 3: jerdno0 folded before Flop (didn't bet)
Seat 4: Lecher1991 (button) folded before Flop (didn't bet)
Seat 5: Everbrun11 (small blind) folded before Flop
Seat 6: viniperri (big blind) showed [Ad 4h] and lost with a pair of Threes

PokerStars Hand #251210166273: Tournament #3769361908, $52.38+$2.62 USD Hold'em No Limit - Level XXIII (2500/5000) - 2024/06/26 23:16:13 UTC [2024/06/26 19:16:13 ET]
Table '3769361908 4' 6-max Seat #5 is the button
Seat 1: C0rpsbal (24668 in chips) 
Seat 2: Chuckster388 (74960 in chips) 
Seat 3: jerdno0 (52968 in chips) 
Seat 4: Lecher1991 (48056 in chips) 
Seat 5: Everbrun11 (136908 in chips) 
Seat 6: viniperri (33321 in chips) 
C0rpsbal: posts the ante 1250
Chuckster388: posts the ante 1250
jerdno0: posts the ante 1250
Lecher1991: posts the ante 1250
Everbrun11: posts the ante 1250
viniperri: posts the ante 1250
viniperri: posts small blind 2500
C0rpsbal: posts big blind 5000
*** HOLE CARDS ***
Chuckster388: folds 
jerdno0: folds 
Lecher1991: folds 
Everbrun11: raises 130658 to 135658 and is all-in
viniperri: folds 
C0rpsbal: folds 
Uncalled bet (130658) returned to Everbrun11
Everbrun11 collected 20000 from pot
Everbrun11: doesn't show hand 
*** SUMMARY ***
Total pot 20000 | Rake 0 
Seat 1: C0rpsbal (big blind) folded before Flop
Seat 2: Chuckster388 folded before Flop (didn't bet)
Seat 3: jerdno0 folded before Flop (didn't bet)
Seat 4: Lecher1991 folded before Flop (didn't bet)
Seat 5: Everbrun11 (button) collected (20000)
Seat 6: viniperri (small blind) folded before Flop

PokerStars Hand #251210173976: Tournament #3769361908, $52.38+$2.62 USD Hold'em No Limit - Level XXIII (2500/5000) - 2024/06/26 23:16:49 UTC [2024/06/26 19:16:49 ET]
Table '3769361908 4' 6-max Seat #6 is the button
Seat 1: C0rpsbal (18418 in chips) 
Seat 2: Chuckster388 (73710 in chips) 
Seat 3: jerdno0 (51718 in chips) 
Seat 4: Lecher1991 (46806 in chips) 
Seat 5: Everbrun11 (150658 in chips) 
Seat 6: viniperri (29571 in chips) 
C0rpsbal: posts the ante 1250
Chuckster388: posts the ante 1250
jerdno0: posts the ante 1250
Lecher1991: posts the ante 1250
Everbrun11: posts the ante 1250
viniperri: posts the ante 1250
C0rpsbal: posts small blind 2500
Chuckster388: posts big blind 5000
*** HOLE CARDS ***
jerdno0: folds 
Lecher1991: folds 
Everbrun11: folds 
viniperri: raises 23321 to 28321 and is all-in
C0rpsbal: calls 14668 and is all-in
Chuckster388: folds 
Uncalled bet (11153) returned to viniperri
*** FLOP *** [Ad Jd 2h]
*** TURN *** [Ad Jd 2h] [8h]
*** RIVER *** [Ad Jd 2h 8h] [3d]
*** SHOW DOWN ***
C0rpsbal: shows [Kc 9s] (high card Ace)
viniperri: shows [Qs 6d] (high card Ace - lower kicker)
C0rpsbal collected 46836 from pot
*** SUMMARY ***
Total pot 46836 | Rake 0 
Board [Ad Jd 2h 8h 3d]
Seat 1: C0rpsbal (small blind) showed [Kc 9s] and won (46836) with high card Ace
Seat 2: Chuckster388 (big blind) folded before Flop
Seat 3: jerdno0 folded before Flop (didn't bet)
Seat 4: Lecher1991 folded before Flop (didn't bet)
Seat 5: Everbrun11 folded before Flop (didn't bet)
Seat 6: viniperri (button) showed [Qs 6d] and lost with high card Ace

PokerStars Hand #251210181535: Tournament #3769361908, $52.38+$2.62 USD Hold'em No Limit - Level XXIV (3000/6000) - 2024/06/26 23:17:24 UTC [2024/06/26 19:17:24 ET]
Table '3769361908 4' 6-max Seat #1 is the button
Seat 1: C0rpsbal (46836 in chips) 
Seat 2: Chuckster388 (67460 in chips) 
Seat 3: jerdno0 (50468 in chips) 
Seat 4: Lecher1991 (45556 in chips) 
Seat 5: Everbrun11 (149408 in chips) 
Seat 6: viniperri (11153 in chips) 
C0rpsbal: posts the ante 1500
Chuckster388: posts the ante 1500
jerdno0: posts the ante 1500
Lecher1991: posts the ante 1500
Everbrun11: posts the ante 1500
viniperri: posts the ante 1500
Chuckster388: posts small blind 3000
jerdno0: posts big blind 6000
*** HOLE CARDS ***
Lecher1991: folds 
Everbrun11: folds 
viniperri: folds 
C0rpsbal: folds 
Chuckster388: calls 3000
jerdno0: checks 
*** FLOP *** [3d 4c 8c]
Chuckster388: bets 59960 and is all-in
jerdno0: folds 
Uncalled bet (59960) returned to Chuckster388
Chuckster388 collected 21000 from pot
Chuckster388: doesn't show hand 
*** SUMMARY ***
Total pot 21000 | Rake 0 
Board [3d 4c 8c]
Seat 1: C0rpsbal (button) folded before Flop (didn't bet)
Seat 2: Chuckster388 (small blind) collected (21000)
Seat 3: jerdno0 (big blind) folded on the Flop
Seat 4: Lecher1991 folded before Flop (didn't bet)
Seat 5: Everbrun11 folded before Flop (didn't bet)
Seat 6: viniperri folded before Flop (didn't bet)

PokerStars Hand #251210189440: Tournament #3769361908, $52.38+$2.62 USD Hold'em No Limit - Level XXIV (3000/6000) - 2024/06/26 23:18:02 UTC [2024/06/26 19:18:02 ET]
Table '3769361908 4' 6-max Seat #2 is the button
Seat 1: C0rpsbal (45336 in chips) 
Seat 2: Chuckster388 (80960 in chips) 
Seat 3: jerdno0 (42968 in chips) 
Seat 4: Lecher1991 (44056 in chips) 
Seat 5: Everbrun11 (147908 in chips) 
Seat 6: viniperri (9653 in chips) 
C0rpsbal: posts the ante 1500
Chuckster388: posts the ante 1500
jerdno0: posts the ante 1500
Lecher1991: posts the ante 1500
Everbrun11: posts the ante 1500
viniperri: posts the ante 1500
jerdno0: posts small blind 3000
Lecher1991: posts big blind 6000
*** HOLE CARDS ***
Everbrun11: folds 
viniperri: folds 
C0rpsbal: folds 
Chuckster388: folds 
jerdno0: calls 3000
Lecher1991: raises 36556 to 42556 and is all-in
jerdno0: calls 35468 and is all-in
Uncalled bet (1088) returned to Lecher1991
*** FLOP *** [5d Jd 9h]
*** TURN *** [5d Jd 9h] [4c]
*** RIVER *** [5d Jd 9h 4c] [Qh]
*** SHOW DOWN ***
jerdno0: shows [Kc Js] (a pair of Jacks)
Lecher1991: shows [7d 8c] (high card Queen)
jerdno0 collected 91936 from pot
*** SUMMARY ***
Total pot 91936 | Rake 0 
Board [5d Jd 9h 4c Qh]
Seat 1: C0rpsbal folded before Flop (didn't bet)
Seat 2: Chuckster388 (button) folded before Flop (didn't bet)
Seat 3: jerdno0 (small blind) showed [Kc Js] and won (91936) with a pair of Jacks
Seat 4: Lecher1991 (big blind) showed [7d 8c] and lost with high card Queen
Seat 5: Everbrun11 folded before Flop (didn't bet)
Seat 6: viniperri folded before Flop (didn't bet)

PokerStars Hand #251210198526: Tournament #3769361908, $52.38+$2.62 USD Hold'em No Limit - Level XXIV (3000/6000) - 2024/06/26 23:18:45 UTC [2024/06/26 19:18:45 ET]
Table '3769361908 4' 6-max Seat #3 is the button
Seat 1: C0rpsbal (43836 in chips) 
Seat 2: Chuckster388 (79460 in chips) 
Seat 3: jerdno0 (91936 in chips) 
Seat 4: Lecher1991 (1088 in chips) 
Seat 5: Everbrun11 (146408 in chips) 
Seat 6: viniperri (8153 in chips) 
C0rpsbal: posts the ante 1500
Chuckster388: posts the ante 1500
jerdno0: posts the ante 1500
Lecher1991: posts the ante 1088 and is all-in
Everbrun11: posts the ante 1500
viniperri: posts the ante 1500
Everbrun11: posts big blind 6000
*** HOLE CARDS ***
viniperri: raises 653 to 6653 and is all-in
C0rpsbal: folds 
Chuckster388: folds 
jerdno0: folds 
Everbrun11: calls 653
*** FLOP *** [Kc 8d Jh]
*** TURN *** [Kc 8d Jh] [Qd]
*** RIVER *** [Kc 8d Jh Qd] [Ac]
*** SHOW DOWN ***
Everbrun11: shows [7s Th] (a straight, Ten to Ace)
viniperri: shows [5s Kh] (a pair of Kings)
Everbrun11 collected 15366 from side pot
Lecher1991: shows [9h 3s] (high card Ace)
Everbrun11 collected 6528 from main pot
viniperri finished the tournament in 38th place and received $111.65.
Lecher1991 finished the tournament in 39th place and received $111.65.
*** SUMMARY ***
Total pot 21894 Main pot 6528. Side pot 15366. | Rake 0 
Board [Kc 8d Jh Qd Ac]
Seat 1: C0rpsbal folded before Flop (didn't bet)
Seat 2: Chuckster388 folded before Flop (didn't bet)
Seat 3: jerdno0 (button) folded before Flop (didn't bet)
Seat 4: Lecher1991 showed [9h 3s] and lost with high card Ace
Seat 5: Everbrun11 (big blind) showed [7s Th] and won (21894) with a straight, Ten to Ace
Seat 6: viniperri showed [5s Kh] and lost with a pair of Kings

PokerStars Hand #251210203595: Tournament #3769361908, $52.38+$2.62 USD Hold'em No Limit - Level XXIV (3000/6000) - 2024/06/26 23:19:09 UTC [2024/06/26 19:19:09 ET]
Table '3769361908 4' 6-max Seat #5 is the button
Seat 1: C0rpsbal (42336 in chips) 
Seat 2: Chuckster388 (77960 in chips) 
Seat 3: jerdno0 (90436 in chips) 
Seat 5: Everbrun11 (160149 in chips) 
C0rpsbal: posts the ante 1500
Chuckster388: posts the ante 1500
jerdno0: posts the ante 1500
Everbrun11: posts the ante 1500
C0rpsbal: posts small blind 3000
Chuckster388: posts big blind 6000
*** HOLE CARDS ***
jerdno0: calls 6000
Everbrun11: folds 
C0rpsbal: folds 
Chuckster388: checks 
*** FLOP *** [3d 7s Ah]
Pseudo Fruto is disconnected 
Acai Brend is disconnected 
Chuckster388: checks 
jerdno0: bets 10500
Chuckster388: folds 
Uncalled bet (10500) returned to jerdno0
jerdno0 collected 21000 from pot
*** SUMMARY ***
Total pot 21000 | Rake 0 
Board [3d 7s Ah]
Seat 1: C0rpsbal (small blind) folded before Flop
Seat 2: Chuckster388 (big blind) folded on the Flop
Seat 3: jerdno0 collected (21000)
Seat 5: Everbrun11 (button) folded before Flop (didn't bet)

PokerStars Hand #251210210677: Tournament #3769361908, $52.38+$2.62 USD Hold'em No Limit - Level XXIV (3000/6000) - 2024/06/26 23:19:43 UTC [2024/06/26 19:19:43 ET]
Table '3769361908 4' 6-max Seat #1 is the button
Seat 1: C0rpsbal (37836 in chips) 
Seat 2: Chuckster388 (70460 in chips) 
Seat 3: jerdno0 (103936 in chips) 
Seat 4: Pseudo Fruto (106930 in chips) 
Seat 5: Everbrun11 (158649 in chips) 
Seat 6: Acai Brend (29566 in chips) 
C0rpsbal: posts the ante 1500
Chuckster388: posts the ante 1500
jerdno0: posts the ante 1500
Pseudo Fruto: posts the ante 1500
Everbrun11: posts the ante 1500
Acai Brend: posts the ante 1500
Chuckster388: posts small blind 3000
jerdno0: posts big blind 6000
*** HOLE CARDS ***
Pseudo Fruto: folds 
Everbrun11: folds 
Acai Brend: raises 22066 to 28066 and is all-in
C0rpsbal: raises 8270 to 36336 and is all-in
Chuckster388: folds 
jerdno0: folds 
Uncalled bet (8270) returned to C0rpsbal
*** FLOP *** [5h 6s 3h]
*** TURN *** [5h 6s 3h] [Jd]
*** RIVER *** [5h 6s 3h Jd] [6c]
*** SHOW DOWN ***
Acai Brend: shows [Th Kh] (a pair of Sixes)
C0rpsbal: shows [7d As] (a pair of Sixes - Ace kicker)
C0rpsbal collected 74132 from pot
Acai Brend finished the tournament in 34th place and received $111.65.
*** SUMMARY ***
Total pot 74132 | Rake 0 
Board [5h 6s 3h Jd 6c]
Seat 1: C0rpsbal (button) showed [7d As] and won (74132) with a pair of Sixes
Seat 2: Chuckster388 (small blind) folded before Flop
Seat 3: jerdno0 (big blind) folded before Flop
Seat 4: Pseudo Fruto folded before Flop (didn't bet)
Seat 5: Everbrun11 folded before Flop (didn't bet)
Seat 6: Acai Brend showed [Th Kh] and lost with a pair of Sixes

PokerStars Hand #251210220025: Tournament #3769361908, $52.38+$2.62 USD Hold'em No Limit - Level XXV (3500/7000) - 2024/06/26 23:20:28 UTC [2024/06/26 19:20:28 ET]
Table '3769361908 4' 6-max Seat #2 is the button
Seat 1: C0rpsbal (82402 in chips) 
Seat 2: Chuckster388 (65960 in chips) 
Seat 3: jerdno0 (96436 in chips) 
Seat 4: Pseudo Fruto (105430 in chips) 
Seat 5: Everbrun11 (157149 in chips) 
C0rpsbal: posts the ante 1750
Chuckster388: posts the ante 1750
jerdno0: posts the ante 1750
Pseudo Fruto: posts the ante 1750
Everbrun11: posts the ante 1750
jerdno0: posts small blind 3500
Pseudo Fruto: posts big blind 7000
*** HOLE CARDS ***
Everbrun11: folds 
C0rpsbal: folds 
Chuckster388: folds 
jerdno0: calls 3500
Pseudo Fruto: checks 
*** FLOP *** [Ah Ad 9h]
jerdno0: bets 7000
Pseudo Fruto: folds 
Uncalled bet (7000) returned to jerdno0
jerdno0 collected 22750 from pot
*** SUMMARY ***
Total pot 22750 | Rake 0 
Board [Ah Ad 9h]
Seat 1: C0rpsbal folded before Flop (didn't bet)
Seat 2: Chuckster388 (button) folded before Flop (didn't bet)
Seat 3: jerdno0 (small blind) collected (22750)
Seat 4: Pseudo Fruto (big blind) folded on the Flop
Seat 5: Everbrun11 folded before Flop (didn't bet)

PokerStars Hand #251210231895: Tournament #3769361908, $52.38+$2.62 USD Hold'em No Limit - Level XXV (3500/7000) - 2024/06/26 23:21:25 UTC [2024/06/26 19:21:25 ET]
Table '3769361908 4' 6-max Seat #3 is the button
Seat 1: C0rpsbal (80652 in chips) 
Seat 2: Chuckster388 (64210 in chips) 
Seat 3: jerdno0 (110436 in chips) 
Seat 4: Pseudo Fruto (96680 in chips) 
Seat 5: Everbrun11 (155399 in chips) 
Seat 6: VxVendetta00 (146970 in chips) 
C0rpsbal: posts the ante 1750
Chuckster388: posts the ante 1750
jerdno0: posts the ante 1750
Pseudo Fruto: posts the ante 1750
Everbrun11: posts the ante 1750
VxVendetta00: posts the ante 1750
Pseudo Fruto: posts small blind 3500
Everbrun11: posts big blind 7000
*** HOLE CARDS ***
VxVendetta00: folds 
C0rpsbal: folds 
Chuckster388: folds 
jerdno0: calls 7000
Pseudo Fruto: folds 
Everbrun11: checks 
*** FLOP *** [9s 5d 6c]
Everbrun11: checks 
jerdno0: bets 7000
Everbrun11: calls 7000
*** TURN *** [9s 5d 6c] [Kc]
Everbrun11: checks 
jerdno0: checks 
*** RIVER *** [9s 5d 6c Kc] [Qd]
Everbrun11: bets 13860
jerdno0: folds 
Uncalled bet (13860) returned to Everbrun11
Everbrun11 collected 42000 from pot
Everbrun11: doesn't show hand 
*** SUMMARY ***
Total pot 42000 | Rake 0 
Board [9s 5d 6c Kc Qd]
Seat 1: C0rpsbal folded before Flop (didn't bet)
Seat 2: Chuckster388 folded before Flop (didn't bet)
Seat 3: jerdno0 (button) folded on the River
Seat 4: Pseudo Fruto (small blind) folded before Flop
Seat 5: Everbrun11 (big blind) collected (42000)
Seat 6: VxVendetta00 folded before Flop (didn't bet)

PokerStars Hand #251210244527: Tournament #3769361908, $52.38+$2.62 USD Hold'em No Limit - Level XXV (3500/7000) - 2024/06/26 23:22:26 UTC [2024/06/26 19:22:26 ET]
Table '3769361908 4' 6-max Seat #4 is the button
Seat 1: C0rpsbal (78902 in chips) 
Seat 2: Chuckster388 (62460 in chips) 
Seat 3: jerdno0 (94686 in chips) 
Seat 4: Pseudo Fruto (91430 in chips) 
Seat 5: Everbrun11 (181649 in chips) 
Seat 6: VxVendetta00 (145220 in chips) 
C0rpsbal: posts the ante 1750
Chuckster388: posts the ante 1750
jerdno0: posts the ante 1750
Pseudo Fruto: posts the ante 1750
Everbrun11: posts the ante 1750
VxVendetta00: posts the ante 1750
Everbrun11: posts small blind 3500
VxVendetta00: posts big blind 7000
*** HOLE CARDS ***
C0rpsbal: folds 
Chuckster388: folds 
jerdno0: folds 
Pseudo Fruto: folds 
Everbrun11: raises 17500 to 24500
VxVendetta00: folds 
Uncalled bet (17500) returned to Everbrun11
Everbrun11 collected 24500 from pot
Everbrun11: doesn't show hand 
*** SUMMARY ***
Total pot 24500 | Rake 0 
Seat 1: C0rpsbal folded before Flop (didn't bet)
Seat 2: Chuckster388 folded before Flop (didn't bet)
Seat 3: jerdno0 folded before Flop (didn't bet)
Seat 4: Pseudo Fruto (button) folded before Flop (didn't bet)
Seat 5: Everbrun11 (small blind) collected (24500)
Seat 6: VxVendetta00 (big blind) folded before Flop

PokerStars Hand #251210250600: Tournament #3769361908, $52.38+$2.62 USD Hold'em No Limit - Level XXV (3500/7000) - 2024/06/26 23:22:55 UTC [2024/06/26 19:22:55 ET]
Table '3769361908 4' 6-max Seat #5 is the button
Seat 1: C0rpsbal (77152 in chips) 
Seat 2: Chuckster388 (60710 in chips) 
Seat 4: Pseudo Fruto (89680 in chips) 
Seat 5: Everbrun11 (197399 in chips) 
Seat 6: VxVendetta00 (136470 in chips) 
C0rpsbal: posts the ante 1750
Chuckster388: posts the ante 1750
Pseudo Fruto: posts the ante 1750
Everbrun11: posts the ante 1750
VxVendetta00: posts the ante 1750
VxVendetta00: posts small blind 3500
C0rpsbal: posts big blind 7000
*** HOLE CARDS ***
Chuckster388: folds 
Pseudo Fruto: raises 80930 to 87930 and is all-in
Everbrun11: folds 
VxVendetta00: folds 
C0rpsbal: folds 
Uncalled bet (80930) returned to Pseudo Fruto
Pseudo Fruto collected 26250 from pot
Pseudo Fruto: doesn't show hand 
*** SUMMARY ***
Total pot 26250 | Rake 0 
Seat 1: C0rpsbal (big blind) folded before Flop
Seat 2: Chuckster388 folded before Flop (didn't bet)
Seat 4: Pseudo Fruto collected (26250)
Seat 5: Everbrun11 (button) folded before Flop (didn't bet)
Seat 6: VxVendetta00 (small blind) folded before Flop

PokerStars Hand #251210254434: Tournament #3769361908, $52.38+$2.62 USD Hold'em No Limit - Level XXV (3500/7000) - 2024/06/26 23:23:14 UTC [2024/06/26 19:23:14 ET]
Table '3769361908 4' 6-max Seat #6 is the button
Seat 1: C0rpsbal (68402 in chips) 
Seat 2: Chuckster388 (58960 in chips) 
Seat 4: Pseudo Fruto (107180 in chips) 
Seat 5: Everbrun11 (195649 in chips) 
Seat 6: VxVendetta00 (131220 in chips) 
C0rpsbal: posts the ante 1750
Chuckster388: posts the ante 1750
Pseudo Fruto: posts the ante 1750
Everbrun11: posts the ante 1750
VxVendetta00: posts the ante 1750
C0rpsbal: posts small blind 3500
Chuckster388: posts big blind 7000
*** HOLE CARDS ***
Pseudo Fruto: folds 
Everbrun11: raises 7000 to 14000
VxVendetta00: folds 
C0rpsbal: folds 
Chuckster388: folds 
Uncalled bet (7000) returned to Everbrun11
Everbrun11 collected 26250 from pot
Everbrun11: doesn't show hand 
*** SUMMARY ***
Total pot 26250 | Rake 0 
Seat 1: C0rpsbal (small blind) folded before Flop
Seat 2: Chuckster388 (big blind) folded before Flop
Seat 4: Pseudo Fruto folded before Flop (didn't bet)
Seat 5: Everbrun11 collected (26250)
Seat 6: VxVendetta00 (button) folded before Flop (didn't bet)

PokerStars Hand #251210261229: Tournament #3769361908, $52.38+$2.62 USD Hold'em No Limit - Level XXVI (4000/8000) - 2024/06/26 23:23:47 UTC [2024/06/26 19:23:47 ET]
Table '3769361908 4' 6-max Seat #1 is the button
Seat 1: C0rpsbal (63152 in chips) 
Seat 2: Chuckster388 (50210 in chips) 
Seat 4: Pseudo Fruto (105430 in chips) 
Seat 5: Everbrun11 (213149 in chips) 
Seat 6: VxVendetta00 (129470 in chips) 
C0rpsbal: posts the ante 2000
Chuckster388: posts the ante 2000
Pseudo Fruto: posts the ante 2000
Everbrun11: posts the ante 2000
VxVendetta00: posts the ante 2000
Chuckster388: posts small blind 4000
Pseudo Fruto: posts big blind 8000
*** HOLE CARDS ***
Everbrun11: raises 8000 to 16000
VxVendetta00: folds 
C0rpsbal: folds 
Chuckster388: folds 
Pseudo Fruto: folds 
Uncalled bet (8000) returned to Everbrun11
Everbrun11 collected 30000 from pot
Everbrun11: doesn't show hand 
*** SUMMARY ***
Total pot 30000 | Rake 0 
Seat 1: C0rpsbal (button) folded before Flop (didn't bet)
Seat 2: Chuckster388 (small blind) folded before Flop
Seat 4: Pseudo Fruto (big blind) folded before Flop
Seat 5: Everbrun11 collected (30000)
Seat 6: VxVendetta00 folded before Flop (didn't bet)

PokerStars Hand #251210265582: Tournament #3769361908, $52.38+$2.62 USD Hold'em No Limit - Level XXVI (4000/8000) - 2024/06/26 23:24:08 UTC [2024/06/26 19:24:08 ET]
Table '3769361908 4' 6-max Seat #2 is the button
Seat 1: C0rpsbal (61152 in chips) 
Seat 2: Chuckster388 (44210 in chips) 
Seat 4: Pseudo Fruto (95430 in chips) 
Seat 5: Everbrun11 (233149 in chips) 
Seat 6: VxVendetta00 (127470 in chips) 
C0rpsbal: posts the ante 2000
Chuckster388: posts the ante 2000
Pseudo Fruto: posts the ante 2000
Everbrun11: posts the ante 2000
VxVendetta00: posts the ante 2000
Pseudo Fruto: posts small blind 4000
Everbrun11: posts big blind 8000
*** HOLE CARDS ***
VxVendetta00: folds 
C0rpsbal: folds 
Chuckster388: folds 
Pseudo Fruto: calls 4000
Everbrun11: checks 
*** FLOP *** [Kh 9s 4h]
Pseudo Fruto: bets 8000
Everbrun11: folds 
Uncalled bet (8000) returned to Pseudo Fruto
Pseudo Fruto collected 26000 from pot
Pseudo Fruto: doesn't show hand 
*** SUMMARY ***
Total pot 26000 | Rake 0 
Board [Kh 9s 4h]
Seat 1: C0rpsbal folded before Flop (didn't bet)
Seat 2: Chuckster388 (button) folded before Flop (didn't bet)
Seat 4: Pseudo Fruto (small blind) collected (26000)
Seat 5: Everbrun11 (big blind) folded on the Flop
Seat 6: VxVendetta00 folded before Flop (didn't bet)

PokerStars Hand #251210269356: Tournament #3769361908, $52.38+$2.62 USD Hold'em No Limit - Level XXVI (4000/8000) - 2024/06/26 23:24:26 UTC [2024/06/26 19:24:26 ET]
Table '3769361908 4' 6-max Seat #4 is the button
Seat 1: C0rpsbal (59152 in chips) 
Seat 2: Chuckster388 (42210 in chips) 
Seat 4: Pseudo Fruto (111430 in chips) 
Seat 5: Everbrun11 (223149 in chips) 
Seat 6: VxVendetta00 (125470 in chips) 
C0rpsbal: posts the ante 2000
Chuckster388: posts the ante 2000
Pseudo Fruto: posts the ante 2000
Everbrun11: posts the ante 2000
VxVendetta00: posts the ante 2000
Everbrun11: posts small blind 4000
VxVendetta00: posts big blind 8000
*** HOLE CARDS ***
C0rpsbal: folds 
Chuckster388: folds 
Pseudo Fruto: folds 
Everbrun11: raises 16000 to 24000
VxVendetta00: folds 
Uncalled bet (16000) returned to Everbrun11
Everbrun11 collected 26000 from pot
Everbrun11: doesn't show hand 
*** SUMMARY ***
Total pot 26000 | Rake 0 
Seat 1: C0rpsbal folded before Flop (didn't bet)
Seat 2: Chuckster388 folded before Flop (didn't bet)
Seat 4: Pseudo Fruto (button) folded before Flop (didn't bet)
Seat 5: Everbrun11 (small blind) collected (26000)
Seat 6: VxVendetta00 (big blind) folded before Flop

PokerStars Hand #251210275101: Tournament #3769361908, $52.38+$2.62 USD Hold'em No Limit - Level XXVI (4000/8000) - 2024/06/26 23:24:54 UTC [2024/06/26 19:24:54 ET]
Table '3769361908 4' 6-max Seat #5 is the button
Seat 1: C0rpsbal (57152 in chips) 
Seat 2: Chuckster388 (40210 in chips) 
Seat 4: Pseudo Fruto (109430 in chips) 
Seat 5: Everbrun11 (239149 in chips) 
Seat 6: VxVendetta00 (115470 in chips) 
C0rpsbal: posts the ante 2000
Chuckster388: posts the ante 2000
Pseudo Fruto: posts the ante 2000
Everbrun11: posts the ante 2000
VxVendetta00: posts the ante 2000
VxVendetta00: posts small blind 4000
C0rpsbal: posts big blind 8000
*** HOLE CARDS ***
Chuckster388: folds 
Pseudo Fruto: folds 
Everbrun11: folds 
VxVendetta00: folds 
Uncalled bet (4000) returned to C0rpsbal
C0rpsbal collected 18000 from pot
C0rpsbal: doesn't show hand 
*** SUMMARY ***
Total pot 18000 | Rake 0 
Seat 1: C0rpsbal (big blind) collected (18000)
Seat 2: Chuckster388 folded before Flop (didn't bet)
Seat 4: Pseudo Fruto folded before Flop (didn't bet)
Seat 5: Everbrun11 (button) folded before Flop (didn't bet)
Seat 6: VxVendetta00 (small blind) folded before Flop

PokerStars Hand #251210278059: Tournament #3769361908, $52.38+$2.62 USD Hold'em No Limit - Level XXVI (4000/8000) - 2024/06/26 23:25:09 UTC [2024/06/26 19:25:09 ET]
Table '3769361908 4' 6-max Seat #6 is the button
Seat 1: C0rpsbal (69152 in chips) 
Seat 2: Chuckster388 (38210 in chips) 
Seat 4: Pseudo Fruto (107430 in chips) 
Seat 5: Everbrun11 (237149 in chips) 
Seat 6: VxVendetta00 (109470 in chips) 
C0rpsbal: posts the ante 2000
Chuckster388: posts the ante 2000
Pseudo Fruto: posts the ante 2000
Everbrun11: posts the ante 2000
VxVendetta00: posts the ante 2000
C0rpsbal: posts small blind 4000
Chuckster388: posts big blind 8000
*** HOLE CARDS ***
Pseudo Fruto: folds 
Everbrun11: folds 
VxVendetta00: folds 
C0rpsbal: folds 
Uncalled bet (4000) returned to Chuckster388
Chuckster388 collected 18000 from pot
Chuckster388: doesn't show hand 
*** SUMMARY ***
Total pot 18000 | Rake 0 
Seat 1: C0rpsbal (small blind) folded before Flop
Seat 2: Chuckster388 (big blind) collected (18000)
Seat 4: Pseudo Fruto folded before Flop (didn't bet)
Seat 5: Everbrun11 folded before Flop (didn't bet)
Seat 6: VxVendetta00 (button) folded before Flop (didn't bet)

PokerStars Hand #251210281026: Tournament #3769361908, $52.38+$2.62 USD Hold'em No Limit - Level XXVI (4000/8000) - 2024/06/26 23:25:23 UTC [2024/06/26 19:25:23 ET]
Table '3769361908 4' 6-max Seat #1 is the button
Seat 1: C0rpsbal (63152 in chips) 
Seat 2: Chuckster388 (50210 in chips) 
Seat 4: Pseudo Fruto (105430 in chips) 
Seat 5: Everbrun11 (235149 in chips) 
Seat 6: VxVendetta00 (107470 in chips) 
C0rpsbal: posts the ante 2000
Chuckster388: posts the ante 2000
Pseudo Fruto: posts the ante 2000
Everbrun11: posts the ante 2000
VxVendetta00: posts the ante 2000
Chuckster388: posts small blind 4000
Pseudo Fruto: posts big blind 8000
*** HOLE CARDS ***
Everbrun11: folds 
VxVendetta00: folds 
C0rpsbal: folds 
Chuckster388: raises 40210 to 48210 and is all-in
Pseudo Fruto: calls 40210
*** FLOP *** [8s 7c Js]
*** TURN *** [8s 7c Js] [Qc]
*** RIVER *** [8s 7c Js Qc] [9s]
*** SHOW DOWN ***
Chuckster388: shows [5d Th] (a straight, Eight to Queen)
Pseudo Fruto: shows [Ks 3h] (high card King)
Chuckster388 collected 106420 from pot
*** SUMMARY ***
Total pot 106420 | Rake 0 
Board [8s 7c Js Qc 9s]
Seat 1: C0rpsbal (button) folded before Flop (didn't bet)
Seat 2: Chuckster388 (small blind) showed [5d Th] and won (106420) with a straight, Eight to Queen
Seat 4: Pseudo Fruto (big blind) showed [Ks 3h] and lost with high card King
Seat 5: Everbrun11 folded before Flop (didn't bet)
Seat 6: VxVendetta00 folded before Flop (didn't bet)

PokerStars Hand #251210285946: Tournament #3769361908, $52.38+$2.62 USD Hold'em No Limit - Level XXVI (4000/8000) - 2024/06/26 23:25:47 UTC [2024/06/26 19:25:47 ET]
Table '3769361908 4' 6-max Seat #2 is the button
Seat 1: C0rpsbal (61152 in chips) 
Seat 2: Chuckster388 (106420 in chips) 
Seat 4: Pseudo Fruto (55220 in chips) 
Seat 5: Everbrun11 (233149 in chips) 
Seat 6: VxVendetta00 (105470 in chips) 
C0rpsbal: posts the ante 2000
Chuckster388: posts the ante 2000
Pseudo Fruto: posts the ante 2000
Everbrun11: posts the ante 2000
VxVendetta00: posts the ante 2000
Pseudo Fruto: posts small blind 4000
Everbrun11: posts big blind 8000
*** HOLE CARDS ***
VxVendetta00: folds 
C0rpsbal: raises 8000 to 16000
Chuckster388: folds 
Pseudo Fruto: folds 
Everbrun11: calls 8000
*** FLOP *** [3h Qc 5h]
Everbrun11: checks 
C0rpsbal: bets 8000
Everbrun11: folds 
Uncalled bet (8000) returned to C0rpsbal
C0rpsbal collected 46000 from pot
C0rpsbal: doesn't show hand 
*** SUMMARY ***
Total pot 46000 | Rake 0 
Board [3h Qc 5h]
Seat 1: C0rpsbal collected (46000)
Seat 2: Chuckster388 (button) folded before Flop (didn't bet)
Seat 4: Pseudo Fruto (small blind) folded before Flop
Seat 5: Everbrun11 (big blind) folded on the Flop
Seat 6: VxVendetta00 folded before Flop (didn't bet)

PokerStars Hand #251210294016: Tournament #3769361908, $52.38+$2.62 USD Hold'em No Limit - Level XXVII (4500/9000) - 2024/06/26 23:26:27 UTC [2024/06/26 19:26:27 ET]
Table '3769361908 4' 6-max Seat #4 is the button
Seat 1: C0rpsbal (89152 in chips) 
Seat 2: Chuckster388 (104420 in chips) 
Seat 4: Pseudo Fruto (49220 in chips) 
Seat 5: Everbrun11 (215149 in chips) 
Seat 6: VxVendetta00 (103470 in chips) 
C0rpsbal: posts the ante 2250
Chuckster388: posts the ante 2250
Pseudo Fruto: posts the ante 2250
Everbrun11: posts the ante 2250
VxVendetta00: posts the ante 2250
Everbrun11: posts small blind 4500
VxVendetta00: posts big blind 9000
*** HOLE CARDS ***
C0rpsbal: raises 77902 to 86902 and is all-in
Chuckster388: folds 
Pseudo Fruto: folds 
Everbrun11: folds 
VxVendetta00: folds 
Uncalled bet (77902) returned to C0rpsbal
C0rpsbal collected 33750 from pot
C0rpsbal: doesn't show hand 
*** SUMMARY ***
Total pot 33750 | Rake 0 
Seat 1: C0rpsbal collected (33750)
Seat 2: Chuckster388 folded before Flop (didn't bet)
Seat 4: Pseudo Fruto (button) folded before Flop (didn't bet)
Seat 5: Everbrun11 (small blind) folded before Flop
Seat 6: VxVendetta00 (big blind) folded before Flop

PokerStars Hand #251210298383: Tournament #3769361908, $52.38+$2.62 USD Hold'em No Limit - Level XXVII (4500/9000) - 2024/06/26 23:26:48 UTC [2024/06/26 19:26:48 ET]
Table '3769361908 4' 6-max Seat #5 is the button
Seat 1: C0rpsbal (111652 in chips) 
Seat 2: Chuckster388 (102170 in chips) 
Seat 4: Pseudo Fruto (46970 in chips) 
Seat 5: Everbrun11 (208399 in chips) 
Seat 6: VxVendetta00 (92220 in chips) 
C0rpsbal: posts the ante 2250
Chuckster388: posts the ante 2250
Pseudo Fruto: posts the ante 2250
Everbrun11: posts the ante 2250
VxVendetta00: posts the ante 2250
VxVendetta00: posts small blind 4500
C0rpsbal: posts big blind 9000
*** HOLE CARDS ***
Chuckster388: folds 
Pseudo Fruto: folds 
Everbrun11: raises 197149 to 206149 and is all-in
VxVendetta00: folds 
C0rpsbal: folds 
Uncalled bet (197149) returned to Everbrun11
Everbrun11 collected 33750 from pot
Everbrun11: doesn't show hand 
*** SUMMARY ***
Total pot 33750 | Rake 0 
Seat 1: C0rpsbal (big blind) folded before Flop
Seat 2: Chuckster388 folded before Flop (didn't bet)
Seat 4: Pseudo Fruto folded before Flop (didn't bet)
Seat 5: Everbrun11 (button) collected (33750)
Seat 6: VxVendetta00 (small blind) folded before Flop

PokerStars Hand #251210302507: Tournament #3769361908, $52.38+$2.62 USD Hold'em No Limit - Level XXVII (4500/9000) - 2024/06/26 23:27:09 UTC [2024/06/26 19:27:09 ET]
Table '3769361908 4' 6-max Seat #6 is the button
Seat 1: C0rpsbal (100402 in chips) 
Seat 2: Chuckster388 (99920 in chips) 
Seat 4: Pseudo Fruto (44720 in chips) 
Seat 5: Everbrun11 (230899 in chips) 
Seat 6: VxVendetta00 (85470 in chips) 
C0rpsbal: posts the ante 2250
Chuckster388: posts the ante 2250
Pseudo Fruto: posts the ante 2250
Everbrun11: posts the ante 2250
VxVendetta00: posts the ante 2250
C0rpsbal: posts small blind 4500
Chuckster388: posts big blind 9000
*** HOLE CARDS ***
Pseudo Fruto: raises 33470 to 42470 and is all-in
Everbrun11: folds 
VxVendetta00: folds 
C0rpsbal: raises 55682 to 98152 and is all-in
Chuckster388: folds 
Uncalled bet (55682) returned to C0rpsbal
*** FLOP *** [9c 5s Td]
*** TURN *** [9c 5s Td] [3h]
*** RIVER *** [9c 5s Td 3h] [4h]
*** SHOW DOWN ***
C0rpsbal: shows [Ah Ad] (a pair of Aces)
Pseudo Fruto: shows [Kc 7c] (high card King)
C0rpsbal collected 105190 from pot
Pseudo Fruto finished the tournament in 26th place and received $135.63.
MjLK MAN is disconnected 
aapetrone91 is disconnected 
*** SUMMARY ***
Total pot 105190 | Rake 0 
Board [9c 5s Td 3h 4h]
Seat 1: C0rpsbal (small blind) showed [Ah Ad] and won (105190) with a pair of Aces
Seat 2: Chuckster388 (big blind) folded before Flop
Seat 4: Pseudo Fruto showed [Kc 7c] and lost with high card King
Seat 5: Everbrun11 folded before Flop (didn't bet)
Seat 6: VxVendetta00 (button) folded before Flop (didn't bet)

PokerStars Hand #251210311580: Tournament #3769361908, $52.38+$2.62 USD Hold'em No Limit - Level XXVII (4500/9000) - 2024/06/26 23:27:54 UTC [2024/06/26 19:27:54 ET]
Table '3769361908 4' 6-max Seat #1 is the button
Seat 1: C0rpsbal (160872 in chips) 
Seat 2: Chuckster388 (88670 in chips) 
Seat 3: MjLK MAN (268227 in chips) 
Seat 4: aapetrone91 (186848 in chips) 
Seat 5: Everbrun11 (228649 in chips) 
Seat 6: VxVendetta00 (83220 in chips) 
C0rpsbal: posts the ante 2250
Chuckster388: posts the ante 2250
MjLK MAN: posts the ante 2250
aapetrone91: posts the ante 2250
Everbrun11: posts the ante 2250
VxVendetta00: posts the ante 2250
Chuckster388: posts small blind 4500
MjLK MAN: posts big blind 9000
*** HOLE CARDS ***
aapetrone91: folds 
Everbrun11: folds 
VxVendetta00: raises 71970 to 80970 and is all-in
C0rpsbal: folds 
Chuckster388: folds 
MjLK MAN has timed out
MjLK MAN: folds 
MjLK MAN is sitting out
Uncalled bet (71970) returned to VxVendetta00
VxVendetta00 collected 36000 from pot
MjLK MAN has returned
*** SUMMARY ***
Total pot 36000 | Rake 0 
Seat 1: C0rpsbal (button) folded before Flop (didn't bet)
Seat 2: Chuckster388 (small blind) folded before Flop
Seat 3: MjLK MAN (big blind) folded before Flop
Seat 4: aapetrone91 folded before Flop (didn't bet)
Seat 5: Everbrun11 folded before Flop (didn't bet)
Seat 6: VxVendetta00 collected (36000)

PokerStars Hand #251210317409: Tournament #3769361908, $52.38+$2.62 USD Hold'em No Limit - Level XXVII (4500/9000) - 2024/06/26 23:28:23 UTC [2024/06/26 19:28:23 ET]
Table '3769361908 4' 6-max Seat #2 is the button
Seat 1: C0rpsbal (158622 in chips) 
Seat 2: Chuckster388 (81920 in chips) 
Seat 3: MjLK MAN (256977 in chips) 
Seat 4: aapetrone91 (184598 in chips) 
Seat 5: Everbrun11 (226399 in chips) 
Seat 6: VxVendetta00 (107970 in chips) 
C0rpsbal: posts the ante 2250
Chuckster388: posts the ante 2250
MjLK MAN: posts the ante 2250
aapetrone91: posts the ante 2250
Everbrun11: posts the ante 2250
VxVendetta00: posts the ante 2250
MjLK MAN: posts small blind 4500
aapetrone91: posts big blind 9000
*** HOLE CARDS ***
Everbrun11: folds 
VxVendetta00: folds 
C0rpsbal: folds 
Chuckster388: folds 
MjLK MAN has timed out
MjLK MAN: folds 
MjLK MAN is sitting out
Uncalled bet (4500) returned to aapetrone91
aapetrone91 collected 22500 from pot
MjLK MAN has returned
*** SUMMARY ***
Total pot 22500 | Rake 0 
Seat 1: C0rpsbal folded before Flop (didn't bet)
Seat 2: Chuckster388 (button) folded before Flop (didn't bet)
Seat 3: MjLK MAN (small blind) folded before Flop
Seat 4: aapetrone91 (big blind) collected (22500)
Seat 5: Everbrun11 folded before Flop (didn't bet)
Seat 6: VxVendetta00 folded before Flop (didn't bet)

PokerStars Hand #251210323162: Tournament #3769361908, $52.38+$2.62 USD Hold'em No Limit - Level XXVII (4500/9000) - 2024/06/26 23:28:52 UTC [2024/06/26 19:28:52 ET]
Table '3769361908 4' 6-max Seat #3 is the button
Seat 1: C0rpsbal (156372 in chips) 
Seat 2: Chuckster388 (79670 in chips) 
Seat 3: MjLK MAN (250227 in chips) 
Seat 4: aapetrone91 (200348 in chips) 
Seat 5: Everbrun11 (224149 in chips) 
Seat 6: VxVendetta00 (105720 in chips) 
C0rpsbal: posts the ante 2250
Chuckster388: posts the ante 2250
MjLK MAN: posts the ante 2250
aapetrone91: posts the ante 2250
Everbrun11: posts the ante 2250
VxVendetta00: posts the ante 2250
aapetrone91: posts small blind 4500
Everbrun11: posts big blind 9000
*** HOLE CARDS ***
VxVendetta00: folds 
C0rpsbal: raises 9000 to 18000
Chuckster388: folds 
MjLK MAN has timed out
MjLK MAN: folds 
MjLK MAN is sitting out
MjLK MAN has returned
aapetrone91: folds 
Everbrun11: calls 9000
*** FLOP *** [3s 5c Ad]
Everbrun11: checks 
C0rpsbal: bets 16200
Everbrun11: raises 19800 to 36000
C0rpsbal: calls 19800
*** TURN *** [3s 5c Ad] [4d]
Everbrun11: bets 40500
C0rpsbal: folds 
Uncalled bet (40500) returned to Everbrun11
Everbrun11 collected 126000 from pot
Everbrun11: doesn't show hand 
*** SUMMARY ***
Total pot 126000 | Rake 0 
Board [3s 5c Ad 4d]
Seat 1: C0rpsbal folded on the Turn
Seat 2: Chuckster388 folded before Flop (didn't bet)
Seat 3: MjLK MAN (button) folded before Flop (didn't bet)
Seat 4: aapetrone91 (small blind) folded before Flop
Seat 5: Everbrun11 (big blind) collected (126000)
Seat 6: VxVendetta00 folded before Flop (didn't bet)

PokerStars Hand #251210340729: Tournament #3769361908, $52.38+$2.62 USD Hold'em No Limit - Level XXVIII (5000/10000) - 2024/06/26 23:30:20 UTC [2024/06/26 19:30:20 ET]
Table '3769361908 4' 6-max Seat #4 is the button
Seat 1: C0rpsbal (100122 in chips) 
Seat 2: Chuckster388 (77420 in chips) 
Seat 3: MjLK MAN (247977 in chips) 
Seat 4: aapetrone91 (193598 in chips) 
Seat 5: Everbrun11 (293899 in chips) 
Seat 6: VxVendetta00 (103470 in chips) 
C0rpsbal: posts the ante 2500
Chuckster388: posts the ante 2500
MjLK MAN: posts the ante 2500
aapetrone91: posts the ante 2500
Everbrun11: posts the ante 2500
VxVendetta00: posts the ante 2500
Everbrun11: posts small blind 5000
VxVendetta00: posts big blind 10000
*** HOLE CARDS ***
C0rpsbal: raises 87622 to 97622 and is all-in
Chuckster388: folds 
MjLK MAN: folds 
aapetrone91: folds 
Everbrun11: folds 
VxVendetta00: folds 
Uncalled bet (87622) returned to C0rpsbal
C0rpsbal collected 40000 from pot
C0rpsbal: doesn't show hand 
*** SUMMARY ***
Total pot 40000 | Rake 0 
Seat 1: C0rpsbal collected (40000)
Seat 2: Chuckster388 folded before Flop (didn't bet)
Seat 3: MjLK MAN folded before Flop (didn't bet)
Seat 4: aapetrone91 (button) folded before Flop (didn't bet)
Seat 5: Everbrun11 (small blind) folded before Flop
Seat 6: VxVendetta00 (big blind) folded before Flop

PokerStars Hand #251210346489: Tournament #3769361908, $52.38+$2.62 USD Hold'em No Limit - Level XXVIII (5000/10000) - 2024/06/26 23:30:48 UTC [2024/06/26 19:30:48 ET]
Table '3769361908 4' 6-max Seat #5 is the button
Seat 1: C0rpsbal (127622 in chips) 
Seat 3: MjLK MAN (245477 in chips) 
Seat 4: aapetrone91 (191098 in chips) 
Seat 5: Everbrun11 (286399 in chips) 
Seat 6: VxVendetta00 (90970 in chips) 
C0rpsbal: posts the ante 2500
MjLK MAN: posts the ante 2500
aapetrone91: posts the ante 2500
Everbrun11: posts the ante 2500
VxVendetta00: posts the ante 2500
VxVendetta00: posts small blind 5000
C0rpsbal: posts big blind 10000
*** HOLE CARDS ***
MjLK MAN: folds 
aapetrone91: folds 
Everbrun11: folds 
VxVendetta00: raises 78470 to 88470 and is all-in
C0rpsbal: folds 
Uncalled bet (78470) returned to VxVendetta00
VxVendetta00 collected 32500 from pot
*** SUMMARY ***
Total pot 32500 | Rake 0 
Seat 1: C0rpsbal (big blind) folded before Flop
Seat 3: MjLK MAN folded before Flop (didn't bet)
Seat 4: aapetrone91 folded before Flop (didn't bet)
Seat 5: Everbrun11 (button) folded before Flop (didn't bet)
Seat 6: VxVendetta00 (small blind) collected (32500)

PokerStars Hand #251210349519: Tournament #3769361908, $52.38+$2.62 USD Hold'em No Limit - Level XXVIII (5000/10000) - 2024/06/26 23:31:04 UTC [2024/06/26 19:31:04 ET]
Table '3769361908 4' 6-max Seat #6 is the button
Seat 1: C0rpsbal (115122 in chips) 
Seat 3: MjLK MAN (242977 in chips) 
Seat 4: aapetrone91 (188598 in chips) 
Seat 5: Everbrun11 (283899 in chips) 
Seat 6: VxVendetta00 (110970 in chips) 
C0rpsbal: posts the ante 2500
MjLK MAN: posts the ante 2500
aapetrone91: posts the ante 2500
Everbrun11: posts the ante 2500
VxVendetta00: posts the ante 2500
C0rpsbal: posts small blind 5000
MjLK MAN: posts big blind 10000
*** HOLE CARDS ***
aapetrone91: folds 
Everbrun11: folds 
VxVendetta00: folds 
C0rpsbal: raises 102622 to 112622 and is all-in
MjLK MAN: calls 102622
*** FLOP *** [Td 3c 9s]
*** TURN *** [Td 3c 9s] [8d]
*** RIVER *** [Td 3c 9s 8d] [4d]
*** SHOW DOWN ***
C0rpsbal: shows [5h Kh] (high card King)
MjLK MAN: shows [7c Ad] (high card Ace)
MjLK MAN collected 237744 from pot
C0rpsbal finished the tournament in 20th place and received $164.76.
*** SUMMARY ***
Total pot 237744 | Rake 0 
Board [Td 3c 9s 8d 4d]
Seat 1: C0rpsbal (small blind) showed [5h Kh] and lost with high card King
Seat 3: MjLK MAN (big blind) showed [7c Ad] and won (237744) with high card Ace
Seat 4: aapetrone91 folded before Flop (didn't bet)
Seat 5: Everbrun11 folded before Flop (didn't bet)
Seat 6: VxVendetta00 (button) folded before Flop (didn't bet)

PokerStars Hand #251210353655: Tournament #3769361908, $52.38+$2.62 USD Hold'em No Limit - Level XXVIII (5000/10000) - 2024/06/26 23:31:24 UTC [2024/06/26 19:31:24 ET]
Table '3769361908 4' 6-max Seat #3 is the button
Seat 3: MjLK MAN (365599 in chips) 
Seat 4: aapetrone91 (186098 in chips) 
Seat 5: Everbrun11 (281399 in chips) 
Seat 6: VxVendetta00 (108470 in chips) 
MjLK MAN: posts the ante 2500
aapetrone91: posts the ante 2500
Everbrun11: posts the ante 2500
VxVendetta00: posts the ante 2500
aapetrone91: posts small blind 5000
Everbrun11: posts big blind 10000
*** HOLE CARDS ***
VxVendetta00: raises 95970 to 105970 and is all-in
MjLK MAN: folds 
aapetrone91: folds 
Everbrun11: folds 
Uncalled bet (95970) returned to VxVendetta00
VxVendetta00 collected 35000 from pot
*** SUMMARY ***
Total pot 35000 | Rake 0 
Seat 3: MjLK MAN (button) folded before Flop (didn't bet)
Seat 4: aapetrone91 (small blind) folded before Flop
Seat 5: Everbrun11 (big blind) folded before Flop
Seat 6: VxVendetta00 collected (35000)

PokerStars Hand #251210355938: Tournament #3769361908, $52.38+$2.62 USD Hold'em No Limit - Level XXVIII (5000/10000) - 2024/06/26 23:31:36 UTC [2024/06/26 19:31:36 ET]
Table '3769361908 4' 6-max Seat #4 is the button
Seat 3: MjLK MAN (363099 in chips) 
Seat 4: aapetrone91 (178598 in chips) 
Seat 5: Everbrun11 (268899 in chips) 
Seat 6: VxVendetta00 (130970 in chips) 
MjLK MAN: posts the ante 2500
aapetrone91: posts the ante 2500
Everbrun11: posts the ante 2500
VxVendetta00: posts the ante 2500
Everbrun11: posts small blind 5000
VxVendetta00: posts big blind 10000
*** HOLE CARDS ***
MjLK MAN: raises 10000 to 20000
aapetrone91: raises 30000 to 50000
Everbrun11: folds 
VxVendetta00: folds 
MjLK MAN: calls 30000
*** FLOP *** [Qc 8s 2d]
MjLK MAN: checks 
aapetrone91: bets 27500
MjLK MAN: calls 27500
*** TURN *** [Qc 8s 2d] [3s]
MjLK MAN: checks 
aapetrone91: bets 98598 and is all-in
MjLK MAN: calls 98598
*** RIVER *** [Qc 8s 2d 3s] [9d]
*** SHOW DOWN ***
MjLK MAN: shows [Ah Ad] (a pair of Aces)
aapetrone91: shows [Jh Jc] (a pair of Jacks)
MjLK MAN collected 377196 from pot
aapetrone91 finished the tournament in 18th place and received $164.76.
*** SUMMARY ***
Total pot 377196 | Rake 0 
Board [Qc 8s 2d 3s 9d]
Seat 3: MjLK MAN showed [Ah Ad] and won (377196) with a pair of Aces
Seat 4: aapetrone91 (button) showed [Jh Jc] and lost with a pair of Jacks
Seat 5: Everbrun11 (small blind) folded before Flop
Seat 6: VxVendetta00 (big blind) folded before Flop

PokerStars Hand #251210372977: Tournament #3769361908, $52.38+$2.62 USD Hold'em No Limit - Level XXIX (6000/12000) - 2024/06/26 23:33:03 UTC [2024/06/26 19:33:03 ET]
Table '3769361908 4' 6-max Seat #5 is the button
Seat 1: DR. ELDAR (193614 in chips) 
Seat 2: mila is best (32638 in chips) 
Seat 3: MjLK MAN (561697 in chips) 
Seat 5: Everbrun11 (261399 in chips) 
Seat 6: VxVendetta00 (118470 in chips) 
DR. ELDAR: posts the ante 3000
mila is best: posts the ante 3000
MjLK MAN: posts the ante 3000
Everbrun11: posts the ante 3000
VxVendetta00: posts the ante 3000
VxVendetta00: posts small blind 6000
DR. ELDAR: posts big blind 12000
*** HOLE CARDS ***
mila is best: folds 
MjLK MAN: raises 12000 to 24000
Everbrun11: folds 
VxVendetta00: folds 
DR. ELDAR: raises 166614 to 190614 and is all-in
MjLK MAN: folds 
Uncalled bet (166614) returned to DR. ELDAR
DR. ELDAR collected 69000 from pot
DR. ELDAR: doesn't show hand 
*** SUMMARY ***
Total pot 69000 | Rake 0 
Seat 1: DR. ELDAR (big blind) collected (69000)
Seat 2: mila is best folded before Flop (didn't bet)
Seat 3: MjLK MAN folded before Flop
Seat 5: Everbrun11 (button) folded before Flop (didn't bet)
Seat 6: VxVendetta00 (small blind) folded before Flop

PokerStars Hand #251210378494: Tournament #3769361908, $52.38+$2.62 USD Hold'em No Limit - Level XXIX (6000/12000) - 2024/06/26 23:33:31 UTC [2024/06/26 19:33:31 ET]
Table '3769361908 4' 6-max Seat #6 is the button
Seat 1: DR. ELDAR (235614 in chips) 
Seat 2: mila is best (29638 in chips) 
Seat 3: MjLK MAN (534697 in chips) 
Seat 5: Everbrun11 (258399 in chips) 
Seat 6: VxVendetta00 (109470 in chips) 
DR. ELDAR: posts the ante 3000
mila is best: posts the ante 3000
MjLK MAN: posts the ante 3000
Everbrun11: posts the ante 3000
VxVendetta00: posts the ante 3000
DR. ELDAR: posts small blind 6000
mila is best: posts big blind 12000
*** HOLE CARDS ***
MjLK MAN: folds 
Everbrun11: raises 12000 to 24000
VxVendetta00: folds 
DR. ELDAR: folds 
mila is best: raises 2638 to 26638 and is all-in
Everbrun11: calls 2638
*** FLOP *** [5d Qd Ks]
*** TURN *** [5d Qd Ks] [3d]
*** RIVER *** [5d Qd Ks 3d] [Js]
*** SHOW DOWN ***
mila is best: shows [Ts Td] (a pair of Tens)
Everbrun11: shows [Qh As] (a pair of Queens)
Everbrun11 collected 74276 from pot
mila is best finished the tournament in 17th place and received $200.15.
*** SUMMARY ***
Total pot 74276 | Rake 0 
Board [5d Qd Ks 3d Js]
Seat 1: DR. ELDAR (small blind) folded before Flop
Seat 2: mila is best (big blind) showed [Ts Td] and lost with a pair of Tens
Seat 3: MjLK MAN folded before Flop (didn't bet)
Seat 5: Everbrun11 showed [Qh As] and won (74276) with a pair of Queens
Seat 6: VxVendetta00 (button) folded before Flop (didn't bet)

PokerStars Hand #251210383372: Tournament #3769361908, $52.38+$2.62 USD Hold'em No Limit - Level XXIX (6000/12000) - 2024/06/26 23:33:55 UTC [2024/06/26 19:33:55 ET]
Table '3769361908 4' 6-max Seat #1 is the button
Seat 1: DR. ELDAR (226614 in chips) 
Seat 3: MjLK MAN (531697 in chips) 
Seat 5: Everbrun11 (303037 in chips) 
Seat 6: VxVendetta00 (106470 in chips) 
DR. ELDAR: posts the ante 3000
MjLK MAN: posts the ante 3000
Everbrun11: posts the ante 3000
VxVendetta00: posts the ante 3000
MjLK MAN: posts small blind 6000
Everbrun11: posts big blind 12000
*** HOLE CARDS ***
Muril0souza is disconnected 
VxVendetta00: folds 
DR. ELDAR: folds 
MjLK MAN: raises 24000 to 36000
Everbrun11: folds 
Uncalled bet (24000) returned to MjLK MAN
MjLK MAN collected 36000 from pot
MjLK MAN: doesn't show hand 
*** SUMMARY ***
Total pot 36000 | Rake 0 
Seat 1: DR. ELDAR (button) folded before Flop (didn't bet)
Seat 3: MjLK MAN (small blind) collected (36000)
Seat 5: Everbrun11 (big blind) folded before Flop
Seat 6: VxVendetta00 folded before Flop (didn't bet)

PokerStars Hand #251210387413: Tournament #3769361908, $52.38+$2.62 USD Hold'em No Limit - Level XXIX (6000/12000) - 2024/06/26 23:34:15 UTC [2024/06/26 19:34:15 ET]
Table '3769361908 4' 6-max Seat #3 is the button
Seat 1: DR. ELDAR (223614 in chips) 
Seat 3: MjLK MAN (552697 in chips) 
Seat 4: Muril0souza (90798 in chips) out of hand (moved from another table into small blind)
Seat 5: Everbrun11 (288037 in chips) 
Seat 6: VxVendetta00 (103470 in chips) 
Muril0souza will be allowed to play after the button
DR. ELDAR: posts the ante 3000
MjLK MAN: posts the ante 3000
Everbrun11: posts the ante 3000
VxVendetta00: posts the ante 3000
Everbrun11: posts small blind 6000
VxVendetta00: posts big blind 12000
*** HOLE CARDS ***
DR. ELDAR: folds 
MjLK MAN: raises 537697 to 549697 and is all-in
Everbrun11: folds 
VxVendetta00: folds 
Uncalled bet (537697) returned to MjLK MAN
MjLK MAN collected 42000 from pot
MjLK MAN: doesn't show hand 
*** SUMMARY ***
Total pot 42000 | Rake 0 
Seat 1: DR. ELDAR folded before Flop (didn't bet)
Seat 3: MjLK MAN (button) collected (42000)
Seat 5: Everbrun11 (small blind) folded before Flop
Seat 6: VxVendetta00 (big blind) folded before Flop

PokerStars Hand #251210389844: Tournament #3769361908, $52.38+$2.62 USD Hold'em No Limit - Level XXIX (6000/12000) - 2024/06/26 23:34:27 UTC [2024/06/26 19:34:27 ET]
Table '3769361908 4' 6-max Seat #5 is the button
Seat 1: DR. ELDAR (220614 in chips) 
Seat 3: MjLK MAN (579697 in chips) 
Seat 4: Muril0souza (90798 in chips) 
Seat 5: Everbrun11 (279037 in chips) 
Seat 6: VxVendetta00 (88470 in chips) 
DR. ELDAR: posts the ante 3000
MjLK MAN: posts the ante 3000
Muril0souza: posts the ante 3000
Everbrun11: posts the ante 3000
VxVendetta00: posts the ante 3000
VxVendetta00: posts small blind 6000
DR. ELDAR: posts big blind 12000
*** HOLE CARDS ***
MjLK MAN: folds 
Muril0souza: raises 75798 to 87798 and is all-in
Everbrun11: folds 
VxVendetta00: folds 
DR. ELDAR: folds 
Uncalled bet (75798) returned to Muril0souza
Muril0souza collected 45000 from pot
*** SUMMARY ***
Total pot 45000 | Rake 0 
Seat 1: DR. ELDAR (big blind) folded before Flop
Seat 3: MjLK MAN folded before Flop (didn't bet)
Seat 4: Muril0souza collected (45000)
Seat 5: Everbrun11 (button) folded before Flop (didn't bet)
Seat 6: VxVendetta00 (small blind) folded before Flop

PokerStars Hand #251210392858: Tournament #3769361908, $52.38+$2.62 USD Hold'em No Limit - Level XXIX (6000/12000) - 2024/06/26 23:34:42 UTC [2024/06/26 19:34:42 ET]
Table '3769361908 4' 6-max Seat #6 is the button
Seat 1: DR. ELDAR (205614 in chips) 
Seat 3: MjLK MAN (576697 in chips) 
Seat 4: Muril0souza (120798 in chips) 
Seat 5: Everbrun11 (276037 in chips) 
Seat 6: VxVendetta00 (79470 in chips) 
DR. ELDAR: posts the ante 3000
MjLK MAN: posts the ante 3000
Muril0souza: posts the ante 3000
Everbrun11: posts the ante 3000
VxVendetta00: posts the ante 3000
DR. ELDAR: posts small blind 6000
MjLK MAN: posts big blind 12000
*** HOLE CARDS ***
Muril0souza: raises 105798 to 117798 and is all-in
Everbrun11: folds 
VxVendetta00: folds 
DR. ELDAR: folds 
MjLK MAN: folds 
Uncalled bet (105798) returned to Muril0souza
Muril0souza collected 45000 from pot
*** SUMMARY ***
Total pot 45000 | Rake 0 
Seat 1: DR. ELDAR (small blind) folded before Flop
Seat 3: MjLK MAN (big blind) folded before Flop
Seat 4: Muril0souza collected (45000)
Seat 5: Everbrun11 folded before Flop (didn't bet)
Seat 6: VxVendetta00 (button) folded before Flop (didn't bet)

PokerStars Hand #251210397751: Tournament #3769361908, $52.38+$2.62 USD Hold'em No Limit - Level XXIX (6000/12000) - 2024/06/26 23:35:07 UTC [2024/06/26 19:35:07 ET]
Table '3769361908 4' 6-max Seat #1 is the button
Seat 1: DR. ELDAR (196614 in chips) 
Seat 3: MjLK MAN (561697 in chips) 
Seat 4: Muril0souza (150798 in chips) 
Seat 5: Everbrun11 (273037 in chips) 
Seat 6: VxVendetta00 (76470 in chips) 
DR. ELDAR: posts the ante 3000
MjLK MAN: posts the ante 3000
Muril0souza: posts the ante 3000
Everbrun11: posts the ante 3000
VxVendetta00: posts the ante 3000
MjLK MAN: posts small blind 6000
Muril0souza: posts big blind 12000
*** HOLE CARDS ***
Everbrun11: folds 
VxVendetta00: folds 
DR. ELDAR: folds 
MjLK MAN: folds 
Uncalled bet (6000) returned to Muril0souza
Muril0souza collected 27000 from pot
*** SUMMARY ***
Total pot 27000 | Rake 0 
Seat 1: DR. ELDAR (button) folded before Flop (didn't bet)
Seat 3: MjLK MAN (small blind) folded before Flop
Seat 4: Muril0souza (big blind) collected (27000)
Seat 5: Everbrun11 folded before Flop (didn't bet)
Seat 6: VxVendetta00 folded before Flop (didn't bet)

PokerStars Hand #251210402684: Tournament #3769361908, $52.38+$2.62 USD Hold'em No Limit - Level XXX (8000/16000) - 2024/06/26 23:35:32 UTC [2024/06/26 19:35:32 ET]
Table '3769361908 4' 6-max Seat #3 is the button
Seat 1: DR. ELDAR (193614 in chips) 
Seat 3: MjLK MAN (552697 in chips) 
Seat 4: Muril0souza (168798 in chips) 
Seat 5: Everbrun11 (270037 in chips) 
Seat 6: VxVendetta00 (73470 in chips) 
DR. ELDAR: posts the ante 4000
MjLK MAN: posts the ante 4000
Muril0souza: posts the ante 4000
Everbrun11: posts the ante 4000
VxVendetta00: posts the ante 4000
Muril0souza: posts small blind 8000
Everbrun11: posts big blind 16000
*** HOLE CARDS ***
VxVendetta00: folds 
DR. ELDAR: raises 173614 to 189614 and is all-in
MjLK MAN: folds 
Muril0souza: folds 
Everbrun11: folds 
Uncalled bet (173614) returned to DR. ELDAR
DR. ELDAR collected 60000 from pot
DR. ELDAR: doesn't show hand 
*** SUMMARY ***
Total pot 60000 | Rake 0 
Seat 1: DR. ELDAR collected (60000)
Seat 3: MjLK MAN (button) folded before Flop (didn't bet)
Seat 4: Muril0souza (small blind) folded before Flop
Seat 5: Everbrun11 (big blind) folded before Flop
Seat 6: VxVendetta00 folded before Flop (didn't bet)

PokerStars Hand #251210408160: Tournament #3769361908, $52.38+$2.62 USD Hold'em No Limit - Level XXX (8000/16000) - 2024/06/26 23:36:00 UTC [2024/06/26 19:36:00 ET]
Table '3769361908 4' 6-max Seat #4 is the button
Seat 1: DR. ELDAR (233614 in chips) 
Seat 3: MjLK MAN (548697 in chips) 
Seat 4: Muril0souza (156798 in chips) 
Seat 5: Everbrun11 (250037 in chips) 
Seat 6: VxVendetta00 (69470 in chips) 
DR. ELDAR: posts the ante 4000
MjLK MAN: posts the ante 4000
Muril0souza: posts the ante 4000
Everbrun11: posts the ante 4000
VxVendetta00: posts the ante 4000
Everbrun11: posts small blind 8000
VxVendetta00: posts big blind 16000
*** HOLE CARDS ***
DR. ELDAR: folds 
MjLK MAN: folds 
Muril0souza: raises 136798 to 152798 and is all-in
Everbrun11: folds 
VxVendetta00: folds 
Uncalled bet (136798) returned to Muril0souza
Muril0souza collected 60000 from pot
*** SUMMARY ***
Total pot 60000 | Rake 0 
Seat 1: DR. ELDAR folded before Flop (didn't bet)
Seat 3: MjLK MAN folded before Flop (didn't bet)
Seat 4: Muril0souza (button) collected (60000)
Seat 5: Everbrun11 (small blind) folded before Flop
Seat 6: VxVendetta00 (big blind) folded before Flop

PokerStars Hand #251210411163: Tournament #3769361908, $52.38+$2.62 USD Hold'em No Limit - Level XXX (8000/16000) - 2024/06/26 23:36:14 UTC [2024/06/26 19:36:14 ET]
Table '3769361908 4' 6-max Seat #5 is the button
Seat 1: DR. ELDAR (229614 in chips) 
Seat 3: MjLK MAN (544697 in chips) 
Seat 4: Muril0souza (196798 in chips) 
Seat 5: Everbrun11 (238037 in chips) 
Seat 6: VxVendetta00 (49470 in chips) 
DR. ELDAR: posts the ante 4000
MjLK MAN: posts the ante 4000
Muril0souza: posts the ante 4000
Everbrun11: posts the ante 4000
VxVendetta00: posts the ante 4000
VxVendetta00: posts small blind 8000
DR. ELDAR: posts big blind 16000
*** HOLE CARDS ***
MjLK MAN: folds 
Muril0souza: folds 
Everbrun11: folds 
VxVendetta00: raises 29470 to 45470 and is all-in
DR. ELDAR: calls 29470
*** FLOP *** [6d 8s Ah]
*** TURN *** [6d 8s Ah] [5h]
*** RIVER *** [6d 8s Ah 5h] [Ac]
*** SHOW DOWN ***
VxVendetta00: shows [8h Qc] (two pair, Aces and Eights)
DR. ELDAR: shows [As 3h] (three of a kind, Aces)
DR. ELDAR collected 110940 from pot
VxVendetta00 finished the tournament in 13th place and received $243.14.
*** SUMMARY ***
Total pot 110940 | Rake 0 
Board [6d 8s Ah 5h Ac]
Seat 1: DR. ELDAR (big blind) showed [As 3h] and won (110940) with three of a kind, Aces
Seat 3: MjLK MAN folded before Flop (didn't bet)
Seat 4: Muril0souza folded before Flop (didn't bet)
Seat 5: Everbrun11 (button) folded before Flop (didn't bet)
Seat 6: VxVendetta00 (small blind) showed [8h Qc] and lost with two pair, Aces and Eights






PokerStars Hand #251209099115: Tournament #3769361908, $52.38+$2.62 USD Hold'em No Limit - Level II (30/60) - 2024/06/26 22:05:55 UTC [2024/06/26 18:05:55 ET]
Table '3769361908 1' 6-max Seat #5 is the button
Seat 1: 67KOSTAS (10108 in chips) 
Seat 2: jessecesar (8748 in chips) 
Seat 3: sinister778 (9985 in chips) 
Seat 4: mehditheboss (10144 in chips) 
Seat 5: lidi77777 (11373 in chips) 
Seat 6: Link_fNK (9913 in chips) 
67KOSTAS: posts the ante 15
jessecesar: posts the ante 15
sinister778: posts the ante 15
mehditheboss: posts the ante 15
lidi77777: posts the ante 15
Link_fNK: posts the ante 15
Link_fNK: posts small blind 30
67KOSTAS: posts big blind 60
*** HOLE CARDS ***
jessecesar: folds 
sinister778: folds 
mehditheboss: folds 
lidi77777: raises 60 to 120
Link_fNK: raises 420 to 540
67KOSTAS: folds 
lidi77777: folds 
Uncalled bet (420) returned to Link_fNK
Link_fNK collected 390 from pot
Link_fNK: doesn't show hand 
*** SUMMARY ***
Total pot 390 | Rake 0 
Seat 1: 67KOSTAS (big blind) folded before Flop
Seat 2: jessecesar folded before Flop (didn't bet)
Seat 3: sinister778 folded before Flop (didn't bet)
Seat 4: mehditheboss folded before Flop (didn't bet)
Seat 5: lidi77777 (button) folded before Flop
Seat 6: Link_fNK (small blind) collected (390)

PokerStars Hand #251209107040: Tournament #3769361908, $52.38+$2.62 USD Hold'em No Limit - Level II (30/60) - 2024/06/26 22:06:22 UTC [2024/06/26 18:06:22 ET]
Table '3769361908 1' 6-max Seat #6 is the button
Seat 1: 67KOSTAS (10033 in chips) 
Seat 3: sinister778 (9970 in chips) 
Seat 4: mehditheboss (10129 in chips) 
Seat 5: lidi77777 (11238 in chips) 
Seat 6: Link_fNK (10168 in chips) 
67KOSTAS: posts the ante 15
sinister778: posts the ante 15
mehditheboss: posts the ante 15
lidi77777: posts the ante 15
Link_fNK: posts the ante 15
67KOSTAS: posts small blind 30
sinister778: posts big blind 60
*** HOLE CARDS ***
mehditheboss: raises 72 to 132
lidi77777: calls 132
Link_fNK: folds 
67KOSTAS: folds 
sinister778: calls 72
*** FLOP *** [3c 4s Ac]
sinister778: checks 
mehditheboss: bets 160
clareou0408 is disconnected 
lidi77777: calls 160
sinister778: folds 
*** TURN *** [3c 4s Ac] [2s]
mehditheboss: checks 
lidi77777: bets 471
mehditheboss: calls 471
*** RIVER *** [3c 4s Ac 2s] [9d]
mehditheboss: checks 
lidi77777: checks 
*** SHOW DOWN ***
mehditheboss: shows [Td Ah] (a pair of Aces)
lidi77777: shows [Ad Jd] (a pair of Aces - Jack kicker)
lidi77777 collected 1763 from pot
*** SUMMARY ***
Total pot 1763 | Rake 0 
Board [3c 4s Ac 2s 9d]
Seat 1: 67KOSTAS (small blind) folded before Flop
Seat 3: sinister778 (big blind) folded on the Flop
Seat 4: mehditheboss showed [Td Ah] and lost with a pair of Aces
Seat 5: lidi77777 showed [Ad Jd] and won (1763) with a pair of Aces
Seat 6: Link_fNK (button) folded before Flop (didn't bet)

PokerStars Hand #251209122496: Tournament #3769361908, $52.38+$2.62 USD Hold'em No Limit - Level II (30/60) - 2024/06/26 22:07:15 UTC [2024/06/26 18:07:15 ET]
Table '3769361908 1' 6-max Seat #1 is the button
Seat 1: 67KOSTAS (9988 in chips) 
Seat 2: clareou0408 (10000 in chips) out of hand (moved from another table into small blind)
Seat 3: sinister778 (9823 in chips) 
Seat 4: mehditheboss (9351 in chips) 
Seat 5: lidi77777 (12223 in chips) 
Seat 6: Link_fNK (10153 in chips) 
clareou0408 will be allowed to play after the button
67KOSTAS: posts the ante 15
sinister778: posts the ante 15
mehditheboss: posts the ante 15
lidi77777: posts the ante 15
Link_fNK: posts the ante 15
sinister778: posts small blind 30
mehditheboss: posts big blind 60
*** HOLE CARDS ***
lidi77777: folds 
Link_fNK: folds 
67KOSTAS: raises 120 to 180
sinister778: calls 150
mehditheboss: folds 
*** FLOP *** [3c 2d 9s]
sinister778: checks 
67KOSTAS: checks 
*** TURN *** [3c 2d 9s] [6c]
sinister778: bets 180
67KOSTAS: calls 180
*** RIVER *** [3c 2d 9s 6c] [Qc]
sinister778: bets 488
67KOSTAS: folds 
Uncalled bet (488) returned to sinister778
sinister778 collected 855 from pot
*** SUMMARY ***
Total pot 855 | Rake 0 
Board [3c 2d 9s 6c Qc]
Seat 1: 67KOSTAS (button) folded on the River
Seat 3: sinister778 (small blind) collected (855)
Seat 4: mehditheboss (big blind) folded before Flop
Seat 5: lidi77777 folded before Flop (didn't bet)
Seat 6: Link_fNK folded before Flop (didn't bet)

PokerStars Hand #251209139991: Tournament #3769361908, $52.38+$2.62 USD Hold'em No Limit - Level III (40/80) - 2024/06/26 22:08:15 UTC [2024/06/26 18:08:15 ET]
Table '3769361908 1' 6-max Seat #3 is the button
Seat 1: 67KOSTAS (9613 in chips) 
Seat 2: clareou0408 (10000 in chips) 
Seat 3: sinister778 (10303 in chips) 
Seat 4: mehditheboss (9276 in chips) 
Seat 5: lidi77777 (12208 in chips) 
Seat 6: Link_fNK (10138 in chips) 
67KOSTAS: posts the ante 20
clareou0408: posts the ante 20
sinister778: posts the ante 20
mehditheboss: posts the ante 20
lidi77777: posts the ante 20
Link_fNK: posts the ante 20
mehditheboss: posts small blind 40
lidi77777: posts big blind 80
*** HOLE CARDS ***
Link_fNK: folds 
67KOSTAS: raises 160 to 240
clareou0408: calls 240
sinister778: folds 
mehditheboss: folds 
lidi77777: raises 880 to 1120
67KOSTAS: calls 880
clareou0408: folds 
*** FLOP *** [9c 9s 5c]
lidi77777: bets 1320
67KOSTAS: calls 1320
*** TURN *** [9c 9s 5c] [6c]
lidi77777: bets 9748 and is all-in
67KOSTAS: folds 
Uncalled bet (9748) returned to lidi77777
lidi77777 collected 5280 from pot
*** SUMMARY ***
Total pot 5280 | Rake 0 
Board [9c 9s 5c 6c]
Seat 1: 67KOSTAS folded on the Turn
Seat 2: clareou0408 folded before Flop
Seat 3: sinister778 (button) folded before Flop (didn't bet)
Seat 4: mehditheboss (small blind) folded before Flop
Seat 5: lidi77777 (big blind) collected (5280)
Seat 6: Link_fNK folded before Flop (didn't bet)

PokerStars Hand #251209152459: Tournament #3769361908, $52.38+$2.62 USD Hold'em No Limit - Level III (40/80) - 2024/06/26 22:08:57 UTC [2024/06/26 18:08:57 ET]
Table '3769361908 1' 6-max Seat #4 is the button
Seat 1: 67KOSTAS (7153 in chips) 
Seat 2: clareou0408 (9740 in chips) 
Seat 3: sinister778 (10283 in chips) 
Seat 4: mehditheboss (9216 in chips) 
Seat 5: lidi77777 (15028 in chips) 
Seat 6: Link_fNK (10118 in chips) 
67KOSTAS: posts the ante 20
clareou0408: posts the ante 20
sinister778: posts the ante 20
mehditheboss: posts the ante 20
lidi77777: posts the ante 20
Link_fNK: posts the ante 20
lidi77777: posts small blind 40
Link_fNK: posts big blind 80
*** HOLE CARDS ***
67KOSTAS: folds 
clareou0408: folds 
sinister778: raises 80 to 160
mehditheboss: folds 
lidi77777: folds 
Link_fNK: folds 
Uncalled bet (80) returned to sinister778
sinister778 collected 320 from pot
*** SUMMARY ***
Total pot 320 | Rake 0 
Seat 1: 67KOSTAS folded before Flop (didn't bet)
Seat 2: clareou0408 folded before Flop (didn't bet)
Seat 3: sinister778 collected (320)
Seat 4: mehditheboss (button) folded before Flop (didn't bet)
Seat 5: lidi77777 (small blind) folded before Flop
Seat 6: Link_fNK (big blind) folded before Flop

PokerStars Hand #251209162121: Tournament #3769361908, $52.38+$2.62 USD Hold'em No Limit - Level III (40/80) - 2024/06/26 22:09:30 UTC [2024/06/26 18:09:30 ET]
Table '3769361908 1' 6-max Seat #5 is the button
Seat 1: 67KOSTAS (7133 in chips) 
Seat 2: clareou0408 (9720 in chips) 
Seat 3: sinister778 (10503 in chips) 
Seat 4: mehditheboss (9196 in chips) 
Seat 5: lidi77777 (14968 in chips) 
Seat 6: Link_fNK (10018 in chips) 
67KOSTAS: posts the ante 20
clareou0408: posts the ante 20
sinister778: posts the ante 20
mehditheboss: posts the ante 20
lidi77777: posts the ante 20
Link_fNK: posts the ante 20
Link_fNK: posts small blind 40
67KOSTAS: posts big blind 80
*** HOLE CARDS ***
clareou0408: folds 
sinister778: raises 80 to 160
mehditheboss: calls 160
lidi77777: calls 160
Link_fNK: folds 
67KOSTAS: raises 800 to 960
sinister778: calls 800
mehditheboss: calls 800
lidi77777: calls 800
*** FLOP *** [7c 2d 5d]
67KOSTAS: bets 2000
sinister778: folds 
mehditheboss: calls 2000
lidi77777: raises 5000 to 7000
67KOSTAS: calls 4153 and is all-in
mehditheboss: folds 
Uncalled bet (847) returned to lidi77777
*** TURN *** [7c 2d 5d] [6h]
*** RIVER *** [7c 2d 5d 6h] [As]
*** SHOW DOWN ***
67KOSTAS: shows [9d 9s] (a pair of Nines)
lidi77777: shows [9c 9h] (a pair of Nines)
67KOSTAS collected 9153 from pot
lidi77777 collected 9153 from pot
*** SUMMARY ***
Total pot 18306 | Rake 0 
Board [7c 2d 5d 6h As]
Seat 1: 67KOSTAS (big blind) showed [9d 9s] and won (9153) with a pair of Nines
Seat 2: clareou0408 folded before Flop (didn't bet)
Seat 3: sinister778 folded on the Flop
Seat 4: mehditheboss folded on the Flop
Seat 5: lidi77777 (button) showed [9c 9h] and won (9153) with a pair of Nines
Seat 6: Link_fNK (small blind) folded before Flop

PokerStars Hand #251209182619: Tournament #3769361908, $52.38+$2.62 USD Hold'em No Limit - Level III (40/80) - 2024/06/26 22:10:40 UTC [2024/06/26 18:10:40 ET]
Table '3769361908 1' 6-max Seat #6 is the button
Seat 1: 67KOSTAS (9153 in chips) 
Seat 2: clareou0408 (9700 in chips) 
Seat 3: sinister778 (9523 in chips) 
Seat 4: mehditheboss (6216 in chips) 
Seat 5: lidi77777 (16988 in chips) 
Seat 6: Link_fNK (9958 in chips) 
67KOSTAS: posts the ante 20
clareou0408: posts the ante 20
sinister778: posts the ante 20
mehditheboss: posts the ante 20
lidi77777: posts the ante 20
Link_fNK: posts the ante 20
67KOSTAS: posts small blind 40
clareou0408: posts big blind 80
*** HOLE CARDS ***
sinister778: raises 80 to 160
mehditheboss: raises 6036 to 6196 and is all-in
lidi77777: folds 
Link_fNK: folds 
67KOSTAS: folds 
clareou0408: folds 
sinister778: calls 6036
*** FLOP *** [5h 6c 3s]
*** TURN *** [5h 6c 3s] [Kd]
*** RIVER *** [5h 6c 3s Kd] [Js]
*** SHOW DOWN ***
sinister778: shows [4c 4s] (a pair of Fours)
mehditheboss: shows [Kh Ad] (a pair of Kings)
mehditheboss collected 12632 from pot
*** SUMMARY ***
Total pot 12632 | Rake 0 
Board [5h 6c 3s Kd Js]
Seat 1: 67KOSTAS (small blind) folded before Flop
Seat 2: clareou0408 (big blind) folded before Flop
Seat 3: sinister778 showed [4c 4s] and lost with a pair of Fours
Seat 4: mehditheboss showed [Kh Ad] and won (12632) with a pair of Kings
Seat 5: lidi77777 folded before Flop (didn't bet)
Seat 6: Link_fNK (button) folded before Flop (didn't bet)

PokerStars Hand #251209195289: Tournament #3769361908, $52.38+$2.62 USD Hold'em No Limit - Level IV (50/100) - 2024/06/26 22:11:25 UTC [2024/06/26 18:11:25 ET]
Table '3769361908 1' 6-max Seat #1 is the button
Seat 1: 67KOSTAS (9093 in chips) 
Seat 2: clareou0408 (9600 in chips) 
Seat 3: sinister778 (3307 in chips) 
Seat 4: mehditheboss (12632 in chips) 
Seat 5: lidi77777 (16968 in chips) 
Seat 6: Link_fNK (9938 in chips) 
67KOSTAS: posts the ante 25
clareou0408: posts the ante 25
sinister778: posts the ante 25
mehditheboss: posts the ante 25
lidi77777: posts the ante 25
Link_fNK: posts the ante 25
clareou0408: posts small blind 50
sinister778: posts big blind 100
*** HOLE CARDS ***
mehditheboss: raises 120 to 220
lidi77777: folds 
Link_fNK: folds 
67KOSTAS: raises 740 to 960
clareou0408: folds 
sinister778: folds 
mehditheboss: folds 
Uncalled bet (740) returned to 67KOSTAS
67KOSTAS collected 740 from pot
67KOSTAS: doesn't show hand 
*** SUMMARY ***
Total pot 740 | Rake 0 
Seat 1: 67KOSTAS (button) collected (740)
Seat 2: clareou0408 (small blind) folded before Flop
Seat 3: sinister778 (big blind) folded before Flop
Seat 4: mehditheboss folded before Flop
Seat 5: lidi77777 folded before Flop (didn't bet)
Seat 6: Link_fNK folded before Flop (didn't bet)

PokerStars Hand #251209200398: Tournament #3769361908, $52.38+$2.62 USD Hold'em No Limit - Level IV (50/100) - 2024/06/26 22:11:42 UTC [2024/06/26 18:11:42 ET]
Table '3769361908 1' 6-max Seat #2 is the button
Seat 2: clareou0408 (9525 in chips) 
Seat 3: sinister778 (3182 in chips) 
Seat 4: mehditheboss (12387 in chips) 
Seat 5: lidi77777 (16943 in chips) 
Seat 6: Link_fNK (9913 in chips) 
clareou0408: posts the ante 25
sinister778: posts the ante 25
mehditheboss: posts the ante 25
lidi77777: posts the ante 25
Link_fNK: posts the ante 25
sinister778: posts small blind 50
mehditheboss: posts big blind 100
*** HOLE CARDS ***
lidi77777: folds 
Link_fNK: folds 
clareou0408: raises 100 to 200
sinister778: calls 150
mehditheboss: folds 
*** FLOP *** [9d Kd 3c]
sinister778: checks 
clareou0408: bets 167
sinister778: calls 167
*** TURN *** [9d Kd 3c] [Td]
sinister778: checks 
clareou0408: checks 
*** RIVER *** [9d Kd 3c Td] [7h]
sinister778: checks 
clareou0408: checks 
*** SHOW DOWN ***
sinister778: shows [9h 8s] (a pair of Nines)
clareou0408: mucks hand 
sinister778 collected 959 from pot
*** SUMMARY ***
Total pot 959 | Rake 0 
Board [9d Kd 3c Td 7h]
Seat 2: clareou0408 (button) mucked
Seat 3: sinister778 (small blind) showed [9h 8s] and won (959) with a pair of Nines
Seat 4: mehditheboss (big blind) folded before Flop
Seat 5: lidi77777 folded before Flop (didn't bet)
Seat 6: Link_fNK folded before Flop (didn't bet)

PokerStars Hand #251209224634: Tournament #3769361908, $52.38+$2.62 USD Hold'em No Limit - Level IV (50/100) - 2024/06/26 22:13:07 UTC [2024/06/26 18:13:07 ET]
Table '3769361908 1' 6-max Seat #3 is the button
Seat 2: clareou0408 (9133 in chips) 
Seat 3: sinister778 (3749 in chips) 
Seat 4: mehditheboss (12262 in chips) 
Seat 5: lidi77777 (16918 in chips) 
Seat 6: Link_fNK (9888 in chips) 
clareou0408: posts the ante 25
sinister778: posts the ante 25
mehditheboss: posts the ante 25
lidi77777: posts the ante 25
Link_fNK: posts the ante 25
mehditheboss: posts small blind 50
lidi77777: posts big blind 100
*** HOLE CARDS ***
Link_fNK: folds 
clareou0408: folds 
sinister778: raises 300 to 400
mehditheboss: folds 
lidi77777: folds 
Uncalled bet (300) returned to sinister778
sinister778 collected 375 from pot
*** SUMMARY ***
Total pot 375 | Rake 0 
Seat 2: clareou0408 folded before Flop (didn't bet)
Seat 3: sinister778 (button) collected (375)
Seat 4: mehditheboss (small blind) folded before Flop
Seat 5: lidi77777 (big blind) folded before Flop
Seat 6: Link_fNK folded before Flop (didn't bet)

PokerStars Hand #251209231236: Tournament #3769361908, $52.38+$2.62 USD Hold'em No Limit - Level IV (50/100) - 2024/06/26 22:13:30 UTC [2024/06/26 18:13:30 ET]
Table '3769361908 1' 6-max Seat #4 is the button
Seat 2: clareou0408 (9108 in chips) 
Seat 3: sinister778 (3999 in chips) 
Seat 4: mehditheboss (12187 in chips) 
Seat 5: lidi77777 (16793 in chips) 
Seat 6: Link_fNK (9863 in chips) 
clareou0408: posts the ante 25
sinister778: posts the ante 25
mehditheboss: posts the ante 25
lidi77777: posts the ante 25
Link_fNK: posts the ante 25
lidi77777: posts small blind 50
Link_fNK: posts big blind 100
*** HOLE CARDS ***
lucaromanoo1 is disconnected 
clareou0408: folds 
sinister778: folds 
mehditheboss: raises 100 to 200
lidi77777: calls 150
Link_fNK: folds 
*** FLOP *** [4d 8d Th]
lidi77777: checks 
mehditheboss: checks 
*** TURN *** [4d 8d Th] [4s]
lidi77777: checks 
mehditheboss: bets 313
lidi77777: raises 626 to 939
mehditheboss: calls 626
*** RIVER *** [4d 8d Th 4s] [Qd]
lidi77777: bets 2452
mehditheboss: folds 
Uncalled bet (2452) returned to lidi77777
lidi77777 collected 2503 from pot
*** SUMMARY ***
Total pot 2503 | Rake 0 
Board [4d 8d Th 4s Qd]
Seat 2: clareou0408 folded before Flop (didn't bet)
Seat 3: sinister778 folded before Flop (didn't bet)
Seat 4: mehditheboss (button) folded on the River
Seat 5: lidi77777 (small blind) collected (2503)
Seat 6: Link_fNK (big blind) folded before Flop

PokerStars Hand #251209252257: Tournament #3769361908, $52.38+$2.62 USD Hold'em No Limit - Level V (60/120) - 2024/06/26 22:14:43 UTC [2024/06/26 18:14:43 ET]
Table '3769361908 1' 6-max Seat #5 is the button
Seat 1: lucaromanoo1 (10000 in chips) 
Seat 2: clareou0408 (9083 in chips) 
Seat 3: sinister778 (3974 in chips) 
Seat 4: mehditheboss (11023 in chips) 
Seat 5: lidi77777 (18132 in chips) 
Seat 6: Link_fNK (9738 in chips) 
lucaromanoo1: posts the ante 30
clareou0408: posts the ante 30
sinister778: posts the ante 30
mehditheboss: posts the ante 30
lidi77777: posts the ante 30
Link_fNK: posts the ante 30
Link_fNK: posts small blind 60
lucaromanoo1: posts big blind 120
*** HOLE CARDS ***
clareou0408: folds 
sinister778: folds 
mehditheboss: folds 
lidi77777: folds 
Link_fNK: raises 300 to 420
lucaromanoo1: calls 300
*** FLOP *** [Kc 2s 7s]
Link_fNK: bets 229
lucaromanoo1: calls 229
*** TURN *** [Kc 2s 7s] [8c]
Link_fNK: bets 1050
lucaromanoo1: calls 1050
*** RIVER *** [Kc 2s 7s 8c] [Js]
Link_fNK: checks 
lucaromanoo1: bets 8271 and is all-in
Link_fNK: folds 
Uncalled bet (8271) returned to lucaromanoo1
lucaromanoo1 collected 3578 from pot
lucaromanoo1: doesn't show hand 
*** SUMMARY ***
Total pot 3578 | Rake 0 
Board [Kc 2s 7s 8c Js]
Seat 1: lucaromanoo1 (big blind) collected (3578)
Seat 2: clareou0408 folded before Flop (didn't bet)
Seat 3: sinister778 folded before Flop (didn't bet)
Seat 4: mehditheboss folded before Flop (didn't bet)
Seat 5: lidi77777 (button) folded before Flop (didn't bet)
Seat 6: Link_fNK (small blind) folded on the River

PokerStars Hand #251209283203: Tournament #3769361908, $52.38+$2.62 USD Hold'em No Limit - Level V (60/120) - 2024/06/26 22:16:33 UTC [2024/06/26 18:16:33 ET]
Table '3769361908 1' 6-max Seat #6 is the button
Seat 1: lucaromanoo1 (11849 in chips) 
Seat 2: clareou0408 (9053 in chips) 
Seat 3: sinister778 (3944 in chips) 
Seat 4: mehditheboss (10993 in chips) 
Seat 5: lidi77777 (18102 in chips) 
Seat 6: Link_fNK (8009 in chips) 
lucaromanoo1: posts the ante 30
clareou0408: posts the ante 30
sinister778: posts the ante 30
mehditheboss: posts the ante 30
lidi77777: posts the ante 30
Link_fNK: posts the ante 30
lucaromanoo1: posts small blind 60
clareou0408: posts big blind 120
*** HOLE CARDS ***
sinister778: raises 120 to 240
mehditheboss: folds 
lidi77777: folds 
Link_fNK: raises 600 to 840
lucaromanoo1: folds 
clareou0408: folds 
sinister778: folds 
Uncalled bet (600) returned to Link_fNK
Link_fNK collected 840 from pot
Link_fNK: doesn't show hand 
*** SUMMARY ***
Total pot 840 | Rake 0 
Seat 1: lucaromanoo1 (small blind) folded before Flop
Seat 2: clareou0408 (big blind) folded before Flop
Seat 3: sinister778 folded before Flop
Seat 4: mehditheboss folded before Flop (didn't bet)
Seat 5: lidi77777 folded before Flop (didn't bet)
Seat 6: Link_fNK (button) collected (840)

PokerStars Hand #251209293039: Tournament #3769361908, $52.38+$2.62 USD Hold'em No Limit - Level V (60/120) - 2024/06/26 22:17:08 UTC [2024/06/26 18:17:08 ET]
Table '3769361908 1' 6-max Seat #1 is the button
Seat 1: lucaromanoo1 (11759 in chips) 
Seat 2: clareou0408 (8903 in chips) 
Seat 3: sinister778 (3674 in chips) 
Seat 4: mehditheboss (10963 in chips) 
Seat 5: lidi77777 (18072 in chips) 
Seat 6: Link_fNK (8579 in chips) 
lucaromanoo1: posts the ante 30
clareou0408: posts the ante 30
sinister778: posts the ante 30
mehditheboss: posts the ante 30
lidi77777: posts the ante 30
Link_fNK: posts the ante 30
clareou0408: posts small blind 60
sinister778: posts big blind 120
*** HOLE CARDS ***
mehditheboss: raises 120 to 240
lidi77777: folds 
Link_fNK: calls 240
lucaromanoo1: folds 
clareou0408: folds 
sinister778: raises 720 to 960
mehditheboss: folds 
Link_fNK: folds 
Uncalled bet (720) returned to sinister778
sinister778 collected 960 from pot
*** SUMMARY ***
Total pot 960 | Rake 0 
Seat 1: lucaromanoo1 (button) folded before Flop (didn't bet)
Seat 2: clareou0408 (small blind) folded before Flop
Seat 3: sinister778 (big blind) collected (960)
Seat 4: mehditheboss folded before Flop
Seat 5: lidi77777 folded before Flop (didn't bet)
Seat 6: Link_fNK folded before Flop

PokerStars Hand #251209300839: Tournament #3769361908, $52.38+$2.62 USD Hold'em No Limit - Level VI (80/160) - 2024/06/26 22:17:35 UTC [2024/06/26 18:17:35 ET]
Table '3769361908 1' 6-max Seat #2 is the button
Seat 1: lucaromanoo1 (11729 in chips) 
Seat 2: clareou0408 (8813 in chips) 
Seat 3: sinister778 (4364 in chips) 
Seat 4: mehditheboss (10693 in chips) 
Seat 5: lidi77777 (18042 in chips) 
Seat 6: Link_fNK (8309 in chips) 
lucaromanoo1: posts the ante 40
clareou0408: posts the ante 40
sinister778: posts the ante 40
mehditheboss: posts the ante 40
lidi77777: posts the ante 40
Link_fNK: posts the ante 40
sinister778: posts small blind 80
mehditheboss: posts big blind 160
*** HOLE CARDS ***
lidi77777: folds 
Link_fNK: folds 
lucaromanoo1: raises 192 to 352
clareou0408: calls 352
sinister778: folds 
mehditheboss: calls 192
*** FLOP *** [4s 9c Ah]
mehditheboss: checks 
lucaromanoo1: bets 440
clareou0408: calls 440
mehditheboss: raises 863 to 1303
lucaromanoo1: calls 863
clareou0408: folds 
*** TURN *** [4s 9c Ah] [6h]
mehditheboss: bets 2560
lucaromanoo1: calls 2560
*** RIVER *** [4s 9c Ah 6h] [Kd]
mehditheboss: bets 6438 and is all-in
lucaromanoo1: folds 
Uncalled bet (6438) returned to mehditheboss
mehditheboss collected 9542 from pot
mehditheboss: doesn't show hand 
*** SUMMARY ***
Total pot 9542 | Rake 0 
Board [4s 9c Ah 6h Kd]
Seat 1: lucaromanoo1 folded on the River
Seat 2: clareou0408 (button) folded on the Flop
Seat 3: sinister778 (small blind) folded before Flop
Seat 4: mehditheboss (big blind) collected (9542)
Seat 5: lidi77777 folded before Flop (didn't bet)
Seat 6: Link_fNK folded before Flop (didn't bet)

PokerStars Hand #251209330006: Tournament #3769361908, $52.38+$2.62 USD Hold'em No Limit - Level VI (80/160) - 2024/06/26 22:19:19 UTC [2024/06/26 18:19:19 ET]
Table '3769361908 1' 6-max Seat #3 is the button
Seat 1: lucaromanoo1 (7474 in chips) 
Seat 2: clareou0408 (7981 in chips) 
Seat 3: sinister778 (4244 in chips) 
Seat 4: mehditheboss (15980 in chips) 
Seat 5: lidi77777 (18002 in chips) 
Seat 6: Link_fNK (8269 in chips) 
lucaromanoo1: posts the ante 40
clareou0408: posts the ante 40
sinister778: posts the ante 40
mehditheboss: posts the ante 40
lidi77777: posts the ante 40
Link_fNK: posts the ante 40
mehditheboss: posts small blind 80
lidi77777: posts big blind 160
*** HOLE CARDS ***
Link_fNK: folds 
lucaromanoo1: raises 160 to 320
clareou0408: folds 
sinister778: folds 
mehditheboss: folds 
lidi77777: calls 160
*** FLOP *** [Ac Ts 2s]
lidi77777: checks 
lucaromanoo1: bets 560
lidi77777: calls 560
*** TURN *** [Ac Ts 2s] [2d]
lidi77777: checks 
lucaromanoo1: bets 1680
lidi77777: calls 1680
*** RIVER *** [Ac Ts 2s 2d] [Js]
lidi77777: checks 
lucaromanoo1: bets 4874 and is all-in
lidi77777: calls 4874
*** SHOW DOWN ***
lucaromanoo1: shows [Ad Qd] (two pair, Aces and Deuces)
lidi77777: shows [9h As] (two pair, Aces and Deuces - lower kicker)
lucaromanoo1 collected 15188 from pot
*** SUMMARY ***
Total pot 15188 | Rake 0 
Board [Ac Ts 2s 2d Js]
Seat 1: lucaromanoo1 showed [Ad Qd] and won (15188) with two pair, Aces and Deuces
Seat 2: clareou0408 folded before Flop (didn't bet)
Seat 3: sinister778 (button) folded before Flop (didn't bet)
Seat 4: mehditheboss (small blind) folded before Flop
Seat 5: lidi77777 (big blind) showed [9h As] and lost with two pair, Aces and Deuces
Seat 6: Link_fNK folded before Flop (didn't bet)

PokerStars Hand #251209348754: Tournament #3769361908, $52.38+$2.62 USD Hold'em No Limit - Level VII (100/200) - 2024/06/26 22:20:27 UTC [2024/06/26 18:20:27 ET]
Table '3769361908 1' 6-max Seat #4 is the button
Seat 1: lucaromanoo1 (15188 in chips) 
Seat 3: sinister778 (4204 in chips) 
Seat 4: mehditheboss (15860 in chips) 
Seat 5: lidi77777 (10528 in chips) 
Seat 6: Link_fNK (8229 in chips) 
lucaromanoo1: posts the ante 50
sinister778: posts the ante 50
mehditheboss: posts the ante 50
lidi77777: posts the ante 50
Link_fNK: posts the ante 50
lidi77777: posts small blind 100
Link_fNK: posts big blind 200
*** HOLE CARDS ***
lucaromanoo1: raises 200 to 400
sinister778: folds 
mehditheboss: folds 
lidi77777: calls 300
Link_fNK: folds 
*** FLOP *** [3h 4h 5d]
lidi77777: checks 
lucaromanoo1: bets 400
lidi77777: raises 1225 to 1625
lucaromanoo1: folds 
Uncalled bet (1225) returned to lidi77777
lidi77777 collected 2050 from pot
*** SUMMARY ***
Total pot 2050 | Rake 0 
Board [3h 4h 5d]
Seat 1: lucaromanoo1 folded on the Flop
Seat 3: sinister778 folded before Flop (didn't bet)
Seat 4: mehditheboss (button) folded before Flop (didn't bet)
Seat 5: lidi77777 (small blind) collected (2050)
Seat 6: Link_fNK (big blind) folded before Flop

PokerStars Hand #251209356462: Tournament #3769361908, $52.38+$2.62 USD Hold'em No Limit - Level VII (100/200) - 2024/06/26 22:20:54 UTC [2024/06/26 18:20:54 ET]
Table '3769361908 1' 6-max Seat #5 is the button
Seat 1: lucaromanoo1 (14338 in chips) 
Seat 3: sinister778 (4154 in chips) 
Seat 4: mehditheboss (15810 in chips) 
Seat 5: lidi77777 (11728 in chips) 
Seat 6: Link_fNK (7979 in chips) 
lucaromanoo1: posts the ante 50
sinister778: posts the ante 50
mehditheboss: posts the ante 50
lidi77777: posts the ante 50
Link_fNK: posts the ante 50
Link_fNK: posts small blind 100
lucaromanoo1: posts big blind 200
*** HOLE CARDS ***
sinister778: folds 
mehditheboss: raises 200 to 400
lidi77777: raises 1350 to 1750
Link_fNK: folds 
lucaromanoo1: folds 
mehditheboss: folds 
Uncalled bet (1350) returned to lidi77777
lidi77777 collected 1350 from pot
*** SUMMARY ***
Total pot 1350 | Rake 0 
Seat 1: lucaromanoo1 (big blind) folded before Flop
Seat 3: sinister778 folded before Flop (didn't bet)
Seat 4: mehditheboss folded before Flop
Seat 5: lidi77777 (button) collected (1350)
Seat 6: Link_fNK (small blind) folded before Flop

PokerStars Hand #251209362477: Tournament #3769361908, $52.38+$2.62 USD Hold'em No Limit - Level VII (100/200) - 2024/06/26 22:21:16 UTC [2024/06/26 18:21:16 ET]
Table '3769361908 1' 6-max Seat #6 is the button
Seat 1: lucaromanoo1 (14088 in chips) 
Seat 3: sinister778 (4104 in chips) 
Seat 4: mehditheboss (15360 in chips) 
Seat 5: lidi77777 (12628 in chips) 
Seat 6: Link_fNK (7829 in chips) 
lucaromanoo1: posts the ante 50
sinister778: posts the ante 50
mehditheboss: posts the ante 50
lidi77777: posts the ante 50
Link_fNK: posts the ante 50
lucaromanoo1: posts small blind 100
sinister778: posts big blind 200
*** HOLE CARDS ***
mehditheboss: folds 
lidi77777: folds 
anth0nypappa is disconnected 
Link_fNK: raises 200 to 400
lucaromanoo1: folds 
sinister778: calls 200
*** FLOP *** [8s 4d 5h]
sinister778: checks 
Link_fNK: checks 
*** TURN *** [8s 4d 5h] [3d]
lucaromanoo1 is disconnected 
sinister778: bets 800
Link_fNK: folds 
Uncalled bet (800) returned to sinister778
sinister778 collected 1150 from pot
*** SUMMARY ***
Total pot 1150 | Rake 0 
Board [8s 4d 5h 3d]
Seat 1: lucaromanoo1 (small blind) folded before Flop
Seat 3: sinister778 (big blind) collected (1150)
Seat 4: mehditheboss folded before Flop (didn't bet)
Seat 5: lidi77777 folded before Flop (didn't bet)
Seat 6: Link_fNK (button) folded on the Turn

PokerStars Hand #251209375889: Tournament #3769361908, $52.38+$2.62 USD Hold'em No Limit - Level VII (100/200) - 2024/06/26 22:22:04 UTC [2024/06/26 18:22:04 ET]
Table '3769361908 1' 6-max Seat #1 is the button
Seat 1: lucaromanoo1 (13938 in chips) 
Seat 2: anth0nypappa (10000 in chips) out of hand (moved from another table into small blind)
Seat 3: sinister778 (4804 in chips) 
Seat 4: mehditheboss (15310 in chips) 
Seat 5: lidi77777 (12578 in chips) 
Seat 6: Link_fNK (7379 in chips) 
anth0nypappa will be allowed to play after the button
lucaromanoo1: posts the ante 50
sinister778: posts the ante 50
mehditheboss: posts the ante 50
lidi77777: posts the ante 50
Link_fNK: posts the ante 50
sinister778: posts small blind 100
mehditheboss: posts big blind 200
*** HOLE CARDS ***
lidi77777: folds 
Link_fNK: folds 
lucaromanoo1: folds 
sinister778: raises 400 to 600
mehditheboss: folds 
Uncalled bet (400) returned to sinister778
sinister778 collected 650 from pot
*** SUMMARY ***
Total pot 650 | Rake 0 
Seat 1: lucaromanoo1 (button) folded before Flop (didn't bet)
Seat 3: sinister778 (small blind) collected (650)
Seat 4: mehditheboss (big blind) folded before Flop
Seat 5: lidi77777 folded before Flop (didn't bet)
Seat 6: Link_fNK folded before Flop (didn't bet)

PokerStars Hand #251209383596: Tournament #3769361908, $52.38+$2.62 USD Hold'em No Limit - Level VII (100/200) - 2024/06/26 22:22:31 UTC [2024/06/26 18:22:31 ET]
Table '3769361908 1' 6-max Seat #3 is the button
Seat 1: lucaromanoo1 (13888 in chips) 
Seat 2: anth0nypappa (10000 in chips) 
Seat 3: sinister778 (5204 in chips) 
Seat 4: mehditheboss (15060 in chips) 
Seat 5: lidi77777 (12528 in chips) 
Seat 6: Link_fNK (7329 in chips) 
lucaromanoo1: posts the ante 50
anth0nypappa: posts the ante 50
sinister778: posts the ante 50
mehditheboss: posts the ante 50
lidi77777: posts the ante 50
Link_fNK: posts the ante 50
mehditheboss: posts small blind 100
lidi77777: posts big blind 200
*** HOLE CARDS ***
Link_fNK: folds 
lucaromanoo1: folds 
anth0nypappa: folds 
sinister778: raises 400 to 600
mehditheboss: calls 500
lidi77777: folds 
*** FLOP *** [6d 7d Jd]
mehditheboss: checks 
sinister778: bets 4554 and is all-in
mehditheboss: folds 
Uncalled bet (4554) returned to sinister778
sinister778 collected 1700 from pot
*** SUMMARY ***
Total pot 1700 | Rake 0 
Board [6d 7d Jd]
Seat 1: lucaromanoo1 folded before Flop (didn't bet)
Seat 2: anth0nypappa folded before Flop (didn't bet)
Seat 3: sinister778 (button) collected (1700)
Seat 4: mehditheboss (small blind) folded on the Flop
Seat 5: lidi77777 (big blind) folded before Flop
Seat 6: Link_fNK folded before Flop (didn't bet)

PokerStars Hand #251209397685: Tournament #3769361908, $52.38+$2.62 USD Hold'em No Limit - Level VIII (125/250) - 2024/06/26 22:23:22 UTC [2024/06/26 18:23:22 ET]
Table '3769361908 1' 6-max Seat #4 is the button
Seat 1: lucaromanoo1 (13838 in chips) 
Seat 2: anth0nypappa (9950 in chips) 
Seat 3: sinister778 (6254 in chips) 
Seat 4: mehditheboss (14410 in chips) 
Seat 5: lidi77777 (12278 in chips) 
Seat 6: Link_fNK (7279 in chips) 
lucaromanoo1: posts the ante 60
anth0nypappa: posts the ante 60
sinister778: posts the ante 60
mehditheboss: posts the ante 60
lidi77777: posts the ante 60
Link_fNK: posts the ante 60
lidi77777: posts small blind 125
Link_fNK: posts big blind 250
*** HOLE CARDS ***
lucaromanoo1: folds 
anth0nypappa: folds 
sinister778: raises 250 to 500
mehditheboss: folds 
lidi77777: folds 
Link_fNK: calls 250
*** FLOP *** [9s Qh 2c]
Link_fNK: checks 
sinister778: checks 
*** TURN *** [9s Qh 2c] [5s]
Link_fNK: checks 
sinister778: checks 
*** RIVER *** [9s Qh 2c 5s] [7d]
Link_fNK: checks 
sinister778: checks 
*** SHOW DOWN ***
Link_fNK: shows [6h Kc] (high card King)
sinister778: shows [7h 8h] (a pair of Sevens)
sinister778 collected 1485 from pot
*** SUMMARY ***
Total pot 1485 | Rake 0 
Board [9s Qh 2c 5s 7d]
Seat 1: lucaromanoo1 folded before Flop (didn't bet)
Seat 2: anth0nypappa folded before Flop (didn't bet)
Seat 3: sinister778 showed [7h 8h] and won (1485) with a pair of Sevens
Seat 4: mehditheboss (button) folded before Flop (didn't bet)
Seat 5: lidi77777 (small blind) folded before Flop
Seat 6: Link_fNK (big blind) showed [6h Kc] and lost with high card King

PokerStars Hand #251209411751: Tournament #3769361908, $52.38+$2.62 USD Hold'em No Limit - Level VIII (125/250) - 2024/06/26 22:24:13 UTC [2024/06/26 18:24:13 ET]
Table '3769361908 1' 6-max Seat #5 is the button
Seat 1: lucaromanoo1 (13778 in chips) 
Seat 2: anth0nypappa (9890 in chips) 
Seat 3: sinister778 (7179 in chips) 
Seat 4: mehditheboss (14350 in chips) 
Seat 5: lidi77777 (12093 in chips) 
Seat 6: Link_fNK (6719 in chips) 
lucaromanoo1: posts the ante 60
anth0nypappa: posts the ante 60
sinister778: posts the ante 60
mehditheboss: posts the ante 60
lidi77777: posts the ante 60
Link_fNK: posts the ante 60
Link_fNK: posts small blind 125
lucaromanoo1: posts big blind 250
*** HOLE CARDS ***
anth0nypappa: folds 
sinister778: folds 
mehditheboss: folds 
lidi77777: folds 
Link_fNK: raises 500 to 750
lucaromanoo1: raises 12968 to 13718 and is all-in
Link_fNK: calls 5909 and is all-in
Uncalled bet (7059) returned to lucaromanoo1
*** FLOP *** [5c 7c Qh]
*** TURN *** [5c 7c Qh] [Ac]
*** RIVER *** [5c 7c Qh Ac] [8h]
*** SHOW DOWN ***
Link_fNK: shows [9h Ah] (a pair of Aces)
lucaromanoo1: shows [4c 4d] (a pair of Fours)
Link_fNK collected 13678 from pot
*** SUMMARY ***
Total pot 13678 | Rake 0 
Board [5c 7c Qh Ac 8h]
Seat 1: lucaromanoo1 (big blind) showed [4c 4d] and lost with a pair of Fours
Seat 2: anth0nypappa folded before Flop (didn't bet)
Seat 3: sinister778 folded before Flop (didn't bet)
Seat 4: mehditheboss folded before Flop (didn't bet)
Seat 5: lidi77777 (button) folded before Flop (didn't bet)
Seat 6: Link_fNK (small blind) showed [9h Ah] and won (13678) with a pair of Aces

PokerStars Hand #251209421037: Tournament #3769361908, $52.38+$2.62 USD Hold'em No Limit - Level VIII (125/250) - 2024/06/26 22:24:46 UTC [2024/06/26 18:24:46 ET]
Table '3769361908 1' 6-max Seat #6 is the button
Seat 1: lucaromanoo1 (7059 in chips) 
Seat 2: anth0nypappa (9830 in chips) 
Seat 3: sinister778 (7119 in chips) 
Seat 4: mehditheboss (14290 in chips) 
Seat 5: lidi77777 (12033 in chips) 
Seat 6: Link_fNK (13678 in chips) 
lucaromanoo1: posts the ante 60
anth0nypappa: posts the ante 60
sinister778: posts the ante 60
mehditheboss: posts the ante 60
lidi77777: posts the ante 60
Link_fNK: posts the ante 60
lucaromanoo1: posts small blind 125
anth0nypappa: posts big blind 250
*** HOLE CARDS ***
sinister778: folds 
mehditheboss: raises 300 to 550
lidi77777: calls 550
Link_fNK: raises 1635 to 2185
lucaromanoo1: folds 
anth0nypappa: folds 
mehditheboss: calls 1635
lidi77777: calls 1635
*** FLOP *** [Js Kh 3d]
mehditheboss: checks 
lidi77777: checks 
Link_fNK: checks 
*** TURN *** [Js Kh 3d] [5c]
mehditheboss: checks 
lidi77777: bets 3395
Link_fNK: folds 
mehditheboss: folds 
Uncalled bet (3395) returned to lidi77777
lidi77777 collected 7290 from pot
*** SUMMARY ***
Total pot 7290 | Rake 0 
Board [Js Kh 3d 5c]
Seat 1: lucaromanoo1 (small blind) folded before Flop
Seat 2: anth0nypappa (big blind) folded before Flop
Seat 3: sinister778 folded before Flop (didn't bet)
Seat 4: mehditheboss folded on the Turn
Seat 5: lidi77777 collected (7290)
Seat 6: Link_fNK (button) folded on the Turn

PokerStars Hand #251209438245: Tournament #3769361908, $52.38+$2.62 USD Hold'em No Limit - Level VIII (125/250) - 2024/06/26 22:25:48 UTC [2024/06/26 18:25:48 ET]
Table '3769361908 1' 6-max Seat #1 is the button
Seat 1: lucaromanoo1 (6874 in chips) 
Seat 2: anth0nypappa (9520 in chips) 
Seat 3: sinister778 (7059 in chips) 
Seat 4: mehditheboss (12045 in chips) 
Seat 5: lidi77777 (17078 in chips) 
Seat 6: Link_fNK (11433 in chips) 
lucaromanoo1: posts the ante 60
anth0nypappa: posts the ante 60
sinister778: posts the ante 60
mehditheboss: posts the ante 60
lidi77777: posts the ante 60
Link_fNK: posts the ante 60
anth0nypappa: posts small blind 125
sinister778: posts big blind 250
*** HOLE CARDS ***
mehditheboss: folds 
lidi77777: folds 
Link_fNK: folds 
lucaromanoo1: folds 
anth0nypappa: calls 125
sinister778: checks 
*** FLOP *** [Jd 8d 7c]
anth0nypappa: checks 
sinister778: checks 
*** TURN *** [Jd 8d 7c] [3d]
anth0nypappa: checks 
sinister778: checks 
*** RIVER *** [Jd 8d 7c 3d] [9c]
anth0nypappa: checks 
sinister778: checks 
*** SHOW DOWN ***
anth0nypappa: shows [4h Kh] (high card King)
sinister778: mucks hand 
anth0nypappa collected 860 from pot
*** SUMMARY ***
Total pot 860 | Rake 0 
Board [Jd 8d 7c 3d 9c]
Seat 1: lucaromanoo1 (button) folded before Flop (didn't bet)
Seat 2: anth0nypappa (small blind) showed [4h Kh] and won (860) with high card King
Seat 3: sinister778 (big blind) mucked
Seat 4: mehditheboss folded before Flop (didn't bet)
Seat 5: lidi77777 folded before Flop (didn't bet)
Seat 6: Link_fNK folded before Flop (didn't bet)

PokerStars Hand #251209451773: Tournament #3769361908, $52.38+$2.62 USD Hold'em No Limit - Level IX (150/300) - 2024/06/26 22:26:37 UTC [2024/06/26 18:26:37 ET]
Table '3769361908 1' 6-max Seat #2 is the button
Seat 1: lucaromanoo1 (6814 in chips) 
Seat 2: anth0nypappa (10070 in chips) 
Seat 3: sinister778 (6749 in chips) 
Seat 4: mehditheboss (11985 in chips) 
Seat 5: lidi77777 (17018 in chips) 
Seat 6: Link_fNK (11373 in chips) 
lucaromanoo1: posts the ante 75
anth0nypappa: posts the ante 75
sinister778: posts the ante 75
mehditheboss: posts the ante 75
lidi77777: posts the ante 75
Link_fNK: posts the ante 75
sinister778: posts small blind 150
mehditheboss: posts big blind 300
*** HOLE CARDS ***
lidi77777: folds 
Link_fNK: folds 
lucaromanoo1: folds 
anth0nypappa: raises 333 to 633
sinister778: folds 
mehditheboss: folds 
Uncalled bet (333) returned to anth0nypappa
anth0nypappa collected 1200 from pot
anth0nypappa: doesn't show hand 
*** SUMMARY ***
Total pot 1200 | Rake 0 
Seat 1: lucaromanoo1 folded before Flop (didn't bet)
Seat 2: anth0nypappa (button) collected (1200)
Seat 3: sinister778 (small blind) folded before Flop
Seat 4: mehditheboss (big blind) folded before Flop
Seat 5: lidi77777 folded before Flop (didn't bet)
Seat 6: Link_fNK folded before Flop (didn't bet)

PokerStars Hand #251209463242: Tournament #3769361908, $52.38+$2.62 USD Hold'em No Limit - Level IX (150/300) - 2024/06/26 22:27:18 UTC [2024/06/26 18:27:18 ET]
Table '3769361908 1' 6-max Seat #3 is the button
Seat 1: lucaromanoo1 (6739 in chips) 
Seat 2: anth0nypappa (10895 in chips) 
Seat 3: sinister778 (6524 in chips) 
Seat 4: mehditheboss (11610 in chips) 
Seat 5: lidi77777 (16943 in chips) 
Seat 6: Link_fNK (11298 in chips) 
lucaromanoo1: posts the ante 75
anth0nypappa: posts the ante 75
sinister778: posts the ante 75
mehditheboss: posts the ante 75
lidi77777: posts the ante 75
Link_fNK: posts the ante 75
mehditheboss: posts small blind 150
lidi77777: posts big blind 300
*** HOLE CARDS ***
Link_fNK: raises 300 to 600
lucaromanoo1: folds 
anth0nypappa: folds 
sinister778: folds 
mehditheboss: folds 
lidi77777: calls 300
*** FLOP *** [6d As 2s]
lidi77777: checks 
Link_fNK: bets 495
lidi77777: folds 
Uncalled bet (495) returned to Link_fNK
Link_fNK collected 1800 from pot
Link_fNK: doesn't show hand 
*** SUMMARY ***
Total pot 1800 | Rake 0 
Board [6d As 2s]
Seat 1: lucaromanoo1 folded before Flop (didn't bet)
Seat 2: anth0nypappa folded before Flop (didn't bet)
Seat 3: sinister778 (button) folded before Flop (didn't bet)
Seat 4: mehditheboss (small blind) folded before Flop
Seat 5: lidi77777 (big blind) folded on the Flop
Seat 6: Link_fNK collected (1800)

PokerStars Hand #251209476942: Tournament #3769361908, $52.38+$2.62 USD Hold'em No Limit - Level IX (150/300) - 2024/06/26 22:28:07 UTC [2024/06/26 18:28:07 ET]
Table '3769361908 1' 6-max Seat #4 is the button
Seat 1: lucaromanoo1 (6664 in chips) 
Seat 2: anth0nypappa (10820 in chips) 
Seat 3: sinister778 (6449 in chips) 
Seat 4: mehditheboss (11385 in chips) 
Seat 5: lidi77777 (16268 in chips) 
Seat 6: Link_fNK (12423 in chips) 
lucaromanoo1: posts the ante 75
anth0nypappa: posts the ante 75
sinister778: posts the ante 75
mehditheboss: posts the ante 75
lidi77777: posts the ante 75
Link_fNK: posts the ante 75
lidi77777: posts small blind 150
Link_fNK: posts big blind 300
*** HOLE CARDS ***
lucaromanoo1: folds 
anth0nypappa: raises 300 to 600
sinister778: raises 5774 to 6374 and is all-in
mehditheboss: folds 
lidi77777: folds 
Link_fNK: folds 
anth0nypappa: folds 
Uncalled bet (5774) returned to sinister778
sinister778 collected 2100 from pot
*** SUMMARY ***
Total pot 2100 | Rake 0 
Seat 1: lucaromanoo1 folded before Flop (didn't bet)
Seat 2: anth0nypappa folded before Flop
Seat 3: sinister778 collected (2100)
Seat 4: mehditheboss (button) folded before Flop (didn't bet)
Seat 5: lidi77777 (small blind) folded before Flop
Seat 6: Link_fNK (big blind) folded before Flop

PokerStars Hand #251209485257: Tournament #3769361908, $52.38+$2.62 USD Hold'em No Limit - Level IX (150/300) - 2024/06/26 22:28:37 UTC [2024/06/26 18:28:37 ET]
Table '3769361908 1' 6-max Seat #5 is the button
Seat 1: lucaromanoo1 (6589 in chips) 
Seat 2: anth0nypappa (10145 in chips) 
Seat 3: sinister778 (7874 in chips) 
Seat 4: mehditheboss (11310 in chips) 
Seat 5: lidi77777 (16043 in chips) 
Seat 6: Link_fNK (12048 in chips) 
lucaromanoo1: posts the ante 75
anth0nypappa: posts the ante 75
sinister778: posts the ante 75
mehditheboss: posts the ante 75
lidi77777: posts the ante 75
Link_fNK: posts the ante 75
Link_fNK: posts small blind 150
lucaromanoo1: posts big blind 300
*** HOLE CARDS ***
anth0nypappa: folds 
sinister778: folds 
mehditheboss: folds 
lidi77777: raises 300 to 600
Link_fNK: raises 1650 to 2250
lucaromanoo1: folds 
lidi77777: calls 1650
*** FLOP *** [Ac 2c Ad]
Link_fNK: bets 1380
lidi77777: calls 1380
*** TURN *** [Ac 2c Ad] [7c]
Link_fNK: bets 2669
lidi77777: calls 2669
*** RIVER *** [Ac 2c Ad 7c] [5c]
Link_fNK: bets 5674 and is all-in
lidi77777: calls 5674
*** SHOW DOWN ***
Link_fNK: shows [Kc As] (a flush, Ace high)
lidi77777: shows [8c Qc] (a flush, Ace high - lower cards)
Link_fNK collected 24696 from pot
*** SUMMARY ***
Total pot 24696 | Rake 0 
Board [Ac 2c Ad 7c 5c]
Seat 1: lucaromanoo1 (big blind) folded before Flop
Seat 2: anth0nypappa folded before Flop (didn't bet)
Seat 3: sinister778 folded before Flop (didn't bet)
Seat 4: mehditheboss folded before Flop (didn't bet)
Seat 5: lidi77777 (button) showed [8c Qc] and lost with a flush, Ace high
Seat 6: Link_fNK (small blind) showed [Kc As] and won (24696) with a flush, Ace high

PokerStars Hand #251209513937: Tournament #3769361908, $52.38+$2.62 USD Hold'em No Limit - Level X (200/400) - 2024/06/26 22:30:20 UTC [2024/06/26 18:30:20 ET]
Table '3769361908 1' 6-max Seat #6 is the button
Seat 1: lucaromanoo1 (6214 in chips) 
Seat 2: anth0nypappa (10070 in chips) 
Seat 3: sinister778 (7799 in chips) 
Seat 4: mehditheboss (11235 in chips) 
Seat 5: lidi77777 (3995 in chips) 
Seat 6: Link_fNK (24696 in chips) 
lucaromanoo1: posts the ante 100
anth0nypappa: posts the ante 100
sinister778: posts the ante 100
mehditheboss: posts the ante 100
lidi77777: posts the ante 100
Link_fNK: posts the ante 100
lucaromanoo1: posts small blind 200
anth0nypappa: posts big blind 400
*** HOLE CARDS ***
sinister778: folds 
mehditheboss: raises 400 to 800
lidi77777: raises 3095 to 3895 and is all-in
Link_fNK: folds 
lucaromanoo1: folds 
anth0nypappa: folds 
mehditheboss: calls 3095
*** FLOP *** [7d Kh 6d]
*** TURN *** [7d Kh 6d] [Js]
*** RIVER *** [7d Kh 6d Js] [Td]
*** SHOW DOWN ***
mehditheboss: shows [9s 7s] (a pair of Sevens)
lidi77777: shows [Kc Tc] (two pair, Kings and Tens)
lidi77777 collected 8990 from pot
*** SUMMARY ***
Total pot 8990 | Rake 0 
Board [7d Kh 6d Js Td]
Seat 1: lucaromanoo1 (small blind) folded before Flop
Seat 2: anth0nypappa (big blind) folded before Flop
Seat 3: sinister778 folded before Flop (didn't bet)
Seat 4: mehditheboss showed [9s 7s] and lost with a pair of Sevens
Seat 5: lidi77777 showed [Kc Tc] and won (8990) with two pair, Kings and Tens
Seat 6: Link_fNK (button) folded before Flop (didn't bet)

PokerStars Hand #251209521767: Tournament #3769361908, $52.38+$2.62 USD Hold'em No Limit - Level X (200/400) - 2024/06/26 22:30:48 UTC [2024/06/26 18:30:48 ET]
Table '3769361908 1' 6-max Seat #1 is the button
Seat 1: lucaromanoo1 (5914 in chips) 
Seat 2: anth0nypappa (9570 in chips) 
Seat 3: sinister778 (7699 in chips) 
Seat 4: mehditheboss (7240 in chips) 
Seat 5: lidi77777 (8990 in chips) 
Seat 6: Link_fNK (24596 in chips) 
lucaromanoo1: posts the ante 100
anth0nypappa: posts the ante 100
sinister778: posts the ante 100
mehditheboss: posts the ante 100
lidi77777: posts the ante 100
Link_fNK: posts the ante 100
anth0nypappa: posts small blind 200
sinister778: posts big blind 400
*** HOLE CARDS ***
mehditheboss: folds 
lidi77777: folds 
Link_fNK: folds 
lucaromanoo1: folds 
anth0nypappa: raises 9070 to 9470 and is all-in
sinister778: calls 7199 and is all-in
Uncalled bet (1871) returned to anth0nypappa
*** FLOP *** [Ad Kd 4h]
*** TURN *** [Ad Kd 4h] [Ts]
*** RIVER *** [Ad Kd 4h Ts] [Kh]
*** SHOW DOWN ***
anth0nypappa: shows [Jc 9h] (a pair of Kings)
sinister778: shows [2s Kc] (three of a kind, Kings)
sinister778 collected 15798 from pot
*** SUMMARY ***
Total pot 15798 | Rake 0 
Board [Ad Kd 4h Ts Kh]
Seat 1: lucaromanoo1 (button) folded before Flop (didn't bet)
Seat 2: anth0nypappa (small blind) showed [Jc 9h] and lost with a pair of Kings
Seat 3: sinister778 (big blind) showed [2s Kc] and won (15798) with three of a kind, Kings
Seat 4: mehditheboss folded before Flop (didn't bet)
Seat 5: lidi77777 folded before Flop (didn't bet)
Seat 6: Link_fNK folded before Flop (didn't bet)

PokerStars Hand #251209527139: Tournament #3769361908, $52.38+$2.62 USD Hold'em No Limit - Level X (200/400) - 2024/06/26 22:31:08 UTC [2024/06/26 18:31:08 ET]
Table '3769361908 1' 6-max Seat #2 is the button
Seat 1: lucaromanoo1 (5814 in chips) 
Seat 2: anth0nypappa (1871 in chips) 
Seat 3: sinister778 (15798 in chips) 
Seat 5: lidi77777 (8890 in chips) 
Seat 6: Link_fNK (24496 in chips) 
lucaromanoo1: posts the ante 100
anth0nypappa: posts the ante 100
sinister778: posts the ante 100
lidi77777: posts the ante 100
Link_fNK: posts the ante 100
sinister778: posts small blind 200
lidi77777: posts big blind 400
*** HOLE CARDS ***
Link_fNK: folds 
lucaromanoo1: raises 5314 to 5714 and is all-in
phcrf is disconnected 
anth0nypappa: folds 
sinister778: folds 
lidi77777: folds 
Uncalled bet (5314) returned to lucaromanoo1
lucaromanoo1 collected 1500 from pot
*** SUMMARY ***
Total pot 1500 | Rake 0 
Seat 1: lucaromanoo1 collected (1500)
Seat 2: anth0nypappa (button) folded before Flop (didn't bet)
Seat 3: sinister778 (small blind) folded before Flop
Seat 5: lidi77777 (big blind) folded before Flop
Seat 6: Link_fNK folded before Flop (didn't bet)

PokerStars Hand #251209534160: Tournament #3769361908, $52.38+$2.62 USD Hold'em No Limit - Level X (200/400) - 2024/06/26 22:31:33 UTC [2024/06/26 18:31:33 ET]
Table '3769361908 1' 6-max Seat #3 is the button
Seat 1: lucaromanoo1 (6814 in chips) 
Seat 2: anth0nypappa (1771 in chips) 
Seat 3: sinister778 (15498 in chips) 
Seat 4: phcrf (10000 in chips) out of hand (moved from another table into small blind)
Seat 5: lidi77777 (8390 in chips) 
Seat 6: Link_fNK (24396 in chips) 
phcrf will be allowed to play after the button
lucaromanoo1: posts the ante 100
anth0nypappa: posts the ante 100
sinister778: posts the ante 100
lidi77777: posts the ante 100
Link_fNK: posts the ante 100
lidi77777: posts small blind 200
Link_fNK: posts big blind 400
*** HOLE CARDS ***
lucaromanoo1: folds 
anth0nypappa: folds 
sinister778: folds 
lidi77777: raises 7890 to 8290 and is all-in
Link_fNK: folds 
Uncalled bet (7890) returned to lidi77777
lidi77777 collected 1300 from pot
*** SUMMARY ***
Total pot 1300 | Rake 0 
Seat 1: lucaromanoo1 folded before Flop (didn't bet)
Seat 2: anth0nypappa folded before Flop (didn't bet)
Seat 3: sinister778 (button) folded before Flop (didn't bet)
Seat 5: lidi77777 (small blind) collected (1300)
Seat 6: Link_fNK (big blind) folded before Flop

PokerStars Hand #251209537700: Tournament #3769361908, $52.38+$2.62 USD Hold'em No Limit - Level X (200/400) - 2024/06/26 22:31:46 UTC [2024/06/26 18:31:46 ET]
Table '3769361908 1' 6-max Seat #5 is the button
Seat 1: lucaromanoo1 (6714 in chips) 
Seat 2: anth0nypappa (1671 in chips) 
Seat 3: sinister778 (15398 in chips) 
Seat 4: phcrf (10000 in chips) 
Seat 5: lidi77777 (9190 in chips) 
Seat 6: Link_fNK (23896 in chips) 
lucaromanoo1: posts the ante 100
anth0nypappa: posts the ante 100
sinister778: posts the ante 100
phcrf: posts the ante 100
lidi77777: posts the ante 100
Link_fNK: posts the ante 100
Link_fNK: posts small blind 200
lucaromanoo1: posts big blind 400
*** HOLE CARDS ***
anth0nypappa: folds 
sinister778: folds 
phcrf: raises 400 to 800
lidi77777: calls 800
Link_fNK: folds 
lucaromanoo1: folds 
*** FLOP *** [Js 9h 9c]
phcrf: checks 
lidi77777: bets 800
phcrf: calls 800
*** TURN *** [Js 9h 9c] [Qh]
phcrf: checks 
lidi77777: bets 1800
phcrf: calls 1800
*** RIVER *** [Js 9h 9c Qh] [Ah]
phcrf: checks 
lidi77777: checks 
*** SHOW DOWN ***
phcrf: shows [Jh Jc] (a full house, Jacks full of Nines)
lidi77777: mucks hand 
phcrf collected 8000 from pot
*** SUMMARY ***
Total pot 8000 | Rake 0 
Board [Js 9h 9c Qh Ah]
Seat 1: lucaromanoo1 (big blind) folded before Flop
Seat 2: anth0nypappa folded before Flop (didn't bet)
Seat 3: sinister778 folded before Flop (didn't bet)
Seat 4: phcrf showed [Jh Jc] and won (8000) with a full house, Jacks full of Nines
Seat 5: lidi77777 (button) mucked
Seat 6: Link_fNK (small blind) folded before Flop

PokerStars Hand #251209555068: Tournament #3769361908, $52.38+$2.62 USD Hold'em No Limit - Level XI (250/500) - 2024/06/26 22:32:50 UTC [2024/06/26 18:32:50 ET]
Table '3769361908 1' 6-max Seat #6 is the button
Seat 1: lucaromanoo1 (6214 in chips) 
Seat 2: anth0nypappa (1571 in chips) 
Seat 3: sinister778 (15298 in chips) 
Seat 4: phcrf (14500 in chips) 
Seat 5: lidi77777 (5690 in chips) 
Seat 6: Link_fNK (23596 in chips) 
lucaromanoo1: posts the ante 125
anth0nypappa: posts the ante 125
sinister778: posts the ante 125
phcrf: posts the ante 125
lidi77777: posts the ante 125
Link_fNK: posts the ante 125
lucaromanoo1: posts small blind 250
anth0nypappa: posts big blind 500
*** HOLE CARDS ***
sinister778: folds 
phcrf: folds 
lidi77777: raises 5065 to 5565 and is all-in
Link_fNK: folds 
lucaromanoo1: folds 
anth0nypappa: calls 946 and is all-in
Uncalled bet (4119) returned to lidi77777
*** FLOP *** [2c 3s Jc]
*** TURN *** [2c 3s Jc] [6h]
*** RIVER *** [2c 3s Jc 6h] [4s]
*** SHOW DOWN ***
anth0nypappa: shows [2d 8d] (a pair of Deuces)
lidi77777: shows [Kd 9s] (high card King)
anth0nypappa collected 3892 from pot
*** SUMMARY ***
Total pot 3892 | Rake 0 
Board [2c 3s Jc 6h 4s]
Seat 1: lucaromanoo1 (small blind) folded before Flop
Seat 2: anth0nypappa (big blind) showed [2d 8d] and won (3892) with a pair of Deuces
Seat 3: sinister778 folded before Flop (didn't bet)
Seat 4: phcrf folded before Flop (didn't bet)
Seat 5: lidi77777 showed [Kd 9s] and lost with high card King
Seat 6: Link_fNK (button) folded before Flop (didn't bet)

PokerStars Hand #251209561660: Tournament #3769361908, $52.38+$2.62 USD Hold'em No Limit - Level XI (250/500) - 2024/06/26 22:33:15 UTC [2024/06/26 18:33:15 ET]
Table '3769361908 1' 6-max Seat #1 is the button
Seat 1: lucaromanoo1 (5839 in chips) 
Seat 2: anth0nypappa (3892 in chips) 
Seat 3: sinister778 (15173 in chips) 
Seat 4: phcrf (14375 in chips) 
Seat 5: lidi77777 (4119 in chips) 
Seat 6: Link_fNK (23471 in chips) 
lucaromanoo1: posts the ante 125
anth0nypappa: posts the ante 125
sinister778: posts the ante 125
phcrf: posts the ante 125
lidi77777: posts the ante 125
Link_fNK: posts the ante 125
anth0nypappa: posts small blind 250
sinister778: posts big blind 500
*** HOLE CARDS ***
phcrf: folds 
lidi77777: raises 3494 to 3994 and is all-in
Link_fNK: folds 
lucaromanoo1: folds 
anth0nypappa: folds 
sinister778: folds 
Uncalled bet (3494) returned to lidi77777
lidi77777 collected 2000 from pot
*** SUMMARY ***
Total pot 2000 | Rake 0 
Seat 1: lucaromanoo1 (button) folded before Flop (didn't bet)
Seat 2: anth0nypappa (small blind) folded before Flop
Seat 3: sinister778 (big blind) folded before Flop
Seat 4: phcrf folded before Flop (didn't bet)
Seat 5: lidi77777 collected (2000)
Seat 6: Link_fNK folded before Flop (didn't bet)

PokerStars Hand #251209567503: Tournament #3769361908, $52.38+$2.62 USD Hold'em No Limit - Level XI (250/500) - 2024/06/26 22:33:37 UTC [2024/06/26 18:33:37 ET]
Table '3769361908 1' 6-max Seat #2 is the button
Seat 1: lucaromanoo1 (5714 in chips) 
Seat 2: anth0nypappa (3517 in chips) 
Seat 3: sinister778 (14548 in chips) 
Seat 4: phcrf (14250 in chips) 
Seat 5: lidi77777 (5494 in chips) 
Seat 6: Link_fNK (23346 in chips) 
lucaromanoo1: posts the ante 125
anth0nypappa: posts the ante 125
sinister778: posts the ante 125
phcrf: posts the ante 125
lidi77777: posts the ante 125
Link_fNK: posts the ante 125
sinister778: posts small blind 250
phcrf: posts big blind 500
*** HOLE CARDS ***
lidi77777: calls 500
Link_fNK: folds 
lucaromanoo1: raises 5089 to 5589 and is all-in
anth0nypappa: folds 
sinister778: folds 
phcrf: folds 
lidi77777: calls 4869 and is all-in
Uncalled bet (220) returned to lucaromanoo1
*** FLOP *** [2d Qc 6c]
*** TURN *** [2d Qc 6c] [6s]
*** RIVER *** [2d Qc 6c 6s] [6h]
*** SHOW DOWN ***
lidi77777: shows [Ad Ah] (a full house, Sixes full of Aces)
lucaromanoo1: shows [8s 8d] (a full house, Sixes full of Eights)
lidi77777 collected 12238 from pot
*** SUMMARY ***
Total pot 12238 | Rake 0 
Board [2d Qc 6c 6s 6h]
Seat 1: lucaromanoo1 showed [8s 8d] and lost with a full house, Sixes full of Eights
Seat 2: anth0nypappa (button) folded before Flop (didn't bet)
Seat 3: sinister778 (small blind) folded before Flop
Seat 4: phcrf (big blind) folded before Flop
Seat 5: lidi77777 showed [Ad Ah] and won (12238) with a full house, Sixes full of Aces
Seat 6: Link_fNK folded before Flop (didn't bet)

PokerStars Hand #251209576426: Tournament #3769361908, $52.38+$2.62 USD Hold'em No Limit - Level XI (250/500) - 2024/06/26 22:34:10 UTC [2024/06/26 18:34:10 ET]
Table '3769361908 1' 6-max Seat #3 is the button
Seat 1: lucaromanoo1 (220 in chips) 
Seat 2: anth0nypappa (3392 in chips) 
Seat 3: sinister778 (14173 in chips) 
Seat 4: phcrf (13625 in chips) 
Seat 5: lidi77777 (12238 in chips) 
Seat 6: Link_fNK (23221 in chips) 
lucaromanoo1: posts the ante 125
anth0nypappa: posts the ante 125
sinister778: posts the ante 125
phcrf: posts the ante 125
lidi77777: posts the ante 125
Link_fNK: posts the ante 125
phcrf: posts small blind 250
lidi77777: posts big blind 500
*** HOLE CARDS ***
Link_fNK: raises 500 to 1000
lucaromanoo1: folds 
anth0nypappa: folds 
sinister778: calls 1000
phcrf: folds 
lidi77777: folds 
*** FLOP *** [6s Kd Qh]
Link_fNK: checks 
sinister778: bets 1500
Link_fNK: folds 
Uncalled bet (1500) returned to sinister778
sinister778 collected 3500 from pot
*** SUMMARY ***
Total pot 3500 | Rake 0 
Board [6s Kd Qh]
Seat 1: lucaromanoo1 folded before Flop (didn't bet)
Seat 2: anth0nypappa folded before Flop (didn't bet)
Seat 3: sinister778 (button) collected (3500)
Seat 4: phcrf (small blind) folded before Flop
Seat 5: lidi77777 (big blind) folded before Flop
Seat 6: Link_fNK folded on the Flop

PokerStars Hand #251209588785: Tournament #3769361908, $52.38+$2.62 USD Hold'em No Limit - Level XI (250/500) - 2024/06/26 22:34:55 UTC [2024/06/26 18:34:55 ET]
Table '3769361908 1' 6-max Seat #4 is the button
Seat 1: lucaromanoo1 (95 in chips) 
Seat 2: anth0nypappa (3267 in chips) 
Seat 3: sinister778 (16548 in chips) 
Seat 4: phcrf (13250 in chips) 
Seat 5: lidi77777 (11613 in chips) 
Seat 6: Link_fNK (22096 in chips) 
lucaromanoo1: posts the ante 95 and is all-in
anth0nypappa: posts the ante 125
sinister778: posts the ante 125
phcrf: posts the ante 125
lidi77777: posts the ante 125
Link_fNK: posts the ante 125
lidi77777: posts small blind 250
Link_fNK: posts big blind 500
*** HOLE CARDS ***
anth0nypappa is disconnected 
anth0nypappa has timed out while disconnected
anth0nypappa: folds 
anth0nypappa is sitting out
sinister778: folds 
phcrf: folds 
lucaromanoo1 is disconnected 
lidi77777: raises 10988 to 11488 and is all-in
Link_fNK: calls 10988
*** FLOP *** [7d 5c 5s]
*** TURN *** [7d 5c 5s] [6d]
*** RIVER *** [7d 5c 5s 6d] [2c]
*** SHOW DOWN ***
lidi77777: shows [2h 7h] (two pair, Sevens and Fives)
Link_fNK: shows [Qs Qh] (two pair, Queens and Fives)
Link_fNK collected 23126 from side pot
lucaromanoo1: shows [4s Qd] (a pair of Fives)
lucaromanoo1 is disconnected 
Link_fNK collected 570 from main pot
lidi77777 finished the tournament
lucaromanoo1 finished the tournament
*** SUMMARY ***
Total pot 23696 Main pot 570. Side pot 23126. | Rake 0 
Board [7d 5c 5s 6d 2c]
Seat 1: lucaromanoo1 showed [4s Qd] and lost with a pair of Fives
Seat 2: anth0nypappa folded before Flop (didn't bet)
Seat 3: sinister778 folded before Flop (didn't bet)
Seat 4: phcrf (button) folded before Flop (didn't bet)
Seat 5: lidi77777 (small blind) showed [2h 7h] and lost with two pair, Sevens and Fives
Seat 6: Link_fNK (big blind) showed [Qs Qh] and won (23696) with two pair, Queens and Fives

PokerStars Hand #251209607786: Tournament #3769361908, $52.38+$2.62 USD Hold'em No Limit - Level XII (300/600) - 2024/06/26 22:36:06 UTC [2024/06/26 18:36:06 ET]
Table '3769361908 1' 6-max Seat #6 is the button
Seat 1: Accio Aces1 (37044 in chips) out of hand (moved from another table into small blind)
Seat 2: anth0nypappa (3142 in chips) is sitting out
Seat 3: sinister778 (16423 in chips) 
Seat 4: phcrf (13125 in chips) 
Seat 6: Link_fNK (34179 in chips) 
Accio Aces1 will be allowed to play after the button
anth0nypappa: posts the ante 150
sinister778: posts the ante 150
phcrf: posts the ante 150
Link_fNK: posts the ante 150
anth0nypappa: posts small blind 300
sinister778: posts big blind 600
*** HOLE CARDS ***
joaoMathias is disconnected 
phcrf: folds 
Link_fNK: raises 600 to 1200
anth0nypappa: folds 
sinister778: calls 600
*** FLOP *** [2s Js 9s]
sinister778: checks 
Link_fNK: bets 825
sinister778: calls 825
*** TURN *** [2s Js 9s] [Td]
sinister778: checks 
Link_fNK: bets 3720
sinister778: calls 3720
*** RIVER *** [2s Js 9s Td] [5d]
sinister778: checks 
Link_fNK: bets 12390
sinister778: calls 10528 and is all-in
Uncalled bet (1862) returned to Link_fNK
*** SHOW DOWN ***
Link_fNK: shows [Ad 3s] (high card Ace)
sinister778: shows [Th Jd] (two pair, Jacks and Tens)
sinister778 collected 33446 from pot
*** SUMMARY ***
Total pot 33446 | Rake 0 
Board [2s Js 9s Td 5d]
Seat 2: anth0nypappa (small blind) folded before Flop
Seat 3: sinister778 (big blind) showed [Th Jd] and won (33446) with two pair, Jacks and Tens
Seat 4: phcrf folded before Flop (didn't bet)
Seat 6: Link_fNK (button) showed [Ad 3s] and lost with high card Ace

PokerStars Hand #251209634091: Tournament #3769361908, $52.38+$2.62 USD Hold'em No Limit - Level XII (300/600) - 2024/06/26 22:37:45 UTC [2024/06/26 18:37:45 ET]
Table '3769361908 1' 6-max Seat #2 is the button
Seat 1: Accio Aces1 (37044 in chips) 
Seat 2: anth0nypappa (2692 in chips) is sitting out
Seat 3: sinister778 (33446 in chips) 
Seat 4: phcrf (12975 in chips) 
Seat 5: joaoMathias (9850 in chips) 
Seat 6: Link_fNK (17756 in chips) 
Accio Aces1: posts the ante 150
anth0nypappa: posts the ante 150
sinister778: posts the ante 150
phcrf: posts the ante 150
joaoMathias: posts the ante 150
Link_fNK: posts the ante 150
sinister778: posts small blind 300
phcrf: posts big blind 600
*** HOLE CARDS ***
joaoMathias: folds 
Link_fNK: folds 
Accio Aces1: folds 
anth0nypappa: folds 
sinister778: raises 1200 to 1800
phcrf: folds [2c]
Uncalled bet (1200) returned to sinister778
sinister778 collected 2100 from pot
*** SUMMARY ***
Total pot 2100 | Rake 0 
Seat 1: Accio Aces1 folded before Flop (didn't bet)
Seat 2: anth0nypappa (button) folded before Flop (didn't bet)
Seat 3: sinister778 (small blind) collected (2100)
Seat 4: phcrf (big blind) folded before Flop
Seat 5: joaoMathias folded before Flop (didn't bet)
Seat 6: Link_fNK folded before Flop (didn't bet)

PokerStars Hand #251209645530: Tournament #3769361908, $52.38+$2.62 USD Hold'em No Limit - Level XIII (400/800) - 2024/06/26 22:38:27 UTC [2024/06/26 18:38:27 ET]
Table '3769361908 1' 6-max Seat #3 is the button
Seat 1: Accio Aces1 (36894 in chips) 
Seat 2: anth0nypappa (2542 in chips) is sitting out
Seat 3: sinister778 (34796 in chips) 
Seat 4: phcrf (12225 in chips) 
Seat 5: joaoMathias (9700 in chips) 
Seat 6: Link_fNK (17606 in chips) 
Accio Aces1: posts the ante 200
anth0nypappa: posts the ante 200
sinister778: posts the ante 200
phcrf: posts the ante 200
joaoMathias: posts the ante 200
Link_fNK: posts the ante 200
phcrf: posts small blind 400
joaoMathias: posts big blind 800
*** HOLE CARDS ***
Link_fNK: folds 
Accio Aces1: folds 
anth0nypappa: folds 
sinister778: folds 
phcrf: raises 11225 to 12025 and is all-in
joaoMathias: calls 8700 and is all-in
Uncalled bet (2525) returned to phcrf
*** FLOP *** [5h Kc Th]
*** TURN *** [5h Kc Th] [Ks]
*** RIVER *** [5h Kc Th Ks] [Jd]
*** SHOW DOWN ***
phcrf: shows [Js 6s] (two pair, Kings and Jacks)
joaoMathias: shows [9h 9s] (two pair, Kings and Nines)
phcrf collected 20200 from pot
joaoMathias finished the tournament
*** SUMMARY ***
Total pot 20200 | Rake 0 
Board [5h Kc Th Ks Jd]
Seat 1: Accio Aces1 folded before Flop (didn't bet)
Seat 2: anth0nypappa folded before Flop (didn't bet)
Seat 3: sinister778 (button) folded before Flop (didn't bet)
Seat 4: phcrf (small blind) showed [Js 6s] and won (20200) with two pair, Kings and Jacks
Seat 5: joaoMathias (big blind) showed [9h 9s] and lost with two pair, Kings and Nines
Seat 6: Link_fNK folded before Flop (didn't bet)

PokerStars Hand #251209652982: Tournament #3769361908, $52.38+$2.62 USD Hold'em No Limit - Level XIII (400/800) - 2024/06/26 22:38:55 UTC [2024/06/26 18:38:55 ET]
Table '3769361908 1' 6-max Seat #4 is the button
Seat 1: Accio Aces1 (36694 in chips) 
Seat 2: anth0nypappa (2342 in chips) is sitting out
Seat 3: sinister778 (34596 in chips) 
Seat 4: phcrf (22725 in chips) 
Seat 6: Link_fNK (17406 in chips) 
Accio Aces1: posts the ante 200
anth0nypappa: posts the ante 200
sinister778: posts the ante 200
phcrf: posts the ante 200
Link_fNK: posts the ante 200
Link_fNK: posts small blind 400
Accio Aces1: posts big blind 800
*** HOLE CARDS ***
anth0nypappa: folds 
sinister778: folds 
phcrf: raises 800 to 1600
Link_fNK: folds 
Accio Aces1: raises 34894 to 36494 and is all-in
phcrf: calls 20925 and is all-in
Uncalled bet (13969) returned to Accio Aces1
*** FLOP *** [Qh 9c 8s]
*** TURN *** [Qh 9c 8s] [4h]
*** RIVER *** [Qh 9c 8s 4h] [5d]
*** SHOW DOWN ***
Accio Aces1: shows [5s 4s] (two pair, Fives and Fours)
phcrf: shows [As Kh] (high card Ace)
Accio Aces1 collected 46450 from pot
phcrf finished the tournament
*** SUMMARY ***
Total pot 46450 | Rake 0 
Board [Qh 9c 8s 4h 5d]
Seat 1: Accio Aces1 (big blind) showed [5s 4s] and won (46450) with two pair, Fives and Fours
Seat 2: anth0nypappa folded before Flop (didn't bet)
Seat 3: sinister778 folded before Flop (didn't bet)
Seat 4: phcrf (button) showed [As Kh] and lost with high card Ace
Seat 6: Link_fNK (small blind) folded before Flop


PokerStars Hand #251209421633: Tournament #3769361908, $52.38+$2.62 USD Hold'em No Limit - Level VIII (125/250) - 2024/06/26 22:24:48 UTC [2024/06/26 18:24:48 ET]
Table '3769361908 16' 6-max Seat #4 is the button
Seat 1: fofAAoBR (24308 in chips) 
Seat 2: SAS_IDS0804 (9940 in chips) 
Seat 3: JonzStars (4132 in chips) 
Seat 4: MagoDelBaralho (8756 in chips) 
Seat 5: VICTOR TXR1 (9617 in chips) 
Seat 6: XxJoaoFeraxX (11346 in chips) 
fofAAoBR: posts the ante 60
SAS_IDS0804: posts the ante 60
JonzStars: posts the ante 60
MagoDelBaralho: posts the ante 60
VICTOR TXR1: posts the ante 60
XxJoaoFeraxX: posts the ante 60
VICTOR TXR1: posts small blind 125
XxJoaoFeraxX: posts big blind 250
*** HOLE CARDS ***
fofAAoBR: folds 
SAS_IDS0804: folds 
JonzStars: raises 250 to 500
MagoDelBaralho: folds 
VICTOR TXR1: folds 
XxJoaoFeraxX: folds 
Uncalled bet (250) returned to JonzStars
JonzStars collected 985 from pot
*** SUMMARY ***
Total pot 985 | Rake 0 
Seat 1: fofAAoBR folded before Flop (didn't bet)
Seat 2: SAS_IDS0804 folded before Flop (didn't bet)
Seat 3: JonzStars collected (985)
Seat 4: MagoDelBaralho (button) folded before Flop (didn't bet)
Seat 5: VICTOR TXR1 (small blind) folded before Flop
Seat 6: XxJoaoFeraxX (big blind) folded before Flop

PokerStars Hand #251209428726: Tournament #3769361908, $52.38+$2.62 USD Hold'em No Limit - Level VIII (125/250) - 2024/06/26 22:25:14 UTC [2024/06/26 18:25:14 ET]
Table '3769361908 16' 6-max Seat #5 is the button
Seat 1: fofAAoBR (24248 in chips) 
Seat 2: SAS_IDS0804 (9880 in chips) 
Seat 3: JonzStars (4807 in chips) 
Seat 4: MagoDelBaralho (8696 in chips) 
Seat 5: VICTOR TXR1 (9432 in chips) 
Seat 6: XxJoaoFeraxX (11036 in chips) 
fofAAoBR: posts the ante 60
SAS_IDS0804: posts the ante 60
JonzStars: posts the ante 60
MagoDelBaralho: posts the ante 60
VICTOR TXR1: posts the ante 60
XxJoaoFeraxX: posts the ante 60
XxJoaoFeraxX: posts small blind 125
fofAAoBR: posts big blind 250
*** HOLE CARDS ***
SAS_IDS0804: folds 
JonzStars: folds 
MagoDelBaralho: folds 
VICTOR TXR1: folds 
XxJoaoFeraxX: calls 125
fofAAoBR: raises 750 to 1000
XxJoaoFeraxX: folds 
Uncalled bet (750) returned to fofAAoBR
fofAAoBR collected 860 from pot
fofAAoBR: doesn't show hand 
*** SUMMARY ***
Total pot 860 | Rake 0 
Seat 1: fofAAoBR (big blind) collected (860)
Seat 2: SAS_IDS0804 folded before Flop (didn't bet)
Seat 3: JonzStars folded before Flop (didn't bet)
Seat 4: MagoDelBaralho folded before Flop (didn't bet)
Seat 5: VICTOR TXR1 (button) folded before Flop (didn't bet)
Seat 6: XxJoaoFeraxX (small blind) folded before Flop

PokerStars Hand #251209440366: Tournament #3769361908, $52.38+$2.62 USD Hold'em No Limit - Level VIII (125/250) - 2024/06/26 22:25:56 UTC [2024/06/26 18:25:56 ET]
Table '3769361908 16' 6-max Seat #6 is the button
Seat 1: fofAAoBR (24798 in chips) 
Seat 2: SAS_IDS0804 (9820 in chips) 
Seat 3: JonzStars (4747 in chips) 
Seat 4: MagoDelBaralho (8636 in chips) 
Seat 5: VICTOR TXR1 (9372 in chips) 
Seat 6: XxJoaoFeraxX (10726 in chips) 
fofAAoBR: posts the ante 60
SAS_IDS0804: posts the ante 60
JonzStars: posts the ante 60
MagoDelBaralho: posts the ante 60
VICTOR TXR1: posts the ante 60
XxJoaoFeraxX: posts the ante 60
fofAAoBR: posts small blind 125
SAS_IDS0804: posts big blind 250
*** HOLE CARDS ***
JonzStars: folds 
MagoDelBaralho: folds 
VICTOR TXR1: folds 
XxJoaoFeraxX: raises 250 to 500
fofAAoBR: calls 375
SAS_IDS0804: calls 250
*** FLOP *** [2d Jd Qd]
fofAAoBR: checks 
SAS_IDS0804: checks 
XxJoaoFeraxX: checks 
*** TURN *** [2d Jd Qd] [Tc]
fofAAoBR: checks 
SAS_IDS0804: checks 
XxJoaoFeraxX: checks 
*** RIVER *** [2d Jd Qd Tc] [Th]
fofAAoBR: checks 
SAS_IDS0804: checks 
XxJoaoFeraxX: bets 614
fofAAoBR: folds 
SAS_IDS0804: folds 
Uncalled bet (614) returned to XxJoaoFeraxX
XxJoaoFeraxX collected 1860 from pot
XxJoaoFeraxX: doesn't show hand 
*** SUMMARY ***
Total pot 1860 | Rake 0 
Board [2d Jd Qd Tc Th]
Seat 1: fofAAoBR (small blind) folded on the River
Seat 2: SAS_IDS0804 (big blind) folded on the River
Seat 3: JonzStars folded before Flop (didn't bet)
Seat 4: MagoDelBaralho folded before Flop (didn't bet)
Seat 5: VICTOR TXR1 folded before Flop (didn't bet)
Seat 6: XxJoaoFeraxX (button) collected (1860)

PokerStars Hand #251209470341: Tournament #3769361908, $52.38+$2.62 USD Hold'em No Limit - Level IX (150/300) - 2024/06/26 22:27:44 UTC [2024/06/26 18:27:44 ET]
Table '3769361908 16' 6-max Seat #1 is the button
Seat 1: fofAAoBR (24238 in chips) 
Seat 2: SAS_IDS0804 (9260 in chips) 
Seat 3: JonzStars (4687 in chips) 
Seat 4: MagoDelBaralho (8576 in chips) 
Seat 5: VICTOR TXR1 (9312 in chips) 
Seat 6: XxJoaoFeraxX (12026 in chips) 
fofAAoBR: posts the ante 75
SAS_IDS0804: posts the ante 75
JonzStars: posts the ante 75
MagoDelBaralho: posts the ante 75
VICTOR TXR1: posts the ante 75
XxJoaoFeraxX: posts the ante 75
SAS_IDS0804: posts small blind 150
JonzStars: posts big blind 300
*** HOLE CARDS ***
MagoDelBaralho: folds 
VICTOR TXR1: raises 348 to 648
XxJoaoFeraxX: folds 
fofAAoBR: calls 648
SAS_IDS0804: folds 
JonzStars: folds 
*** FLOP *** [9h Ks 3s]
VICTOR TXR1: checks 
fofAAoBR: checks 
*** TURN *** [9h Ks 3s] [7c]
VICTOR TXR1: bets 1500
fofAAoBR: calls 1500
*** RIVER *** [9h Ks 3s 7c] [5d]
VICTOR TXR1: checks 
fofAAoBR: checks 
*** SHOW DOWN ***
VICTOR TXR1: shows [Ah 5h] (a pair of Fives)
fofAAoBR: shows [Jh Jd] (a pair of Jacks)
fofAAoBR collected 5196 from pot
*** SUMMARY ***
Total pot 5196 | Rake 0 
Board [9h Ks 3s 7c 5d]
Seat 1: fofAAoBR (button) showed [Jh Jd] and won (5196) with a pair of Jacks
Seat 2: SAS_IDS0804 (small blind) folded before Flop
Seat 3: JonzStars (big blind) folded before Flop
Seat 4: MagoDelBaralho folded before Flop (didn't bet)
Seat 5: VICTOR TXR1 showed [Ah 5h] and lost with a pair of Fives
Seat 6: XxJoaoFeraxX folded before Flop (didn't bet)

PokerStars Hand #251209485644: Tournament #3769361908, $52.38+$2.62 USD Hold'em No Limit - Level IX (150/300) - 2024/06/26 22:28:38 UTC [2024/06/26 18:28:38 ET]
Table '3769361908 16' 6-max Seat #2 is the button
Seat 1: fofAAoBR (27211 in chips) 
Seat 2: SAS_IDS0804 (9035 in chips) 
Seat 3: JonzStars (4312 in chips) 
Seat 4: MagoDelBaralho (8501 in chips) 
Seat 5: VICTOR TXR1 (7089 in chips) 
Seat 6: XxJoaoFeraxX (11951 in chips) 
fofAAoBR: posts the ante 75
SAS_IDS0804: posts the ante 75
JonzStars: posts the ante 75
MagoDelBaralho: posts the ante 75
VICTOR TXR1: posts the ante 75
XxJoaoFeraxX: posts the ante 75
JonzStars: posts small blind 150
MagoDelBaralho: posts big blind 300
*** HOLE CARDS ***
VICTOR TXR1: folds 
XxJoaoFeraxX: folds 
fofAAoBR: raises 300 to 600
SAS_IDS0804: folds 
JonzStars: raises 3637 to 4237 and is all-in
MagoDelBaralho: folds 
fofAAoBR: folds 
Uncalled bet (3637) returned to JonzStars
JonzStars collected 1950 from pot
*** SUMMARY ***
Total pot 1950 | Rake 0 
Seat 1: fofAAoBR folded before Flop
Seat 2: SAS_IDS0804 (button) folded before Flop (didn't bet)
Seat 3: JonzStars (small blind) collected (1950)
Seat 4: MagoDelBaralho (big blind) folded before Flop
Seat 5: VICTOR TXR1 folded before Flop (didn't bet)
Seat 6: XxJoaoFeraxX folded before Flop (didn't bet)

PokerStars Hand #251209492386: Tournament #3769361908, $52.38+$2.62 USD Hold'em No Limit - Level IX (150/300) - 2024/06/26 22:29:03 UTC [2024/06/26 18:29:03 ET]
Table '3769361908 16' 6-max Seat #3 is the button
Seat 1: fofAAoBR (26536 in chips) 
Seat 2: SAS_IDS0804 (8960 in chips) 
Seat 3: JonzStars (5587 in chips) 
Seat 4: MagoDelBaralho (8126 in chips) 
Seat 6: XxJoaoFeraxX (11876 in chips) 
fofAAoBR: posts the ante 75
SAS_IDS0804: posts the ante 75
JonzStars: posts the ante 75
MagoDelBaralho: posts the ante 75
XxJoaoFeraxX: posts the ante 75
MagoDelBaralho: posts small blind 150
XxJoaoFeraxX: posts big blind 300
*** HOLE CARDS ***
fofAAoBR: folds 
SAS_IDS0804: folds 
JonzStars: folds 
MagoDelBaralho: folds 
Uncalled bet (150) returned to XxJoaoFeraxX
XxJoaoFeraxX collected 675 from pot
XxJoaoFeraxX: doesn't show hand 
*** SUMMARY ***
Total pot 675 | Rake 0 
Seat 1: fofAAoBR folded before Flop (didn't bet)
Seat 2: SAS_IDS0804 folded before Flop (didn't bet)
Seat 3: JonzStars (button) folded before Flop (didn't bet)
Seat 4: MagoDelBaralho (small blind) folded before Flop
Seat 6: XxJoaoFeraxX (big blind) collected (675)

PokerStars Hand #251209502783: Tournament #3769361908, $52.38+$2.62 USD Hold'em No Limit - Level X (200/400) - 2024/06/26 22:29:40 UTC [2024/06/26 18:29:40 ET]
Table '3769361908 16' 6-max Seat #4 is the button
Seat 1: fofAAoBR (26461 in chips) 
Seat 2: SAS_IDS0804 (8885 in chips) 
Seat 3: JonzStars (5512 in chips) 
Seat 4: MagoDelBaralho (7901 in chips) 
Seat 6: XxJoaoFeraxX (12326 in chips) 
fofAAoBR: posts the ante 100
SAS_IDS0804: posts the ante 100
JonzStars: posts the ante 100
MagoDelBaralho: posts the ante 100
XxJoaoFeraxX: posts the ante 100
XxJoaoFeraxX: posts small blind 200
fofAAoBR: posts big blind 400
*** HOLE CARDS ***
SAS_IDS0804: folds 
JonzStars: folds 
MagoDelBaralho: folds 
XxJoaoFeraxX: calls 200
fofAAoBR: checks 
*** FLOP *** [5h Tc Ad]
XxJoaoFeraxX: checks 
fofAAoBR: bets 400
XxJoaoFeraxX: calls 400
*** TURN *** [5h Tc Ad] [2d]
XxJoaoFeraxX: checks 
fofAAoBR: bets 1470
XxJoaoFeraxX: folds 
Uncalled bet (1470) returned to fofAAoBR
fofAAoBR collected 2100 from pot
fofAAoBR: doesn't show hand 
*** SUMMARY ***
Total pot 2100 | Rake 0 
Board [5h Tc Ad 2d]
Seat 1: fofAAoBR (big blind) collected (2100)
Seat 2: SAS_IDS0804 folded before Flop (didn't bet)
Seat 3: JonzStars folded before Flop (didn't bet)
Seat 4: MagoDelBaralho (button) folded before Flop (didn't bet)
Seat 6: XxJoaoFeraxX (small blind) folded on the Turn

PokerStars Hand #251209516322: Tournament #3769361908, $52.38+$2.62 USD Hold'em No Limit - Level X (200/400) - 2024/06/26 22:30:28 UTC [2024/06/26 18:30:28 ET]
Table '3769361908 16' 6-max Seat #6 is the button
Seat 1: fofAAoBR (27661 in chips) 
Seat 2: SAS_IDS0804 (8785 in chips) 
Seat 3: JonzStars (5412 in chips) 
Seat 4: MagoDelBaralho (7801 in chips) 
Seat 6: XxJoaoFeraxX (11426 in chips) 
fofAAoBR: posts the ante 100
SAS_IDS0804: posts the ante 100
JonzStars: posts the ante 100
MagoDelBaralho: posts the ante 100
XxJoaoFeraxX: posts the ante 100
fofAAoBR: posts small blind 200
SAS_IDS0804: posts big blind 400
*** HOLE CARDS ***
JonzStars: folds 
MagoDelBaralho: folds 
XxJoaoFeraxX: raises 400 to 800
fofAAoBR: folds 
SAS_IDS0804: calls 400
*** FLOP *** [5s Qh 3s]
SAS_IDS0804: checks 
XxJoaoFeraxX: checks 
*** TURN *** [5s Qh 3s] [As]
SAS_IDS0804: checks 
XxJoaoFeraxX: checks 
*** RIVER *** [5s Qh 3s As] [2d]
SAS_IDS0804: bets 7885 and is all-in
XxJoaoFeraxX: folds 
Uncalled bet (7885) returned to SAS_IDS0804
SAS_IDS0804 collected 2300 from pot
SAS_IDS0804: doesn't show hand 
*** SUMMARY ***
Total pot 2300 | Rake 0 
Board [5s Qh 3s As 2d]
Seat 1: fofAAoBR (small blind) folded before Flop
Seat 2: SAS_IDS0804 (big blind) collected (2300)
Seat 3: JonzStars folded before Flop (didn't bet)
Seat 4: MagoDelBaralho folded before Flop (didn't bet)
Seat 6: XxJoaoFeraxX (button) folded on the River

PokerStars Hand #251209539009: Tournament #3769361908, $52.38+$2.62 USD Hold'em No Limit - Level X (200/400) - 2024/06/26 22:31:51 UTC [2024/06/26 18:31:51 ET]
Table '3769361908 16' 6-max Seat #1 is the button
Seat 1: fofAAoBR (27361 in chips) 
Seat 2: SAS_IDS0804 (10185 in chips) 
Seat 3: JonzStars (5312 in chips) 
Seat 4: MagoDelBaralho (7701 in chips) 
Seat 5: mila is best (10000 in chips) 
Seat 6: XxJoaoFeraxX (10526 in chips) 
fofAAoBR: posts the ante 100
SAS_IDS0804: posts the ante 100
JonzStars: posts the ante 100
MagoDelBaralho: posts the ante 100
mila is best: posts the ante 100
XxJoaoFeraxX: posts the ante 100
SAS_IDS0804: posts small blind 200
JonzStars: posts big blind 400
*** HOLE CARDS ***
MagoDelBaralho: folds 
mila is best: raises 400 to 800
XxJoaoFeraxX: folds 
fofAAoBR: calls 800
SAS_IDS0804: folds 
JonzStars: calls 400
*** FLOP *** [Ad Td 5d]
JonzStars: checks 
mila is best: checks 
fofAAoBR: checks 
*** TURN *** [Ad Td 5d] [Jc]
JonzStars: checks 
mila is best: checks 
fofAAoBR: checks 
*** RIVER *** [Ad Td 5d Jc] [Kh]
JonzStars: checks 
mila is best: checks 
fofAAoBR: checks 
*** SHOW DOWN ***
JonzStars: shows [7d Th] (a pair of Tens)
mila is best: shows [Ts 8s] (a pair of Tens)
fofAAoBR: mucks hand 
JonzStars collected 1600 from pot
mila is best collected 1600 from pot
*** SUMMARY ***
Total pot 3200 | Rake 0 
Board [Ad Td 5d Jc Kh]
Seat 1: fofAAoBR (button) mucked
Seat 2: SAS_IDS0804 (small blind) folded before Flop
Seat 3: JonzStars (big blind) showed [7d Th] and won (1600) with a pair of Tens
Seat 4: MagoDelBaralho folded before Flop (didn't bet)
Seat 5: mila is best showed [Ts 8s] and won (1600) with a pair of Tens
Seat 6: XxJoaoFeraxX folded before Flop (didn't bet)

PokerStars Hand #251209556302: Tournament #3769361908, $52.38+$2.62 USD Hold'em No Limit - Level XI (250/500) - 2024/06/26 22:32:55 UTC [2024/06/26 18:32:55 ET]
Table '3769361908 16' 6-max Seat #2 is the button
Seat 1: fofAAoBR (26461 in chips) 
Seat 2: SAS_IDS0804 (9885 in chips) 
Seat 3: JonzStars (6012 in chips) 
Seat 4: MagoDelBaralho (7601 in chips) 
Seat 5: mila is best (10700 in chips) 
Seat 6: XxJoaoFeraxX (10426 in chips) 
fofAAoBR: posts the ante 125
SAS_IDS0804: posts the ante 125
JonzStars: posts the ante 125
MagoDelBaralho: posts the ante 125
mila is best: posts the ante 125
XxJoaoFeraxX: posts the ante 125
JonzStars: posts small blind 250
MagoDelBaralho: posts big blind 500
*** HOLE CARDS ***
mila is best: folds 
XxJoaoFeraxX: raises 500 to 1000
fofAAoBR: folds 
SAS_IDS0804: folds 
JonzStars: folds 
MagoDelBaralho: raises 6476 to 7476 and is all-in
XxJoaoFeraxX: folds 
Uncalled bet (6476) returned to MagoDelBaralho
MagoDelBaralho collected 3000 from pot
*** SUMMARY ***
Total pot 3000 | Rake 0 
Seat 1: fofAAoBR folded before Flop (didn't bet)
Seat 2: SAS_IDS0804 (button) folded before Flop (didn't bet)
Seat 3: JonzStars (small blind) folded before Flop
Seat 4: MagoDelBaralho (big blind) collected (3000)
Seat 5: mila is best folded before Flop (didn't bet)
Seat 6: XxJoaoFeraxX folded before Flop

PokerStars Hand #251209564298: Tournament #3769361908, $52.38+$2.62 USD Hold'em No Limit - Level XI (250/500) - 2024/06/26 22:33:24 UTC [2024/06/26 18:33:24 ET]
Table '3769361908 16' 6-max Seat #3 is the button
Seat 1: fofAAoBR (26336 in chips) 
Seat 2: SAS_IDS0804 (9760 in chips) 
Seat 3: JonzStars (5637 in chips) 
Seat 4: MagoDelBaralho (9476 in chips) 
Seat 5: mila is best (10575 in chips) 
Seat 6: XxJoaoFeraxX (9301 in chips) 
fofAAoBR: posts the ante 125
SAS_IDS0804: posts the ante 125
JonzStars: posts the ante 125
MagoDelBaralho: posts the ante 125
mila is best: posts the ante 125
XxJoaoFeraxX: posts the ante 125
MagoDelBaralho: posts small blind 250
mila is best: posts big blind 500
*** HOLE CARDS ***
XxJoaoFeraxX: raises 500 to 1000
fofAAoBR: folds 
SAS_IDS0804: folds 
JonzStars: folds 
MagoDelBaralho: folds 
mila is best: raises 9450 to 10450 and is all-in
XxJoaoFeraxX: folds 
Uncalled bet (9450) returned to mila is best
mila is best collected 3000 from pot
*** SUMMARY ***
Total pot 3000 | Rake 0 
Seat 1: fofAAoBR folded before Flop (didn't bet)
Seat 2: SAS_IDS0804 folded before Flop (didn't bet)
Seat 3: JonzStars (button) folded before Flop (didn't bet)
Seat 4: MagoDelBaralho (small blind) folded before Flop
Seat 5: mila is best (big blind) collected (3000)
Seat 6: XxJoaoFeraxX folded before Flop

PokerStars Hand #251209574005: Tournament #3769361908, $52.38+$2.62 USD Hold'em No Limit - Level XI (250/500) - 2024/06/26 22:34:01 UTC [2024/06/26 18:34:01 ET]
Table '3769361908 16' 6-max Seat #4 is the button
Seat 1: fofAAoBR (26211 in chips) 
Seat 2: SAS_IDS0804 (9635 in chips) 
Seat 3: JonzStars (5512 in chips) 
Seat 4: MagoDelBaralho (9101 in chips) 
Seat 5: mila is best (12450 in chips) 
Seat 6: XxJoaoFeraxX (8176 in chips) 
fofAAoBR: posts the ante 125
SAS_IDS0804: posts the ante 125
JonzStars: posts the ante 125
MagoDelBaralho: posts the ante 125
mila is best: posts the ante 125
XxJoaoFeraxX: posts the ante 125
mila is best: posts small blind 250
XxJoaoFeraxX: posts big blind 500
*** HOLE CARDS ***
fofAAoBR: raises 500 to 1000
SAS_IDS0804: folds 
JonzStars: folds 
MagoDelBaralho: folds 
mila is best: folds 
XxJoaoFeraxX: calls 500
*** FLOP *** [9s 5s 8h]
XxJoaoFeraxX: checks 
fofAAoBR: checks 
*** TURN *** [9s 5s 8h] [Ah]
XxJoaoFeraxX: checks 
fofAAoBR: bets 1500
XxJoaoFeraxX: calls 1500
*** RIVER *** [9s 5s 8h Ah] [Ac]
XxJoaoFeraxX: checks 
fofAAoBR: checks 
*** SHOW DOWN ***
XxJoaoFeraxX: shows [6c As] (three of a kind, Aces)
fofAAoBR: mucks hand 
XxJoaoFeraxX collected 6000 from pot
*** SUMMARY ***
Total pot 6000 | Rake 0 
Board [9s 5s 8h Ah Ac]
Seat 1: fofAAoBR mucked
Seat 2: SAS_IDS0804 folded before Flop (didn't bet)
Seat 3: JonzStars folded before Flop (didn't bet)
Seat 4: MagoDelBaralho (button) folded before Flop (didn't bet)
Seat 5: mila is best (small blind) folded before Flop
Seat 6: XxJoaoFeraxX (big blind) showed [6c As] and won (6000) with three of a kind, Aces

PokerStars Hand #251209588098: Tournament #3769361908, $52.38+$2.62 USD Hold'em No Limit - Level XI (250/500) - 2024/06/26 22:34:53 UTC [2024/06/26 18:34:53 ET]
Table '3769361908 16' 6-max Seat #5 is the button
Seat 1: fofAAoBR (23586 in chips) 
Seat 2: SAS_IDS0804 (9510 in chips) 
Seat 3: JonzStars (5387 in chips) 
Seat 4: MagoDelBaralho (8976 in chips) 
Seat 5: mila is best (12075 in chips) 
Seat 6: XxJoaoFeraxX (11551 in chips) 
fofAAoBR: posts the ante 125
SAS_IDS0804: posts the ante 125
JonzStars: posts the ante 125
MagoDelBaralho: posts the ante 125
mila is best: posts the ante 125
XxJoaoFeraxX: posts the ante 125
XxJoaoFeraxX: posts small blind 250
fofAAoBR: posts big blind 500
*** HOLE CARDS ***
SAS_IDS0804: folds 
JonzStars: raises 4762 to 5262 and is all-in
MagoDelBaralho: folds 
mila is best: folds 
XxJoaoFeraxX: folds 
fofAAoBR: folds 
Uncalled bet (4762) returned to JonzStars
JonzStars collected 2000 from pot
*** SUMMARY ***
Total pot 2000 | Rake 0 
Seat 1: fofAAoBR (big blind) folded before Flop
Seat 2: SAS_IDS0804 folded before Flop (didn't bet)
Seat 3: JonzStars collected (2000)
Seat 4: MagoDelBaralho folded before Flop (didn't bet)
Seat 5: mila is best (button) folded before Flop (didn't bet)
Seat 6: XxJoaoFeraxX (small blind) folded before Flop

PokerStars Hand #251209593806: Tournament #3769361908, $52.38+$2.62 USD Hold'em No Limit - Level XII (300/600) - 2024/06/26 22:35:14 UTC [2024/06/26 18:35:14 ET]
Table '3769361908 16' 6-max Seat #6 is the button
Seat 1: fofAAoBR (22961 in chips) 
Seat 2: SAS_IDS0804 (9385 in chips) 
Seat 3: JonzStars (6762 in chips) 
Seat 4: MagoDelBaralho (8851 in chips) 
Seat 5: mila is best (11950 in chips) 
Seat 6: XxJoaoFeraxX (11176 in chips) 
fofAAoBR: posts the ante 150
SAS_IDS0804: posts the ante 150
JonzStars: posts the ante 150
MagoDelBaralho: posts the ante 150
mila is best: posts the ante 150
XxJoaoFeraxX: posts the ante 150
fofAAoBR: posts small blind 300
SAS_IDS0804: posts big blind 600
*** HOLE CARDS ***
JonzStars: raises 6012 to 6612 and is all-in
MagoDelBaralho: folds 
mila is best: folds 
XxJoaoFeraxX: folds 
fofAAoBR: folds 
SAS_IDS0804: folds 
Uncalled bet (6012) returned to JonzStars
JonzStars collected 2400 from pot
*** SUMMARY ***
Total pot 2400 | Rake 0 
Seat 1: fofAAoBR (small blind) folded before Flop
Seat 2: SAS_IDS0804 (big blind) folded before Flop
Seat 3: JonzStars collected (2400)
Seat 4: MagoDelBaralho folded before Flop (didn't bet)
Seat 5: mila is best folded before Flop (didn't bet)
Seat 6: XxJoaoFeraxX (button) folded before Flop (didn't bet)

PokerStars Hand #251209600919: Tournament #3769361908, $52.38+$2.62 USD Hold'em No Limit - Level XII (300/600) - 2024/06/26 22:35:41 UTC [2024/06/26 18:35:41 ET]
Table '3769361908 16' 6-max Seat #1 is the button
Seat 1: fofAAoBR (22511 in chips) 
Seat 2: SAS_IDS0804 (8635 in chips) 
Seat 3: JonzStars (8412 in chips) 
Seat 4: MagoDelBaralho (8701 in chips) 
Seat 5: mila is best (11800 in chips) 
Seat 6: XxJoaoFeraxX (11026 in chips) 
fofAAoBR: posts the ante 150
SAS_IDS0804: posts the ante 150
JonzStars: posts the ante 150
MagoDelBaralho: posts the ante 150
mila is best: posts the ante 150
XxJoaoFeraxX: posts the ante 150
SAS_IDS0804: posts small blind 300
JonzStars: posts big blind 600
*** HOLE CARDS ***
MagoDelBaralho: folds 
mila is best: raises 600 to 1200
XxJoaoFeraxX: folds 
fofAAoBR: raises 1800 to 3000
SAS_IDS0804: folds 
JonzStars: folds 
mila is best: calls 1800
*** FLOP *** [9c Kc 2h]
mila is best: checks 
fofAAoBR: bets 900
mila is best: calls 900
*** TURN *** [9c Kc 2h] [As]
mila is best: checks 
fofAAoBR: bets 2100
mila is best: folds 
Uncalled bet (2100) returned to fofAAoBR
fofAAoBR collected 9600 from pot
fofAAoBR: doesn't show hand 
*** SUMMARY ***
Total pot 9600 | Rake 0 
Board [9c Kc 2h As]
Seat 1: fofAAoBR (button) collected (9600)
Seat 2: SAS_IDS0804 (small blind) folded before Flop
Seat 3: JonzStars (big blind) folded before Flop
Seat 4: MagoDelBaralho folded before Flop (didn't bet)
Seat 5: mila is best folded on the Turn
Seat 6: XxJoaoFeraxX folded before Flop (didn't bet)

PokerStars Hand #251209616592: Tournament #3769361908, $52.38+$2.62 USD Hold'em No Limit - Level XII (300/600) - 2024/06/26 22:36:39 UTC [2024/06/26 18:36:39 ET]
Table '3769361908 16' 6-max Seat #2 is the button
Seat 1: fofAAoBR (28061 in chips) 
Seat 2: SAS_IDS0804 (8185 in chips) 
Seat 3: JonzStars (7662 in chips) 
Seat 4: MagoDelBaralho (8551 in chips) 
Seat 5: mila is best (7750 in chips) 
Seat 6: XxJoaoFeraxX (10876 in chips) 
fofAAoBR: posts the ante 150
SAS_IDS0804: posts the ante 150
JonzStars: posts the ante 150
MagoDelBaralho: posts the ante 150
mila is best: posts the ante 150
XxJoaoFeraxX: posts the ante 150
JonzStars: posts small blind 300
MagoDelBaralho: posts big blind 600
*** HOLE CARDS ***
mila is best: folds 
XxJoaoFeraxX: raises 600 to 1200
fofAAoBR: folds 
SAS_IDS0804: folds 
JonzStars: folds 
MagoDelBaralho: raises 7201 to 8401 and is all-in
XxJoaoFeraxX: folds 
Uncalled bet (7201) returned to MagoDelBaralho
MagoDelBaralho collected 3600 from pot
*** SUMMARY ***
Total pot 3600 | Rake 0 
Seat 1: fofAAoBR folded before Flop (didn't bet)
Seat 2: SAS_IDS0804 (button) folded before Flop (didn't bet)
Seat 3: JonzStars (small blind) folded before Flop
Seat 4: MagoDelBaralho (big blind) collected (3600)
Seat 5: mila is best folded before Flop (didn't bet)
Seat 6: XxJoaoFeraxX folded before Flop

PokerStars Hand #251209627110: Tournament #3769361908, $52.38+$2.62 USD Hold'em No Limit - Level XII (300/600) - 2024/06/26 22:37:19 UTC [2024/06/26 18:37:19 ET]
Table '3769361908 16' 6-max Seat #3 is the button
Seat 1: fofAAoBR (27911 in chips) 
Seat 2: SAS_IDS0804 (8035 in chips) 
Seat 3: JonzStars (7212 in chips) 
Seat 4: MagoDelBaralho (10801 in chips) 
Seat 5: mila is best (7600 in chips) 
Seat 6: XxJoaoFeraxX (9526 in chips) 
fofAAoBR: posts the ante 150
SAS_IDS0804: posts the ante 150
JonzStars: posts the ante 150
MagoDelBaralho: posts the ante 150
mila is best: posts the ante 150
XxJoaoFeraxX: posts the ante 150
MagoDelBaralho: posts small blind 300
mila is best: posts big blind 600
*** HOLE CARDS ***
XxJoaoFeraxX: folds 
fofAAoBR: raises 720 to 1320
SAS_IDS0804: folds 
JonzStars: folds 
MagoDelBaralho: folds 
mila is best: calls 720
*** FLOP *** [3s Qc 7h]
mila is best: checks 
fofAAoBR: bets 1267
mila is best: calls 1267
*** TURN *** [3s Qc 7h] [Th]
mila is best: checks 
fofAAoBR: checks 
*** RIVER *** [3s Qc 7h Th] [6d]
mila is best: checks 
fofAAoBR: checks 
*** SHOW DOWN ***
mila is best: shows [3c 6c] (two pair, Sixes and Threes)
fofAAoBR: mucks hand 
mila is best collected 6374 from pot
*** SUMMARY ***
Total pot 6374 | Rake 0 
Board [3s Qc 7h Th 6d]
Seat 1: fofAAoBR mucked
Seat 2: SAS_IDS0804 folded before Flop (didn't bet)
Seat 3: JonzStars (button) folded before Flop (didn't bet)
Seat 4: MagoDelBaralho (small blind) folded before Flop
Seat 5: mila is best (big blind) showed [3c 6c] and won (6374) with two pair, Sixes and Threes
Seat 6: XxJoaoFeraxX folded before Flop (didn't bet)

PokerStars Hand #251209639696: Tournament #3769361908, $52.38+$2.62 USD Hold'em No Limit - Level XII (300/600) - 2024/06/26 22:38:06 UTC [2024/06/26 18:38:06 ET]
Table '3769361908 16' 6-max Seat #4 is the button
Seat 1: fofAAoBR (25174 in chips) 
Seat 2: SAS_IDS0804 (7885 in chips) 
Seat 3: JonzStars (7062 in chips) 
Seat 4: MagoDelBaralho (10351 in chips) 
Seat 5: mila is best (11237 in chips) 
Seat 6: XxJoaoFeraxX (9376 in chips) 
fofAAoBR: posts the ante 150
SAS_IDS0804: posts the ante 150
JonzStars: posts the ante 150
MagoDelBaralho: posts the ante 150
mila is best: posts the ante 150
XxJoaoFeraxX: posts the ante 150
mila is best: posts small blind 300
XxJoaoFeraxX: posts big blind 600
*** HOLE CARDS ***
fofAAoBR: folds 
SAS_IDS0804: raises 600 to 1200
JonzStars: folds 
MagoDelBaralho: folds 
mila is best: folds 
XxJoaoFeraxX: folds 
Uncalled bet (600) returned to SAS_IDS0804
SAS_IDS0804 collected 2400 from pot
SAS_IDS0804: doesn't show hand 
*** SUMMARY ***
Total pot 2400 | Rake 0 
Seat 1: fofAAoBR folded before Flop (didn't bet)
Seat 2: SAS_IDS0804 collected (2400)
Seat 3: JonzStars folded before Flop (didn't bet)
Seat 4: MagoDelBaralho (button) folded before Flop (didn't bet)
Seat 5: mila is best (small blind) folded before Flop
Seat 6: XxJoaoFeraxX (big blind) folded before Flop

PokerStars Hand #251209649665: Tournament #3769361908, $52.38+$2.62 USD Hold'em No Limit - Level XIII (400/800) - 2024/06/26 22:38:43 UTC [2024/06/26 18:38:43 ET]
Table '3769361908 16' 6-max Seat #5 is the button
Seat 1: fofAAoBR (25024 in chips) 
Seat 2: SAS_IDS0804 (9535 in chips) 
Seat 3: JonzStars (6912 in chips) 
Seat 4: MagoDelBaralho (10201 in chips) 
Seat 5: mila is best (10787 in chips) 
Seat 6: XxJoaoFeraxX (8626 in chips) 
fofAAoBR: posts the ante 200
SAS_IDS0804: posts the ante 200
JonzStars: posts the ante 200
MagoDelBaralho: posts the ante 200
mila is best: posts the ante 200
XxJoaoFeraxX: posts the ante 200
XxJoaoFeraxX: posts small blind 400
fofAAoBR: posts big blind 800
*** HOLE CARDS ***
SAS_IDS0804: folds 
JonzStars: raises 800 to 1600
MagoDelBaralho: folds 
mila is best: folds 
XxJoaoFeraxX: folds 
fofAAoBR: calls 800
*** FLOP *** [Td Kh Qs]
fofAAoBR: checks 
JonzStars: bets 5112 and is all-in
fofAAoBR: folds 
Uncalled bet (5112) returned to JonzStars
JonzStars collected 4800 from pot
*** SUMMARY ***
Total pot 4800 | Rake 0 
Board [Td Kh Qs]
Seat 1: fofAAoBR (big blind) folded on the Flop
Seat 2: SAS_IDS0804 folded before Flop (didn't bet)
Seat 3: JonzStars collected (4800)
Seat 4: MagoDelBaralho folded before Flop (didn't bet)
Seat 5: mila is best (button) folded before Flop (didn't bet)
Seat 6: XxJoaoFeraxX (small blind) folded before Flop

PokerStars Hand #251209657584: Tournament #3769361908, $52.38+$2.62 USD Hold'em No Limit - Level XIII (400/800) - 2024/06/26 22:39:13 UTC [2024/06/26 18:39:13 ET]
Table '3769361908 16' 6-max Seat #6 is the button
Seat 1: fofAAoBR (23224 in chips) 
Seat 2: SAS_IDS0804 (9335 in chips) 
Seat 3: JonzStars (9912 in chips) 
Seat 4: MagoDelBaralho (10001 in chips) 
Seat 5: mila is best (10587 in chips) 
Seat 6: XxJoaoFeraxX (8026 in chips) 
fofAAoBR: posts the ante 200
SAS_IDS0804: posts the ante 200
JonzStars: posts the ante 200
MagoDelBaralho: posts the ante 200
mila is best: posts the ante 200
XxJoaoFeraxX: posts the ante 200
fofAAoBR: posts small blind 400
SAS_IDS0804: posts big blind 800
*** HOLE CARDS ***
JonzStars: folds 
MagoDelBaralho: folds 
mila is best: raises 9587 to 10387 and is all-in
XxJoaoFeraxX: folds 
fofAAoBR: folds 
SAS_IDS0804: calls 8335 and is all-in
Uncalled bet (1252) returned to mila is best
*** FLOP *** [Js 6c Jh]
*** TURN *** [Js 6c Jh] [7d]
*** RIVER *** [Js 6c Jh 7d] [Qh]
*** SHOW DOWN ***
SAS_IDS0804: shows [As 3d] (a pair of Jacks)
mila is best: shows [Ad Kc] (a pair of Jacks - Ace+King kicker)
mila is best collected 19870 from pot
SAS_IDS0804 finished the tournament
*** SUMMARY ***
Total pot 19870 | Rake 0 
Board [Js 6c Jh 7d Qh]
Seat 1: fofAAoBR (small blind) folded before Flop
Seat 2: SAS_IDS0804 (big blind) showed [As 3d] and lost with a pair of Jacks
Seat 3: JonzStars folded before Flop (didn't bet)
Seat 4: MagoDelBaralho folded before Flop (didn't bet)
Seat 5: mila is best showed [Ad Kc] and won (19870) with a pair of Jacks
Seat 6: XxJoaoFeraxX (button) folded before Flop (didn't bet)

PokerStars Hand #251209666190: Tournament #3769361908, $52.38+$2.62 USD Hold'em No Limit - Level XIII (400/800) - 2024/06/26 22:39:45 UTC [2024/06/26 18:39:45 ET]
Table '3769361908 16' 6-max Seat #1 is the button
Seat 1: fofAAoBR (22624 in chips) 
Seat 3: JonzStars (9712 in chips) 
Seat 4: MagoDelBaralho (9801 in chips) 
Seat 5: mila is best (21122 in chips) 
Seat 6: XxJoaoFeraxX (7826 in chips) 
fofAAoBR: posts the ante 200
JonzStars: posts the ante 200
MagoDelBaralho: posts the ante 200
mila is best: posts the ante 200
XxJoaoFeraxX: posts the ante 200
JonzStars: posts small blind 400
MagoDelBaralho: posts big blind 800
*** HOLE CARDS ***
mila is best: folds 
XxJoaoFeraxX: raises 6826 to 7626 and is all-in
fofAAoBR: folds 
JonzStars: folds 
MagoDelBaralho: folds 
Uncalled bet (6826) returned to XxJoaoFeraxX
XxJoaoFeraxX collected 3000 from pot
XxJoaoFeraxX: doesn't show hand 
*** SUMMARY ***
Total pot 3000 | Rake 0 
Seat 1: fofAAoBR (button) folded before Flop (didn't bet)
Seat 3: JonzStars (small blind) folded before Flop
Seat 4: MagoDelBaralho (big blind) folded before Flop
Seat 5: mila is best folded before Flop (didn't bet)
Seat 6: XxJoaoFeraxX collected (3000)

PokerStars Hand #251209672029: Tournament #3769361908, $52.38+$2.62 USD Hold'em No Limit - Level XIII (400/800) - 2024/06/26 22:40:07 UTC [2024/06/26 18:40:07 ET]
Table '3769361908 16' 6-max Seat #3 is the button
Seat 1: fofAAoBR (22424 in chips) 
Seat 3: JonzStars (9112 in chips) 
Seat 4: MagoDelBaralho (8801 in chips) 
Seat 5: mila is best (20922 in chips) 
Seat 6: XxJoaoFeraxX (9826 in chips) 
fofAAoBR: posts the ante 200
JonzStars: posts the ante 200
MagoDelBaralho: posts the ante 200
mila is best: posts the ante 200
XxJoaoFeraxX: posts the ante 200
MagoDelBaralho: posts small blind 400
mila is best: posts big blind 800
*** HOLE CARDS ***
XxJoaoFeraxX: folds 
fofAAoBR: raises 800 to 1600
passat1g is disconnected 
JonzStars: folds 
MagoDelBaralho: folds 
mila is best: calls 800
*** FLOP *** [Jd 6s Jh]
mila is best: checks 
fofAAoBR: bets 1518
mila is best: calls 1518
*** TURN *** [Jd 6s Jh] [7h]
mila is best: checks 
fofAAoBR: bets 4800
mila is best: folds 
Uncalled bet (4800) returned to fofAAoBR
fofAAoBR collected 7636 from pot
fofAAoBR: doesn't show hand 
*** SUMMARY ***
Total pot 7636 | Rake 0 
Board [Jd 6s Jh 7h]
Seat 1: fofAAoBR collected (7636)
Seat 3: JonzStars (button) folded before Flop (didn't bet)
Seat 4: MagoDelBaralho (small blind) folded before Flop
Seat 5: mila is best (big blind) folded on the Turn
Seat 6: XxJoaoFeraxX folded before Flop (didn't bet)

PokerStars Hand #251209685063: Tournament #3769361908, $52.38+$2.62 USD Hold'em No Limit - Level XIII (400/800) - 2024/06/26 22:40:57 UTC [2024/06/26 18:40:57 ET]
Table '3769361908 16' 6-max Seat #4 is the button
Seat 2: passat1g (15144 in chips) 
Seat 3: JonzStars (8912 in chips) 
Seat 4: MagoDelBaralho (8201 in chips) 
Seat 5: mila is best (17604 in chips) 
Seat 6: XxJoaoFeraxX (9626 in chips) 
passat1g: posts the ante 200
JonzStars: posts the ante 200
MagoDelBaralho: posts the ante 200
mila is best: posts the ante 200
XxJoaoFeraxX: posts the ante 200
mila is best: posts small blind 400
XxJoaoFeraxX: posts big blind 800
*** HOLE CARDS ***
passat1g: raises 800 to 1600
JonzStars: folds 
MagoDelBaralho: folds 
mila is best: calls 1200
nzlking is disconnected 
XxJoaoFeraxX: folds 
*** FLOP *** [Th Jd Qh]
mila is best: checks 
passat1g: bets 3550
mila is best: raises 12254 to 15804 and is all-in
passat1g: calls 9794 and is all-in
Uncalled bet (2460) returned to mila is best
*** TURN *** [Th Jd Qh] [Qc]
*** RIVER *** [Th Jd Qh Qc] [Ad]
*** SHOW DOWN ***
mila is best: shows [9h 8d] (a straight, Eight to Queen)
passat1g: shows [Ts Js] (two pair, Queens and Jacks)
mila is best collected 31688 from pot
passat1g finished the tournament
*** SUMMARY ***
Total pot 31688 | Rake 0 
Board [Th Jd Qh Qc Ad]
Seat 2: passat1g showed [Ts Js] and lost with two pair, Queens and Jacks
Seat 3: JonzStars folded before Flop (didn't bet)
Seat 4: MagoDelBaralho (button) folded before Flop (didn't bet)
Seat 5: mila is best (small blind) showed [9h 8d] and won (31688) with a straight, Eight to Queen
Seat 6: XxJoaoFeraxX (big blind) folded before Flop

PokerStars Hand #251209698954: Tournament #3769361908, $52.38+$2.62 USD Hold'em No Limit - Level XIV (500/1000) - 2024/06/26 22:41:50 UTC [2024/06/26 18:41:50 ET]
Table '3769361908 16' 6-max Seat #5 is the button
Seat 1: nzlking (10000 in chips) 
Seat 3: JonzStars (8712 in chips) 
Seat 4: MagoDelBaralho (8001 in chips) 
Seat 5: mila is best (34148 in chips) 
Seat 6: XxJoaoFeraxX (8626 in chips) 
nzlking: posts the ante 250
JonzStars: posts the ante 250
MagoDelBaralho: posts the ante 250
mila is best: posts the ante 250
XxJoaoFeraxX: posts the ante 250
XxJoaoFeraxX: posts small blind 500
nzlking: posts big blind 1000
*** HOLE CARDS ***
JonzStars: folds 
MagoDelBaralho: raises 6751 to 7751 and is all-in
mila is best: folds 
XxJoaoFeraxX: folds 
nzlking: calls 6751
*** FLOP *** [Kc 8c Qs]
*** TURN *** [Kc 8c Qs] [3s]
*** RIVER *** [Kc 8c Qs 3s] [Ac]
*** SHOW DOWN ***
nzlking: shows [Td Ad] (a pair of Aces)
MagoDelBaralho: shows [Ks 5s] (a pair of Kings)
nzlking collected 17252 from pot
MagoDelBaralho finished the tournament
Joe Santana is disconnected 
*** SUMMARY ***
Total pot 17252 | Rake 0 
Board [Kc 8c Qs 3s Ac]
Seat 1: nzlking (big blind) showed [Td Ad] and won (17252) with a pair of Aces
Seat 3: JonzStars folded before Flop (didn't bet)
Seat 4: MagoDelBaralho showed [Ks 5s] and lost with a pair of Kings
Seat 5: mila is best (button) folded before Flop (didn't bet)
Seat 6: XxJoaoFeraxX (small blind) folded before Flop

PokerStars Hand #251209707489: Tournament #3769361908, $52.38+$2.62 USD Hold'em No Limit - Level XIV (500/1000) - 2024/06/26 22:42:23 UTC [2024/06/26 18:42:23 ET]
Table '3769361908 16' 6-max Seat #6 is the button
Seat 1: nzlking (19251 in chips) 
Seat 2: Joe Santana (13150 in chips) 
Seat 3: JonzStars (8462 in chips) 
Seat 5: mila is best (33898 in chips) 
Seat 6: XxJoaoFeraxX (7876 in chips) 
nzlking: posts the ante 250
Joe Santana: posts the ante 250
JonzStars: posts the ante 250
mila is best: posts the ante 250
XxJoaoFeraxX: posts the ante 250
nzlking: posts small blind 500
Joe Santana: posts big blind 1000
*** HOLE CARDS ***
JonzStars: raises 7212 to 8212 and is all-in
mila is best: folds 
XxJoaoFeraxX: folds 
nzlking: folds 
Joe Santana: folds 
Uncalled bet (7212) returned to JonzStars
JonzStars collected 3750 from pot
*** SUMMARY ***
Total pot 3750 | Rake 0 
Seat 1: nzlking (small blind) folded before Flop
Seat 2: Joe Santana (big blind) folded before Flop
Seat 3: JonzStars collected (3750)
Seat 5: mila is best folded before Flop (didn't bet)
Seat 6: XxJoaoFeraxX (button) folded before Flop (didn't bet)

PokerStars Hand #251209719767: Tournament #3769361908, $52.38+$2.62 USD Hold'em No Limit - Level XIV (500/1000) - 2024/06/26 22:43:11 UTC [2024/06/26 18:43:11 ET]
Table '3769361908 16' 6-max Seat #1 is the button
Seat 1: nzlking (18501 in chips) 
Seat 2: Joe Santana (11900 in chips) 
Seat 3: JonzStars (10962 in chips) 
Seat 5: mila is best (33648 in chips) 
Seat 6: XxJoaoFeraxX (7626 in chips) 
nzlking: posts the ante 250
Joe Santana: posts the ante 250
JonzStars: posts the ante 250
mila is best: posts the ante 250
XxJoaoFeraxX: posts the ante 250
Joe Santana: posts small blind 500
JonzStars: posts big blind 1000
*** HOLE CARDS ***
mila is best: folds 
XxJoaoFeraxX: folds 
nzlking: folds 
Earl of Poker V is disconnected 
Joe Santana: folds 
Uncalled bet (500) returned to JonzStars
JonzStars collected 2250 from pot
*** SUMMARY ***
Total pot 2250 | Rake 0 
Seat 1: nzlking (button) folded before Flop (didn't bet)
Seat 2: Joe Santana (small blind) folded before Flop
Seat 3: JonzStars (big blind) collected (2250)
Seat 5: mila is best folded before Flop (didn't bet)
Seat 6: XxJoaoFeraxX folded before Flop (didn't bet)

PokerStars Hand #251209730981: Tournament #3769361908, $52.38+$2.62 USD Hold'em No Limit - Level XIV (500/1000) - 2024/06/26 22:43:55 UTC [2024/06/26 18:43:55 ET]
Table '3769361908 16' 6-max Seat #2 is the button
Seat 1: nzlking (18251 in chips) 
Seat 2: Joe Santana (11150 in chips) 
Seat 3: JonzStars (12462 in chips) 
Seat 4: Earl of Poker V (10000 in chips) 
Seat 5: mila is best (33398 in chips) 
Seat 6: XxJoaoFeraxX (7376 in chips) 
nzlking: posts the ante 250
Joe Santana: posts the ante 250
JonzStars: posts the ante 250
Earl of Poker V: posts the ante 250
mila is best: posts the ante 250
XxJoaoFeraxX: posts the ante 250
JonzStars: posts small blind 500
Earl of Poker V: posts big blind 1000
*** HOLE CARDS ***
mila is best: raises 1000 to 2000
XxJoaoFeraxX: folds 
nzlking: folds 
Joe Santana: folds 
JonzStars: folds 
Earl of Poker V: folds 
Uncalled bet (1000) returned to mila is best
mila is best collected 4000 from pot
*** SUMMARY ***
Total pot 4000 | Rake 0 
Seat 1: nzlking folded before Flop (didn't bet)
Seat 2: Joe Santana (button) folded before Flop (didn't bet)
Seat 3: JonzStars (small blind) folded before Flop
Seat 4: Earl of Poker V (big blind) folded before Flop
Seat 5: mila is best collected (4000)
Seat 6: XxJoaoFeraxX folded before Flop (didn't bet)

PokerStars Hand #251209734654: Tournament #3769361908, $52.38+$2.62 USD Hold'em No Limit - Level XIV (500/1000) - 2024/06/26 22:44:09 UTC [2024/06/26 18:44:09 ET]
Table '3769361908 16' 6-max Seat #3 is the button
Seat 1: nzlking (18001 in chips) 
Seat 2: Joe Santana (10900 in chips) 
Seat 3: JonzStars (11712 in chips) 
Seat 4: Earl of Poker V (8750 in chips) 
Seat 5: mila is best (36148 in chips) 
Seat 6: XxJoaoFeraxX (7126 in chips) 
nzlking: posts the ante 250
Joe Santana: posts the ante 250
JonzStars: posts the ante 250
Earl of Poker V: posts the ante 250
mila is best: posts the ante 250
XxJoaoFeraxX: posts the ante 250
Earl of Poker V: posts small blind 500
mila is best: posts big blind 1000
*** HOLE CARDS ***
XxJoaoFeraxX: raises 5876 to 6876 and is all-in
nzlking: folds 
Joe Santana: folds 
JonzStars: folds 
Earl of Poker V: folds 
mila is best: calls 5876
*** FLOP *** [4c 7c 8s]
*** TURN *** [4c 7c 8s] [3c]
*** RIVER *** [4c 7c 8s 3c] [4s]
*** SHOW DOWN ***
mila is best: shows [3h Qh] (two pair, Fours and Threes)
XxJoaoFeraxX: shows [Jh Kd] (a pair of Fours)
mila is best collected 15752 from pot
XxJoaoFeraxX finished the tournament
*** SUMMARY ***
Total pot 15752 | Rake 0 
Board [4c 7c 8s 3c 4s]
Seat 1: nzlking folded before Flop (didn't bet)
Seat 2: Joe Santana folded before Flop (didn't bet)
Seat 3: JonzStars (button) folded before Flop (didn't bet)
Seat 4: Earl of Poker V (small blind) folded before Flop
Seat 5: mila is best (big blind) showed [3h Qh] and won (15752) with two pair, Fours and Threes
Seat 6: XxJoaoFeraxX showed [Jh Kd] and lost with a pair of Fours

PokerStars Hand #251209742837: Tournament #3769361908, $52.38+$2.62 USD Hold'em No Limit - Level XV (600/1200) - 2024/06/26 22:44:41 UTC [2024/06/26 18:44:41 ET]
Table '3769361908 16' 6-max Seat #4 is the button
Seat 1: nzlking (17751 in chips) 
Seat 2: Joe Santana (10650 in chips) 
Seat 3: JonzStars (11462 in chips) 
Seat 4: Earl of Poker V (8000 in chips) 
Seat 5: mila is best (44774 in chips) 
nzlking: posts the ante 300
Joe Santana: posts the ante 300
JonzStars: posts the ante 300
Earl of Poker V: posts the ante 300
mila is best: posts the ante 300
mila is best: posts small blind 600
nzlking: posts big blind 1200
*** HOLE CARDS ***
Joe Santana: folds 
escabofildo is disconnected 
JonzStars: folds 
Earl of Poker V: raises 6500 to 7700 and is all-in
mila is best: folds 
nzlking: folds 
Uncalled bet (6500) returned to Earl of Poker V
Earl of Poker V collected 4500 from pot
Earl of Poker V: doesn't show hand 
*** SUMMARY ***
Total pot 4500 | Rake 0 
Seat 1: nzlking (big blind) folded before Flop
Seat 2: Joe Santana folded before Flop (didn't bet)
Seat 3: JonzStars folded before Flop (didn't bet)
Seat 4: Earl of Poker V (button) collected (4500)
Seat 5: mila is best (small blind) folded before Flop

PokerStars Hand #251209749124: Tournament #3769361908, $52.38+$2.62 USD Hold'em No Limit - Level XV (600/1200) - 2024/06/26 22:45:05 UTC [2024/06/26 18:45:05 ET]
Table '3769361908 16' 6-max Seat #5 is the button
Seat 1: nzlking (16251 in chips) 
Seat 3: JonzStars (11162 in chips) 
Seat 4: Earl of Poker V (11000 in chips) 
Seat 5: mila is best (43874 in chips) 
Seat 6: escabofildo (10000 in chips) out of hand (moved from another table into small blind)
escabofildo will be allowed to play after the button
nzlking: posts the ante 300
JonzStars: posts the ante 300
Earl of Poker V: posts the ante 300
mila is best: posts the ante 300
nzlking: posts small blind 600
JonzStars: posts big blind 1200
*** HOLE CARDS ***
Earl of Poker V: folds 
mila is best: raises 1200 to 2400
4sasss is disconnected 
nzlking: folds 
JonzStars: calls 1200
*** FLOP *** [Qc 5s Tc]
JonzStars: checks 
mila is best: checks 
*** TURN *** [Qc 5s Tc] [Jd]
JonzStars: checks 
mila is best: checks 
*** RIVER *** [Qc 5s Tc Jd] [3h]
JonzStars: checks 
mila is best: bets 2400
JonzStars: folds 
Uncalled bet (2400) returned to mila is best
mila is best collected 6600 from pot
*** SUMMARY ***
Total pot 6600 | Rake 0 
Board [Qc 5s Tc Jd 3h]
Seat 1: nzlking (small blind) folded before Flop
Seat 3: JonzStars (big blind) folded on the River
Seat 4: Earl of Poker V folded before Flop (didn't bet)
Seat 5: mila is best (button) collected (6600)

PokerStars Hand #251209760257: Tournament #3769361908, $52.38+$2.62 USD Hold'em No Limit - Level XV (600/1200) - 2024/06/26 22:45:48 UTC [2024/06/26 18:45:48 ET]
Table '3769361908 16' 6-max Seat #1 is the button
Seat 1: nzlking (15351 in chips) 
Seat 2: 4sasss (10000 in chips) out of hand (moved from another table into small blind)
Seat 3: JonzStars (8462 in chips) 
Seat 4: Earl of Poker V (10700 in chips) 
Seat 5: mila is best (47774 in chips) 
Seat 6: escabofildo (10000 in chips) 
4sasss will be allowed to play after the button
nzlking: posts the ante 300
JonzStars: posts the ante 300
Earl of Poker V: posts the ante 300
mila is best: posts the ante 300
escabofildo: posts the ante 300
JonzStars: posts small blind 600
Earl of Poker V: posts big blind 1200
*** HOLE CARDS ***
mila is best: folds 
escabofildo: folds 
nzlking: folds 
JonzStars: raises 6600 to 7800
Earl of Poker V: folds 
Uncalled bet (6600) returned to JonzStars
JonzStars collected 3900 from pot
*** SUMMARY ***
Total pot 3900 | Rake 0 
Seat 1: nzlking (button) folded before Flop (didn't bet)
Seat 3: JonzStars (small blind) collected (3900)
Seat 4: Earl of Poker V (big blind) folded before Flop
Seat 5: mila is best folded before Flop (didn't bet)
Seat 6: escabofildo folded before Flop (didn't bet)

PokerStars Hand #251209764202: Tournament #3769361908, $52.38+$2.62 USD Hold'em No Limit - Level XV (600/1200) - 2024/06/26 22:46:04 UTC [2024/06/26 18:46:04 ET]
Table '3769361908 16' 6-max Seat #3 is the button
Seat 1: nzlking (15051 in chips) 
Seat 2: 4sasss (10000 in chips) 
Seat 3: JonzStars (10862 in chips) 
Seat 4: Earl of Poker V (9200 in chips) 
Seat 5: mila is best (47474 in chips) 
Seat 6: escabofildo (9700 in chips) 
nzlking: posts the ante 300
4sasss: posts the ante 300
JonzStars: posts the ante 300
Earl of Poker V: posts the ante 300
mila is best: posts the ante 300
escabofildo: posts the ante 300
Earl of Poker V: posts small blind 600
mila is best: posts big blind 1200
*** HOLE CARDS ***
escabofildo: folds 
nzlking: folds 
4sasss: raises 8500 to 9700 and is all-in
JonzStars: folds 
Earl of Poker V: calls 8300 and is all-in
mila is best: folds 
Uncalled bet (800) returned to 4sasss
*** FLOP *** [As Kc 7d]
*** TURN *** [As Kc 7d] [4d]
*** RIVER *** [As Kc 7d 4d] [9s]
*** SHOW DOWN ***
Earl of Poker V: shows [9d Kh] (two pair, Kings and Nines)
4sasss: shows [3h Ac] (a pair of Aces)
Earl of Poker V collected 20800 from pot
*** SUMMARY ***
Total pot 20800 | Rake 0 
Board [As Kc 7d 4d 9s]
Seat 1: nzlking folded before Flop (didn't bet)
Seat 2: 4sasss showed [3h Ac] and lost with a pair of Aces
Seat 3: JonzStars (button) folded before Flop (didn't bet)
Seat 4: Earl of Poker V (small blind) showed [9d Kh] and won (20800) with two pair, Kings and Nines
Seat 5: mila is best (big blind) folded before Flop
Seat 6: escabofildo folded before Flop (didn't bet)

PokerStars Hand #251209772343: Tournament #3769361908, $52.38+$2.62 USD Hold'em No Limit - Level XV (600/1200) - 2024/06/26 22:46:35 UTC [2024/06/26 18:46:35 ET]
Table '3769361908 16' 6-max Seat #4 is the button
Seat 1: nzlking (14751 in chips) 
Seat 2: 4sasss (800 in chips) 
Seat 3: JonzStars (10562 in chips) 
Seat 4: Earl of Poker V (20800 in chips) 
Seat 5: mila is best (45974 in chips) 
Seat 6: escabofildo (9400 in chips) 
nzlking: posts the ante 300
4sasss: posts the ante 300
JonzStars: posts the ante 300
Earl of Poker V: posts the ante 300
mila is best: posts the ante 300
escabofildo: posts the ante 300
mila is best: posts small blind 600
escabofildo: posts big blind 1200
*** HOLE CARDS ***
nzlking: folds 
4sasss: calls 500 and is all-in
JonzStars: folds 
Earl of Poker V: raises 19300 to 20500 and is all-in
mila is best: folds 
escabofildo: calls 7900 and is all-in
Uncalled bet (11400) returned to Earl of Poker V
*** FLOP *** [4s 2d 7h]
*** TURN *** [4s 2d 7h] [Kc]
*** RIVER *** [4s 2d 7h Kc] [6h]
*** SHOW DOWN ***
escabofildo: shows [As Ks] (a pair of Kings)
Earl of Poker V: shows [Td Qd] (high card King)
escabofildo collected 17300 from side pot
4sasss: shows [4c 2h] (two pair, Fours and Deuces)
4sasss collected 3800 from main pot
*** SUMMARY ***
Total pot 21100 Main pot 3800. Side pot 17300. | Rake 0 
Board [4s 2d 7h Kc 6h]
Seat 1: nzlking folded before Flop (didn't bet)
Seat 2: 4sasss showed [4c 2h] and won (3800) with two pair, Fours and Deuces
Seat 3: JonzStars folded before Flop (didn't bet)
Seat 4: Earl of Poker V (button) showed [Td Qd] and lost with high card King
Seat 5: mila is best (small blind) folded before Flop
Seat 6: escabofildo (big blind) showed [As Ks] and won (17300) with a pair of Kings

PokerStars Hand #251209779752: Tournament #3769361908, $52.38+$2.62 USD Hold'em No Limit - Level XV (600/1200) - 2024/06/26 22:47:04 UTC [2024/06/26 18:47:04 ET]
Table '3769361908 16' 6-max Seat #5 is the button
Seat 1: nzlking (14451 in chips) 
Seat 2: 4sasss (3800 in chips) 
Seat 3: JonzStars (10262 in chips) 
Seat 4: Earl of Poker V (11400 in chips) 
Seat 5: mila is best (45074 in chips) 
Seat 6: escabofildo (17300 in chips) 
nzlking: posts the ante 300
4sasss: posts the ante 300
JonzStars: posts the ante 300
Earl of Poker V: posts the ante 300
mila is best: posts the ante 300
escabofildo: posts the ante 300
escabofildo: posts small blind 600
nzlking: posts big blind 1200
*** HOLE CARDS ***
4sasss: raises 2300 to 3500 and is all-in
JonzStars: folds 
Earl of Poker V: folds 
mila is best: raises 41274 to 44774 and is all-in
escabofildo: folds 
nzlking: folds 
Uncalled bet (41274) returned to mila is best
*** FLOP *** [Ks Ts Qd]
*** TURN *** [Ks Ts Qd] [7c]
*** RIVER *** [Ks Ts Qd 7c] [Qh]
*** SHOW DOWN ***
4sasss: shows [8d As] (a pair of Queens)
mila is best: shows [Ad 8c] (a pair of Queens)
4sasss collected 5300 from pot
mila is best collected 5300 from pot
*** SUMMARY ***
Total pot 10600 | Rake 0 
Board [Ks Ts Qd 7c Qh]
Seat 1: nzlking (big blind) folded before Flop
Seat 2: 4sasss showed [8d As] and won (5300) with a pair of Queens
Seat 3: JonzStars folded before Flop (didn't bet)
Seat 4: Earl of Poker V folded before Flop (didn't bet)
Seat 5: mila is best (button) showed [Ad 8c] and won (5300) with a pair of Queens
Seat 6: escabofildo (small blind) folded before Flop

PokerStars Hand #251209786581: Tournament #3769361908, $52.38+$2.62 USD Hold'em No Limit - Level XVI (800/1600) - 2024/06/26 22:47:31 UTC [2024/06/26 18:47:31 ET]
Table '3769361908 16' 6-max Seat #6 is the button
Seat 1: nzlking (12951 in chips) 
Seat 2: 4sasss (5300 in chips) 
Seat 3: JonzStars (9962 in chips) 
Seat 4: Earl of Poker V (11100 in chips) 
Seat 5: mila is best (46574 in chips) 
Seat 6: escabofildo (16400 in chips) 
nzlking: posts the ante 400
4sasss: posts the ante 400
JonzStars: posts the ante 400
Earl of Poker V: posts the ante 400
mila is best: posts the ante 400
escabofildo: posts the ante 400
nzlking: posts small blind 800
4sasss: posts big blind 1600
*** HOLE CARDS ***
JonzStars: raises 7962 to 9562 and is all-in
Earl of Poker V: raises 1138 to 10700 and is all-in
mila is best: folds 
escabofildo: folds 
nzlking: folds 
4sasss: folds 
Uncalled bet (1138) returned to Earl of Poker V
*** FLOP *** [Kd 9d Kh]
*** TURN *** [Kd 9d Kh] [8s]
*** RIVER *** [Kd 9d Kh 8s] [9h]
*** SHOW DOWN ***
JonzStars: shows [6c 6s] (two pair, Kings and Nines)
Earl of Poker V: shows [Ac Qc] (two pair, Kings and Nines - Ace kicker)
Earl of Poker V collected 23924 from pot
JonzStars finished the tournament
*** SUMMARY ***
Total pot 23924 | Rake 0 
Board [Kd 9d Kh 8s 9h]
Seat 1: nzlking (small blind) folded before Flop
Seat 2: 4sasss (big blind) folded before Flop
Seat 3: JonzStars showed [6c 6s] and lost with two pair, Kings and Nines
Seat 4: Earl of Poker V showed [Ac Qc] and won (23924) with two pair, Kings and Nines
Seat 5: mila is best folded before Flop (didn't bet)
Seat 6: escabofildo (button) folded before Flop (didn't bet)

PokerStars Hand #251209793516: Tournament #3769361908, $52.38+$2.62 USD Hold'em No Limit - Level XVI (800/1600) - 2024/06/26 22:47:59 UTC [2024/06/26 18:47:59 ET]
Table '3769361908 16' 6-max Seat #1 is the button
Seat 1: nzlking (11751 in chips) 
Seat 2: 4sasss (3300 in chips) 
Seat 4: Earl of Poker V (25062 in chips) 
Seat 5: mila is best (46174 in chips) 
Seat 6: escabofildo (16000 in chips) 
nzlking: posts the ante 400
4sasss: posts the ante 400
Earl of Poker V: posts the ante 400
mila is best: posts the ante 400
escabofildo: posts the ante 400
4sasss: posts small blind 800
Earl of Poker V: posts big blind 1600
*** HOLE CARDS ***
mila is best: folds 
escabofildo: raises 14000 to 15600 and is all-in
nzlking: folds 
4sasss: folds 
Earl of Poker V: calls 14000
*** FLOP *** [Ah Kc 4c]
lintumies12 is disconnected 
*** TURN *** [Ah Kc 4c] [9h]
*** RIVER *** [Ah Kc 4c 9h] [6s]
*** SHOW DOWN ***
Earl of Poker V: shows [Ac 8s] (a pair of Aces)
escabofildo: shows [As 9d] (two pair, Aces and Nines)
escabofildo collected 34000 from pot
*** SUMMARY ***
Total pot 34000 | Rake 0 
Board [Ah Kc 4c 9h 6s]
Seat 1: nzlking (button) folded before Flop (didn't bet)
Seat 2: 4sasss (small blind) folded before Flop
Seat 4: Earl of Poker V (big blind) showed [Ac 8s] and lost with a pair of Aces
Seat 5: mila is best folded before Flop (didn't bet)
Seat 6: escabofildo showed [As 9d] and won (34000) with two pair, Aces and Nines

PokerStars Hand #251209798904: Tournament #3769361908, $52.38+$2.62 USD Hold'em No Limit - Level XVI (800/1600) - 2024/06/26 22:48:20 UTC [2024/06/26 18:48:20 ET]
Table '3769361908 16' 6-max Seat #2 is the button
Seat 1: nzlking (11351 in chips) 
Seat 2: 4sasss (2100 in chips) 
Seat 3: lintumies12 (17370 in chips) out of hand (moved from another table into small blind)
Seat 4: Earl of Poker V (9062 in chips) 
Seat 5: mila is best (45774 in chips) 
Seat 6: escabofildo (34000 in chips) 
lintumies12 will be allowed to play after the button
nzlking: posts the ante 400
4sasss: posts the ante 400
Earl of Poker V: posts the ante 400
mila is best: posts the ante 400
escabofildo: posts the ante 400
Earl of Poker V: posts small blind 800
mila is best: posts big blind 1600
*** HOLE CARDS ***
escabofildo: folds 
nzlking: folds 
4sasss: raises 100 to 1700 and is all-in
Earl of Poker V: raises 6962 to 8662 and is all-in
mila is best: calls 7062
*** FLOP *** [7d 6d 9d]
*** TURN *** [7d 6d 9d] [Th]
*** RIVER *** [7d 6d 9d Th] [8c]
*** SHOW DOWN ***
Earl of Poker V: shows [Kh 7s] (a straight, Six to Ten)
mila is best: shows [3c 3h] (a straight, Six to Ten)
Earl of Poker V collected 6962 from side pot
mila is best collected 6962 from side pot
4sasss: shows [3d Kd] (a flush, King high)
4sasss collected 7100 from main pot
*** SUMMARY ***
Total pot 21024 Main pot 7100. Side pot 13924. | Rake 0 
Board [7d 6d 9d Th 8c]
Seat 1: nzlking folded before Flop (didn't bet)
Seat 2: 4sasss (button) showed [3d Kd] and won (7100) with a flush, King high
Seat 4: Earl of Poker V (small blind) showed [Kh 7s] and won (6962) with a straight, Six to Ten
Seat 5: mila is best (big blind) showed [3c 3h] and won (6962) with a straight, Six to Ten
Seat 6: escabofildo folded before Flop (didn't bet)

PokerStars Hand #251209805854: Tournament #3769361908, $52.38+$2.62 USD Hold'em No Limit - Level XVI (800/1600) - 2024/06/26 22:48:47 UTC [2024/06/26 18:48:47 ET]
Table '3769361908 16' 6-max Seat #4 is the button
Seat 1: nzlking (10951 in chips) 
Seat 2: 4sasss (7100 in chips) 
Seat 3: lintumies12 (17370 in chips) 
Seat 4: Earl of Poker V (6962 in chips) 
Seat 5: mila is best (43674 in chips) 
Seat 6: escabofildo (33600 in chips) 
nzlking: posts the ante 400
4sasss: posts the ante 400
lintumies12: posts the ante 400
Earl of Poker V: posts the ante 400
mila is best: posts the ante 400
escabofildo: posts the ante 400
mila is best: posts small blind 800
escabofildo: posts big blind 1600
*** HOLE CARDS ***
nzlking: folds 
4sasss: raises 5100 to 6700 and is all-in
lintumies12: folds 
Earl of Poker V: folds 
mila is best: folds 
escabofildo: calls 5100
*** FLOP *** [3c 5c 8s]
*** TURN *** [3c 5c 8s] [Th]
*** RIVER *** [3c 5c 8s Th] [Kh]
*** SHOW DOWN ***
escabofildo: shows [Ad Jc] (high card Ace)
4sasss: shows [Kc Jd] (a pair of Kings)
4sasss collected 16600 from pot
*** SUMMARY ***
Total pot 16600 | Rake 0 
Board [3c 5c 8s Th Kh]
Seat 1: nzlking folded before Flop (didn't bet)
Seat 2: 4sasss showed [Kc Jd] and won (16600) with a pair of Kings
Seat 3: lintumies12 folded before Flop (didn't bet)
Seat 4: Earl of Poker V (button) folded before Flop (didn't bet)
Seat 5: mila is best (small blind) folded before Flop
Seat 6: escabofildo (big blind) showed [Ad Jc] and lost with high card Ace

PokerStars Hand #251209815640: Tournament #3769361908, $52.38+$2.62 USD Hold'em No Limit - Level XVI (800/1600) - 2024/06/26 22:49:27 UTC [2024/06/26 18:49:27 ET]
Table '3769361908 16' 6-max Seat #5 is the button
Seat 1: nzlking (10551 in chips) 
Seat 2: 4sasss (16600 in chips) 
Seat 3: lintumies12 (16970 in chips) 
Seat 4: Earl of Poker V (6562 in chips) 
Seat 5: mila is best (42474 in chips) 
Seat 6: escabofildo (26500 in chips) 
nzlking: posts the ante 400
4sasss: posts the ante 400
lintumies12: posts the ante 400
Earl of Poker V: posts the ante 400
mila is best: posts the ante 400
escabofildo: posts the ante 400
escabofildo: posts small blind 800
nzlking: posts big blind 1600
*** HOLE CARDS ***
4sasss: folds 
lintumies12: folds 
Earl of Poker V: folds 
mila is best: folds 
escabofildo: raises 24500 to 26100 and is all-in
nzlking: calls 8551 and is all-in
Uncalled bet (15949) returned to escabofildo
*** FLOP *** [Kc Ad 5h]
*** TURN *** [Kc Ad 5h] [As]
*** RIVER *** [Kc Ad 5h As] [8c]
*** SHOW DOWN ***
escabofildo: shows [3d Ts] (a pair of Aces)
nzlking: shows [6c Qc] (a pair of Aces - King+Queen kicker)
nzlking collected 22702 from pot
*** SUMMARY ***
Total pot 22702 | Rake 0 
Board [Kc Ad 5h As 8c]
Seat 1: nzlking (big blind) showed [6c Qc] and won (22702) with a pair of Aces
Seat 2: 4sasss folded before Flop (didn't bet)
Seat 3: lintumies12 folded before Flop (didn't bet)
Seat 4: Earl of Poker V folded before Flop (didn't bet)
Seat 5: mila is best (button) folded before Flop (didn't bet)
Seat 6: escabofildo (small blind) showed [3d Ts] and lost with a pair of Aces

PokerStars Hand #251209828910: Tournament #3769361908, $52.38+$2.62 USD Hold'em No Limit - Level XVII (1000/2000) - 2024/06/26 22:50:20 UTC [2024/06/26 18:50:20 ET]
Table '3769361908 16' 6-max Seat #6 is the button
Seat 1: nzlking (22702 in chips) 
Seat 2: 4sasss (16200 in chips) 
Seat 3: lintumies12 (16570 in chips) 
Seat 4: Earl of Poker V (6162 in chips) 
Seat 5: mila is best (42074 in chips) 
Seat 6: escabofildo (15949 in chips) 
nzlking: posts the ante 500
4sasss: posts the ante 500
lintumies12: posts the ante 500
Earl of Poker V: posts the ante 500
mila is best: posts the ante 500
escabofildo: posts the ante 500
nzlking: posts small blind 1000
4sasss: posts big blind 2000
*** HOLE CARDS ***
lintumies12: folds 
Earl of Poker V: raises 3662 to 5662 and is all-in
mila is best: folds 
escabofildo: folds 
nzlking: folds 
4sasss: calls 3662
*** FLOP *** [Js Ts Ac]
*** TURN *** [Js Ts Ac] [3c]
*** RIVER *** [Js Ts Ac 3c] [2s]
*** SHOW DOWN ***
4sasss: shows [6c Kh] (high card Ace)
Earl of Poker V: shows [Jd 8d] (a pair of Jacks)
Earl of Poker V collected 15324 from pot
*** SUMMARY ***
Total pot 15324 | Rake 0 
Board [Js Ts Ac 3c 2s]
Seat 1: nzlking (small blind) folded before Flop
Seat 2: 4sasss (big blind) showed [6c Kh] and lost with high card Ace
Seat 3: lintumies12 folded before Flop (didn't bet)
Seat 4: Earl of Poker V showed [Jd 8d] and won (15324) with a pair of Jacks
Seat 5: mila is best folded before Flop (didn't bet)
Seat 6: escabofildo (button) folded before Flop (didn't bet)

PokerStars Hand #251209838244: Tournament #3769361908, $52.38+$2.62 USD Hold'em No Limit - Level XVII (1000/2000) - 2024/06/26 22:50:59 UTC [2024/06/26 18:50:59 ET]
Table '3769361908 16' 6-max Seat #1 is the button
Seat 1: nzlking (21202 in chips) 
Seat 2: 4sasss (10038 in chips) 
Seat 3: lintumies12 (16070 in chips) 
Seat 4: Earl of Poker V (15324 in chips) 
Seat 5: mila is best (41574 in chips) 
Seat 6: escabofildo (15449 in chips) 
nzlking: posts the ante 500
4sasss: posts the ante 500
lintumies12: posts the ante 500
Earl of Poker V: posts the ante 500
mila is best: posts the ante 500
escabofildo: posts the ante 500
4sasss: posts small blind 1000
lintumies12: posts big blind 2000
*** HOLE CARDS ***
Earl of Poker V: folds 
mila is best: folds 
escabofildo: raises 12949 to 14949 and is all-in
nzlking: folds 
4sasss: folds 
lintumies12: calls 12949
*** FLOP *** [5s Qc 6d]
*** TURN *** [5s Qc 6d] [6h]
*** RIVER *** [5s Qc 6d 6h] [Qh]
*** SHOW DOWN ***
lintumies12: shows [Jd Qd] (a full house, Queens full of Sixes)
escabofildo: shows [Ks Ah] (two pair, Queens and Sixes)
lintumies12 collected 33898 from pot
escabofildo finished the tournament in 98th place
*** SUMMARY ***
Total pot 33898 | Rake 0 
Board [5s Qc 6d 6h Qh]
Seat 1: nzlking (button) folded before Flop (didn't bet)
Seat 2: 4sasss (small blind) folded before Flop
Seat 3: lintumies12 (big blind) showed [Jd Qd] and won (33898) with a full house, Queens full of Sixes
Seat 4: Earl of Poker V folded before Flop (didn't bet)
Seat 5: mila is best folded before Flop (didn't bet)
Seat 6: escabofildo showed [Ks Ah] and lost with two pair, Queens and Sixes

PokerStars Hand #251209850724: Tournament #3769361908, $52.38+$2.62 USD Hold'em No Limit - Level XVII (1000/2000) - 2024/06/26 22:51:50 UTC [2024/06/26 18:51:50 ET]
Table '3769361908 16' 6-max Seat #2 is the button
Seat 1: nzlking (20702 in chips) 
Seat 2: 4sasss (8538 in chips) 
Seat 3: lintumies12 (34519 in chips) 
Seat 4: Earl of Poker V (14824 in chips) 
Seat 5: mila is best (41074 in chips) 
nzlking: posts the ante 500
4sasss: posts the ante 500
lintumies12: posts the ante 500
Earl of Poker V: posts the ante 500
mila is best: posts the ante 500
lintumies12: posts small blind 1000
Earl of Poker V: posts big blind 2000
*** HOLE CARDS ***
GabrielTho1 is disconnected 
mila is best: folds 
nzlking: raises 18202 to 20202 and is all-in
4sasss: calls 8038 and is all-in
lintumies12: folds 
Earl of Poker V: folds 
Uncalled bet (12164) returned to nzlking
*** FLOP *** [2d 3d Td]
*** TURN *** [2d 3d Td] [6c]
*** RIVER *** [2d 3d Td 6c] [9d]
*** SHOW DOWN ***
nzlking: shows [As 5s] (high card Ace)
4sasss: shows [Qd Kd] (a flush, King high)
4sasss collected 21576 from pot
*** SUMMARY ***
Total pot 21576 | Rake 0 
Board [2d 3d Td 6c 9d]
Seat 1: nzlking showed [As 5s] and lost with high card Ace
Seat 2: 4sasss (button) showed [Qd Kd] and won (21576) with a flush, King high
Seat 3: lintumies12 (small blind) folded before Flop
Seat 4: Earl of Poker V (big blind) folded before Flop
Seat 5: mila is best folded before Flop (didn't bet)

PokerStars Hand #251209861204: Tournament #3769361908, $52.38+$2.62 USD Hold'em No Limit - Level XVII (1000/2000) - 2024/06/26 22:52:33 UTC [2024/06/26 18:52:33 ET]
Table '3769361908 16' 6-max Seat #3 is the button
Seat 1: nzlking (12164 in chips) 
Seat 2: 4sasss (21576 in chips) 
Seat 3: lintumies12 (33019 in chips) 
Seat 4: Earl of Poker V (12324 in chips) 
Seat 5: mila is best (40574 in chips) 
Seat 6: GabrielTho1 (32111 in chips) 
nzlking: posts the ante 500
4sasss: posts the ante 500
lintumies12: posts the ante 500
Earl of Poker V: posts the ante 500
mila is best: posts the ante 500
GabrielTho1: posts the ante 500
Earl of Poker V: posts small blind 1000
mila is best: posts big blind 2000
*** HOLE CARDS ***
GabrielTho1: folds 
nzlking: folds 
4sasss: raises 19076 to 21076 and is all-in
lintumies12: folds 
Earl of Poker V: folds 
mila is best: folds 
Uncalled bet (19076) returned to 4sasss
4sasss collected 8000 from pot
*** SUMMARY ***
Total pot 8000 | Rake 0 
Seat 1: nzlking folded before Flop (didn't bet)
Seat 2: 4sasss collected (8000)
Seat 3: lintumies12 (button) folded before Flop (didn't bet)
Seat 4: Earl of Poker V (small blind) folded before Flop
Seat 5: mila is best (big blind) folded before Flop
Seat 6: GabrielTho1 folded before Flop (didn't bet)

PokerStars Hand #251209869427: Tournament #3769361908, $52.38+$2.62 USD Hold'em No Limit - Level XVII (1000/2000) - 2024/06/26 22:53:06 UTC [2024/06/26 18:53:06 ET]
Table '3769361908 16' 6-max Seat #4 is the button
Seat 1: nzlking (11664 in chips) 
Seat 2: 4sasss (27076 in chips) 
Seat 3: lintumies12 (32519 in chips) 
Seat 4: Earl of Poker V (10824 in chips) 
Seat 5: mila is best (38074 in chips) 
Seat 6: GabrielTho1 (31611 in chips) 
nzlking: posts the ante 500
4sasss: posts the ante 500
lintumies12: posts the ante 500
Earl of Poker V: posts the ante 500
mila is best: posts the ante 500
GabrielTho1: posts the ante 500
mila is best: posts small blind 1000
GabrielTho1: posts big blind 2000
*** HOLE CARDS ***
nzlking: folds 
4sasss: folds 
lintumies12: raises 30019 to 32019 and is all-in
Earl of Poker V: folds 
mila is best: folds 
GabrielTho1: folds 
Uncalled bet (30019) returned to lintumies12
lintumies12 collected 8000 from pot
lintumies12: doesn't show hand 
*** SUMMARY ***
Total pot 8000 | Rake 0 
Seat 1: nzlking folded before Flop (didn't bet)
Seat 2: 4sasss folded before Flop (didn't bet)
Seat 3: lintumies12 collected (8000)
Seat 4: Earl of Poker V (button) folded before Flop (didn't bet)
Seat 5: mila is best (small blind) folded before Flop
Seat 6: GabrielTho1 (big blind) folded before Flop

PokerStars Hand #251209884120: Tournament #3769361908, $52.38+$2.62 USD Hold'em No Limit - Level XVIII (1200/2400) - 2024/06/26 22:54:07 UTC [2024/06/26 18:54:07 ET]
Table '3769361908 16' 6-max Seat #5 is the button
Seat 1: nzlking (11164 in chips) 
Seat 2: 4sasss (26576 in chips) 
Seat 3: lintumies12 (38019 in chips) 
Seat 4: Earl of Poker V (10324 in chips) 
Seat 5: mila is best (36574 in chips) 
Seat 6: GabrielTho1 (29111 in chips) 
nzlking: posts the ante 600
4sasss: posts the ante 600
lintumies12: posts the ante 600
Earl of Poker V: posts the ante 600
mila is best: posts the ante 600
GabrielTho1: posts the ante 600
GabrielTho1: posts small blind 1200
nzlking: posts big blind 2400
*** HOLE CARDS ***
4sasss: raises 3600 to 6000
lintumies12: folds 
Earl of Poker V: folds 
mila is best: folds 
GabrielTho1: folds 
nzlking: folds 
Uncalled bet (3600) returned to 4sasss
4sasss collected 9600 from pot
*** SUMMARY ***
Total pot 9600 | Rake 0 
Seat 1: nzlking (big blind) folded before Flop
Seat 2: 4sasss collected (9600)
Seat 3: lintumies12 folded before Flop (didn't bet)
Seat 4: Earl of Poker V folded before Flop (didn't bet)
Seat 5: mila is best (button) folded before Flop (didn't bet)
Seat 6: GabrielTho1 (small blind) folded before Flop

PokerStars Hand #251209893086: Tournament #3769361908, $52.38+$2.62 USD Hold'em No Limit - Level XVIII (1200/2400) - 2024/06/26 22:54:44 UTC [2024/06/26 18:54:44 ET]
Table '3769361908 16' 6-max Seat #6 is the button
Seat 1: nzlking (8164 in chips) 
Seat 2: 4sasss (33176 in chips) 
Seat 3: lintumies12 (37419 in chips) 
Seat 4: Earl of Poker V (9724 in chips) 
Seat 5: mila is best (35974 in chips) 
Seat 6: GabrielTho1 (27311 in chips) 
nzlking: posts the ante 600
4sasss: posts the ante 600
lintumies12: posts the ante 600
Earl of Poker V: posts the ante 600
mila is best: posts the ante 600
GabrielTho1: posts the ante 600
nzlking: posts small blind 1200
4sasss: posts big blind 2400
*** HOLE CARDS ***
lintumies12: raises 34419 to 36819 and is all-in
Earl of Poker V: calls 9124 and is all-in
mila is best: folds 
GabrielTho1: folds 
nzlking: calls 6364 and is all-in
4sasss: folds 
Uncalled bet (27695) returned to lintumies12
*** FLOP *** [Jh Td Jc]
*** TURN *** [Jh Td Jc] [2s]
*** RIVER *** [Jh Td Jc 2s] [9c]
*** SHOW DOWN ***
lintumies12: shows [Ad Kc] (a pair of Jacks)
Earl of Poker V: shows [Th Ts] (a full house, Tens full of Jacks)
Earl of Poker V collected 3120 from side pot
nzlking: shows [6h 6d] (two pair, Jacks and Sixes)
Earl of Poker V collected 28692 from main pot
nzlking finished the tournament in 73rd place
*** SUMMARY ***
Total pot 31812 Main pot 28692. Side pot 3120. | Rake 0 
Board [Jh Td Jc 2s 9c]
Seat 1: nzlking (small blind) showed [6h 6d] and lost with two pair, Jacks and Sixes
Seat 2: 4sasss (big blind) folded before Flop
Seat 3: lintumies12 showed [Ad Kc] and lost with a pair of Jacks
Seat 4: Earl of Poker V showed [Th Ts] and won (31812) with a full house, Tens full of Jacks
Seat 5: mila is best folded before Flop (didn't bet)
Seat 6: GabrielTho1 (button) folded before Flop (didn't bet)




PokerStars Hand #251209148851: Tournament #3769361908, $52.38+$2.62 USD Hold'em No Limit - Level III (40/80) - 2024/06/26 22:08:45 UTC [2024/06/26 18:08:45 ET]
Table '3769361908 14' 6-max Seat #5 is the button
Seat 1: dulek_jason (11287 in chips) 
Seat 2: jessecesar (8520 in chips) 
Seat 3: whaleptt (9605 in chips) 
Seat 4: Go4ElvIS (8330 in chips) 
Seat 5: mennck (6434 in chips) 
dulek_jason: posts the ante 20
jessecesar: posts the ante 20
whaleptt: posts the ante 20
Go4ElvIS: posts the ante 20
mennck: posts the ante 20
dulek_jason: posts small blind 40
jessecesar: posts big blind 80
*** HOLE CARDS ***
whaleptt: folds 
Go4ElvIS: folds 
mennck: folds 
dulek_jason: calls 40
$aymon9 is disconnected 
jessecesar: raises 240 to 320
dulek_jason: calls 240
*** FLOP *** [Qc Ac 8s]
dulek_jason: checks 
jessecesar: checks 
*** TURN *** [Qc Ac 8s] [3c]
dulek_jason: checks 
jessecesar: checks 
*** RIVER *** [Qc Ac 8s 3c] [5h]
dulek_jason: bets 548
jessecesar: folds 
Uncalled bet (548) returned to dulek_jason
dulek_jason collected 740 from pot
dulek_jason: doesn't show hand 
*** SUMMARY ***
Total pot 740 | Rake 0 
Board [Qc Ac 8s 3c 5h]
Seat 1: dulek_jason (small blind) collected (740)
Seat 2: jessecesar (big blind) folded on the River
Seat 3: whaleptt folded before Flop (didn't bet)
Seat 4: Go4ElvIS folded before Flop (didn't bet)
Seat 5: mennck (button) folded before Flop (didn't bet)

PokerStars Hand #251209174666: Tournament #3769361908, $52.38+$2.62 USD Hold'em No Limit - Level III (40/80) - 2024/06/26 22:10:13 UTC [2024/06/26 18:10:13 ET]
Table '3769361908 14' 6-max Seat #1 is the button
Seat 1: dulek_jason (11687 in chips) 
Seat 2: jessecesar (8180 in chips) 
Seat 3: whaleptt (9585 in chips) 
Seat 4: Go4ElvIS (8310 in chips) 
Seat 5: mennck (6414 in chips) 
Seat 6: $aymon9 (10000 in chips) 
dulek_jason: posts the ante 20
jessecesar: posts the ante 20
whaleptt: posts the ante 20
Go4ElvIS: posts the ante 20
mennck: posts the ante 20
$aymon9: posts the ante 20
jessecesar: posts small blind 40
whaleptt: posts big blind 80
*** HOLE CARDS ***
Go4ElvIS: folds 
mennck: folds 
$aymon9: folds 
dulek_jason: raises 91 to 171
jessecesar: calls 131
whaleptt: folds 
*** FLOP *** [5h Kc 7c]
jessecesar: checks 
dulek_jason: bets 179
jessecesar: raises 621 to 800
dulek_jason: folds 
Uncalled bet (621) returned to jessecesar
jessecesar collected 900 from pot
jessecesar: doesn't show hand 
*** SUMMARY ***
Total pot 900 | Rake 0 
Board [5h Kc 7c]
Seat 1: dulek_jason (button) folded on the Flop
Seat 2: jessecesar (small blind) collected (900)
Seat 3: whaleptt (big blind) folded before Flop
Seat 4: Go4ElvIS folded before Flop (didn't bet)
Seat 5: mennck folded before Flop (didn't bet)
Seat 6: $aymon9 folded before Flop (didn't bet)

PokerStars Hand #251209192049: Tournament #3769361908, $52.38+$2.62 USD Hold'em No Limit - Level IV (50/100) - 2024/06/26 22:11:13 UTC [2024/06/26 18:11:13 ET]
Table '3769361908 14' 6-max Seat #2 is the button
Seat 1: dulek_jason (11317 in chips) 
Seat 2: jessecesar (8710 in chips) 
Seat 3: whaleptt (9485 in chips) 
Seat 4: Go4ElvIS (8290 in chips) 
Seat 5: mennck (6394 in chips) 
Seat 6: $aymon9 (9980 in chips) 
dulek_jason: posts the ante 25
jessecesar: posts the ante 25
whaleptt: posts the ante 25
Go4ElvIS: posts the ante 25
mennck: posts the ante 25
$aymon9: posts the ante 25
whaleptt: posts small blind 50
Go4ElvIS: posts big blind 100
*** HOLE CARDS ***
mennck: folds 
$aymon9: raises 100 to 200
dulek_jason: folds 
jessecesar: calls 200
whaleptt: calls 150
Go4ElvIS: calls 100
*** FLOP *** [9c 6s 2d]
whaleptt: checks 
Go4ElvIS: checks 
$aymon9: bets 314
jessecesar: folds 
whaleptt: calls 314
Go4ElvIS: folds 
*** TURN *** [9c 6s 2d] [6d]
whaleptt: bets 395
$aymon9: calls 395
*** RIVER *** [9c 6s 2d 6d] [Qd]
whaleptt: bets 1965
$aymon9: calls 1965
*** SHOW DOWN ***
whaleptt: shows [7s As] (a pair of Sixes)
$aymon9: shows [Tc Td] (two pair, Tens and Sixes)
$aymon9 collected 6298 from pot
*** SUMMARY ***
Total pot 6298 | Rake 0 
Board [9c 6s 2d 6d Qd]
Seat 1: dulek_jason folded before Flop (didn't bet)
Seat 2: jessecesar (button) folded on the Flop
Seat 3: whaleptt (small blind) showed [7s As] and lost with a pair of Sixes
Seat 4: Go4ElvIS (big blind) folded on the Flop
Seat 5: mennck folded before Flop (didn't bet)
Seat 6: $aymon9 showed [Tc Td] and won (6298) with two pair, Tens and Sixes

PokerStars Hand #251209221124: Tournament #3769361908, $52.38+$2.62 USD Hold'em No Limit - Level IV (50/100) - 2024/06/26 22:12:54 UTC [2024/06/26 18:12:54 ET]
Table '3769361908 14' 6-max Seat #3 is the button
Seat 1: dulek_jason (11292 in chips) 
Seat 2: jessecesar (8485 in chips) 
Seat 3: whaleptt (6586 in chips) 
Seat 4: Go4ElvIS (8065 in chips) 
Seat 5: mennck (6369 in chips) 
Seat 6: $aymon9 (13379 in chips) 
dulek_jason: posts the ante 25
jessecesar: posts the ante 25
whaleptt: posts the ante 25
Go4ElvIS: posts the ante 25
mennck: posts the ante 25
$aymon9: posts the ante 25
Go4ElvIS: posts small blind 50
mennck: posts big blind 100
*** HOLE CARDS ***
$aymon9: raises 100 to 200
dulek_jason: folds 
jessecesar: folds 
whaleptt: folds 
Go4ElvIS: raises 400 to 600
mennck: folds 
$aymon9: calls 400
*** FLOP *** [8c Qs 4c]
Go4ElvIS: bets 479
$aymon9: calls 479
*** TURN *** [8c Qs 4c] [5c]
Go4ElvIS: checks 
$aymon9: checks 
*** RIVER *** [8c Qs 4c 5c] [2d]
Go4ElvIS: checks 
$aymon9: bets 1350
Go4ElvIS: calls 1350
*** SHOW DOWN ***
$aymon9: shows [Qc Ad] (a pair of Queens)
Go4ElvIS: mucks hand 
$aymon9 collected 5108 from pot
*** SUMMARY ***
Total pot 5108 | Rake 0 
Board [8c Qs 4c 5c 2d]
Seat 1: dulek_jason folded before Flop (didn't bet)
Seat 2: jessecesar folded before Flop (didn't bet)
Seat 3: whaleptt (button) folded before Flop (didn't bet)
Seat 4: Go4ElvIS (small blind) mucked
Seat 5: mennck (big blind) folded before Flop
Seat 6: $aymon9 showed [Qc Ad] and won (5108) with a pair of Queens

PokerStars Hand #251209239944: Tournament #3769361908, $52.38+$2.62 USD Hold'em No Limit - Level IV (50/100) - 2024/06/26 22:14:00 UTC [2024/06/26 18:14:00 ET]
Table '3769361908 14' 6-max Seat #4 is the button
Seat 1: dulek_jason (11267 in chips) 
Seat 2: jessecesar (8460 in chips) 
Seat 3: whaleptt (6561 in chips) 
Seat 4: Go4ElvIS (5611 in chips) 
Seat 5: mennck (6244 in chips) 
Seat 6: $aymon9 (16033 in chips) 
dulek_jason: posts the ante 25
jessecesar: posts the ante 25
whaleptt: posts the ante 25
Go4ElvIS: posts the ante 25
mennck: posts the ante 25
$aymon9: posts the ante 25
mennck: posts small blind 50
$aymon9: posts big blind 100
*** HOLE CARDS ***
dulek_jason: folds 
jessecesar: folds 
whaleptt: raises 120 to 220
Go4ElvIS: folds 
mennck: folds 
$aymon9: calls 120
*** FLOP *** [Ad 8c 5s]
$aymon9: checks 
whaleptt: bets 160
$aymon9: calls 160
*** TURN *** [Ad 8c 5s] [Qc]
$aymon9: checks 
whaleptt: checks 
*** RIVER *** [Ad 8c 5s Qc] [9c]
$aymon9: bets 600
whaleptt: folds 
Uncalled bet (600) returned to $aymon9
$aymon9 collected 960 from pot
*** SUMMARY ***
Total pot 960 | Rake 0 
Board [Ad 8c 5s Qc 9c]
Seat 1: dulek_jason folded before Flop (didn't bet)
Seat 2: jessecesar folded before Flop (didn't bet)
Seat 3: whaleptt folded on the River
Seat 4: Go4ElvIS (button) folded before Flop (didn't bet)
Seat 5: mennck (small blind) folded before Flop
Seat 6: $aymon9 (big blind) collected (960)

PokerStars Hand #251209261585: Tournament #3769361908, $52.38+$2.62 USD Hold'em No Limit - Level V (60/120) - 2024/06/26 22:15:16 UTC [2024/06/26 18:15:16 ET]
Table '3769361908 14' 6-max Seat #5 is the button
Seat 1: dulek_jason (11242 in chips) 
Seat 2: jessecesar (8435 in chips) 
Seat 3: whaleptt (6156 in chips) 
Seat 4: Go4ElvIS (5586 in chips) 
Seat 5: mennck (6169 in chips) 
Seat 6: $aymon9 (16588 in chips) 
dulek_jason: posts the ante 30
jessecesar: posts the ante 30
whaleptt: posts the ante 30
Go4ElvIS: posts the ante 30
mennck: posts the ante 30
$aymon9: posts the ante 30
$aymon9: posts small blind 60
dulek_jason: posts big blind 120
*** HOLE CARDS ***
jessecesar: raises 120 to 240
whaleptt: folds 
Go4ElvIS: folds 
mennck: folds 
$aymon9: raises 720 to 960
dulek_jason: folds 
jessecesar: folds 
Uncalled bet (720) returned to $aymon9
$aymon9 collected 780 from pot
*** SUMMARY ***
Total pot 780 | Rake 0 
Seat 1: dulek_jason (big blind) folded before Flop
Seat 2: jessecesar folded before Flop
Seat 3: whaleptt folded before Flop (didn't bet)
Seat 4: Go4ElvIS folded before Flop (didn't bet)
Seat 5: mennck (button) folded before Flop (didn't bet)
Seat 6: $aymon9 (small blind) collected (780)

PokerStars Hand #251209269202: Tournament #3769361908, $52.38+$2.62 USD Hold'em No Limit - Level V (60/120) - 2024/06/26 22:15:43 UTC [2024/06/26 18:15:43 ET]
Table '3769361908 14' 6-max Seat #6 is the button
Seat 1: dulek_jason (11092 in chips) 
Seat 2: jessecesar (8165 in chips) 
Seat 3: whaleptt (6126 in chips) 
Seat 4: Go4ElvIS (5556 in chips) 
Seat 5: mennck (6139 in chips) 
Seat 6: $aymon9 (17098 in chips) 
dulek_jason: posts the ante 30
jessecesar: posts the ante 30
whaleptt: posts the ante 30
Go4ElvIS: posts the ante 30
mennck: posts the ante 30
$aymon9: posts the ante 30
dulek_jason: posts small blind 60
jessecesar: posts big blind 120
*** HOLE CARDS ***
whaleptt: folds 
Go4ElvIS: raises 132 to 252
mennck: folds 
$aymon9: raises 468 to 720
dulek_jason: folds 
jessecesar: folds 
Go4ElvIS: raises 4806 to 5526 and is all-in
$aymon9: folds 
Uncalled bet (4806) returned to Go4ElvIS
Go4ElvIS collected 1800 from pot
Go4ElvIS: doesn't show hand 
*** SUMMARY ***
Total pot 1800 | Rake 0 
Seat 1: dulek_jason (small blind) folded before Flop
Seat 2: jessecesar (big blind) folded before Flop
Seat 3: whaleptt folded before Flop (didn't bet)
Seat 4: Go4ElvIS collected (1800)
Seat 5: mennck folded before Flop (didn't bet)
Seat 6: $aymon9 (button) folded before Flop

PokerStars Hand #251209281404: Tournament #3769361908, $52.38+$2.62 USD Hold'em No Limit - Level V (60/120) - 2024/06/26 22:16:26 UTC [2024/06/26 18:16:26 ET]
Table '3769361908 14' 6-max Seat #1 is the button
Seat 1: dulek_jason (11002 in chips) 
Seat 2: jessecesar (8015 in chips) 
Seat 3: whaleptt (6096 in chips) 
Seat 4: Go4ElvIS (6606 in chips) 
Seat 5: mennck (6109 in chips) 
Seat 6: $aymon9 (16348 in chips) 
dulek_jason: posts the ante 30
jessecesar: posts the ante 30
whaleptt: posts the ante 30
Go4ElvIS: posts the ante 30
mennck: posts the ante 30
$aymon9: posts the ante 30
jessecesar: posts small blind 60
whaleptt: posts big blind 120
*** HOLE CARDS ***
Go4ElvIS: folds 
mennck: raises 156 to 276
$aymon9: folds 
dulek_jason: folds 
jessecesar: folds 
whaleptt: calls 156
*** FLOP *** [Td 8h 9c]
whaleptt: checks 
mennck: checks 
*** TURN *** [Td 8h 9c] [2c]
whaleptt: checks 
mennck: checks 
*** RIVER *** [Td 8h 9c 2c] [2d]
whaleptt: checks 
mennck: bets 436
whaleptt: folds 
Uncalled bet (436) returned to mennck
mennck collected 792 from pot
mennck: doesn't show hand 
*** SUMMARY ***
Total pot 792 | Rake 0 
Board [Td 8h 9c 2c 2d]
Seat 1: dulek_jason (button) folded before Flop (didn't bet)
Seat 2: jessecesar (small blind) folded before Flop
Seat 3: whaleptt (big blind) folded on the River
Seat 4: Go4ElvIS folded before Flop (didn't bet)
Seat 5: mennck collected (792)
Seat 6: $aymon9 folded before Flop (didn't bet)

PokerStars Hand #251209296699: Tournament #3769361908, $52.38+$2.62 USD Hold'em No Limit - Level VI (80/160) - 2024/06/26 22:17:21 UTC [2024/06/26 18:17:21 ET]
Table '3769361908 14' 6-max Seat #2 is the button
Seat 1: dulek_jason (10972 in chips) 
Seat 2: jessecesar (7925 in chips) 
Seat 3: whaleptt (5790 in chips) 
Seat 4: Go4ElvIS (6576 in chips) 
Seat 5: mennck (6595 in chips) 
Seat 6: $aymon9 (16318 in chips) 
dulek_jason: posts the ante 40
jessecesar: posts the ante 40
whaleptt: posts the ante 40
Go4ElvIS: posts the ante 40
mennck: posts the ante 40
$aymon9: posts the ante 40
whaleptt: posts small blind 80
Go4ElvIS: posts big blind 160
*** HOLE CARDS ***
mennck: folds 
$aymon9: folds 
dulek_jason: folds 
jessecesar: raises 160 to 320
whaleptt: folds 
Go4ElvIS: folds 
Uncalled bet (160) returned to jessecesar
jessecesar collected 640 from pot
jessecesar: doesn't show hand 
*** SUMMARY ***
Total pot 640 | Rake 0 
Seat 1: dulek_jason folded before Flop (didn't bet)
Seat 2: jessecesar (button) collected (640)
Seat 3: whaleptt (small blind) folded before Flop
Seat 4: Go4ElvIS (big blind) folded before Flop
Seat 5: mennck folded before Flop (didn't bet)
Seat 6: $aymon9 folded before Flop (didn't bet)

PokerStars Hand #251209302238: Tournament #3769361908, $52.38+$2.62 USD Hold'em No Limit - Level VI (80/160) - 2024/06/26 22:17:40 UTC [2024/06/26 18:17:40 ET]
Table '3769361908 14' 6-max Seat #3 is the button
Seat 1: dulek_jason (10932 in chips) 
Seat 2: jessecesar (8365 in chips) 
Seat 3: whaleptt (5670 in chips) 
Seat 4: Go4ElvIS (6376 in chips) 
Seat 5: mennck (6555 in chips) 
Seat 6: $aymon9 (16278 in chips) 
dulek_jason: posts the ante 40
jessecesar: posts the ante 40
whaleptt: posts the ante 40
Go4ElvIS: posts the ante 40
mennck: posts the ante 40
$aymon9: posts the ante 40
Go4ElvIS: posts small blind 80
mennck: posts big blind 160
*** HOLE CARDS ***
$aymon9: folds 
dulek_jason: raises 182 to 342
jessecesar: raises 698 to 1040
whaleptt: folds 
Go4ElvIS: folds 
mennck: folds 
dulek_jason: calls 698
*** FLOP *** [4c 7s 2c]
dulek_jason: checks 
jessecesar: bets 844
dulek_jason: raises 1402 to 2246
jessecesar: raises 5039 to 7285 and is all-in
dulek_jason: calls 5039
*** TURN *** [4c 7s 2c] [Ts]
*** RIVER *** [4c 7s 2c Ts] [6h]
*** SHOW DOWN ***
dulek_jason: shows [9c 9d] (a pair of Nines)
jessecesar: shows [Th Td] (three of a kind, Tens)
jessecesar collected 17130 from pot
*** SUMMARY ***
Total pot 17130 | Rake 0 
Board [4c 7s 2c Ts 6h]
Seat 1: dulek_jason showed [9c 9d] and lost with a pair of Nines
Seat 2: jessecesar showed [Th Td] and won (17130) with three of a kind, Tens
Seat 3: whaleptt (button) folded before Flop (didn't bet)
Seat 4: Go4ElvIS (small blind) folded before Flop
Seat 5: mennck (big blind) folded before Flop
Seat 6: $aymon9 folded before Flop (didn't bet)

PokerStars Hand #251209321426: Tournament #3769361908, $52.38+$2.62 USD Hold'em No Limit - Level VI (80/160) - 2024/06/26 22:18:48 UTC [2024/06/26 18:18:48 ET]
Table '3769361908 14' 6-max Seat #4 is the button
Seat 1: dulek_jason (2567 in chips) 
Seat 2: jessecesar (17130 in chips) 
Seat 3: whaleptt (5630 in chips) 
Seat 4: Go4ElvIS (6256 in chips) 
Seat 5: mennck (6355 in chips) 
Seat 6: $aymon9 (16238 in chips) 
dulek_jason: posts the ante 40
jessecesar: posts the ante 40
whaleptt: posts the ante 40
Go4ElvIS: posts the ante 40
mennck: posts the ante 40
$aymon9: posts the ante 40
mennck: posts small blind 80
$aymon9: posts big blind 160
*** HOLE CARDS ***
dulek_jason: raises 160 to 320
jessecesar: raises 480 to 800
whaleptt: folds 
Go4ElvIS: folds 
mennck: folds 
$aymon9: folds 
dulek_jason: folds 
Uncalled bet (480) returned to jessecesar
jessecesar collected 1120 from pot
jessecesar: doesn't show hand 
*** SUMMARY ***
Total pot 1120 | Rake 0 
Seat 1: dulek_jason folded before Flop
Seat 2: jessecesar collected (1120)
Seat 3: whaleptt folded before Flop (didn't bet)
Seat 4: Go4ElvIS (button) folded before Flop (didn't bet)
Seat 5: mennck (small blind) folded before Flop
Seat 6: $aymon9 (big blind) folded before Flop

PokerStars Hand #251209330082: Tournament #3769361908, $52.38+$2.62 USD Hold'em No Limit - Level VI (80/160) - 2024/06/26 22:19:20 UTC [2024/06/26 18:19:20 ET]
Table '3769361908 14' 6-max Seat #5 is the button
Seat 1: dulek_jason (2207 in chips) 
Seat 2: jessecesar (17890 in chips) 
Seat 3: whaleptt (5590 in chips) 
Seat 4: Go4ElvIS (6216 in chips) 
Seat 5: mennck (6235 in chips) 
Seat 6: $aymon9 (16038 in chips) 
dulek_jason: posts the ante 40
jessecesar: posts the ante 40
whaleptt: posts the ante 40
Go4ElvIS: posts the ante 40
mennck: posts the ante 40
$aymon9: posts the ante 40
$aymon9: posts small blind 80
dulek_jason: posts big blind 160
*** HOLE CARDS ***
jessecesar: folds 
whaleptt: folds 
Go4ElvIS: folds 
mennck: folds 
$aymon9: raises 15838 to 15998 and is all-in
dulek_jason: calls 2007 and is all-in
Uncalled bet (13831) returned to $aymon9
*** FLOP *** [7h 5d Qc]
*** TURN *** [7h 5d Qc] [Kc]
*** RIVER *** [7h 5d Qc Kc] [7s]
*** SHOW DOWN ***
$aymon9: shows [Th 9d] (a pair of Sevens)
dulek_jason: shows [Ks 6s] (two pair, Kings and Sevens)
dulek_jason collected 4574 from pot
*** SUMMARY ***
Total pot 4574 | Rake 0 
Board [7h 5d Qc Kc 7s]
Seat 1: dulek_jason (big blind) showed [Ks 6s] and won (4574) with two pair, Kings and Sevens
Seat 2: jessecesar folded before Flop (didn't bet)
Seat 3: whaleptt folded before Flop (didn't bet)
Seat 4: Go4ElvIS folded before Flop (didn't bet)
Seat 5: mennck (button) folded before Flop (didn't bet)
Seat 6: $aymon9 (small blind) showed [Th 9d] and lost with a pair of Sevens

PokerStars Hand #251209337605: Tournament #3769361908, $52.38+$2.62 USD Hold'em No Limit - Level VI (80/160) - 2024/06/26 22:19:46 UTC [2024/06/26 18:19:46 ET]
Table '3769361908 14' 6-max Seat #6 is the button
Seat 1: dulek_jason (4574 in chips) 
Seat 2: jessecesar (17850 in chips) 
Seat 3: whaleptt (5550 in chips) 
Seat 4: Go4ElvIS (6176 in chips) 
Seat 5: mennck (6195 in chips) 
Seat 6: $aymon9 (13831 in chips) 
dulek_jason: posts the ante 40
jessecesar: posts the ante 40
whaleptt: posts the ante 40
Go4ElvIS: posts the ante 40
mennck: posts the ante 40
$aymon9: posts the ante 40
dulek_jason: posts small blind 80
jessecesar: posts big blind 160
*** HOLE CARDS ***
whaleptt: folds 
Go4ElvIS: folds 
mennck: folds 
$aymon9: folds 
dulek_jason: calls 80
jessecesar: checks 
*** FLOP *** [3s Ks Ad]
dulek_jason: bets 160
jessecesar: folds 
Uncalled bet (160) returned to dulek_jason
dulek_jason collected 560 from pot
dulek_jason: doesn't show hand 
*** SUMMARY ***
Total pot 560 | Rake 0 
Board [3s Ks Ad]
Seat 1: dulek_jason (small blind) collected (560)
Seat 2: jessecesar (big blind) folded on the Flop
Seat 3: whaleptt folded before Flop (didn't bet)
Seat 4: Go4ElvIS folded before Flop (didn't bet)
Seat 5: mennck folded before Flop (didn't bet)
Seat 6: $aymon9 (button) folded before Flop (didn't bet)

PokerStars Hand #251209350481: Tournament #3769361908, $52.38+$2.62 USD Hold'em No Limit - Level VII (100/200) - 2024/06/26 22:20:33 UTC [2024/06/26 18:20:33 ET]
Table '3769361908 14' 6-max Seat #1 is the button
Seat 1: dulek_jason (4934 in chips) 
Seat 2: jessecesar (17650 in chips) 
Seat 3: whaleptt (5510 in chips) 
Seat 4: Go4ElvIS (6136 in chips) 
Seat 5: mennck (6155 in chips) 
Seat 6: $aymon9 (13791 in chips) 
dulek_jason: posts the ante 50
jessecesar: posts the ante 50
whaleptt: posts the ante 50
Go4ElvIS: posts the ante 50
mennck: posts the ante 50
$aymon9: posts the ante 50
jessecesar: posts small blind 100
whaleptt: posts big blind 200
*** HOLE CARDS ***
Go4ElvIS: folds 
mennck: folds 
$aymon9: raises 200 to 400
dulek_jason: folds 
jessecesar: folds 
whaleptt: calls 200
*** FLOP *** [5s 9s 3c]
whaleptt: checks 
$aymon9: bets 396
whaleptt: calls 396
*** TURN *** [5s 9s 3c] [2h]
whaleptt: checks 
$aymon9: checks 
*** RIVER *** [5s 9s 3c 2h] [2c]
whaleptt: bets 657
$aymon9: folds 
Uncalled bet (657) returned to whaleptt
whaleptt collected 1992 from pot
whaleptt: doesn't show hand 
*** SUMMARY ***
Total pot 1992 | Rake 0 
Board [5s 9s 3c 2h 2c]
Seat 1: dulek_jason (button) folded before Flop (didn't bet)
Seat 2: jessecesar (small blind) folded before Flop
Seat 3: whaleptt (big blind) collected (1992)
Seat 4: Go4ElvIS folded before Flop (didn't bet)
Seat 5: mennck folded before Flop (didn't bet)
Seat 6: $aymon9 folded on the River

PokerStars Hand #251209371267: Tournament #3769361908, $52.38+$2.62 USD Hold'em No Limit - Level VII (100/200) - 2024/06/26 22:21:47 UTC [2024/06/26 18:21:47 ET]
Table '3769361908 14' 6-max Seat #2 is the button
Seat 1: dulek_jason (4884 in chips) 
Seat 2: jessecesar (17500 in chips) 
Seat 3: whaleptt (6656 in chips) 
Seat 4: Go4ElvIS (6086 in chips) 
Seat 5: mennck (6105 in chips) 
Seat 6: $aymon9 (12945 in chips) 
dulek_jason: posts the ante 50
jessecesar: posts the ante 50
whaleptt: posts the ante 50
Go4ElvIS: posts the ante 50
mennck: posts the ante 50
$aymon9: posts the ante 50
whaleptt: posts small blind 100
Go4ElvIS: posts big blind 200
*** HOLE CARDS ***
mennck: folds 
$aymon9: folds 
dulek_jason: raises 200 to 400
jessecesar: folds 
whaleptt: folds 
Go4ElvIS: folds 
Uncalled bet (200) returned to dulek_jason
dulek_jason collected 800 from pot
dulek_jason: doesn't show hand 
*** SUMMARY ***
Total pot 800 | Rake 0 
Seat 1: dulek_jason collected (800)
Seat 2: jessecesar (button) folded before Flop (didn't bet)
Seat 3: whaleptt (small blind) folded before Flop
Seat 4: Go4ElvIS (big blind) folded before Flop
Seat 5: mennck folded before Flop (didn't bet)
Seat 6: $aymon9 folded before Flop (didn't bet)

PokerStars Hand #251209377245: Tournament #3769361908, $52.38+$2.62 USD Hold'em No Limit - Level VII (100/200) - 2024/06/26 22:22:08 UTC [2024/06/26 18:22:08 ET]
Table '3769361908 14' 6-max Seat #3 is the button
Seat 1: dulek_jason (5434 in chips) 
Seat 2: jessecesar (17450 in chips) 
Seat 3: whaleptt (6506 in chips) 
Seat 4: Go4ElvIS (5836 in chips) 
Seat 5: mennck (6055 in chips) 
Seat 6: $aymon9 (12895 in chips) 
dulek_jason: posts the ante 50
jessecesar: posts the ante 50
whaleptt: posts the ante 50
Go4ElvIS: posts the ante 50
mennck: posts the ante 50
$aymon9: posts the ante 50
Go4ElvIS: posts small blind 100
mennck: posts big blind 200
*** HOLE CARDS ***
$aymon9: folds 
dulek_jason: folds 
jessecesar: folds 
whaleptt: raises 200 to 400
Go4ElvIS: calls 300
mennck: calls 200
*** FLOP *** [Ad 4d Ts]
Go4ElvIS: checks 
mennck: checks 
whaleptt: checks 
*** TURN *** [Ad 4d Ts] [8h]
Go4ElvIS: bets 1000
mennck: folds 
whaleptt: folds 
Uncalled bet (1000) returned to Go4ElvIS
Go4ElvIS collected 1500 from pot
Go4ElvIS: doesn't show hand 
*** SUMMARY ***
Total pot 1500 | Rake 0 
Board [Ad 4d Ts 8h]
Seat 1: dulek_jason folded before Flop (didn't bet)
Seat 2: jessecesar folded before Flop (didn't bet)
Seat 3: whaleptt (button) folded on the Turn
Seat 4: Go4ElvIS (small blind) collected (1500)
Seat 5: mennck (big blind) folded on the Turn
Seat 6: $aymon9 folded before Flop (didn't bet)

PokerStars Hand #251209391219: Tournament #3769361908, $52.38+$2.62 USD Hold'em No Limit - Level VII (100/200) - 2024/06/26 22:22:58 UTC [2024/06/26 18:22:58 ET]
Table '3769361908 14' 6-max Seat #4 is the button
Seat 1: dulek_jason (5384 in chips) 
Seat 2: jessecesar (17400 in chips) 
Seat 3: whaleptt (6056 in chips) 
Seat 4: Go4ElvIS (6886 in chips) 
Seat 5: mennck (5605 in chips) 
Seat 6: $aymon9 (12845 in chips) 
dulek_jason: posts the ante 50
jessecesar: posts the ante 50
whaleptt: posts the ante 50
Go4ElvIS: posts the ante 50
mennck: posts the ante 50
$aymon9: posts the ante 50
mennck: posts small blind 100
$aymon9: posts big blind 200
*** HOLE CARDS ***
dulek_jason: folds 
jessecesar: folds 
whaleptt: raises 200 to 400
Go4ElvIS: folds 
mennck: folds 
$aymon9: calls 200
*** FLOP *** [Kh 9s 9c]
$aymon9: checks 
whaleptt: bets 300
$aymon9: calls 300
*** TURN *** [Kh 9s 9c] [5s]
$aymon9: checks 
whaleptt: checks 
*** RIVER *** [Kh 9s 9c 5s] [9h]
$aymon9: bets 1200
whaleptt: calls 1200
*** SHOW DOWN ***
$aymon9: shows [Td Jd] (three of a kind, Nines)
whaleptt: shows [8c Ad] (three of a kind, Nines - Ace kicker)
whaleptt collected 4200 from pot
*** SUMMARY ***
Total pot 4200 | Rake 0 
Board [Kh 9s 9c 5s 9h]
Seat 1: dulek_jason folded before Flop (didn't bet)
Seat 2: jessecesar folded before Flop (didn't bet)
Seat 3: whaleptt showed [8c Ad] and won (4200) with three of a kind, Nines
Seat 4: Go4ElvIS (button) folded before Flop (didn't bet)
Seat 5: mennck (small blind) folded before Flop
Seat 6: $aymon9 (big blind) showed [Td Jd] and lost with three of a kind, Nines

PokerStars Hand #251209420638: Tournament #3769361908, $52.38+$2.62 USD Hold'em No Limit - Level VIII (125/250) - 2024/06/26 22:24:45 UTC [2024/06/26 18:24:45 ET]
Table '3769361908 14' 6-max Seat #5 is the button
Seat 1: dulek_jason (5334 in chips) 
Seat 2: jessecesar (17350 in chips) 
Seat 3: whaleptt (8306 in chips) 
Seat 4: Go4ElvIS (6836 in chips) 
Seat 5: mennck (5455 in chips) 
Seat 6: $aymon9 (10895 in chips) 
dulek_jason: posts the ante 60
jessecesar: posts the ante 60
whaleptt: posts the ante 60
Go4ElvIS: posts the ante 60
mennck: posts the ante 60
$aymon9: posts the ante 60
$aymon9: posts small blind 125
dulek_jason: posts big blind 250
*** HOLE CARDS ***
jessecesar: raises 250 to 500
whaleptt: folds 
Go4ElvIS: folds 
mennck: folds 
$aymon9: folds 
dulek_jason: folds 
Uncalled bet (250) returned to jessecesar
jessecesar collected 985 from pot
jessecesar: doesn't show hand 
*** SUMMARY ***
Total pot 985 | Rake 0 
Seat 1: dulek_jason (big blind) folded before Flop
Seat 2: jessecesar collected (985)
Seat 3: whaleptt folded before Flop (didn't bet)
Seat 4: Go4ElvIS folded before Flop (didn't bet)
Seat 5: mennck (button) folded before Flop (didn't bet)
Seat 6: $aymon9 (small blind) folded before Flop

PokerStars Hand #251209428525: Tournament #3769361908, $52.38+$2.62 USD Hold'em No Limit - Level VIII (125/250) - 2024/06/26 22:25:13 UTC [2024/06/26 18:25:13 ET]
Table '3769361908 14' 6-max Seat #6 is the button
Seat 1: dulek_jason (5024 in chips) 
Seat 2: jessecesar (18025 in chips) 
Seat 3: whaleptt (8246 in chips) 
Seat 4: Go4ElvIS (6776 in chips) 
Seat 5: mennck (5395 in chips) 
Seat 6: $aymon9 (10710 in chips) 
dulek_jason: posts the ante 60
jessecesar: posts the ante 60
whaleptt: posts the ante 60
Go4ElvIS: posts the ante 60
mennck: posts the ante 60
$aymon9: posts the ante 60
dulek_jason: posts small blind 125
jessecesar: posts big blind 250
*** HOLE CARDS ***
whaleptt: raises 250 to 500
Go4ElvIS: raises 6216 to 6716 and is all-in
mennck: folds 
$aymon9: folds 
dulek_jason: folds 
jessecesar: folds 
whaleptt: folds 
Uncalled bet (6216) returned to Go4ElvIS
Go4ElvIS collected 1735 from pot
Go4ElvIS: doesn't show hand 
*** SUMMARY ***
Total pot 1735 | Rake 0 
Seat 1: dulek_jason (small blind) folded before Flop
Seat 2: jessecesar (big blind) folded before Flop
Seat 3: whaleptt folded before Flop
Seat 4: Go4ElvIS collected (1735)
Seat 5: mennck folded before Flop (didn't bet)
Seat 6: $aymon9 (button) folded before Flop (didn't bet)

PokerStars Hand #251209437100: Tournament #3769361908, $52.38+$2.62 USD Hold'em No Limit - Level VIII (125/250) - 2024/06/26 22:25:44 UTC [2024/06/26 18:25:44 ET]
Table '3769361908 14' 6-max Seat #1 is the button
Seat 1: dulek_jason (4839 in chips) 
Seat 2: jessecesar (17715 in chips) 
Seat 3: whaleptt (7686 in chips) 
Seat 4: Go4ElvIS (7951 in chips) 
Seat 5: mennck (5335 in chips) 
Seat 6: $aymon9 (10650 in chips) 
dulek_jason: posts the ante 60
jessecesar: posts the ante 60
whaleptt: posts the ante 60
Go4ElvIS: posts the ante 60
mennck: posts the ante 60
$aymon9: posts the ante 60
jessecesar: posts small blind 125
whaleptt: posts big blind 250
*** HOLE CARDS ***
Go4ElvIS: folds 
mennck: folds 
$aymon9: raises 250 to 500
dulek_jason: raises 750 to 1250
jessecesar: folds 
whaleptt: folds 
$aymon9: raises 9340 to 10590 and is all-in
dulek_jason: calls 3529 and is all-in
Uncalled bet (5811) returned to $aymon9
*** FLOP *** [Qd 6d 8c]
*** TURN *** [Qd 6d 8c] [Td]
*** RIVER *** [Qd 6d 8c Td] [3s]
*** SHOW DOWN ***
$aymon9: shows [2d 2h] (a pair of Deuces)
dulek_jason: shows [Jh Jc] (a pair of Jacks)
dulek_jason collected 10293 from pot
*** SUMMARY ***
Total pot 10293 | Rake 0 
Board [Qd 6d 8c Td 3s]
Seat 1: dulek_jason (button) showed [Jh Jc] and won (10293) with a pair of Jacks
Seat 2: jessecesar (small blind) folded before Flop
Seat 3: whaleptt (big blind) folded before Flop
Seat 4: Go4ElvIS folded before Flop (didn't bet)
Seat 5: mennck folded before Flop (didn't bet)
Seat 6: $aymon9 showed [2d 2h] and lost with a pair of Deuces

PokerStars Hand #251209449480: Tournament #3769361908, $52.38+$2.62 USD Hold'em No Limit - Level IX (150/300) - 2024/06/26 22:26:29 UTC [2024/06/26 18:26:29 ET]
Table '3769361908 14' 6-max Seat #2 is the button
Seat 1: dulek_jason (10293 in chips) 
Seat 2: jessecesar (17530 in chips) 
Seat 3: whaleptt (7376 in chips) 
Seat 4: Go4ElvIS (7891 in chips) 
Seat 5: mennck (5275 in chips) 
Seat 6: $aymon9 (5811 in chips) 
dulek_jason: posts the ante 75
jessecesar: posts the ante 75
whaleptt: posts the ante 75
Go4ElvIS: posts the ante 75
mennck: posts the ante 75
$aymon9: posts the ante 75
whaleptt: posts small blind 150
Go4ElvIS: posts big blind 300
*** HOLE CARDS ***
mennck: folds 
$aymon9: folds 
dulek_jason: raises 300 to 600
jessecesar: raises 1200 to 1800
whaleptt: raises 5501 to 7301 and is all-in
Go4ElvIS: folds 
dulek_jason: folds 
jessecesar: folds 
Uncalled bet (5501) returned to whaleptt
whaleptt collected 4950 from pot
whaleptt: doesn't show hand 
*** SUMMARY ***
Total pot 4950 | Rake 0 
Seat 1: dulek_jason folded before Flop
Seat 2: jessecesar (button) folded before Flop
Seat 3: whaleptt (small blind) collected (4950)
Seat 4: Go4ElvIS (big blind) folded before Flop
Seat 5: mennck folded before Flop (didn't bet)
Seat 6: $aymon9 folded before Flop (didn't bet)

PokerStars Hand #251209461010: Tournament #3769361908, $52.38+$2.62 USD Hold'em No Limit - Level IX (150/300) - 2024/06/26 22:27:10 UTC [2024/06/26 18:27:10 ET]
Table '3769361908 14' 6-max Seat #3 is the button
Seat 1: dulek_jason (9618 in chips) 
Seat 2: jessecesar (15655 in chips) 
Seat 3: whaleptt (10451 in chips) 
Seat 4: Go4ElvIS (7516 in chips) 
Seat 5: mennck (5200 in chips) 
Seat 6: $aymon9 (5736 in chips) 
dulek_jason: posts the ante 75
jessecesar: posts the ante 75
whaleptt: posts the ante 75
Go4ElvIS: posts the ante 75
mennck: posts the ante 75
$aymon9: posts the ante 75
Go4ElvIS: posts small blind 150
mennck: posts big blind 300
*** HOLE CARDS ***
$aymon9: folds 
dulek_jason: folds 
jessecesar: folds 
whaleptt: raises 300 to 600
Go4ElvIS: raises 6841 to 7441 and is all-in
mennck: folds 
whaleptt: folds 
Uncalled bet (6841) returned to Go4ElvIS
Go4ElvIS collected 1950 from pot
Go4ElvIS: doesn't show hand 
*** SUMMARY ***
Total pot 1950 | Rake 0 
Seat 1: dulek_jason folded before Flop (didn't bet)
Seat 2: jessecesar folded before Flop (didn't bet)
Seat 3: whaleptt (button) folded before Flop
Seat 4: Go4ElvIS (small blind) collected (1950)
Seat 5: mennck (big blind) folded before Flop
Seat 6: $aymon9 folded before Flop (didn't bet)

PokerStars Hand #251209469081: Tournament #3769361908, $52.38+$2.62 USD Hold'em No Limit - Level IX (150/300) - 2024/06/26 22:27:39 UTC [2024/06/26 18:27:39 ET]
Table '3769361908 14' 6-max Seat #4 is the button
Seat 1: dulek_jason (9543 in chips) 
Seat 2: jessecesar (15580 in chips) 
Seat 3: whaleptt (9776 in chips) 
Seat 4: Go4ElvIS (8791 in chips) 
Seat 5: mennck (4825 in chips) 
Seat 6: $aymon9 (5661 in chips) 
dulek_jason: posts the ante 75
jessecesar: posts the ante 75
whaleptt: posts the ante 75
Go4ElvIS: posts the ante 75
mennck: posts the ante 75
$aymon9: posts the ante 75
mennck: posts small blind 150
$aymon9: posts big blind 300
*** HOLE CARDS ***
dulek_jason: raises 300 to 600
jessecesar: folds 
whaleptt: raises 900 to 1500
Go4ElvIS: folds 
mennck: folds 
$aymon9: folds 
dulek_jason: calls 900
*** FLOP *** [Ts Qh 6d]
dulek_jason: checks 
whaleptt: bets 1287
dulek_jason: calls 1287
*** TURN *** [Ts Qh 6d] [2c]
dulek_jason: checks 
whaleptt: bets 6914 and is all-in
dulek_jason: calls 6681 and is all-in
Uncalled bet (233) returned to whaleptt
*** RIVER *** [Ts Qh 6d 2c] [6c]
*** SHOW DOWN ***
dulek_jason: shows [Ad Ah] (two pair, Aces and Sixes)
whaleptt: shows [Jh Ac] (a pair of Sixes)
dulek_jason collected 19836 from pot
*** SUMMARY ***
Total pot 19836 | Rake 0 
Board [Ts Qh 6d 2c 6c]
Seat 1: dulek_jason showed [Ad Ah] and won (19836) with two pair, Aces and Sixes
Seat 2: jessecesar folded before Flop (didn't bet)
Seat 3: whaleptt showed [Jh Ac] and lost with a pair of Sixes
Seat 4: Go4ElvIS (button) folded before Flop (didn't bet)
Seat 5: mennck (small blind) folded before Flop
Seat 6: $aymon9 (big blind) folded before Flop

PokerStars Hand #251209484500: Tournament #3769361908, $52.38+$2.62 USD Hold'em No Limit - Level IX (150/300) - 2024/06/26 22:28:34 UTC [2024/06/26 18:28:34 ET]
Table '3769361908 14' 6-max Seat #5 is the button
Seat 1: dulek_jason (19836 in chips) 
Seat 2: jessecesar (15505 in chips) 
Seat 3: whaleptt (233 in chips) 
Seat 4: Go4ElvIS (8716 in chips) 
Seat 5: mennck (4600 in chips) 
Seat 6: $aymon9 (5286 in chips) 
dulek_jason: posts the ante 75
jessecesar: posts the ante 75
whaleptt: posts the ante 75
Go4ElvIS: posts the ante 75
mennck: posts the ante 75
$aymon9: posts the ante 75
$aymon9: posts small blind 150
dulek_jason: posts big blind 300
*** HOLE CARDS ***
jessecesar: folds 
whaleptt: calls 158 and is all-in
Go4ElvIS: folds 
mennck: folds 
$aymon9: folds 
Uncalled bet (142) returned to dulek_jason
*** FLOP *** [8c Qd 5h]
*** TURN *** [8c Qd 5h] [7s]
*** RIVER *** [8c Qd 5h 7s] [Ah]
*** SHOW DOWN ***
dulek_jason: shows [4s 2h] (high card Ace)
whaleptt: shows [Ad 5c] (two pair, Aces and Fives)
whaleptt collected 916 from pot
*** SUMMARY ***
Total pot 916 | Rake 0 
Board [8c Qd 5h 7s Ah]
Seat 1: dulek_jason (big blind) showed [4s 2h] and lost with high card Ace
Seat 2: jessecesar folded before Flop (didn't bet)
Seat 3: whaleptt showed [Ad 5c] and won (916) with two pair, Aces and Fives
Seat 4: Go4ElvIS folded before Flop (didn't bet)
Seat 5: mennck (button) folded before Flop (didn't bet)
Seat 6: $aymon9 (small blind) folded before Flop

PokerStars Hand #251209493269: Tournament #3769361908, $52.38+$2.62 USD Hold'em No Limit - Level IX (150/300) - 2024/06/26 22:29:06 UTC [2024/06/26 18:29:06 ET]
Table '3769361908 14' 6-max Seat #6 is the button
Seat 1: dulek_jason (19603 in chips) 
Seat 2: jessecesar (15430 in chips) 
Seat 3: whaleptt (916 in chips) 
Seat 4: Go4ElvIS (8641 in chips) 
Seat 5: mennck (4525 in chips) 
Seat 6: $aymon9 (5061 in chips) 
dulek_jason: posts the ante 75
jessecesar: posts the ante 75
whaleptt: posts the ante 75
Go4ElvIS: posts the ante 75
mennck: posts the ante 75
$aymon9: posts the ante 75
dulek_jason: posts small blind 150
jessecesar: posts big blind 300
*** HOLE CARDS ***
whaleptt: folds 
Go4ElvIS: raises 330 to 630
mennck: folds 
$aymon9: folds 
dulek_jason: folds 
jessecesar: calls 330
*** FLOP *** [Th 2c 9d]
jessecesar: checks 
Go4ElvIS: checks 
*** TURN *** [Th 2c 9d] [Qh]
jessecesar: checks 
Go4ElvIS: checks 
*** RIVER *** [Th 2c 9d Qh] [4d]
jessecesar: bets 615
Go4ElvIS: folds 
Uncalled bet (615) returned to jessecesar
jessecesar collected 1860 from pot
jessecesar: doesn't show hand 
*** SUMMARY ***
Total pot 1860 | Rake 0 
Board [Th 2c 9d Qh 4d]
Seat 1: dulek_jason (small blind) folded before Flop
Seat 2: jessecesar (big blind) collected (1860)
Seat 3: whaleptt folded before Flop (didn't bet)
Seat 4: Go4ElvIS folded on the River
Seat 5: mennck folded before Flop (didn't bet)
Seat 6: $aymon9 (button) folded before Flop (didn't bet)

PokerStars Hand #251209509711: Tournament #3769361908, $52.38+$2.62 USD Hold'em No Limit - Level X (200/400) - 2024/06/26 22:30:05 UTC [2024/06/26 18:30:05 ET]
Table '3769361908 14' 6-max Seat #1 is the button
Seat 1: dulek_jason (19378 in chips) 
Seat 2: jessecesar (16585 in chips) 
Seat 3: whaleptt (841 in chips) 
Seat 4: Go4ElvIS (7936 in chips) 
Seat 5: mennck (4450 in chips) 
Seat 6: $aymon9 (4986 in chips) 
dulek_jason: posts the ante 100
jessecesar: posts the ante 100
whaleptt: posts the ante 100
Go4ElvIS: posts the ante 100
mennck: posts the ante 100
$aymon9: posts the ante 100
jessecesar: posts small blind 200
whaleptt: posts big blind 400
*** HOLE CARDS ***
Go4ElvIS: folds 
mennck: raises 3950 to 4350 and is all-in
$aymon9: folds 
dulek_jason: folds 
jessecesar: folds 
whaleptt: calls 341 and is all-in
Uncalled bet (3609) returned to mennck
*** FLOP *** [2h 2s Kc]
*** TURN *** [2h 2s Kc] [Jd]
*** RIVER *** [2h 2s Kc Jd] [Js]
*** SHOW DOWN ***
whaleptt: shows [Jc 6s] (a full house, Jacks full of Deuces)
mennck: shows [Tc Td] (two pair, Jacks and Tens)
whaleptt collected 2282 from pot
*** SUMMARY ***
Total pot 2282 | Rake 0 
Board [2h 2s Kc Jd Js]
Seat 1: dulek_jason (button) folded before Flop (didn't bet)
Seat 2: jessecesar (small blind) folded before Flop
Seat 3: whaleptt (big blind) showed [Jc 6s] and won (2282) with a full house, Jacks full of Deuces
Seat 4: Go4ElvIS folded before Flop (didn't bet)
Seat 5: mennck showed [Tc Td] and lost with two pair, Jacks and Tens
Seat 6: $aymon9 folded before Flop (didn't bet)

PokerStars Hand #251209517112: Tournament #3769361908, $52.38+$2.62 USD Hold'em No Limit - Level X (200/400) - 2024/06/26 22:30:31 UTC [2024/06/26 18:30:31 ET]
Table '3769361908 14' 6-max Seat #2 is the button
Seat 1: dulek_jason (19278 in chips) 
Seat 2: jessecesar (16285 in chips) 
Seat 3: whaleptt (2282 in chips) 
Seat 4: Go4ElvIS (7836 in chips) 
Seat 5: mennck (3609 in chips) 
Seat 6: $aymon9 (4886 in chips) 
dulek_jason: posts the ante 100
jessecesar: posts the ante 100
whaleptt: posts the ante 100
Go4ElvIS: posts the ante 100
mennck: posts the ante 100
$aymon9: posts the ante 100
whaleptt: posts small blind 200
Go4ElvIS: posts big blind 400
*** HOLE CARDS ***
mennck: folds 
$aymon9: raises 400 to 800
dulek_jason: folds 
jessecesar: folds 
whaleptt: folds 
Go4ElvIS: folds 
Uncalled bet (400) returned to $aymon9
$aymon9 collected 1600 from pot
*** SUMMARY ***
Total pot 1600 | Rake 0 
Seat 1: dulek_jason folded before Flop (didn't bet)
Seat 2: jessecesar (button) folded before Flop (didn't bet)
Seat 3: whaleptt (small blind) folded before Flop
Seat 4: Go4ElvIS (big blind) folded before Flop
Seat 5: mennck folded before Flop (didn't bet)
Seat 6: $aymon9 collected (1600)

PokerStars Hand #251209524166: Tournament #3769361908, $52.38+$2.62 USD Hold'em No Limit - Level X (200/400) - 2024/06/26 22:30:57 UTC [2024/06/26 18:30:57 ET]
Table '3769361908 14' 6-max Seat #3 is the button
Seat 1: dulek_jason (19178 in chips) 
Seat 2: jessecesar (16185 in chips) 
Seat 3: whaleptt (1982 in chips) 
Seat 4: Go4ElvIS (7336 in chips) 
Seat 5: mennck (3509 in chips) 
Seat 6: $aymon9 (5986 in chips) 
dulek_jason: posts the ante 100
jessecesar: posts the ante 100
whaleptt: posts the ante 100
Go4ElvIS: posts the ante 100
mennck: posts the ante 100
$aymon9: posts the ante 100
Go4ElvIS: posts small blind 200
mennck: posts big blind 400
*** HOLE CARDS ***
$aymon9: folds 
dulek_jason: folds 
jessecesar: folds 
whaleptt: folds 
Go4ElvIS: folds 
Uncalled bet (200) returned to mennck
mennck collected 1000 from pot
mennck: doesn't show hand 
*** SUMMARY ***
Total pot 1000 | Rake 0 
Seat 1: dulek_jason folded before Flop (didn't bet)
Seat 2: jessecesar folded before Flop (didn't bet)
Seat 3: whaleptt (button) folded before Flop (didn't bet)
Seat 4: Go4ElvIS (small blind) folded before Flop
Seat 5: mennck (big blind) collected (1000)
Seat 6: $aymon9 folded before Flop (didn't bet)

PokerStars Hand #251209528970: Tournament #3769361908, $52.38+$2.62 USD Hold'em No Limit - Level X (200/400) - 2024/06/26 22:31:15 UTC [2024/06/26 18:31:15 ET]
Table '3769361908 14' 6-max Seat #4 is the button
Seat 1: dulek_jason (19078 in chips) 
Seat 2: jessecesar (16085 in chips) 
Seat 3: whaleptt (1882 in chips) 
Seat 4: Go4ElvIS (7036 in chips) 
Seat 5: mennck (4209 in chips) 
Seat 6: $aymon9 (5886 in chips) 
dulek_jason: posts the ante 100
jessecesar: posts the ante 100
whaleptt: posts the ante 100
Go4ElvIS: posts the ante 100
mennck: posts the ante 100
$aymon9: posts the ante 100
mennck: posts small blind 200
$aymon9: posts big blind 400
*** HOLE CARDS ***
dulek_jason: folds 
jessecesar: raises 400 to 800
whaleptt: folds 
Go4ElvIS: folds 
mennck: folds 
$aymon9: raises 4986 to 5786 and is all-in
jessecesar: folds 
Uncalled bet (4986) returned to $aymon9
$aymon9 collected 2400 from pot
*** SUMMARY ***
Total pot 2400 | Rake 0 
Seat 1: dulek_jason folded before Flop (didn't bet)
Seat 2: jessecesar folded before Flop
Seat 3: whaleptt folded before Flop (didn't bet)
Seat 4: Go4ElvIS (button) folded before Flop (didn't bet)
Seat 5: mennck (small blind) folded before Flop
Seat 6: $aymon9 (big blind) collected (2400)

PokerStars Hand #251209537528: Tournament #3769361908, $52.38+$2.62 USD Hold'em No Limit - Level X (200/400) - 2024/06/26 22:31:46 UTC [2024/06/26 18:31:46 ET]
Table '3769361908 14' 6-max Seat #5 is the button
Seat 1: dulek_jason (18978 in chips) 
Seat 2: jessecesar (15185 in chips) 
Seat 3: whaleptt (1782 in chips) 
Seat 4: Go4ElvIS (6936 in chips) 
Seat 5: mennck (3909 in chips) 
Seat 6: $aymon9 (7386 in chips) 
dulek_jason: posts the ante 100
jessecesar: posts the ante 100
whaleptt: posts the ante 100
Go4ElvIS: posts the ante 100
mennck: posts the ante 100
$aymon9: posts the ante 100
$aymon9: posts small blind 200
dulek_jason: posts big blind 400
*** HOLE CARDS ***
jessecesar: folds 
whaleptt: folds 
Go4ElvIS: folds 
mennck: folds 
$aymon9: calls 200
dulek_jason: checks 
*** FLOP *** [4d 8s Ah]
$aymon9: bets 400
dulek_jason: calls 400
*** TURN *** [4d 8s Ah] [5h]
$aymon9: checks 
dulek_jason: bets 1126
$aymon9: calls 1126
*** RIVER *** [4d 8s Ah 5h] [2h]
$aymon9: checks 
dulek_jason: bets 16952 and is all-in
$aymon9: folds 
Uncalled bet (16952) returned to dulek_jason
dulek_jason collected 4452 from pot
dulek_jason: doesn't show hand 
*** SUMMARY ***
Total pot 4452 | Rake 0 
Board [4d 8s Ah 5h 2h]
Seat 1: dulek_jason (big blind) collected (4452)
Seat 2: jessecesar folded before Flop (didn't bet)
Seat 3: whaleptt folded before Flop (didn't bet)
Seat 4: Go4ElvIS folded before Flop (didn't bet)
Seat 5: mennck (button) folded before Flop (didn't bet)
Seat 6: $aymon9 (small blind) folded on the River

PokerStars Hand #251209559353: Tournament #3769361908, $52.38+$2.62 USD Hold'em No Limit - Level XI (250/500) - 2024/06/26 22:33:06 UTC [2024/06/26 18:33:06 ET]
Table '3769361908 14' 6-max Seat #6 is the button
Seat 1: dulek_jason (21404 in chips) 
Seat 2: jessecesar (15085 in chips) 
Seat 3: whaleptt (1682 in chips) 
Seat 4: Go4ElvIS (6836 in chips) 
Seat 5: mennck (3809 in chips) 
Seat 6: $aymon9 (5360 in chips) 
dulek_jason: posts the ante 125
jessecesar: posts the ante 125
whaleptt: posts the ante 125
Go4ElvIS: posts the ante 125
mennck: posts the ante 125
$aymon9: posts the ante 125
dulek_jason: posts small blind 250
jessecesar: posts big blind 500
*** HOLE CARDS ***
whaleptt: folds 
Go4ElvIS: folds 
mennck: raises 3184 to 3684 and is all-in
$aymon9: folds 
dulek_jason: folds 
jessecesar: folds 
Uncalled bet (3184) returned to mennck
mennck collected 2000 from pot
mennck: doesn't show hand 
*** SUMMARY ***
Total pot 2000 | Rake 0 
Seat 1: dulek_jason (small blind) folded before Flop
Seat 2: jessecesar (big blind) folded before Flop
Seat 3: whaleptt folded before Flop (didn't bet)
Seat 4: Go4ElvIS folded before Flop (didn't bet)
Seat 5: mennck collected (2000)
Seat 6: $aymon9 (button) folded before Flop (didn't bet)

PokerStars Hand #251209564146: Tournament #3769361908, $52.38+$2.62 USD Hold'em No Limit - Level XI (250/500) - 2024/06/26 22:33:24 UTC [2024/06/26 18:33:24 ET]
Table '3769361908 14' 6-max Seat #1 is the button
Seat 1: dulek_jason (21029 in chips) 
Seat 2: jessecesar (14460 in chips) 
Seat 3: whaleptt (1557 in chips) 
Seat 4: Go4ElvIS (6711 in chips) 
Seat 5: mennck (5184 in chips) 
Seat 6: $aymon9 (5235 in chips) 
dulek_jason: posts the ante 125
jessecesar: posts the ante 125
whaleptt: posts the ante 125
Go4ElvIS: posts the ante 125
mennck: posts the ante 125
$aymon9: posts the ante 125
jessecesar: posts small blind 250
whaleptt: posts big blind 500
*** HOLE CARDS ***
Go4ElvIS: folds 
mennck: folds 
$aymon9: raises 4610 to 5110 and is all-in
dulek_jason: folds 
jessecesar: folds 
whaleptt: calls 932 and is all-in
Uncalled bet (3678) returned to $aymon9
*** FLOP *** [7d 2c Jh]
*** TURN *** [7d 2c Jh] [6h]
*** RIVER *** [7d 2c Jh 6h] [Kd]
*** SHOW DOWN ***
whaleptt: shows [3s Js] (a pair of Jacks)
$aymon9: shows [Jc Ad] (a pair of Jacks - Ace kicker)
$aymon9 collected 3864 from pot
whaleptt finished the tournament
*** SUMMARY ***
Total pot 3864 | Rake 0 
Board [7d 2c Jh 6h Kd]
Seat 1: dulek_jason (button) folded before Flop (didn't bet)
Seat 2: jessecesar (small blind) folded before Flop
Seat 3: whaleptt (big blind) showed [3s Js] and lost with a pair of Jacks
Seat 4: Go4ElvIS folded before Flop (didn't bet)
Seat 5: mennck folded before Flop (didn't bet)
Seat 6: $aymon9 showed [Jc Ad] and won (3864) with a pair of Jacks

PokerStars Hand #251209572575: Tournament #3769361908, $52.38+$2.62 USD Hold'em No Limit - Level XI (250/500) - 2024/06/26 22:33:55 UTC [2024/06/26 18:33:55 ET]
Table '3769361908 14' 6-max Seat #2 is the button
Seat 1: dulek_jason (20904 in chips) 
Seat 2: jessecesar (14085 in chips) 
Seat 4: Go4ElvIS (6586 in chips) 
Seat 5: mennck (5059 in chips) 
Seat 6: $aymon9 (7542 in chips) 
dulek_jason: posts the ante 125
jessecesar: posts the ante 125
Go4ElvIS: posts the ante 125
mennck: posts the ante 125
$aymon9: posts the ante 125
Go4ElvIS: posts small blind 250
mennck: posts big blind 500
*** HOLE CARDS ***
$aymon9: raises 500 to 1000
dulek_jason: folds 
jessecesar: folds 
Go4ElvIS: folds 
mennck: calls 500
*** FLOP *** [8h 3h 3s]
mennck: checks 
Gsmith13 is disconnected 
$aymon9: bets 750
mennck: raises 3184 to 3934 and is all-in
$aymon9: calls 3184
*** TURN *** [8h 3h 3s] [Kh]
*** RIVER *** [8h 3h 3s Kh] [Qc]
*** SHOW DOWN ***
mennck: shows [8d Qh] (two pair, Queens and Eights)
$aymon9: shows [Ad 9h] (a pair of Threes)
mennck collected 10743 from pot
*** SUMMARY ***
Total pot 10743 | Rake 0 
Board [8h 3h 3s Kh Qc]
Seat 1: dulek_jason folded before Flop (didn't bet)
Seat 2: jessecesar (button) folded before Flop (didn't bet)
Seat 4: Go4ElvIS (small blind) folded before Flop
Seat 5: mennck (big blind) showed [8d Qh] and won (10743) with two pair, Queens and Eights
Seat 6: $aymon9 showed [Ad 9h] and lost with a pair of Threes

PokerStars Hand #251209585945: Tournament #3769361908, $52.38+$2.62 USD Hold'em No Limit - Level XI (250/500) - 2024/06/26 22:34:45 UTC [2024/06/26 18:34:45 ET]
Table '3769361908 14' 6-max Seat #4 is the button
Seat 1: dulek_jason (20779 in chips) 
Seat 2: jessecesar (13960 in chips) 
Seat 3: Gsmith13 (10000 in chips) 
Seat 4: Go4ElvIS (6211 in chips) 
Seat 5: mennck (10743 in chips) 
Seat 6: $aymon9 (2483 in chips) 
dulek_jason: posts the ante 125
jessecesar: posts the ante 125
Gsmith13: posts the ante 125
Go4ElvIS: posts the ante 125
mennck: posts the ante 125
$aymon9: posts the ante 125
mennck: posts small blind 250
$aymon9: posts big blind 500
*** HOLE CARDS ***
dulek_jason: folds 
jessecesar: folds 
Gsmith13: folds 
Go4ElvIS: folds 
mennck: folds 
Uncalled bet (250) returned to $aymon9
$aymon9 collected 1250 from pot
*** SUMMARY ***
Total pot 1250 | Rake 0 
Seat 1: dulek_jason folded before Flop (didn't bet)
Seat 2: jessecesar folded before Flop (didn't bet)
Seat 3: Gsmith13 folded before Flop (didn't bet)
Seat 4: Go4ElvIS (button) folded before Flop (didn't bet)
Seat 5: mennck (small blind) folded before Flop
Seat 6: $aymon9 (big blind) collected (1250)

PokerStars Hand #251209590578: Tournament #3769361908, $52.38+$2.62 USD Hold'em No Limit - Level XI (250/500) - 2024/06/26 22:35:02 UTC [2024/06/26 18:35:02 ET]
Table '3769361908 14' 6-max Seat #5 is the button
Seat 1: dulek_jason (20654 in chips) 
Seat 2: jessecesar (13835 in chips) 
Seat 3: Gsmith13 (9875 in chips) 
Seat 4: Go4ElvIS (6086 in chips) 
Seat 5: mennck (10368 in chips) 
Seat 6: $aymon9 (3358 in chips) 
dulek_jason: posts the ante 125
jessecesar: posts the ante 125
Gsmith13: posts the ante 125
Go4ElvIS: posts the ante 125
mennck: posts the ante 125
$aymon9: posts the ante 125
$aymon9: posts small blind 250
dulek_jason: posts big blind 500
*** HOLE CARDS ***
jessecesar: folds 
Gsmith13: folds 
Go4ElvIS: folds 
mennck: folds 
$aymon9: raises 2733 to 3233 and is all-in
dulek_jason: calls 2733
*** FLOP *** [5d 5s Kd]
*** TURN *** [5d 5s Kd] [8h]
*** RIVER *** [5d 5s Kd 8h] [4s]
*** SHOW DOWN ***
$aymon9: shows [Th Td] (two pair, Tens and Fives)
dulek_jason: shows [2s Ac] (a pair of Fives)
$aymon9 collected 7216 from pot
*** SUMMARY ***
Total pot 7216 | Rake 0 
Board [5d 5s Kd 8h 4s]
Seat 1: dulek_jason (big blind) showed [2s Ac] and lost with a pair of Fives
Seat 2: jessecesar folded before Flop (didn't bet)
Seat 3: Gsmith13 folded before Flop (didn't bet)
Seat 4: Go4ElvIS folded before Flop (didn't bet)
Seat 5: mennck (button) folded before Flop (didn't bet)
Seat 6: $aymon9 (small blind) showed [Th Td] and won (7216) with two pair, Tens and Fives

PokerStars Hand #251209599285: Tournament #3769361908, $52.38+$2.62 USD Hold'em No Limit - Level XII (300/600) - 2024/06/26 22:35:34 UTC [2024/06/26 18:35:34 ET]
Table '3769361908 14' 6-max Seat #6 is the button
Seat 1: dulek_jason (17296 in chips) 
Seat 2: jessecesar (13710 in chips) 
Seat 3: Gsmith13 (9750 in chips) 
Seat 4: Go4ElvIS (5961 in chips) 
Seat 5: mennck (10243 in chips) 
Seat 6: $aymon9 (7216 in chips) 
dulek_jason: posts the ante 150
jessecesar: posts the ante 150
Gsmith13: posts the ante 150
Go4ElvIS: posts the ante 150
mennck: posts the ante 150
$aymon9: posts the ante 150
dulek_jason: posts small blind 300
jessecesar: posts big blind 600
*** HOLE CARDS ***
Gsmith13: folds 
Go4ElvIS: folds 
mennck: folds 
$aymon9: folds 
dulek_jason: calls 300
jessecesar: checks 
*** FLOP *** [5s Ts Qd]
dulek_jason: checks 
jessecesar: checks 
*** TURN *** [5s Ts Qd] [Jc]
dulek_jason: checks 
jessecesar: checks 
*** RIVER *** [5s Ts Qd Jc] [7c]
dulek_jason: bets 1554
jessecesar: folds 
Uncalled bet (1554) returned to dulek_jason
dulek_jason collected 2100 from pot
dulek_jason: doesn't show hand 
*** SUMMARY ***
Total pot 2100 | Rake 0 
Board [5s Ts Qd Jc 7c]
Seat 1: dulek_jason (small blind) collected (2100)
Seat 2: jessecesar (big blind) folded on the River
Seat 3: Gsmith13 folded before Flop (didn't bet)
Seat 4: Go4ElvIS folded before Flop (didn't bet)
Seat 5: mennck folded before Flop (didn't bet)
Seat 6: $aymon9 (button) folded before Flop (didn't bet)

PokerStars Hand #251209611919: Tournament #3769361908, $52.38+$2.62 USD Hold'em No Limit - Level XII (300/600) - 2024/06/26 22:36:21 UTC [2024/06/26 18:36:21 ET]
Table '3769361908 14' 6-max Seat #1 is the button
Seat 1: dulek_jason (18646 in chips) 
Seat 2: jessecesar (12960 in chips) 
Seat 3: Gsmith13 (9600 in chips) 
Seat 4: Go4ElvIS (5811 in chips) 
Seat 5: mennck (10093 in chips) 
Seat 6: $aymon9 (7066 in chips) 
dulek_jason: posts the ante 150
jessecesar: posts the ante 150
Gsmith13: posts the ante 150
Go4ElvIS: posts the ante 150
mennck: posts the ante 150
$aymon9: posts the ante 150
jessecesar: posts small blind 300
Gsmith13: posts big blind 600
*** HOLE CARDS ***
Go4ElvIS: raises 660 to 1260
mennck: folds 
$aymon9: folds 
dulek_jason: folds 
jessecesar: folds 
Gsmith13: folds 
Uncalled bet (660) returned to Go4ElvIS
Go4ElvIS collected 2400 from pot
Go4ElvIS: doesn't show hand 
*** SUMMARY ***
Total pot 2400 | Rake 0 
Seat 1: dulek_jason (button) folded before Flop (didn't bet)
Seat 2: jessecesar (small blind) folded before Flop
Seat 3: Gsmith13 (big blind) folded before Flop
Seat 4: Go4ElvIS collected (2400)
Seat 5: mennck folded before Flop (didn't bet)
Seat 6: $aymon9 folded before Flop (didn't bet)

PokerStars Hand #251209616977: Tournament #3769361908, $52.38+$2.62 USD Hold'em No Limit - Level XII (300/600) - 2024/06/26 22:36:40 UTC [2024/06/26 18:36:40 ET]
Table '3769361908 14' 6-max Seat #2 is the button
Seat 1: dulek_jason (18496 in chips) 
Seat 2: jessecesar (12510 in chips) 
Seat 3: Gsmith13 (8850 in chips) 
Seat 4: Go4ElvIS (7461 in chips) 
Seat 5: mennck (9943 in chips) 
Seat 6: $aymon9 (6916 in chips) 
dulek_jason: posts the ante 150
jessecesar: posts the ante 150
Gsmith13: posts the ante 150
Go4ElvIS: posts the ante 150
mennck: posts the ante 150
$aymon9: posts the ante 150
Gsmith13: posts small blind 300
Go4ElvIS: posts big blind 600
*** HOLE CARDS ***
mennck: folds 
$aymon9: folds 
dulek_jason: raises 17746 to 18346 and is all-in
jessecesar: folds 
Gsmith13: folds 
Go4ElvIS: folds 
Uncalled bet (17746) returned to dulek_jason
dulek_jason collected 2400 from pot
dulek_jason: doesn't show hand 
*** SUMMARY ***
Total pot 2400 | Rake 0 
Seat 1: dulek_jason collected (2400)
Seat 2: jessecesar (button) folded before Flop (didn't bet)
Seat 3: Gsmith13 (small blind) folded before Flop
Seat 4: Go4ElvIS (big blind) folded before Flop
Seat 5: mennck folded before Flop (didn't bet)
Seat 6: $aymon9 folded before Flop (didn't bet)

PokerStars Hand #251209623262: Tournament #3769361908, $52.38+$2.62 USD Hold'em No Limit - Level XII (300/600) - 2024/06/26 22:37:04 UTC [2024/06/26 18:37:04 ET]
Table '3769361908 14' 6-max Seat #3 is the button
Seat 1: dulek_jason (20146 in chips) 
Seat 2: jessecesar (12360 in chips) 
Seat 3: Gsmith13 (8400 in chips) 
Seat 4: Go4ElvIS (6711 in chips) 
Seat 5: mennck (9793 in chips) 
Seat 6: $aymon9 (6766 in chips) 
dulek_jason: posts the ante 150
jessecesar: posts the ante 150
Gsmith13: posts the ante 150
Go4ElvIS: posts the ante 150
mennck: posts the ante 150
$aymon9: posts the ante 150
Go4ElvIS: posts small blind 300
mennck: posts big blind 600
*** HOLE CARDS ***
$aymon9: raises 600 to 1200
dulek_jason: folds 
jessecesar: raises 11010 to 12210 and is all-in
Gsmith13: folds 
Go4ElvIS: calls 6261 and is all-in
mennck: folds 
$aymon9: folds 
Uncalled bet (5649) returned to jessecesar
*** FLOP *** [6h Qh 8c]
*** TURN *** [6h Qh 8c] [9h]
*** RIVER *** [6h Qh 8c 9h] [As]
*** SHOW DOWN ***
Go4ElvIS: shows [9s 9d] (three of a kind, Nines)
jessecesar: shows [Kd Td] (high card Ace)
Go4ElvIS collected 15822 from pot
*** SUMMARY ***
Total pot 15822 | Rake 0 
Board [6h Qh 8c 9h As]
Seat 1: dulek_jason folded before Flop (didn't bet)
Seat 2: jessecesar showed [Kd Td] and lost with high card Ace
Seat 3: Gsmith13 (button) folded before Flop (didn't bet)
Seat 4: Go4ElvIS (small blind) showed [9s 9d] and won (15822) with three of a kind, Nines
Seat 5: mennck (big blind) folded before Flop
Seat 6: $aymon9 folded before Flop

PokerStars Hand #251209632578: Tournament #3769361908, $52.38+$2.62 USD Hold'em No Limit - Level XII (300/600) - 2024/06/26 22:37:39 UTC [2024/06/26 18:37:39 ET]
Table '3769361908 14' 6-max Seat #4 is the button
Seat 1: dulek_jason (19996 in chips) 
Seat 2: jessecesar (5649 in chips) 
Seat 3: Gsmith13 (8250 in chips) 
Seat 4: Go4ElvIS (15822 in chips) 
Seat 5: mennck (9043 in chips) 
Seat 6: $aymon9 (5416 in chips) 
dulek_jason: posts the ante 150
jessecesar: posts the ante 150
Gsmith13: posts the ante 150
Go4ElvIS: posts the ante 150
mennck: posts the ante 150
$aymon9: posts the ante 150
mennck: posts small blind 300
$aymon9: posts big blind 600
*** HOLE CARDS ***
dulek_jason: folds 
jessecesar: raises 4899 to 5499 and is all-in
Gsmith13: folds 
Go4ElvIS: raises 10173 to 15672 and is all-in
mennck: folds 
$aymon9: folds 
Uncalled bet (10173) returned to Go4ElvIS
*** FLOP *** [8c 8h 4h]
*** TURN *** [8c 8h 4h] [3c]
*** RIVER *** [8c 8h 4h 3c] [Kd]
*** SHOW DOWN ***
jessecesar: shows [Ah 3d] (two pair, Eights and Threes)
Go4ElvIS: shows [5c Ad] (a pair of Eights)
jessecesar collected 12798 from pot
*** SUMMARY ***
Total pot 12798 | Rake 0 
Board [8c 8h 4h 3c Kd]
Seat 1: dulek_jason folded before Flop (didn't bet)
Seat 2: jessecesar showed [Ah 3d] and won (12798) with two pair, Eights and Threes
Seat 3: Gsmith13 folded before Flop (didn't bet)
Seat 4: Go4ElvIS (button) showed [5c Ad] and lost with a pair of Eights
Seat 5: mennck (small blind) folded before Flop
Seat 6: $aymon9 (big blind) folded before Flop

PokerStars Hand #251209645086: Tournament #3769361908, $52.38+$2.62 USD Hold'em No Limit - Level XIII (400/800) - 2024/06/26 22:38:26 UTC [2024/06/26 18:38:26 ET]
Table '3769361908 14' 6-max Seat #5 is the button
Seat 1: dulek_jason (19846 in chips) 
Seat 2: jessecesar (12798 in chips) 
Seat 3: Gsmith13 (8100 in chips) 
Seat 4: Go4ElvIS (10173 in chips) 
Seat 5: mennck (8593 in chips) 
Seat 6: $aymon9 (4666 in chips) 
dulek_jason: posts the ante 200
jessecesar: posts the ante 200
Gsmith13: posts the ante 200
Go4ElvIS: posts the ante 200
mennck: posts the ante 200
$aymon9: posts the ante 200
$aymon9: posts small blind 400
dulek_jason: posts big blind 800
*** HOLE CARDS ***
jessecesar: folds 
Gsmith13: folds 
Go4ElvIS: folds 
mennck: folds 
$aymon9: raises 3666 to 4466 and is all-in
dulek_jason: calls 3666
*** FLOP *** [6h Js 7s]
*** TURN *** [6h Js 7s] [6s]
*** RIVER *** [6h Js 7s 6s] [7c]
*** SHOW DOWN ***
$aymon9: shows [Qh 2d] (two pair, Sevens and Sixes)
dulek_jason: shows [5c Qc] (two pair, Sevens and Sixes)
$aymon9 collected 5066 from pot
dulek_jason collected 5066 from pot
*** SUMMARY ***
Total pot 10132 | Rake 0 
Board [6h Js 7s 6s 7c]
Seat 1: dulek_jason (big blind) showed [5c Qc] and won (5066) with two pair, Sevens and Sixes
Seat 2: jessecesar folded before Flop (didn't bet)
Seat 3: Gsmith13 folded before Flop (didn't bet)
Seat 4: Go4ElvIS folded before Flop (didn't bet)
Seat 5: mennck (button) folded before Flop (didn't bet)
Seat 6: $aymon9 (small blind) showed [Qh 2d] and won (5066) with two pair, Sevens and Sixes

PokerStars Hand #251209652822: Tournament #3769361908, $52.38+$2.62 USD Hold'em No Limit - Level XIII (400/800) - 2024/06/26 22:38:54 UTC [2024/06/26 18:38:54 ET]
Table '3769361908 14' 6-max Seat #6 is the button
Seat 1: dulek_jason (20246 in chips) 
Seat 2: jessecesar (12598 in chips) 
Seat 3: Gsmith13 (7900 in chips) 
Seat 4: Go4ElvIS (9973 in chips) 
Seat 5: mennck (8393 in chips) 
Seat 6: $aymon9 (5066 in chips) 
dulek_jason: posts the ante 200
jessecesar: posts the ante 200
Gsmith13: posts the ante 200
Go4ElvIS: posts the ante 200
mennck: posts the ante 200
$aymon9: posts the ante 200
dulek_jason: posts small blind 400
jessecesar: posts big blind 800
*** HOLE CARDS ***
Gsmith13: folds 
Go4ElvIS: raises 8973 to 9773 and is all-in
mennck: folds 
$aymon9: folds 
dulek_jason: folds 
jessecesar: calls 8973
*** FLOP *** [Kh Th 2h]
*** TURN *** [Kh Th 2h] [6h]
*** RIVER *** [Kh Th 2h 6h] [Qh]
*** SHOW DOWN ***
jessecesar: shows [9s Ad] (a flush, King high)
Go4ElvIS: shows [As 6d] (a flush, King high)
jessecesar collected 10573 from pot
Go4ElvIS collected 10573 from pot
*** SUMMARY ***
Total pot 21146 | Rake 0 
Board [Kh Th 2h 6h Qh]
Seat 1: dulek_jason (small blind) folded before Flop
Seat 2: jessecesar (big blind) showed [9s Ad] and won (10573) with a flush, King high
Seat 3: Gsmith13 folded before Flop (didn't bet)
Seat 4: Go4ElvIS showed [As 6d] and won (10573) with a flush, King high
Seat 5: mennck folded before Flop (didn't bet)
Seat 6: $aymon9 (button) folded before Flop (didn't bet)

PokerStars Hand #251209661865: Tournament #3769361908, $52.38+$2.62 USD Hold'em No Limit - Level XIII (400/800) - 2024/06/26 22:39:28 UTC [2024/06/26 18:39:28 ET]
Table '3769361908 14' 6-max Seat #1 is the button
Seat 1: dulek_jason (19646 in chips) 
Seat 2: jessecesar (13198 in chips) 
Seat 3: Gsmith13 (7700 in chips) 
Seat 4: Go4ElvIS (10573 in chips) 
Seat 5: mennck (8193 in chips) 
Seat 6: $aymon9 (4866 in chips) 
dulek_jason: posts the ante 200
jessecesar: posts the ante 200
Gsmith13: posts the ante 200
Go4ElvIS: posts the ante 200
mennck: posts the ante 200
$aymon9: posts the ante 200
jessecesar: posts small blind 400
Gsmith13: posts big blind 800
*** HOLE CARDS ***
Go4ElvIS: raises 9573 to 10373 and is all-in
mennck: folds 
$aymon9: folds 
dulek_jason: folds 
jessecesar: folds 
Gsmith13: folds 
Uncalled bet (9573) returned to Go4ElvIS
Go4ElvIS collected 3200 from pot
Go4ElvIS: doesn't show hand 
*** SUMMARY ***
Total pot 3200 | Rake 0 
Seat 1: dulek_jason (button) folded before Flop (didn't bet)
Seat 2: jessecesar (small blind) folded before Flop
Seat 3: Gsmith13 (big blind) folded before Flop
Seat 4: Go4ElvIS collected (3200)
Seat 5: mennck folded before Flop (didn't bet)
Seat 6: $aymon9 folded before Flop (didn't bet)

PokerStars Hand #251209668351: Tournament #3769361908, $52.38+$2.62 USD Hold'em No Limit - Level XIII (400/800) - 2024/06/26 22:39:53 UTC [2024/06/26 18:39:53 ET]
Table '3769361908 14' 6-max Seat #2 is the button
Seat 1: dulek_jason (19446 in chips) 
Seat 2: jessecesar (12598 in chips) 
Seat 3: Gsmith13 (6700 in chips) 
Seat 4: Go4ElvIS (12773 in chips) 
Seat 5: mennck (7993 in chips) 
Seat 6: $aymon9 (4666 in chips) 
dulek_jason: posts the ante 200
jessecesar: posts the ante 200
Gsmith13: posts the ante 200
Go4ElvIS: posts the ante 200
mennck: posts the ante 200
$aymon9: posts the ante 200
Gsmith13: posts small blind 400
Go4ElvIS: posts big blind 800
*** HOLE CARDS ***
mennck: folds 
$aymon9: raises 3666 to 4466 and is all-in
dulek_jason: folds 
jessecesar: folds 
Gsmith13: folds 
Go4ElvIS: calls 3666
*** FLOP *** [Qc 7h Qd]
*** TURN *** [Qc 7h Qd] [9c]
*** RIVER *** [Qc 7h Qd 9c] [3d]
*** SHOW DOWN ***
Go4ElvIS: shows [As Jc] (a pair of Queens)
$aymon9: shows [Ks Qs] (three of a kind, Queens)
$aymon9 collected 10532 from pot
*** SUMMARY ***
Total pot 10532 | Rake 0 
Board [Qc 7h Qd 9c 3d]
Seat 1: dulek_jason folded before Flop (didn't bet)
Seat 2: jessecesar (button) folded before Flop (didn't bet)
Seat 3: Gsmith13 (small blind) folded before Flop
Seat 4: Go4ElvIS (big blind) showed [As Jc] and lost with a pair of Queens
Seat 5: mennck folded before Flop (didn't bet)
Seat 6: $aymon9 showed [Ks Qs] and won (10532) with three of a kind, Queens

PokerStars Hand #251209674359: Tournament #3769361908, $52.38+$2.62 USD Hold'em No Limit - Level XIII (400/800) - 2024/06/26 22:40:16 UTC [2024/06/26 18:40:16 ET]
Table '3769361908 14' 6-max Seat #3 is the button
Seat 1: dulek_jason (19246 in chips) 
Seat 2: jessecesar (12398 in chips) 
Seat 3: Gsmith13 (6100 in chips) 
Seat 4: Go4ElvIS (8107 in chips) 
Seat 5: mennck (7793 in chips) 
Seat 6: $aymon9 (10532 in chips) 
dulek_jason: posts the ante 200
jessecesar: posts the ante 200
Gsmith13: posts the ante 200
Go4ElvIS: posts the ante 200
mennck: posts the ante 200
$aymon9: posts the ante 200
Go4ElvIS: posts small blind 400
mennck: posts big blind 800
*** HOLE CARDS ***
$aymon9: folds 
dulek_jason: folds 
jessecesar: folds 
Gsmith13: folds 
Go4ElvIS: raises 7107 to 7907 and is all-in
mennck: folds 
Uncalled bet (7107) returned to Go4ElvIS
Go4ElvIS collected 2800 from pot
Go4ElvIS: doesn't show hand 
*** SUMMARY ***
Total pot 2800 | Rake 0 
Seat 1: dulek_jason folded before Flop (didn't bet)
Seat 2: jessecesar folded before Flop (didn't bet)
Seat 3: Gsmith13 (button) folded before Flop (didn't bet)
Seat 4: Go4ElvIS (small blind) collected (2800)
Seat 5: mennck (big blind) folded before Flop
Seat 6: $aymon9 folded before Flop (didn't bet)

PokerStars Hand #251209680632: Tournament #3769361908, $52.38+$2.62 USD Hold'em No Limit - Level XIII (400/800) - 2024/06/26 22:40:39 UTC [2024/06/26 18:40:39 ET]
Table '3769361908 14' 6-max Seat #4 is the button
Seat 1: dulek_jason (19046 in chips) 
Seat 2: jessecesar (12198 in chips) 
Seat 3: Gsmith13 (5900 in chips) 
Seat 4: Go4ElvIS (9907 in chips) 
Seat 5: mennck (6793 in chips) 
Seat 6: $aymon9 (10332 in chips) 
dulek_jason: posts the ante 200
jessecesar: posts the ante 200
Gsmith13: posts the ante 200
Go4ElvIS: posts the ante 200
mennck: posts the ante 200
$aymon9: posts the ante 200
mennck: posts small blind 400
$aymon9: posts big blind 800
*** HOLE CARDS ***
dulek_jason: folds 
jessecesar: folds 
Gsmith13: raises 4900 to 5700 and is all-in
Go4ElvIS: folds 
mennck: folds 
$aymon9: folds 
Uncalled bet (4900) returned to Gsmith13
Gsmith13 collected 3200 from pot
Gsmith13: doesn't show hand 
*** SUMMARY ***
Total pot 3200 | Rake 0 
Seat 1: dulek_jason folded before Flop (didn't bet)
Seat 2: jessecesar folded before Flop (didn't bet)
Seat 3: Gsmith13 collected (3200)
Seat 4: Go4ElvIS (button) folded before Flop (didn't bet)
Seat 5: mennck (small blind) folded before Flop
Seat 6: $aymon9 (big blind) folded before Flop

PokerStars Hand #251209687465: Tournament #3769361908, $52.38+$2.62 USD Hold'em No Limit - Level XIII (400/800) - 2024/06/26 22:41:06 UTC [2024/06/26 18:41:06 ET]
Table '3769361908 14' 6-max Seat #5 is the button
Seat 1: dulek_jason (18846 in chips) 
Seat 2: jessecesar (11998 in chips) 
Seat 3: Gsmith13 (8100 in chips) 
Seat 4: Go4ElvIS (9707 in chips) 
Seat 5: mennck (6193 in chips) 
Seat 6: $aymon9 (9332 in chips) 
dulek_jason: posts the ante 200
jessecesar: posts the ante 200
Gsmith13: posts the ante 200
Go4ElvIS: posts the ante 200
mennck: posts the ante 200
$aymon9: posts the ante 200
$aymon9: posts small blind 400
dulek_jason: posts big blind 800
*** HOLE CARDS ***
jessecesar: raises 800 to 1600
Gsmith13: folds 
Go4ElvIS: folds 
mennck: folds 
$aymon9: folds 
dulek_jason: folds 
Uncalled bet (800) returned to jessecesar
jessecesar collected 3200 from pot
jessecesar: doesn't show hand 
*** SUMMARY ***
Total pot 3200 | Rake 0 
Seat 1: dulek_jason (big blind) folded before Flop
Seat 2: jessecesar collected (3200)
Seat 3: Gsmith13 folded before Flop (didn't bet)
Seat 4: Go4ElvIS folded before Flop (didn't bet)
Seat 5: mennck (button) folded before Flop (didn't bet)
Seat 6: $aymon9 (small blind) folded before Flop

PokerStars Hand #251209695603: Tournament #3769361908, $52.38+$2.62 USD Hold'em No Limit - Level XIV (500/1000) - 2024/06/26 22:41:37 UTC [2024/06/26 18:41:37 ET]
Table '3769361908 14' 6-max Seat #6 is the button
Seat 1: dulek_jason (17846 in chips) 
Seat 2: jessecesar (14198 in chips) 
Seat 3: Gsmith13 (7900 in chips) 
Seat 4: Go4ElvIS (9507 in chips) 
Seat 5: mennck (5993 in chips) 
Seat 6: $aymon9 (8732 in chips) 
dulek_jason: posts the ante 250
jessecesar: posts the ante 250
Gsmith13: posts the ante 250
Go4ElvIS: posts the ante 250
mennck: posts the ante 250
$aymon9: posts the ante 250
dulek_jason: posts small blind 500
jessecesar: posts big blind 1000
*** HOLE CARDS ***
Gsmith13: folds 
Go4ElvIS: raises 8257 to 9257 and is all-in
mennck: folds 
$aymon9: folds 
dulek_jason: folds 
jessecesar: calls 8257
*** FLOP *** [Qh Th Js]
*** TURN *** [Qh Th Js] [As]
*** RIVER *** [Qh Th Js As] [Td]
*** SHOW DOWN ***
jessecesar: shows [Qd Ah] (two pair, Aces and Queens)
Go4ElvIS: shows [Ad Jc] (two pair, Aces and Jacks)
jessecesar collected 20514 from pot
Go4ElvIS finished the tournament
*** SUMMARY ***
Total pot 20514 | Rake 0 
Board [Qh Th Js As Td]
Seat 1: dulek_jason (small blind) folded before Flop
Seat 2: jessecesar (big blind) showed [Qd Ah] and won (20514) with two pair, Aces and Queens
Seat 3: Gsmith13 folded before Flop (didn't bet)
Seat 4: Go4ElvIS showed [Ad Jc] and lost with two pair, Aces and Jacks
Seat 5: mennck folded before Flop (didn't bet)
Seat 6: $aymon9 (button) folded before Flop (didn't bet)


PokerStars Hand #251209384555: Tournament #3769361908, $52.38+$2.62 USD Hold'em No Limit - Level VII (100/200) - 2024/06/26 22:22:34 UTC [2024/06/26 18:22:34 ET]
Table '3769361908 13' 6-max Seat #1 is the button
Seat 1: sanatamaria (11150 in chips) 
Seat 3: giftmyra (5838 in chips) 
Seat 4: fernandoefv (10310 in chips) 
Seat 5: laapin (11010 in chips) 
Seat 6: ratitoBR (11965 in chips) 
sanatamaria: posts the ante 50
giftmyra: posts the ante 50
fernandoefv: posts the ante 50
laapin: posts the ante 50
ratitoBR: posts the ante 50
giftmyra: posts small blind 100
fernandoefv: posts big blind 200
*** HOLE CARDS ***
laapin: raises 300 to 500
ratitoBR: folds 
sanatamaria: folds 
giftmyra: folds 
fernandoefv: calls 300
*** FLOP *** [4c Jd Kh]
fernandoefv: checks 
laapin: bets 959
fernandoefv: calls 959
*** TURN *** [4c Jd Kh] [4d]
fernandoefv: checks 
laapin: checks 
*** RIVER *** [4c Jd Kh 4d] [9s]
handsfull69 is disconnected 
fernandoefv: checks 
laapin: checks 
*** SHOW DOWN ***
fernandoefv: shows [Td Qs] (a straight, Nine to King)
laapin: mucks hand 
fernandoefv collected 3268 from pot
*** SUMMARY ***
Total pot 3268 | Rake 0 
Board [4c Jd Kh 4d 9s]
Seat 1: sanatamaria (button) folded before Flop (didn't bet)
Seat 3: giftmyra (small blind) folded before Flop
Seat 4: fernandoefv (big blind) showed [Td Qs] and won (3268) with a straight, Nine to King
Seat 5: laapin mucked
Seat 6: ratitoBR folded before Flop (didn't bet)

PokerStars Hand #251209404882: Tournament #3769361908, $52.38+$2.62 USD Hold'em No Limit - Level VIII (125/250) - 2024/06/26 22:23:48 UTC [2024/06/26 18:23:48 ET]
Table '3769361908 13' 6-max Seat #3 is the button
Seat 1: sanatamaria (11100 in chips) 
Seat 2: handsfull69 (10000 in chips) 
Seat 3: giftmyra (5688 in chips) 
Seat 4: fernandoefv (12069 in chips) 
Seat 5: laapin (9501 in chips) 
Seat 6: ratitoBR (11915 in chips) 
sanatamaria: posts the ante 60
handsfull69: posts the ante 60
giftmyra: posts the ante 60
fernandoefv: posts the ante 60
laapin: posts the ante 60
ratitoBR: posts the ante 60
fernandoefv: posts small blind 125
laapin: posts big blind 250
*** HOLE CARDS ***
ratitoBR: raises 250 to 500
sanatamaria: calls 500
handsfull69: folds 
giftmyra: folds 
fernandoefv: folds 
laapin: folds 
*** FLOP *** [2d Kd 4h]
ratitoBR: checks 
sanatamaria: checks 
*** TURN *** [2d Kd 4h] [3h]
ratitoBR: checks 
sanatamaria: checks 
*** RIVER *** [2d Kd 4h 3h] [Ad]
ratitoBR: bets 500
sanatamaria: calls 500
*** SHOW DOWN ***
ratitoBR: shows [Jc Qd] (high card Ace)
sanatamaria: shows [9h As] (a pair of Aces)
sanatamaria collected 2735 from pot
*** SUMMARY ***
Total pot 2735 | Rake 0 
Board [2d Kd 4h 3h Ad]
Seat 1: sanatamaria showed [9h As] and won (2735) with a pair of Aces
Seat 2: handsfull69 folded before Flop (didn't bet)
Seat 3: giftmyra (button) folded before Flop (didn't bet)
Seat 4: fernandoefv (small blind) folded before Flop
Seat 5: laapin (big blind) folded before Flop
Seat 6: ratitoBR showed [Jc Qd] and lost with high card Ace

PokerStars Hand #251209416027: Tournament #3769361908, $52.38+$2.62 USD Hold'em No Limit - Level VIII (125/250) - 2024/06/26 22:24:28 UTC [2024/06/26 18:24:28 ET]
Table '3769361908 13' 6-max Seat #4 is the button
Seat 1: sanatamaria (12775 in chips) 
Seat 2: handsfull69 (9940 in chips) 
Seat 3: giftmyra (5628 in chips) 
Seat 4: fernandoefv (11884 in chips) 
Seat 5: laapin (9191 in chips) 
Seat 6: ratitoBR (10855 in chips) 
sanatamaria: posts the ante 60
handsfull69: posts the ante 60
giftmyra: posts the ante 60
fernandoefv: posts the ante 60
laapin: posts the ante 60
ratitoBR: posts the ante 60
laapin: posts small blind 125
ratitoBR: posts big blind 250
*** HOLE CARDS ***
sanatamaria: calls 250
handsfull69: folds 
giftmyra: raises 275 to 525
fernandoefv: folds 
laapin: raises 8606 to 9131 and is all-in
ratitoBR: folds 
sanatamaria: folds 
giftmyra: calls 5043 and is all-in
Uncalled bet (3563) returned to laapin
*** FLOP *** [6h 9c Ts]
*** TURN *** [6h 9c Ts] [Kc]
*** RIVER *** [6h 9c Ts Kc] [3c]
*** SHOW DOWN ***
laapin: shows [Ah Jd] (high card Ace)
giftmyra: shows [As Td] (a pair of Tens)
giftmyra collected 11996 from pot
*** SUMMARY ***
Total pot 11996 | Rake 0 
Board [6h 9c Ts Kc 3c]
Seat 1: sanatamaria folded before Flop
Seat 2: handsfull69 folded before Flop (didn't bet)
Seat 3: giftmyra showed [As Td] and won (11996) with a pair of Tens
Seat 4: fernandoefv (button) folded before Flop (didn't bet)
Seat 5: laapin (small blind) showed [Ah Jd] and lost with high card Ace
Seat 6: ratitoBR (big blind) folded before Flop

PokerStars Hand #251209433415: Tournament #3769361908, $52.38+$2.62 USD Hold'em No Limit - Level VIII (125/250) - 2024/06/26 22:25:31 UTC [2024/06/26 18:25:31 ET]
Table '3769361908 13' 6-max Seat #5 is the button
Seat 1: sanatamaria (12465 in chips) 
Seat 2: handsfull69 (9880 in chips) 
Seat 3: giftmyra (11996 in chips) 
Seat 4: fernandoefv (11824 in chips) 
Seat 5: laapin (3563 in chips) 
Seat 6: ratitoBR (10545 in chips) 
sanatamaria: posts the ante 60
handsfull69: posts the ante 60
giftmyra: posts the ante 60
fernandoefv: posts the ante 60
laapin: posts the ante 60
ratitoBR: posts the ante 60
ratitoBR: posts small blind 125
sanatamaria: posts big blind 250
*** HOLE CARDS ***
handsfull69: folds 
giftmyra: folds 
fernandoefv: folds 
laapin: raises 3253 to 3503 and is all-in
ratitoBR: raises 6982 to 10485 and is all-in
sanatamaria: calls 10235
*** FLOP *** [Ts 7d 2d]
*** TURN *** [Ts 7d 2d] [Ah]
*** RIVER *** [Ts 7d 2d Ah] [9c]
*** SHOW DOWN ***
ratitoBR: shows [4d 4h] (a pair of Fours)
sanatamaria: shows [Qc Kh] (high card Ace)
ratitoBR collected 13964 from side pot
laapin: shows [5h 7s] (a pair of Sevens)
laapin collected 10869 from main pot
*** SUMMARY ***
Total pot 24833 Main pot 10869. Side pot 13964. | Rake 0 
Board [Ts 7d 2d Ah 9c]
Seat 1: sanatamaria (big blind) showed [Qc Kh] and lost with high card Ace
Seat 2: handsfull69 folded before Flop (didn't bet)
Seat 3: giftmyra folded before Flop (didn't bet)
Seat 4: fernandoefv folded before Flop (didn't bet)
Seat 5: laapin (button) showed [5h 7s] and won (10869) with a pair of Sevens
Seat 6: ratitoBR (small blind) showed [4d 4h] and won (13964) with a pair of Fours

PokerStars Hand #251209440873: Tournament #3769361908, $52.38+$2.62 USD Hold'em No Limit - Level VIII (125/250) - 2024/06/26 22:25:58 UTC [2024/06/26 18:25:58 ET]
Table '3769361908 13' 6-max Seat #6 is the button
Seat 1: sanatamaria (1920 in chips) 
Seat 2: handsfull69 (9820 in chips) 
Seat 3: giftmyra (11936 in chips) 
Seat 4: fernandoefv (11764 in chips) 
Seat 5: laapin (10869 in chips) 
Seat 6: ratitoBR (13964 in chips) 
sanatamaria: posts the ante 60
handsfull69: posts the ante 60
giftmyra: posts the ante 60
fernandoefv: posts the ante 60
laapin: posts the ante 60
ratitoBR: posts the ante 60
sanatamaria: posts small blind 125
handsfull69: posts big blind 250
*** HOLE CARDS ***
giftmyra: folds 
fernandoefv: folds 
laapin: folds 
ratitoBR: folds 
sanatamaria: raises 1610 to 1860 and is all-in
handsfull69: calls 1610
*** FLOP *** [Qd 3s 5d]
*** TURN *** [Qd 3s 5d] [9h]
*** RIVER *** [Qd 3s 5d 9h] [4h]
*** SHOW DOWN ***
sanatamaria: shows [Js Tc] (high card Queen)
handsfull69: shows [Jh 7h] (high card Queen - lower kicker)
sanatamaria collected 4080 from pot
*** SUMMARY ***
Total pot 4080 | Rake 0 
Board [Qd 3s 5d 9h 4h]
Seat 1: sanatamaria (small blind) showed [Js Tc] and won (4080) with high card Queen
Seat 2: handsfull69 (big blind) showed [Jh 7h] and lost with high card Queen
Seat 3: giftmyra folded before Flop (didn't bet)
Seat 4: fernandoefv folded before Flop (didn't bet)
Seat 5: laapin folded before Flop (didn't bet)
Seat 6: ratitoBR (button) folded before Flop (didn't bet)

PokerStars Hand #251209452520: Tournament #3769361908, $52.38+$2.62 USD Hold'em No Limit - Level IX (150/300) - 2024/06/26 22:26:40 UTC [2024/06/26 18:26:40 ET]
Table '3769361908 13' 6-max Seat #1 is the button
Seat 1: sanatamaria (4080 in chips) 
Seat 2: handsfull69 (7900 in chips) 
Seat 3: giftmyra (11876 in chips) 
Seat 4: fernandoefv (11704 in chips) 
Seat 5: laapin (10809 in chips) 
Seat 6: ratitoBR (13904 in chips) 
sanatamaria: posts the ante 75
handsfull69: posts the ante 75
giftmyra: posts the ante 75
fernandoefv: posts the ante 75
laapin: posts the ante 75
ratitoBR: posts the ante 75
handsfull69: posts small blind 150
giftmyra: posts big blind 300
*** HOLE CARDS ***
fernandoefv: raises 300 to 600
laapin: folds 
ratitoBR: folds 
sanatamaria: folds 
handsfull69: calls 450
giftmyra: folds 
*** FLOP *** [Jd 8d Jc]
handsfull69: bets 975
fernandoefv: folds 
Uncalled bet (975) returned to handsfull69
handsfull69 collected 1950 from pot
*** SUMMARY ***
Total pot 1950 | Rake 0 
Board [Jd 8d Jc]
Seat 1: sanatamaria (button) folded before Flop (didn't bet)
Seat 2: handsfull69 (small blind) collected (1950)
Seat 3: giftmyra (big blind) folded before Flop
Seat 4: fernandoefv folded on the Flop
Seat 5: laapin folded before Flop (didn't bet)
Seat 6: ratitoBR folded before Flop (didn't bet)

PokerStars Hand #251209467806: Tournament #3769361908, $52.38+$2.62 USD Hold'em No Limit - Level IX (150/300) - 2024/06/26 22:27:35 UTC [2024/06/26 18:27:35 ET]
Table '3769361908 13' 6-max Seat #2 is the button
Seat 1: sanatamaria (4005 in chips) 
Seat 2: handsfull69 (9175 in chips) 
Seat 3: giftmyra (11501 in chips) 
Seat 5: laapin (10734 in chips) 
Seat 6: ratitoBR (13829 in chips) 
sanatamaria: posts the ante 75
handsfull69: posts the ante 75
giftmyra: posts the ante 75
laapin: posts the ante 75
ratitoBR: posts the ante 75
giftmyra: posts small blind 150
laapin: posts big blind 300
*** HOLE CARDS ***
ratitoBR: folds 
sanatamaria: folds 
handsfull69: raises 300 to 600
giftmyra: folds 
laapin: folds 
Uncalled bet (300) returned to handsfull69
handsfull69 collected 1125 from pot
*** SUMMARY ***
Total pot 1125 | Rake 0 
Seat 1: sanatamaria folded before Flop (didn't bet)
Seat 2: handsfull69 (button) collected (1125)
Seat 3: giftmyra (small blind) folded before Flop
Seat 5: laapin (big blind) folded before Flop
Seat 6: ratitoBR folded before Flop (didn't bet)

PokerStars Hand #251209472811: Tournament #3769361908, $52.38+$2.62 USD Hold'em No Limit - Level IX (150/300) - 2024/06/26 22:27:52 UTC [2024/06/26 18:27:52 ET]
Table '3769361908 13' 6-max Seat #3 is the button
Seat 1: sanatamaria (3930 in chips) 
Seat 2: handsfull69 (9925 in chips) 
Seat 3: giftmyra (11276 in chips) 
Seat 5: laapin (10359 in chips) 
Seat 6: ratitoBR (13754 in chips) 
sanatamaria: posts the ante 75
handsfull69: posts the ante 75
giftmyra: posts the ante 75
laapin: posts the ante 75
ratitoBR: posts the ante 75
laapin: posts small blind 150
ratitoBR: posts big blind 300
*** HOLE CARDS ***
sanatamaria: folds 
handsfull69: raises 300 to 600
giftmyra: folds 
laapin: folds 
ratitoBR: calls 300
*** FLOP *** [Jh 8c 7c]
ratitoBR: checks 
vip_1985Z is disconnected 
handsfull69: checks 
*** TURN *** [Jh 8c 7c] [2h]
ratitoBR: checks 
handsfull69: checks 
*** RIVER *** [Jh 8c 7c 2h] [9d]
ratitoBR: checks 
handsfull69: checks 
*** SHOW DOWN ***
ratitoBR: shows [2s Ah] (a pair of Deuces)
handsfull69: shows [4d 4s] (a pair of Fours)
handsfull69 collected 1725 from pot
*** SUMMARY ***
Total pot 1725 | Rake 0 
Board [Jh 8c 7c 2h 9d]
Seat 1: sanatamaria folded before Flop (didn't bet)
Seat 2: handsfull69 showed [4d 4s] and won (1725) with a pair of Fours
Seat 3: giftmyra (button) folded before Flop (didn't bet)
Seat 5: laapin (small blind) folded before Flop
Seat 6: ratitoBR (big blind) showed [2s Ah] and lost with a pair of Deuces

PokerStars Hand #251209485972: Tournament #3769361908, $52.38+$2.62 USD Hold'em No Limit - Level IX (150/300) - 2024/06/26 22:28:40 UTC [2024/06/26 18:28:40 ET]
Table '3769361908 13' 6-max Seat #5 is the button
Seat 1: sanatamaria (3855 in chips) 
Seat 2: handsfull69 (10975 in chips) 
Seat 3: giftmyra (11201 in chips) 
Seat 4: vip_1985Z (10000 in chips) 
Seat 5: laapin (10134 in chips) 
Seat 6: ratitoBR (13079 in chips) 
sanatamaria: posts the ante 75
handsfull69: posts the ante 75
giftmyra: posts the ante 75
vip_1985Z: posts the ante 75
laapin: posts the ante 75
ratitoBR: posts the ante 75
ratitoBR: posts small blind 150
sanatamaria: posts big blind 300
*** HOLE CARDS ***
handsfull69: raises 300 to 600
giftmyra: folds 
vip_1985Z: folds 
laapin: folds 
ratitoBR: folds 
sanatamaria: calls 300
*** FLOP *** [Ks Qs 2h]
sanatamaria: checks 
handsfull69: checks 
*** TURN *** [Ks Qs 2h] [7s]
sanatamaria: checks 
handsfull69: checks 
*** RIVER *** [Ks Qs 2h 7s] [4h]
sanatamaria: bets 3180 and is all-in
handsfull69: calls 3180
*** SHOW DOWN ***
sanatamaria: shows [9d Kh] (a pair of Kings)
handsfull69: shows [6h 6s] (a pair of Sixes)
sanatamaria collected 8160 from pot
*** SUMMARY ***
Total pot 8160 | Rake 0 
Board [Ks Qs 2h 7s 4h]
Seat 1: sanatamaria (big blind) showed [9d Kh] and won (8160) with a pair of Kings
Seat 2: handsfull69 showed [6h 6s] and lost with a pair of Sixes
Seat 3: giftmyra folded before Flop (didn't bet)
Seat 4: vip_1985Z folded before Flop (didn't bet)
Seat 5: laapin (button) folded before Flop (didn't bet)
Seat 6: ratitoBR (small blind) folded before Flop

PokerStars Hand #251209496462: Tournament #3769361908, $52.38+$2.62 USD Hold'em No Limit - Level X (200/400) - 2024/06/26 22:29:17 UTC [2024/06/26 18:29:17 ET]
Table '3769361908 13' 6-max Seat #6 is the button
Seat 1: sanatamaria (8160 in chips) 
Seat 2: handsfull69 (7120 in chips) 
Seat 3: giftmyra (11126 in chips) 
Seat 4: vip_1985Z (9925 in chips) 
Seat 5: laapin (10059 in chips) 
Seat 6: ratitoBR (12854 in chips) 
sanatamaria: posts the ante 100
handsfull69: posts the ante 100
giftmyra: posts the ante 100
vip_1985Z: posts the ante 100
laapin: posts the ante 100
ratitoBR: posts the ante 100
sanatamaria: posts small blind 200
handsfull69: posts big blind 400
*** HOLE CARDS ***
giftmyra: folds 
vip_1985Z: folds 
laapin: folds 
ratitoBR: folds 
sanatamaria: folds 
Uncalled bet (200) returned to handsfull69
handsfull69 collected 1000 from pot
*** SUMMARY ***
Total pot 1000 | Rake 0 
Seat 1: sanatamaria (small blind) folded before Flop
Seat 2: handsfull69 (big blind) collected (1000)
Seat 3: giftmyra folded before Flop (didn't bet)
Seat 4: vip_1985Z folded before Flop (didn't bet)
Seat 5: laapin folded before Flop (didn't bet)
Seat 6: ratitoBR (button) folded before Flop (didn't bet)

PokerStars Hand #251209505300: Tournament #3769361908, $52.38+$2.62 USD Hold'em No Limit - Level X (200/400) - 2024/06/26 22:29:49 UTC [2024/06/26 18:29:49 ET]
Table '3769361908 13' 6-max Seat #1 is the button
Seat 1: sanatamaria (7860 in chips) 
Seat 2: handsfull69 (7820 in chips) 
Seat 3: giftmyra (11026 in chips) 
Seat 4: vip_1985Z (9825 in chips) 
Seat 5: laapin (9959 in chips) 
Seat 6: ratitoBR (12754 in chips) 
sanatamaria: posts the ante 100
handsfull69: posts the ante 100
giftmyra: posts the ante 100
vip_1985Z: posts the ante 100
laapin: posts the ante 100
ratitoBR: posts the ante 100
handsfull69: posts small blind 200
giftmyra: posts big blind 400
*** HOLE CARDS ***
vip_1985Z: folds 
laapin: folds 
ratitoBR: folds 
sanatamaria: folds 
handsfull69: raises 7320 to 7720 and is all-in
giftmyra: folds 
Uncalled bet (7320) returned to handsfull69
handsfull69 collected 1400 from pot
*** SUMMARY ***
Total pot 1400 | Rake 0 
Seat 1: sanatamaria (button) folded before Flop (didn't bet)
Seat 2: handsfull69 (small blind) collected (1400)
Seat 3: giftmyra (big blind) folded before Flop
Seat 4: vip_1985Z folded before Flop (didn't bet)
Seat 5: laapin folded before Flop (didn't bet)
Seat 6: ratitoBR folded before Flop (didn't bet)

PokerStars Hand #251209514978: Tournament #3769361908, $52.38+$2.62 USD Hold'em No Limit - Level X (200/400) - 2024/06/26 22:30:23 UTC [2024/06/26 18:30:23 ET]
Table '3769361908 13' 6-max Seat #2 is the button
Seat 1: sanatamaria (7760 in chips) 
Seat 2: handsfull69 (8720 in chips) 
Seat 3: giftmyra (10526 in chips) 
Seat 4: vip_1985Z (9725 in chips) 
Seat 5: laapin (9859 in chips) 
Seat 6: ratitoBR (12654 in chips) 
sanatamaria: posts the ante 100
handsfull69: posts the ante 100
giftmyra: posts the ante 100
vip_1985Z: posts the ante 100
laapin: posts the ante 100
ratitoBR: posts the ante 100
giftmyra: posts small blind 200
vip_1985Z: posts big blind 400
*** HOLE CARDS ***
laapin: folds 
ratitoBR: folds 
sanatamaria: folds 
handsfull69: folds 
giftmyra: folds 
Uncalled bet (200) returned to vip_1985Z
vip_1985Z collected 1000 from pot
vip_1985Z: doesn't show hand 
*** SUMMARY ***
Total pot 1000 | Rake 0 
Seat 1: sanatamaria folded before Flop (didn't bet)
Seat 2: handsfull69 (button) folded before Flop (didn't bet)
Seat 3: giftmyra (small blind) folded before Flop
Seat 4: vip_1985Z (big blind) collected (1000)
Seat 5: laapin folded before Flop (didn't bet)
Seat 6: ratitoBR folded before Flop (didn't bet)

PokerStars Hand #251209525409: Tournament #3769361908, $52.38+$2.62 USD Hold'em No Limit - Level X (200/400) - 2024/06/26 22:31:01 UTC [2024/06/26 18:31:01 ET]
Table '3769361908 13' 6-max Seat #3 is the button
Seat 1: sanatamaria (7660 in chips) 
Seat 2: handsfull69 (8620 in chips) 
Seat 3: giftmyra (10226 in chips) 
Seat 4: vip_1985Z (10425 in chips) 
Seat 5: laapin (9759 in chips) 
Seat 6: ratitoBR (12554 in chips) 
sanatamaria: posts the ante 100
handsfull69: posts the ante 100
giftmyra: posts the ante 100
vip_1985Z: posts the ante 100
laapin: posts the ante 100
ratitoBR: posts the ante 100
vip_1985Z: posts small blind 200
laapin: posts big blind 400
*** HOLE CARDS ***
ratitoBR: folds 
sanatamaria: raises 7160 to 7560 and is all-in
handsfull69: raises 960 to 8520 and is all-in
giftmyra: folds 
vip_1985Z: folds 
laapin: calls 8120
*** FLOP *** [Jd Ks 3s]
*** TURN *** [Jd Ks 3s] [6h]
*** RIVER *** [Jd Ks 3s 6h] [2c]
*** SHOW DOWN ***
laapin: shows [5c 5s] (a pair of Fives)
handsfull69: shows [9d 9s] (a pair of Nines)
handsfull69 collected 1920 from side pot
sanatamaria: shows [Th Kh] (a pair of Kings)
sanatamaria collected 23480 from main pot
*** SUMMARY ***
Total pot 25400 Main pot 23480. Side pot 1920. | Rake 0 
Board [Jd Ks 3s 6h 2c]
Seat 1: sanatamaria showed [Th Kh] and won (23480) with a pair of Kings
Seat 2: handsfull69 showed [9d 9s] and won (1920) with a pair of Nines
Seat 3: giftmyra (button) folded before Flop (didn't bet)
Seat 4: vip_1985Z (small blind) folded before Flop
Seat 5: laapin (big blind) showed [5c 5s] and lost with a pair of Fives
Seat 6: ratitoBR folded before Flop (didn't bet)

PokerStars Hand #251209534378: Tournament #3769361908, $52.38+$2.62 USD Hold'em No Limit - Level X (200/400) - 2024/06/26 22:31:34 UTC [2024/06/26 18:31:34 ET]
Table '3769361908 13' 6-max Seat #4 is the button
Seat 1: sanatamaria (23480 in chips) 
Seat 2: handsfull69 (1920 in chips) 
Seat 3: giftmyra (10126 in chips) 
Seat 4: vip_1985Z (10125 in chips) 
Seat 5: laapin (1139 in chips) 
Seat 6: ratitoBR (12454 in chips) 
sanatamaria: posts the ante 100
handsfull69: posts the ante 100
giftmyra: posts the ante 100
vip_1985Z: posts the ante 100
laapin: posts the ante 100
ratitoBR: posts the ante 100
laapin: posts small blind 200
ratitoBR: posts big blind 400
*** HOLE CARDS ***
sanatamaria: folds 
handsfull69: raises 1420 to 1820 and is all-in
giftmyra: folds 
vip_1985Z: calls 1820
laapin: calls 839 and is all-in
ratitoBR: folds 
*** FLOP *** [Tc 5c 3d]
*** TURN *** [Tc 5c 3d] [3c]
*** RIVER *** [Tc 5c 3d 3c] [6s]
*** SHOW DOWN ***
handsfull69: shows [Jd 4h] (a pair of Threes)
vip_1985Z: shows [Ah As] (two pair, Aces and Threes)
vip_1985Z collected 1562 from side pot
laapin: shows [3h 2h] (three of a kind, Threes)
laapin collected 4117 from main pot
handsfull69 finished the tournament
*** SUMMARY ***
Total pot 5679 Main pot 4117. Side pot 1562. | Rake 0 
Board [Tc 5c 3d 3c 6s]
Seat 1: sanatamaria folded before Flop (didn't bet)
Seat 2: handsfull69 showed [Jd 4h] and lost with a pair of Threes
Seat 3: giftmyra folded before Flop (didn't bet)
Seat 4: vip_1985Z (button) showed [Ah As] and won (1562) with two pair, Aces and Threes
Seat 5: laapin (small blind) showed [3h 2h] and won (4117) with three of a kind, Threes
Seat 6: ratitoBR (big blind) folded before Flop

PokerStars Hand #251209540693: Tournament #3769361908, $52.38+$2.62 USD Hold'em No Limit - Level X (200/400) - 2024/06/26 22:31:57 UTC [2024/06/26 18:31:57 ET]
Table '3769361908 13' 6-max Seat #5 is the button
Seat 1: sanatamaria (23380 in chips) 
Seat 3: giftmyra (10026 in chips) 
Seat 4: vip_1985Z (9767 in chips) 
Seat 5: laapin (4117 in chips) 
Seat 6: ratitoBR (11954 in chips) 
sanatamaria: posts the ante 100
giftmyra: posts the ante 100
vip_1985Z: posts the ante 100
laapin: posts the ante 100
ratitoBR: posts the ante 100
ratitoBR: posts small blind 200
sanatamaria: posts big blind 400
*** HOLE CARDS ***
giftmyra: folds 
vip_1985Z: folds 
PIUlimeira is disconnected 
laapin: raises 3617 to 4017 and is all-in
ratitoBR: calls 3817
sanatamaria: folds 
*** FLOP *** [Kd 8d Kc]
*** TURN *** [Kd 8d Kc] [Ah]
*** RIVER *** [Kd 8d Kc Ah] [Qh]
*** SHOW DOWN ***
ratitoBR: shows [2s As] (two pair, Aces and Kings)
laapin: shows [5d 6h] (a pair of Kings)
ratitoBR collected 8934 from pot
laapin finished the tournament
*** SUMMARY ***
Total pot 8934 | Rake 0 
Board [Kd 8d Kc Ah Qh]
Seat 1: sanatamaria (big blind) folded before Flop
Seat 3: giftmyra folded before Flop (didn't bet)
Seat 4: vip_1985Z folded before Flop (didn't bet)
Seat 5: laapin (button) showed [5d 6h] and lost with a pair of Kings
Seat 6: ratitoBR (small blind) showed [2s As] and won (8934) with two pair, Aces and Kings

PokerStars Hand #251209550127: Tournament #3769361908, $52.38+$2.62 USD Hold'em No Limit - Level XI (250/500) - 2024/06/26 22:32:32 UTC [2024/06/26 18:32:32 ET]
Table '3769361908 13' 6-max Seat #6 is the button
Seat 1: sanatamaria (22880 in chips) 
Seat 2: PIUlimeira (10000 in chips) 
Seat 3: giftmyra (9926 in chips) 
Seat 4: vip_1985Z (9667 in chips) 
Seat 6: ratitoBR (16771 in chips) 
sanatamaria: posts the ante 125
PIUlimeira: posts the ante 125
giftmyra: posts the ante 125
vip_1985Z: posts the ante 125
ratitoBR: posts the ante 125
sanatamaria: posts small blind 250
PIUlimeira: posts big blind 500
*** HOLE CARDS ***
giftmyra: folds 
vip_1985Z: folds 
ratitoBR: folds 
sanatamaria: calls 250
PIUlimeira: checks 
*** FLOP *** [7h 4s 4h]
sanatamaria: bets 500
PIUlimeira: folds 
Uncalled bet (500) returned to sanatamaria
sanatamaria collected 1625 from pot
sanatamaria: doesn't show hand 
*** SUMMARY ***
Total pot 1625 | Rake 0 
Board [7h 4s 4h]
Seat 1: sanatamaria (small blind) collected (1625)
Seat 2: PIUlimeira (big blind) folded on the Flop
Seat 3: giftmyra folded before Flop (didn't bet)
Seat 4: vip_1985Z folded before Flop (didn't bet)
Seat 6: ratitoBR (button) folded before Flop (didn't bet)

PokerStars Hand #251209559655: Tournament #3769361908, $52.38+$2.62 USD Hold'em No Limit - Level XI (250/500) - 2024/06/26 22:33:07 UTC [2024/06/26 18:33:07 ET]
Table '3769361908 13' 6-max Seat #1 is the button
Seat 1: sanatamaria (23880 in chips) 
Seat 2: PIUlimeira (9375 in chips) 
Seat 3: giftmyra (9801 in chips) 
Seat 4: vip_1985Z (9542 in chips) 
Seat 6: ratitoBR (16646 in chips) 
sanatamaria: posts the ante 125
PIUlimeira: posts the ante 125
giftmyra: posts the ante 125
vip_1985Z: posts the ante 125
ratitoBR: posts the ante 125
PIUlimeira: posts small blind 250
giftmyra: posts big blind 500
*** HOLE CARDS ***
vip_1985Z: raises 600 to 1100
ratitoBR: folds 
sanatamaria: folds 
PIUlimeira: folds 
giftmyra: calls 600
*** FLOP *** [8h Qh 5s]
giftmyra: checks 
vip_1985Z: bets 923
giftmyra: calls 923
*** TURN *** [8h Qh 5s] [5h]
giftmyra: checks 
vip_1985Z: checks 
*** RIVER *** [8h Qh 5s 5h] [7c]
giftmyra: bets 1624
vip_1985Z: folds 
Uncalled bet (1624) returned to giftmyra
giftmyra collected 4921 from pot
giftmyra: doesn't show hand 
*** SUMMARY ***
Total pot 4921 | Rake 0 
Board [8h Qh 5s 5h 7c]
Seat 1: sanatamaria (button) folded before Flop (didn't bet)
Seat 2: PIUlimeira (small blind) folded before Flop
Seat 3: giftmyra (big blind) collected (4921)
Seat 4: vip_1985Z folded on the River
Seat 6: ratitoBR folded before Flop (didn't bet)

PokerStars Hand #251209579286: Tournament #3769361908, $52.38+$2.62 USD Hold'em No Limit - Level XI (250/500) - 2024/06/26 22:34:20 UTC [2024/06/26 18:34:20 ET]
Table '3769361908 13' 6-max Seat #2 is the button
Seat 1: sanatamaria (23755 in chips) 
Seat 2: PIUlimeira (9000 in chips) 
Seat 3: giftmyra (12574 in chips) 
Seat 4: vip_1985Z (7394 in chips) 
Seat 6: ratitoBR (16521 in chips) 
sanatamaria: posts the ante 125
PIUlimeira: posts the ante 125
giftmyra: posts the ante 125
vip_1985Z: posts the ante 125
ratitoBR: posts the ante 125
giftmyra: posts small blind 250
vip_1985Z: posts big blind 500
*** HOLE CARDS ***
ratitoBR: folds 
sanatamaria: folds 
PIUlimeira: folds 
giftmyra: calls 250
vip_1985Z: checks 
*** FLOP *** [Ac Ad 7h]
giftmyra: bets 500
vip_1985Z: folds 
Uncalled bet (500) returned to giftmyra
giftmyra collected 1625 from pot
giftmyra: doesn't show hand 
*** SUMMARY ***
Total pot 1625 | Rake 0 
Board [Ac Ad 7h]
Seat 1: sanatamaria folded before Flop (didn't bet)
Seat 2: PIUlimeira (button) folded before Flop (didn't bet)
Seat 3: giftmyra (small blind) collected (1625)
Seat 4: vip_1985Z (big blind) folded on the Flop
Seat 6: ratitoBR folded before Flop (didn't bet)

PokerStars Hand #251209587507: Tournament #3769361908, $52.38+$2.62 USD Hold'em No Limit - Level XI (250/500) - 2024/06/26 22:34:51 UTC [2024/06/26 18:34:51 ET]
Table '3769361908 13' 6-max Seat #3 is the button
Seat 1: sanatamaria (23630 in chips) 
Seat 2: PIUlimeira (8875 in chips) 
Seat 3: giftmyra (13574 in chips) 
Seat 4: vip_1985Z (6769 in chips) 
Seat 6: ratitoBR (16396 in chips) 
sanatamaria: posts the ante 125
PIUlimeira: posts the ante 125
giftmyra: posts the ante 125
vip_1985Z: posts the ante 125
ratitoBR: posts the ante 125
vip_1985Z: posts small blind 250
ratitoBR: posts big blind 500
*** HOLE CARDS ***
sanatamaria: folds 
PIUlimeira: folds 
giftmyra: folds 
vip_1985Z: folds 
Uncalled bet (250) returned to ratitoBR
ratitoBR collected 1125 from pot
ratitoBR: doesn't show hand 
*** SUMMARY ***
Total pot 1125 | Rake 0 
Seat 1: sanatamaria folded before Flop (didn't bet)
Seat 2: PIUlimeira folded before Flop (didn't bet)
Seat 3: giftmyra (button) folded before Flop (didn't bet)
Seat 4: vip_1985Z (small blind) folded before Flop
Seat 6: ratitoBR (big blind) collected (1125)

PokerStars Hand #251209597714: Tournament #3769361908, $52.38+$2.62 USD Hold'em No Limit - Level XII (300/600) - 2024/06/26 22:35:29 UTC [2024/06/26 18:35:29 ET]
Table '3769361908 13' 6-max Seat #4 is the button
Seat 1: sanatamaria (23505 in chips) 
Seat 2: PIUlimeira (8750 in chips) 
Seat 3: giftmyra (13449 in chips) 
Seat 4: vip_1985Z (6394 in chips) 
Seat 6: ratitoBR (17146 in chips) 
sanatamaria: posts the ante 150
PIUlimeira: posts the ante 150
giftmyra: posts the ante 150
vip_1985Z: posts the ante 150
ratitoBR: posts the ante 150
ratitoBR: posts small blind 300
sanatamaria: posts big blind 600
*** HOLE CARDS ***
PIUlimeira: folds 
giftmyra: folds 
vip_1985Z: folds 
ratitoBR: calls 300
sanatamaria: checks 
*** FLOP *** [7s 9h 3c]
ratitoBR: bets 600
sanatamaria: folds 
Uncalled bet (600) returned to ratitoBR
ratitoBR collected 1950 from pot
ratitoBR: doesn't show hand 
*** SUMMARY ***
Total pot 1950 | Rake 0 
Board [7s 9h 3c]
Seat 1: sanatamaria (big blind) folded on the Flop
Seat 2: PIUlimeira folded before Flop (didn't bet)
Seat 3: giftmyra folded before Flop (didn't bet)
Seat 4: vip_1985Z (button) folded before Flop (didn't bet)
Seat 6: ratitoBR (small blind) collected (1950)

PokerStars Hand #251209607619: Tournament #3769361908, $52.38+$2.62 USD Hold'em No Limit - Level XII (300/600) - 2024/06/26 22:36:05 UTC [2024/06/26 18:36:05 ET]
Table '3769361908 13' 6-max Seat #6 is the button
Seat 1: sanatamaria (22755 in chips) 
Seat 2: PIUlimeira (8600 in chips) 
Seat 3: giftmyra (13299 in chips) 
Seat 4: vip_1985Z (6244 in chips) 
Seat 6: ratitoBR (18346 in chips) 
sanatamaria: posts the ante 150
PIUlimeira: posts the ante 150
giftmyra: posts the ante 150
vip_1985Z: posts the ante 150
ratitoBR: posts the ante 150
sanatamaria: posts small blind 300
PIUlimeira: posts big blind 600
*** HOLE CARDS ***
giftmyra: folds 
vip_1985Z: folds 
ratitoBR: raises 600 to 1200
sanatamaria: folds 
PIUlimeira: folds 
Uncalled bet (600) returned to ratitoBR
ratitoBR collected 2250 from pot
ratitoBR: doesn't show hand 
*** SUMMARY ***
Total pot 2250 | Rake 0 
Seat 1: sanatamaria (small blind) folded before Flop
Seat 2: PIUlimeira (big blind) folded before Flop
Seat 3: giftmyra folded before Flop (didn't bet)
Seat 4: vip_1985Z folded before Flop (didn't bet)
Seat 6: ratitoBR (button) collected (2250)

PokerStars Hand #251209614731: Tournament #3769361908, $52.38+$2.62 USD Hold'em No Limit - Level XII (300/600) - 2024/06/26 22:36:32 UTC [2024/06/26 18:36:32 ET]
Table '3769361908 13' 6-max Seat #1 is the button
Seat 1: sanatamaria (22305 in chips) 
Seat 2: PIUlimeira (7850 in chips) 
Seat 3: giftmyra (13149 in chips) 
Seat 4: vip_1985Z (6094 in chips) 
Seat 6: ratitoBR (19846 in chips) 
sanatamaria: posts the ante 150
PIUlimeira: posts the ante 150
giftmyra: posts the ante 150
vip_1985Z: posts the ante 150
ratitoBR: posts the ante 150
PIUlimeira: posts small blind 300
giftmyra: posts big blind 600
*** HOLE CARDS ***
vip_1985Z: folds 
ratitoBR: folds 
sanatamaria: folds 
PIUlimeira: raises 7100 to 7700 and is all-in
giftmyra: folds 
Uncalled bet (7100) returned to PIUlimeira
PIUlimeira collected 1950 from pot
*** SUMMARY ***
Total pot 1950 | Rake 0 
Seat 1: sanatamaria (button) folded before Flop (didn't bet)
Seat 2: PIUlimeira (small blind) collected (1950)
Seat 3: giftmyra (big blind) folded before Flop
Seat 4: vip_1985Z folded before Flop (didn't bet)
Seat 6: ratitoBR folded before Flop (didn't bet)

PokerStars Hand #251209619887: Tournament #3769361908, $52.38+$2.62 USD Hold'em No Limit - Level XII (300/600) - 2024/06/26 22:36:52 UTC [2024/06/26 18:36:52 ET]
Table '3769361908 13' 6-max Seat #2 is the button
Seat 1: sanatamaria (22155 in chips) 
Seat 2: PIUlimeira (9050 in chips) 
Seat 3: giftmyra (12399 in chips) 
Seat 4: vip_1985Z (5944 in chips) 
Seat 6: ratitoBR (19696 in chips) 
sanatamaria: posts the ante 150
PIUlimeira: posts the ante 150
giftmyra: posts the ante 150
vip_1985Z: posts the ante 150
ratitoBR: posts the ante 150
giftmyra: posts small blind 300
vip_1985Z: posts big blind 600
*** HOLE CARDS ***
ratitoBR: raises 900 to 1500
sanatamaria: folds 
PIUlimeira: folds 
leocir25 is disconnected 
giftmyra: folds 
vip_1985Z: folds 
Uncalled bet (900) returned to ratitoBR
ratitoBR collected 2250 from pot
ratitoBR: doesn't show hand 
*** SUMMARY ***
Total pot 2250 | Rake 0 
Seat 1: sanatamaria folded before Flop (didn't bet)
Seat 2: PIUlimeira (button) folded before Flop (didn't bet)
Seat 3: giftmyra (small blind) folded before Flop
Seat 4: vip_1985Z (big blind) folded before Flop
Seat 6: ratitoBR collected (2250)

PokerStars Hand #251209626125: Tournament #3769361908, $52.38+$2.62 USD Hold'em No Limit - Level XII (300/600) - 2024/06/26 22:37:15 UTC [2024/06/26 18:37:15 ET]
Table '3769361908 13' 6-max Seat #3 is the button
Seat 1: sanatamaria (22005 in chips) 
Seat 2: PIUlimeira (8900 in chips) 
Seat 3: giftmyra (11949 in chips) 
Seat 4: vip_1985Z (5194 in chips) 
Seat 5: leocir25 (10000 in chips) 
Seat 6: ratitoBR (21196 in chips) 
sanatamaria: posts the ante 150
PIUlimeira: posts the ante 150
giftmyra: posts the ante 150
vip_1985Z: posts the ante 150
leocir25: posts the ante 150
ratitoBR: posts the ante 150
vip_1985Z: posts small blind 300
leocir25: posts big blind 600
*** HOLE CARDS ***
ratitoBR: raises 600 to 1200
sanatamaria: folds 
PIUlimeira: folds 
giftmyra: folds 
vip_1985Z: folds 
leocir25: calls 600
*** FLOP *** [Qs 4s 9s]
leocir25: checks 
ratitoBR: bets 1100
leocir25: calls 1100
*** TURN *** [Qs 4s 9s] [Jh]
leocir25: checks 
ratitoBR: bets 2800
leocir25: calls 2800
*** RIVER *** [Qs 4s 9s Jh] [7d]
leocir25: checks 
ratitoBR: checks 
*** SHOW DOWN ***
leocir25: shows [9c Qh] (two pair, Queens and Nines)
ratitoBR: mucks hand 
leocir25 collected 11400 from pot
*** SUMMARY ***
Total pot 11400 | Rake 0 
Board [Qs 4s 9s Jh 7d]
Seat 1: sanatamaria folded before Flop (didn't bet)
Seat 2: PIUlimeira folded before Flop (didn't bet)
Seat 3: giftmyra (button) folded before Flop (didn't bet)
Seat 4: vip_1985Z (small blind) folded before Flop
Seat 5: leocir25 (big blind) showed [9c Qh] and won (11400) with two pair, Queens and Nines
Seat 6: ratitoBR mucked

PokerStars Hand #251209653112: Tournament #3769361908, $52.38+$2.62 USD Hold'em No Limit - Level XIII (400/800) - 2024/06/26 22:38:55 UTC [2024/06/26 18:38:55 ET]
Table '3769361908 13' 6-max Seat #4 is the button
Seat 1: sanatamaria (21855 in chips) 
Seat 2: PIUlimeira (8750 in chips) 
Seat 3: giftmyra (11799 in chips) 
Seat 4: vip_1985Z (4744 in chips) 
Seat 5: leocir25 (16150 in chips) 
Seat 6: ratitoBR (15946 in chips) 
sanatamaria: posts the ante 200
PIUlimeira: posts the ante 200
giftmyra: posts the ante 200
vip_1985Z: posts the ante 200
leocir25: posts the ante 200
ratitoBR: posts the ante 200
leocir25: posts small blind 400
ratitoBR: posts big blind 800
*** HOLE CARDS ***
sanatamaria: folds 
PIUlimeira: folds 
giftmyra: folds 
vip_1985Z: folds 
leocir25: calls 400
ratitoBR: checks 
*** FLOP *** [5s Qc Kc]
leocir25: bets 2328
ratitoBR: calls 2328
*** TURN *** [5s Qc Kc] [Kh]
leocir25: bets 3728
ratitoBR: calls 3728
*** RIVER *** [5s Qc Kc Kh] [3h]
leocir25: bets 9094 and is all-in
ratitoBR: calls 8890 and is all-in
Uncalled bet (204) returned to leocir25
*** SHOW DOWN ***
leocir25: shows [Tc Ks] (three of a kind, Kings)
ratitoBR: shows [Jc Qs] (two pair, Kings and Queens)
leocir25 collected 32692 from pot
ratitoBR finished the tournament
*** SUMMARY ***
Total pot 32692 | Rake 0 
Board [5s Qc Kc Kh 3h]
Seat 1: sanatamaria folded before Flop (didn't bet)
Seat 2: PIUlimeira folded before Flop (didn't bet)
Seat 3: giftmyra folded before Flop (didn't bet)
Seat 4: vip_1985Z (button) folded before Flop (didn't bet)
Seat 5: leocir25 (small blind) showed [Tc Ks] and won (32692) with three of a kind, Kings
Seat 6: ratitoBR (big blind) showed [Jc Qs] and lost with two pair, Kings and Queens

PokerStars Hand #251209676767: Tournament #3769361908, $52.38+$2.62 USD Hold'em No Limit - Level XIII (400/800) - 2024/06/26 22:40:25 UTC [2024/06/26 18:40:25 ET]
Table '3769361908 13' 6-max Seat #5 is the button
Seat 1: sanatamaria (21655 in chips) 
Seat 2: PIUlimeira (8550 in chips) 
Seat 3: giftmyra (11599 in chips) 
Seat 4: vip_1985Z (4544 in chips) 
Seat 5: leocir25 (32896 in chips) 
sanatamaria: posts the ante 200
PIUlimeira: posts the ante 200
giftmyra: posts the ante 200
vip_1985Z: posts the ante 200
leocir25: posts the ante 200
sanatamaria: posts small blind 400
PIUlimeira: posts big blind 800
*** HOLE CARDS ***
vavan199212 is disconnected 
giftmyra: folds 
vip_1985Z: raises 3544 to 4344 and is all-in
leocir25: folds 
sanatamaria: raises 3544 to 7888
PIUlimeira: folds 
Uncalled bet (3544) returned to sanatamaria
*** FLOP *** [Kh Tc 2h]
*** TURN *** [Kh Tc 2h] [8c]
*** RIVER *** [Kh Tc 2h 8c] [5s]
*** SHOW DOWN ***
sanatamaria: shows [Kd Ks] (three of a kind, Kings)
vip_1985Z: shows [As Qs] (high card Ace)
sanatamaria collected 10488 from pot
vip_1985Z finished the tournament
*** SUMMARY ***
Total pot 10488 | Rake 0 
Board [Kh Tc 2h 8c 5s]
Seat 1: sanatamaria (small blind) showed [Kd Ks] and won (10488) with three of a kind, Kings
Seat 2: PIUlimeira (big blind) folded before Flop
Seat 3: giftmyra folded before Flop (didn't bet)
Seat 4: vip_1985Z showed [As Qs] and lost with high card Ace
Seat 5: leocir25 (button) folded before Flop (didn't bet)

PokerStars Hand #251209687836: Tournament #3769361908, $52.38+$2.62 USD Hold'em No Limit - Level XIII (400/800) - 2024/06/26 22:41:07 UTC [2024/06/26 18:41:07 ET]
Table '3769361908 13' 6-max Seat #1 is the button
Seat 1: sanatamaria (27599 in chips) 
Seat 2: PIUlimeira (7550 in chips) 
Seat 3: giftmyra (11399 in chips) 
Seat 5: leocir25 (32696 in chips) 
Seat 6: vavan199212 (10000 in chips) 
sanatamaria: posts the ante 200
PIUlimeira: posts the ante 200
giftmyra: posts the ante 200
leocir25: posts the ante 200
vavan199212: posts the ante 200
PIUlimeira: posts small blind 400
giftmyra: posts big blind 800
*** HOLE CARDS ***
leocir25: raises 800 to 1600
vavan199212: folds 
sanatamaria: folds 
PIUlimeira: folds 
giftmyra: calls 800
*** FLOP *** [Ad 8c Th]
giftmyra: checks 
leocir25: bets 1152
giftmyra: raises 2278 to 3430
leocir25: raises 22962 to 26392
giftmyra: calls 6169 and is all-in
Uncalled bet (16793) returned to leocir25
*** TURN *** [Ad 8c Th] [5c]
*** RIVER *** [Ad 8c Th 5c] [3s]
*** SHOW DOWN ***
giftmyra: shows [7c 9s] (high card Ace)
leocir25: shows [Qh Qc] (a pair of Queens)
leocir25 collected 23798 from pot
giftmyra finished the tournament
Gsmith13 is disconnected 
*** SUMMARY ***
Total pot 23798 | Rake 0 
Board [Ad 8c Th 5c 3s]
Seat 1: sanatamaria (button) folded before Flop (didn't bet)
Seat 2: PIUlimeira (small blind) folded before Flop
Seat 3: giftmyra (big blind) showed [7c 9s] and lost with high card Ace
Seat 5: leocir25 showed [Qh Qc] and won (23798) with a pair of Queens
Seat 6: vavan199212 folded before Flop (didn't bet)

PokerStars Hand #251209702939: Tournament #3769361908, $52.38+$2.62 USD Hold'em No Limit - Level XIV (500/1000) - 2024/06/26 22:42:06 UTC [2024/06/26 18:42:06 ET]
Table '3769361908 13' 6-max Seat #2 is the button
Seat 1: sanatamaria (27399 in chips) 
Seat 2: PIUlimeira (6950 in chips) 
Seat 3: jessecesar (25205 in chips) out of hand (moved from another table into small blind)
Seat 4: Gsmith13 (7650 in chips) out of hand (moved from another table into small blind)
Seat 5: leocir25 (45095 in chips) 
Seat 6: vavan199212 (9800 in chips) 
jessecesar will be allowed to play after the button
Gsmith13 will be allowed to play after the button
sanatamaria: posts the ante 250
PIUlimeira: posts the ante 250
leocir25: posts the ante 250
vavan199212: posts the ante 250
leocir25: posts small blind 500
vavan199212: posts big blind 1000
*** HOLE CARDS ***
sanatamaria: folds 
PIUlimeira: raises 5700 to 6700 and is all-in
leocir25: raises 5700 to 12400
vavan199212: folds 
Uncalled bet (5700) returned to leocir25
*** FLOP *** [9h Ts 3d]
*** TURN *** [9h Ts 3d] [Jh]
*** RIVER *** [9h Ts 3d Jh] [7s]
*** SHOW DOWN ***
leocir25: shows [Kc Jd] (a pair of Jacks)
PIUlimeira: shows [Kh 7d] (a pair of Sevens)
leocir25 collected 15400 from pot
PIUlimeira finished the tournament
*** SUMMARY ***
Total pot 15400 | Rake 0 
Board [9h Ts 3d Jh 7s]
Seat 1: sanatamaria folded before Flop (didn't bet)
Seat 2: PIUlimeira (button) showed [Kh 7d] and lost with a pair of Sevens
Seat 5: leocir25 (small blind) showed [Kc Jd] and won (15400) with a pair of Jacks
Seat 6: vavan199212 (big blind) folded before Flop

PokerStars Hand #251209709534: Tournament #3769361908, $52.38+$2.62 USD Hold'em No Limit - Level XIV (500/1000) - 2024/06/26 22:42:31 UTC [2024/06/26 18:42:31 ET]
Table '3769361908 13' 6-max Seat #5 is the button
Seat 1: sanatamaria (27149 in chips) 
Seat 3: jessecesar (25205 in chips) 
Seat 4: Gsmith13 (7650 in chips) 
Seat 5: leocir25 (53545 in chips) 
Seat 6: vavan199212 (8550 in chips) 
sanatamaria: posts the ante 250
jessecesar: posts the ante 250
Gsmith13: posts the ante 250
leocir25: posts the ante 250
vavan199212: posts the ante 250
vavan199212: posts small blind 500
sanatamaria: posts big blind 1000
*** HOLE CARDS ***
jessecesar: folds 
Gsmith13: raises 6400 to 7400 and is all-in
tom6969222 is disconnected 
leocir25: folds 
vavan199212: folds 
sanatamaria: calls 6400
*** FLOP *** [4s 9d Qd]
*** TURN *** [4s 9d Qd] [8c]
*** RIVER *** [4s 9d Qd 8c] [Td]
*** SHOW DOWN ***
sanatamaria: shows [Th Kd] (a pair of Tens)
Gsmith13: shows [Ks 7s] (high card King)
sanatamaria collected 16550 from pot
Gsmith13 finished the tournament
*** SUMMARY ***
Total pot 16550 | Rake 0 
Board [4s 9d Qd 8c Td]
Seat 1: sanatamaria (big blind) showed [Th Kd] and won (16550) with a pair of Tens
Seat 3: jessecesar folded before Flop (didn't bet)
Seat 4: Gsmith13 showed [Ks 7s] and lost with high card King
Seat 5: leocir25 (button) folded before Flop (didn't bet)
Seat 6: vavan199212 (small blind) folded before Flop

PokerStars Hand #251209716783: Tournament #3769361908, $52.38+$2.62 USD Hold'em No Limit - Level XIV (500/1000) - 2024/06/26 22:42:59 UTC [2024/06/26 18:42:59 ET]
Table '3769361908 13' 6-max Seat #6 is the button
Seat 1: sanatamaria (36049 in chips) 
Seat 2: tom6969222 (10000 in chips) 
Seat 3: jessecesar (24955 in chips) 
Seat 5: leocir25 (53295 in chips) 
Seat 6: vavan199212 (7800 in chips) 
sanatamaria: posts the ante 250
tom6969222: posts the ante 250
jessecesar: posts the ante 250
leocir25: posts the ante 250
vavan199212: posts the ante 250
sanatamaria: posts small blind 500
tom6969222: posts big blind 1000
*** HOLE CARDS ***
jessecesar: folds 
leocir25: folds 
vavan199212: folds 
sanatamaria: folds 
Uncalled bet (500) returned to tom6969222
tom6969222 collected 2250 from pot
tom6969222: doesn't show hand 
*** SUMMARY ***
Total pot 2250 | Rake 0 
Seat 1: sanatamaria (small blind) folded before Flop
Seat 2: tom6969222 (big blind) collected (2250)
Seat 3: jessecesar folded before Flop (didn't bet)
Seat 5: leocir25 folded before Flop (didn't bet)
Seat 6: vavan199212 (button) folded before Flop (didn't bet)

PokerStars Hand #251209719026: Tournament #3769361908, $52.38+$2.62 USD Hold'em No Limit - Level XIV (500/1000) - 2024/06/26 22:43:08 UTC [2024/06/26 18:43:08 ET]
Table '3769361908 13' 6-max Seat #1 is the button
Seat 1: sanatamaria (35299 in chips) 
Seat 2: tom6969222 (11500 in chips) 
Seat 3: jessecesar (24705 in chips) 
Seat 5: leocir25 (53045 in chips) 
Seat 6: vavan199212 (7550 in chips) 
sanatamaria: posts the ante 250
tom6969222: posts the ante 250
jessecesar: posts the ante 250
leocir25: posts the ante 250
vavan199212: posts the ante 250
tom6969222: posts small blind 500
jessecesar: posts big blind 1000
*** HOLE CARDS ***
leocir25: folds 
vavan199212: folds 
sanatamaria: folds 
tom6969222: folds 
Uncalled bet (500) returned to jessecesar
jessecesar collected 2250 from pot
jessecesar: doesn't show hand 
*** SUMMARY ***
Total pot 2250 | Rake 0 
Seat 1: sanatamaria (button) folded before Flop (didn't bet)
Seat 2: tom6969222 (small blind) folded before Flop
Seat 3: jessecesar (big blind) collected (2250)
Seat 5: leocir25 folded before Flop (didn't bet)
Seat 6: vavan199212 folded before Flop (didn't bet)

PokerStars Hand #251209721426: Tournament #3769361908, $52.38+$2.62 USD Hold'em No Limit - Level XIV (500/1000) - 2024/06/26 22:43:17 UTC [2024/06/26 18:43:17 ET]
Table '3769361908 13' 6-max Seat #2 is the button
Seat 1: sanatamaria (35049 in chips) 
Seat 2: tom6969222 (10750 in chips) 
Seat 3: jessecesar (26205 in chips) 
Seat 5: leocir25 (52795 in chips) 
Seat 6: vavan199212 (7300 in chips) 
sanatamaria: posts the ante 250
tom6969222: posts the ante 250
jessecesar: posts the ante 250
leocir25: posts the ante 250
vavan199212: posts the ante 250
jessecesar: posts small blind 500
leocir25: posts big blind 1000
*** HOLE CARDS ***
vavan199212: raises 6050 to 7050 and is all-in
sanatamaria: folds 
tom6969222: folds 
jessecesar: folds 
leocir25: folds 
Uncalled bet (6050) returned to vavan199212
vavan199212 collected 3750 from pot
vavan199212: doesn't show hand 
*** SUMMARY ***
Total pot 3750 | Rake 0 
Seat 1: sanatamaria folded before Flop (didn't bet)
Seat 2: tom6969222 (button) folded before Flop (didn't bet)
Seat 3: jessecesar (small blind) folded before Flop
Seat 5: leocir25 (big blind) folded before Flop
Seat 6: vavan199212 collected (3750)

PokerStars Hand #251209729286: Tournament #3769361908, $52.38+$2.62 USD Hold'em No Limit - Level XIV (500/1000) - 2024/06/26 22:43:48 UTC [2024/06/26 18:43:48 ET]
Table '3769361908 13' 6-max Seat #3 is the button
Seat 1: sanatamaria (34799 in chips) 
Seat 2: tom6969222 (10500 in chips) 
Seat 3: jessecesar (25455 in chips) 
Seat 5: leocir25 (51545 in chips) 
Seat 6: vavan199212 (9800 in chips) 
sanatamaria: posts the ante 250
tom6969222: posts the ante 250
jessecesar: posts the ante 250
leocir25: posts the ante 250
vavan199212: posts the ante 250
leocir25: posts small blind 500
vavan199212: posts big blind 1000
*** HOLE CARDS ***
sanatamaria: folds 
tom6969222: folds 
jessecesar: folds 
DarkSkies21 is disconnected 
leocir25: calls 500
vavan199212: checks 
*** FLOP *** [Qc Ac 7d]
leocir25: bets 2000
vavan199212: folds 
Uncalled bet (2000) returned to leocir25
leocir25 collected 3250 from pot
*** SUMMARY ***
Total pot 3250 | Rake 0 
Board [Qc Ac 7d]
Seat 1: sanatamaria folded before Flop (didn't bet)
Seat 2: tom6969222 folded before Flop (didn't bet)
Seat 3: jessecesar (button) folded before Flop (didn't bet)
Seat 5: leocir25 (small blind) collected (3250)
Seat 6: vavan199212 (big blind) folded on the Flop

PokerStars Hand #251209736012: Tournament #3769361908, $52.38+$2.62 USD Hold'em No Limit - Level XV (600/1200) - 2024/06/26 22:44:14 UTC [2024/06/26 18:44:14 ET]
Table '3769361908 13' 6-max Seat #5 is the button
Seat 1: sanatamaria (34549 in chips) 
Seat 2: tom6969222 (10250 in chips) 
Seat 3: jessecesar (25205 in chips) 
Seat 4: DarkSkies21 (26834 in chips) 
Seat 5: leocir25 (53545 in chips) 
Seat 6: vavan199212 (8550 in chips) 
sanatamaria: posts the ante 300
tom6969222: posts the ante 300
jessecesar: posts the ante 300
DarkSkies21: posts the ante 300
leocir25: posts the ante 300
vavan199212: posts the ante 300
vavan199212: posts small blind 600
sanatamaria: posts big blind 1200
*** HOLE CARDS ***
tom6969222: folds 
jessecesar: folds 
DarkSkies21: folds 
leocir25: raises 1200 to 2400
vavan199212: raises 5850 to 8250 and is all-in
sanatamaria: folds 
leocir25: calls 5850
*** FLOP *** [Jh 6d Th]
*** TURN *** [Jh 6d Th] [Ts]
*** RIVER *** [Jh 6d Th Ts] [4s]
*** SHOW DOWN ***
vavan199212: shows [9c Ah] (a pair of Tens)
leocir25: shows [Tc Js] (a full house, Tens full of Jacks)
leocir25 collected 19500 from pot
vavan199212 finished the tournament
teamcucha10 is disconnected 
*** SUMMARY ***
Total pot 19500 | Rake 0 
Board [Jh 6d Th Ts 4s]
Seat 1: sanatamaria (big blind) folded before Flop
Seat 2: tom6969222 folded before Flop (didn't bet)
Seat 3: jessecesar folded before Flop (didn't bet)
Seat 4: DarkSkies21 folded before Flop (didn't bet)
Seat 5: leocir25 (button) showed [Tc Js] and won (19500) with a full house, Tens full of Jacks
Seat 6: vavan199212 (small blind) showed [9c Ah] and lost with a pair of Tens

PokerStars Hand #251209744139: Tournament #3769361908, $52.38+$2.62 USD Hold'em No Limit - Level XV (600/1200) - 2024/06/26 22:44:46 UTC [2024/06/26 18:44:46 ET]
Table '3769361908 13' 6-max Seat #1 is the button
Seat 1: sanatamaria (33049 in chips) 
Seat 2: tom6969222 (9950 in chips) 
Seat 3: jessecesar (24905 in chips) 
Seat 4: DarkSkies21 (26534 in chips) 
Seat 5: leocir25 (64495 in chips) 
Seat 6: teamcucha10 (29564 in chips) 
sanatamaria: posts the ante 300
tom6969222: posts the ante 300
jessecesar: posts the ante 300
DarkSkies21: posts the ante 300
leocir25: posts the ante 300
teamcucha10: posts the ante 300
tom6969222: posts small blind 600
jessecesar: posts big blind 1200
*** HOLE CARDS ***
DarkSkies21: folds 
leocir25: folds 
teamcucha10: folds 
sanatamaria: folds 
tom6969222: raises 8450 to 9650 and is all-in
jessecesar: folds 
Uncalled bet (8450) returned to tom6969222
tom6969222 collected 4200 from pot
tom6969222: doesn't show hand 
*** SUMMARY ***
Total pot 4200 | Rake 0 
Seat 1: sanatamaria (button) folded before Flop (didn't bet)
Seat 2: tom6969222 (small blind) collected (4200)
Seat 3: jessecesar (big blind) folded before Flop
Seat 4: DarkSkies21 folded before Flop (didn't bet)
Seat 5: leocir25 folded before Flop (didn't bet)
Seat 6: teamcucha10 folded before Flop (didn't bet)

PokerStars Hand #251209753367: Tournament #3769361908, $52.38+$2.62 USD Hold'em No Limit - Level XV (600/1200) - 2024/06/26 22:45:22 UTC [2024/06/26 18:45:22 ET]
Table '3769361908 13' 6-max Seat #2 is the button
Seat 1: sanatamaria (32749 in chips) 
Seat 2: tom6969222 (12650 in chips) 
Seat 3: jessecesar (23405 in chips) 
Seat 4: DarkSkies21 (26234 in chips) 
Seat 5: leocir25 (64195 in chips) 
Seat 6: teamcucha10 (29264 in chips) 
sanatamaria: posts the ante 300
tom6969222: posts the ante 300
jessecesar: posts the ante 300
DarkSkies21: posts the ante 300
leocir25: posts the ante 300
teamcucha10: posts the ante 300
jessecesar: posts small blind 600
DarkSkies21: posts big blind 1200
*** HOLE CARDS ***
leocir25: folds 
teamcucha10: folds 
sanatamaria: folds 
tom6969222: raises 2400 to 3600
jessecesar: folds 
DarkSkies21: folds 
Uncalled bet (2400) returned to tom6969222
tom6969222 collected 4800 from pot
tom6969222: doesn't show hand 
*** SUMMARY ***
Total pot 4800 | Rake 0 
Seat 1: sanatamaria folded before Flop (didn't bet)
Seat 2: tom6969222 (button) collected (4800)
Seat 3: jessecesar (small blind) folded before Flop
Seat 4: DarkSkies21 (big blind) folded before Flop
Seat 5: leocir25 folded before Flop (didn't bet)
Seat 6: teamcucha10 folded before Flop (didn't bet)

PokerStars Hand #251209762270: Tournament #3769361908, $52.38+$2.62 USD Hold'em No Limit - Level XV (600/1200) - 2024/06/26 22:45:56 UTC [2024/06/26 18:45:56 ET]
Table '3769361908 13' 6-max Seat #3 is the button
Seat 1: sanatamaria (32449 in chips) 
Seat 2: tom6969222 (15950 in chips) 
Seat 3: jessecesar (22505 in chips) 
Seat 4: DarkSkies21 (24734 in chips) 
Seat 5: leocir25 (63895 in chips) 
Seat 6: teamcucha10 (28964 in chips) 
sanatamaria: posts the ante 300
tom6969222: posts the ante 300
jessecesar: posts the ante 300
DarkSkies21: posts the ante 300
leocir25: posts the ante 300
teamcucha10: posts the ante 300
DarkSkies21: posts small blind 600
leocir25: posts big blind 1200
*** HOLE CARDS ***
teamcucha10: folds 
sanatamaria: folds 
tom6969222: raises 2400 to 3600
jessecesar: folds 
DarkSkies21: folds 
leocir25: folds 
Uncalled bet (2400) returned to tom6969222
tom6969222 collected 4800 from pot
tom6969222: doesn't show hand 
*** SUMMARY ***
Total pot 4800 | Rake 0 
Seat 1: sanatamaria folded before Flop (didn't bet)
Seat 2: tom6969222 collected (4800)
Seat 3: jessecesar (button) folded before Flop (didn't bet)
Seat 4: DarkSkies21 (small blind) folded before Flop
Seat 5: leocir25 (big blind) folded before Flop
Seat 6: teamcucha10 folded before Flop (didn't bet)

PokerStars Hand #251209770409: Tournament #3769361908, $52.38+$2.62 USD Hold'em No Limit - Level XV (600/1200) - 2024/06/26 22:46:28 UTC [2024/06/26 18:46:28 ET]
Table '3769361908 13' 6-max Seat #4 is the button
Seat 1: sanatamaria (32149 in chips) 
Seat 2: tom6969222 (19250 in chips) 
Seat 3: jessecesar (22205 in chips) 
Seat 4: DarkSkies21 (23834 in chips) 
Seat 5: leocir25 (62395 in chips) 
Seat 6: teamcucha10 (28664 in chips) 
sanatamaria: posts the ante 300
tom6969222: posts the ante 300
jessecesar: posts the ante 300
DarkSkies21: posts the ante 300
leocir25: posts the ante 300
teamcucha10: posts the ante 300
leocir25: posts small blind 600
teamcucha10: posts big blind 1200
*** HOLE CARDS ***
sanatamaria: folds 
tom6969222: folds 
jessecesar: folds 
DarkSkies21: folds 
leocir25: calls 600
teamcucha10: checks 
*** FLOP *** [8s 9d 3c]
leocir25: checks 
teamcucha10: bets 1200
leocir25: calls 1200
*** TURN *** [8s 9d 3c] [5h]
leocir25: checks 
teamcucha10: bets 3600
leocir25: calls 3600
*** RIVER *** [8s 9d 3c 5h] [4h]
leocir25: checks 
teamcucha10: bets 11550
leocir25: folds 
Uncalled bet (11550) returned to teamcucha10
teamcucha10 collected 13800 from pot
teamcucha10: doesn't show hand 
*** SUMMARY ***
Total pot 13800 | Rake 0 
Board [8s 9d 3c 5h 4h]
Seat 1: sanatamaria folded before Flop (didn't bet)
Seat 2: tom6969222 folded before Flop (didn't bet)
Seat 3: jessecesar folded before Flop (didn't bet)
Seat 4: DarkSkies21 (button) folded before Flop (didn't bet)
Seat 5: leocir25 (small blind) folded on the River
Seat 6: teamcucha10 (big blind) collected (13800)

PokerStars Hand #251209801230: Tournament #3769361908, $52.38+$2.62 USD Hold'em No Limit - Level XVI (800/1600) - 2024/06/26 22:48:29 UTC [2024/06/26 18:48:29 ET]
Table '3769361908 13' 6-max Seat #5 is the button
Seat 1: sanatamaria (31849 in chips) 
Seat 2: tom6969222 (18950 in chips) 
Seat 3: jessecesar (21905 in chips) 
Seat 4: DarkSkies21 (23534 in chips) 
Seat 5: leocir25 (56095 in chips) 
Seat 6: teamcucha10 (36164 in chips) 
sanatamaria: posts the ante 400
tom6969222: posts the ante 400
jessecesar: posts the ante 400
DarkSkies21: posts the ante 400
leocir25: posts the ante 400
teamcucha10: posts the ante 400
teamcucha10: posts small blind 800
sanatamaria: posts big blind 1600
*** HOLE CARDS ***
tom6969222: folds 
jessecesar: folds 
DarkSkies21: folds 
leocir25: raises 1600 to 3200
teamcucha10: folds 
sanatamaria: folds 
Uncalled bet (1600) returned to leocir25
leocir25 collected 6400 from pot
*** SUMMARY ***
Total pot 6400 | Rake 0 
Seat 1: sanatamaria (big blind) folded before Flop
Seat 2: tom6969222 folded before Flop (didn't bet)
Seat 3: jessecesar folded before Flop (didn't bet)
Seat 4: DarkSkies21 folded before Flop (didn't bet)
Seat 5: leocir25 (button) collected (6400)
Seat 6: teamcucha10 (small blind) folded before Flop

PokerStars Hand #251209814161: Tournament #3769361908, $52.38+$2.62 USD Hold'em No Limit - Level XVI (800/1600) - 2024/06/26 22:49:21 UTC [2024/06/26 18:49:21 ET]
Table '3769361908 13' 6-max Seat #6 is the button
Seat 1: sanatamaria (29849 in chips) 
Seat 2: tom6969222 (18550 in chips) 
Seat 3: jessecesar (21505 in chips) 
Seat 4: DarkSkies21 (23134 in chips) 
Seat 5: leocir25 (60495 in chips) 
Seat 6: teamcucha10 (34964 in chips) 
sanatamaria: posts the ante 400
tom6969222: posts the ante 400
jessecesar: posts the ante 400
DarkSkies21: posts the ante 400
leocir25: posts the ante 400
teamcucha10: posts the ante 400
sanatamaria: posts small blind 800
tom6969222: posts big blind 1600
*** HOLE CARDS ***
jessecesar: folds 
DarkSkies21: folds 
leocir25: folds 
teamcucha10: raises 32964 to 34564 and is all-in
sanatamaria: folds 
tom6969222: calls 16550 and is all-in
Uncalled bet (16414) returned to teamcucha10
*** FLOP *** [3c 5s As]
*** TURN *** [3c 5s As] [7h]
*** RIVER *** [3c 5s As 7h] [6s]
*** SHOW DOWN ***
tom6969222: shows [Kc Tc] (high card Ace)
teamcucha10: shows [Qc Kd] (high card Ace - King+Queen kicker)
teamcucha10 collected 39500 from pot
tom6969222 finished the tournament in 111th place
*** SUMMARY ***
Total pot 39500 | Rake 0 
Board [3c 5s As 7h 6s]
Seat 1: sanatamaria (small blind) folded before Flop
Seat 2: tom6969222 (big blind) showed [Kc Tc] and lost with high card Ace
Seat 3: jessecesar folded before Flop (didn't bet)
Seat 4: DarkSkies21 folded before Flop (didn't bet)
Seat 5: leocir25 folded before Flop (didn't bet)
Seat 6: teamcucha10 (button) showed [Qc Kd] and won (39500) with high card Ace

PokerStars Hand #251209824371: Tournament #3769361908, $52.38+$2.62 USD Hold'em No Limit - Level XVI (800/1600) - 2024/06/26 22:50:02 UTC [2024/06/26 18:50:02 ET]
Table '3769361908 13' 6-max Seat #1 is the button
Seat 1: sanatamaria (28649 in chips) 
Seat 3: jessecesar (21105 in chips) 
Seat 4: DarkSkies21 (22734 in chips) 
Seat 5: leocir25 (60095 in chips) 
Seat 6: teamcucha10 (55914 in chips) 
sanatamaria: posts the ante 400
jessecesar: posts the ante 400
DarkSkies21: posts the ante 400
leocir25: posts the ante 400
teamcucha10: posts the ante 400
jessecesar: posts small blind 800
DarkSkies21: posts big blind 1600
*** HOLE CARDS ***
leocir25: folds 
teamcucha10: raises 1760 to 3360
sanatamaria: folds 
jessecesar: folds 
MezuuÜuuT is disconnected 
DarkSkies21: raises 18974 to 22334 and is all-in
teamcucha10: calls 18974
*** FLOP *** [8s 5c 8h]
*** TURN *** [8s 5c 8h] [Td]
*** RIVER *** [8s 5c 8h Td] [3s]
*** SHOW DOWN ***
DarkSkies21: shows [6c 6h] (two pair, Eights and Sixes)
teamcucha10: shows [Th Tc] (a full house, Tens full of Eights)
teamcucha10 collected 47468 from pot
DarkSkies21 finished the tournament in 108th place
*** SUMMARY ***
Total pot 47468 | Rake 0 
Board [8s 5c 8h Td 3s]
Seat 1: sanatamaria (button) folded before Flop (didn't bet)
Seat 3: jessecesar (small blind) folded before Flop
Seat 4: DarkSkies21 (big blind) showed [6c 6h] and lost with two pair, Eights and Sixes
Seat 5: leocir25 folded before Flop (didn't bet)
Seat 6: teamcucha10 showed [Th Tc] and won (47468) with a full house, Tens full of Eights

PokerStars Hand #251209833374: Tournament #3769361908, $52.38+$2.62 USD Hold'em No Limit - Level XVII (1000/2000) - 2024/06/26 22:50:39 UTC [2024/06/26 18:50:39 ET]
Table '3769361908 13' 6-max Seat #3 is the button
Seat 1: sanatamaria (28249 in chips) 
Seat 2: MezuuÜuuT (12800 in chips) 
Seat 3: jessecesar (19905 in chips) 
Seat 5: leocir25 (59695 in chips) 
Seat 6: teamcucha10 (80648 in chips) 
sanatamaria: posts the ante 500
MezuuÜuuT: posts the ante 500
jessecesar: posts the ante 500
leocir25: posts the ante 500
teamcucha10: posts the ante 500
leocir25: posts small blind 1000
teamcucha10: posts big blind 2000
*** HOLE CARDS ***
sanatamaria: folds 
MezuuÜuuT: raises 10300 to 12300 and is all-in
jessecesar: folds 
leocir25: folds 
teamcucha10: folds 
Uncalled bet (10300) returned to MezuuÜuuT
MezuuÜuuT collected 7500 from pot
MezuuÜuuT: doesn't show hand 
*** SUMMARY ***
Total pot 7500 | Rake 0 
Seat 1: sanatamaria folded before Flop (didn't bet)
Seat 2: MezuuÜuuT collected (7500)
Seat 3: jessecesar (button) folded before Flop (didn't bet)
Seat 5: leocir25 (small blind) folded before Flop
Seat 6: teamcucha10 (big blind) folded before Flop

PokerStars Hand #251209843086: Tournament #3769361908, $52.38+$2.62 USD Hold'em No Limit - Level XVII (1000/2000) - 2024/06/26 22:51:19 UTC [2024/06/26 18:51:19 ET]
Table '3769361908 13' 6-max Seat #5 is the button
Seat 1: sanatamaria (27749 in chips) 
Seat 2: MezuuÜuuT (17800 in chips) 
Seat 3: jessecesar (19405 in chips) 
Seat 5: leocir25 (58195 in chips) 
Seat 6: teamcucha10 (78148 in chips) 
sanatamaria: posts the ante 500
MezuuÜuuT: posts the ante 500
jessecesar: posts the ante 500
leocir25: posts the ante 500
teamcucha10: posts the ante 500
teamcucha10: posts small blind 1000
sanatamaria: posts big blind 2000
*** HOLE CARDS ***
Muringa.SP is disconnected 
MezuuÜuuT: folds 
jessecesar: raises 16905 to 18905 and is all-in
leocir25: folds 
teamcucha10: folds 
sanatamaria: folds 
Uncalled bet (16905) returned to jessecesar
jessecesar collected 7500 from pot
jessecesar: doesn't show hand 
*** SUMMARY ***
Total pot 7500 | Rake 0 
Seat 1: sanatamaria (big blind) folded before Flop
Seat 2: MezuuÜuuT folded before Flop (didn't bet)
Seat 3: jessecesar collected (7500)
Seat 5: leocir25 (button) folded before Flop (didn't bet)
Seat 6: teamcucha10 (small blind) folded before Flop

PokerStars Hand #251209850260: Tournament #3769361908, $52.38+$2.62 USD Hold'em No Limit - Level XVII (1000/2000) - 2024/06/26 22:51:48 UTC [2024/06/26 18:51:48 ET]
Table '3769361908 13' 6-max Seat #6 is the button
Seat 1: sanatamaria (25249 in chips) 
Seat 2: MezuuÜuuT (17300 in chips) 
Seat 3: jessecesar (24405 in chips) 
Seat 4: Muringa.SP (21875 in chips) 
Seat 5: leocir25 (57695 in chips) 
Seat 6: teamcucha10 (76648 in chips) 
sanatamaria: posts the ante 500
MezuuÜuuT: posts the ante 500
jessecesar: posts the ante 500
Muringa.SP: posts the ante 500
leocir25: posts the ante 500
teamcucha10: posts the ante 500
sanatamaria: posts small blind 1000
MezuuÜuuT: posts big blind 2000
*** HOLE CARDS ***
jessecesar: folds 
Muringa.SP: folds 
leocir25: raises 2000 to 4000
teamcucha10: folds 
sanatamaria: folds 
MezuuÜuuT: calls 2000
*** FLOP *** [Td 9h Th]
MezuuÜuuT: bets 12800 and is all-in
leocir25: calls 12800
*** TURN *** [Td 9h Th] [2s]
*** RIVER *** [Td 9h Th 2s] [4d]
*** SHOW DOWN ***
MezuuÜuuT: shows [7d Jh] (a pair of Tens)
leocir25: shows [6d Ad] (a pair of Tens - Ace kicker)
leocir25 collected 37600 from pot
MezuuÜuuT finished the tournament in 95th place
*** SUMMARY ***
Total pot 37600 | Rake 0 
Board [Td 9h Th 2s 4d]
Seat 1: sanatamaria (small blind) folded before Flop
Seat 2: MezuuÜuuT (big blind) showed [7d Jh] and lost with a pair of Tens
Seat 3: jessecesar folded before Flop (didn't bet)
Seat 4: Muringa.SP folded before Flop (didn't bet)
Seat 5: leocir25 showed [6d Ad] and won (37600) with a pair of Tens
Seat 6: teamcucha10 (button) folded before Flop (didn't bet)

PokerStars Hand #251209859743: Tournament #3769361908, $52.38+$2.62 USD Hold'em No Limit - Level XVII (1000/2000) - 2024/06/26 22:52:27 UTC [2024/06/26 18:52:27 ET]
Table '3769361908 13' 6-max Seat #1 is the button
Seat 1: sanatamaria (23749 in chips) 
Seat 3: jessecesar (23905 in chips) 
Seat 4: Muringa.SP (21375 in chips) 
Seat 5: leocir25 (77995 in chips) 
Seat 6: teamcucha10 (76148 in chips) 
sanatamaria: posts the ante 500
jessecesar: posts the ante 500
Muringa.SP: posts the ante 500
leocir25: posts the ante 500
teamcucha10: posts the ante 500
jessecesar: posts small blind 1000
Muringa.SP: posts big blind 2000
*** HOLE CARDS ***
leocir25: raises 2000 to 4000
teamcucha10: folds 
podiiii is disconnected 
sanatamaria: folds 
jessecesar: folds 
Muringa.SP: calls 2000
*** FLOP *** [7d 2c 4h]
Muringa.SP: checks 
leocir25: checks 
*** TURN *** [7d 2c 4h] [Ac]
Muringa.SP: checks 
leocir25: checks 
*** RIVER *** [7d 2c 4h Ac] [Jd]
Muringa.SP: checks 
leocir25: checks 
*** SHOW DOWN ***
Muringa.SP: shows [9s Qh] (high card Ace)
leocir25: shows [3s 3h] (a pair of Threes)
leocir25 collected 11500 from pot
*** SUMMARY ***
Total pot 11500 | Rake 0 
Board [7d 2c 4h Ac Jd]
Seat 1: sanatamaria (button) folded before Flop (didn't bet)
Seat 3: jessecesar (small blind) folded before Flop
Seat 4: Muringa.SP (big blind) showed [9s Qh] and lost with high card Ace
Seat 5: leocir25 showed [3s 3h] and won (11500) with a pair of Threes
Seat 6: teamcucha10 folded before Flop (didn't bet)

PokerStars Hand #251209873515: Tournament #3769361908, $52.38+$2.62 USD Hold'em No Limit - Level XVIII (1200/2400) - 2024/06/26 22:53:23 UTC [2024/06/26 18:53:23 ET]
Table '3769361908 13' 6-max Seat #3 is the button
Seat 1: sanatamaria (23249 in chips) 
Seat 2: podiiii (29236 in chips) 
Seat 3: jessecesar (22405 in chips) 
Seat 4: Muringa.SP (16875 in chips) 
Seat 5: leocir25 (84995 in chips) 
Seat 6: teamcucha10 (75648 in chips) 
sanatamaria: posts the ante 600
podiiii: posts the ante 600
jessecesar: posts the ante 600
Muringa.SP: posts the ante 600
leocir25: posts the ante 600
teamcucha10: posts the ante 600
Muringa.SP: posts small blind 1200
leocir25: posts big blind 2400
*** HOLE CARDS ***
teamcucha10: folds 
sanatamaria: folds 
podiiii: folds 
jessecesar: folds 
Muringa.SP: raises 13875 to 16275 and is all-in
leocir25: calls 13875
*** FLOP *** [8d Qs Td]
*** TURN *** [8d Qs Td] [8h]
*** RIVER *** [8d Qs Td 8h] [3d]
*** SHOW DOWN ***
Muringa.SP: shows [4s Ts] (two pair, Tens and Eights)
leocir25: shows [Qh 9s] (two pair, Queens and Eights)
leocir25 collected 36150 from pot
Muringa.SP finished the tournament in 85th place
*** SUMMARY ***
Total pot 36150 | Rake 0 
Board [8d Qs Td 8h 3d]
Seat 1: sanatamaria folded before Flop (didn't bet)
Seat 2: podiiii folded before Flop (didn't bet)
Seat 3: jessecesar (button) folded before Flop (didn't bet)
Seat 4: Muringa.SP (small blind) showed [4s Ts] and lost with two pair, Tens and Eights
Seat 5: leocir25 (big blind) showed [Qh 9s] and won (36150) with two pair, Queens and Eights
Seat 6: teamcucha10 folded before Flop (didn't bet)


PokerStars Hand #251209502112: Tournament #3769361908, $52.38+$2.62 USD Hold'em No Limit - Level X (200/400) - 2024/06/26 22:29:37 UTC [2024/06/26 18:29:37 ET]
Table '3769361908 12' 6-max Seat #4 is the button
Seat 1: Baca4b (18647 in chips) 
Seat 2: lamer0k (4470 in chips) 
Seat 3: Tom_Poker_NL (11767 in chips) 
Seat 4: jvieiradias8 (19635 in chips) 
Seat 5: MPB2502 (5372 in chips) 
Seat 6: goshaleg (9850 in chips) 
Baca4b: posts the ante 100
lamer0k: posts the ante 100
Tom_Poker_NL: posts the ante 100
jvieiradias8: posts the ante 100
MPB2502: posts the ante 100
goshaleg: posts the ante 100
MPB2502: posts small blind 200
goshaleg: posts big blind 400
*** HOLE CARDS ***
Baca4b: raises 400 to 800
lamer0k: folds 
Tom_Poker_NL: folds 
jvieiradias8: folds 
MPB2502: raises 4472 to 5272 and is all-in
goshaleg: folds 
Baca4b: folds 
Uncalled bet (4472) returned to MPB2502
MPB2502 collected 2600 from pot
MPB2502: doesn't show hand 
*** SUMMARY ***
Total pot 2600 | Rake 0 
Seat 1: Baca4b folded before Flop
Seat 2: lamer0k folded before Flop (didn't bet)
Seat 3: Tom_Poker_NL folded before Flop (didn't bet)
Seat 4: jvieiradias8 (button) folded before Flop (didn't bet)
Seat 5: MPB2502 (small blind) collected (2600)
Seat 6: goshaleg (big blind) folded before Flop

PokerStars Hand #251209512976: Tournament #3769361908, $52.38+$2.62 USD Hold'em No Limit - Level X (200/400) - 2024/06/26 22:30:16 UTC [2024/06/26 18:30:16 ET]
Table '3769361908 12' 6-max Seat #5 is the button
Seat 1: Baca4b (17747 in chips) 
Seat 2: lamer0k (4370 in chips) 
Seat 3: Tom_Poker_NL (11667 in chips) 
Seat 4: jvieiradias8 (19535 in chips) 
Seat 5: MPB2502 (7072 in chips) 
Seat 6: goshaleg (9350 in chips) 
Baca4b: posts the ante 100
lamer0k: posts the ante 100
Tom_Poker_NL: posts the ante 100
jvieiradias8: posts the ante 100
MPB2502: posts the ante 100
goshaleg: posts the ante 100
goshaleg: posts small blind 200
Baca4b: posts big blind 400
*** HOLE CARDS ***
lamer0k: folds 
Tom_Poker_NL: raises 400 to 800
jvieiradias8: folds 
MPB2502: folds 
goshaleg: folds 
Baca4b: raises 1800 to 2600
Tom_Poker_NL: calls 1800
*** FLOP *** [Kc 3h 7d]
Baca4b: bets 1000
Tom_Poker_NL: calls 1000
*** TURN *** [Kc 3h 7d] [4c]
Baca4b: bets 2400
Tom_Poker_NL: folds 
Uncalled bet (2400) returned to Baca4b
Baca4b collected 8000 from pot
Baca4b: doesn't show hand 
*** SUMMARY ***
Total pot 8000 | Rake 0 
Board [Kc 3h 7d 4c]
Seat 1: Baca4b (big blind) collected (8000)
Seat 2: lamer0k folded before Flop (didn't bet)
Seat 3: Tom_Poker_NL folded on the Turn
Seat 4: jvieiradias8 folded before Flop (didn't bet)
Seat 5: MPB2502 (button) folded before Flop (didn't bet)
Seat 6: goshaleg (small blind) folded before Flop

PokerStars Hand #251209535856: Tournament #3769361908, $52.38+$2.62 USD Hold'em No Limit - Level X (200/400) - 2024/06/26 22:31:40 UTC [2024/06/26 18:31:40 ET]
Table '3769361908 12' 6-max Seat #6 is the button
Seat 1: Baca4b (22047 in chips) 
Seat 2: lamer0k (4270 in chips) 
Seat 3: Tom_Poker_NL (7967 in chips) 
Seat 4: jvieiradias8 (19435 in chips) 
Seat 5: MPB2502 (6972 in chips) 
Seat 6: goshaleg (9050 in chips) 
Baca4b: posts the ante 100
lamer0k: posts the ante 100
Tom_Poker_NL: posts the ante 100
jvieiradias8: posts the ante 100
MPB2502: posts the ante 100
goshaleg: posts the ante 100
Baca4b: posts small blind 200
lamer0k: posts big blind 400
*** HOLE CARDS ***
Tom_Poker_NL: folds 
jvieiradias8: raises 400 to 800
MPB2502: folds 
goshaleg: folds 
Baca4b: folds 
lamer0k: calls 400
*** FLOP *** [4s Jd Qd]
lamer0k: checks 
jvieiradias8: bets 600
lamer0k: raises 2770 to 3370 and is all-in
jvieiradias8: calls 2770
*** TURN *** [4s Jd Qd] [5d]
*** RIVER *** [4s Jd Qd 5d] [6s]
*** SHOW DOWN ***
lamer0k: shows [Kd 6d] (a flush, King high)
jvieiradias8: shows [9s Js] (a pair of Jacks)
lamer0k collected 9140 from pot
*** SUMMARY ***
Total pot 9140 | Rake 0 
Board [4s Jd Qd 5d 6s]
Seat 1: Baca4b (small blind) folded before Flop
Seat 2: lamer0k (big blind) showed [Kd 6d] and won (9140) with a flush, King high
Seat 3: Tom_Poker_NL folded before Flop (didn't bet)
Seat 4: jvieiradias8 showed [9s Js] and lost with a pair of Jacks
Seat 5: MPB2502 folded before Flop (didn't bet)
Seat 6: goshaleg (button) folded before Flop (didn't bet)

PokerStars Hand #251209558219: Tournament #3769361908, $52.38+$2.62 USD Hold'em No Limit - Level XI (250/500) - 2024/06/26 22:33:02 UTC [2024/06/26 18:33:02 ET]
Table '3769361908 12' 6-max Seat #1 is the button
Seat 1: Baca4b (21747 in chips) 
Seat 2: lamer0k (9140 in chips) 
Seat 3: Tom_Poker_NL (7867 in chips) 
Seat 4: jvieiradias8 (15165 in chips) 
Seat 5: MPB2502 (6872 in chips) 
Seat 6: goshaleg (8950 in chips) 
Baca4b: posts the ante 125
lamer0k: posts the ante 125
Tom_Poker_NL: posts the ante 125
jvieiradias8: posts the ante 125
MPB2502: posts the ante 125
goshaleg: posts the ante 125
lamer0k: posts small blind 250
Tom_Poker_NL: posts big blind 500
*** HOLE CARDS ***
jvieiradias8: raises 500 to 1000
MPB2502: folds 
goshaleg: folds 
Baca4b: folds 
lamer0k: calls 750
Tom_Poker_NL: calls 500
*** FLOP *** [Jh 3d Kh]
lamer0k: checks 
Tom_Poker_NL: checks 
jvieiradias8: bets 1240
lamer0k: calls 1240
Tom_Poker_NL: folds 
*** TURN *** [Jh 3d Kh] [Qc]
lamer0k: checks 
jvieiradias8: bets 2565
lamer0k: raises 4210 to 6775 and is all-in
jvieiradias8: calls 4210
*** RIVER *** [Jh 3d Kh Qc] [6c]
*** SHOW DOWN ***
lamer0k: shows [Qd Ah] (a pair of Queens)
jvieiradias8: shows [Kc Td] (a pair of Kings)
jvieiradias8 collected 19780 from pot
lamer0k finished the tournament
*** SUMMARY ***
Total pot 19780 | Rake 0 
Board [Jh 3d Kh Qc 6c]
Seat 1: Baca4b (button) folded before Flop (didn't bet)
Seat 2: lamer0k (small blind) showed [Qd Ah] and lost with a pair of Queens
Seat 3: Tom_Poker_NL (big blind) folded on the Flop
Seat 4: jvieiradias8 showed [Kc Td] and won (19780) with a pair of Kings
Seat 5: MPB2502 folded before Flop (didn't bet)
Seat 6: goshaleg folded before Flop (didn't bet)

PokerStars Hand #251209580694: Tournament #3769361908, $52.38+$2.62 USD Hold'em No Limit - Level XI (250/500) - 2024/06/26 22:34:25 UTC [2024/06/26 18:34:25 ET]
Table '3769361908 12' 6-max Seat #3 is the button
Seat 1: Baca4b (21622 in chips) 
Seat 3: Tom_Poker_NL (6742 in chips) 
Seat 4: jvieiradias8 (25805 in chips) 
Seat 5: MPB2502 (6747 in chips) 
Seat 6: goshaleg (8825 in chips) 
Baca4b: posts the ante 125
Tom_Poker_NL: posts the ante 125
jvieiradias8: posts the ante 125
MPB2502: posts the ante 125
goshaleg: posts the ante 125
jvieiradias8: posts small blind 250
MPB2502: posts big blind 500
*** HOLE CARDS ***
goshaleg: folds 
Baca4b: folds 
Tom_Poker_NL: folds 
jvieiradias8: raises 25180 to 25680 and is all-in
MPB2502: calls 6122 and is all-in
Uncalled bet (19058) returned to jvieiradias8
*** FLOP *** [5c Th Jd]
*** TURN *** [5c Th Jd] [Kh]
*** RIVER *** [5c Th Jd Kh] [4c]
*** SHOW DOWN ***
jvieiradias8: shows [7h Kd] (a pair of Kings)
MPB2502: shows [Qs Td] (a pair of Tens)
jvieiradias8 collected 13869 from pot
MPB2502 finished the tournament
*** SUMMARY ***
Total pot 13869 | Rake 0 
Board [5c Th Jd Kh 4c]
Seat 1: Baca4b folded before Flop (didn't bet)
Seat 3: Tom_Poker_NL (button) folded before Flop (didn't bet)
Seat 4: jvieiradias8 (small blind) showed [7h Kd] and won (13869) with a pair of Kings
Seat 5: MPB2502 (big blind) showed [Qs Td] and lost with a pair of Tens
Seat 6: goshaleg folded before Flop (didn't bet)

PokerStars Hand #251209589312: Tournament #3769361908, $52.38+$2.62 USD Hold'em No Limit - Level XI (250/500) - 2024/06/26 22:34:57 UTC [2024/06/26 18:34:57 ET]
Table '3769361908 12' 6-max Seat #4 is the button
Seat 1: Baca4b (21497 in chips) 
Seat 3: Tom_Poker_NL (6617 in chips) 
Seat 4: jvieiradias8 (32927 in chips) 
Seat 6: goshaleg (8700 in chips) 
Baca4b: posts the ante 125
Tom_Poker_NL: posts the ante 125
jvieiradias8: posts the ante 125
goshaleg: posts the ante 125
goshaleg: posts small blind 250
Baca4b: posts big blind 500
*** HOLE CARDS ***
RenALLiin is disconnected 
Tom_Poker_NL: folds 
jvieiradias8: folds 
goshaleg: folds 
Uncalled bet (250) returned to Baca4b
Baca4b collected 1000 from pot
Baca4b: doesn't show hand 
*** SUMMARY ***
Total pot 1000 | Rake 0 
Seat 1: Baca4b (big blind) collected (1000)
Seat 3: Tom_Poker_NL folded before Flop (didn't bet)
Seat 4: jvieiradias8 (button) folded before Flop (didn't bet)
Seat 6: goshaleg (small blind) folded before Flop

PokerStars Hand #251209594411: Tournament #3769361908, $52.38+$2.62 USD Hold'em No Limit - Level XII (300/600) - 2024/06/26 22:35:16 UTC [2024/06/26 18:35:16 ET]
Table '3769361908 12' 6-max Seat #6 is the button
Seat 1: Baca4b (22122 in chips) 
Seat 2: RenALLiin (13125 in chips) 
Seat 3: Tom_Poker_NL (6492 in chips) 
Seat 4: jvieiradias8 (32802 in chips) 
Seat 6: goshaleg (8325 in chips) 
Baca4b: posts the ante 150
RenALLiin: posts the ante 150
Tom_Poker_NL: posts the ante 150
jvieiradias8: posts the ante 150
goshaleg: posts the ante 150
Baca4b: posts small blind 300
RenALLiin: posts big blind 600
*** HOLE CARDS ***
Tom_Poker_NL: raises 5742 to 6342 and is all-in
jvieiradias8: raises 26310 to 32652 and is all-in
goshaleg: folds 
Baca4b: folds 
RenALLiin: folds 
Uncalled bet (26310) returned to jvieiradias8
*** FLOP *** [As 8d Jd]
*** TURN *** [As 8d Jd] [6d]
*** RIVER *** [As 8d Jd 6d] [7s]
*** SHOW DOWN ***
Tom_Poker_NL: shows [Jh Qd] (a pair of Jacks)
jvieiradias8: shows [7c 7d] (three of a kind, Sevens)
jvieiradias8 collected 14334 from pot
Tom_Poker_NL finished the tournament
*** SUMMARY ***
Total pot 14334 | Rake 0 
Board [As 8d Jd 6d 7s]
Seat 1: Baca4b (small blind) folded before Flop
Seat 2: RenALLiin (big blind) folded before Flop
Seat 3: Tom_Poker_NL showed [Jh Qd] and lost with a pair of Jacks
Seat 4: jvieiradias8 showed [7c 7d] and won (14334) with three of a kind, Sevens
Seat 6: goshaleg (button) folded before Flop (didn't bet)

PokerStars Hand #251209601707: Tournament #3769361908, $52.38+$2.62 USD Hold'em No Limit - Level XII (300/600) - 2024/06/26 22:35:43 UTC [2024/06/26 18:35:43 ET]
Table '3769361908 12' 6-max Seat #1 is the button
Seat 1: Baca4b (21672 in chips) 
Seat 2: RenALLiin (12375 in chips) 
Seat 4: jvieiradias8 (40644 in chips) 
Seat 6: goshaleg (8175 in chips) 
Baca4b: posts the ante 150
RenALLiin: posts the ante 150
jvieiradias8: posts the ante 150
goshaleg: posts the ante 150
RenALLiin: posts small blind 300
jvieiradias8: posts big blind 600
*** HOLE CARDS ***
LadyLuke2010 is disconnected 
goshaleg: folds 
Baca4b: folds 
RenALLiin: raises 11625 to 12225 and is all-in
jvieiradias8: folds 
Uncalled bet (11625) returned to RenALLiin
Scorgiej is disconnected 
RenALLiin collected 1800 from pot
RenALLiin: doesn't show hand 
*** SUMMARY ***
Total pot 1800 | Rake 0 
Seat 1: Baca4b (button) folded before Flop (didn't bet)
Seat 2: RenALLiin (small blind) collected (1800)
Seat 4: jvieiradias8 (big blind) folded before Flop
Seat 6: goshaleg folded before Flop (didn't bet)

PokerStars Hand #251209608988: Tournament #3769361908, $52.38+$2.62 USD Hold'em No Limit - Level XII (300/600) - 2024/06/26 22:36:10 UTC [2024/06/26 18:36:10 ET]
Table '3769361908 12' 6-max Seat #2 is the button
Seat 1: Baca4b (21522 in chips) 
Seat 2: RenALLiin (13425 in chips) 
Seat 3: LadyLuke2010 (5350 in chips) out of hand (moved from another table into small blind)
Seat 4: jvieiradias8 (39894 in chips) 
Seat 5: Scorgiej (9975 in chips) 
Seat 6: goshaleg (8025 in chips) 
LadyLuke2010 will be allowed to play after the button
Baca4b: posts the ante 150
RenALLiin: posts the ante 150
jvieiradias8: posts the ante 150
Scorgiej: posts the ante 150
goshaleg: posts the ante 150
jvieiradias8: posts small blind 300
Scorgiej: posts big blind 600
*** HOLE CARDS ***
goshaleg: raises 7275 to 7875 and is all-in
Baca4b: folds 
RenALLiin: folds 
jvieiradias8: folds 
Scorgiej: folds 
Uncalled bet (7275) returned to goshaleg
goshaleg collected 2250 from pot
goshaleg: doesn't show hand 
*** SUMMARY ***
Total pot 2250 | Rake 0 
Seat 1: Baca4b folded before Flop (didn't bet)
Seat 2: RenALLiin (button) folded before Flop (didn't bet)
Seat 4: jvieiradias8 (small blind) folded before Flop
Seat 5: Scorgiej (big blind) folded before Flop
Seat 6: goshaleg collected (2250)

PokerStars Hand #251209613544: Tournament #3769361908, $52.38+$2.62 USD Hold'em No Limit - Level XII (300/600) - 2024/06/26 22:36:27 UTC [2024/06/26 18:36:27 ET]
Table '3769361908 12' 6-max Seat #4 is the button
Seat 1: Baca4b (21372 in chips) 
Seat 2: RenALLiin (13275 in chips) 
Seat 3: LadyLuke2010 (5350 in chips) 
Seat 4: jvieiradias8 (39444 in chips) 
Seat 5: Scorgiej (9225 in chips) 
Seat 6: goshaleg (9525 in chips) 
Baca4b: posts the ante 150
RenALLiin: posts the ante 150
LadyLuke2010: posts the ante 150
jvieiradias8: posts the ante 150
Scorgiej: posts the ante 150
goshaleg: posts the ante 150
Scorgiej: posts small blind 300
goshaleg: posts big blind 600
*** HOLE CARDS ***
Baca4b: folds 
RenALLiin: folds 
LadyLuke2010: raises 4600 to 5200 and is all-in
jvieiradias8: folds 
Scorgiej: folds 
goshaleg: calls 4600
*** FLOP *** [9c 6c Td]
*** TURN *** [9c 6c Td] [2d]
*** RIVER *** [9c 6c Td 2d] [Ts]
*** SHOW DOWN ***
goshaleg: shows [4d 4c] (two pair, Tens and Fours)
LadyLuke2010: shows [Qh Ac] (a pair of Tens)
goshaleg collected 11600 from pot
LadyLuke2010 finished the tournament
*** SUMMARY ***
Total pot 11600 | Rake 0 
Board [9c 6c Td 2d Ts]
Seat 1: Baca4b folded before Flop (didn't bet)
Seat 2: RenALLiin folded before Flop (didn't bet)
Seat 3: LadyLuke2010 showed [Qh Ac] and lost with a pair of Tens
Seat 4: jvieiradias8 (button) folded before Flop (didn't bet)
Seat 5: Scorgiej (small blind) folded before Flop
Seat 6: goshaleg (big blind) showed [4d 4c] and won (11600) with two pair, Tens and Fours

PokerStars Hand #251209619547: Tournament #3769361908, $52.38+$2.62 USD Hold'em No Limit - Level XII (300/600) - 2024/06/26 22:36:50 UTC [2024/06/26 18:36:50 ET]
Table '3769361908 12' 6-max Seat #5 is the button
Seat 1: Baca4b (21222 in chips) 
Seat 2: RenALLiin (13125 in chips) 
Seat 4: jvieiradias8 (39294 in chips) 
Seat 5: Scorgiej (8775 in chips) 
Seat 6: goshaleg (15775 in chips) 
Baca4b: posts the ante 150
RenALLiin: posts the ante 150
jvieiradias8: posts the ante 150
Scorgiej: posts the ante 150
goshaleg: posts the ante 150
goshaleg: posts small blind 300
Baca4b: posts big blind 600
*** HOLE CARDS ***
RenALLiin: folds 
LadyLuke2010 is disconnected 
jvieiradias8: folds 
Scorgiej: raises 8025 to 8625 and is all-in
goshaleg: folds 
Baca4b: folds 
Uncalled bet (8025) returned to Scorgiej
Scorgiej collected 2250 from pot
Scorgiej: doesn't show hand 
*** SUMMARY ***
Total pot 2250 | Rake 0 
Seat 1: Baca4b (big blind) folded before Flop
Seat 2: RenALLiin folded before Flop (didn't bet)
Seat 4: jvieiradias8 folded before Flop (didn't bet)
Seat 5: Scorgiej (button) collected (2250)
Seat 6: goshaleg (small blind) folded before Flop

PokerStars Hand #251209623747: Tournament #3769361908, $52.38+$2.62 USD Hold'em No Limit - Level XII (300/600) - 2024/06/26 22:37:06 UTC [2024/06/26 18:37:06 ET]
Table '3769361908 12' 6-max Seat #6 is the button
Seat 1: Baca4b (20472 in chips) 
Seat 2: RenALLiin (12975 in chips) 
Seat 3: LadyLuke2010 (10000 in chips) 
Seat 4: jvieiradias8 (39144 in chips) 
Seat 5: Scorgiej (10275 in chips) 
Seat 6: goshaleg (15325 in chips) 
Baca4b: posts the ante 150
RenALLiin: posts the ante 150
LadyLuke2010: posts the ante 150
jvieiradias8: posts the ante 150
Scorgiej: posts the ante 150
goshaleg: posts the ante 150
Baca4b: posts small blind 300
RenALLiin: posts big blind 600
*** HOLE CARDS ***
LadyLuke2010: folds 
jvieiradias8: folds 
Scorgiej: raises 600 to 1200
goshaleg: folds 
Baca4b: folds 
RenALLiin: calls 600
*** FLOP *** [7s Ts 4d]
RenALLiin: checks 
Scorgiej: checks 
*** TURN *** [7s Ts 4d] [Jd]
RenALLiin: bets 1188
Scorgiej: calls 1188
*** RIVER *** [7s Ts 4d Jd] [2d]
RenALLiin: bets 1494
Scorgiej: calls 1494
*** SHOW DOWN ***
RenALLiin: shows [Td Qs] (a pair of Tens)
Scorgiej: mucks hand 
RenALLiin collected 8964 from pot
*** SUMMARY ***
Total pot 8964 | Rake 0 
Board [7s Ts 4d Jd 2d]
Seat 1: Baca4b (small blind) folded before Flop
Seat 2: RenALLiin (big blind) showed [Td Qs] and won (8964) with a pair of Tens
Seat 3: LadyLuke2010 folded before Flop (didn't bet)
Seat 4: jvieiradias8 folded before Flop (didn't bet)
Seat 5: Scorgiej mucked
Seat 6: goshaleg (button) folded before Flop (didn't bet)

PokerStars Hand #251209637143: Tournament #3769361908, $52.38+$2.62 USD Hold'em No Limit - Level XII (300/600) - 2024/06/26 22:37:56 UTC [2024/06/26 18:37:56 ET]
Table '3769361908 12' 6-max Seat #1 is the button
Seat 1: Baca4b (20022 in chips) 
Seat 2: RenALLiin (17907 in chips) 
Seat 3: LadyLuke2010 (9850 in chips) 
Seat 4: jvieiradias8 (38994 in chips) 
Seat 5: Scorgiej (6243 in chips) 
Seat 6: goshaleg (15175 in chips) 
Baca4b: posts the ante 150
RenALLiin: posts the ante 150
LadyLuke2010: posts the ante 150
jvieiradias8: posts the ante 150
Scorgiej: posts the ante 150
goshaleg: posts the ante 150
RenALLiin: posts small blind 300
LadyLuke2010: posts big blind 600
*** HOLE CARDS ***
jvieiradias8: folds 
Scorgiej: folds 
goshaleg: raises 600 to 1200
Baca4b: folds 
RenALLiin: raises 16557 to 17757 and is all-in
LadyLuke2010: folds 
goshaleg: folds 
Uncalled bet (16557) returned to RenALLiin
RenALLiin collected 3900 from pot
RenALLiin: doesn't show hand 
*** SUMMARY ***
Total pot 3900 | Rake 0 
Seat 1: Baca4b (button) folded before Flop (didn't bet)
Seat 2: RenALLiin (small blind) collected (3900)
Seat 3: LadyLuke2010 (big blind) folded before Flop
Seat 4: jvieiradias8 folded before Flop (didn't bet)
Seat 5: Scorgiej folded before Flop (didn't bet)
Seat 6: goshaleg folded before Flop

PokerStars Hand #251209646366: Tournament #3769361908, $52.38+$2.62 USD Hold'em No Limit - Level XIII (400/800) - 2024/06/26 22:38:30 UTC [2024/06/26 18:38:30 ET]
Table '3769361908 12' 6-max Seat #2 is the button
Seat 1: Baca4b (19872 in chips) 
Seat 2: RenALLiin (20457 in chips) 
Seat 3: LadyLuke2010 (9100 in chips) 
Seat 4: jvieiradias8 (38844 in chips) 
Seat 5: Scorgiej (6093 in chips) 
Seat 6: goshaleg (13825 in chips) 
Baca4b: posts the ante 200
RenALLiin: posts the ante 200
LadyLuke2010: posts the ante 200
jvieiradias8: posts the ante 200
Scorgiej: posts the ante 200
goshaleg: posts the ante 200
LadyLuke2010: posts small blind 400
jvieiradias8: posts big blind 800
*** HOLE CARDS ***
Scorgiej: folds 
goshaleg: calls 800
Baca4b: folds 
RenALLiin: calls 800
LadyLuke2010: calls 400
jvieiradias8: raises 4000 to 4800
goshaleg: folds 
RenALLiin: folds 
LadyLuke2010: folds 
Uncalled bet (4000) returned to jvieiradias8
jvieiradias8 collected 4400 from pot
jvieiradias8: doesn't show hand 
*** SUMMARY ***
Total pot 4400 | Rake 0 
Seat 1: Baca4b folded before Flop (didn't bet)
Seat 2: RenALLiin (button) folded before Flop
Seat 3: LadyLuke2010 (small blind) folded before Flop
Seat 4: jvieiradias8 (big blind) collected (4400)
Seat 5: Scorgiej folded before Flop (didn't bet)
Seat 6: goshaleg folded before Flop

PokerStars Hand #251209661136: Tournament #3769361908, $52.38+$2.62 USD Hold'em No Limit - Level XIII (400/800) - 2024/06/26 22:39:26 UTC [2024/06/26 18:39:26 ET]
Table '3769361908 12' 6-max Seat #4 is the button
Seat 1: Baca4b (19672 in chips) 
Seat 2: RenALLiin (19457 in chips) 
Seat 4: jvieiradias8 (42244 in chips) 
Seat 5: Scorgiej (5893 in chips) 
Seat 6: goshaleg (12825 in chips) 
Baca4b: posts the ante 200
RenALLiin: posts the ante 200
jvieiradias8: posts the ante 200
Scorgiej: posts the ante 200
goshaleg: posts the ante 200
Scorgiej: posts small blind 400
goshaleg: posts big blind 800
*** HOLE CARDS ***
Baca4b: folds 
Link_fNK is disconnected 
RenALLiin: raises 800 to 1600
jvieiradias8: calls 1600
Scorgiej: folds 
goshaleg: folds 
*** FLOP *** [3h 3s 6c]
RenALLiin: checks 
jvieiradias8: checks 
*** TURN *** [3h 3s 6c] [2c]
RenALLiin: bets 3564
jvieiradias8: calls 3564
*** RIVER *** [3h 3s 6c 2c] [Ks]
RenALLiin: bets 14093 and is all-in
jvieiradias8: folds 
Uncalled bet (14093) returned to RenALLiin
RenALLiin collected 12528 from pot
RenALLiin: doesn't show hand 
*** SUMMARY ***
Total pot 12528 | Rake 0 
Board [3h 3s 6c 2c Ks]
Seat 1: Baca4b folded before Flop (didn't bet)
Seat 2: RenALLiin collected (12528)
Seat 4: jvieiradias8 (button) folded on the River
Seat 5: Scorgiej (small blind) folded before Flop
Seat 6: goshaleg (big blind) folded before Flop

PokerStars Hand #251209678484: Tournament #3769361908, $52.38+$2.62 USD Hold'em No Limit - Level XIII (400/800) - 2024/06/26 22:40:31 UTC [2024/06/26 18:40:31 ET]
Table '3769361908 12' 6-max Seat #5 is the button
Seat 1: Baca4b (19472 in chips) 
Seat 2: RenALLiin (26621 in chips) 
Seat 3: Link_fNK (16806 in chips) 
Seat 4: jvieiradias8 (36880 in chips) 
Seat 5: Scorgiej (5293 in chips) 
Seat 6: goshaleg (11825 in chips) 
Baca4b: posts the ante 200
RenALLiin: posts the ante 200
Link_fNK: posts the ante 200
jvieiradias8: posts the ante 200
Scorgiej: posts the ante 200
goshaleg: posts the ante 200
goshaleg: posts small blind 400
Baca4b: posts big blind 800
*** HOLE CARDS ***
RenALLiin: folds 
Link_fNK: folds 
jvieiradias8: folds 
Scorgiej: folds 
goshaleg: calls 400
Baca4b: checks 
*** FLOP *** [Js 2d Td]
goshaleg: checks 
Baca4b: bets 800
goshaleg: folds 
Uncalled bet (800) returned to Baca4b
Baca4b collected 2800 from pot
Baca4b: doesn't show hand 
*** SUMMARY ***
Total pot 2800 | Rake 0 
Board [Js 2d Td]
Seat 1: Baca4b (big blind) collected (2800)
Seat 2: RenALLiin folded before Flop (didn't bet)
Seat 3: Link_fNK folded before Flop (didn't bet)
Seat 4: jvieiradias8 folded before Flop (didn't bet)
Seat 5: Scorgiej (button) folded before Flop (didn't bet)
Seat 6: goshaleg (small blind) folded on the Flop

PokerStars Hand #251209687889: Tournament #3769361908, $52.38+$2.62 USD Hold'em No Limit - Level XIII (400/800) - 2024/06/26 22:41:08 UTC [2024/06/26 18:41:08 ET]
Table '3769361908 12' 6-max Seat #6 is the button
Seat 1: Baca4b (21272 in chips) 
Seat 2: RenALLiin (26421 in chips) 
Seat 3: Link_fNK (16606 in chips) 
Seat 4: jvieiradias8 (36680 in chips) 
Seat 5: Scorgiej (5093 in chips) 
Seat 6: goshaleg (10825 in chips) 
Baca4b: posts the ante 200
RenALLiin: posts the ante 200
Link_fNK: posts the ante 200
jvieiradias8: posts the ante 200
Scorgiej: posts the ante 200
goshaleg: posts the ante 200
Baca4b: posts small blind 400
RenALLiin: posts big blind 800
*** HOLE CARDS ***
Link_fNK: folds 
jvieiradias8: raises 800 to 1600
Scorgiej: folds 
goshaleg: folds 
Baca4b: folds 
RenALLiin: calls 800
*** FLOP *** [7c Jh 8c]
RenALLiin: checks 
jvieiradias8: checks 
*** TURN *** [7c Jh 8c] [6s]
RenALLiin: checks 
jvieiradias8: checks 
*** RIVER *** [7c Jh 8c 6s] [5s]
RenALLiin: bets 2400
jvieiradias8: folds 
Uncalled bet (2400) returned to RenALLiin
RenALLiin collected 4800 from pot
RenALLiin: doesn't show hand 
*** SUMMARY ***
Total pot 4800 | Rake 0 
Board [7c Jh 8c 6s 5s]
Seat 1: Baca4b (small blind) folded before Flop
Seat 2: RenALLiin (big blind) collected (4800)
Seat 3: Link_fNK folded before Flop (didn't bet)
Seat 4: jvieiradias8 folded on the River
Seat 5: Scorgiej folded before Flop (didn't bet)
Seat 6: goshaleg (button) folded before Flop (didn't bet)

PokerStars Hand #251209708806: Tournament #3769361908, $52.38+$2.62 USD Hold'em No Limit - Level XIV (500/1000) - 2024/06/26 22:42:28 UTC [2024/06/26 18:42:28 ET]
Table '3769361908 12' 6-max Seat #1 is the button
Seat 1: Baca4b (20672 in chips) 
Seat 2: RenALLiin (29421 in chips) 
Seat 3: Link_fNK (16406 in chips) 
Seat 4: jvieiradias8 (34880 in chips) 
Seat 5: Scorgiej (4893 in chips) 
Seat 6: goshaleg (10625 in chips) 
Baca4b: posts the ante 250
RenALLiin: posts the ante 250
Link_fNK: posts the ante 250
jvieiradias8: posts the ante 250
Scorgiej: posts the ante 250
goshaleg: posts the ante 250
RenALLiin: posts small blind 500
Link_fNK: posts big blind 1000
*** HOLE CARDS ***
jvieiradias8: folds 
Scorgiej: folds 
goshaleg: raises 9375 to 10375 and is all-in
Baca4b: folds 
RenALLiin: raises 9375 to 19750
Link_fNK: calls 15156 and is all-in
Uncalled bet (3594) returned to RenALLiin
*** FLOP *** [9h 5s 5c]
*** TURN *** [9h 5s 5c] [8d]
*** RIVER *** [9h 5s 5c 8d] [Jc]
*** SHOW DOWN ***
RenALLiin: shows [Ah Qd] (a pair of Fives)
Link_fNK: shows [Qh As] (a pair of Fives)
RenALLiin collected 5781 from side pot
Link_fNK collected 5781 from side pot
goshaleg: shows [Ks 8s] (two pair, Eights and Fives)
goshaleg collected 32625 from main pot
*** SUMMARY ***
Total pot 44187 Main pot 32625. Side pot 11562. | Rake 0 
Board [9h 5s 5c 8d Jc]
Seat 1: Baca4b (button) folded before Flop (didn't bet)
Seat 2: RenALLiin (small blind) showed [Ah Qd] and won (5781) with a pair of Fives
Seat 3: Link_fNK (big blind) showed [Qh As] and won (5781) with a pair of Fives
Seat 4: jvieiradias8 folded before Flop (didn't bet)
Seat 5: Scorgiej folded before Flop (didn't bet)
Seat 6: goshaleg showed [Ks 8s] and won (32625) with two pair, Eights and Fives

PokerStars Hand #251209717984: Tournament #3769361908, $52.38+$2.62 USD Hold'em No Limit - Level XIV (500/1000) - 2024/06/26 22:43:04 UTC [2024/06/26 18:43:04 ET]
Table '3769361908 12' 6-max Seat #2 is the button
Seat 1: Baca4b (20422 in chips) 
Seat 2: RenALLiin (18796 in chips) 
Seat 3: Link_fNK (5781 in chips) 
Seat 4: jvieiradias8 (34630 in chips) 
Seat 5: Scorgiej (4643 in chips) 
Seat 6: goshaleg (32625 in chips) 
Baca4b: posts the ante 250
RenALLiin: posts the ante 250
Link_fNK: posts the ante 250
jvieiradias8: posts the ante 250
Scorgiej: posts the ante 250
goshaleg: posts the ante 250
Link_fNK: posts small blind 500
jvieiradias8: posts big blind 1000
*** HOLE CARDS ***
Scorgiej: raises 3393 to 4393 and is all-in
goshaleg: folds 
Baca4b: folds 
RenALLiin: folds 
Link_fNK: folds 
jvieiradias8: folds 
Uncalled bet (3393) returned to Scorgiej
Scorgiej collected 4000 from pot
Scorgiej: doesn't show hand 
*** SUMMARY ***
Total pot 4000 | Rake 0 
Seat 1: Baca4b folded before Flop (didn't bet)
Seat 2: RenALLiin (button) folded before Flop (didn't bet)
Seat 3: Link_fNK (small blind) folded before Flop
Seat 4: jvieiradias8 (big blind) folded before Flop
Seat 5: Scorgiej collected (4000)
Seat 6: goshaleg folded before Flop (didn't bet)

PokerStars Hand #251209723964: Tournament #3769361908, $52.38+$2.62 USD Hold'em No Limit - Level XIV (500/1000) - 2024/06/26 22:43:27 UTC [2024/06/26 18:43:27 ET]
Table '3769361908 12' 6-max Seat #3 is the button
Seat 1: Baca4b (20172 in chips) 
Seat 2: RenALLiin (18546 in chips) 
Seat 3: Link_fNK (5031 in chips) 
Seat 4: jvieiradias8 (33380 in chips) 
Seat 5: Scorgiej (7393 in chips) 
Seat 6: goshaleg (32375 in chips) 
Baca4b: posts the ante 250
RenALLiin: posts the ante 250
Link_fNK: posts the ante 250
jvieiradias8: posts the ante 250
Scorgiej: posts the ante 250
goshaleg: posts the ante 250
jvieiradias8: posts small blind 500
Scorgiej: posts big blind 1000
*** HOLE CARDS ***
goshaleg: folds 
Baca4b: folds 
RenALLiin: folds 
Link_fNK: raises 3781 to 4781 and is all-in
jvieiradias8: raises 3781 to 8562
Scorgiej: calls 6143 and is all-in
Uncalled bet (1419) returned to jvieiradias8
*** FLOP *** [7c 3s 3h]
*** TURN *** [7c 3s 3h] [7h]
*** RIVER *** [7c 3s 3h 7h] [Jd]
*** SHOW DOWN ***
jvieiradias8: shows [Qc 9c] (two pair, Sevens and Threes)
Scorgiej: shows [Ah Ad] (two pair, Aces and Sevens)
Scorgiej collected 4724 from side pot
Link_fNK: shows [6d Ac] (two pair, Sevens and Threes)
Scorgiej collected 15843 from main pot
Link_fNK finished the tournament
*** SUMMARY ***
Total pot 20567 Main pot 15843. Side pot 4724. | Rake 0 
Board [7c 3s 3h 7h Jd]
Seat 1: Baca4b folded before Flop (didn't bet)
Seat 2: RenALLiin folded before Flop (didn't bet)
Seat 3: Link_fNK (button) showed [6d Ac] and lost with two pair, Sevens and Threes
Seat 4: jvieiradias8 (small blind) showed [Qc 9c] and lost with two pair, Sevens and Threes
Seat 5: Scorgiej (big blind) showed [Ah Ad] and won (20567) with two pair, Aces and Sevens
Seat 6: goshaleg folded before Flop (didn't bet)

PokerStars Hand #251209730364: Tournament #3769361908, $52.38+$2.62 USD Hold'em No Limit - Level XIV (500/1000) - 2024/06/26 22:43:52 UTC [2024/06/26 18:43:52 ET]
Table '3769361908 12' 6-max Seat #4 is the button
Seat 1: Baca4b (19922 in chips) 
Seat 2: RenALLiin (18296 in chips) 
Seat 4: jvieiradias8 (25987 in chips) 
Seat 5: Scorgiej (20567 in chips) 
Seat 6: goshaleg (32125 in chips) 
Baca4b: posts the ante 250
RenALLiin: posts the ante 250
jvieiradias8: posts the ante 250
Scorgiej: posts the ante 250
goshaleg: posts the ante 250
Scorgiej: posts small blind 500
goshaleg: posts big blind 1000
*** HOLE CARDS ***
Baca4b: folds 
RenALLiin: folds 
jvieiradias8: raises 1000 to 2000
Scorgiej: raises 18317 to 20317 and is all-in
@tetaschell is disconnected 
goshaleg: folds 
jvieiradias8: calls 18317
*** FLOP *** [5c Js 6s]
*** TURN *** [5c Js 6s] [Qd]
*** RIVER *** [5c Js 6s Qd] [As]
*** SHOW DOWN ***
Scorgiej: shows [5s Ac] (two pair, Aces and Fives)
jvieiradias8: shows [7d 7s] (a pair of Sevens)
Scorgiej collected 42884 from pot
*** SUMMARY ***
Total pot 42884 | Rake 0 
Board [5c Js 6s Qd As]
Seat 1: Baca4b folded before Flop (didn't bet)
Seat 2: RenALLiin folded before Flop (didn't bet)
Seat 4: jvieiradias8 (button) showed [7d 7s] and lost with a pair of Sevens
Seat 5: Scorgiej (small blind) showed [5s Ac] and won (42884) with two pair, Aces and Fives
Seat 6: goshaleg (big blind) folded before Flop

PokerStars Hand #251209740627: Tournament #3769361908, $52.38+$2.62 USD Hold'em No Limit - Level XV (600/1200) - 2024/06/26 22:44:32 UTC [2024/06/26 18:44:32 ET]
Table '3769361908 12' 6-max Seat #5 is the button
Seat 1: Baca4b (19672 in chips) 
Seat 2: RenALLiin (18046 in chips) 
Seat 3: @tetaschell (10000 in chips) 
Seat 4: jvieiradias8 (5420 in chips) 
Seat 5: Scorgiej (42884 in chips) 
Seat 6: goshaleg (30875 in chips) 
Baca4b: posts the ante 300
RenALLiin: posts the ante 300
@tetaschell: posts the ante 300
jvieiradias8: posts the ante 300
Scorgiej: posts the ante 300
goshaleg: posts the ante 300
goshaleg: posts small blind 600
Baca4b: posts big blind 1200
*** HOLE CARDS ***
RenALLiin: folds 
@tetaschell: raises 8500 to 9700 and is all-in
jvieiradias8: folds 
Scorgiej: raises 32884 to 42584 and is all-in
goshaleg: folds 
Baca4b: folds 
Uncalled bet (32884) returned to Scorgiej
*** FLOP *** [4d 7h 8s]
*** TURN *** [4d 7h 8s] [Th]
*** RIVER *** [4d 7h 8s Th] [Js]
*** SHOW DOWN ***
@tetaschell: shows [Qh Qd] (a pair of Queens)
Scorgiej: shows [As Kd] (high card Ace)
@tetaschell collected 23000 from pot
*** SUMMARY ***
Total pot 23000 | Rake 0 
Board [4d 7h 8s Th Js]
Seat 1: Baca4b (big blind) folded before Flop
Seat 2: RenALLiin folded before Flop (didn't bet)
Seat 3: @tetaschell showed [Qh Qd] and won (23000) with a pair of Queens
Seat 4: jvieiradias8 folded before Flop (didn't bet)
Seat 5: Scorgiej (button) showed [As Kd] and lost with high card Ace
Seat 6: goshaleg (small blind) folded before Flop

PokerStars Hand #251209752025: Tournament #3769361908, $52.38+$2.62 USD Hold'em No Limit - Level XV (600/1200) - 2024/06/26 22:45:16 UTC [2024/06/26 18:45:16 ET]
Table '3769361908 12' 6-max Seat #6 is the button
Seat 1: Baca4b (18172 in chips) 
Seat 2: RenALLiin (17746 in chips) 
Seat 3: @tetaschell (23000 in chips) 
Seat 4: jvieiradias8 (5120 in chips) 
Seat 5: Scorgiej (32884 in chips) 
Seat 6: goshaleg (29975 in chips) 
Baca4b: posts the ante 300
RenALLiin: posts the ante 300
@tetaschell: posts the ante 300
jvieiradias8: posts the ante 300
Scorgiej: posts the ante 300
goshaleg: posts the ante 300
Baca4b: posts small blind 600
RenALLiin: posts big blind 1200
*** HOLE CARDS ***
@tetaschell: folds 
jvieiradias8: raises 3620 to 4820 and is all-in
Scorgiej: raises 27764 to 32584 and is all-in
goshaleg: folds 
Baca4b: folds 
RenALLiin: folds 
Uncalled bet (27764) returned to Scorgiej
*** FLOP *** [2s 2d Qc]
*** TURN *** [2s 2d Qc] [7d]
*** RIVER *** [2s 2d Qc 7d] [Tc]
*** SHOW DOWN ***
jvieiradias8: shows [Js Kd] (a pair of Deuces)
Scorgiej: shows [8h 8d] (two pair, Eights and Deuces)
Scorgiej collected 13240 from pot
jvieiradias8 finished the tournament
*** SUMMARY ***
Total pot 13240 | Rake 0 
Board [2s 2d Qc 7d Tc]
Seat 1: Baca4b (small blind) folded before Flop
Seat 2: RenALLiin (big blind) folded before Flop
Seat 3: @tetaschell folded before Flop (didn't bet)
Seat 4: jvieiradias8 showed [Js Kd] and lost with a pair of Deuces
Seat 5: Scorgiej showed [8h 8d] and won (13240) with two pair, Eights and Deuces
Seat 6: goshaleg (button) folded before Flop (didn't bet)

PokerStars Hand #251209763900: Tournament #3769361908, $52.38+$2.62 USD Hold'em No Limit - Level XV (600/1200) - 2024/06/26 22:46:02 UTC [2024/06/26 18:46:02 ET]
Table '3769361908 12' 6-max Seat #1 is the button
Seat 1: Baca4b (17272 in chips) 
Seat 2: RenALLiin (16246 in chips) 
Seat 3: @tetaschell (22700 in chips) 
Seat 5: Scorgiej (41004 in chips) 
Seat 6: goshaleg (29675 in chips) 
Baca4b: posts the ante 300
RenALLiin: posts the ante 300
@tetaschell: posts the ante 300
Scorgiej: posts the ante 300
goshaleg: posts the ante 300
RenALLiin: posts small blind 600
@tetaschell: posts big blind 1200
*** HOLE CARDS ***
Scorgiej: raises 1200 to 2400
goshaleg: folds 
Baca4b: folds 
RenALLiin: folds 
@tetaschell: calls 1200
*** FLOP *** [9h 5c 9c]
@tetaschell: checks 
Scorgiej: checks 
*** TURN *** [9h 5c 9c] [2c]
@tetaschell: bets 2400
Scorgiej: calls 2400
*** RIVER *** [9h 5c 9c 2c] [Tc]
@tetaschell: bets 2661
Monsieur Foutre is disconnected 
Scorgiej: folds 
Uncalled bet (2661) returned to @tetaschell
@tetaschell collected 11700 from pot
@tetaschell: doesn't show hand 
*** SUMMARY ***
Total pot 11700 | Rake 0 
Board [9h 5c 9c 2c Tc]
Seat 1: Baca4b (button) folded before Flop (didn't bet)
Seat 2: RenALLiin (small blind) folded before Flop
Seat 3: @tetaschell (big blind) collected (11700)
Seat 5: Scorgiej folded on the River
Seat 6: goshaleg folded before Flop (didn't bet)

PokerStars Hand #251209780520: Tournament #3769361908, $52.38+$2.62 USD Hold'em No Limit - Level XV (600/1200) - 2024/06/26 22:47:07 UTC [2024/06/26 18:47:07 ET]
Table '3769361908 12' 6-max Seat #2 is the button
Seat 1: Baca4b (16972 in chips) 
Seat 2: RenALLiin (15346 in chips) 
Seat 3: @tetaschell (29300 in chips) 
Seat 4: Monsieur Foutre (10000 in chips) 
Seat 5: Scorgiej (35904 in chips) 
Seat 6: goshaleg (29375 in chips) 
Baca4b: posts the ante 300
RenALLiin: posts the ante 300
@tetaschell: posts the ante 300
Monsieur Foutre: posts the ante 300
Scorgiej: posts the ante 300
goshaleg: posts the ante 300
@tetaschell: posts small blind 600
Monsieur Foutre: posts big blind 1200
*** HOLE CARDS ***
Scorgiej: raises 1200 to 2400
goshaleg: folds 
Baca4b: folds 
RenALLiin: folds 
@tetaschell: folds 
Monsieur Foutre: calls 1200
*** FLOP *** [7c 7h 2c]
Monsieur Foutre: checks 
Scorgiej: bets 1200
Monsieur Foutre: raises 6100 to 7300 and is all-in
Scorgiej: calls 6100
*** TURN *** [7c 7h 2c] [8c]
*** RIVER *** [7c 7h 2c 8c] [3c]
*** SHOW DOWN ***
Monsieur Foutre: shows [As 3d] (two pair, Sevens and Threes)
Scorgiej: shows [Th Ts] (two pair, Tens and Sevens)
Scorgiej collected 21800 from pot
Monsieur Foutre finished the tournament
*** SUMMARY ***
Total pot 21800 | Rake 0 
Board [7c 7h 2c 8c 3c]
Seat 1: Baca4b folded before Flop (didn't bet)
Seat 2: RenALLiin (button) folded before Flop (didn't bet)
Seat 3: @tetaschell (small blind) folded before Flop
Seat 4: Monsieur Foutre (big blind) showed [As 3d] and lost with two pair, Sevens and Threes
Seat 5: Scorgiej showed [Th Ts] and won (21800) with two pair, Tens and Sevens
Seat 6: goshaleg folded before Flop (didn't bet)

PokerStars Hand #251209794207: Tournament #3769361908, $52.38+$2.62 USD Hold'em No Limit - Level XVI (800/1600) - 2024/06/26 22:48:01 UTC [2024/06/26 18:48:01 ET]
Table '3769361908 12' 6-max Seat #3 is the button
Seat 1: Baca4b (16672 in chips) 
Seat 2: RenALLiin (15046 in chips) 
Seat 3: @tetaschell (28400 in chips) 
Seat 5: Scorgiej (47704 in chips) 
Seat 6: goshaleg (29075 in chips) 
Baca4b: posts the ante 400
RenALLiin: posts the ante 400
@tetaschell: posts the ante 400
Scorgiej: posts the ante 400
goshaleg: posts the ante 400
Scorgiej: posts small blind 800
goshaleg: posts big blind 1600
*** HOLE CARDS ***
Baca4b: folds 
RenALLiin: raises 13046 to 14646 and is all-in
@tetaschell: folds 
Scorgiej: raises 32658 to 47304 and is all-in
goshaleg: folds 
Uncalled bet (32658) returned to Scorgiej
*** FLOP *** [3s 9s Qs]
*** TURN *** [3s 9s Qs] [Td]
*** RIVER *** [3s 9s Qs Td] [3h]
*** SHOW DOWN ***
Scorgiej: shows [As Ad] (two pair, Aces and Threes)
RenALLiin: shows [5d 5c] (two pair, Fives and Threes)
Scorgiej collected 32892 from pot
RenALLiin finished the tournament
*** SUMMARY ***
Total pot 32892 | Rake 0 
Board [3s 9s Qs Td 3h]
Seat 1: Baca4b folded before Flop (didn't bet)
Seat 2: RenALLiin showed [5d 5c] and lost with two pair, Fives and Threes
Seat 3: @tetaschell (button) folded before Flop (didn't bet)
Seat 5: Scorgiej (small blind) showed [As Ad] and won (32892) with two pair, Aces and Threes
Seat 6: goshaleg (big blind) folded before Flop

PokerStars Hand #251209801194: Tournament #3769361908, $52.38+$2.62 USD Hold'em No Limit - Level XVI (800/1600) - 2024/06/26 22:48:29 UTC [2024/06/26 18:48:29 ET]
Table '3769361908 12' 6-max Seat #5 is the button
Seat 1: Baca4b (16272 in chips) 
Seat 3: @tetaschell (28000 in chips) 
Seat 5: Scorgiej (65550 in chips) 
Seat 6: goshaleg (27075 in chips) 
Baca4b: posts the ante 400
@tetaschell: posts the ante 400
Scorgiej: posts the ante 400
goshaleg: posts the ante 400
goshaleg: posts small blind 800
Baca4b: posts big blind 1600
*** HOLE CARDS ***
@tetaschell: folds 
Scorgiej: raises 2080 to 3680
goshaleg: folds 
Baca4b: calls 2080
*** FLOP *** [4c 2c Jh]
Baca4b: checks 
Scorgiej: checks 
*** TURN *** [4c 2c Jh] [2s]
Baca4b: checks 
Scorgiej: checks 
*** RIVER *** [4c 2c Jh 2s] [6d]
Baca4b: bets 4880
Scorgiej: folds 
Uncalled bet (4880) returned to Baca4b
Baca4b collected 9760 from pot
Baca4b: doesn't show hand 
*** SUMMARY ***
Total pot 9760 | Rake 0 
Board [4c 2c Jh 2s 6d]
Seat 1: Baca4b (big blind) collected (9760)
Seat 3: @tetaschell folded before Flop (didn't bet)
Seat 5: Scorgiej (button) folded on the River
Seat 6: goshaleg (small blind) folded before Flop

PokerStars Hand #251209814087: Tournament #3769361908, $52.38+$2.62 USD Hold'em No Limit - Level XVI (800/1600) - 2024/06/26 22:49:20 UTC [2024/06/26 18:49:20 ET]
Table '3769361908 12' 6-max Seat #6 is the button
Seat 1: Baca4b (21952 in chips) 
Seat 2: jklñjklñ (7410 in chips) 
Seat 3: @tetaschell (27600 in chips) 
Seat 5: Scorgiej (61470 in chips) 
Seat 6: goshaleg (25875 in chips) 
Baca4b: posts the ante 400
jklñjklñ: posts the ante 400
@tetaschell: posts the ante 400
Scorgiej: posts the ante 400
goshaleg: posts the ante 400
Baca4b: posts small blind 800
jklñjklñ: posts big blind 1600
*** HOLE CARDS ***
@tetaschell: folds 
vitor762 is disconnected 
Scorgiej: raises 1600 to 3200
goshaleg: folds 
Baca4b: folds 
jklñjklñ: folds 
Uncalled bet (1600) returned to Scorgiej
Scorgiej collected 6000 from pot
Scorgiej: doesn't show hand 
*** SUMMARY ***
Total pot 6000 | Rake 0 
Seat 1: Baca4b (small blind) folded before Flop
Seat 2: jklñjklñ (big blind) folded before Flop
Seat 3: @tetaschell folded before Flop (didn't bet)
Seat 5: Scorgiej collected (6000)
Seat 6: goshaleg (button) folded before Flop (didn't bet)

PokerStars Hand #251209819951: Tournament #3769361908, $52.38+$2.62 USD Hold'em No Limit - Level XVI (800/1600) - 2024/06/26 22:49:44 UTC [2024/06/26 18:49:44 ET]
Table '3769361908 12' 6-max Seat #1 is the button
Seat 1: Baca4b (20752 in chips) 
Seat 2: jklñjklñ (5410 in chips) 
Seat 3: @tetaschell (27200 in chips) 
Seat 4: vitor762 (14070 in chips) 
Seat 5: Scorgiej (65470 in chips) 
Seat 6: goshaleg (25475 in chips) 
Baca4b: posts the ante 400
jklñjklñ: posts the ante 400
@tetaschell: posts the ante 400
vitor762: posts the ante 400
Scorgiej: posts the ante 400
goshaleg: posts the ante 400
jklñjklñ: posts small blind 800
@tetaschell: posts big blind 1600
*** HOLE CARDS ***
vitor762: folds 
Scorgiej: folds 
goshaleg: raises 1600 to 3200
Baca4b: folds 
jklñjklñ: folds 
@tetaschell: raises 4000 to 7200
goshaleg: folds 
Uncalled bet (4000) returned to @tetaschell
@tetaschell collected 9600 from pot
@tetaschell: doesn't show hand 
*** SUMMARY ***
Total pot 9600 | Rake 0 
Seat 1: Baca4b (button) folded before Flop (didn't bet)
Seat 2: jklñjklñ (small blind) folded before Flop
Seat 3: @tetaschell (big blind) collected (9600)
Seat 4: vitor762 folded before Flop (didn't bet)
Seat 5: Scorgiej folded before Flop (didn't bet)
Seat 6: goshaleg folded before Flop

PokerStars Hand #251209830418: Tournament #3769361908, $52.38+$2.62 USD Hold'em No Limit - Level XVII (1000/2000) - 2024/06/26 22:50:26 UTC [2024/06/26 18:50:26 ET]
Table '3769361908 12' 6-max Seat #2 is the button
Seat 1: Baca4b (20352 in chips) 
Seat 2: jklñjklñ (4210 in chips) 
Seat 3: @tetaschell (33200 in chips) 
Seat 4: vitor762 (13670 in chips) 
Seat 5: Scorgiej (65070 in chips) 
Seat 6: goshaleg (21875 in chips) 
Baca4b: posts the ante 500
jklñjklñ: posts the ante 500
@tetaschell: posts the ante 500
vitor762: posts the ante 500
Scorgiej: posts the ante 500
goshaleg: posts the ante 500
@tetaschell: posts small blind 1000
vitor762: posts big blind 2000
*** HOLE CARDS ***
Scorgiej: folds 
goshaleg: folds 
Baca4b: folds 
jklñjklñ: raises 1710 to 3710 and is all-in
@tetaschell: raises 28990 to 32700 and is all-in
vitor762: calls 11170 and is all-in
Uncalled bet (19530) returned to @tetaschell
*** FLOP *** [2s Th 4h]
*** TURN *** [2s Th 4h] [6c]
*** RIVER *** [2s Th 4h 6c] [3d]
*** SHOW DOWN ***
@tetaschell: shows [6d 8d] (a pair of Sixes)
vitor762: shows [8h 8c] (a pair of Eights)
vitor762 collected 18920 from side pot
jklñjklñ: shows [Qd Qs] (a pair of Queens)
jklñjklñ collected 14130 from main pot
*** SUMMARY ***
Total pot 33050 Main pot 14130. Side pot 18920. | Rake 0 
Board [2s Th 4h 6c 3d]
Seat 1: Baca4b folded before Flop (didn't bet)
Seat 2: jklñjklñ (button) showed [Qd Qs] and won (14130) with a pair of Queens
Seat 3: @tetaschell (small blind) showed [6d 8d] and lost with a pair of Sixes
Seat 4: vitor762 (big blind) showed [8h 8c] and won (18920) with a pair of Eights
Seat 5: Scorgiej folded before Flop (didn't bet)
Seat 6: goshaleg folded before Flop (didn't bet)

PokerStars Hand #251209838074: Tournament #3769361908, $52.38+$2.62 USD Hold'em No Limit - Level XVII (1000/2000) - 2024/06/26 22:50:58 UTC [2024/06/26 18:50:58 ET]
Table '3769361908 12' 6-max Seat #3 is the button
Seat 1: Baca4b (19852 in chips) 
Seat 2: jklñjklñ (14130 in chips) 
Seat 3: @tetaschell (19530 in chips) 
Seat 4: vitor762 (18920 in chips) 
Seat 5: Scorgiej (64570 in chips) 
Seat 6: goshaleg (21375 in chips) 
Baca4b: posts the ante 500
jklñjklñ: posts the ante 500
@tetaschell: posts the ante 500
vitor762: posts the ante 500
Scorgiej: posts the ante 500
goshaleg: posts the ante 500
vitor762: posts small blind 1000
Scorgiej: posts big blind 2000
*** HOLE CARDS ***
goshaleg: folds 
Baca4b: folds 
jklñjklñ: raises 11630 to 13630 and is all-in
@tetaschell: folds 
vitor762: folds 
Scorgiej: folds 
Uncalled bet (11630) returned to jklñjklñ
jklñjklñ collected 8000 from pot
*** SUMMARY ***
Total pot 8000 | Rake 0 
Seat 1: Baca4b folded before Flop (didn't bet)
Seat 2: jklñjklñ collected (8000)
Seat 3: @tetaschell (button) folded before Flop (didn't bet)
Seat 4: vitor762 (small blind) folded before Flop
Seat 5: Scorgiej (big blind) folded before Flop
Seat 6: goshaleg folded before Flop (didn't bet)

PokerStars Hand #251209842678: Tournament #3769361908, $52.38+$2.62 USD Hold'em No Limit - Level XVII (1000/2000) - 2024/06/26 22:51:17 UTC [2024/06/26 18:51:17 ET]
Table '3769361908 12' 6-max Seat #4 is the button
Seat 1: Baca4b (19352 in chips) 
Seat 2: jklñjklñ (19630 in chips) 
Seat 3: @tetaschell (19030 in chips) 
Seat 4: vitor762 (17420 in chips) 
Seat 5: Scorgiej (62070 in chips) 
Seat 6: goshaleg (20875 in chips) 
Baca4b: posts the ante 500
jklñjklñ: posts the ante 500
@tetaschell: posts the ante 500
vitor762: posts the ante 500
Scorgiej: posts the ante 500
goshaleg: posts the ante 500
Scorgiej: posts small blind 1000
goshaleg: posts big blind 2000
*** HOLE CARDS ***
Baca4b: folds 
jklñjklñ: folds 
@tetaschell: folds 
vitor762: folds 
Scorgiej: raises 59570 to 61570 and is all-in
goshaleg: calls 18375 and is all-in
Uncalled bet (41195) returned to Scorgiej
*** FLOP *** [8d 2s Qh]
*** TURN *** [8d 2s Qh] [2d]
*** RIVER *** [8d 2s Qh 2d] [6s]
*** SHOW DOWN ***
Scorgiej: shows [9d Qc] (two pair, Queens and Deuces)
goshaleg: shows [Ad 4h] (a pair of Deuces)
Scorgiej collected 43750 from pot
goshaleg finished the tournament in 100th place
*** SUMMARY ***
Total pot 43750 | Rake 0 
Board [8d 2s Qh 2d 6s]
Seat 1: Baca4b folded before Flop (didn't bet)
Seat 2: jklñjklñ folded before Flop (didn't bet)
Seat 3: @tetaschell folded before Flop (didn't bet)
Seat 4: vitor762 (button) folded before Flop (didn't bet)
Seat 5: Scorgiej (small blind) showed [9d Qc] and won (43750) with two pair, Queens and Deuces
Seat 6: goshaleg (big blind) showed [Ad 4h] and lost with a pair of Deuces

PokerStars Hand #251209849149: Tournament #3769361908, $52.38+$2.62 USD Hold'em No Limit - Level XVII (1000/2000) - 2024/06/26 22:51:44 UTC [2024/06/26 18:51:44 ET]
Table '3769361908 12' 6-max Seat #5 is the button
Seat 1: Baca4b (18852 in chips) 
Seat 2: jklñjklñ (19130 in chips) 
Seat 3: @tetaschell (18530 in chips) 
Seat 4: vitor762 (16920 in chips) 
Seat 5: Scorgiej (84945 in chips) 
Baca4b: posts the ante 500
jklñjklñ: posts the ante 500
@tetaschell: posts the ante 500
vitor762: posts the ante 500
Scorgiej: posts the ante 500
Baca4b: posts small blind 1000
jklñjklñ: posts big blind 2000
*** HOLE CARDS ***
@tetaschell: folds 
vitor762: raises 14420 to 16420 and is all-in
Scorgiej: folds 
Baca4b: raises 1932 to 18352 and is all-in
jklñjklñ: folds 
Uncalled bet (1932) returned to Baca4b
*** FLOP *** [3s Jc 8s]
*** TURN *** [3s Jc 8s] [7s]
*** RIVER *** [3s Jc 8s 7s] [Js]
G_haeffner is disconnected 
*** SHOW DOWN ***
Baca4b: shows [6d 6c] (two pair, Jacks and Sixes)
vitor762: shows [Qs Qc] (a flush, Queen high)
vitor762 collected 37340 from pot
*** SUMMARY ***
Total pot 37340 | Rake 0 
Board [3s Jc 8s 7s Js]
Seat 1: Baca4b (small blind) showed [6d 6c] and lost with two pair, Jacks and Sixes
Seat 2: jklñjklñ (big blind) folded before Flop
Seat 3: @tetaschell folded before Flop (didn't bet)
Seat 4: vitor762 showed [Qs Qc] and won (37340) with a flush, Queen high
Seat 5: Scorgiej (button) folded before Flop (didn't bet)

PokerStars Hand #251209856163: Tournament #3769361908, $52.38+$2.62 USD Hold'em No Limit - Level XVII (1000/2000) - 2024/06/26 22:52:12 UTC [2024/06/26 18:52:12 ET]
Table '3769361908 12' 6-max Seat #1 is the button
Seat 1: Baca4b (1932 in chips) 
Seat 2: jklñjklñ (16630 in chips) 
Seat 3: @tetaschell (18030 in chips) 
Seat 4: vitor762 (37340 in chips) 
Seat 5: Scorgiej (84445 in chips) 
Seat 6: G_haeffner (9348 in chips) 
Baca4b: posts the ante 500
jklñjklñ: posts the ante 500
@tetaschell: posts the ante 500
vitor762: posts the ante 500
Scorgiej: posts the ante 500
G_haeffner: posts the ante 500
jklñjklñ: posts small blind 1000
@tetaschell: posts big blind 2000
*** HOLE CARDS ***
vitor762: folds 
Scorgiej: raises 81945 to 83945 and is all-in
G_haeffner: folds 
Baca4b: calls 1432 and is all-in
jklñjklñ: folds 
@tetaschell: folds 
Uncalled bet (81945) returned to Scorgiej
*** FLOP *** [Jd 7d 5s]
*** TURN *** [Jd 7d 5s] [Js]
*** RIVER *** [Jd 7d 5s Js] [3h]
*** SHOW DOWN ***
Scorgiej: shows [6h As] (a pair of Jacks)
Scorgiej collected 1136 from side pot
Baca4b: shows [5d 5c] (a full house, Fives full of Jacks)
Baca4b collected 8296 from main pot
*** SUMMARY ***
Total pot 9432 Main pot 8296. Side pot 1136. | Rake 0 
Board [Jd 7d 5s Js 3h]
Seat 1: Baca4b (button) showed [5d 5c] and won (8296) with a full house, Fives full of Jacks
Seat 2: jklñjklñ (small blind) folded before Flop
Seat 3: @tetaschell (big blind) folded before Flop
Seat 4: vitor762 folded before Flop (didn't bet)
Seat 5: Scorgiej showed [6h As] and won (1136) with a pair of Jacks
Seat 6: G_haeffner folded before Flop (didn't bet)

PokerStars Hand #251209863128: Tournament #3769361908, $52.38+$2.62 USD Hold'em No Limit - Level XVII (1000/2000) - 2024/06/26 22:52:40 UTC [2024/06/26 18:52:40 ET]
Table '3769361908 12' 6-max Seat #2 is the button
Seat 1: Baca4b (8296 in chips) 
Seat 2: jklñjklñ (15130 in chips) 
Seat 3: @tetaschell (15530 in chips) 
Seat 4: vitor762 (36840 in chips) 
Seat 5: Scorgiej (83081 in chips) 
Seat 6: G_haeffner (8848 in chips) 
Baca4b: posts the ante 500
jklñjklñ: posts the ante 500
@tetaschell: posts the ante 500
vitor762: posts the ante 500
Scorgiej: posts the ante 500
G_haeffner: posts the ante 500
@tetaschell: posts small blind 1000
vitor762: posts big blind 2000
*** HOLE CARDS ***
Scorgiej: raises 2000 to 4000
G_haeffner: folds 
Baca4b: folds 
jklñjklñ: folds 
@tetaschell: folds 
vitor762: calls 2000
*** FLOP *** [Jd 8d Jh]
vitor762: checks 
Scorgiej: bets 3000
vitor762: folds 
Uncalled bet (3000) returned to Scorgiej
Scorgiej collected 12000 from pot
Scorgiej: doesn't show hand 
*** SUMMARY ***
Total pot 12000 | Rake 0 
Board [Jd 8d Jh]
Seat 1: Baca4b folded before Flop (didn't bet)
Seat 2: jklñjklñ (button) folded before Flop (didn't bet)
Seat 3: @tetaschell (small blind) folded before Flop
Seat 4: vitor762 (big blind) folded on the Flop
Seat 5: Scorgiej collected (12000)
Seat 6: G_haeffner folded before Flop (didn't bet)

PokerStars Hand #251209874511: Tournament #3769361908, $52.38+$2.62 USD Hold'em No Limit - Level XVIII (1200/2400) - 2024/06/26 22:53:28 UTC [2024/06/26 18:53:28 ET]
Table '3769361908 12' 6-max Seat #3 is the button
Seat 1: Baca4b (7796 in chips) 
Seat 2: jklñjklñ (14630 in chips) 
Seat 3: @tetaschell (14030 in chips) 
Seat 4: vitor762 (32340 in chips) 
Seat 5: Scorgiej (90581 in chips) 
Seat 6: G_haeffner (8348 in chips) 
Baca4b: posts the ante 600
jklñjklñ: posts the ante 600
@tetaschell: posts the ante 600
vitor762: posts the ante 600
Scorgiej: posts the ante 600
G_haeffner: posts the ante 600
vitor762: posts small blind 1200
Scorgiej: posts big blind 2400
*** HOLE CARDS ***
G_haeffner: raises 5348 to 7748 and is all-in
Baca4b: calls 7196 and is all-in
jklñjklñ: raises 6282 to 14030 and is all-in
@tetaschell: folds 
vitor762: folds 
Scorgiej: folds 
Uncalled bet (6282) returned to jklñjklñ
*** FLOP *** [8h Ks 9c]
*** TURN *** [8h Ks 9c] [9h]
*** RIVER *** [8h Ks 9c 9h] [6d]
*** SHOW DOWN ***
G_haeffner: shows [Qh Ah] (a pair of Nines)
jklñjklñ: shows [Ac Jc] (a pair of Nines - lower kicker)
G_haeffner collected 1104 from side pot
Baca4b: shows [Ad Tc] (a pair of Nines - lower kicker)
G_haeffner collected 28788 from main pot
Baca4b finished the tournament in 83rd place
*** SUMMARY ***
Total pot 29892 Main pot 28788. Side pot 1104. | Rake 0 
Board [8h Ks 9c 9h 6d]
Seat 1: Baca4b showed [Ad Tc] and lost with a pair of Nines
Seat 2: jklñjklñ showed [Ac Jc] and lost with a pair of Nines
Seat 3: @tetaschell (button) folded before Flop (didn't bet)
Seat 4: vitor762 (small blind) folded before Flop
Seat 5: Scorgiej (big blind) folded before Flop
Seat 6: G_haeffner showed [Qh Ah] and won (29892) with a pair of Nines

PokerStars Hand #251209885604: Tournament #3769361908, $52.38+$2.62 USD Hold'em No Limit - Level XVIII (1200/2400) - 2024/06/26 22:54:13 UTC [2024/06/26 18:54:13 ET]
Table '3769361908 12' 6-max Seat #4 is the button
Seat 2: jklñjklñ (6282 in chips) 
Seat 3: @tetaschell (13430 in chips) 
Seat 4: vitor762 (30540 in chips) 
Seat 5: Scorgiej (87581 in chips) 
Seat 6: G_haeffner (29892 in chips) 
jklñjklñ: posts the ante 600
@tetaschell: posts the ante 600
vitor762: posts the ante 600
Scorgiej: posts the ante 600
G_haeffner: posts the ante 600
Scorgiej: posts small blind 1200
G_haeffner: posts big blind 2400
*** HOLE CARDS ***
jklñjklñ: folds 
@tetaschell: folds 
vitor762: folds 
Scorgiej: raises 84581 to 86981 and is all-in
G_haeffner: folds 
Uncalled bet (84581) returned to Scorgiej
Scorgiej collected 7800 from pot
Scorgiej: doesn't show hand 
*** SUMMARY ***
Total pot 7800 | Rake 0 
Seat 2: jklñjklñ folded before Flop (didn't bet)
Seat 3: @tetaschell folded before Flop (didn't bet)
Seat 4: vitor762 (button) folded before Flop (didn't bet)
Seat 5: Scorgiej (small blind) collected (7800)
Seat 6: G_haeffner (big blind) folded before Flop

PokerStars Hand #251209892168: Tournament #3769361908, $52.38+$2.62 USD Hold'em No Limit - Level XVIII (1200/2400) - 2024/06/26 22:54:40 UTC [2024/06/26 18:54:40 ET]
Table '3769361908 12' 6-max Seat #5 is the button
Seat 2: jklñjklñ (5682 in chips) 
Seat 3: @tetaschell (12830 in chips) 
Seat 4: vitor762 (29940 in chips) 
Seat 5: Scorgiej (92381 in chips) 
Seat 6: G_haeffner (26892 in chips) 
jklñjklñ: posts the ante 600
@tetaschell: posts the ante 600
vitor762: posts the ante 600
Scorgiej: posts the ante 600
G_haeffner: posts the ante 600
G_haeffner: posts small blind 1200
jklñjklñ: posts big blind 2400
*** HOLE CARDS ***
@tetaschell: raises 9830 to 12230 and is all-in
vitor762: folds 
Scorgiej: folds 
G_haeffner: folds 
jklñjklñ: calls 2682 and is all-in
Uncalled bet (7148) returned to @tetaschell
*** FLOP *** [7h 6c 9s]
DR. ELDAR is disconnected 
*** TURN *** [7h 6c 9s] [6s]
*** RIVER *** [7h 6c 9s 6s] [4c]
*** SHOW DOWN ***
jklñjklñ: shows [3s Jd] (a pair of Sixes)
@tetaschell: shows [9h As] (two pair, Nines and Sixes)
@tetaschell collected 14364 from pot
jklñjklñ finished the tournament in 77th place
*** SUMMARY ***
Total pot 14364 | Rake 0 
Board [7h 6c 9s 6s 4c]
Seat 2: jklñjklñ (big blind) showed [3s Jd] and lost with a pair of Sixes
Seat 3: @tetaschell showed [9h As] and won (14364) with two pair, Nines and Sixes
Seat 4: vitor762 folded before Flop (didn't bet)
Seat 5: Scorgiej (button) folded before Flop (didn't bet)
Seat 6: G_haeffner (small blind) folded before Flop

PokerStars Hand #251209964591: Tournament #3769361908, $52.38+$2.62 USD Hold'em No Limit - Level XVIII (1200/2400) - 2024/06/26 23:01:09 UTC [2024/06/26 19:01:09 ET]
Table '3769361908 12' 6-max Seat #6 is the button
Seat 1: DR. ELDAR (36345 in chips) out of hand (moved from another table into small blind)
Seat 2: 4sasss (30176 in chips) out of hand (moved from another table into small blind)
Seat 3: @tetaschell (21512 in chips) 
Seat 4: vitor762 (29340 in chips) 
Seat 5: Scorgiej (91781 in chips) 
Seat 6: G_haeffner (25092 in chips) 
DR. ELDAR will be allowed to play after the button
4sasss will be allowed to play after the button
@tetaschell: posts the ante 600
vitor762: posts the ante 600
Scorgiej: posts the ante 600
G_haeffner: posts the ante 600
@tetaschell: posts small blind 1200
vitor762: posts big blind 2400
*** HOLE CARDS ***
Scorgiej: folds 
G_haeffner: folds 
@tetaschell: raises 18512 to 20912 and is all-in
vitor762: folds 
Uncalled bet (18512) returned to @tetaschell
@tetaschell collected 7200 from pot
@tetaschell: doesn't show hand 
*** SUMMARY ***
Total pot 7200 | Rake 0 
Seat 3: @tetaschell (small blind) collected (7200)
Seat 4: vitor762 (big blind) folded before Flop
Seat 5: Scorgiej folded before Flop (didn't bet)
Seat 6: G_haeffner (button) folded before Flop (didn't bet)

PokerStars Hand #251209968830: Tournament #3769361908, $52.38+$2.62 USD Hold'em No Limit - Level XVIII (1200/2400) - 2024/06/26 23:01:28 UTC [2024/06/26 19:01:28 ET]
Table '3769361908 12' 6-max Seat #3 is the button
Seat 1: DR. ELDAR (36345 in chips) 
Seat 2: 4sasss (30176 in chips) 
Seat 3: @tetaschell (25712 in chips) 
Seat 4: vitor762 (26340 in chips) 
Seat 5: Scorgiej (91181 in chips) 
Seat 6: G_haeffner (24492 in chips) 
DR. ELDAR: posts the ante 600
4sasss: posts the ante 600
@tetaschell: posts the ante 600
vitor762: posts the ante 600
Scorgiej: posts the ante 600
G_haeffner: posts the ante 600
vitor762: posts small blind 1200
Scorgiej: posts big blind 2400
*** HOLE CARDS ***
G_haeffner: folds 
DR. ELDAR: folds 
4sasss: folds 
@tetaschell: folds 
vitor762: folds 
Uncalled bet (1200) returned to Scorgiej
Scorgiej collected 6000 from pot
Scorgiej: doesn't show hand 
*** SUMMARY ***
Total pot 6000 | Rake 0 
Seat 1: DR. ELDAR folded before Flop (didn't bet)
Seat 2: 4sasss folded before Flop (didn't bet)
Seat 3: @tetaschell (button) folded before Flop (didn't bet)
Seat 4: vitor762 (small blind) folded before Flop
Seat 5: Scorgiej (big blind) collected (6000)
Seat 6: G_haeffner folded before Flop (didn't bet)

PokerStars Hand #251209982019: Tournament #3769361908, $52.38+$2.62 USD Hold'em No Limit - Level XIX (1400/2800) - 2024/06/26 23:02:25 UTC [2024/06/26 19:02:25 ET]
Table '3769361908 12' 6-max Seat #4 is the button
Seat 1: DR. ELDAR (35745 in chips) 
Seat 2: 4sasss (29576 in chips) 
Seat 3: @tetaschell (25112 in chips) 
Seat 4: vitor762 (24540 in chips) 
Seat 5: Scorgiej (95381 in chips) 
Seat 6: G_haeffner (23892 in chips) 
DR. ELDAR: posts the ante 700
4sasss: posts the ante 700
@tetaschell: posts the ante 700
vitor762: posts the ante 700
Scorgiej: posts the ante 700
G_haeffner: posts the ante 700
Scorgiej: posts small blind 1400
G_haeffner: posts big blind 2800
*** HOLE CARDS ***
DR. ELDAR: folds 
4sasss: raises 26076 to 28876 and is all-in
@tetaschell: folds 
vitor762: calls 23840 and is all-in
Scorgiej: folds 
G_haeffner: folds 
Uncalled bet (5036) returned to 4sasss
*** FLOP *** [6d 5h 9d]
*** TURN *** [6d 5h 9d] [3c]
*** RIVER *** [6d 5h 9d 3c] [4c]
*** SHOW DOWN ***
4sasss: shows [Qs Ah] (high card Ace)
vitor762: shows [As Ac] (a pair of Aces)
vitor762 collected 56080 from pot
*** SUMMARY ***
Total pot 56080 | Rake 0 
Board [6d 5h 9d 3c 4c]
Seat 1: DR. ELDAR folded before Flop (didn't bet)
Seat 2: 4sasss showed [Qs Ah] and lost with high card Ace
Seat 3: @tetaschell folded before Flop (didn't bet)
Seat 4: vitor762 (button) showed [As Ac] and won (56080) with a pair of Aces
Seat 5: Scorgiej (small blind) folded before Flop
Seat 6: G_haeffner (big blind) folded before Flop

PokerStars Hand #251209994009: Tournament #3769361908, $52.38+$2.62 USD Hold'em No Limit - Level XIX (1400/2800) - 2024/06/26 23:03:17 UTC [2024/06/26 19:03:17 ET]
Table '3769361908 12' 6-max Seat #5 is the button
Seat 1: DR. ELDAR (35045 in chips) 
Seat 2: 4sasss (5036 in chips) 
Seat 3: @tetaschell (24412 in chips) 
Seat 4: vitor762 (56080 in chips) 
Seat 5: Scorgiej (93281 in chips) 
Seat 6: G_haeffner (20392 in chips) 
DR. ELDAR: posts the ante 700
4sasss: posts the ante 700
@tetaschell: posts the ante 700
vitor762: posts the ante 700
Scorgiej: posts the ante 700
G_haeffner: posts the ante 700
G_haeffner: posts small blind 1400
DR. ELDAR: posts big blind 2800
*** HOLE CARDS ***
4sasss: folds 
@tetaschell: folds 
vitor762: folds 
Scorgiej: folds 
G_haeffner: folds 
Uncalled bet (1400) returned to DR. ELDAR
DR. ELDAR collected 7000 from pot
DR. ELDAR: doesn't show hand 
*** SUMMARY ***
Total pot 7000 | Rake 0 
Seat 1: DR. ELDAR (big blind) collected (7000)
Seat 2: 4sasss folded before Flop (didn't bet)
Seat 3: @tetaschell folded before Flop (didn't bet)
Seat 4: vitor762 folded before Flop (didn't bet)
Seat 5: Scorgiej (button) folded before Flop (didn't bet)
Seat 6: G_haeffner (small blind) folded before Flop

PokerStars Hand #251210006784: Tournament #3769361908, $52.38+$2.62 USD Hold'em No Limit - Level XIX (1400/2800) - 2024/06/26 23:04:12 UTC [2024/06/26 19:04:12 ET]
Table '3769361908 12' 6-max Seat #6 is the button
Seat 1: DR. ELDAR (39945 in chips) 
Seat 2: 4sasss (4336 in chips) 
Seat 3: @tetaschell (23712 in chips) 
Seat 4: vitor762 (55380 in chips) 
Seat 5: Scorgiej (92581 in chips) 
Seat 6: G_haeffner (18292 in chips) 
DR. ELDAR: posts the ante 700
4sasss: posts the ante 700
@tetaschell: posts the ante 700
vitor762: posts the ante 700
Scorgiej: posts the ante 700
G_haeffner: posts the ante 700
DR. ELDAR: posts small blind 1400
4sasss: posts big blind 2800
*** HOLE CARDS ***
@tetaschell: folds 
vitor762: raises 2800 to 5600
Scorgiej: folds 
G_haeffner: folds 
DR. ELDAR: folds 
4sasss: calls 836 and is all-in
Uncalled bet (1964) returned to vitor762
*** FLOP *** [4c Kc 9s]
*** TURN *** [4c Kc 9s] [Jc]
*** RIVER *** [4c Kc 9s Jc] [4h]
*** SHOW DOWN ***
4sasss: shows [2c 7d] (a pair of Fours)
vitor762: shows [Ad 8s] (a pair of Fours - Ace kicker)
vitor762 collected 12872 from pot
4sasss finished the tournament in 65th place
*** SUMMARY ***
Total pot 12872 | Rake 0 
Board [4c Kc 9s Jc 4h]
Seat 1: DR. ELDAR (small blind) folded before Flop
Seat 2: 4sasss (big blind) showed [2c 7d] and lost with a pair of Fours
Seat 3: @tetaschell folded before Flop (didn't bet)
Seat 4: vitor762 showed [Ad 8s] and won (12872) with a pair of Fours
Seat 5: Scorgiej folded before Flop (didn't bet)
Seat 6: G_haeffner (button) folded before Flop (didn't bet)

PokerStars Hand #251210018709: Tournament #3769361908, $52.38+$2.62 USD Hold'em No Limit - Level XIX (1400/2800) - 2024/06/26 23:05:03 UTC [2024/06/26 19:05:03 ET]
Table '3769361908 12' 6-max Seat #1 is the button
Seat 1: DR. ELDAR (37845 in chips) 
Seat 3: @tetaschell (23012 in chips) 
Seat 4: vitor762 (63916 in chips) 
Seat 5: Scorgiej (91881 in chips) 
Seat 6: G_haeffner (17592 in chips) 
DR. ELDAR: posts the ante 700
@tetaschell: posts the ante 700
vitor762: posts the ante 700
Scorgiej: posts the ante 700
G_haeffner: posts the ante 700
@tetaschell: posts small blind 1400
vitor762: posts big blind 2800
*** HOLE CARDS ***
Scorgiej: folds 
G_haeffner: folds 
DR. ELDAR: raises 34345 to 37145 and is all-in
@tetaschell: folds 
vitor762: folds 
Uncalled bet (34345) returned to DR. ELDAR
DR. ELDAR collected 10500 from pot
DR. ELDAR: doesn't show hand 
*** SUMMARY ***
Total pot 10500 | Rake 0 
Seat 1: DR. ELDAR (button) collected (10500)
Seat 3: @tetaschell (small blind) folded before Flop
Seat 4: vitor762 (big blind) folded before Flop
Seat 5: Scorgiej folded before Flop (didn't bet)
Seat 6: G_haeffner folded before Flop (didn't bet)

PokerStars Hand #251210036486: Tournament #3769361908, $52.38+$2.62 USD Hold'em No Limit - Level XX (1600/3200) - 2024/06/26 23:06:21 UTC [2024/06/26 19:06:21 ET]
Table '3769361908 12' 6-max Seat #3 is the button
Seat 1: DR. ELDAR (44845 in chips) 
Seat 3: @tetaschell (20912 in chips) 
Seat 4: vitor762 (60416 in chips) 
Seat 5: Scorgiej (91181 in chips) 
Seat 6: G_haeffner (16892 in chips) 
DR. ELDAR: posts the ante 800
@tetaschell: posts the ante 800
vitor762: posts the ante 800
Scorgiej: posts the ante 800
G_haeffner: posts the ante 800
vitor762: posts small blind 1600
Scorgiej: posts big blind 3200
*** HOLE CARDS ***
G_haeffner: folds 
DR. ELDAR: folds 
@tetaschell: folds 
vitor762: calls 1600
Scorgiej: checks 
*** FLOP *** [9d Kd 4h]
vitor762: bets 3200
Scorgiej: folds 
Uncalled bet (3200) returned to vitor762
vitor762 collected 10400 from pot
vitor762: doesn't show hand 
*** SUMMARY ***
Total pot 10400 | Rake 0 
Board [9d Kd 4h]
Seat 1: DR. ELDAR folded before Flop (didn't bet)
Seat 3: @tetaschell (button) folded before Flop (didn't bet)
Seat 4: vitor762 (small blind) collected (10400)
Seat 5: Scorgiej (big blind) folded on the Flop
Seat 6: G_haeffner folded before Flop (didn't bet)

PokerStars Hand #251210050918: Tournament #3769361908, $52.38+$2.62 USD Hold'em No Limit - Level XX (1600/3200) - 2024/06/26 23:07:24 UTC [2024/06/26 19:07:24 ET]
Table '3769361908 12' 6-max Seat #4 is the button
Seat 1: DR. ELDAR (44045 in chips) 
Seat 3: @tetaschell (20112 in chips) 
Seat 4: vitor762 (66816 in chips) 
Seat 5: Scorgiej (87181 in chips) 
Seat 6: G_haeffner (16092 in chips) 
DR. ELDAR: posts the ante 800
@tetaschell: posts the ante 800
vitor762: posts the ante 800
Scorgiej: posts the ante 800
G_haeffner: posts the ante 800
Scorgiej: posts small blind 1600
G_haeffner: posts big blind 3200
*** HOLE CARDS ***
DR. ELDAR: folds 
@tetaschell: raises 16000 to 19200
vitor762: folds 
Scorgiej: folds 
G_haeffner: folds 
Uncalled bet (16000) returned to @tetaschell
@tetaschell collected 12000 from pot
@tetaschell: doesn't show hand 
*** SUMMARY ***
Total pot 12000 | Rake 0 
Seat 1: DR. ELDAR folded before Flop (didn't bet)
Seat 3: @tetaschell collected (12000)
Seat 4: vitor762 (button) folded before Flop (didn't bet)
Seat 5: Scorgiej (small blind) folded before Flop
Seat 6: G_haeffner (big blind) folded before Flop

PokerStars Hand #251210063048: Tournament #3769361908, $52.38+$2.62 USD Hold'em No Limit - Level XXI (1800/3600) - 2024/06/26 23:08:18 UTC [2024/06/26 19:08:18 ET]
Table '3769361908 12' 6-max Seat #5 is the button
Seat 1: DR. ELDAR (43245 in chips) 
Seat 3: @tetaschell (28112 in chips) 
Seat 4: vitor762 (66016 in chips) 
Seat 5: Scorgiej (84781 in chips) 
Seat 6: G_haeffner (12092 in chips) 
DR. ELDAR: posts the ante 900
@tetaschell: posts the ante 900
vitor762: posts the ante 900
Scorgiej: posts the ante 900
G_haeffner: posts the ante 900
G_haeffner: posts small blind 1800
DR. ELDAR: posts big blind 3600
*** HOLE CARDS ***
@tetaschell: folds 
vitor762: folds 
Scorgiej: raises 80281 to 83881 and is all-in
G_haeffner: folds 
DR. ELDAR: folds 
Uncalled bet (80281) returned to Scorgiej
Scorgiej collected 13500 from pot
Scorgiej: doesn't show hand 
*** SUMMARY ***
Total pot 13500 | Rake 0 
Seat 1: DR. ELDAR (big blind) folded before Flop
Seat 3: @tetaschell folded before Flop (didn't bet)
Seat 4: vitor762 folded before Flop (didn't bet)
Seat 5: Scorgiej (button) collected (13500)
Seat 6: G_haeffner (small blind) folded before Flop

PokerStars Hand #251210075601: Tournament #3769361908, $52.38+$2.62 USD Hold'em No Limit - Level XXI (1800/3600) - 2024/06/26 23:09:14 UTC [2024/06/26 19:09:14 ET]
Table '3769361908 12' 6-max Seat #6 is the button
Seat 1: DR. ELDAR (38745 in chips) 
Seat 3: @tetaschell (27212 in chips) 
Seat 4: vitor762 (65116 in chips) 
Seat 5: Scorgiej (93781 in chips) 
Seat 6: G_haeffner (9392 in chips) 
DR. ELDAR: posts the ante 900
@tetaschell: posts the ante 900
vitor762: posts the ante 900
Scorgiej: posts the ante 900
G_haeffner: posts the ante 900
DR. ELDAR: posts small blind 1800
@tetaschell: posts big blind 3600
*** HOLE CARDS ***
vitor762: folds 
Scorgiej: folds 
G_haeffner: folds 
DR. ELDAR: raises 34245 to 37845 and is all-in
@tetaschell: folds 
Uncalled bet (34245) returned to DR. ELDAR
DR. ELDAR collected 11700 from pot
DR. ELDAR: doesn't show hand 
*** SUMMARY ***
Total pot 11700 | Rake 0 
Seat 1: DR. ELDAR (small blind) collected (11700)
Seat 3: @tetaschell (big blind) folded before Flop
Seat 4: vitor762 folded before Flop (didn't bet)
Seat 5: Scorgiej folded before Flop (didn't bet)
Seat 6: G_haeffner (button) folded before Flop (didn't bet)

PokerStars Hand #251210087833: Tournament #3769361908, $52.38+$2.62 USD Hold'em No Limit - Level XXI (1800/3600) - 2024/06/26 23:10:10 UTC [2024/06/26 19:10:10 ET]
Table '3769361908 12' 6-max Seat #1 is the button
Seat 1: DR. ELDAR (45945 in chips) 
Seat 3: @tetaschell (22712 in chips) 
Seat 4: vitor762 (64216 in chips) 
Seat 5: Scorgiej (92881 in chips) 
Seat 6: G_haeffner (8492 in chips) 
DR. ELDAR: posts the ante 900
@tetaschell: posts the ante 900
vitor762: posts the ante 900
Scorgiej: posts the ante 900
G_haeffner: posts the ante 900
@tetaschell: posts small blind 1800
vitor762: posts big blind 3600
*** HOLE CARDS ***
Scorgiej: folds 
G_haeffner: raises 3600 to 7200
DR. ELDAR: folds 
@tetaschell: folds 
vitor762: calls 3600
*** FLOP *** [6h Ad 4d]
vitor762: bets 3600
G_haeffner: calls 392 and is all-in
Uncalled bet (3208) returned to vitor762
*** TURN *** [6h Ad 4d] [7d]
*** RIVER *** [6h Ad 4d 7d] [Js]
*** SHOW DOWN ***
vitor762: shows [2c Ac] (a pair of Aces)
G_haeffner: shows [Kh Qc] (high card Ace)
vitor762 collected 21484 from pot
G_haeffner finished the tournament in 63rd place
*** SUMMARY ***
Total pot 21484 | Rake 0 
Board [6h Ad 4d 7d Js]
Seat 1: DR. ELDAR (button) folded before Flop (didn't bet)
Seat 3: @tetaschell (small blind) folded before Flop
Seat 4: vitor762 (big blind) showed [2c Ac] and won (21484) with a pair of Aces
Seat 5: Scorgiej folded before Flop (didn't bet)
Seat 6: G_haeffner showed [Kh Qc] and lost with high card Ace

PokerStars Hand #251210099753: Tournament #3769361908, $52.38+$2.62 USD Hold'em No Limit - Level XXI (1800/3600) - 2024/06/26 23:11:04 UTC [2024/06/26 19:11:04 ET]
Table '3769361908 12' 6-max Seat #3 is the button
Seat 1: DR. ELDAR (45045 in chips) 
Seat 3: @tetaschell (20012 in chips) 
Seat 4: vitor762 (77208 in chips) 
Seat 5: Scorgiej (91981 in chips) 
DR. ELDAR: posts the ante 900
@tetaschell: posts the ante 900
vitor762: posts the ante 900
Scorgiej: posts the ante 900
vitor762: posts small blind 1800
Scorgiej: posts big blind 3600
*** HOLE CARDS ***
EqualizeSTAR is disconnected 
DR. ELDAR: folds 
@tetaschell: folds 
vitor762: folds 
Uncalled bet (1800) returned to Scorgiej
Scorgiej collected 7200 from pot
Scorgiej: doesn't show hand 
*** SUMMARY ***
Total pot 7200 | Rake 0 
Seat 1: DR. ELDAR folded before Flop (didn't bet)
Seat 3: @tetaschell (button) folded before Flop (didn't bet)
Seat 4: vitor762 (small blind) folded before Flop
Seat 5: Scorgiej (big blind) collected (7200)

PokerStars Hand #251210106072: Tournament #3769361908, $52.38+$2.62 USD Hold'em No Limit - Level XXII (2000/4000) - 2024/06/26 23:11:33 UTC [2024/06/26 19:11:33 ET]
Table '3769361908 12' 6-max Seat #4 is the button
Seat 1: DR. ELDAR (44145 in chips) 
Seat 3: @tetaschell (19112 in chips) 
Seat 4: vitor762 (74508 in chips) 
Seat 5: Scorgiej (96481 in chips) 
Seat 6: EqualizeSTAR (38358 in chips) 
DR. ELDAR: posts the ante 1000
@tetaschell: posts the ante 1000
vitor762: posts the ante 1000
Scorgiej: posts the ante 1000
EqualizeSTAR: posts the ante 1000
Scorgiej: posts small blind 2000
EqualizeSTAR: posts big blind 4000
*** HOLE CARDS ***
DR. ELDAR: folds 
@tetaschell: folds 
vitor762: raises 4000 to 8000
Scorgiej: folds 
EqualizeSTAR: calls 4000
*** FLOP *** [5d 5c 4c]
EqualizeSTAR: checks 
vitor762: bets 6000
pj0901 is disconnected 
EqualizeSTAR: folds 
Uncalled bet (6000) returned to vitor762
vitor762 collected 23000 from pot
vitor762: doesn't show hand 
*** SUMMARY ***
Total pot 23000 | Rake 0 
Board [5d 5c 4c]
Seat 1: DR. ELDAR folded before Flop (didn't bet)
Seat 3: @tetaschell folded before Flop (didn't bet)
Seat 4: vitor762 (button) collected (23000)
Seat 5: Scorgiej (small blind) folded before Flop
Seat 6: EqualizeSTAR (big blind) folded on the Flop

PokerStars Hand #251210129375: Tournament #3769361908, $52.38+$2.62 USD Hold'em No Limit - Level XXII (2000/4000) - 2024/06/26 23:13:22 UTC [2024/06/26 19:13:22 ET]
Table '3769361908 12' 6-max Seat #5 is the button
Seat 1: DR. ELDAR (43145 in chips) 
Seat 2: pj0901 (25996 in chips) 
Seat 3: @tetaschell (18112 in chips) 
Seat 4: vitor762 (88508 in chips) 
Seat 5: Scorgiej (93481 in chips) 
Seat 6: EqualizeSTAR (29358 in chips) 
DR. ELDAR: posts the ante 1000
pj0901: posts the ante 1000
@tetaschell: posts the ante 1000
vitor762: posts the ante 1000
Scorgiej: posts the ante 1000
EqualizeSTAR: posts the ante 1000
EqualizeSTAR: posts small blind 2000
DR. ELDAR: posts big blind 4000
*** HOLE CARDS ***
pj0901: raises 20000 to 24000
@tetaschell: folds 
vitor762: folds 
Scorgiej: folds 
EqualizeSTAR: folds 
DR. ELDAR: folds 
Uncalled bet (20000) returned to pj0901
pj0901 collected 16000 from pot
pj0901: doesn't show hand 
*** SUMMARY ***
Total pot 16000 | Rake 0 
Seat 1: DR. ELDAR (big blind) folded before Flop
Seat 2: pj0901 collected (16000)
Seat 3: @tetaschell folded before Flop (didn't bet)
Seat 4: vitor762 folded before Flop (didn't bet)
Seat 5: Scorgiej (button) folded before Flop (didn't bet)
Seat 6: EqualizeSTAR (small blind) folded before Flop

PokerStars Hand #251210133891: Tournament #3769361908, $52.38+$2.62 USD Hold'em No Limit - Level XXII (2000/4000) - 2024/06/26 23:13:42 UTC [2024/06/26 19:13:42 ET]
Table '3769361908 12' 6-max Seat #6 is the button
Seat 1: DR. ELDAR (38145 in chips) 
Seat 2: pj0901 (36996 in chips) 
Seat 3: @tetaschell (17112 in chips) 
Seat 4: vitor762 (87508 in chips) 
Seat 5: Scorgiej (92481 in chips) 
Seat 6: EqualizeSTAR (26358 in chips) 
DR. ELDAR: posts the ante 1000
pj0901: posts the ante 1000
@tetaschell: posts the ante 1000
vitor762: posts the ante 1000
Scorgiej: posts the ante 1000
EqualizeSTAR: posts the ante 1000
DR. ELDAR: posts small blind 2000
pj0901: posts big blind 4000
*** HOLE CARDS ***
@tetaschell: folds 
vitor762: folds 
Scorgiej: folds 
EqualizeSTAR: folds 
DR. ELDAR: folds 
Uncalled bet (2000) returned to pj0901
pj0901 collected 10000 from pot
pj0901: doesn't show hand 
*** SUMMARY ***
Total pot 10000 | Rake 0 
Seat 1: DR. ELDAR (small blind) folded before Flop
Seat 2: pj0901 (big blind) collected (10000)
Seat 3: @tetaschell folded before Flop (didn't bet)
Seat 4: vitor762 folded before Flop (didn't bet)
Seat 5: Scorgiej folded before Flop (didn't bet)
Seat 6: EqualizeSTAR (button) folded before Flop (didn't bet)

PokerStars Hand #251210141457: Tournament #3769361908, $52.38+$2.62 USD Hold'em No Limit - Level XXIII (2500/5000) - 2024/06/26 23:14:18 UTC [2024/06/26 19:14:18 ET]
Table '3769361908 12' 6-max Seat #1 is the button
Seat 1: DR. ELDAR (35145 in chips) 
Seat 2: pj0901 (43996 in chips) 
Seat 3: @tetaschell (16112 in chips) 
Seat 4: vitor762 (86508 in chips) 
Seat 5: Scorgiej (91481 in chips) 
Seat 6: EqualizeSTAR (25358 in chips) 
DR. ELDAR: posts the ante 1250
pj0901: posts the ante 1250
@tetaschell: posts the ante 1250
vitor762: posts the ante 1250
Scorgiej: posts the ante 1250
EqualizeSTAR: posts the ante 1250
pj0901: posts small blind 2500
@tetaschell: posts big blind 5000
*** HOLE CARDS ***
vitor762: folds 
Scorgiej: folds 
EqualizeSTAR: folds 
DR. ELDAR: folds 
pj0901: raises 8500 to 13500
@tetaschell: raises 1362 to 14862 and is all-in
pj0901: calls 1362
*** FLOP *** [2h 5c 7c]
*** TURN *** [2h 5c 7c] [6s]
*** RIVER *** [2h 5c 7c 6s] [3h]
*** SHOW DOWN ***
pj0901: shows [Th 6d] (a pair of Sixes)
@tetaschell: shows [3s Ks] (a pair of Threes)
pj0901 collected 37224 from pot
@tetaschell finished the tournament in 52nd place and received $91.90.
*** SUMMARY ***
Total pot 37224 | Rake 0 
Board [2h 5c 7c 6s 3h]
Seat 1: DR. ELDAR (button) folded before Flop (didn't bet)
Seat 2: pj0901 (small blind) showed [Th 6d] and won (37224) with a pair of Sixes
Seat 3: @tetaschell (big blind) showed [3s Ks] and lost with a pair of Threes
Seat 4: vitor762 folded before Flop (didn't bet)
Seat 5: Scorgiej folded before Flop (didn't bet)
Seat 6: EqualizeSTAR folded before Flop (didn't bet)

PokerStars Hand #251210152125: Tournament #3769361908, $52.38+$2.62 USD Hold'em No Limit - Level XXIII (2500/5000) - 2024/06/26 23:15:07 UTC [2024/06/26 19:15:07 ET]
Table '3769361908 12' 6-max Seat #2 is the button
Seat 1: DR. ELDAR (33895 in chips) 
Seat 2: pj0901 (65108 in chips) 
Seat 4: vitor762 (85258 in chips) 
Seat 5: Scorgiej (90231 in chips) 
Seat 6: EqualizeSTAR (24108 in chips) 
DR. ELDAR: posts the ante 1250
pj0901: posts the ante 1250
vitor762: posts the ante 1250
Scorgiej: posts the ante 1250
EqualizeSTAR: posts the ante 1250
vitor762: posts small blind 2500
Scorgiej: posts big blind 5000
*** HOLE CARDS ***
EqualizeSTAR: folds 
DR. ELDAR: folds 
pj0901: folds 
vitor762: calls 2500
Scorgiej: raises 8500 to 13500
vitor762: raises 70508 to 84008 and is all-in
Scorgiej: folds 
Uncalled bet (70508) returned to vitor762
vitor762 collected 33250 from pot
vitor762: doesn't show hand 
*** SUMMARY ***
Total pot 33250 | Rake 0 
Seat 1: DR. ELDAR folded before Flop (didn't bet)
Seat 2: pj0901 (button) folded before Flop (didn't bet)
Seat 4: vitor762 (small blind) collected (33250)
Seat 5: Scorgiej (big blind) folded before Flop
Seat 6: EqualizeSTAR folded before Flop (didn't bet)

PokerStars Hand #251210163884: Tournament #3769361908, $52.38+$2.62 USD Hold'em No Limit - Level XXIII (2500/5000) - 2024/06/26 23:16:02 UTC [2024/06/26 19:16:02 ET]
Table '3769361908 12' 6-max Seat #4 is the button
Seat 1: DR. ELDAR (32645 in chips) 
Seat 2: pj0901 (63858 in chips) 
Seat 3: assalbi (87332 in chips) 
Seat 4: vitor762 (103758 in chips) 
Seat 5: Scorgiej (75481 in chips) 
Seat 6: EqualizeSTAR (22858 in chips) 
DR. ELDAR: posts the ante 1250
pj0901: posts the ante 1250
assalbi: posts the ante 1250
vitor762: posts the ante 1250
Scorgiej: posts the ante 1250
EqualizeSTAR: posts the ante 1250
Scorgiej: posts small blind 2500
EqualizeSTAR: posts big blind 5000
*** HOLE CARDS ***
DR. ELDAR: folds 
pj0901: folds 
assalbi: folds 
vitor762: folds 
Scorgiej: folds 
Uncalled bet (2500) returned to EqualizeSTAR
EqualizeSTAR collected 12500 from pot
EqualizeSTAR: doesn't show hand 
*** SUMMARY ***
Total pot 12500 | Rake 0 
Seat 1: DR. ELDAR folded before Flop (didn't bet)
Seat 2: pj0901 folded before Flop (didn't bet)
Seat 3: assalbi folded before Flop (didn't bet)
Seat 4: vitor762 (button) folded before Flop (didn't bet)
Seat 5: Scorgiej (small blind) folded before Flop
Seat 6: EqualizeSTAR (big blind) collected (12500)

PokerStars Hand #251210170856: Tournament #3769361908, $52.38+$2.62 USD Hold'em No Limit - Level XXIII (2500/5000) - 2024/06/26 23:16:34 UTC [2024/06/26 19:16:34 ET]
Table '3769361908 12' 6-max Seat #5 is the button
Seat 1: DR. ELDAR (31395 in chips) 
Seat 2: pj0901 (62608 in chips) 
Seat 3: assalbi (86082 in chips) 
Seat 4: vitor762 (102508 in chips) 
Seat 5: Scorgiej (71731 in chips) 
Seat 6: EqualizeSTAR (31608 in chips) 
DR. ELDAR: posts the ante 1250
pj0901: posts the ante 1250
assalbi: posts the ante 1250
vitor762: posts the ante 1250
Scorgiej: posts the ante 1250
EqualizeSTAR: posts the ante 1250
EqualizeSTAR: posts small blind 2500
DR. ELDAR: posts big blind 5000
*** HOLE CARDS ***
pj0901: folds 
assalbi: folds 
vitor762: folds 
Scorgiej: folds 
EqualizeSTAR: raises 25358 to 30358 and is all-in
DR. ELDAR: folds 
Uncalled bet (25358) returned to EqualizeSTAR
EqualizeSTAR collected 17500 from pot
EqualizeSTAR: doesn't show hand 
*** SUMMARY ***
Total pot 17500 | Rake 0 
Seat 1: DR. ELDAR (big blind) folded before Flop
Seat 2: pj0901 folded before Flop (didn't bet)
Seat 3: assalbi folded before Flop (didn't bet)
Seat 4: vitor762 folded before Flop (didn't bet)
Seat 5: Scorgiej (button) folded before Flop (didn't bet)
Seat 6: EqualizeSTAR (small blind) collected (17500)

PokerStars Hand #251210177558: Tournament #3769361908, $52.38+$2.62 USD Hold'em No Limit - Level XXIII (2500/5000) - 2024/06/26 23:17:06 UTC [2024/06/26 19:17:06 ET]
Table '3769361908 12' 6-max Seat #6 is the button
Seat 1: DR. ELDAR (25145 in chips) 
Seat 2: pj0901 (61358 in chips) 
Seat 3: assalbi (84832 in chips) 
Seat 4: vitor762 (101258 in chips) 
Seat 5: Scorgiej (70481 in chips) 
Seat 6: EqualizeSTAR (42858 in chips) 
DR. ELDAR: posts the ante 1250
pj0901: posts the ante 1250
assalbi: posts the ante 1250
vitor762: posts the ante 1250
Scorgiej: posts the ante 1250
EqualizeSTAR: posts the ante 1250
DR. ELDAR: posts small blind 2500
pj0901: posts big blind 5000
*** HOLE CARDS ***
assalbi: folds 
vitor762: folds 
Scorgiej: folds 
EqualizeSTAR: folds 
DR. ELDAR: raises 18895 to 23895 and is all-in
pj0901: folds 
Uncalled bet (18895) returned to DR. ELDAR
DR. ELDAR collected 17500 from pot
DR. ELDAR: doesn't show hand 
*** SUMMARY ***
Total pot 17500 | Rake 0 
Seat 1: DR. ELDAR (small blind) collected (17500)
Seat 2: pj0901 (big blind) folded before Flop
Seat 3: assalbi folded before Flop (didn't bet)
Seat 4: vitor762 folded before Flop (didn't bet)
Seat 5: Scorgiej folded before Flop (didn't bet)
Seat 6: EqualizeSTAR (button) folded before Flop (didn't bet)

PokerStars Hand #251210185839: Tournament #3769361908, $52.38+$2.62 USD Hold'em No Limit - Level XXIV (3000/6000) - 2024/06/26 23:17:45 UTC [2024/06/26 19:17:45 ET]
Table '3769361908 12' 6-max Seat #1 is the button
Seat 1: DR. ELDAR (36395 in chips) 
Seat 2: pj0901 (55108 in chips) 
Seat 3: assalbi (83582 in chips) 
Seat 4: vitor762 (100008 in chips) 
Seat 5: Scorgiej (69231 in chips) 
Seat 6: EqualizeSTAR (41608 in chips) 
DR. ELDAR: posts the ante 1500
pj0901: posts the ante 1500
assalbi: posts the ante 1500
vitor762: posts the ante 1500
Scorgiej: posts the ante 1500
EqualizeSTAR: posts the ante 1500
pj0901: posts small blind 3000
assalbi: posts big blind 6000
*** HOLE CARDS ***
vitor762: folds 
Scorgiej: folds 
EqualizeSTAR: folds 
DR. ELDAR: raises 28895 to 34895 and is all-in
pj0901: folds 
assalbi: folds 
Uncalled bet (28895) returned to DR. ELDAR
DR. ELDAR collected 24000 from pot
DR. ELDAR: doesn't show hand 
*** SUMMARY ***
Total pot 24000 | Rake 0 
Seat 1: DR. ELDAR (button) collected (24000)
Seat 2: pj0901 (small blind) folded before Flop
Seat 3: assalbi (big blind) folded before Flop
Seat 4: vitor762 folded before Flop (didn't bet)
Seat 5: Scorgiej folded before Flop (didn't bet)
Seat 6: EqualizeSTAR folded before Flop (didn't bet)

PokerStars Hand #251210194137: Tournament #3769361908, $52.38+$2.62 USD Hold'em No Limit - Level XXIV (3000/6000) - 2024/06/26 23:18:24 UTC [2024/06/26 19:18:24 ET]
Table '3769361908 12' 6-max Seat #2 is the button
Seat 1: DR. ELDAR (52895 in chips) 
Seat 2: pj0901 (50608 in chips) 
Seat 3: assalbi (76082 in chips) 
Seat 4: vitor762 (98508 in chips) 
Seat 5: Scorgiej (67731 in chips) 
Seat 6: EqualizeSTAR (40108 in chips) 
DR. ELDAR: posts the ante 1500
pj0901: posts the ante 1500
assalbi: posts the ante 1500
vitor762: posts the ante 1500
Scorgiej: posts the ante 1500
EqualizeSTAR: posts the ante 1500
assalbi: posts small blind 3000
vitor762: posts big blind 6000
*** HOLE CARDS ***
Scorgiej: raises 60231 to 66231 and is all-in
EqualizeSTAR: folds 
DR. ELDAR: folds 
pj0901: folds 
assalbi: folds 
vitor762: folds 
Uncalled bet (60231) returned to Scorgiej
Scorgiej collected 24000 from pot
Scorgiej: doesn't show hand 
*** SUMMARY ***
Total pot 24000 | Rake 0 
Seat 1: DR. ELDAR folded before Flop (didn't bet)
Seat 2: pj0901 (button) folded before Flop (didn't bet)
Seat 3: assalbi (small blind) folded before Flop
Seat 4: vitor762 (big blind) folded before Flop
Seat 5: Scorgiej collected (24000)
Seat 6: EqualizeSTAR folded before Flop (didn't bet)

PokerStars Hand #251210200770: Tournament #3769361908, $52.38+$2.62 USD Hold'em No Limit - Level XXIV (3000/6000) - 2024/06/26 23:18:56 UTC [2024/06/26 19:18:56 ET]
Table '3769361908 12' 6-max Seat #3 is the button
Seat 1: DR. ELDAR (51395 in chips) 
Seat 2: pj0901 (49108 in chips) 
Seat 3: assalbi (71582 in chips) 
Seat 4: vitor762 (91008 in chips) 
Seat 5: Scorgiej (84231 in chips) 
Seat 6: EqualizeSTAR (38608 in chips) 
DR. ELDAR: posts the ante 1500
pj0901: posts the ante 1500
assalbi: posts the ante 1500
vitor762: posts the ante 1500
Scorgiej: posts the ante 1500
EqualizeSTAR: posts the ante 1500
vitor762: posts small blind 3000
Scorgiej: posts big blind 6000
*** HOLE CARDS ***
EqualizeSTAR: folds 
DR. ELDAR: folds 
pj0901: folds 
assalbi: folds 
vitor762: calls 3000
Scorgiej: checks 
*** FLOP *** [9d 7c Qh]
vitor762: bets 6930
Scorgiej: calls 6930
*** TURN *** [9d 7c Qh] [Kd]
vitor762: bets 21600
Scorgiej: folds 
Uncalled bet (21600) returned to vitor762
vitor762 collected 34860 from pot
vitor762: doesn't show hand 
*** SUMMARY ***
Total pot 34860 | Rake 0 
Board [9d 7c Qh Kd]
Seat 1: DR. ELDAR folded before Flop (didn't bet)
Seat 2: pj0901 folded before Flop (didn't bet)
Seat 3: assalbi (button) folded before Flop (didn't bet)
Seat 4: vitor762 (small blind) collected (34860)
Seat 5: Scorgiej (big blind) folded on the Turn
Seat 6: EqualizeSTAR folded before Flop (didn't bet)

PokerStars Hand #251210213337: Tournament #3769361908, $52.38+$2.62 USD Hold'em No Limit - Level XXIV (3000/6000) - 2024/06/26 23:19:56 UTC [2024/06/26 19:19:56 ET]
Table '3769361908 12' 6-max Seat #4 is the button
Seat 1: DR. ELDAR (49895 in chips) 
Seat 2: pj0901 (47608 in chips) 
Seat 3: assalbi (70082 in chips) 
Seat 4: vitor762 (111438 in chips) 
Seat 5: Scorgiej (69801 in chips) 
Seat 6: EqualizeSTAR (37108 in chips) 
DR. ELDAR: posts the ante 1500
pj0901: posts the ante 1500
assalbi: posts the ante 1500
vitor762: posts the ante 1500
Scorgiej: posts the ante 1500
EqualizeSTAR: posts the ante 1500
Scorgiej: posts small blind 3000
EqualizeSTAR: posts big blind 6000
*** HOLE CARDS ***
DR. ELDAR: raises 6600 to 12600
pj0901: folds 
assalbi: folds 
vitor762: folds 
Scorgiej: folds 
EqualizeSTAR: raises 23008 to 35608 and is all-in
DR. ELDAR: calls 23008
*** FLOP *** [6c Jd 5s]
*** TURN *** [6c Jd 5s] [Ks]
*** RIVER *** [6c Jd 5s Ks] [2h]
*** SHOW DOWN ***
EqualizeSTAR: shows [8c Ad] (high card Ace)
DR. ELDAR: shows [Jc Tc] (a pair of Jacks)
DR. ELDAR collected 83216 from pot
EqualizeSTAR finished the tournament in 32nd place and received $111.65.
*** SUMMARY ***
Total pot 83216 | Rake 0 
Board [6c Jd 5s Ks 2h]
Seat 1: DR. ELDAR showed [Jc Tc] and won (83216) with a pair of Jacks
Seat 2: pj0901 folded before Flop (didn't bet)
Seat 3: assalbi folded before Flop (didn't bet)
Seat 4: vitor762 (button) folded before Flop (didn't bet)
Seat 5: Scorgiej (small blind) folded before Flop
Seat 6: EqualizeSTAR (big blind) showed [8c Ad] and lost with high card Ace

PokerStars Hand #251210224391: Tournament #3769361908, $52.38+$2.62 USD Hold'em No Limit - Level XXV (3500/7000) - 2024/06/26 23:20:49 UTC [2024/06/26 19:20:49 ET]
Table '3769361908 12' 6-max Seat #5 is the button
Seat 1: DR. ELDAR (96003 in chips) 
Seat 2: pj0901 (46108 in chips) 
Seat 3: assalbi (68582 in chips) 
Seat 4: vitor762 (109938 in chips) 
Seat 5: Scorgiej (65301 in chips) 
DR. ELDAR: posts the ante 1750
pj0901: posts the ante 1750
assalbi: posts the ante 1750
vitor762: posts the ante 1750
Scorgiej: posts the ante 1750
DR. ELDAR: posts small blind 3500
pj0901: posts big blind 7000
*** HOLE CARDS ***
assalbi: folds 
vitor762: folds 
Scorgiej: folds 
DR. ELDAR: folds 
Uncalled bet (3500) returned to pj0901
pj0901 collected 15750 from pot
pj0901: doesn't show hand 
*** SUMMARY ***
Total pot 15750 | Rake 0 
Seat 1: DR. ELDAR (small blind) folded before Flop
Seat 2: pj0901 (big blind) collected (15750)
Seat 3: assalbi folded before Flop (didn't bet)
Seat 4: vitor762 folded before Flop (didn't bet)
Seat 5: Scorgiej (button) folded before Flop (didn't bet)

PokerStars Hand #251210228730: Tournament #3769361908, $52.38+$2.62 USD Hold'em No Limit - Level XXV (3500/7000) - 2024/06/26 23:21:10 UTC [2024/06/26 19:21:10 ET]
Table '3769361908 12' 6-max Seat #1 is the button
Seat 1: DR. ELDAR (90753 in chips) 
Seat 2: pj0901 (56608 in chips) 
Seat 3: assalbi (66832 in chips) 
Seat 4: vitor762 (108188 in chips) 
Seat 5: Scorgiej (63551 in chips) 
Seat 6: sinister778 (114122 in chips) 
DR. ELDAR: posts the ante 1750
pj0901: posts the ante 1750
assalbi: posts the ante 1750
vitor762: posts the ante 1750
Scorgiej: posts the ante 1750
sinister778: posts the ante 1750
pj0901: posts small blind 3500
assalbi: posts big blind 7000
*** HOLE CARDS ***
vitor762: folds 
Scorgiej: folds 
sinister778: raises 7000 to 14000
DR. ELDAR: folds 
pj0901: folds 
assalbi: folds 
Uncalled bet (7000) returned to sinister778
sinister778 collected 28000 from pot
*** SUMMARY ***
Total pot 28000 | Rake 0 
Seat 1: DR. ELDAR (button) folded before Flop (didn't bet)
Seat 2: pj0901 (small blind) folded before Flop
Seat 3: assalbi (big blind) folded before Flop
Seat 4: vitor762 folded before Flop (didn't bet)
Seat 5: Scorgiej folded before Flop (didn't bet)
Seat 6: sinister778 collected (28000)

PokerStars Hand #251210235643: Tournament #3769361908, $52.38+$2.62 USD Hold'em No Limit - Level XXV (3500/7000) - 2024/06/26 23:21:43 UTC [2024/06/26 19:21:43 ET]
Table '3769361908 12' 6-max Seat #2 is the button
Seat 1: DR. ELDAR (89003 in chips) 
Seat 2: pj0901 (51358 in chips) 
Seat 3: assalbi (58082 in chips) 
Seat 4: vitor762 (106438 in chips) 
Seat 5: Scorgiej (61801 in chips) 
Seat 6: sinister778 (133372 in chips) 
DR. ELDAR: posts the ante 1750
pj0901: posts the ante 1750
assalbi: posts the ante 1750
vitor762: posts the ante 1750
Scorgiej: posts the ante 1750
sinister778: posts the ante 1750
assalbi: posts small blind 3500
vitor762: posts big blind 7000
*** HOLE CARDS ***
Scorgiej: folds 
sinister778: folds 
DR. ELDAR: raises 80253 to 87253 and is all-in
pj0901: folds 
assalbi: folds 
vitor762: calls 80253
*** FLOP *** [Qd Tc Qh]
*** TURN *** [Qd Tc Qh] [6s]
*** RIVER *** [Qd Tc Qh 6s] [Ks]
*** SHOW DOWN ***
vitor762: shows [9s 9h] (two pair, Queens and Nines)
DR. ELDAR: shows [Kd 7c] (two pair, Kings and Queens)
DR. ELDAR collected 188506 from pot
*** SUMMARY ***
Total pot 188506 | Rake 0 
Board [Qd Tc Qh 6s Ks]
Seat 1: DR. ELDAR showed [Kd 7c] and won (188506) with two pair, Kings and Queens
Seat 2: pj0901 (button) folded before Flop (didn't bet)
Seat 3: assalbi (small blind) folded before Flop
Seat 4: vitor762 (big blind) showed [9s 9h] and lost with two pair, Queens and Nines
Seat 5: Scorgiej folded before Flop (didn't bet)
Seat 6: sinister778 folded before Flop (didn't bet)

PokerStars Hand #251210243687: Tournament #3769361908, $52.38+$2.62 USD Hold'em No Limit - Level XXV (3500/7000) - 2024/06/26 23:22:22 UTC [2024/06/26 19:22:22 ET]
Table '3769361908 12' 6-max Seat #3 is the button
Seat 1: DR. ELDAR (188506 in chips) 
Seat 2: pj0901 (49608 in chips) 
Seat 3: assalbi (52832 in chips) 
Seat 4: vitor762 (17435 in chips) 
Seat 5: Scorgiej (60051 in chips) 
DR. ELDAR: posts the ante 1750
pj0901: posts the ante 1750
assalbi: posts the ante 1750
vitor762: posts the ante 1750
Scorgiej: posts the ante 1750
vitor762: posts small blind 3500
Scorgiej: posts big blind 7000
*** HOLE CARDS ***
DR. ELDAR: folds 
pj0901: raises 35000 to 42000
assalbi: folds 
vitor762: folds 
Scorgiej: folds 
Uncalled bet (35000) returned to pj0901
pj0901 collected 26250 from pot
pj0901: doesn't show hand 
*** SUMMARY ***
Total pot 26250 | Rake 0 
Seat 1: DR. ELDAR folded before Flop (didn't bet)
Seat 2: pj0901 collected (26250)
Seat 3: assalbi (button) folded before Flop (didn't bet)
Seat 4: vitor762 (small blind) folded before Flop
Seat 5: Scorgiej (big blind) folded before Flop

PokerStars Hand #251210247972: Tournament #3769361908, $52.38+$2.62 USD Hold'em No Limit - Level XXV (3500/7000) - 2024/06/26 23:22:43 UTC [2024/06/26 19:22:43 ET]
Table '3769361908 12' 6-max Seat #4 is the button
Seat 1: DR. ELDAR (186756 in chips) 
Seat 2: pj0901 (67108 in chips) 
Seat 3: assalbi (51082 in chips) 
Seat 4: vitor762 (12185 in chips) 
Seat 5: Scorgiej (51301 in chips) 
DR. ELDAR: posts the ante 1750
pj0901: posts the ante 1750
assalbi: posts the ante 1750
vitor762: posts the ante 1750
Scorgiej: posts the ante 1750
Scorgiej: posts small blind 3500
DR. ELDAR: posts big blind 7000
*** HOLE CARDS ***
pj0901: folds 
assalbi: folds 
vitor762: folds 
Scorgiej: folds 
Uncalled bet (3500) returned to DR. ELDAR
DR. ELDAR collected 15750 from pot
DR. ELDAR: doesn't show hand 
*** SUMMARY ***
Total pot 15750 | Rake 0 
Seat 1: DR. ELDAR (big blind) collected (15750)
Seat 2: pj0901 folded before Flop (didn't bet)
Seat 3: assalbi folded before Flop (didn't bet)
Seat 4: vitor762 (button) folded before Flop (didn't bet)
Seat 5: Scorgiej (small blind) folded before Flop

PokerStars Hand #251210252890: Tournament #3769361908, $52.38+$2.62 USD Hold'em No Limit - Level XXV (3500/7000) - 2024/06/26 23:23:06 UTC [2024/06/26 19:23:06 ET]
Table '3769361908 12' 6-max Seat #5 is the button
Seat 1: DR. ELDAR (197256 in chips) 
Seat 2: pj0901 (65358 in chips) 
Seat 3: assalbi (49332 in chips) 
Seat 4: vitor762 (10435 in chips) 
Seat 5: Scorgiej (46051 in chips) 
DR. ELDAR: posts the ante 1750
pj0901: posts the ante 1750
assalbi: posts the ante 1750
vitor762: posts the ante 1750
Scorgiej: posts the ante 1750
DR. ELDAR: posts small blind 3500
pj0901: posts big blind 7000
*** HOLE CARDS ***
assalbi: raises 40582 to 47582 and is all-in
vitor762: folds 
Scorgiej: folds 
DR. ELDAR: folds 
pj0901: folds 
Uncalled bet (40582) returned to assalbi
assalbi collected 26250 from pot
assalbi: doesn't show hand 
*** SUMMARY ***
Total pot 26250 | Rake 0 
Seat 1: DR. ELDAR (small blind) folded before Flop
Seat 2: pj0901 (big blind) folded before Flop
Seat 3: assalbi collected (26250)
Seat 4: vitor762 folded before Flop (didn't bet)
Seat 5: Scorgiej (button) folded before Flop (didn't bet)

PokerStars Hand #251210258247: Tournament #3769361908, $52.38+$2.62 USD Hold'em No Limit - Level XXVI (4000/8000) - 2024/06/26 23:23:32 UTC [2024/06/26 19:23:32 ET]
Table '3769361908 12' 6-max Seat #1 is the button
Seat 1: DR. ELDAR (192006 in chips) 
Seat 2: pj0901 (56608 in chips) 
Seat 3: assalbi (66832 in chips) 
Seat 4: vitor762 (8685 in chips) 
Seat 5: Scorgiej (44301 in chips) 
DR. ELDAR: posts the ante 2000
pj0901: posts the ante 2000
assalbi: posts the ante 2000
vitor762: posts the ante 2000
Scorgiej: posts the ante 2000
pj0901: posts small blind 4000
assalbi: posts big blind 8000
*** HOLE CARDS ***
vitor762: calls 6685 and is all-in
Scorgiej: folds 
DR. ELDAR: folds 
pj0901: raises 44000 to 52000
assalbi: folds 
Uncalled bet (44000) returned to pj0901
*** FLOP *** [7s 4h Jc]
*** TURN *** [7s 4h Jc] [2s]
*** RIVER *** [7s 4h Jc 2s] [9h]
*** SHOW DOWN ***
pj0901: shows [Kc 6h] (high card King)
pj0901 collected 2630 from side pot
vitor762: shows [Qs Ac] (high card Ace)
vitor762 collected 30055 from main pot
*** SUMMARY ***
Total pot 32685 Main pot 30055. Side pot 2630. | Rake 0 
Board [7s 4h Jc 2s 9h]
Seat 1: DR. ELDAR (button) folded before Flop (didn't bet)
Seat 2: pj0901 (small blind) showed [Kc 6h] and won (2630) with high card King
Seat 3: assalbi (big blind) folded before Flop
Seat 4: vitor762 showed [Qs Ac] and won (30055) with high card Ace
Seat 5: Scorgiej folded before Flop (didn't bet)

PokerStars Hand #251210266461: Tournament #3769361908, $52.38+$2.62 USD Hold'em No Limit - Level XXVI (4000/8000) - 2024/06/26 23:24:12 UTC [2024/06/26 19:24:12 ET]
Table '3769361908 12' 6-max Seat #2 is the button
Seat 1: DR. ELDAR (190006 in chips) 
Seat 2: pj0901 (49238 in chips) 
Seat 3: assalbi (56832 in chips) 
Seat 4: vitor762 (30055 in chips) 
Seat 5: Scorgiej (42301 in chips) 
DR. ELDAR: posts the ante 2000
pj0901: posts the ante 2000
assalbi: posts the ante 2000
vitor762: posts the ante 2000
Scorgiej: posts the ante 2000
assalbi: posts small blind 4000
vitor762: posts big blind 8000
*** HOLE CARDS ***
Scorgiej: raises 32000 to 40000
DR. ELDAR: folds 
pj0901: folds 
assalbi: raises 14832 to 54832 and is all-in
vitor762: folds 
Scorgiej: calls 301 and is all-in
Uncalled bet (14531) returned to assalbi
*** FLOP *** [8d Qc 7s]
*** TURN *** [8d Qc 7s] [5h]
*** RIVER *** [8d Qc 7s 5h] [7c]
*** SHOW DOWN ***
assalbi: shows [Ac Ks] (a pair of Sevens)
Scorgiej: shows [7h 7d] (four of a kind, Sevens)
Scorgiej collected 98602 from pot
*** SUMMARY ***
Total pot 98602 | Rake 0 
Board [8d Qc 7s 5h 7c]
Seat 1: DR. ELDAR folded before Flop (didn't bet)
Seat 2: pj0901 (button) folded before Flop (didn't bet)
Seat 3: assalbi (small blind) showed [Ac Ks] and lost with a pair of Sevens
Seat 4: vitor762 (big blind) folded before Flop
Seat 5: Scorgiej showed [7h 7d] and won (98602) with four of a kind, Sevens

PokerStars Hand #251210277132: Tournament #3769361908, $52.38+$2.62 USD Hold'em No Limit - Level XXVI (4000/8000) - 2024/06/26 23:25:04 UTC [2024/06/26 19:25:04 ET]
Table '3769361908 12' 6-max Seat #3 is the button
Seat 1: DR. ELDAR (188006 in chips) 
Seat 2: pj0901 (47238 in chips) 
Seat 3: assalbi (14531 in chips) 
Seat 4: vitor762 (20055 in chips) 
Seat 5: Scorgiej (98602 in chips) 
DR. ELDAR: posts the ante 2000
pj0901: posts the ante 2000
assalbi: posts the ante 2000
vitor762: posts the ante 2000
Scorgiej: posts the ante 2000
vitor762: posts small blind 4000
Scorgiej: posts big blind 8000
*** HOLE CARDS ***
DR. ELDAR: folds 
pj0901: folds 
assalbi: raises 4531 to 12531 and is all-in
vitor762: folds 
Scorgiej: calls 4531
*** FLOP *** [8h 6c 3h]
*** TURN *** [8h 6c 3h] [As]
*** RIVER *** [8h 6c 3h As] [Kc]
*** SHOW DOWN ***
Scorgiej: shows [Ah 9c] (a pair of Aces)
assalbi: shows [7h Jd] (high card Ace)
Scorgiej collected 39062 from pot
assalbi finished the tournament in 27th place and received $135.63.
*** SUMMARY ***
Total pot 39062 | Rake 0 
Board [8h 6c 3h As Kc]
Seat 1: DR. ELDAR folded before Flop (didn't bet)
Seat 2: pj0901 folded before Flop (didn't bet)
Seat 3: assalbi (button) showed [7h Jd] and lost with high card Ace
Seat 4: vitor762 (small blind) folded before Flop
Seat 5: Scorgiej (big blind) showed [Ah 9c] and won (39062) with a pair of Aces

PokerStars Hand #251210283587: Tournament #3769361908, $52.38+$2.62 USD Hold'em No Limit - Level XXVI (4000/8000) - 2024/06/26 23:25:35 UTC [2024/06/26 19:25:35 ET]
Table '3769361908 12' 6-max Seat #4 is the button
Seat 1: DR. ELDAR (186006 in chips) 
Seat 2: pj0901 (45238 in chips) 
Seat 4: vitor762 (14055 in chips) 
Seat 5: Scorgiej (123133 in chips) 
DR. ELDAR: posts the ante 2000
pj0901: posts the ante 2000
vitor762: posts the ante 2000
Scorgiej: posts the ante 2000
Scorgiej: posts small blind 4000
DR. ELDAR: posts big blind 8000
*** HOLE CARDS ***
pj0901: folds 
vitor762: raises 4055 to 12055 and is all-in
chrichrac is disconnected 
Scorgiej: calls 8055
DR. ELDAR: calls 4055
*** FLOP *** [8h 2h 7h]
Scorgiej: checks 
DR. ELDAR: checks 
*** TURN *** [8h 2h 7h] [8d]
Scorgiej: checks 
DR. ELDAR: checks 
*** RIVER *** [8h 2h 7h 8d] [2d]
Scorgiej: checks 
DR. ELDAR: checks 
*** SHOW DOWN ***
Scorgiej: shows [Jh 9d] (two pair, Eights and Deuces)
DR. ELDAR: shows [Js Td] (two pair, Eights and Deuces)
vitor762: shows [Ks 8c] (a full house, Eights full of Deuces)
vitor762 collected 44165 from pot
*** SUMMARY ***
Total pot 44165 | Rake 0 
Board [8h 2h 7h 8d 2d]
Seat 1: DR. ELDAR (big blind) showed [Js Td] and lost with two pair, Eights and Deuces
Seat 2: pj0901 folded before Flop (didn't bet)
Seat 4: vitor762 (button) showed [Ks 8c] and won (44165) with a full house, Eights full of Deuces
Seat 5: Scorgiej (small blind) showed [Jh 9d] and lost with two pair, Eights and Deuces

PokerStars Hand #251210290969: Tournament #3769361908, $52.38+$2.62 USD Hold'em No Limit - Level XXVI (4000/8000) - 2024/06/26 23:26:12 UTC [2024/06/26 19:26:12 ET]
Table '3769361908 12' 6-max Seat #5 is the button
Seat 1: DR. ELDAR (171951 in chips) 
Seat 2: pj0901 (43238 in chips) 
Seat 3: chrichrac (83486 in chips) 
Seat 4: vitor762 (44165 in chips) 
Seat 5: Scorgiej (109078 in chips) 
DR. ELDAR: posts the ante 2000
pj0901: posts the ante 2000
chrichrac: posts the ante 2000
vitor762: posts the ante 2000
Scorgiej: posts the ante 2000
DR. ELDAR: posts small blind 4000
pj0901: posts big blind 8000
*** HOLE CARDS ***
chrichrac: folds 
vitor762: folds 
Scorgiej: folds 
DR. ELDAR: folds 
Uncalled bet (4000) returned to pj0901
pj0901 collected 18000 from pot
pj0901: doesn't show hand 
*** SUMMARY ***
Total pot 18000 | Rake 0 
Seat 1: DR. ELDAR (small blind) folded before Flop
Seat 2: pj0901 (big blind) collected (18000)
Seat 3: chrichrac folded before Flop (didn't bet)
Seat 4: vitor762 folded before Flop (didn't bet)
Seat 5: Scorgiej (button) folded before Flop (didn't bet)

PokerStars Hand #251210295720: Tournament #3769361908, $52.38+$2.62 USD Hold'em No Limit - Level XXVII (4500/9000) - 2024/06/26 23:26:35 UTC [2024/06/26 19:26:35 ET]
Table '3769361908 12' 6-max Seat #1 is the button
Seat 1: DR. ELDAR (165951 in chips) 
Seat 2: pj0901 (55238 in chips) 
Seat 3: chrichrac (81486 in chips) 
Seat 4: vitor762 (42165 in chips) 
Seat 5: Scorgiej (107078 in chips) 
DR. ELDAR: posts the ante 2250
pj0901: posts the ante 2250
chrichrac: posts the ante 2250
vitor762: posts the ante 2250
Scorgiej: posts the ante 2250
pj0901: posts small blind 4500
chrichrac: posts big blind 9000
*** HOLE CARDS ***
vitor762: raises 30915 to 39915 and is all-in
Scorgiej: folds 
DR. ELDAR: folds 
pj0901: folds 
chrichrac: folds 
Uncalled bet (30915) returned to vitor762
vitor762 collected 33750 from pot
vitor762: doesn't show hand 
*** SUMMARY ***
Total pot 33750 | Rake 0 
Seat 1: DR. ELDAR (button) folded before Flop (didn't bet)
Seat 2: pj0901 (small blind) folded before Flop
Seat 3: chrichrac (big blind) folded before Flop
Seat 4: vitor762 collected (33750)
Seat 5: Scorgiej folded before Flop (didn't bet)

PokerStars Hand #251210304273: Tournament #3769361908, $52.38+$2.62 USD Hold'em No Limit - Level XXVII (4500/9000) - 2024/06/26 23:27:18 UTC [2024/06/26 19:27:18 ET]
Table '3769361908 12' 6-max Seat #2 is the button
Seat 1: DR. ELDAR (163701 in chips) 
Seat 2: pj0901 (48488 in chips) 
Seat 3: chrichrac (70236 in chips) 
Seat 4: vitor762 (64665 in chips) 
Seat 5: Scorgiej (104828 in chips) 
DR. ELDAR: posts the ante 2250
pj0901: posts the ante 2250
chrichrac: posts the ante 2250
vitor762: posts the ante 2250
Scorgiej: posts the ante 2250
chrichrac: posts small blind 4500
vitor762: posts big blind 9000
*** HOLE CARDS ***
Scorgiej: folds 
DR. ELDAR: raises 152451 to 161451 and is all-in
pj0901: folds 
chrichrac: folds 
vitor762: calls 53415 and is all-in
Uncalled bet (99036) returned to DR. ELDAR
*** FLOP *** [8s 7d 9h]
*** TURN *** [8s 7d 9h] [3d]
*** RIVER *** [8s 7d 9h 3d] [Jc]
*** SHOW DOWN ***
vitor762: shows [Jd Ks] (a pair of Jacks)
DR. ELDAR: shows [Qd Ac] (high card Ace)
vitor762 collected 140580 from pot
*** SUMMARY ***
Total pot 140580 | Rake 0 
Board [8s 7d 9h 3d Jc]
Seat 1: DR. ELDAR showed [Qd Ac] and lost with high card Ace
Seat 2: pj0901 (button) folded before Flop (didn't bet)
Seat 3: chrichrac (small blind) folded before Flop
Seat 4: vitor762 (big blind) showed [Jd Ks] and won (140580) with a pair of Jacks
Seat 5: Scorgiej folded before Flop (didn't bet)

PokerStars Hand #251210316212: Tournament #3769361908, $52.38+$2.62 USD Hold'em No Limit - Level XXVII (4500/9000) - 2024/06/26 23:28:17 UTC [2024/06/26 19:28:17 ET]
Table '3769361908 12' 6-max Seat #3 is the button
Seat 1: DR. ELDAR (99036 in chips) 
Seat 2: pj0901 (46238 in chips) 
Seat 3: chrichrac (63486 in chips) 
Seat 4: vitor762 (140580 in chips) 
Seat 5: Scorgiej (102578 in chips) 
Seat 6: mila is best (110124 in chips) 
DR. ELDAR: posts the ante 2250
pj0901: posts the ante 2250
chrichrac: posts the ante 2250
vitor762: posts the ante 2250
Scorgiej: posts the ante 2250
mila is best: posts the ante 2250
vitor762: posts small blind 4500
Scorgiej: posts big blind 9000
*** HOLE CARDS ***
mila is best: folds 
DR. ELDAR: folds 
pj0901: raises 31500 to 40500
chrichrac has timed out
chrichrac: folds 
chrichrac is sitting out
chrichrac has returned
vitor762: folds 
Scorgiej: folds 
Uncalled bet (31500) returned to pj0901
pj0901 collected 36000 from pot
pj0901: doesn't show hand 
*** SUMMARY ***
Total pot 36000 | Rake 0 
Seat 1: DR. ELDAR folded before Flop (didn't bet)
Seat 2: pj0901 collected (36000)
Seat 3: chrichrac (button) folded before Flop (didn't bet)
Seat 4: vitor762 (small blind) folded before Flop
Seat 5: Scorgiej (big blind) folded before Flop
Seat 6: mila is best folded before Flop (didn't bet)

PokerStars Hand #251210325067: Tournament #3769361908, $52.38+$2.62 USD Hold'em No Limit - Level XXVII (4500/9000) - 2024/06/26 23:29:01 UTC [2024/06/26 19:29:01 ET]
Table '3769361908 12' 6-max Seat #4 is the button
Seat 1: DR. ELDAR (96786 in chips) 
Seat 2: pj0901 (70988 in chips) 
Seat 3: chrichrac (61236 in chips) 
Seat 4: vitor762 (133830 in chips) 
Seat 5: Scorgiej (91328 in chips) 
Seat 6: mila is best (107874 in chips) 
DR. ELDAR: posts the ante 2250
pj0901: posts the ante 2250
chrichrac: posts the ante 2250
vitor762: posts the ante 2250
Scorgiej: posts the ante 2250
mila is best: posts the ante 2250
Scorgiej: posts small blind 4500
mila is best: posts big blind 9000
*** HOLE CARDS ***
DR. ELDAR: raises 19800 to 28800
pj0901: folds 
chrichrac: folds 
vitor762: folds 
Scorgiej: raises 60278 to 89078 and is all-in
mila is best: folds 
DR. ELDAR: calls 60278
*** FLOP *** [2c Jd 5d]
*** TURN *** [2c Jd 5d] [Qd]
*** RIVER *** [2c Jd 5d Qd] [7c]
*** SHOW DOWN ***
Scorgiej: shows [Ks Kc] (a pair of Kings)
DR. ELDAR: shows [Qh Jc] (two pair, Queens and Jacks)
DR. ELDAR collected 200656 from pot
Scorgiej finished the tournament in 22nd place and received $164.76.
*** SUMMARY ***
Total pot 200656 | Rake 0 
Board [2c Jd 5d Qd 7c]
Seat 1: DR. ELDAR showed [Qh Jc] and won (200656) with two pair, Queens and Jacks
Seat 2: pj0901 folded before Flop (didn't bet)
Seat 3: chrichrac folded before Flop (didn't bet)
Seat 4: vitor762 (button) folded before Flop (didn't bet)
Seat 5: Scorgiej (small blind) showed [Ks Kc] and lost with a pair of Kings
Seat 6: mila is best (big blind) folded before Flop

PokerStars Hand #251210336153: Tournament #3769361908, $52.38+$2.62 USD Hold'em No Limit - Level XXVIII (5000/10000) - 2024/06/26 23:29:57 UTC [2024/06/26 19:29:57 ET]
Table '3769361908 12' 6-max Seat #6 is the button
Seat 1: DR. ELDAR (206114 in chips) 
Seat 2: pj0901 (68738 in chips) 
Seat 3: chrichrac (58986 in chips) 
Seat 4: vitor762 (131580 in chips) 
Seat 6: mila is best (96624 in chips) 
DR. ELDAR: posts the ante 2500
pj0901: posts the ante 2500
chrichrac: posts the ante 2500
vitor762: posts the ante 2500
mila is best: posts the ante 2500
DR. ELDAR: posts small blind 5000
pj0901: posts big blind 10000
*** HOLE CARDS ***
chrichrac: raises 46486 to 56486 and is all-in
vitor762: folds 
mila is best: raises 37638 to 94124 and is all-in
DR. ELDAR: folds 
pj0901: folds 
Uncalled bet (37638) returned to mila is best
*** FLOP *** [3s 8s Js]
*** TURN *** [3s 8s Js] [9c]
*** RIVER *** [3s 8s Js 9c] [Qs]
*** SHOW DOWN ***
chrichrac: shows [Kc Th] (a straight, Nine to King)
mila is best: shows [Qc Ac] (a pair of Queens)
chrichrac collected 140472 from pot
*** SUMMARY ***
Total pot 140472 | Rake 0 
Board [3s 8s Js 9c Qs]
Seat 1: DR. ELDAR (small blind) folded before Flop
Seat 2: pj0901 (big blind) folded before Flop
Seat 3: chrichrac showed [Kc Th] and won (140472) with a straight, Nine to King
Seat 4: vitor762 folded before Flop (didn't bet)
Seat 6: mila is best (button) showed [Qc Ac] and lost with a pair of Queens

PokerStars Hand #251210344950: Tournament #3769361908, $52.38+$2.62 USD Hold'em No Limit - Level XXVIII (5000/10000) - 2024/06/26 23:30:41 UTC [2024/06/26 19:30:41 ET]
Table '3769361908 12' 6-max Seat #1 is the button
Seat 1: DR. ELDAR (198614 in chips) 
Seat 2: pj0901 (56238 in chips) 
Seat 3: chrichrac (140472 in chips) 
Seat 4: vitor762 (129080 in chips) 
Seat 6: mila is best (37638 in chips) 
DR. ELDAR: posts the ante 2500
pj0901: posts the ante 2500
chrichrac: posts the ante 2500
vitor762: posts the ante 2500
mila is best: posts the ante 2500
pj0901: posts small blind 5000
chrichrac: posts big blind 10000
*** HOLE CARDS ***
vitor762: folds 
mila is best: folds 
DR. ELDAR: folds 
pj0901: folds 
Uncalled bet (5000) returned to chrichrac
chrichrac collected 22500 from pot
chrichrac: doesn't show hand 
*** SUMMARY ***
Total pot 22500 | Rake 0 
Seat 1: DR. ELDAR (button) folded before Flop (didn't bet)
Seat 2: pj0901 (small blind) folded before Flop
Seat 3: chrichrac (big blind) collected (22500)
Seat 4: vitor762 folded before Flop (didn't bet)
Seat 6: mila is best folded before Flop (didn't bet)

PokerStars Hand #251210350900: Tournament #3769361908, $52.38+$2.62 USD Hold'em No Limit - Level XXVIII (5000/10000) - 2024/06/26 23:31:10 UTC [2024/06/26 19:31:10 ET]
Table '3769361908 12' 6-max Seat #2 is the button
Seat 1: DR. ELDAR (196114 in chips) 
Seat 2: pj0901 (48738 in chips) 
Seat 3: chrichrac (155472 in chips) 
Seat 4: vitor762 (126580 in chips) 
Seat 6: mila is best (35138 in chips) 
DR. ELDAR: posts the ante 2500
pj0901: posts the ante 2500
chrichrac: posts the ante 2500
vitor762: posts the ante 2500
mila is best: posts the ante 2500
chrichrac: posts small blind 5000
vitor762: posts big blind 10000
*** HOLE CARDS ***
mila is best: folds 
DR. ELDAR: folds 
pj0901: raises 35000 to 45000
chrichrac: raises 107972 to 152972 and is all-in
vitor762: folds 
pj0901: calls 1238 and is all-in
Uncalled bet (106734) returned to chrichrac
*** FLOP *** [8c 2c 9c]
*** TURN *** [8c 2c 9c] [7s]
*** RIVER *** [8c 2c 9c 7s] [6s]
*** SHOW DOWN ***
chrichrac: shows [9s 9d] (three of a kind, Nines)
pj0901: shows [Qc Jd] (high card Queen)
chrichrac collected 114976 from pot
pj0901 finished the tournament in 19th place and received $164.76.
*** SUMMARY ***
Total pot 114976 | Rake 0 
Board [8c 2c 9c 7s 6s]
Seat 1: DR. ELDAR folded before Flop (didn't bet)
Seat 2: pj0901 (button) showed [Qc Jd] and lost with high card Queen
Seat 3: chrichrac (small blind) showed [9s 9d] and won (114976) with three of a kind, Nines
Seat 4: vitor762 (big blind) folded before Flop
Seat 6: mila is best folded before Flop (didn't bet)


PokerStars Hand #251209481455: Tournament #3769361908, $52.38+$2.62 USD Hold'em No Limit - Level IX (150/300) - 2024/06/26 22:28:23 UTC [2024/06/26 18:28:23 ET]
Table '3769361908 11' 6-max Seat #5 is the button
Seat 1: Spectral34 (8849 in chips) 
Seat 2: TRAVISROYAL (7415 in chips) 
Seat 3: lucasrojo (10960 in chips) 
Seat 4: UruRey (16633 in chips) 
Seat 5: Pkrscott1992 (2169 in chips) 
Seat 6: lulira10 (14732 in chips) 
Spectral34: posts the ante 75
TRAVISROYAL: posts the ante 75
lucasrojo: posts the ante 75
UruRey: posts the ante 75
Pkrscott1992: posts the ante 75
lulira10: posts the ante 75
lulira10: posts small blind 150
Spectral34: posts big blind 300
*** HOLE CARDS ***
TRAVISROYAL: raises 600 to 900
lucasrojo: folds 
UruRey: raises 2400 to 3300
Pkrscott1992: folds 
lulira10: folds 
Spectral34: folds 
TRAVISROYAL: calls 2400
*** FLOP *** [Qs 9s 8h]
TRAVISROYAL: bets 4040 and is all-in
UruRey: calls 4040
*** TURN *** [Qs 9s 8h] [6h]
*** RIVER *** [Qs 9s 8h 6h] [7d]
*** SHOW DOWN ***
TRAVISROYAL: shows [Qh Kh] (a pair of Queens)
UruRey: shows [Jd Jh] (a pair of Jacks)
TRAVISROYAL collected 15580 from pot
*** SUMMARY ***
Total pot 15580 | Rake 0 
Board [Qs 9s 8h 6h 7d]
Seat 1: Spectral34 (big blind) folded before Flop
Seat 2: TRAVISROYAL showed [Qh Kh] and won (15580) with a pair of Queens
Seat 3: lucasrojo folded before Flop (didn't bet)
Seat 4: UruRey showed [Jd Jh] and lost with a pair of Jacks
Seat 5: Pkrscott1992 (button) folded before Flop (didn't bet)
Seat 6: lulira10 (small blind) folded before Flop

PokerStars Hand #251209492342: Tournament #3769361908, $52.38+$2.62 USD Hold'em No Limit - Level IX (150/300) - 2024/06/26 22:29:02 UTC [2024/06/26 18:29:02 ET]
Table '3769361908 11' 6-max Seat #6 is the button
Seat 1: Spectral34 (8474 in chips) 
Seat 2: TRAVISROYAL (15580 in chips) 
Seat 3: lucasrojo (10885 in chips) 
Seat 4: UruRey (9218 in chips) 
Seat 5: Pkrscott1992 (2094 in chips) 
Seat 6: lulira10 (14507 in chips) 
Spectral34: posts the ante 75
TRAVISROYAL: posts the ante 75
lucasrojo: posts the ante 75
UruRey: posts the ante 75
Pkrscott1992: posts the ante 75
lulira10: posts the ante 75
Spectral34: posts small blind 150
TRAVISROYAL: posts big blind 300
*** HOLE CARDS ***
lucasrojo: folds 
UruRey: folds 
Pkrscott1992: folds 
lulira10: folds 
Spectral34: calls 150
TRAVISROYAL: checks 
*** FLOP *** [2h Kc 3s]
Spectral34: bets 300
TRAVISROYAL: calls 300
*** TURN *** [2h Kc 3s] [Qd]
Spectral34: bets 1200
TRAVISROYAL: calls 1200
*** RIVER *** [2h Kc 3s Qd] [4h]
Spectral34: checks 
TRAVISROYAL: bets 1800
Spectral34: folds 
Uncalled bet (1800) returned to TRAVISROYAL
TRAVISROYAL collected 4050 from pot
*** SUMMARY ***
Total pot 4050 | Rake 0 
Board [2h Kc 3s Qd 4h]
Seat 1: Spectral34 (small blind) folded on the River
Seat 2: TRAVISROYAL (big blind) collected (4050)
Seat 3: lucasrojo folded before Flop (didn't bet)
Seat 4: UruRey folded before Flop (didn't bet)
Seat 5: Pkrscott1992 folded before Flop (didn't bet)
Seat 6: lulira10 (button) folded before Flop (didn't bet)

PokerStars Hand #251209515082: Tournament #3769361908, $52.38+$2.62 USD Hold'em No Limit - Level X (200/400) - 2024/06/26 22:30:24 UTC [2024/06/26 18:30:24 ET]
Table '3769361908 11' 6-max Seat #1 is the button
Seat 1: Spectral34 (6599 in chips) 
Seat 2: TRAVISROYAL (17755 in chips) 
Seat 3: lucasrojo (10810 in chips) 
Seat 4: UruRey (9143 in chips) 
Seat 5: Pkrscott1992 (2019 in chips) 
Seat 6: lulira10 (14432 in chips) 
Spectral34: posts the ante 100
TRAVISROYAL: posts the ante 100
lucasrojo: posts the ante 100
UruRey: posts the ante 100
Pkrscott1992: posts the ante 100
lulira10: posts the ante 100
TRAVISROYAL: posts small blind 200
lucasrojo: posts big blind 400
*** HOLE CARDS ***
UruRey: folds 
Pkrscott1992: raises 1519 to 1919 and is all-in
lulira10: folds 
Spectral34: raises 4580 to 6499 and is all-in
TRAVISROYAL: folds 
lucasrojo: folds 
Uncalled bet (4580) returned to Spectral34
*** FLOP *** [7d 9d 9h]
*** TURN *** [7d 9d 9h] [As]
*** RIVER *** [7d 9d 9h As] [9c]
*** SHOW DOWN ***
Pkrscott1992: shows [Qh 9s] (four of a kind, Nines)
Spectral34: shows [Td Ad] (a full house, Nines full of Aces)
Pkrscott1992 collected 5038 from pot
*** SUMMARY ***
Total pot 5038 | Rake 0 
Board [7d 9d 9h As 9c]
Seat 1: Spectral34 (button) showed [Td Ad] and lost with a full house, Nines full of Aces
Seat 2: TRAVISROYAL (small blind) folded before Flop
Seat 3: lucasrojo (big blind) folded before Flop
Seat 4: UruRey folded before Flop (didn't bet)
Seat 5: Pkrscott1992 showed [Qh 9s] and won (5038) with four of a kind, Nines
Seat 6: lulira10 folded before Flop (didn't bet)

PokerStars Hand #251209522199: Tournament #3769361908, $52.38+$2.62 USD Hold'em No Limit - Level X (200/400) - 2024/06/26 22:30:50 UTC [2024/06/26 18:30:50 ET]
Table '3769361908 11' 6-max Seat #2 is the button
Seat 1: Spectral34 (4580 in chips) 
Seat 2: TRAVISROYAL (17455 in chips) 
Seat 3: lucasrojo (10310 in chips) 
Seat 4: UruRey (9043 in chips) 
Seat 5: Pkrscott1992 (5038 in chips) 
Seat 6: lulira10 (14332 in chips) 
Spectral34: posts the ante 100
TRAVISROYAL: posts the ante 100
lucasrojo: posts the ante 100
UruRey: posts the ante 100
Pkrscott1992: posts the ante 100
lulira10: posts the ante 100
lucasrojo: posts small blind 200
UruRey: posts big blind 400
*** HOLE CARDS ***
Pkrscott1992: folds 
lulira10: raises 400 to 800
Spectral34: folds 
TRAVISROYAL: calls 800
lucasrojo: folds 
UruRey: calls 400
*** FLOP *** [3c 7h Qh]
UruRey: checks 
lulira10: bets 1600
TRAVISROYAL: folds 
UruRey: folds 
Uncalled bet (1600) returned to lulira10
lulira10 collected 3200 from pot
lulira10: doesn't show hand 
*** SUMMARY ***
Total pot 3200 | Rake 0 
Board [3c 7h Qh]
Seat 1: Spectral34 folded before Flop (didn't bet)
Seat 2: TRAVISROYAL (button) folded on the Flop
Seat 3: lucasrojo (small blind) folded before Flop
Seat 4: UruRey (big blind) folded on the Flop
Seat 5: Pkrscott1992 folded before Flop (didn't bet)
Seat 6: lulira10 collected (3200)

PokerStars Hand #251209534179: Tournament #3769361908, $52.38+$2.62 USD Hold'em No Limit - Level X (200/400) - 2024/06/26 22:31:34 UTC [2024/06/26 18:31:34 ET]
Table '3769361908 11' 6-max Seat #3 is the button
Seat 1: Spectral34 (4480 in chips) 
Seat 2: TRAVISROYAL (16555 in chips) 
Seat 3: lucasrojo (10010 in chips) 
Seat 4: UruRey (8143 in chips) 
Seat 5: Pkrscott1992 (4938 in chips) 
Seat 6: lulira10 (16632 in chips) 
Spectral34: posts the ante 100
TRAVISROYAL: posts the ante 100
lucasrojo: posts the ante 100
UruRey: posts the ante 100
Pkrscott1992: posts the ante 100
lulira10: posts the ante 100
UruRey: posts small blind 200
Pkrscott1992: posts big blind 400
*** HOLE CARDS ***
lulira10: folds 
Spectral34: folds 
TRAVISROYAL: calls 400
lucasrojo: folds 
UruRey: folds 
Pkrscott1992: checks 
*** FLOP *** [Ks 3d 8d]
Pkrscott1992: checks 
TRAVISROYAL: checks 
*** TURN *** [Ks 3d 8d] [Ts]
Pkrscott1992: bets 4438 and is all-in
TRAVISROYAL: folds 
Uncalled bet (4438) returned to Pkrscott1992
Pkrscott1992 collected 1600 from pot
Pkrscott1992: doesn't show hand 
*** SUMMARY ***
Total pot 1600 | Rake 0 
Board [Ks 3d 8d Ts]
Seat 1: Spectral34 folded before Flop (didn't bet)
Seat 2: TRAVISROYAL folded on the Turn
Seat 3: lucasrojo (button) folded before Flop (didn't bet)
Seat 4: UruRey (small blind) folded before Flop
Seat 5: Pkrscott1992 (big blind) collected (1600)
Seat 6: lulira10 folded before Flop (didn't bet)

PokerStars Hand #251209545923: Tournament #3769361908, $52.38+$2.62 USD Hold'em No Limit - Level XI (250/500) - 2024/06/26 22:32:16 UTC [2024/06/26 18:32:16 ET]
Table '3769361908 11' 6-max Seat #4 is the button
Seat 1: Spectral34 (4380 in chips) 
Seat 2: TRAVISROYAL (16055 in chips) 
Seat 3: lucasrojo (9910 in chips) 
Seat 4: UruRey (7843 in chips) 
Seat 5: Pkrscott1992 (6038 in chips) 
Seat 6: lulira10 (16532 in chips) 
Spectral34: posts the ante 125
TRAVISROYAL: posts the ante 125
lucasrojo: posts the ante 125
UruRey: posts the ante 125
Pkrscott1992: posts the ante 125
lulira10: posts the ante 125
Pkrscott1992: posts small blind 250
lulira10: posts big blind 500
*** HOLE CARDS ***
Spectral34: folds 
TRAVISROYAL: raises 500 to 1000
lucasrojo: folds 
UruRey: folds 
Pkrscott1992: folds 
lulira10: folds 
Uncalled bet (500) returned to TRAVISROYAL
TRAVISROYAL collected 2000 from pot
*** SUMMARY ***
Total pot 2000 | Rake 0 
Seat 1: Spectral34 folded before Flop (didn't bet)
Seat 2: TRAVISROYAL collected (2000)
Seat 3: lucasrojo folded before Flop (didn't bet)
Seat 4: UruRey (button) folded before Flop (didn't bet)
Seat 5: Pkrscott1992 (small blind) folded before Flop
Seat 6: lulira10 (big blind) folded before Flop

PokerStars Hand #251209554767: Tournament #3769361908, $52.38+$2.62 USD Hold'em No Limit - Level XI (250/500) - 2024/06/26 22:32:49 UTC [2024/06/26 18:32:49 ET]
Table '3769361908 11' 6-max Seat #5 is the button
Seat 1: Spectral34 (4255 in chips) 
Seat 2: TRAVISROYAL (17430 in chips) 
Seat 3: lucasrojo (9785 in chips) 
Seat 4: UruRey (7718 in chips) 
Seat 5: Pkrscott1992 (5663 in chips) 
Seat 6: lulira10 (15907 in chips) 
Spectral34: posts the ante 125
TRAVISROYAL: posts the ante 125
lucasrojo: posts the ante 125
UruRey: posts the ante 125
Pkrscott1992: posts the ante 125
lulira10: posts the ante 125
lulira10: posts small blind 250
Spectral34: posts big blind 500
*** HOLE CARDS ***
TRAVISROYAL: raises 500 to 1000
lucasrojo: folds 
UruRey: raises 6593 to 7593 and is all-in
Pkrscott1992: folds 
lulira10: folds 
Spectral34: folds 
TRAVISROYAL: folds 
Uncalled bet (6593) returned to UruRey
UruRey collected 3500 from pot
UruRey: doesn't show hand 
*** SUMMARY ***
Total pot 3500 | Rake 0 
Seat 1: Spectral34 (big blind) folded before Flop
Seat 2: TRAVISROYAL folded before Flop
Seat 3: lucasrojo folded before Flop (didn't bet)
Seat 4: UruRey collected (3500)
Seat 5: Pkrscott1992 (button) folded before Flop (didn't bet)
Seat 6: lulira10 (small blind) folded before Flop

PokerStars Hand #251209563463: Tournament #3769361908, $52.38+$2.62 USD Hold'em No Limit - Level XI (250/500) - 2024/06/26 22:33:21 UTC [2024/06/26 18:33:21 ET]
Table '3769361908 11' 6-max Seat #6 is the button
Seat 1: Spectral34 (3630 in chips) 
Seat 2: TRAVISROYAL (16305 in chips) 
Seat 3: lucasrojo (9660 in chips) 
Seat 4: UruRey (10093 in chips) 
Seat 5: Pkrscott1992 (5538 in chips) 
Seat 6: lulira10 (15532 in chips) 
Spectral34: posts the ante 125
TRAVISROYAL: posts the ante 125
lucasrojo: posts the ante 125
UruRey: posts the ante 125
Pkrscott1992: posts the ante 125
lulira10: posts the ante 125
Spectral34: posts small blind 250
TRAVISROYAL: posts big blind 500
*** HOLE CARDS ***
lucasrojo: folds 
UruRey: folds 
Pkrscott1992: folds 
lulira10: folds 
Spectral34: raises 3005 to 3505 and is all-in
TRAVISROYAL: folds 
Uncalled bet (3005) returned to Spectral34
Spectral34 collected 1750 from pot
Spectral34: doesn't show hand 
*** SUMMARY ***
Total pot 1750 | Rake 0 
Seat 1: Spectral34 (small blind) collected (1750)
Seat 2: TRAVISROYAL (big blind) folded before Flop
Seat 3: lucasrojo folded before Flop (didn't bet)
Seat 4: UruRey folded before Flop (didn't bet)
Seat 5: Pkrscott1992 folded before Flop (didn't bet)
Seat 6: lulira10 (button) folded before Flop (didn't bet)

PokerStars Hand #251209569239: Tournament #3769361908, $52.38+$2.62 USD Hold'em No Limit - Level XI (250/500) - 2024/06/26 22:33:43 UTC [2024/06/26 18:33:43 ET]
Table '3769361908 11' 6-max Seat #1 is the button
Seat 1: Spectral34 (4755 in chips) 
Seat 2: TRAVISROYAL (15680 in chips) 
Seat 3: lucasrojo (9535 in chips) 
Seat 4: UruRey (9968 in chips) 
Seat 5: Pkrscott1992 (5413 in chips) 
Seat 6: lulira10 (15407 in chips) 
Spectral34: posts the ante 125
TRAVISROYAL: posts the ante 125
lucasrojo: posts the ante 125
UruRey: posts the ante 125
Pkrscott1992: posts the ante 125
lulira10: posts the ante 125
TRAVISROYAL: posts small blind 250
lucasrojo: posts big blind 500
*** HOLE CARDS ***
UruRey: folds 
Pkrscott1992: folds 
lulira10: folds 
Spectral34: raises 500 to 1000
TRAVISROYAL: folds 
lucasrojo: calls 500
*** FLOP *** [Ad Qh Kd]
lucasrojo: checks 
Spectral34: bets 500
lucasrojo: folds 
Uncalled bet (500) returned to Spectral34
Spectral34 collected 3000 from pot
Spectral34: doesn't show hand 
*** SUMMARY ***
Total pot 3000 | Rake 0 
Board [Ad Qh Kd]
Seat 1: Spectral34 (button) collected (3000)
Seat 2: TRAVISROYAL (small blind) folded before Flop
Seat 3: lucasrojo (big blind) folded on the Flop
Seat 4: UruRey folded before Flop (didn't bet)
Seat 5: Pkrscott1992 folded before Flop (didn't bet)
Seat 6: lulira10 folded before Flop (didn't bet)

PokerStars Hand #251209579816: Tournament #3769361908, $52.38+$2.62 USD Hold'em No Limit - Level XI (250/500) - 2024/06/26 22:34:22 UTC [2024/06/26 18:34:22 ET]
Table '3769361908 11' 6-max Seat #2 is the button
Seat 1: Spectral34 (6630 in chips) 
Seat 2: TRAVISROYAL (15305 in chips) 
Seat 3: lucasrojo (8410 in chips) 
Seat 4: UruRey (9843 in chips) 
Seat 5: Pkrscott1992 (5288 in chips) 
Seat 6: lulira10 (15282 in chips) 
Spectral34: posts the ante 125
TRAVISROYAL: posts the ante 125
lucasrojo: posts the ante 125
UruRey: posts the ante 125
Pkrscott1992: posts the ante 125
lulira10: posts the ante 125
lucasrojo: posts small blind 250
UruRey: posts big blind 500
*** HOLE CARDS ***
Pkrscott1992: raises 4663 to 5163 and is all-in
lulira10: folds 
Spectral34: folds 
TRAVISROYAL: folds 
lucasrojo: folds 
UruRey: folds 
Uncalled bet (4663) returned to Pkrscott1992
Pkrscott1992 collected 2000 from pot
Pkrscott1992: doesn't show hand 
*** SUMMARY ***
Total pot 2000 | Rake 0 
Seat 1: Spectral34 folded before Flop (didn't bet)
Seat 2: TRAVISROYAL (button) folded before Flop (didn't bet)
Seat 3: lucasrojo (small blind) folded before Flop
Seat 4: UruRey (big blind) folded before Flop
Seat 5: Pkrscott1992 collected (2000)
Seat 6: lulira10 folded before Flop (didn't bet)

PokerStars Hand #251209583893: Tournament #3769361908, $52.38+$2.62 USD Hold'em No Limit - Level XI (250/500) - 2024/06/26 22:34:37 UTC [2024/06/26 18:34:37 ET]
Table '3769361908 11' 6-max Seat #3 is the button
Seat 1: Spectral34 (6505 in chips) 
Seat 2: TRAVISROYAL (15180 in chips) 
Seat 3: lucasrojo (8035 in chips) 
Seat 4: UruRey (9218 in chips) 
Seat 5: Pkrscott1992 (6663 in chips) 
Seat 6: lulira10 (15157 in chips) 
Spectral34: posts the ante 125
TRAVISROYAL: posts the ante 125
lucasrojo: posts the ante 125
UruRey: posts the ante 125
Pkrscott1992: posts the ante 125
lulira10: posts the ante 125
UruRey: posts small blind 250
Pkrscott1992: posts big blind 500
*** HOLE CARDS ***
lulira10: folds 
Spectral34: folds 
TRAVISROYAL: raises 1000 to 1500
lucasrojo: folds 
UruRey: raises 7593 to 9093 and is all-in
Pkrscott1992: folds 
TRAVISROYAL: folds 
Uncalled bet (7593) returned to UruRey
UruRey collected 4250 from pot
UruRey: doesn't show hand 
*** SUMMARY ***
Total pot 4250 | Rake 0 
Seat 1: Spectral34 folded before Flop (didn't bet)
Seat 2: TRAVISROYAL folded before Flop
Seat 3: lucasrojo (button) folded before Flop (didn't bet)
Seat 4: UruRey (small blind) collected (4250)
Seat 5: Pkrscott1992 (big blind) folded before Flop
Seat 6: lulira10 folded before Flop (didn't bet)

PokerStars Hand #251209594165: Tournament #3769361908, $52.38+$2.62 USD Hold'em No Limit - Level XII (300/600) - 2024/06/26 22:35:15 UTC [2024/06/26 18:35:15 ET]
Table '3769361908 11' 6-max Seat #4 is the button
Seat 1: Spectral34 (6380 in chips) 
Seat 2: TRAVISROYAL (13555 in chips) 
Seat 3: lucasrojo (7910 in chips) 
Seat 4: UruRey (11843 in chips) 
Seat 5: Pkrscott1992 (6038 in chips) 
Seat 6: lulira10 (15032 in chips) 
Spectral34: posts the ante 150
TRAVISROYAL: posts the ante 150
lucasrojo: posts the ante 150
UruRey: posts the ante 150
Pkrscott1992: posts the ante 150
lulira10: posts the ante 150
Pkrscott1992: posts small blind 300
lulira10: posts big blind 600
*** HOLE CARDS ***
Spectral34: raises 5630 to 6230 and is all-in
TRAVISROYAL: folds 
lucasrojo: raises 1530 to 7760 and is all-in
UruRey: folds 
Pkrscott1992: folds 
lulira10: calls 7160
*** FLOP *** [5h 9d Jh]
*** TURN *** [5h 9d Jh] [2h]
*** RIVER *** [5h 9d Jh 2h] [Td]
*** SHOW DOWN ***
lulira10: shows [Ks Kd] (a pair of Kings)
lucasrojo: shows [Kh Kc] (a pair of Kings)
lulira10 collected 1530 from side pot
lucasrojo collected 1530 from side pot
Spectral34: shows [Ah Th] (a flush, Ace high)
Spectral34 collected 19890 from main pot
*** SUMMARY ***
Total pot 22950 Main pot 19890. Side pot 3060. | Rake 0 
Board [5h 9d Jh 2h Td]
Seat 1: Spectral34 showed [Ah Th] and won (19890) with a flush, Ace high
Seat 2: TRAVISROYAL folded before Flop (didn't bet)
Seat 3: lucasrojo showed [Kh Kc] and won (1530) with a pair of Kings
Seat 4: UruRey (button) folded before Flop (didn't bet)
Seat 5: Pkrscott1992 (small blind) folded before Flop
Seat 6: lulira10 (big blind) showed [Ks Kd] and won (1530) with a pair of Kings

PokerStars Hand #251209601163: Tournament #3769361908, $52.38+$2.62 USD Hold'em No Limit - Level XII (300/600) - 2024/06/26 22:35:41 UTC [2024/06/26 18:35:41 ET]
Table '3769361908 11' 6-max Seat #5 is the button
Seat 1: Spectral34 (19890 in chips) 
Seat 2: TRAVISROYAL (13405 in chips) 
Seat 3: lucasrojo (1530 in chips) 
Seat 4: UruRey (11693 in chips) 
Seat 5: Pkrscott1992 (5588 in chips) 
Seat 6: lulira10 (8652 in chips) 
Spectral34: posts the ante 150
TRAVISROYAL: posts the ante 150
lucasrojo: posts the ante 150
UruRey: posts the ante 150
Pkrscott1992: posts the ante 150
lulira10: posts the ante 150
lulira10: posts small blind 300
Spectral34: posts big blind 600
*** HOLE CARDS ***
TRAVISROYAL: folds 
lucasrojo: raises 780 to 1380 and is all-in
UruRey: folds 
Pkrscott1992: folds 
lulira10: calls 1080
Spectral34: raises 18360 to 19740 and is all-in
lulira10: folds 
Uncalled bet (18360) returned to Spectral34
*** FLOP *** [Tc Qd 5d]
*** TURN *** [Tc Qd 5d] [Qh]
*** RIVER *** [Tc Qd 5d Qh] [4s]
*** SHOW DOWN ***
Spectral34: shows [3d As] (a pair of Queens)
lucasrojo: shows [Ad 3h] (a pair of Queens)
Spectral34 collected 2520 from pot
lucasrojo collected 2520 from pot
*** SUMMARY ***
Total pot 5040 | Rake 0 
Board [Tc Qd 5d Qh 4s]
Seat 1: Spectral34 (big blind) showed [3d As] and won (2520) with a pair of Queens
Seat 2: TRAVISROYAL folded before Flop (didn't bet)
Seat 3: lucasrojo showed [Ad 3h] and won (2520) with a pair of Queens
Seat 4: UruRey folded before Flop (didn't bet)
Seat 5: Pkrscott1992 (button) folded before Flop (didn't bet)
Seat 6: lulira10 (small blind) folded before Flop

PokerStars Hand #251209608437: Tournament #3769361908, $52.38+$2.62 USD Hold'em No Limit - Level XII (300/600) - 2024/06/26 22:36:08 UTC [2024/06/26 18:36:08 ET]
Table '3769361908 11' 6-max Seat #6 is the button
Seat 1: Spectral34 (20880 in chips) 
Seat 2: TRAVISROYAL (13255 in chips) 
Seat 3: lucasrojo (2520 in chips) 
Seat 4: UruRey (11543 in chips) 
Seat 5: Pkrscott1992 (5438 in chips) 
Seat 6: lulira10 (7122 in chips) 
Spectral34: posts the ante 150
TRAVISROYAL: posts the ante 150
lucasrojo: posts the ante 150
UruRey: posts the ante 150
Pkrscott1992: posts the ante 150
lulira10: posts the ante 150
Spectral34: posts small blind 300
TRAVISROYAL: posts big blind 600
*** HOLE CARDS ***
lucasrojo: raises 1770 to 2370 and is all-in
UruRey: folds 
Pkrscott1992: folds 
lulira10: raises 4602 to 6972 and is all-in
Spectral34: folds 
TRAVISROYAL: folds 
Uncalled bet (4602) returned to lulira10
*** FLOP *** [5h 4h Qh]
*** TURN *** [5h 4h Qh] [Th]
*** RIVER *** [5h 4h Qh Th] [Qs]
*** SHOW DOWN ***
lucasrojo: shows [Jh 8d] (a flush, Queen high)
lulira10: shows [2h Kh] (a flush, King high)
lulira10 collected 6540 from pot
lucasrojo is sitting out
lucasrojo finished the tournament
*** SUMMARY ***
Total pot 6540 | Rake 0 
Board [5h 4h Qh Th Qs]
Seat 1: Spectral34 (small blind) folded before Flop
Seat 2: TRAVISROYAL (big blind) folded before Flop
Seat 3: lucasrojo showed [Jh 8d] and lost with a flush, Queen high
Seat 4: UruRey folded before Flop (didn't bet)
Seat 5: Pkrscott1992 folded before Flop (didn't bet)
Seat 6: lulira10 (button) showed [2h Kh] and won (6540) with a flush, King high

PokerStars Hand #251209614280: Tournament #3769361908, $52.38+$2.62 USD Hold'em No Limit - Level XII (300/600) - 2024/06/26 22:36:30 UTC [2024/06/26 18:36:30 ET]
Table '3769361908 11' 6-max Seat #1 is the button
Seat 1: Spectral34 (20430 in chips) 
Seat 2: TRAVISROYAL (12505 in chips) 
Seat 4: UruRey (11393 in chips) 
Seat 5: Pkrscott1992 (5288 in chips) 
Seat 6: lulira10 (11142 in chips) 
Spectral34: posts the ante 150
TRAVISROYAL: posts the ante 150
UruRey: posts the ante 150
Pkrscott1992: posts the ante 150
lulira10: posts the ante 150
TRAVISROYAL: posts small blind 300
UruRey: posts big blind 600
*** HOLE CARDS ***
Pkrscott1992: raises 4538 to 5138 and is all-in
lulira10: folds 
Spectral34: folds 
TRAVISROYAL: folds 
UruRey: calls 4538
*** FLOP *** [2s Jd Qc]
*** TURN *** [2s Jd Qc] [Ah]
*** RIVER *** [2s Jd Qc Ah] [7s]
*** SHOW DOWN ***
UruRey: shows [Kc Kh] (a pair of Kings)
Pkrscott1992: shows [As 9h] (a pair of Aces)
Pkrscott1992 collected 11326 from pot
*** SUMMARY ***
Total pot 11326 | Rake 0 
Board [2s Jd Qc Ah 7s]
Seat 1: Spectral34 (button) folded before Flop (didn't bet)
Seat 2: TRAVISROYAL (small blind) folded before Flop
Seat 4: UruRey (big blind) showed [Kc Kh] and lost with a pair of Kings
Seat 5: Pkrscott1992 showed [As 9h] and won (11326) with a pair of Aces
Seat 6: lulira10 folded before Flop (didn't bet)

PokerStars Hand #251209621158: Tournament #3769361908, $52.38+$2.62 USD Hold'em No Limit - Level XII (300/600) - 2024/06/26 22:36:56 UTC [2024/06/26 18:36:56 ET]
Table '3769361908 11' 6-max Seat #2 is the button
Seat 1: Spectral34 (20280 in chips) 
Seat 2: TRAVISROYAL (12055 in chips) 
Seat 4: UruRey (6105 in chips) 
Seat 5: Pkrscott1992 (11326 in chips) 
Seat 6: lulira10 (10992 in chips) 
Spectral34: posts the ante 150
TRAVISROYAL: posts the ante 150
UruRey: posts the ante 150
Pkrscott1992: posts the ante 150
lulira10: posts the ante 150
UruRey: posts small blind 300
Pkrscott1992: posts big blind 600
*** HOLE CARDS ***
lulira10: folds 
Spectral34: folds 
TRAVISROYAL: folds 
Rochinha2011 is disconnected 
UruRey: raises 5355 to 5955 and is all-in
Pkrscott1992: folds 
Uncalled bet (5355) returned to UruRey
UruRey collected 1950 from pot
UruRey: doesn't show hand 
*** SUMMARY ***
Total pot 1950 | Rake 0 
Seat 1: Spectral34 folded before Flop (didn't bet)
Seat 2: TRAVISROYAL (button) folded before Flop (didn't bet)
Seat 4: UruRey (small blind) collected (1950)
Seat 5: Pkrscott1992 (big blind) folded before Flop
Seat 6: lulira10 folded before Flop (didn't bet)

PokerStars Hand #251209624683: Tournament #3769361908, $52.38+$2.62 USD Hold'em No Limit - Level XII (300/600) - 2024/06/26 22:37:09 UTC [2024/06/26 18:37:09 ET]
Table '3769361908 11' 6-max Seat #4 is the button
Seat 1: Spectral34 (20130 in chips) 
Seat 2: TRAVISROYAL (11905 in chips) 
Seat 3: Rochinha2011 (10000 in chips) 
Seat 4: UruRey (7305 in chips) 
Seat 5: Pkrscott1992 (10576 in chips) 
Seat 6: lulira10 (10842 in chips) 
Spectral34: posts the ante 150
TRAVISROYAL: posts the ante 150
Rochinha2011: posts the ante 150
UruRey: posts the ante 150
Pkrscott1992: posts the ante 150
lulira10: posts the ante 150
Pkrscott1992: posts small blind 300
lulira10: posts big blind 600
*** HOLE CARDS ***
Spectral34: raises 600 to 1200
TRAVISROYAL: folds 
Rochinha2011: folds 
UruRey: raises 5955 to 7155 and is all-in
Pkrscott1992: folds 
lulira10: folds 
Spectral34: calls 5955
*** FLOP *** [Kc Jh Qh]
*** TURN *** [Kc Jh Qh] [4s]
*** RIVER *** [Kc Jh Qh 4s] [2c]
*** SHOW DOWN ***
Spectral34: shows [As Ac] (a pair of Aces)
UruRey: shows [Ad Jd] (a pair of Jacks)
Spectral34 collected 16110 from pot
UruRey finished the tournament
*** SUMMARY ***
Total pot 16110 | Rake 0 
Board [Kc Jh Qh 4s 2c]
Seat 1: Spectral34 showed [As Ac] and won (16110) with a pair of Aces
Seat 2: TRAVISROYAL folded before Flop (didn't bet)
Seat 3: Rochinha2011 folded before Flop (didn't bet)
Seat 4: UruRey (button) showed [Ad Jd] and lost with a pair of Jacks
Seat 5: Pkrscott1992 (small blind) folded before Flop
Seat 6: lulira10 (big blind) folded before Flop

PokerStars Hand #251209630523: Tournament #3769361908, $52.38+$2.62 USD Hold'em No Limit - Level XII (300/600) - 2024/06/26 22:37:32 UTC [2024/06/26 18:37:32 ET]
Table '3769361908 11' 6-max Seat #5 is the button
Seat 1: Spectral34 (28935 in chips) 
Seat 2: TRAVISROYAL (11755 in chips) 
Seat 3: Rochinha2011 (9850 in chips) 
Seat 5: Pkrscott1992 (10126 in chips) 
Seat 6: lulira10 (10092 in chips) 
Spectral34: posts the ante 150
TRAVISROYAL: posts the ante 150
Rochinha2011: posts the ante 150
Pkrscott1992: posts the ante 150
lulira10: posts the ante 150
lulira10: posts small blind 300
Spectral34: posts big blind 600
*** HOLE CARDS ***
TRAVISROYAL: folds 
kayamia is disconnected 
Rochinha2011: folds 
Pkrscott1992: folds 
lulira10: raises 9342 to 9942 and is all-in
Spectral34: calls 9342
*** FLOP *** [8h 9s 2d]
*** TURN *** [8h 9s 2d] [4h]
*** RIVER *** [8h 9s 2d 4h] [4c]
*** SHOW DOWN ***
lulira10: shows [6d Ad] (a pair of Fours)
Spectral34: shows [Tc Kd] (a pair of Fours - lower kicker)
lulira10 collected 20634 from pot
*** SUMMARY ***
Total pot 20634 | Rake 0 
Board [8h 9s 2d 4h 4c]
Seat 1: Spectral34 (big blind) showed [Tc Kd] and lost with a pair of Fours
Seat 2: TRAVISROYAL folded before Flop (didn't bet)
Seat 3: Rochinha2011 folded before Flop (didn't bet)
Seat 5: Pkrscott1992 (button) folded before Flop (didn't bet)
Seat 6: lulira10 (small blind) showed [6d Ad] and won (20634) with a pair of Fours

PokerStars Hand #251209637201: Tournament #3769361908, $52.38+$2.62 USD Hold'em No Limit - Level XII (300/600) - 2024/06/26 22:37:57 UTC [2024/06/26 18:37:57 ET]
Table '3769361908 11' 6-max Seat #6 is the button
Seat 1: Spectral34 (18843 in chips) 
Seat 2: TRAVISROYAL (11605 in chips) 
Seat 3: Rochinha2011 (9700 in chips) 
Seat 4: kayamia (10000 in chips) 
Seat 5: Pkrscott1992 (9976 in chips) 
Seat 6: lulira10 (20634 in chips) 
Spectral34: posts the ante 150
TRAVISROYAL: posts the ante 150
Rochinha2011: posts the ante 150
kayamia: posts the ante 150
Pkrscott1992: posts the ante 150
lulira10: posts the ante 150
Spectral34: posts small blind 300
TRAVISROYAL: posts big blind 600
*** HOLE CARDS ***
Rochinha2011: raises 600 to 1200
kayamia: folds 
Pkrscott1992: folds 
lulira10: folds 
Spectral34: folds 
TRAVISROYAL: calls 600
*** FLOP *** [3s 9h 6d]
TRAVISROYAL: bets 1800
Rochinha2011: raises 1800 to 3600
TRAVISROYAL: calls 1800
*** TURN *** [3s 9h 6d] [7d]
TRAVISROYAL: bets 2400
Rochinha2011: raises 2350 to 4750 and is all-in
TRAVISROYAL: calls 2350
*** RIVER *** [3s 9h 6d 7d] [2d]
*** SHOW DOWN ***
TRAVISROYAL: shows [Ts Kc] (high card King)
Rochinha2011: shows [9d As] (a pair of Nines)
Rochinha2011 collected 20300 from pot
*** SUMMARY ***
Total pot 20300 | Rake 0 
Board [3s 9h 6d 7d 2d]
Seat 1: Spectral34 (small blind) folded before Flop
Seat 2: TRAVISROYAL (big blind) showed [Ts Kc] and lost with high card King
Seat 3: Rochinha2011 showed [9d As] and won (20300) with a pair of Nines
Seat 4: kayamia folded before Flop (didn't bet)
Seat 5: Pkrscott1992 folded before Flop (didn't bet)
Seat 6: lulira10 (button) folded before Flop (didn't bet)

PokerStars Hand #251209655531: Tournament #3769361908, $52.38+$2.62 USD Hold'em No Limit - Level XIII (400/800) - 2024/06/26 22:39:05 UTC [2024/06/26 18:39:05 ET]
Table '3769361908 11' 6-max Seat #1 is the button
Seat 1: Spectral34 (18393 in chips) 
Seat 2: TRAVISROYAL (1905 in chips) 
Seat 3: Rochinha2011 (20300 in chips) 
Seat 4: kayamia (9850 in chips) 
Seat 5: Pkrscott1992 (9826 in chips) 
Seat 6: lulira10 (20484 in chips) 
Spectral34: posts the ante 200
TRAVISROYAL: posts the ante 200
Rochinha2011: posts the ante 200
kayamia: posts the ante 200
Pkrscott1992: posts the ante 200
lulira10: posts the ante 200
TRAVISROYAL: posts small blind 400
Rochinha2011: posts big blind 800
*** HOLE CARDS ***
kayamia: folds 
Pkrscott1992: raises 8826 to 9626 and is all-in
lulira10: calls 9626
Spectral34: folds 
TRAVISROYAL: calls 1305 and is all-in
Rochinha2011: folds 
*** FLOP *** [Kd Ks 5s]
*** TURN *** [Kd Ks 5s] [8d]
*** RIVER *** [Kd Ks 5s 8d] [Jh]
*** SHOW DOWN ***
Pkrscott1992: shows [Qs 9s] (a pair of Kings)
lulira10: shows [Js As] (two pair, Kings and Jacks)
lulira10 collected 15842 from side pot
TRAVISROYAL: shows [9h 7h] (a pair of Kings)
lulira10 collected 7115 from main pot
Pkrscott1992 finished the tournament
TRAVISROYAL finished the tournament
LadyLuke2010 is disconnected 
*** SUMMARY ***
Total pot 22957 Main pot 7115. Side pot 15842. | Rake 0 
Board [Kd Ks 5s 8d Jh]
Seat 1: Spectral34 (button) folded before Flop (didn't bet)
Seat 2: TRAVISROYAL (small blind) showed [9h 7h] and lost with a pair of Kings
Seat 3: Rochinha2011 (big blind) folded before Flop
Seat 4: kayamia folded before Flop (didn't bet)
Seat 5: Pkrscott1992 showed [Qs 9s] and lost with a pair of Kings
Seat 6: lulira10 showed [Js As] and won (22957) with two pair, Kings and Jacks

PokerStars Hand #251209661945: Tournament #3769361908, $52.38+$2.62 USD Hold'em No Limit - Level XIII (400/800) - 2024/06/26 22:39:29 UTC [2024/06/26 18:39:29 ET]
Table '3769361908 11' 6-max Seat #3 is the button
Seat 1: Spectral34 (18193 in chips) 
Seat 2: LadyLuke2010 (8100 in chips) 
Seat 3: Rochinha2011 (19300 in chips) 
Seat 4: kayamia (9650 in chips) 
Seat 6: lulira10 (33615 in chips) 
Spectral34: posts the ante 200
LadyLuke2010: posts the ante 200
Rochinha2011: posts the ante 200
kayamia: posts the ante 200
lulira10: posts the ante 200
kayamia: posts small blind 400
lulira10: posts big blind 800
*** HOLE CARDS ***
Spectral34: raises 800 to 1600
LadyLuke2010: calls 1600
Rochinha2011: folds 
kayamia: folds 
lulira10: calls 800
*** FLOP *** [Tc 8c Qd]
lulira10: checks 
Spectral34: bets 2400
LadyLuke2010: raises 3900 to 6300 and is all-in
lulira10: folds 
Spectral34: calls 3900
*** TURN *** [Tc 8c Qd] [2c]
*** RIVER *** [Tc 8c Qd 2c] [9s]
*** SHOW DOWN ***
Spectral34: shows [9c Kc] (a flush, King high)
LadyLuke2010: shows [Td Jh] (a straight, Eight to Queen)
Spectral34 collected 18800 from pot
LadyLuke2010 finished the tournament
*** SUMMARY ***
Total pot 18800 | Rake 0 
Board [Tc 8c Qd 2c 9s]
Seat 1: Spectral34 showed [9c Kc] and won (18800) with a flush, King high
Seat 2: LadyLuke2010 showed [Td Jh] and lost with a straight, Eight to Queen
Seat 3: Rochinha2011 (button) folded before Flop (didn't bet)
Seat 4: kayamia (small blind) folded before Flop
Seat 6: lulira10 (big blind) folded on the Flop

PokerStars Hand #251209670120: Tournament #3769361908, $52.38+$2.62 USD Hold'em No Limit - Level XIII (400/800) - 2024/06/26 22:39:59 UTC [2024/06/26 18:39:59 ET]
Table '3769361908 11' 6-max Seat #4 is the button
Seat 1: Spectral34 (28893 in chips) 
Seat 3: Rochinha2011 (19100 in chips) 
Seat 4: kayamia (9050 in chips) 
Seat 6: lulira10 (31815 in chips) 
Spectral34: posts the ante 200
Rochinha2011: posts the ante 200
kayamia: posts the ante 200
lulira10: posts the ante 200
lulira10: posts small blind 400
Spectral34: posts big blind 800
*** HOLE CARDS ***
biuzinho17 is disconnected 
Rochinha2011: folds 
kayamia: folds 
lulira10: raises 800 to 1600
Spectral34: calls 800
*** FLOP *** [Ad Jd Ac]
lulira10: bets 2000
Spectral34: folds 
Uncalled bet (2000) returned to lulira10
aramio29 is disconnected 
lulira10 collected 4000 from pot
lulira10: doesn't show hand 
*** SUMMARY ***
Total pot 4000 | Rake 0 
Board [Ad Jd Ac]
Seat 1: Spectral34 (big blind) folded on the Flop
Seat 3: Rochinha2011 folded before Flop (didn't bet)
Seat 4: kayamia (button) folded before Flop (didn't bet)
Seat 6: lulira10 (small blind) collected (4000)

PokerStars Hand #251209675141: Tournament #3769361908, $52.38+$2.62 USD Hold'em No Limit - Level XIII (400/800) - 2024/06/26 22:40:19 UTC [2024/06/26 18:40:19 ET]
Table '3769361908 11' 6-max Seat #6 is the button
Seat 1: Spectral34 (27093 in chips) 
Seat 2: biuzinho17 (23100 in chips) 
Seat 3: Rochinha2011 (18900 in chips) 
Seat 4: kayamia (8850 in chips) 
Seat 5: aramio29 (19808 in chips) 
Seat 6: lulira10 (34015 in chips) 
Spectral34: posts the ante 200
biuzinho17: posts the ante 200
Rochinha2011: posts the ante 200
kayamia: posts the ante 200
aramio29: posts the ante 200
lulira10: posts the ante 200
Spectral34: posts small blind 400
biuzinho17: posts big blind 800
*** HOLE CARDS ***
Rochinha2011: folds 
kayamia: raises 800 to 1600
aramio29: folds 
lulira10: folds 
Spectral34: folds 
biuzinho17: folds 
Uncalled bet (800) returned to kayamia
kayamia collected 3200 from pot
kayamia: doesn't show hand 
*** SUMMARY ***
Total pot 3200 | Rake 0 
Seat 1: Spectral34 (small blind) folded before Flop
Seat 2: biuzinho17 (big blind) folded before Flop
Seat 3: Rochinha2011 folded before Flop (didn't bet)
Seat 4: kayamia collected (3200)
Seat 5: aramio29 folded before Flop (didn't bet)
Seat 6: lulira10 (button) folded before Flop (didn't bet)

PokerStars Hand #251209679408: Tournament #3769361908, $52.38+$2.62 USD Hold'em No Limit - Level XIII (400/800) - 2024/06/26 22:40:35 UTC [2024/06/26 18:40:35 ET]
Table '3769361908 11' 6-max Seat #1 is the button
Seat 1: Spectral34 (26493 in chips) 
Seat 2: biuzinho17 (22100 in chips) 
Seat 3: Rochinha2011 (18700 in chips) 
Seat 4: kayamia (11050 in chips) 
Seat 5: aramio29 (19608 in chips) 
Seat 6: lulira10 (33815 in chips) 
Spectral34: posts the ante 200
biuzinho17: posts the ante 200
Rochinha2011: posts the ante 200
kayamia: posts the ante 200
aramio29: posts the ante 200
lulira10: posts the ante 200
biuzinho17: posts small blind 400
Rochinha2011: posts big blind 800
*** HOLE CARDS ***
kayamia: folds 
aramio29: folds 
lulira10: calls 800
Spectral34: folds 
biuzinho17: calls 400
Rochinha2011: raises 2400 to 3200
lulira10: folds 
biuzinho17: folds 
Uncalled bet (2400) returned to Rochinha2011
Rochinha2011 collected 3600 from pot
Rochinha2011: doesn't show hand 
*** SUMMARY ***
Total pot 3600 | Rake 0 
Seat 1: Spectral34 (button) folded before Flop (didn't bet)
Seat 2: biuzinho17 (small blind) folded before Flop
Seat 3: Rochinha2011 (big blind) collected (3600)
Seat 4: kayamia folded before Flop (didn't bet)
Seat 5: aramio29 folded before Flop (didn't bet)
Seat 6: lulira10 folded before Flop

PokerStars Hand #251209689681: Tournament #3769361908, $52.38+$2.62 USD Hold'em No Limit - Level XIV (500/1000) - 2024/06/26 22:41:14 UTC [2024/06/26 18:41:14 ET]
Table '3769361908 11' 6-max Seat #2 is the button
Seat 1: Spectral34 (26293 in chips) 
Seat 2: biuzinho17 (21100 in chips) 
Seat 3: Rochinha2011 (21300 in chips) 
Seat 4: kayamia (10850 in chips) 
Seat 5: aramio29 (19408 in chips) 
Seat 6: lulira10 (32815 in chips) 
Spectral34: posts the ante 250
biuzinho17: posts the ante 250
Rochinha2011: posts the ante 250
kayamia: posts the ante 250
aramio29: posts the ante 250
lulira10: posts the ante 250
Rochinha2011: posts small blind 500
kayamia: posts big blind 1000
*** HOLE CARDS ***
aramio29: folds 
lulira10: folds 
Spectral34: raises 1000 to 2000
biuzinho17: folds 
Rochinha2011: raises 4500 to 6500
kayamia: folds 
Spectral34: folds 
Uncalled bet (4500) returned to Rochinha2011
Rochinha2011 collected 6500 from pot
Rochinha2011: doesn't show hand 
*** SUMMARY ***
Total pot 6500 | Rake 0 
Seat 1: Spectral34 folded before Flop
Seat 2: biuzinho17 (button) folded before Flop (didn't bet)
Seat 3: Rochinha2011 (small blind) collected (6500)
Seat 4: kayamia (big blind) folded before Flop
Seat 5: aramio29 folded before Flop (didn't bet)
Seat 6: lulira10 folded before Flop (didn't bet)

PokerStars Hand #251209701786: Tournament #3769361908, $52.38+$2.62 USD Hold'em No Limit - Level XIV (500/1000) - 2024/06/26 22:42:01 UTC [2024/06/26 18:42:01 ET]
Table '3769361908 11' 6-max Seat #3 is the button
Seat 1: Spectral34 (24043 in chips) 
Seat 2: biuzinho17 (20850 in chips) 
Seat 3: Rochinha2011 (25550 in chips) 
Seat 4: kayamia (9600 in chips) 
Seat 5: aramio29 (19158 in chips) 
Seat 6: lulira10 (32565 in chips) 
Spectral34: posts the ante 250
biuzinho17: posts the ante 250
Rochinha2011: posts the ante 250
kayamia: posts the ante 250
aramio29: posts the ante 250
lulira10: posts the ante 250
kayamia: posts small blind 500
aramio29: posts big blind 1000
*** HOLE CARDS ***
lulira10: folds 
Spectral34: folds 
biuzinho17: raises 1000 to 2000
Rochinha2011: folds 
kayamia: folds 
aramio29: folds 
Uncalled bet (1000) returned to biuzinho17
biuzinho17 collected 4000 from pot
biuzinho17: doesn't show hand 
*** SUMMARY ***
Total pot 4000 | Rake 0 
Seat 1: Spectral34 folded before Flop (didn't bet)
Seat 2: biuzinho17 collected (4000)
Seat 3: Rochinha2011 (button) folded before Flop (didn't bet)
Seat 4: kayamia (small blind) folded before Flop
Seat 5: aramio29 (big blind) folded before Flop
Seat 6: lulira10 folded before Flop (didn't bet)

PokerStars Hand #251209706055: Tournament #3769361908, $52.38+$2.62 USD Hold'em No Limit - Level XIV (500/1000) - 2024/06/26 22:42:18 UTC [2024/06/26 18:42:18 ET]
Table '3769361908 11' 6-max Seat #4 is the button
Seat 1: Spectral34 (23793 in chips) 
Seat 2: biuzinho17 (23600 in chips) 
Seat 3: Rochinha2011 (25300 in chips) 
Seat 4: kayamia (8850 in chips) 
Seat 5: aramio29 (17908 in chips) 
Seat 6: lulira10 (32315 in chips) 
Spectral34: posts the ante 250
biuzinho17: posts the ante 250
Rochinha2011: posts the ante 250
kayamia: posts the ante 250
aramio29: posts the ante 250
lulira10: posts the ante 250
aramio29: posts small blind 500
lulira10: posts big blind 1000
*** HOLE CARDS ***
Spectral34: folds 
biuzinho17: folds 
Rochinha2011: folds 
kayamia: folds 
aramio29: calls 500
lulira10: raises 31065 to 32065 and is all-in
aramio29: folds 
Uncalled bet (31065) returned to lulira10
lulira10 collected 3500 from pot
lulira10: doesn't show hand 
*** SUMMARY ***
Total pot 3500 | Rake 0 
Seat 1: Spectral34 folded before Flop (didn't bet)
Seat 2: biuzinho17 folded before Flop (didn't bet)
Seat 3: Rochinha2011 folded before Flop (didn't bet)
Seat 4: kayamia (button) folded before Flop (didn't bet)
Seat 5: aramio29 (small blind) folded before Flop
Seat 6: lulira10 (big blind) collected (3500)

PokerStars Hand #251209712367: Tournament #3769361908, $52.38+$2.62 USD Hold'em No Limit - Level XIV (500/1000) - 2024/06/26 22:42:42 UTC [2024/06/26 18:42:42 ET]
Table '3769361908 11' 6-max Seat #5 is the button
Seat 1: Spectral34 (23543 in chips) 
Seat 2: biuzinho17 (23350 in chips) 
Seat 3: Rochinha2011 (25050 in chips) 
Seat 4: kayamia (8600 in chips) 
Seat 5: aramio29 (16658 in chips) 
Seat 6: lulira10 (34565 in chips) 
Spectral34: posts the ante 250
biuzinho17: posts the ante 250
Rochinha2011: posts the ante 250
kayamia: posts the ante 250
aramio29: posts the ante 250
lulira10: posts the ante 250
lulira10: posts small blind 500
Spectral34: posts big blind 1000
*** HOLE CARDS ***
biuzinho17: folds 
Rochinha2011: raises 1000 to 2000
kayamia: folds 
aramio29: folds 
lulira10: folds 
Spectral34: calls 1000
*** FLOP *** [8h Jh 2h]
Spectral34: checks 
Rochinha2011: bets 1500
Spectral34: calls 1500
*** TURN *** [8h Jh 2h] [9s]
Spectral34: checks 
Rochinha2011: checks 
*** RIVER *** [8h Jh 2h 9s] [9h]
Spectral34: checks 
Rochinha2011: checks 
*** SHOW DOWN ***
Spectral34: shows [Js Kd] (two pair, Jacks and Nines)
Rochinha2011: shows [9c Ac] (three of a kind, Nines)
Rochinha2011 collected 9000 from pot
*** SUMMARY ***
Total pot 9000 | Rake 0 
Board [8h Jh 2h 9s 9h]
Seat 1: Spectral34 (big blind) showed [Js Kd] and lost with two pair, Jacks and Nines
Seat 2: biuzinho17 folded before Flop (didn't bet)
Seat 3: Rochinha2011 showed [9c Ac] and won (9000) with three of a kind, Nines
Seat 4: kayamia folded before Flop (didn't bet)
Seat 5: aramio29 (button) folded before Flop (didn't bet)
Seat 6: lulira10 (small blind) folded before Flop

PokerStars Hand #251209728790: Tournament #3769361908, $52.38+$2.62 USD Hold'em No Limit - Level XIV (500/1000) - 2024/06/26 22:43:46 UTC [2024/06/26 18:43:46 ET]
Table '3769361908 11' 6-max Seat #6 is the button
Seat 1: Spectral34 (19793 in chips) 
Seat 2: biuzinho17 (23100 in chips) 
Seat 3: Rochinha2011 (30300 in chips) 
Seat 4: kayamia (8350 in chips) 
Seat 5: aramio29 (16408 in chips) 
Seat 6: lulira10 (33815 in chips) 
Spectral34: posts the ante 250
biuzinho17: posts the ante 250
Rochinha2011: posts the ante 250
kayamia: posts the ante 250
aramio29: posts the ante 250
lulira10: posts the ante 250
Spectral34: posts small blind 500
biuzinho17: posts big blind 1000
*** HOLE CARDS ***
Rochinha2011: folds 
kayamia: folds 
aramio29: folds 
lulira10: calls 1000
Spectral34: folds 
biuzinho17: checks 
*** FLOP *** [8c Qc 2h]
biuzinho17: checks 
lulira10: bets 2000
biuzinho17: folds 
Uncalled bet (2000) returned to lulira10
lulira10 collected 4000 from pot
lulira10: doesn't show hand 
*** SUMMARY ***
Total pot 4000 | Rake 0 
Board [8c Qc 2h]
Seat 1: Spectral34 (small blind) folded before Flop
Seat 2: biuzinho17 (big blind) folded on the Flop
Seat 3: Rochinha2011 folded before Flop (didn't bet)
Seat 4: kayamia folded before Flop (didn't bet)
Seat 5: aramio29 folded before Flop (didn't bet)
Seat 6: lulira10 (button) collected (4000)

PokerStars Hand #251209739119: Tournament #3769361908, $52.38+$2.62 USD Hold'em No Limit - Level XV (600/1200) - 2024/06/26 22:44:27 UTC [2024/06/26 18:44:27 ET]
Table '3769361908 11' 6-max Seat #1 is the button
Seat 1: Spectral34 (19043 in chips) 
Seat 2: biuzinho17 (21850 in chips) 
Seat 3: Rochinha2011 (30050 in chips) 
Seat 4: kayamia (8100 in chips) 
Seat 5: aramio29 (16158 in chips) 
Seat 6: lulira10 (36565 in chips) 
Spectral34: posts the ante 300
biuzinho17: posts the ante 300
Rochinha2011: posts the ante 300
kayamia: posts the ante 300
aramio29: posts the ante 300
lulira10: posts the ante 300
biuzinho17: posts small blind 600
Rochinha2011: posts big blind 1200
*** HOLE CARDS ***
kayamia: folds 
aramio29: folds 
lulira10: folds 
Spectral34: folds 
biuzinho17: calls 600
Rochinha2011: raises 2400 to 3600
biuzinho17: calls 2400
*** FLOP *** [Qd Ac 3c]
biuzinho17: checks 
Rochinha2011: bets 2250
biuzinho17: calls 2250
*** TURN *** [Qd Ac 3c] [6h]
biuzinho17: checks 
Rochinha2011: checks 
*** RIVER *** [Qd Ac 3c 6h] [3h]
biuzinho17: bets 15700 and is all-in
Rochinha2011: folds 
Uncalled bet (15700) returned to biuzinho17
biuzinho17 collected 13500 from pot
biuzinho17: doesn't show hand 
*** SUMMARY ***
Total pot 13500 | Rake 0 
Board [Qd Ac 3c 6h 3h]
Seat 1: Spectral34 (button) folded before Flop (didn't bet)
Seat 2: biuzinho17 (small blind) collected (13500)
Seat 3: Rochinha2011 (big blind) folded on the River
Seat 4: kayamia folded before Flop (didn't bet)
Seat 5: aramio29 folded before Flop (didn't bet)
Seat 6: lulira10 folded before Flop (didn't bet)

PokerStars Hand #251209767002: Tournament #3769361908, $52.38+$2.62 USD Hold'em No Limit - Level XV (600/1200) - 2024/06/26 22:46:15 UTC [2024/06/26 18:46:15 ET]
Table '3769361908 11' 6-max Seat #2 is the button
Seat 1: Spectral34 (18743 in chips) 
Seat 2: biuzinho17 (29200 in chips) 
Seat 3: Rochinha2011 (23900 in chips) 
Seat 4: kayamia (7800 in chips) 
Seat 5: aramio29 (15858 in chips) 
Seat 6: lulira10 (36265 in chips) 
Spectral34: posts the ante 300
biuzinho17: posts the ante 300
Rochinha2011: posts the ante 300
kayamia: posts the ante 300
aramio29: posts the ante 300
lulira10: posts the ante 300
Rochinha2011: posts small blind 600
kayamia: posts big blind 1200
*** HOLE CARDS ***
aramio29: folds 
lulira10: folds 
Spectral34: folds 
biuzinho17: folds 
Rochinha2011: raises 22400 to 23600 and is all-in
kayamia: calls 6300 and is all-in
Uncalled bet (16100) returned to Rochinha2011
*** FLOP *** [Qs 4h Ac]
*** TURN *** [Qs 4h Ac] [2h]
*** RIVER *** [Qs 4h Ac 2h] [Ah]
*** SHOW DOWN ***
Rochinha2011: shows [6s Kc] (a pair of Aces)
kayamia: shows [7s 8d] (a pair of Aces - lower kicker)
Rochinha2011 collected 16800 from pot
kayamia finished the tournament
*** SUMMARY ***
Total pot 16800 | Rake 0 
Board [Qs 4h Ac 2h Ah]
Seat 1: Spectral34 folded before Flop (didn't bet)
Seat 2: biuzinho17 (button) folded before Flop (didn't bet)
Seat 3: Rochinha2011 (small blind) showed [6s Kc] and won (16800) with a pair of Aces
Seat 4: kayamia (big blind) showed [7s 8d] and lost with a pair of Aces
Seat 5: aramio29 folded before Flop (didn't bet)
Seat 6: lulira10 folded before Flop (didn't bet)

PokerStars Hand #251209776579: Tournament #3769361908, $52.38+$2.62 USD Hold'em No Limit - Level XV (600/1200) - 2024/06/26 22:46:52 UTC [2024/06/26 18:46:52 ET]
Table '3769361908 11' 6-max Seat #3 is the button
Seat 1: Spectral34 (18443 in chips) 
Seat 2: biuzinho17 (28900 in chips) 
Seat 3: Rochinha2011 (32900 in chips) 
Seat 5: aramio29 (15558 in chips) 
Seat 6: lulira10 (35965 in chips) 
Spectral34: posts the ante 300
biuzinho17: posts the ante 300
Rochinha2011: posts the ante 300
aramio29: posts the ante 300
lulira10: posts the ante 300
aramio29: posts small blind 600
lulira10: posts big blind 1200
*** HOLE CARDS ***
Spectral34: folds 
MjLK MAN is disconnected 
biuzinho17: folds 
Rochinha2011: raises 1200 to 2400
aramio29: raises 12858 to 15258 and is all-in
lulira10: folds 
Rochinha2011: calls 12858
*** FLOP *** [6d Jd 3c]
*** TURN *** [6d Jd 3c] [9d]
*** RIVER *** [6d Jd 3c 9d] [8c]
*** SHOW DOWN ***
aramio29: shows [Jh As] (a pair of Jacks)
Rochinha2011: shows [Qd Qc] (a pair of Queens)
Rochinha2011 collected 33216 from pot
aramio29 finished the tournament
*** SUMMARY ***
Total pot 33216 | Rake 0 
Board [6d Jd 3c 9d 8c]
Seat 1: Spectral34 folded before Flop (didn't bet)
Seat 2: biuzinho17 folded before Flop (didn't bet)
Seat 3: Rochinha2011 (button) showed [Qd Qc] and won (33216) with a pair of Queens
Seat 5: aramio29 (small blind) showed [Jh As] and lost with a pair of Jacks
Seat 6: lulira10 (big blind) folded before Flop

PokerStars Hand #251209785189: Tournament #3769361908, $52.38+$2.62 USD Hold'em No Limit - Level XVI (800/1600) - 2024/06/26 22:47:26 UTC [2024/06/26 18:47:26 ET]
Table '3769361908 11' 6-max Seat #6 is the button
Seat 1: Spectral34 (18143 in chips) 
Seat 2: biuzinho17 (28600 in chips) 
Seat 3: Rochinha2011 (50558 in chips) 
Seat 4: MjLK MAN (10000 in chips) 
Seat 6: lulira10 (34465 in chips) 
Spectral34: posts the ante 400
biuzinho17: posts the ante 400
Rochinha2011: posts the ante 400
MjLK MAN: posts the ante 400
lulira10: posts the ante 400
Spectral34: posts small blind 800
biuzinho17: posts big blind 1600
*** HOLE CARDS ***
Rochinha2011: folds 
MjLK MAN: raises 8000 to 9600 and is all-in
Boogz96 is disconnected 
lulira10: folds 
Spectral34: folds 
biuzinho17: folds 
Uncalled bet (8000) returned to MjLK MAN
MjLK MAN collected 6000 from pot
MjLK MAN: doesn't show hand 
*** SUMMARY ***
Total pot 6000 | Rake 0 
Seat 1: Spectral34 (small blind) folded before Flop
Seat 2: biuzinho17 (big blind) folded before Flop
Seat 3: Rochinha2011 folded before Flop (didn't bet)
Seat 4: MjLK MAN collected (6000)
Seat 6: lulira10 (button) folded before Flop (didn't bet)

PokerStars Hand #251209798470: Tournament #3769361908, $52.38+$2.62 USD Hold'em No Limit - Level XVI (800/1600) - 2024/06/26 22:48:18 UTC [2024/06/26 18:48:18 ET]
Table '3769361908 11' 6-max Seat #1 is the button
Seat 1: Spectral34 (16943 in chips) 
Seat 2: biuzinho17 (26600 in chips) 
Seat 3: Rochinha2011 (50158 in chips) 
Seat 4: MjLK MAN (14000 in chips) 
Seat 5: Boogz96 (13800 in chips) 
Seat 6: lulira10 (34065 in chips) 
Spectral34: posts the ante 400
biuzinho17: posts the ante 400
Rochinha2011: posts the ante 400
MjLK MAN: posts the ante 400
Boogz96: posts the ante 400
lulira10: posts the ante 400
biuzinho17: posts small blind 800
Rochinha2011: posts big blind 1600
*** HOLE CARDS ***
MjLK MAN: folds 
Boogz96: folds 
lulira10: folds 
Spectral34: raises 14943 to 16543 and is all-in
biuzinho17: folds 
Rochinha2011: folds 
Uncalled bet (14943) returned to Spectral34
Spectral34 collected 6400 from pot
Spectral34: doesn't show hand 
*** SUMMARY ***
Total pot 6400 | Rake 0 
Seat 1: Spectral34 (button) collected (6400)
Seat 2: biuzinho17 (small blind) folded before Flop
Seat 3: Rochinha2011 (big blind) folded before Flop
Seat 4: MjLK MAN folded before Flop (didn't bet)
Seat 5: Boogz96 folded before Flop (didn't bet)
Seat 6: lulira10 folded before Flop (didn't bet)

PokerStars Hand #251209804741: Tournament #3769361908, $52.38+$2.62 USD Hold'em No Limit - Level XVI (800/1600) - 2024/06/26 22:48:43 UTC [2024/06/26 18:48:43 ET]
Table '3769361908 11' 6-max Seat #2 is the button
Seat 1: Spectral34 (21343 in chips) 
Seat 2: biuzinho17 (25400 in chips) 
Seat 3: Rochinha2011 (48158 in chips) 
Seat 4: MjLK MAN (13600 in chips) 
Seat 5: Boogz96 (13400 in chips) 
Seat 6: lulira10 (33665 in chips) 
Spectral34: posts the ante 400
biuzinho17: posts the ante 400
Rochinha2011: posts the ante 400
MjLK MAN: posts the ante 400
Boogz96: posts the ante 400
lulira10: posts the ante 400
Rochinha2011: posts small blind 800
MjLK MAN: posts big blind 1600
*** HOLE CARDS ***
Boogz96: folds 
lulira10: folds 
Spectral34: folds 
biuzinho17: raises 1600 to 3200
Rochinha2011: raises 44558 to 47758 and is all-in
MjLK MAN: folds 
biuzinho17: calls 21800 and is all-in
Uncalled bet (22758) returned to Rochinha2011
*** FLOP *** [5c 3h 4c]
*** TURN *** [5c 3h 4c] [Qd]
*** RIVER *** [5c 3h 4c Qd] [Kd]
*** SHOW DOWN ***
Rochinha2011: shows [Qc Kc] (two pair, Kings and Queens)
biuzinho17: shows [9c Ah] (high card Ace)
Rochinha2011 collected 54000 from pot
biuzinho17 finished the tournament in 120th place
*** SUMMARY ***
Total pot 54000 | Rake 0 
Board [5c 3h 4c Qd Kd]
Seat 1: Spectral34 folded before Flop (didn't bet)
Seat 2: biuzinho17 (button) showed [9c Ah] and lost with high card Ace
Seat 3: Rochinha2011 (small blind) showed [Qc Kc] and won (54000) with two pair, Kings and Queens
Seat 4: MjLK MAN (big blind) folded before Flop
Seat 5: Boogz96 folded before Flop (didn't bet)
Seat 6: lulira10 folded before Flop (didn't bet)

PokerStars Hand #251209815816: Tournament #3769361908, $52.38+$2.62 USD Hold'em No Limit - Level XVI (800/1600) - 2024/06/26 22:49:27 UTC [2024/06/26 18:49:27 ET]
Table '3769361908 11' 6-max Seat #3 is the button
Seat 1: Spectral34 (20943 in chips) 
Seat 3: Rochinha2011 (76758 in chips) 
Seat 4: MjLK MAN (11600 in chips) 
Seat 5: Boogz96 (13000 in chips) 
Seat 6: lulira10 (33265 in chips) 
Spectral34: posts the ante 400
Rochinha2011: posts the ante 400
MjLK MAN: posts the ante 400
Boogz96: posts the ante 400
lulira10: posts the ante 400
MjLK MAN: posts small blind 800
Boogz96: posts big blind 1600
*** HOLE CARDS ***
lulira10: folds 
Spectral34: folds 
Rochinha2011: raises 74758 to 76358 and is all-in
jack310759 is disconnected 
MjLK MAN: folds 
Boogz96: folds 
Uncalled bet (74758) returned to Rochinha2011
Rochinha2011 collected 6000 from pot
Rochinha2011: doesn't show hand 
*** SUMMARY ***
Total pot 6000 | Rake 0 
Seat 1: Spectral34 folded before Flop (didn't bet)
Seat 3: Rochinha2011 (button) collected (6000)
Seat 4: MjLK MAN (small blind) folded before Flop
Seat 5: Boogz96 (big blind) folded before Flop
Seat 6: lulira10 folded before Flop (didn't bet)

PokerStars Hand #251209828965: Tournament #3769361908, $52.38+$2.62 USD Hold'em No Limit - Level XVII (1000/2000) - 2024/06/26 22:50:21 UTC [2024/06/26 18:50:21 ET]
Table '3769361908 11' 6-max Seat #4 is the button
Seat 1: Spectral34 (20543 in chips) 
Seat 2: jack310759 (37083 in chips) 
Seat 3: Rochinha2011 (80758 in chips) 
Seat 4: MjLK MAN (10400 in chips) 
Seat 5: Boogz96 (11000 in chips) 
Seat 6: lulira10 (32865 in chips) 
Spectral34: posts the ante 500
jack310759: posts the ante 500
Rochinha2011: posts the ante 500
MjLK MAN: posts the ante 500
Boogz96: posts the ante 500
lulira10: posts the ante 500
Boogz96: posts small blind 1000
lulira10: posts big blind 2000
*** HOLE CARDS ***
Spectral34: folds 
jack310759: raises 4000 to 6000
Rochinha2011: folds 
MjLK MAN: raises 3900 to 9900 and is all-in
Boogz96: folds 
lulira10: folds 
jack310759: calls 3900
*** FLOP *** [6s Kc 2c]
*** TURN *** [6s Kc 2c] [9c]
*** RIVER *** [6s Kc 2c 9c] [2s]
*** SHOW DOWN ***
jack310759: shows [Ah 7h] (a pair of Deuces)
MjLK MAN: shows [Ad Td] (a pair of Deuces - Ace+King+Ten kicker)
MjLK MAN collected 25800 from pot
*** SUMMARY ***
Total pot 25800 | Rake 0 
Board [6s Kc 2c 9c 2s]
Seat 1: Spectral34 folded before Flop (didn't bet)
Seat 2: jack310759 showed [Ah 7h] and lost with a pair of Deuces
Seat 3: Rochinha2011 folded before Flop (didn't bet)
Seat 4: MjLK MAN (button) showed [Ad Td] and won (25800) with a pair of Deuces
Seat 5: Boogz96 (small blind) folded before Flop
Seat 6: lulira10 (big blind) folded before Flop

PokerStars Hand #251209846146: Tournament #3769361908, $52.38+$2.62 USD Hold'em No Limit - Level XVII (1000/2000) - 2024/06/26 22:51:31 UTC [2024/06/26 18:51:31 ET]
Table '3769361908 11' 6-max Seat #5 is the button
Seat 1: Spectral34 (20043 in chips) 
Seat 2: jack310759 (26683 in chips) 
Seat 3: Rochinha2011 (80258 in chips) 
Seat 4: MjLK MAN (25800 in chips) 
Seat 5: Boogz96 (9500 in chips) 
Seat 6: lulira10 (30365 in chips) 
Spectral34: posts the ante 500
jack310759: posts the ante 500
Rochinha2011: posts the ante 500
MjLK MAN: posts the ante 500
Boogz96: posts the ante 500
lulira10: posts the ante 500
lulira10: posts small blind 1000
Spectral34: posts big blind 2000
*** HOLE CARDS ***
jack310759: folds 
Rochinha2011: folds 
MjLK MAN: folds 
Boogz96: folds 
lulira10: raises 27865 to 29865 and is all-in
Spectral34: calls 17543 and is all-in
Uncalled bet (10322) returned to lulira10
*** FLOP *** [3s Ad 3c]
*** TURN *** [3s Ad 3c] [Ts]
*** RIVER *** [3s Ad 3c Ts] [9d]
*** SHOW DOWN ***
lulira10: shows [6h 6d] (two pair, Sixes and Threes)
Spectral34: shows [Ah 3d] (a full house, Threes full of Aces)
Spectral34 collected 42086 from pot
*** SUMMARY ***
Total pot 42086 | Rake 0 
Board [3s Ad 3c Ts 9d]
Seat 1: Spectral34 (big blind) showed [Ah 3d] and won (42086) with a full house, Threes full of Aces
Seat 2: jack310759 folded before Flop (didn't bet)
Seat 3: Rochinha2011 folded before Flop (didn't bet)
Seat 4: MjLK MAN folded before Flop (didn't bet)
Seat 5: Boogz96 (button) folded before Flop (didn't bet)
Seat 6: lulira10 (small blind) showed [6h 6d] and lost with two pair, Sixes and Threes

PokerStars Hand #251209851722: Tournament #3769361908, $52.38+$2.62 USD Hold'em No Limit - Level XVII (1000/2000) - 2024/06/26 22:51:54 UTC [2024/06/26 18:51:54 ET]
Table '3769361908 11' 6-max Seat #6 is the button
Seat 1: Spectral34 (42086 in chips) 
Seat 2: jack310759 (26183 in chips) 
Seat 3: Rochinha2011 (79758 in chips) 
Seat 4: MjLK MAN (25300 in chips) 
Seat 5: Boogz96 (9000 in chips) 
Seat 6: lulira10 (10322 in chips) 
Spectral34: posts the ante 500
jack310759: posts the ante 500
Rochinha2011: posts the ante 500
MjLK MAN: posts the ante 500
Boogz96: posts the ante 500
lulira10: posts the ante 500
Spectral34: posts small blind 1000
jack310759: posts big blind 2000
*** HOLE CARDS ***
Rochinha2011: folds 
MjLK MAN: folds 
Boogz96: folds 
lulira10: folds 
Spectral34: raises 39586 to 41586 and is all-in
jack310759: folds 
Uncalled bet (39586) returned to Spectral34
Spectral34 collected 7000 from pot
Spectral34: doesn't show hand 
*** SUMMARY ***
Total pot 7000 | Rake 0 
Seat 1: Spectral34 (small blind) collected (7000)
Seat 2: jack310759 (big blind) folded before Flop
Seat 3: Rochinha2011 folded before Flop (didn't bet)
Seat 4: MjLK MAN folded before Flop (didn't bet)
Seat 5: Boogz96 folded before Flop (didn't bet)
Seat 6: lulira10 (button) folded before Flop (didn't bet)

PokerStars Hand #251209856855: Tournament #3769361908, $52.38+$2.62 USD Hold'em No Limit - Level XVII (1000/2000) - 2024/06/26 22:52:15 UTC [2024/06/26 18:52:15 ET]
Table '3769361908 11' 6-max Seat #1 is the button
Seat 1: Spectral34 (46586 in chips) 
Seat 2: jack310759 (23683 in chips) 
Seat 3: Rochinha2011 (79258 in chips) 
Seat 4: MjLK MAN (24800 in chips) 
Seat 5: Boogz96 (8500 in chips) 
Seat 6: lulira10 (9822 in chips) 
Spectral34: posts the ante 500
jack310759: posts the ante 500
Rochinha2011: posts the ante 500
MjLK MAN: posts the ante 500
Boogz96: posts the ante 500
lulira10: posts the ante 500
jack310759: posts small blind 1000
Rochinha2011: posts big blind 2000
*** HOLE CARDS ***
MjLK MAN: folds 
Boogz96: folds 
lulira10: folds 
Spectral34: folds 
jack310759: raises 7000 to 9000
Rochinha2011: raises 69758 to 78758 and is all-in
jack310759: calls 14183 and is all-in
Uncalled bet (55575) returned to Rochinha2011
*** FLOP *** [9s 7h 3c]
*** TURN *** [9s 7h 3c] [3s]
*** RIVER *** [9s 7h 3c 3s] [Kh]
*** SHOW DOWN ***
jack310759: shows [Jc Qc] (a pair of Threes)
Rochinha2011: shows [8h Ac] (a pair of Threes - Ace kicker)
Rochinha2011 collected 49366 from pot
jack310759 finished the tournament in 89th place
*** SUMMARY ***
Total pot 49366 | Rake 0 
Board [9s 7h 3c 3s Kh]
Seat 1: Spectral34 (button) folded before Flop (didn't bet)
Seat 2: jack310759 (small blind) showed [Jc Qc] and lost with a pair of Threes
Seat 3: Rochinha2011 (big blind) showed [8h Ac] and won (49366) with a pair of Threes
Seat 4: MjLK MAN folded before Flop (didn't bet)
Seat 5: Boogz96 folded before Flop (didn't bet)
Seat 6: lulira10 folded before Flop (didn't bet)

PokerStars Hand #251209868064: Tournament #3769361908, $52.38+$2.62 USD Hold'em No Limit - Level XVII (1000/2000) - 2024/06/26 22:53:01 UTC [2024/06/26 18:53:01 ET]
Table '3769361908 11' 6-max Seat #3 is the button
Seat 1: Spectral34 (46086 in chips) 
Seat 3: Rochinha2011 (104941 in chips) 
Seat 4: MjLK MAN (24300 in chips) 
Seat 5: Boogz96 (8000 in chips) 
Seat 6: lulira10 (9322 in chips) 
Spectral34: posts the ante 500
Rochinha2011: posts the ante 500
MjLK MAN: posts the ante 500
Boogz96: posts the ante 500
lulira10: posts the ante 500
MjLK MAN: posts small blind 1000
Boogz96: posts big blind 2000
*** HOLE CARDS ***
lulira10: raises 6822 to 8822 and is all-in
Spectral34: folds 
Rochinha2011: raises 95619 to 104441 and is all-in
MjLK MAN: folds 
Boogz96: folds 
Uncalled bet (95619) returned to Rochinha2011
*** FLOP *** [2d 4c 4d]
*** TURN *** [2d 4c 4d] [Qc]
*** RIVER *** [2d 4c 4d Qc] [5h]
*** SHOW DOWN ***
lulira10: shows [Tc Js] (a pair of Fours)
Rochinha2011: shows [6c 6s] (two pair, Sixes and Fours)
Rochinha2011 collected 23144 from pot
lulira10 finished the tournament in 87th place
*** SUMMARY ***
Total pot 23144 | Rake 0 
Board [2d 4c 4d Qc 5h]
Seat 1: Spectral34 folded before Flop (didn't bet)
Seat 3: Rochinha2011 (button) showed [6c 6s] and won (23144) with two pair, Sixes and Fours
Seat 4: MjLK MAN (small blind) folded before Flop
Seat 5: Boogz96 (big blind) folded before Flop
Seat 6: lulira10 showed [Tc Js] and lost with a pair of Fours

PokerStars Hand #251209877847: Tournament #3769361908, $52.38+$2.62 USD Hold'em No Limit - Level XVIII (1200/2400) - 2024/06/26 22:53:41 UTC [2024/06/26 18:53:41 ET]
Table '3769361908 11' 6-max Seat #4 is the button
Seat 1: Spectral34 (45586 in chips) 
Seat 2: DuduLôbo2012 (36990 in chips) 
Seat 3: Rochinha2011 (118763 in chips) 
Seat 4: MjLK MAN (22800 in chips) 
Seat 5: Boogz96 (5500 in chips) 
Spectral34: posts the ante 600
DuduLôbo2012: posts the ante 600
Rochinha2011: posts the ante 600
MjLK MAN: posts the ante 600
Boogz96: posts the ante 600
Boogz96: posts small blind 1200
Spectral34: posts big blind 2400
*** HOLE CARDS ***
DuduLôbo2012: folds 
Rochinha2011: folds 
leocir25 is disconnected 
MjLK MAN: raises 19800 to 22200 and is all-in
Boogz96: folds 
Spectral34: folds 
Uncalled bet (19800) returned to MjLK MAN
MjLK MAN collected 9000 from pot
MjLK MAN: doesn't show hand 
*** SUMMARY ***
Total pot 9000 | Rake 0 
Seat 1: Spectral34 (big blind) folded before Flop
Seat 2: DuduLôbo2012 folded before Flop (didn't bet)
Seat 3: Rochinha2011 folded before Flop (didn't bet)
Seat 4: MjLK MAN (button) collected (9000)
Seat 5: Boogz96 (small blind) folded before Flop

PokerStars Hand #251209883513: Tournament #3769361908, $52.38+$2.62 USD Hold'em No Limit - Level XVIII (1200/2400) - 2024/06/26 22:54:04 UTC [2024/06/26 18:54:04 ET]
Table '3769361908 11' 6-max Seat #5 is the button
Seat 1: Spectral34 (42586 in chips) 
Seat 2: DuduLôbo2012 (36390 in chips) 
Seat 3: Rochinha2011 (118163 in chips) 
Seat 4: MjLK MAN (28800 in chips) 
Seat 5: Boogz96 (3700 in chips) 
Seat 6: leocir25 (104270 in chips) out of hand (moved from another table into small blind)
leocir25 will be allowed to play after the button
Spectral34: posts the ante 600
DuduLôbo2012: posts the ante 600
Rochinha2011: posts the ante 600
MjLK MAN: posts the ante 600
Boogz96: posts the ante 600
Spectral34: posts small blind 1200
DuduLôbo2012: posts big blind 2400
*** HOLE CARDS ***
Rochinha2011: raises 2400 to 4800
MjLK MAN: folds 
Boogz96: folds 
Spectral34: folds 
DuduLôbo2012: folds 
Uncalled bet (2400) returned to Rochinha2011
Rochinha2011 collected 9000 from pot
Rochinha2011: doesn't show hand 
*** SUMMARY ***
Total pot 9000 | Rake 0 
Seat 1: Spectral34 (small blind) folded before Flop
Seat 2: DuduLôbo2012 (big blind) folded before Flop
Seat 3: Rochinha2011 collected (9000)
Seat 4: MjLK MAN folded before Flop (didn't bet)
Seat 5: Boogz96 (button) folded before Flop (didn't bet)

PokerStars Hand #251209891624: Tournament #3769361908, $52.38+$2.62 USD Hold'em No Limit - Level XVIII (1200/2400) - 2024/06/26 22:54:38 UTC [2024/06/26 18:54:38 ET]
Table '3769361908 11' 6-max Seat #1 is the button
Seat 1: Spectral34 (40786 in chips) 
Seat 2: DuduLôbo2012 (33390 in chips) 
Seat 3: Rochinha2011 (124163 in chips) 
Seat 4: MjLK MAN (28200 in chips) 
Seat 5: Boogz96 (3100 in chips) 
Seat 6: leocir25 (104270 in chips) 
Spectral34: posts the ante 600
DuduLôbo2012: posts the ante 600
Rochinha2011: posts the ante 600
MjLK MAN: posts the ante 600
Boogz96: posts the ante 600
leocir25: posts the ante 600
DuduLôbo2012: posts small blind 1200
Rochinha2011: posts big blind 2400
*** HOLE CARDS ***
MjLK MAN: folds 
Boogz96: raises 100 to 2500 and is all-in
leocir25: folds 
Spectral34: folds 
DuduLôbo2012: raises 30290 to 32790 and is all-in
Rochinha2011: folds 
Uncalled bet (30290) returned to DuduLôbo2012
*** FLOP *** [Qd Kh 3h]
*** TURN *** [Qd Kh 3h] [3c]
*** RIVER *** [Qd Kh 3h 3c] [Qh]
*** SHOW DOWN ***
DuduLôbo2012: shows [8h Ah] (a flush, Ace high)
Boogz96: shows [9d Kc] (two pair, Kings and Queens)
DuduLôbo2012 collected 11000 from pot
Boogz96 finished the tournament in 76th place
*** SUMMARY ***
Total pot 11000 | Rake 0 
Board [Qd Kh 3h 3c Qh]
Seat 1: Spectral34 (button) folded before Flop (didn't bet)
Seat 2: DuduLôbo2012 (small blind) showed [8h Ah] and won (11000) with a flush, Ace high
Seat 3: Rochinha2011 (big blind) folded before Flop
Seat 4: MjLK MAN folded before Flop (didn't bet)
Seat 5: Boogz96 showed [9d Kc] and lost with two pair, Kings and Queens
Seat 6: leocir25 folded before Flop (didn't bet)

PokerStars Hand #251209964589: Tournament #3769361908, $52.38+$2.62 USD Hold'em No Limit - Level XVIII (1200/2400) - 2024/06/26 23:01:09 UTC [2024/06/26 19:01:09 ET]
Table '3769361908 11' 6-max Seat #2 is the button
Seat 1: Spectral34 (40186 in chips) 
Seat 2: DuduLôbo2012 (41290 in chips) 
Seat 3: Rochinha2011 (121163 in chips) 
Seat 4: MjLK MAN (27600 in chips) 
Seat 5: mila is best (35374 in chips) 
Seat 6: leocir25 (103670 in chips) 
Spectral34: posts the ante 600
DuduLôbo2012: posts the ante 600
Rochinha2011: posts the ante 600
MjLK MAN: posts the ante 600
mila is best: posts the ante 600
leocir25: posts the ante 600
Rochinha2011: posts small blind 1200
MjLK MAN: posts big blind 2400
*** HOLE CARDS ***
mila is best: folds 
leocir25: folds 
Spectral34: raises 2400 to 4800
DuduLôbo2012: folds 
Rochinha2011: folds 
MjLK MAN: folds 
Uncalled bet (2400) returned to Spectral34
Spectral34 collected 9600 from pot
Spectral34: doesn't show hand 
*** SUMMARY ***
Total pot 9600 | Rake 0 
Seat 1: Spectral34 collected (9600)
Seat 2: DuduLôbo2012 (button) folded before Flop (didn't bet)
Seat 3: Rochinha2011 (small blind) folded before Flop
Seat 4: MjLK MAN (big blind) folded before Flop
Seat 5: mila is best folded before Flop (didn't bet)
Seat 6: leocir25 folded before Flop (didn't bet)

PokerStars Hand #251209976820: Tournament #3769361908, $52.38+$2.62 USD Hold'em No Limit - Level XVIII (1200/2400) - 2024/06/26 23:02:03 UTC [2024/06/26 19:02:03 ET]
Table '3769361908 11' 6-max Seat #3 is the button
Seat 1: Spectral34 (46786 in chips) 
Seat 2: DuduLôbo2012 (40690 in chips) 
Seat 3: Rochinha2011 (119363 in chips) 
Seat 4: MjLK MAN (24600 in chips) 
Seat 5: mila is best (34774 in chips) 
Seat 6: leocir25 (103070 in chips) 
Spectral34: posts the ante 600
DuduLôbo2012: posts the ante 600
Rochinha2011: posts the ante 600
MjLK MAN: posts the ante 600
mila is best: posts the ante 600
leocir25: posts the ante 600
MjLK MAN: posts small blind 1200
mila is best: posts big blind 2400
*** HOLE CARDS ***
leocir25: folds 
Spectral34: folds 
DuduLôbo2012: folds 
Rochinha2011: folds 
MjLK MAN: raises 21600 to 24000 and is all-in
mila is best: folds 
Uncalled bet (21600) returned to MjLK MAN
MjLK MAN collected 8400 from pot
MjLK MAN: doesn't show hand 
*** SUMMARY ***
Total pot 8400 | Rake 0 
Seat 1: Spectral34 folded before Flop (didn't bet)
Seat 2: DuduLôbo2012 folded before Flop (didn't bet)
Seat 3: Rochinha2011 (button) folded before Flop (didn't bet)
Seat 4: MjLK MAN (small blind) collected (8400)
Seat 5: mila is best (big blind) folded before Flop
Seat 6: leocir25 folded before Flop (didn't bet)

PokerStars Hand #251209991711: Tournament #3769361908, $52.38+$2.62 USD Hold'em No Limit - Level XIX (1400/2800) - 2024/06/26 23:03:07 UTC [2024/06/26 19:03:07 ET]
Table '3769361908 11' 6-max Seat #4 is the button
Seat 1: Spectral34 (46186 in chips) 
Seat 2: DuduLôbo2012 (40090 in chips) 
Seat 3: Rochinha2011 (118763 in chips) 
Seat 4: MjLK MAN (30000 in chips) 
Seat 5: mila is best (31774 in chips) 
Seat 6: leocir25 (102470 in chips) 
Spectral34: posts the ante 700
DuduLôbo2012: posts the ante 700
Rochinha2011: posts the ante 700
MjLK MAN: posts the ante 700
mila is best: posts the ante 700
leocir25: posts the ante 700
mila is best: posts small blind 1400
leocir25: posts big blind 2800
*** HOLE CARDS ***
Spectral34: folds 
DuduLôbo2012: folds 
Rochinha2011: raises 2800 to 5600
MjLK MAN: raises 23700 to 29300 and is all-in
mila is best: folds 
leocir25: folds 
Rochinha2011: folds 
Uncalled bet (23700) returned to MjLK MAN
MjLK MAN collected 19600 from pot
MjLK MAN: doesn't show hand 
*** SUMMARY ***
Total pot 19600 | Rake 0 
Seat 1: Spectral34 folded before Flop (didn't bet)
Seat 2: DuduLôbo2012 folded before Flop (didn't bet)
Seat 3: Rochinha2011 folded before Flop
Seat 4: MjLK MAN (button) collected (19600)
Seat 5: mila is best (small blind) folded before Flop
Seat 6: leocir25 (big blind) folded before Flop

PokerStars Hand #251210003671: Tournament #3769361908, $52.38+$2.62 USD Hold'em No Limit - Level XIX (1400/2800) - 2024/06/26 23:03:58 UTC [2024/06/26 19:03:58 ET]
Table '3769361908 11' 6-max Seat #5 is the button
Seat 1: Spectral34 (45486 in chips) 
Seat 2: DuduLôbo2012 (39390 in chips) 
Seat 3: Rochinha2011 (112463 in chips) 
Seat 4: MjLK MAN (43300 in chips) 
Seat 5: mila is best (29674 in chips) 
Seat 6: leocir25 (98970 in chips) 
Spectral34: posts the ante 700
DuduLôbo2012: posts the ante 700
Rochinha2011: posts the ante 700
MjLK MAN: posts the ante 700
mila is best: posts the ante 700
leocir25: posts the ante 700
leocir25: posts small blind 1400
Spectral34: posts big blind 2800
*** HOLE CARDS ***
DuduLôbo2012: folds 
Rochinha2011: folds 
MjLK MAN: folds 
mila is best: folds 
leocir25: raises 95470 to 98270 and is all-in
Spectral34: folds 
Uncalled bet (95470) returned to leocir25
leocir25 collected 9800 from pot
*** SUMMARY ***
Total pot 9800 | Rake 0 
Seat 1: Spectral34 (big blind) folded before Flop
Seat 2: DuduLôbo2012 folded before Flop (didn't bet)
Seat 3: Rochinha2011 folded before Flop (didn't bet)
Seat 4: MjLK MAN folded before Flop (didn't bet)
Seat 5: mila is best (button) folded before Flop (didn't bet)
Seat 6: leocir25 (small blind) collected (9800)

PokerStars Hand #251210016331: Tournament #3769361908, $52.38+$2.62 USD Hold'em No Limit - Level XIX (1400/2800) - 2024/06/26 23:04:53 UTC [2024/06/26 19:04:53 ET]
Table '3769361908 11' 6-max Seat #6 is the button
Seat 1: Spectral34 (41986 in chips) 
Seat 2: DuduLôbo2012 (38690 in chips) 
Seat 3: Rochinha2011 (111763 in chips) 
Seat 4: MjLK MAN (42600 in chips) 
Seat 5: mila is best (28974 in chips) 
Seat 6: leocir25 (105270 in chips) 
Spectral34: posts the ante 700
DuduLôbo2012: posts the ante 700
Rochinha2011: posts the ante 700
MjLK MAN: posts the ante 700
mila is best: posts the ante 700
leocir25: posts the ante 700
Spectral34: posts small blind 1400
DuduLôbo2012: posts big blind 2800
*** HOLE CARDS ***
Rochinha2011: raises 2800 to 5600
MjLK MAN: folds 
mila is best: folds 
leocir25: folds 
Spectral34: folds 
DuduLôbo2012: folds 
Uncalled bet (2800) returned to Rochinha2011
Rochinha2011 collected 11200 from pot
Rochinha2011: doesn't show hand 
*** SUMMARY ***
Total pot 11200 | Rake 0 
Seat 1: Spectral34 (small blind) folded before Flop
Seat 2: DuduLôbo2012 (big blind) folded before Flop
Seat 3: Rochinha2011 collected (11200)
Seat 4: MjLK MAN folded before Flop (didn't bet)
Seat 5: mila is best folded before Flop (didn't bet)
Seat 6: leocir25 (button) folded before Flop (didn't bet)

PokerStars Hand #251210030467: Tournament #3769361908, $52.38+$2.62 USD Hold'em No Limit - Level XX (1600/3200) - 2024/06/26 23:05:54 UTC [2024/06/26 19:05:54 ET]
Table '3769361908 11' 6-max Seat #1 is the button
Seat 1: Spectral34 (39886 in chips) 
Seat 2: DuduLôbo2012 (35190 in chips) 
Seat 3: Rochinha2011 (119463 in chips) 
Seat 4: MjLK MAN (41900 in chips) 
Seat 5: mila is best (28274 in chips) 
Seat 6: leocir25 (104570 in chips) 
Spectral34: posts the ante 800
DuduLôbo2012: posts the ante 800
Rochinha2011: posts the ante 800
MjLK MAN: posts the ante 800
mila is best: posts the ante 800
leocir25: posts the ante 800
DuduLôbo2012: posts small blind 1600
Rochinha2011: posts big blind 3200
*** HOLE CARDS ***
MjLK MAN: raises 37900 to 41100 and is all-in
mila is best: folds 
leocir25: folds 
Spectral34: folds 
DuduLôbo2012: folds 
Rochinha2011: folds 
Uncalled bet (37900) returned to MjLK MAN
MjLK MAN collected 12800 from pot
MjLK MAN: doesn't show hand 
*** SUMMARY ***
Total pot 12800 | Rake 0 
Seat 1: Spectral34 (button) folded before Flop (didn't bet)
Seat 2: DuduLôbo2012 (small blind) folded before Flop
Seat 3: Rochinha2011 (big blind) folded before Flop
Seat 4: MjLK MAN collected (12800)
Seat 5: mila is best folded before Flop (didn't bet)
Seat 6: leocir25 folded before Flop (didn't bet)

PokerStars Hand #251210044318: Tournament #3769361908, $52.38+$2.62 USD Hold'em No Limit - Level XX (1600/3200) - 2024/06/26 23:06:55 UTC [2024/06/26 19:06:55 ET]
Table '3769361908 11' 6-max Seat #2 is the button
Seat 1: Spectral34 (39086 in chips) 
Seat 2: DuduLôbo2012 (32790 in chips) 
Seat 3: Rochinha2011 (115463 in chips) 
Seat 4: MjLK MAN (50700 in chips) 
Seat 5: mila is best (27474 in chips) 
Seat 6: leocir25 (103770 in chips) 
Spectral34: posts the ante 800
DuduLôbo2012: posts the ante 800
Rochinha2011: posts the ante 800
MjLK MAN: posts the ante 800
mila is best: posts the ante 800
leocir25: posts the ante 800
Rochinha2011: posts small blind 1600
MjLK MAN: posts big blind 3200
*** HOLE CARDS ***
mila is best: folds 
leocir25: folds 
Spectral34: folds 
DuduLôbo2012: folds 
Rochinha2011: raises 111463 to 114663 and is all-in
MjLK MAN: folds 
Uncalled bet (111463) returned to Rochinha2011
Rochinha2011 collected 11200 from pot
Rochinha2011: doesn't show hand 
*** SUMMARY ***
Total pot 11200 | Rake 0 
Seat 1: Spectral34 folded before Flop (didn't bet)
Seat 2: DuduLôbo2012 (button) folded before Flop (didn't bet)
Seat 3: Rochinha2011 (small blind) collected (11200)
Seat 4: MjLK MAN (big blind) folded before Flop
Seat 5: mila is best folded before Flop (didn't bet)
Seat 6: leocir25 folded before Flop (didn't bet)

PokerStars Hand #251210056406: Tournament #3769361908, $52.38+$2.62 USD Hold'em No Limit - Level XX (1600/3200) - 2024/06/26 23:07:48 UTC [2024/06/26 19:07:48 ET]
Table '3769361908 11' 6-max Seat #3 is the button
Seat 1: Spectral34 (38286 in chips) 
Seat 2: DuduLôbo2012 (31990 in chips) 
Seat 3: Rochinha2011 (122663 in chips) 
Seat 4: MjLK MAN (46700 in chips) 
Seat 5: mila is best (26674 in chips) 
Seat 6: leocir25 (102970 in chips) 
Spectral34: posts the ante 800
DuduLôbo2012: posts the ante 800
Rochinha2011: posts the ante 800
MjLK MAN: posts the ante 800
mila is best: posts the ante 800
leocir25: posts the ante 800
MjLK MAN: posts small blind 1600
mila is best: posts big blind 3200
*** HOLE CARDS ***
leocir25: folds 
Spectral34: folds 
DuduLôbo2012: folds 
Rochinha2011: raises 118663 to 121863 and is all-in
MjLK MAN: folds 
mila is best: folds 
Uncalled bet (118663) returned to Rochinha2011
Rochinha2011 collected 12800 from pot
Rochinha2011: doesn't show hand 
*** SUMMARY ***
Total pot 12800 | Rake 0 
Seat 1: Spectral34 folded before Flop (didn't bet)
Seat 2: DuduLôbo2012 folded before Flop (didn't bet)
Seat 3: Rochinha2011 (button) collected (12800)
Seat 4: MjLK MAN (small blind) folded before Flop
Seat 5: mila is best (big blind) folded before Flop
Seat 6: leocir25 folded before Flop (didn't bet)

PokerStars Hand #251210070803: Tournament #3769361908, $52.38+$2.62 USD Hold'em No Limit - Level XXI (1800/3600) - 2024/06/26 23:08:53 UTC [2024/06/26 19:08:53 ET]
Table '3769361908 11' 6-max Seat #4 is the button
Seat 1: Spectral34 (37486 in chips) 
Seat 2: DuduLôbo2012 (31190 in chips) 
Seat 3: Rochinha2011 (131463 in chips) 
Seat 4: MjLK MAN (44300 in chips) 
Seat 5: mila is best (22674 in chips) 
Seat 6: leocir25 (102170 in chips) 
Spectral34: posts the ante 900
DuduLôbo2012: posts the ante 900
Rochinha2011: posts the ante 900
MjLK MAN: posts the ante 900
mila is best: posts the ante 900
leocir25: posts the ante 900
mila is best: posts small blind 1800
leocir25: posts big blind 3600
*** HOLE CARDS ***
Spectral34: folds 
DuduLôbo2012: folds 
Rochinha2011: raises 3600 to 7200
MjLK MAN: folds 
mila is best: folds 
leocir25: calls 3600
*** FLOP *** [As 9s Qs]
leocir25: checks 
Rochinha2011: bets 5400
leocir25: folds 
Uncalled bet (5400) returned to Rochinha2011
Rochinha2011 collected 21600 from pot
Rochinha2011: doesn't show hand 
*** SUMMARY ***
Total pot 21600 | Rake 0 
Board [As 9s Qs]
Seat 1: Spectral34 folded before Flop (didn't bet)
Seat 2: DuduLôbo2012 folded before Flop (didn't bet)
Seat 3: Rochinha2011 collected (21600)
Seat 4: MjLK MAN (button) folded before Flop (didn't bet)
Seat 5: mila is best (small blind) folded before Flop
Seat 6: leocir25 (big blind) folded on the Flop

PokerStars Hand #251210096828: Tournament #3769361908, $52.38+$2.62 USD Hold'em No Limit - Level XXI (1800/3600) - 2024/06/26 23:10:50 UTC [2024/06/26 19:10:50 ET]
Table '3769361908 11' 6-max Seat #5 is the button
Seat 1: Spectral34 (36586 in chips) 
Seat 2: DuduLôbo2012 (30290 in chips) 
Seat 3: Rochinha2011 (144963 in chips) 
Seat 4: MjLK MAN (43400 in chips) 
Seat 5: mila is best (19974 in chips) 
Seat 6: leocir25 (94070 in chips) 
Spectral34: posts the ante 900
DuduLôbo2012: posts the ante 900
Rochinha2011: posts the ante 900
MjLK MAN: posts the ante 900
mila is best: posts the ante 900
leocir25: posts the ante 900
leocir25: posts small blind 1800
Spectral34: posts big blind 3600
*** HOLE CARDS ***
DuduLôbo2012 has timed out
DuduLôbo2012: folds 
DuduLôbo2012 is sitting out
DuduLôbo2012 has returned
Rochinha2011: raises 3600 to 7200
MjLK MAN: folds 
mila is best: folds 
leocir25: folds 
Spectral34: folds 
Uncalled bet (3600) returned to Rochinha2011
Rochinha2011 collected 14400 from pot
Rochinha2011: doesn't show hand 
*** SUMMARY ***
Total pot 14400 | Rake 0 
Seat 1: Spectral34 (big blind) folded before Flop
Seat 2: DuduLôbo2012 folded before Flop (didn't bet)
Seat 3: Rochinha2011 collected (14400)
Seat 4: MjLK MAN folded before Flop (didn't bet)
Seat 5: mila is best (button) folded before Flop (didn't bet)
Seat 6: leocir25 (small blind) folded before Flop

PokerStars Hand #251210112311: Tournament #3769361908, $52.38+$2.62 USD Hold'em No Limit - Level XXII (2000/4000) - 2024/06/26 23:12:02 UTC [2024/06/26 19:12:02 ET]
Table '3769361908 11' 6-max Seat #6 is the button
Seat 1: Spectral34 (32086 in chips) 
Seat 2: DuduLôbo2012 (29390 in chips) 
Seat 3: Rochinha2011 (154863 in chips) 
Seat 4: MjLK MAN (42500 in chips) 
Seat 5: mila is best (19074 in chips) 
Seat 6: leocir25 (91370 in chips) 
Spectral34: posts the ante 1000
DuduLôbo2012: posts the ante 1000
Rochinha2011: posts the ante 1000
MjLK MAN: posts the ante 1000
mila is best: posts the ante 1000
leocir25: posts the ante 1000
Spectral34: posts small blind 2000
DuduLôbo2012: posts big blind 4000
*** HOLE CARDS ***
Rochinha2011: raises 149863 to 153863 and is all-in
MjLK MAN has timed out
MjLK MAN: folds 
MjLK MAN is sitting out
MjLK MAN has returned
mila is best: folds 
leocir25: folds 
Spectral34: folds 
DuduLôbo2012: folds 
Uncalled bet (149863) returned to Rochinha2011
Rochinha2011 collected 16000 from pot
Rochinha2011: doesn't show hand 
*** SUMMARY ***
Total pot 16000 | Rake 0 
Seat 1: Spectral34 (small blind) folded before Flop
Seat 2: DuduLôbo2012 (big blind) folded before Flop
Seat 3: Rochinha2011 collected (16000)
Seat 4: MjLK MAN folded before Flop (didn't bet)
Seat 5: mila is best folded before Flop (didn't bet)
Seat 6: leocir25 (button) folded before Flop (didn't bet)

PokerStars Hand #251210129374: Tournament #3769361908, $52.38+$2.62 USD Hold'em No Limit - Level XXII (2000/4000) - 2024/06/26 23:13:21 UTC [2024/06/26 19:13:21 ET]
Table '3769361908 11' 6-max Seat #1 is the button
Seat 1: Spectral34 (29086 in chips) 
Seat 2: DuduLôbo2012 (24390 in chips) 
Seat 3: Rochinha2011 (165863 in chips) 
Seat 4: MjLK MAN (41500 in chips) 
Seat 5: mila is best (18074 in chips) 
Seat 6: leocir25 (90370 in chips) 
Spectral34: posts the ante 1000
DuduLôbo2012: posts the ante 1000
Rochinha2011: posts the ante 1000
MjLK MAN: posts the ante 1000
mila is best: posts the ante 1000
leocir25: posts the ante 1000
DuduLôbo2012: posts small blind 2000
Rochinha2011: posts big blind 4000
*** HOLE CARDS ***
MjLK MAN: folds 
mila is best: folds 
leocir25: raises 4000 to 8000
Spectral34: folds 
DuduLôbo2012: raises 15390 to 23390 and is all-in
Rochinha2011: folds 
leocir25: calls 15390
*** FLOP *** [9d 2c 2s]
*** TURN *** [9d 2c 2s] [2d]
*** RIVER *** [9d 2c 2s 2d] [Td]
*** SHOW DOWN ***
DuduLôbo2012: shows [4s As] (three of a kind, Deuces)
leocir25: shows [Ks 7s] (three of a kind, Deuces - lower kicker)
DuduLôbo2012 collected 56780 from pot
*** SUMMARY ***
Total pot 56780 | Rake 0 
Board [9d 2c 2s 2d Td]
Seat 1: Spectral34 (button) folded before Flop (didn't bet)
Seat 2: DuduLôbo2012 (small blind) showed [4s As] and won (56780) with three of a kind, Deuces
Seat 3: Rochinha2011 (big blind) folded before Flop
Seat 4: MjLK MAN folded before Flop (didn't bet)
Seat 5: mila is best folded before Flop (didn't bet)
Seat 6: leocir25 showed [Ks 7s] and lost with three of a kind, Deuces

PokerStars Hand #251210137105: Tournament #3769361908, $52.38+$2.62 USD Hold'em No Limit - Level XXII (2000/4000) - 2024/06/26 23:13:57 UTC [2024/06/26 19:13:57 ET]
Table '3769361908 11' 6-max Seat #2 is the button
Seat 1: Spectral34 (28086 in chips) 
Seat 2: DuduLôbo2012 (56780 in chips) 
Seat 3: Rochinha2011 (160863 in chips) 
Seat 4: MjLK MAN (40500 in chips) 
Seat 5: mila is best (17074 in chips) 
Seat 6: leocir25 (65980 in chips) 
Spectral34: posts the ante 1000
DuduLôbo2012: posts the ante 1000
Rochinha2011: posts the ante 1000
MjLK MAN: posts the ante 1000
mila is best: posts the ante 1000
leocir25: posts the ante 1000
Rochinha2011: posts small blind 2000
MjLK MAN: posts big blind 4000
*** HOLE CARDS ***
mila is best: folds 
leocir25: raises 60980 to 64980 and is all-in
Spectral34: folds 
DuduLôbo2012: folds 
Rochinha2011: folds 
MjLK MAN has timed out
MjLK MAN: folds 
MjLK MAN is sitting out
Uncalled bet (60980) returned to leocir25
MjLK MAN has returned
leocir25 collected 16000 from pot
*** SUMMARY ***
Total pot 16000 | Rake 0 
Seat 1: Spectral34 folded before Flop (didn't bet)
Seat 2: DuduLôbo2012 (button) folded before Flop (didn't bet)
Seat 3: Rochinha2011 (small blind) folded before Flop
Seat 4: MjLK MAN (big blind) folded before Flop
Seat 5: mila is best folded before Flop (didn't bet)
Seat 6: leocir25 collected (16000)

PokerStars Hand #251210146025: Tournament #3769361908, $52.38+$2.62 USD Hold'em No Limit - Level XXIII (2500/5000) - 2024/06/26 23:14:39 UTC [2024/06/26 19:14:39 ET]
Table '3769361908 11' 6-max Seat #3 is the button
Seat 1: Spectral34 (27086 in chips) 
Seat 2: DuduLôbo2012 (55780 in chips) 
Seat 3: Rochinha2011 (157863 in chips) 
Seat 4: MjLK MAN (35500 in chips) 
Seat 5: mila is best (16074 in chips) 
Seat 6: leocir25 (76980 in chips) 
Spectral34: posts the ante 1250
DuduLôbo2012: posts the ante 1250
Rochinha2011: posts the ante 1250
MjLK MAN: posts the ante 1250
mila is best: posts the ante 1250
leocir25: posts the ante 1250
MjLK MAN: posts small blind 2500
mila is best: posts big blind 5000
*** HOLE CARDS ***
leocir25: folds 
Spectral34: folds 
DuduLôbo2012: folds 
Rochinha2011: raises 151613 to 156613 and is all-in
MjLK MAN: folds 
mila is best: calls 9824 and is all-in
Uncalled bet (141789) returned to Rochinha2011
*** FLOP *** [Ad Ts 5c]
*** TURN *** [Ad Ts 5c] [8d]
*** RIVER *** [Ad Ts 5c 8d] [Kc]
*** SHOW DOWN ***
mila is best: shows [3c Td] (a pair of Tens)
Rochinha2011: shows [Jc 8c] (a pair of Eights)
mila is best collected 39648 from pot
*** SUMMARY ***
Total pot 39648 | Rake 0 
Board [Ad Ts 5c 8d Kc]
Seat 1: Spectral34 folded before Flop (didn't bet)
Seat 2: DuduLôbo2012 folded before Flop (didn't bet)
Seat 3: Rochinha2011 (button) showed [Jc 8c] and lost with a pair of Eights
Seat 4: MjLK MAN (small blind) folded before Flop
Seat 5: mila is best (big blind) showed [3c Td] and won (39648) with a pair of Tens
Seat 6: leocir25 folded before Flop (didn't bet)

PokerStars Hand #251210152634: Tournament #3769361908, $52.38+$2.62 USD Hold'em No Limit - Level XXIII (2500/5000) - 2024/06/26 23:15:10 UTC [2024/06/26 19:15:10 ET]
Table '3769361908 11' 6-max Seat #4 is the button
Seat 1: Spectral34 (25836 in chips) 
Seat 3: Rochinha2011 (141789 in chips) 
Seat 4: MjLK MAN (31750 in chips) 
Seat 5: mila is best (39648 in chips) 
Seat 6: leocir25 (75730 in chips) 
Spectral34: posts the ante 1250
Rochinha2011: posts the ante 1250
MjLK MAN: posts the ante 1250
mila is best: posts the ante 1250
leocir25: posts the ante 1250
mila is best: posts small blind 2500
leocir25: posts big blind 5000
*** HOLE CARDS ***
Spectral34: raises 19586 to 24586 and is all-in
Rochinha2011: folds 
MjLK MAN: raises 5914 to 30500 and is all-in
mila is best: folds 
aapetrone91 is disconnected 
leocir25: folds 
Uncalled bet (5914) returned to MjLK MAN
*** FLOP *** [4h Js Td]
*** TURN *** [4h Js Td] [Ac]
*** RIVER *** [4h Js Td Ac] [2d]
*** SHOW DOWN ***
Spectral34: shows [7c 7s] (a pair of Sevens)
MjLK MAN: shows [4c 4d] (three of a kind, Fours)
MjLK MAN collected 62922 from pot
Spectral34 finished the tournament in 48th place and received $91.90.
*** SUMMARY ***
Total pot 62922 | Rake 0 
Board [4h Js Td Ac 2d]
Seat 1: Spectral34 showed [7c 7s] and lost with a pair of Sevens
Seat 3: Rochinha2011 folded before Flop (didn't bet)
Seat 4: MjLK MAN (button) showed [4c 4d] and won (62922) with three of a kind, Fours
Seat 5: mila is best (small blind) folded before Flop
Seat 6: leocir25 (big blind) folded before Flop

PokerStars Hand #251210159961: Tournament #3769361908, $52.38+$2.62 USD Hold'em No Limit - Level XXIII (2500/5000) - 2024/06/26 23:15:43 UTC [2024/06/26 19:15:43 ET]
Table '3769361908 11' 6-max Seat #5 is the button
Seat 2: aapetrone91 (124118 in chips) 
Seat 3: Rochinha2011 (140539 in chips) 
Seat 4: MjLK MAN (68836 in chips) 
Seat 5: mila is best (35898 in chips) 
Seat 6: leocir25 (69480 in chips) 
aapetrone91: posts the ante 1250
Rochinha2011: posts the ante 1250
MjLK MAN: posts the ante 1250
mila is best: posts the ante 1250
leocir25: posts the ante 1250
leocir25: posts small blind 2500
aapetrone91: posts big blind 5000
*** HOLE CARDS ***
Rochinha2011: raises 5000 to 10000
MjLK MAN: folds 
mila is best: folds 
leocir25: folds 
aapetrone91: calls 5000
*** FLOP *** [Tc 8d 7d]
aapetrone91: checks 
Rochinha2011: bets 19550
aapetrone91: folds 
Uncalled bet (19550) returned to Rochinha2011
Rochinha2011 collected 28750 from pot
Rochinha2011: doesn't show hand 
*** SUMMARY ***
Total pot 28750 | Rake 0 
Board [Tc 8d 7d]
Seat 2: aapetrone91 (big blind) folded on the Flop
Seat 3: Rochinha2011 collected (28750)
Seat 4: MjLK MAN folded before Flop (didn't bet)
Seat 5: mila is best (button) folded before Flop (didn't bet)
Seat 6: leocir25 (small blind) folded before Flop

PokerStars Hand #251210168089: Tournament #3769361908, $52.38+$2.62 USD Hold'em No Limit - Level XXIII (2500/5000) - 2024/06/26 23:16:22 UTC [2024/06/26 19:16:22 ET]
Table '3769361908 11' 6-max Seat #6 is the button
Seat 2: aapetrone91 (112868 in chips) 
Seat 3: Rochinha2011 (158039 in chips) 
Seat 4: MjLK MAN (67586 in chips) 
Seat 5: mila is best (34648 in chips) 
Seat 6: leocir25 (65730 in chips) 
aapetrone91: posts the ante 1250
Rochinha2011: posts the ante 1250
MjLK MAN: posts the ante 1250
mila is best: posts the ante 1250
leocir25: posts the ante 1250
aapetrone91: posts small blind 2500
Rochinha2011: posts big blind 5000
*** HOLE CARDS ***
MjLK MAN: folds 
mila is best: folds 
leocir25: raises 59480 to 64480 and is all-in
aapetrone91: folds 
Rochinha2011: folds 
Uncalled bet (59480) returned to leocir25
leocir25 collected 18750 from pot
*** SUMMARY ***
Total pot 18750 | Rake 0 
Seat 2: aapetrone91 (small blind) folded before Flop
Seat 3: Rochinha2011 (big blind) folded before Flop
Seat 4: MjLK MAN folded before Flop (didn't bet)
Seat 5: mila is best folded before Flop (didn't bet)
Seat 6: leocir25 (button) collected (18750)

PokerStars Hand #251210172388: Tournament #3769361908, $52.38+$2.62 USD Hold'em No Limit - Level XXIII (2500/5000) - 2024/06/26 23:16:42 UTC [2024/06/26 19:16:42 ET]
Table '3769361908 11' 6-max Seat #2 is the button
Seat 2: aapetrone91 (109118 in chips) 
Seat 3: Rochinha2011 (151789 in chips) 
Seat 4: MjLK MAN (66336 in chips) 
Seat 5: mila is best (33398 in chips) 
Seat 6: leocir25 (78230 in chips) 
aapetrone91: posts the ante 1250
Rochinha2011: posts the ante 1250
MjLK MAN: posts the ante 1250
mila is best: posts the ante 1250
leocir25: posts the ante 1250
Rochinha2011: posts small blind 2500
MjLK MAN: posts big blind 5000
*** HOLE CARDS ***
mila is best: folds 
leocir25: raises 5000 to 10000
aapetrone91: folds 
Rochinha2011: folds 
MjLK MAN: folds 
Uncalled bet (5000) returned to leocir25
leocir25 collected 18750 from pot
*** SUMMARY ***
Total pot 18750 | Rake 0 
Seat 2: aapetrone91 (button) folded before Flop (didn't bet)
Seat 3: Rochinha2011 (small blind) folded before Flop
Seat 4: MjLK MAN (big blind) folded before Flop
Seat 5: mila is best folded before Flop (didn't bet)
Seat 6: leocir25 collected (18750)

PokerStars Hand #251210177266: Tournament #3769361908, $52.38+$2.62 USD Hold'em No Limit - Level XXIII (2500/5000) - 2024/06/26 23:17:04 UTC [2024/06/26 19:17:04 ET]
Table '3769361908 11' 6-max Seat #3 is the button
Seat 2: aapetrone91 (107868 in chips) 
Seat 3: Rochinha2011 (148039 in chips) 
Seat 4: MjLK MAN (60086 in chips) 
Seat 5: mila is best (32148 in chips) 
Seat 6: leocir25 (90730 in chips) 
aapetrone91: posts the ante 1250
Rochinha2011: posts the ante 1250
MjLK MAN: posts the ante 1250
mila is best: posts the ante 1250
leocir25: posts the ante 1250
MjLK MAN: posts small blind 2500
mila is best: posts big blind 5000
*** HOLE CARDS ***
leocir25: raises 10000 to 15000
aapetrone91: raises 91618 to 106618 and is all-in
Rochinha2011: folds 
MjLK MAN: folds 
mila is best: folds 
gusanti is disconnected 
leocir25: calls 74480 and is all-in
Uncalled bet (17138) returned to aapetrone91
*** FLOP *** [Qc 2s 7d]
*** TURN *** [Qc 2s 7d] [9h]
*** RIVER *** [Qc 2s 7d 9h] [Jd]
*** SHOW DOWN ***
leocir25: shows [Ad Qs] (a pair of Queens)
aapetrone91: shows [7s 7c] (three of a kind, Sevens)
aapetrone91 collected 192710 from pot
leocir25 finished the tournament in 42nd place and received $91.90.
*** SUMMARY ***
Total pot 192710 | Rake 0 
Board [Qc 2s 7d 9h Jd]
Seat 2: aapetrone91 showed [7s 7c] and won (192710) with three of a kind, Sevens
Seat 3: Rochinha2011 (button) folded before Flop (didn't bet)
Seat 4: MjLK MAN (small blind) folded before Flop
Seat 5: mila is best (big blind) folded before Flop
Seat 6: leocir25 showed [Ad Qs] and lost with a pair of Queens

PokerStars Hand #251210186791: Tournament #3769361908, $52.38+$2.62 USD Hold'em No Limit - Level XXIV (3000/6000) - 2024/06/26 23:17:49 UTC [2024/06/26 19:17:49 ET]
Table '3769361908 11' 6-max Seat #4 is the button
Seat 1: gusanti (50828 in chips) 
Seat 2: aapetrone91 (209848 in chips) 
Seat 3: Rochinha2011 (146789 in chips) 
Seat 4: MjLK MAN (56336 in chips) 
Seat 5: mila is best (25898 in chips) 
gusanti: posts the ante 1500
aapetrone91: posts the ante 1500
Rochinha2011: posts the ante 1500
MjLK MAN: posts the ante 1500
mila is best: posts the ante 1500
mila is best: posts small blind 3000
gusanti: posts big blind 6000
*** HOLE CARDS ***
aapetrone91: folds 
Rochinha2011: raises 139289 to 145289 and is all-in
MjLK MAN: folds 
mila is best: calls 21398 and is all-in
gusanti: folds 
Uncalled bet (120891) returned to Rochinha2011
*** FLOP *** [Qh 2h 2s]
*** TURN *** [Qh 2h 2s] [Ad]
*** RIVER *** [Qh 2h 2s Ad] [Jc]
*** SHOW DOWN ***
mila is best: shows [9d As] (two pair, Aces and Deuces)
Rochinha2011: shows [9s Js] (two pair, Jacks and Deuces)
mila is best collected 62296 from pot
*** SUMMARY ***
Total pot 62296 | Rake 0 
Board [Qh 2h 2s Ad Jc]
Seat 1: gusanti (big blind) folded before Flop
Seat 2: aapetrone91 folded before Flop (didn't bet)
Seat 3: Rochinha2011 showed [9s Js] and lost with two pair, Jacks and Deuces
Seat 4: MjLK MAN (button) folded before Flop (didn't bet)
Seat 5: mila is best (small blind) showed [9d As] and won (62296) with two pair, Aces and Deuces

PokerStars Hand #251210193457: Tournament #3769361908, $52.38+$2.62 USD Hold'em No Limit - Level XXIV (3000/6000) - 2024/06/26 23:18:21 UTC [2024/06/26 19:18:21 ET]
Table '3769361908 11' 6-max Seat #5 is the button
Seat 1: gusanti (43328 in chips) 
Seat 2: aapetrone91 (208348 in chips) 
Seat 3: Rochinha2011 (120891 in chips) 
Seat 4: MjLK MAN (54836 in chips) 
Seat 5: mila is best (62296 in chips) 
gusanti: posts the ante 1500
aapetrone91: posts the ante 1500
Rochinha2011: posts the ante 1500
MjLK MAN: posts the ante 1500
mila is best: posts the ante 1500
gusanti: posts small blind 3000
aapetrone91: posts big blind 6000
*** HOLE CARDS ***
Rochinha2011: raises 6000 to 12000
MjLK MAN: folds 
mila is best: calls 12000
gusanti: folds 
aapetrone91: folds 
*** FLOP *** [Ac 3d Qs]
Rochinha2011: checks 
mila is best: checks 
*** TURN *** [Ac 3d Qs] [Ad]
Rochinha2011: checks 
mila is best: checks 
*** RIVER *** [Ac 3d Qs Ad] [6d]
Rochinha2011: bets 107391 and is all-in
mila is best: folds 
Uncalled bet (107391) returned to Rochinha2011
Rochinha2011 collected 40500 from pot
Rochinha2011: doesn't show hand 
*** SUMMARY ***
Total pot 40500 | Rake 0 
Board [Ac 3d Qs Ad 6d]
Seat 1: gusanti (small blind) folded before Flop
Seat 2: aapetrone91 (big blind) folded before Flop
Seat 3: Rochinha2011 collected (40500)
Seat 4: MjLK MAN folded before Flop (didn't bet)
Seat 5: mila is best (button) folded on the River

PokerStars Hand #251210204866: Tournament #3769361908, $52.38+$2.62 USD Hold'em No Limit - Level XXIV (3000/6000) - 2024/06/26 23:19:15 UTC [2024/06/26 19:19:15 ET]
Table '3769361908 11' 6-max Seat #1 is the button
Seat 1: gusanti (38828 in chips) 
Seat 2: aapetrone91 (200848 in chips) 
Seat 3: Rochinha2011 (147891 in chips) 
Seat 4: MjLK MAN (53336 in chips) 
Seat 5: mila is best (48796 in chips) 
gusanti: posts the ante 1500
aapetrone91: posts the ante 1500
Rochinha2011: posts the ante 1500
MjLK MAN: posts the ante 1500
mila is best: posts the ante 1500
aapetrone91: posts small blind 3000
Rochinha2011: posts big blind 6000
*** HOLE CARDS ***
MjLK MAN: folds 
mila is best: raises 41296 to 47296 and is all-in
DEERV is disconnected 
gusanti: calls 37328 and is all-in
aapetrone91: folds 
Rochinha2011: folds 
Uncalled bet (9968) returned to mila is best
*** FLOP *** [Qc Qh 9c]
*** TURN *** [Qc Qh 9c] [9s]
*** RIVER *** [Qc Qh 9c 9s] [6s]
*** SHOW DOWN ***
mila is best: shows [Jh Jc] (two pair, Queens and Jacks)
gusanti: shows [Tc Ts] (two pair, Queens and Tens)
mila is best collected 91156 from pot
gusanti finished the tournament in 36th place and received $111.65.
*** SUMMARY ***
Total pot 91156 | Rake 0 
Board [Qc Qh 9c 9s 6s]
Seat 1: gusanti (button) showed [Tc Ts] and lost with two pair, Queens and Tens
Seat 2: aapetrone91 (small blind) folded before Flop
Seat 3: Rochinha2011 (big blind) folded before Flop
Seat 4: MjLK MAN folded before Flop (didn't bet)
Seat 5: mila is best showed [Jh Jc] and won (91156) with two pair, Queens and Jacks

PokerStars Hand #251210211347: Tournament #3769361908, $52.38+$2.62 USD Hold'em No Limit - Level XXIV (3000/6000) - 2024/06/26 23:19:46 UTC [2024/06/26 19:19:46 ET]
Table '3769361908 11' 6-max Seat #2 is the button
Seat 2: aapetrone91 (196348 in chips) 
Seat 3: Rochinha2011 (140391 in chips) 
Seat 4: MjLK MAN (51836 in chips) 
Seat 5: mila is best (101124 in chips) 
Seat 6: DEERV (173020 in chips) 
aapetrone91: posts the ante 1500
Rochinha2011: posts the ante 1500
MjLK MAN: posts the ante 1500
mila is best: posts the ante 1500
DEERV: posts the ante 1500
Rochinha2011: posts small blind 3000
MjLK MAN: posts big blind 6000
*** HOLE CARDS ***
mila is best: folds 
DEERV: folds 
aapetrone91: folds 
Rochinha2011: raises 132891 to 138891 and is all-in
MjLK MAN: calls 44336 and is all-in
Uncalled bet (88555) returned to Rochinha2011
*** FLOP *** [4s 8s 5h]
*** TURN *** [4s 8s 5h] [5s]
*** RIVER *** [4s 8s 5h 5s] [Qd]
*** SHOW DOWN ***
Rochinha2011: shows [Td 9d] (a pair of Fives)
MjLK MAN: shows [As Qh] (two pair, Queens and Fives)
MjLK MAN collected 108172 from pot
*** SUMMARY ***
Total pot 108172 | Rake 0 
Board [4s 8s 5h 5s Qd]
Seat 2: aapetrone91 (button) folded before Flop (didn't bet)
Seat 3: Rochinha2011 (small blind) showed [Td 9d] and lost with a pair of Fives
Seat 4: MjLK MAN (big blind) showed [As Qh] and won (108172) with two pair, Queens and Fives
Seat 5: mila is best folded before Flop (didn't bet)
Seat 6: DEERV folded before Flop (didn't bet)

PokerStars Hand #251210217988: Tournament #3769361908, $52.38+$2.62 USD Hold'em No Limit - Level XXV (3500/7000) - 2024/06/26 23:20:18 UTC [2024/06/26 19:20:18 ET]
Table '3769361908 11' 6-max Seat #3 is the button
Seat 2: aapetrone91 (194848 in chips) 
Seat 3: Rochinha2011 (88555 in chips) 
Seat 4: MjLK MAN (108172 in chips) 
Seat 5: mila is best (99624 in chips) 
Seat 6: DEERV (171520 in chips) 
aapetrone91: posts the ante 1750
Rochinha2011: posts the ante 1750
MjLK MAN: posts the ante 1750
mila is best: posts the ante 1750
DEERV: posts the ante 1750
MjLK MAN: posts small blind 3500
mila is best: posts big blind 7000
*** HOLE CARDS ***
DEERV: folds 
aapetrone91: raises 186098 to 193098 and is all-in
Rochinha2011: folds 
MjLK MAN: folds 
mila is best: folds 
Uncalled bet (186098) returned to aapetrone91
aapetrone91 collected 26250 from pot
*** SUMMARY ***
Total pot 26250 | Rake 0 
Seat 2: aapetrone91 collected (26250)
Seat 3: Rochinha2011 (button) folded before Flop (didn't bet)
Seat 4: MjLK MAN (small blind) folded before Flop
Seat 5: mila is best (big blind) folded before Flop
Seat 6: DEERV folded before Flop (didn't bet)

PokerStars Hand #251210222905: Tournament #3769361908, $52.38+$2.62 USD Hold'em No Limit - Level XXV (3500/7000) - 2024/06/26 23:20:42 UTC [2024/06/26 19:20:42 ET]
Table '3769361908 11' 6-max Seat #4 is the button
Seat 2: aapetrone91 (212348 in chips) 
Seat 3: Rochinha2011 (86805 in chips) 
Seat 4: MjLK MAN (102922 in chips) 
Seat 5: mila is best (90874 in chips) 
Seat 6: DEERV (169770 in chips) 
aapetrone91: posts the ante 1750
Rochinha2011: posts the ante 1750
MjLK MAN: posts the ante 1750
mila is best: posts the ante 1750
DEERV: posts the ante 1750
mila is best: posts small blind 3500
DEERV: posts big blind 7000
*** HOLE CARDS ***
aapetrone91: folds 
Rochinha2011: folds 
MjLK MAN: raises 94172 to 101172 and is all-in
mila is best: folds 
DEERV: folds 
Uncalled bet (94172) returned to MjLK MAN
MjLK MAN collected 26250 from pot
MjLK MAN: doesn't show hand 
*** SUMMARY ***
Total pot 26250 | Rake 0 
Seat 2: aapetrone91 folded before Flop (didn't bet)
Seat 3: Rochinha2011 folded before Flop (didn't bet)
Seat 4: MjLK MAN (button) collected (26250)
Seat 5: mila is best (small blind) folded before Flop
Seat 6: DEERV (big blind) folded before Flop

PokerStars Hand #251210226365: Tournament #3769361908, $52.38+$2.62 USD Hold'em No Limit - Level XXV (3500/7000) - 2024/06/26 23:20:58 UTC [2024/06/26 19:20:58 ET]
Table '3769361908 11' 6-max Seat #5 is the button
Seat 2: aapetrone91 (210598 in chips) 
Seat 3: Rochinha2011 (85055 in chips) 
Seat 4: MjLK MAN (120422 in chips) 
Seat 5: mila is best (85624 in chips) 
Seat 6: DEERV (161020 in chips) 
aapetrone91: posts the ante 1750
Rochinha2011: posts the ante 1750
MjLK MAN: posts the ante 1750
mila is best: posts the ante 1750
DEERV: posts the ante 1750
DEERV: posts small blind 3500
aapetrone91: posts big blind 7000
*** HOLE CARDS ***
davideriksso is disconnected 
Rochinha2011: raises 76305 to 83305 and is all-in
MjLK MAN: folds 
mila is best: folds 
DEERV: folds 
aapetrone91: folds 
Uncalled bet (76305) returned to Rochinha2011
Rochinha2011 collected 26250 from pot
Rochinha2011: doesn't show hand 
*** SUMMARY ***
Total pot 26250 | Rake 0 
Seat 2: aapetrone91 (big blind) folded before Flop
Seat 3: Rochinha2011 collected (26250)
Seat 4: MjLK MAN folded before Flop (didn't bet)
Seat 5: mila is best (button) folded before Flop (didn't bet)
Seat 6: DEERV (small blind) folded before Flop

PokerStars Hand #251210231593: Tournament #3769361908, $52.38+$2.62 USD Hold'em No Limit - Level XXV (3500/7000) - 2024/06/26 23:21:23 UTC [2024/06/26 19:21:23 ET]
Table '3769361908 11' 6-max Seat #6 is the button
Seat 1: davideriksso (181627 in chips) out of hand (moved from another table into small blind)
Seat 2: aapetrone91 (201848 in chips) 
Seat 3: Rochinha2011 (102555 in chips) 
Seat 4: MjLK MAN (118672 in chips) 
Seat 5: mila is best (83874 in chips) 
Seat 6: DEERV (155770 in chips) 
davideriksso will be allowed to play after the button
aapetrone91: posts the ante 1750
Rochinha2011: posts the ante 1750
MjLK MAN: posts the ante 1750
mila is best: posts the ante 1750
DEERV: posts the ante 1750
aapetrone91: posts small blind 3500
Rochinha2011: posts big blind 7000
*** HOLE CARDS ***
MjLK MAN: folds 
mila is best: folds 
DEERV: folds 
aapetrone91: raises 193098 to 200098 and is all-in
Rochinha2011: folds 
Uncalled bet (193098) returned to aapetrone91
aapetrone91 collected 22750 from pot
*** SUMMARY ***
Total pot 22750 | Rake 0 
Seat 2: aapetrone91 (small blind) collected (22750)
Seat 3: Rochinha2011 (big blind) folded before Flop
Seat 4: MjLK MAN folded before Flop (didn't bet)
Seat 5: mila is best folded before Flop (didn't bet)
Seat 6: DEERV (button) folded before Flop (didn't bet)

PokerStars Hand #251210235903: Tournament #3769361908, $52.38+$2.62 USD Hold'em No Limit - Level XXV (3500/7000) - 2024/06/26 23:21:44 UTC [2024/06/26 19:21:44 ET]
Table '3769361908 11' 6-max Seat #2 is the button
Seat 1: davideriksso (181627 in chips) 
Seat 2: aapetrone91 (215848 in chips) 
Seat 3: Rochinha2011 (93805 in chips) 
Seat 4: MjLK MAN (116922 in chips) 
Seat 5: mila is best (82124 in chips) 
Seat 6: DEERV (154020 in chips) 
davideriksso: posts the ante 1750
aapetrone91: posts the ante 1750
Rochinha2011: posts the ante 1750
MjLK MAN: posts the ante 1750
mila is best: posts the ante 1750
DEERV: posts the ante 1750
Rochinha2011: posts small blind 3500
MjLK MAN: posts big blind 7000
*** HOLE CARDS ***
mila is best: folds 
DEERV: folds 
davideriksso: folds 
aapetrone91: raises 207098 to 214098 and is all-in
Rochinha2011: folds 
MjLK MAN has timed out
MjLK MAN: folds 
MjLK MAN is sitting out
Uncalled bet (207098) returned to aapetrone91
MjLK MAN has returned
aapetrone91 collected 28000 from pot
*** SUMMARY ***
Total pot 28000 | Rake 0 
Seat 1: davideriksso folded before Flop (didn't bet)
Seat 2: aapetrone91 (button) collected (28000)
Seat 3: Rochinha2011 (small blind) folded before Flop
Seat 4: MjLK MAN (big blind) folded before Flop
Seat 5: mila is best folded before Flop (didn't bet)
Seat 6: DEERV folded before Flop (didn't bet)

PokerStars Hand #251210242062: Tournament #3769361908, $52.38+$2.62 USD Hold'em No Limit - Level XXV (3500/7000) - 2024/06/26 23:22:14 UTC [2024/06/26 19:22:14 ET]
Table '3769361908 11' 6-max Seat #3 is the button
Seat 1: davideriksso (179877 in chips) 
Seat 2: aapetrone91 (235098 in chips) 
Seat 3: Rochinha2011 (88555 in chips) 
Seat 4: MjLK MAN (108172 in chips) 
Seat 5: mila is best (80374 in chips) 
Seat 6: DEERV (152270 in chips) 
davideriksso: posts the ante 1750
aapetrone91: posts the ante 1750
Rochinha2011: posts the ante 1750
MjLK MAN: posts the ante 1750
mila is best: posts the ante 1750
DEERV: posts the ante 1750
MjLK MAN: posts small blind 3500
mila is best: posts big blind 7000
*** HOLE CARDS ***
DEERV: folds 
davideriksso: calls 7000
aapetrone91: folds 
Rochinha2011: folds 
MjLK MAN has timed out
MjLK MAN: folds 
MjLK MAN is sitting out
MjLK MAN has returned
mila is best: checks 
*** FLOP *** [3h 8h 9d]
mila is best: checks 
davideriksso: checks 
*** TURN *** [3h 8h 9d] [Kd]
mila is best: checks 
davideriksso: checks 
*** RIVER *** [3h 8h 9d Kd] [3d]
mila is best: checks 
davideriksso: checks 
*** SHOW DOWN ***
mila is best: shows [6d 8s] (two pair, Eights and Threes)
davideriksso: mucks hand 
mila is best collected 28000 from pot
*** SUMMARY ***
Total pot 28000 | Rake 0 
Board [3h 8h 9d Kd 3d]
Seat 1: davideriksso mucked
Seat 2: aapetrone91 folded before Flop (didn't bet)
Seat 3: Rochinha2011 (button) folded before Flop (didn't bet)
Seat 4: MjLK MAN (small blind) folded before Flop
Seat 5: mila is best (big blind) showed [6d 8s] and won (28000) with two pair, Eights and Threes
Seat 6: DEERV folded before Flop (didn't bet)

PokerStars Hand #251210252478: Tournament #3769361908, $52.38+$2.62 USD Hold'em No Limit - Level XXV (3500/7000) - 2024/06/26 23:23:04 UTC [2024/06/26 19:23:04 ET]
Table '3769361908 11' 6-max Seat #4 is the button
Seat 1: davideriksso (171127 in chips) 
Seat 2: aapetrone91 (233348 in chips) 
Seat 3: Rochinha2011 (86805 in chips) 
Seat 4: MjLK MAN (102922 in chips) 
Seat 5: mila is best (99624 in chips) 
Seat 6: DEERV (150520 in chips) 
davideriksso: posts the ante 1750
aapetrone91: posts the ante 1750
Rochinha2011: posts the ante 1750
MjLK MAN: posts the ante 1750
mila is best: posts the ante 1750
DEERV: posts the ante 1750
mila is best: posts small blind 3500
DEERV: posts big blind 7000
*** HOLE CARDS ***
davideriksso: folds 
aapetrone91: folds 
Rochinha2011: folds 
MjLK MAN: folds 
mila is best: raises 90874 to 97874 and is all-in
DEERV: folds 
Uncalled bet (90874) returned to mila is best
mila is best collected 24500 from pot
*** SUMMARY ***
Total pot 24500 | Rake 0 
Seat 1: davideriksso folded before Flop (didn't bet)
Seat 2: aapetrone91 folded before Flop (didn't bet)
Seat 3: Rochinha2011 folded before Flop (didn't bet)
Seat 4: MjLK MAN (button) folded before Flop (didn't bet)
Seat 5: mila is best (small blind) collected (24500)
Seat 6: DEERV (big blind) folded before Flop

PokerStars Hand #251210258375: Tournament #3769361908, $52.38+$2.62 USD Hold'em No Limit - Level XXVI (4000/8000) - 2024/06/26 23:23:33 UTC [2024/06/26 19:23:33 ET]
Table '3769361908 11' 6-max Seat #5 is the button
Seat 1: davideriksso (169377 in chips) 
Seat 2: aapetrone91 (231598 in chips) 
Seat 3: Rochinha2011 (85055 in chips) 
Seat 4: MjLK MAN (101172 in chips) 
Seat 5: mila is best (115374 in chips) 
Seat 6: DEERV (141770 in chips) 
davideriksso: posts the ante 2000
aapetrone91: posts the ante 2000
Rochinha2011: posts the ante 2000
MjLK MAN: posts the ante 2000
mila is best: posts the ante 2000
DEERV: posts the ante 2000
DEERV: posts small blind 4000
davideriksso: posts big blind 8000
*** HOLE CARDS ***
aapetrone91: folds 
Rochinha2011: folds 
MjLK MAN: raises 91172 to 99172 and is all-in
mila is best: folds 
DEERV: folds 
davideriksso: folds 
Uncalled bet (91172) returned to MjLK MAN
MjLK MAN collected 32000 from pot
MjLK MAN: doesn't show hand 
*** SUMMARY ***
Total pot 32000 | Rake 0 
Seat 1: davideriksso (big blind) folded before Flop
Seat 2: aapetrone91 folded before Flop (didn't bet)
Seat 3: Rochinha2011 folded before Flop (didn't bet)
Seat 4: MjLK MAN collected (32000)
Seat 5: mila is best (button) folded before Flop (didn't bet)
Seat 6: DEERV (small blind) folded before Flop

PokerStars Hand #251210262512: Tournament #3769361908, $52.38+$2.62 USD Hold'em No Limit - Level XXVI (4000/8000) - 2024/06/26 23:23:53 UTC [2024/06/26 19:23:53 ET]
Table '3769361908 11' 6-max Seat #6 is the button
Seat 1: davideriksso (159377 in chips) 
Seat 2: aapetrone91 (229598 in chips) 
Seat 3: Rochinha2011 (83055 in chips) 
Seat 4: MjLK MAN (123172 in chips) 
Seat 5: mila is best (113374 in chips) 
Seat 6: DEERV (135770 in chips) 
davideriksso: posts the ante 2000
aapetrone91: posts the ante 2000
Rochinha2011: posts the ante 2000
MjLK MAN: posts the ante 2000
mila is best: posts the ante 2000
DEERV: posts the ante 2000
davideriksso: posts small blind 4000
aapetrone91: posts big blind 8000
*** HOLE CARDS ***
Rochinha2011: raises 8000 to 16000
MjLK MAN: folds 
mila is best: folds 
DEERV: folds 
davideriksso: folds 
aapetrone91: folds 
Uncalled bet (8000) returned to Rochinha2011
Rochinha2011 collected 32000 from pot
Rochinha2011: doesn't show hand 
*** SUMMARY ***
Total pot 32000 | Rake 0 
Seat 1: davideriksso (small blind) folded before Flop
Seat 2: aapetrone91 (big blind) folded before Flop
Seat 3: Rochinha2011 collected (32000)
Seat 4: MjLK MAN folded before Flop (didn't bet)
Seat 5: mila is best folded before Flop (didn't bet)
Seat 6: DEERV (button) folded before Flop (didn't bet)

PokerStars Hand #251210267539: Tournament #3769361908, $52.38+$2.62 USD Hold'em No Limit - Level XXVI (4000/8000) - 2024/06/26 23:24:18 UTC [2024/06/26 19:24:18 ET]
Table '3769361908 11' 6-max Seat #1 is the button
Seat 1: davideriksso (153377 in chips) 
Seat 2: aapetrone91 (219598 in chips) 
Seat 3: Rochinha2011 (105055 in chips) 
Seat 4: MjLK MAN (121172 in chips) 
Seat 5: mila is best (111374 in chips) 
Seat 6: DEERV (133770 in chips) 
davideriksso: posts the ante 2000
aapetrone91: posts the ante 2000
Rochinha2011: posts the ante 2000
MjLK MAN: posts the ante 2000
mila is best: posts the ante 2000
DEERV: posts the ante 2000
aapetrone91: posts small blind 4000
Rochinha2011: posts big blind 8000
*** HOLE CARDS ***
MjLK MAN: raises 8000 to 16000
mila is best: folds 
DEERV: folds 
davideriksso: folds 
aapetrone91: folds 
Rochinha2011: calls 8000
*** FLOP *** [5d Qh 4c]
Rochinha2011: checks 
MjLK MAN: bets 8000
Rochinha2011: folds 
Uncalled bet (8000) returned to MjLK MAN
MjLK MAN collected 48000 from pot
MjLK MAN: doesn't show hand 
*** SUMMARY ***
Total pot 48000 | Rake 0 
Board [5d Qh 4c]
Seat 1: davideriksso (button) folded before Flop (didn't bet)
Seat 2: aapetrone91 (small blind) folded before Flop
Seat 3: Rochinha2011 (big blind) folded on the Flop
Seat 4: MjLK MAN collected (48000)
Seat 5: mila is best folded before Flop (didn't bet)
Seat 6: DEERV folded before Flop (didn't bet)

PokerStars Hand #251210275363: Tournament #3769361908, $52.38+$2.62 USD Hold'em No Limit - Level XXVI (4000/8000) - 2024/06/26 23:24:56 UTC [2024/06/26 19:24:56 ET]
Table '3769361908 11' 6-max Seat #2 is the button
Seat 1: davideriksso (151377 in chips) 
Seat 2: aapetrone91 (213598 in chips) 
Seat 3: Rochinha2011 (87055 in chips) 
Seat 4: MjLK MAN (151172 in chips) 
Seat 5: mila is best (109374 in chips) 
Seat 6: DEERV (131770 in chips) 
davideriksso: posts the ante 2000
aapetrone91: posts the ante 2000
Rochinha2011: posts the ante 2000
MjLK MAN: posts the ante 2000
mila is best: posts the ante 2000
DEERV: posts the ante 2000
Rochinha2011: posts small blind 4000
MjLK MAN: posts big blind 8000
*** HOLE CARDS ***
mila is best: raises 8000 to 16000
DEERV: folds 
davideriksso: folds 
aapetrone91: folds 
Rochinha2011: folds 
MjLK MAN: calls 8000
*** FLOP *** [Jc Ah Qd]
MjLK MAN: checks 
mila is best: bets 16000
MjLK MAN: folds 
Uncalled bet (16000) returned to mila is best
mila is best collected 48000 from pot
*** SUMMARY ***
Total pot 48000 | Rake 0 
Board [Jc Ah Qd]
Seat 1: davideriksso folded before Flop (didn't bet)
Seat 2: aapetrone91 (button) folded before Flop (didn't bet)
Seat 3: Rochinha2011 (small blind) folded before Flop
Seat 4: MjLK MAN (big blind) folded on the Flop
Seat 5: mila is best collected (48000)
Seat 6: DEERV folded before Flop (didn't bet)

PokerStars Hand #251210292253: Tournament #3769361908, $52.38+$2.62 USD Hold'em No Limit - Level XXVII (4500/9000) - 2024/06/26 23:26:18 UTC [2024/06/26 19:26:18 ET]
Table '3769361908 11' 6-max Seat #3 is the button
Seat 1: davideriksso (149377 in chips) 
Seat 2: aapetrone91 (211598 in chips) 
Seat 3: Rochinha2011 (81055 in chips) 
Seat 4: MjLK MAN (133172 in chips) 
Seat 5: mila is best (139374 in chips) 
Seat 6: DEERV (129770 in chips) 
davideriksso: posts the ante 2250
aapetrone91: posts the ante 2250
Rochinha2011: posts the ante 2250
MjLK MAN: posts the ante 2250
mila is best: posts the ante 2250
DEERV: posts the ante 2250
MjLK MAN: posts small blind 4500
mila is best: posts big blind 9000
*** HOLE CARDS ***
DEERV: folds 
davideriksso: raises 9000 to 18000
aapetrone91: folds 
Rochinha2011: folds 
MjLK MAN: folds 
mila is best: calls 9000
*** FLOP *** [4d 6h 8s]
mila is best: checks 
davideriksso: bets 18000
mila is best: folds 
Uncalled bet (18000) returned to davideriksso
davideriksso collected 54000 from pot
davideriksso: doesn't show hand 
*** SUMMARY ***
Total pot 54000 | Rake 0 
Board [4d 6h 8s]
Seat 1: davideriksso collected (54000)
Seat 2: aapetrone91 folded before Flop (didn't bet)
Seat 3: Rochinha2011 (button) folded before Flop (didn't bet)
Seat 4: MjLK MAN (small blind) folded before Flop
Seat 5: mila is best (big blind) folded on the Flop
Seat 6: DEERV folded before Flop (didn't bet)

PokerStars Hand #251210299898: Tournament #3769361908, $52.38+$2.62 USD Hold'em No Limit - Level XXVII (4500/9000) - 2024/06/26 23:26:56 UTC [2024/06/26 19:26:56 ET]
Table '3769361908 11' 6-max Seat #4 is the button
Seat 1: davideriksso (183127 in chips) 
Seat 2: aapetrone91 (209348 in chips) 
Seat 3: Rochinha2011 (78805 in chips) 
Seat 4: MjLK MAN (126422 in chips) 
Seat 5: mila is best (119124 in chips) 
Seat 6: DEERV (127520 in chips) 
davideriksso: posts the ante 2250
aapetrone91: posts the ante 2250
Rochinha2011: posts the ante 2250
MjLK MAN: posts the ante 2250
mila is best: posts the ante 2250
DEERV: posts the ante 2250
mila is best: posts small blind 4500
DEERV: posts big blind 9000
*** HOLE CARDS ***
davideriksso: folds 
aapetrone91: folds 
Rochinha2011: folds 
MjLK MAN: raises 115172 to 124172 and is all-in
mila is best: folds 
DEERV: folds 
Uncalled bet (115172) returned to MjLK MAN
MjLK MAN collected 36000 from pot
MjLK MAN: doesn't show hand 
*** SUMMARY ***
Total pot 36000 | Rake 0 
Seat 1: davideriksso folded before Flop (didn't bet)
Seat 2: aapetrone91 folded before Flop (didn't bet)
Seat 3: Rochinha2011 folded before Flop (didn't bet)
Seat 4: MjLK MAN (button) collected (36000)
Seat 5: mila is best (small blind) folded before Flop
Seat 6: DEERV (big blind) folded before Flop

PokerStars Hand #251210303982: Tournament #3769361908, $52.38+$2.62 USD Hold'em No Limit - Level XXVII (4500/9000) - 2024/06/26 23:27:16 UTC [2024/06/26 19:27:16 ET]
Table '3769361908 11' 6-max Seat #5 is the button
Seat 1: davideriksso (180877 in chips) 
Seat 2: aapetrone91 (207098 in chips) 
Seat 3: Rochinha2011 (76555 in chips) 
Seat 4: MjLK MAN (151172 in chips) 
Seat 5: mila is best (112374 in chips) 
Seat 6: DEERV (116270 in chips) 
davideriksso: posts the ante 2250
aapetrone91: posts the ante 2250
Rochinha2011: posts the ante 2250
MjLK MAN: posts the ante 2250
mila is best: posts the ante 2250
DEERV: posts the ante 2250
DEERV: posts small blind 4500
davideriksso: posts big blind 9000
*** HOLE CARDS ***
aapetrone91: raises 9000 to 18000
Rochinha2011: raises 56305 to 74305 and is all-in
MjLK MAN: raises 74617 to 148922 and is all-in
mila is best: folds 
DEERV: folds 
davideriksso: folds 
aapetrone91: folds 
Uncalled bet (74617) returned to MjLK MAN
*** FLOP *** [7s 2h 9c]
*** TURN *** [7s 2h 9c] [Ac]
*** RIVER *** [7s 2h 9c Ac] [4h]
*** SHOW DOWN ***
Rochinha2011: shows [Qd Kd] (high card Ace)
MjLK MAN: shows [Jh Jc] (a pair of Jacks)
MjLK MAN collected 193610 from pot
Rochinha2011 finished the tournament in 25th place and received $135.63.
*** SUMMARY ***
Total pot 193610 | Rake 0 
Board [7s 2h 9c Ac 4h]
Seat 1: davideriksso (big blind) folded before Flop
Seat 2: aapetrone91 folded before Flop
Seat 3: Rochinha2011 showed [Qd Kd] and lost with high card Ace
Seat 4: MjLK MAN showed [Jh Jc] and won (193610) with a pair of Jacks
Seat 5: mila is best (button) folded before Flop (didn't bet)
Seat 6: DEERV (small blind) folded before Flop


PokerStars Hand #251209318840: Tournament #3769361908, $52.38+$2.62 USD Hold'em No Limit - Level VI (80/160) - 2024/06/26 22:18:39 UTC [2024/06/26 18:18:39 ET]
Table '3769361908 10' 6-max Seat #2 is the button
Seat 1: maiconvol75 (13030 in chips) 
Seat 2: Aidy703 (8482 in chips) 
Seat 3: Eat_U_Up_ha (12598 in chips) 
Seat 4: accezz (9900 in chips) 
Seat 5: sanatamaria (9229 in chips) 
maiconvol75: posts the ante 40
Aidy703: posts the ante 40
Eat_U_Up_ha: posts the ante 40
accezz: posts the ante 40
sanatamaria: posts the ante 40
Eat_U_Up_ha: posts small blind 80
accezz: posts big blind 160
*** HOLE CARDS ***
sanatamaria: raises 320 to 480
maiconvol75: calls 480
Aidy703: calls 480
Eat_U_Up_ha: folds 
accezz: calls 320
*** FLOP *** [2h 7s 4h]
accezz: checks 
sanatamaria: bets 1100
maiconvol75: calls 1100
Aidy703: folds 
accezz: folds 
*** TURN *** [2h 7s 4h] [6s]
sanatamaria: bets 7609 and is all-in
GabrielTho1 is disconnected 
maiconvol75: calls 7609
*** RIVER *** [2h 7s 4h 6s] [3d]
*** SHOW DOWN ***
sanatamaria: shows [Ad Jc] (high card Ace)
maiconvol75: shows [Qh 6h] (a pair of Sixes)
maiconvol75 collected 19618 from pot
sanatamaria finished the tournament
*** SUMMARY ***
Total pot 19618 | Rake 0 
Board [2h 7s 4h 6s 3d]
Seat 1: maiconvol75 showed [Qh 6h] and won (19618) with a pair of Sixes
Seat 2: Aidy703 (button) folded on the Flop
Seat 3: Eat_U_Up_ha (small blind) folded before Flop
Seat 4: accezz (big blind) folded on the Flop
Seat 5: sanatamaria showed [Ad Jc] and lost with high card Ace

PokerStars Hand #251209333222: Tournament #3769361908, $52.38+$2.62 USD Hold'em No Limit - Level VI (80/160) - 2024/06/26 22:19:31 UTC [2024/06/26 18:19:31 ET]
Table '3769361908 10' 6-max Seat #3 is the button
Seat 1: maiconvol75 (23419 in chips) 
Seat 2: Aidy703 (7962 in chips) 
Seat 3: Eat_U_Up_ha (12478 in chips) 
Seat 4: accezz (9380 in chips) 
Seat 6: GabrielTho1 (10000 in chips) 
maiconvol75: posts the ante 40
Aidy703: posts the ante 40
Eat_U_Up_ha: posts the ante 40
accezz: posts the ante 40
GabrielTho1: posts the ante 40
accezz: posts small blind 80
GabrielTho1: posts big blind 160
*** HOLE CARDS ***
maiconvol75: folds 
Aidy703: folds 
Eat_U_Up_ha: raises 240 to 400
accezz: folds 
GabrielTho1: folds 
Uncalled bet (240) returned to Eat_U_Up_ha
Eat_U_Up_ha collected 600 from pot
Eat_U_Up_ha: doesn't show hand 
*** SUMMARY ***
Total pot 600 | Rake 0 
Seat 1: maiconvol75 folded before Flop (didn't bet)
Seat 2: Aidy703 folded before Flop (didn't bet)
Seat 3: Eat_U_Up_ha (button) collected (600)
Seat 4: accezz (small blind) folded before Flop
Seat 6: GabrielTho1 (big blind) folded before Flop

PokerStars Hand #251209342277: Tournament #3769361908, $52.38+$2.62 USD Hold'em No Limit - Level VI (80/160) - 2024/06/26 22:20:03 UTC [2024/06/26 18:20:03 ET]
Table '3769361908 10' 6-max Seat #4 is the button
Seat 1: maiconvol75 (23379 in chips) 
Seat 2: Aidy703 (7922 in chips) 
Seat 3: Eat_U_Up_ha (12878 in chips) 
Seat 4: accezz (9260 in chips) 
Seat 6: GabrielTho1 (9800 in chips) 
maiconvol75: posts the ante 40
Aidy703: posts the ante 40
Eat_U_Up_ha: posts the ante 40
accezz: posts the ante 40
GabrielTho1: posts the ante 40
GabrielTho1: posts small blind 80
maiconvol75: posts big blind 160
*** HOLE CARDS ***
Aidy703: folds 
Eat_U_Up_ha: folds 
accezz: folds 
GabrielTho1: raises 240 to 400
maiconvol75: folds 
Uncalled bet (240) returned to GabrielTho1
GabrielTho1 collected 520 from pot
GabrielTho1: doesn't show hand 
*** SUMMARY ***
Total pot 520 | Rake 0 
Seat 1: maiconvol75 (big blind) folded before Flop
Seat 2: Aidy703 folded before Flop (didn't bet)
Seat 3: Eat_U_Up_ha folded before Flop (didn't bet)
Seat 4: accezz (button) folded before Flop (didn't bet)
Seat 6: GabrielTho1 (small blind) collected (520)

PokerStars Hand #251209347874: Tournament #3769361908, $52.38+$2.62 USD Hold'em No Limit - Level VII (100/200) - 2024/06/26 22:20:23 UTC [2024/06/26 18:20:23 ET]
Table '3769361908 10' 6-max Seat #6 is the button
Seat 1: maiconvol75 (23179 in chips) 
Seat 2: Aidy703 (7882 in chips) 
Seat 3: Eat_U_Up_ha (12838 in chips) 
Seat 4: accezz (9220 in chips) 
Seat 5: chrichrac (10000 in chips) 
Seat 6: GabrielTho1 (10120 in chips) 
maiconvol75: posts the ante 50
Aidy703: posts the ante 50
Eat_U_Up_ha: posts the ante 50
accezz: posts the ante 50
chrichrac: posts the ante 50
GabrielTho1: posts the ante 50
maiconvol75: posts small blind 100
Aidy703: posts big blind 200
*** HOLE CARDS ***
Eat_U_Up_ha: folds 
accezz: raises 240 to 440
chrichrac: folds 
GabrielTho1: folds 
maiconvol75: calls 340
Aidy703: calls 240
*** FLOP *** [3c 5h 7d]
maiconvol75: checks 
Aidy703: checks 
accezz: checks 
*** TURN *** [3c 5h 7d] [3d]
maiconvol75: checks 
Aidy703: checks 
accezz: checks 
*** RIVER *** [3c 5h 7d 3d] [Ad]
maiconvol75: checks 
Aidy703: checks 
accezz: bets 790
maiconvol75: folds 
Aidy703: folds 
Uncalled bet (790) returned to accezz
accezz collected 1620 from pot
accezz: doesn't show hand 
*** SUMMARY ***
Total pot 1620 | Rake 0 
Board [3c 5h 7d 3d Ad]
Seat 1: maiconvol75 (small blind) folded on the River
Seat 2: Aidy703 (big blind) folded on the River
Seat 3: Eat_U_Up_ha folded before Flop (didn't bet)
Seat 4: accezz collected (1620)
Seat 5: chrichrac folded before Flop (didn't bet)
Seat 6: GabrielTho1 (button) folded before Flop (didn't bet)

PokerStars Hand #251209372275: Tournament #3769361908, $52.38+$2.62 USD Hold'em No Limit - Level VII (100/200) - 2024/06/26 22:21:51 UTC [2024/06/26 18:21:51 ET]
Table '3769361908 10' 6-max Seat #1 is the button
Seat 1: maiconvol75 (22689 in chips) 
Seat 2: Aidy703 (7392 in chips) 
Seat 3: Eat_U_Up_ha (12788 in chips) 
Seat 4: accezz (10350 in chips) 
Seat 5: chrichrac (9950 in chips) 
Seat 6: GabrielTho1 (10070 in chips) 
maiconvol75: posts the ante 50
Aidy703: posts the ante 50
Eat_U_Up_ha: posts the ante 50
accezz: posts the ante 50
chrichrac: posts the ante 50
GabrielTho1: posts the ante 50
Aidy703: posts small blind 100
Eat_U_Up_ha: posts big blind 200
*** HOLE CARDS ***
accezz: folds 
chrichrac: raises 220 to 420
GabrielTho1: folds 
maiconvol75: folds 
Aidy703: calls 320
Eat_U_Up_ha: calls 220
*** FLOP *** [9d Td Kc]
Aidy703: checks 
Eat_U_Up_ha: checks 
chrichrac: checks 
*** TURN *** [9d Td Kc] [4c]
Aidy703: bets 600
Eat_U_Up_ha: folds 
chrichrac: folds 
Uncalled bet (600) returned to Aidy703
Aidy703 collected 1560 from pot
*** SUMMARY ***
Total pot 1560 | Rake 0 
Board [9d Td Kc 4c]
Seat 1: maiconvol75 (button) folded before Flop (didn't bet)
Seat 2: Aidy703 (small blind) collected (1560)
Seat 3: Eat_U_Up_ha (big blind) folded on the Turn
Seat 4: accezz folded before Flop (didn't bet)
Seat 5: chrichrac folded on the Turn
Seat 6: GabrielTho1 folded before Flop (didn't bet)

PokerStars Hand #251209384878: Tournament #3769361908, $52.38+$2.62 USD Hold'em No Limit - Level VII (100/200) - 2024/06/26 22:22:36 UTC [2024/06/26 18:22:36 ET]
Table '3769361908 10' 6-max Seat #2 is the button
Seat 1: maiconvol75 (22639 in chips) 
Seat 2: Aidy703 (8482 in chips) 
Seat 3: Eat_U_Up_ha (12318 in chips) 
Seat 4: accezz (10300 in chips) 
Seat 5: chrichrac (9480 in chips) 
Seat 6: GabrielTho1 (10020 in chips) 
maiconvol75: posts the ante 50
Aidy703: posts the ante 50
Eat_U_Up_ha: posts the ante 50
accezz: posts the ante 50
chrichrac: posts the ante 50
GabrielTho1: posts the ante 50
Eat_U_Up_ha: posts small blind 100
accezz: posts big blind 200
*** HOLE CARDS ***
chrichrac: folds 
GabrielTho1: folds 
maiconvol75: folds 
Aidy703: folds 
Eat_U_Up_ha: raises 400 to 600
accezz: calls 400
*** FLOP *** [8s Qh 8c]
Eat_U_Up_ha: bets 600
accezz: calls 600
*** TURN *** [8s Qh 8c] [Kc]
Eat_U_Up_ha: checks 
accezz: bets 700
Eat_U_Up_ha: calls 700
*** RIVER *** [8s Qh 8c Kc] [4c]
Eat_U_Up_ha: checks 
accezz: checks 
*** SHOW DOWN ***
Eat_U_Up_ha: shows [Qs 8h] (a full house, Eights full of Queens)
accezz: mucks hand 
Eat_U_Up_ha collected 4100 from pot
*** SUMMARY ***
Total pot 4100 | Rake 0 
Board [8s Qh 8c Kc 4c]
Seat 1: maiconvol75 folded before Flop (didn't bet)
Seat 2: Aidy703 (button) folded before Flop (didn't bet)
Seat 3: Eat_U_Up_ha (small blind) showed [Qs 8h] and won (4100) with a full house, Eights full of Queens
Seat 4: accezz (big blind) mucked
Seat 5: chrichrac folded before Flop (didn't bet)
Seat 6: GabrielTho1 folded before Flop (didn't bet)

PokerStars Hand #251209402878: Tournament #3769361908, $52.38+$2.62 USD Hold'em No Limit - Level VIII (125/250) - 2024/06/26 22:23:41 UTC [2024/06/26 18:23:41 ET]
Table '3769361908 10' 6-max Seat #3 is the button
Seat 1: maiconvol75 (22589 in chips) 
Seat 2: Aidy703 (8432 in chips) 
Seat 3: Eat_U_Up_ha (14468 in chips) 
Seat 4: accezz (8350 in chips) 
Seat 5: chrichrac (9430 in chips) 
Seat 6: GabrielTho1 (9970 in chips) 
maiconvol75: posts the ante 60
Aidy703: posts the ante 60
Eat_U_Up_ha: posts the ante 60
accezz: posts the ante 60
chrichrac: posts the ante 60
GabrielTho1: posts the ante 60
accezz: posts small blind 125
chrichrac: posts big blind 250
*** HOLE CARDS ***
GabrielTho1: folds 
maiconvol75: raises 500 to 750
Aidy703: folds 
Eat_U_Up_ha: folds 
accezz: folds 
chrichrac: folds 
Uncalled bet (500) returned to maiconvol75
maiconvol75 collected 985 from pot
maiconvol75: doesn't show hand 
*** SUMMARY ***
Total pot 985 | Rake 0 
Seat 1: maiconvol75 collected (985)
Seat 2: Aidy703 folded before Flop (didn't bet)
Seat 3: Eat_U_Up_ha (button) folded before Flop (didn't bet)
Seat 4: accezz (small blind) folded before Flop
Seat 5: chrichrac (big blind) folded before Flop
Seat 6: GabrielTho1 folded before Flop (didn't bet)

PokerStars Hand #251209410315: Tournament #3769361908, $52.38+$2.62 USD Hold'em No Limit - Level VIII (125/250) - 2024/06/26 22:24:07 UTC [2024/06/26 18:24:07 ET]
Table '3769361908 10' 6-max Seat #4 is the button
Seat 1: maiconvol75 (23264 in chips) 
Seat 2: Aidy703 (8372 in chips) 
Seat 3: Eat_U_Up_ha (14408 in chips) 
Seat 4: accezz (8165 in chips) 
Seat 5: chrichrac (9120 in chips) 
Seat 6: GabrielTho1 (9910 in chips) 
maiconvol75: posts the ante 60
Aidy703: posts the ante 60
Eat_U_Up_ha: posts the ante 60
accezz: posts the ante 60
chrichrac: posts the ante 60
GabrielTho1: posts the ante 60
chrichrac: posts small blind 125
GabrielTho1: posts big blind 250
*** HOLE CARDS ***
maiconvol75: folds 
Aidy703: raises 250 to 500
Eat_U_Up_ha: folds 
accezz: folds 
chrichrac: folds 
GabrielTho1: raises 9350 to 9850 and is all-in
Aidy703: folds 
Uncalled bet (9350) returned to GabrielTho1
GabrielTho1 collected 1485 from pot
GabrielTho1: doesn't show hand 
*** SUMMARY ***
Total pot 1485 | Rake 0 
Seat 1: maiconvol75 folded before Flop (didn't bet)
Seat 2: Aidy703 folded before Flop
Seat 3: Eat_U_Up_ha folded before Flop (didn't bet)
Seat 4: accezz (button) folded before Flop (didn't bet)
Seat 5: chrichrac (small blind) folded before Flop
Seat 6: GabrielTho1 (big blind) collected (1485)

PokerStars Hand #251209419041: Tournament #3769361908, $52.38+$2.62 USD Hold'em No Limit - Level VIII (125/250) - 2024/06/26 22:24:39 UTC [2024/06/26 18:24:39 ET]
Table '3769361908 10' 6-max Seat #5 is the button
Seat 1: maiconvol75 (23204 in chips) 
Seat 2: Aidy703 (7812 in chips) 
Seat 3: Eat_U_Up_ha (14348 in chips) 
Seat 4: accezz (8105 in chips) 
Seat 5: chrichrac (8935 in chips) 
Seat 6: GabrielTho1 (10835 in chips) 
maiconvol75: posts the ante 60
Aidy703: posts the ante 60
Eat_U_Up_ha: posts the ante 60
accezz: posts the ante 60
chrichrac: posts the ante 60
GabrielTho1: posts the ante 60
GabrielTho1: posts small blind 125
maiconvol75: posts big blind 250
*** HOLE CARDS ***
Aidy703: folds 
Eat_U_Up_ha: raises 300 to 550
accezz: folds 
chrichrac: calls 550
GabrielTho1: folds 
maiconvol75: folds 
*** FLOP *** [7d 2c Kc]
Eat_U_Up_ha: bets 750
chrichrac: calls 750
*** TURN *** [7d 2c Kc] [Kh]
Eat_U_Up_ha: bets 1101
chrichrac: calls 1101
*** RIVER *** [7d 2c Kc Kh] [9h]
Eat_U_Up_ha: checks 
chrichrac: bets 2500
Eat_U_Up_ha: folds 
Uncalled bet (2500) returned to chrichrac
chrichrac collected 5537 from pot
chrichrac: doesn't show hand 
*** SUMMARY ***
Total pot 5537 | Rake 0 
Board [7d 2c Kc Kh 9h]
Seat 1: maiconvol75 (big blind) folded before Flop
Seat 2: Aidy703 folded before Flop (didn't bet)
Seat 3: Eat_U_Up_ha folded on the River
Seat 4: accezz folded before Flop (didn't bet)
Seat 5: chrichrac (button) collected (5537)
Seat 6: GabrielTho1 (small blind) folded before Flop

PokerStars Hand #251209439091: Tournament #3769361908, $52.38+$2.62 USD Hold'em No Limit - Level VIII (125/250) - 2024/06/26 22:25:51 UTC [2024/06/26 18:25:51 ET]
Table '3769361908 10' 6-max Seat #6 is the button
Seat 1: maiconvol75 (22894 in chips) 
Seat 2: Aidy703 (7752 in chips) 
Seat 3: Eat_U_Up_ha (11887 in chips) 
Seat 4: accezz (8045 in chips) 
Seat 5: chrichrac (12011 in chips) 
Seat 6: GabrielTho1 (10650 in chips) 
maiconvol75: posts the ante 60
Aidy703: posts the ante 60
Eat_U_Up_ha: posts the ante 60
accezz: posts the ante 60
chrichrac: posts the ante 60
GabrielTho1: posts the ante 60
maiconvol75: posts small blind 125
Aidy703: posts big blind 250
*** HOLE CARDS ***
Eat_U_Up_ha: folds 
accezz: folds 
chrichrac: folds 
GabrielTho1: folds 
maiconvol75: folds 
Uncalled bet (125) returned to Aidy703
Aidy703 collected 610 from pot
*** SUMMARY ***
Total pot 610 | Rake 0 
Seat 1: maiconvol75 (small blind) folded before Flop
Seat 2: Aidy703 (big blind) collected (610)
Seat 3: Eat_U_Up_ha folded before Flop (didn't bet)
Seat 4: accezz folded before Flop (didn't bet)
Seat 5: chrichrac folded before Flop (didn't bet)
Seat 6: GabrielTho1 (button) folded before Flop (didn't bet)

PokerStars Hand #251209445352: Tournament #3769361908, $52.38+$2.62 USD Hold'em No Limit - Level IX (150/300) - 2024/06/26 22:26:14 UTC [2024/06/26 18:26:14 ET]
Table '3769361908 10' 6-max Seat #1 is the button
Seat 1: maiconvol75 (22709 in chips) 
Seat 2: Aidy703 (8177 in chips) 
Seat 3: Eat_U_Up_ha (11827 in chips) 
Seat 4: accezz (7985 in chips) 
Seat 5: chrichrac (11951 in chips) 
Seat 6: GabrielTho1 (10590 in chips) 
maiconvol75: posts the ante 75
Aidy703: posts the ante 75
Eat_U_Up_ha: posts the ante 75
accezz: posts the ante 75
chrichrac: posts the ante 75
GabrielTho1: posts the ante 75
Aidy703: posts small blind 150
Eat_U_Up_ha: posts big blind 300
*** HOLE CARDS ***
accezz: raises 360 to 660
chrichrac: folds 
GabrielTho1: folds 
maiconvol75: folds 
Aidy703: calls 510
Eat_U_Up_ha: calls 360
*** FLOP *** [4s Ad Ah]
Aidy703: checks 
Eat_U_Up_ha: checks 
accezz: bets 735
Aidy703: calls 735
Eat_U_Up_ha: calls 735
*** TURN *** [4s Ad Ah] [5s]
Aidy703: checks 
Eat_U_Up_ha: checks 
accezz: checks 
*** RIVER *** [4s Ad Ah 5s] [Kh]
Aidy703: checks 
Eat_U_Up_ha: bets 2318
accezz: calls 2318
Aidy703: folds 
*** SHOW DOWN ***
Eat_U_Up_ha: shows [9c As] (three of a kind, Aces)
accezz: mucks hand 
Eat_U_Up_ha collected 9271 from pot
*** SUMMARY ***
Total pot 9271 | Rake 0 
Board [4s Ad Ah 5s Kh]
Seat 1: maiconvol75 (button) folded before Flop (didn't bet)
Seat 2: Aidy703 (small blind) folded on the River
Seat 3: Eat_U_Up_ha (big blind) showed [9c As] and won (9271) with three of a kind, Aces
Seat 4: accezz mucked
Seat 5: chrichrac folded before Flop (didn't bet)
Seat 6: GabrielTho1 folded before Flop (didn't bet)

PokerStars Hand #251209463935: Tournament #3769361908, $52.38+$2.62 USD Hold'em No Limit - Level IX (150/300) - 2024/06/26 22:27:21 UTC [2024/06/26 18:27:21 ET]
Table '3769361908 10' 6-max Seat #2 is the button
Seat 1: maiconvol75 (22634 in chips) 
Seat 2: Aidy703 (6707 in chips) 
Seat 3: Eat_U_Up_ha (17310 in chips) 
Seat 4: accezz (4197 in chips) 
Seat 5: chrichrac (11876 in chips) 
Seat 6: GabrielTho1 (10515 in chips) 
maiconvol75: posts the ante 75
Aidy703: posts the ante 75
Eat_U_Up_ha: posts the ante 75
accezz: posts the ante 75
chrichrac: posts the ante 75
GabrielTho1: posts the ante 75
Eat_U_Up_ha: posts small blind 150
accezz: posts big blind 300
*** HOLE CARDS ***
chrichrac: folds 
GabrielTho1: folds 
maiconvol75: folds 
Aidy703: raises 300 to 600
Eat_U_Up_ha: folds 
accezz: folds 
Uncalled bet (300) returned to Aidy703
Aidy703 collected 1200 from pot
*** SUMMARY ***
Total pot 1200 | Rake 0 
Seat 1: maiconvol75 folded before Flop (didn't bet)
Seat 2: Aidy703 (button) collected (1200)
Seat 3: Eat_U_Up_ha (small blind) folded before Flop
Seat 4: accezz (big blind) folded before Flop
Seat 5: chrichrac folded before Flop (didn't bet)
Seat 6: GabrielTho1 folded before Flop (didn't bet)

PokerStars Hand #251209469624: Tournament #3769361908, $52.38+$2.62 USD Hold'em No Limit - Level IX (150/300) - 2024/06/26 22:27:41 UTC [2024/06/26 18:27:41 ET]
Table '3769361908 10' 6-max Seat #3 is the button
Seat 1: maiconvol75 (22559 in chips) 
Seat 2: Aidy703 (7532 in chips) 
Seat 3: Eat_U_Up_ha (17085 in chips) 
Seat 4: accezz (3822 in chips) 
Seat 5: chrichrac (11801 in chips) 
Seat 6: GabrielTho1 (10440 in chips) 
maiconvol75: posts the ante 75
Aidy703: posts the ante 75
Eat_U_Up_ha: posts the ante 75
accezz: posts the ante 75
chrichrac: posts the ante 75
GabrielTho1: posts the ante 75
accezz: posts small blind 150
chrichrac: posts big blind 300
*** HOLE CARDS ***
GabrielTho1: folds 
maiconvol75: folds 
Aidy703: folds 
Eat_U_Up_ha: folds 
accezz: raises 3447 to 3747 and is all-in
chrichrac: folds 
Uncalled bet (3447) returned to accezz
accezz collected 1050 from pot
accezz: doesn't show hand 
*** SUMMARY ***
Total pot 1050 | Rake 0 
Seat 1: maiconvol75 folded before Flop (didn't bet)
Seat 2: Aidy703 folded before Flop (didn't bet)
Seat 3: Eat_U_Up_ha (button) folded before Flop (didn't bet)
Seat 4: accezz (small blind) collected (1050)
Seat 5: chrichrac (big blind) folded before Flop
Seat 6: GabrielTho1 folded before Flop (didn't bet)

PokerStars Hand #251209478234: Tournament #3769361908, $52.38+$2.62 USD Hold'em No Limit - Level IX (150/300) - 2024/06/26 22:28:12 UTC [2024/06/26 18:28:12 ET]
Table '3769361908 10' 6-max Seat #4 is the button
Seat 1: maiconvol75 (22484 in chips) 
Seat 2: Aidy703 (7457 in chips) 
Seat 3: Eat_U_Up_ha (17010 in chips) 
Seat 4: accezz (4497 in chips) 
Seat 5: chrichrac (11426 in chips) 
Seat 6: GabrielTho1 (10365 in chips) 
maiconvol75: posts the ante 75
Aidy703: posts the ante 75
Eat_U_Up_ha: posts the ante 75
accezz: posts the ante 75
chrichrac: posts the ante 75
GabrielTho1: posts the ante 75
chrichrac: posts small blind 150
GabrielTho1: posts big blind 300
*** HOLE CARDS ***
maiconvol75: folds 
Aidy703: calls 300
Eat_U_Up_ha: folds 
accezz: folds 
chrichrac: folds 
GabrielTho1: raises 900 to 1200
Aidy703: calls 900
*** FLOP *** [Kh 6c 3c]
GabrielTho1: bets 750
Aidy703: calls 750
*** TURN *** [Kh 6c 3c] [4s]
GabrielTho1: bets 2550
Aidy703: calls 2550
*** RIVER *** [Kh 6c 3c 4s] [6h]
GabrielTho1: bets 5790 and is all-in
Aidy703: calls 2882 and is all-in
Uncalled bet (2908) returned to GabrielTho1
*** SHOW DOWN ***
GabrielTho1: shows [Qc Qs] (two pair, Queens and Sixes)
Aidy703: shows [7c 4c] (two pair, Sixes and Fours)
GabrielTho1 collected 15364 from pot
Aidy703 finished the tournament
*** SUMMARY ***
Total pot 15364 | Rake 0 
Board [Kh 6c 3c 4s 6h]
Seat 1: maiconvol75 folded before Flop (didn't bet)
Seat 2: Aidy703 showed [7c 4c] and lost with two pair, Sixes and Fours
Seat 3: Eat_U_Up_ha folded before Flop (didn't bet)
Seat 4: accezz (button) folded before Flop (didn't bet)
Seat 5: chrichrac (small blind) folded before Flop
Seat 6: GabrielTho1 (big blind) showed [Qc Qs] and won (15364) with two pair, Queens and Sixes

PokerStars Hand #251209498518: Tournament #3769361908, $52.38+$2.62 USD Hold'em No Limit - Level X (200/400) - 2024/06/26 22:29:25 UTC [2024/06/26 18:29:25 ET]
Table '3769361908 10' 6-max Seat #5 is the button
Seat 1: maiconvol75 (22409 in chips) 
Seat 3: Eat_U_Up_ha (16935 in chips) 
Seat 4: accezz (4422 in chips) 
Seat 5: chrichrac (11201 in chips) 
Seat 6: GabrielTho1 (18272 in chips) 
maiconvol75: posts the ante 100
Eat_U_Up_ha: posts the ante 100
accezz: posts the ante 100
chrichrac: posts the ante 100
GabrielTho1: posts the ante 100
GabrielTho1: posts small blind 200
maiconvol75: posts big blind 400
*** HOLE CARDS ***
Eat_U_Up_ha: raises 480 to 880
accezz: raises 3442 to 4322 and is all-in
chrichrac: folds 
GabrielTho1: folds 
maiconvol75: folds 
Eat_U_Up_ha: calls 3442
*** FLOP *** [Jc 9h 9s]
*** TURN *** [Jc 9h 9s] [6c]
*** RIVER *** [Jc 9h 9s 6c] [2d]
*** SHOW DOWN ***
Eat_U_Up_ha: shows [8d Ah] (a pair of Nines)
accezz: shows [Kh Kd] (two pair, Kings and Nines)
accezz collected 9744 from pot
*** SUMMARY ***
Total pot 9744 | Rake 0 
Board [Jc 9h 9s 6c 2d]
Seat 1: maiconvol75 (big blind) folded before Flop
Seat 3: Eat_U_Up_ha showed [8d Ah] and lost with a pair of Nines
Seat 4: accezz showed [Kh Kd] and won (9744) with two pair, Kings and Nines
Seat 5: chrichrac (button) folded before Flop (didn't bet)
Seat 6: GabrielTho1 (small blind) folded before Flop

PokerStars Hand #251209506456: Tournament #3769361908, $52.38+$2.62 USD Hold'em No Limit - Level X (200/400) - 2024/06/26 22:29:53 UTC [2024/06/26 18:29:53 ET]
Table '3769361908 10' 6-max Seat #6 is the button
Seat 1: maiconvol75 (21909 in chips) 
Seat 3: Eat_U_Up_ha (12513 in chips) 
Seat 4: accezz (9744 in chips) 
Seat 5: chrichrac (11101 in chips) 
Seat 6: GabrielTho1 (17972 in chips) 
maiconvol75: posts the ante 100
Eat_U_Up_ha: posts the ante 100
accezz: posts the ante 100
chrichrac: posts the ante 100
GabrielTho1: posts the ante 100
maiconvol75: posts small blind 200
Eat_U_Up_ha: posts big blind 400
*** HOLE CARDS ***
accezz: raises 400 to 800
chrichrac: folds 
GabrielTho1: folds 
maiconvol75: calls 600
Eat_U_Up_ha: calls 400
*** FLOP *** [3s Qc Qd]
maiconvol75: checks 
Eat_U_Up_ha: checks 
accezz: bets 964
maiconvol75: calls 964
Eat_U_Up_ha: folds 
*** TURN *** [3s Qc Qd] [9d]
maiconvol75: checks 
accezz: checks 
*** RIVER *** [3s Qc Qd 9d] [7c]
maiconvol75: bets 2414
accezz: calls 2414
*** SHOW DOWN ***
maiconvol75: shows [6h 6d] (two pair, Queens and Sixes)
accezz: shows [9h As] (two pair, Queens and Nines)
accezz collected 9656 from pot
*** SUMMARY ***
Total pot 9656 | Rake 0 
Board [3s Qc Qd 9d 7c]
Seat 1: maiconvol75 (small blind) showed [6h 6d] and lost with two pair, Queens and Sixes
Seat 3: Eat_U_Up_ha (big blind) folded on the Flop
Seat 4: accezz showed [9h As] and won (9656) with two pair, Queens and Nines
Seat 5: chrichrac folded before Flop (didn't bet)
Seat 6: GabrielTho1 (button) folded before Flop (didn't bet)

PokerStars Hand #251209527811: Tournament #3769361908, $52.38+$2.62 USD Hold'em No Limit - Level X (200/400) - 2024/06/26 22:31:10 UTC [2024/06/26 18:31:10 ET]
Table '3769361908 10' 6-max Seat #1 is the button
Seat 1: maiconvol75 (17631 in chips) 
Seat 2: Aidy703 (10000 in chips) out of hand (moved from another table into small blind)
Seat 3: Eat_U_Up_ha (11613 in chips) 
Seat 5: chrichrac (11001 in chips) 
Seat 6: GabrielTho1 (17872 in chips) 
Aidy703 will be allowed to play after the button
maiconvol75: posts the ante 100
Eat_U_Up_ha: posts the ante 100
chrichrac: posts the ante 100
GabrielTho1: posts the ante 100
Eat_U_Up_ha: posts small blind 200
chrichrac: posts big blind 400
*** HOLE CARDS ***
GabrielTho1: raises 400 to 800
maiconvol75: calls 800
Eat_U_Up_ha: folds 
DR. ELDAR is disconnected 
chrichrac: folds 
*** FLOP *** [Kc 4h 3s]
GabrielTho1: bets 650
maiconvol75: calls 650
*** TURN *** [Kc 4h 3s] [Td]
GabrielTho1: bets 1950
maiconvol75: folds 
Uncalled bet (1950) returned to GabrielTho1
GabrielTho1 collected 3900 from pot
GabrielTho1: doesn't show hand 
*** SUMMARY ***
Total pot 3900 | Rake 0 
Board [Kc 4h 3s Td]
Seat 1: maiconvol75 (button) folded on the Turn
Seat 3: Eat_U_Up_ha (small blind) folded before Flop
Seat 5: chrichrac (big blind) folded before Flop
Seat 6: GabrielTho1 collected (3900)

PokerStars Hand #251209546593: Tournament #3769361908, $52.38+$2.62 USD Hold'em No Limit - Level XI (250/500) - 2024/06/26 22:32:19 UTC [2024/06/26 18:32:19 ET]
Table '3769361908 10' 6-max Seat #3 is the button
Seat 1: maiconvol75 (16081 in chips) 
Seat 2: Aidy703 (10000 in chips) 
Seat 3: Eat_U_Up_ha (11313 in chips) 
Seat 4: DR. ELDAR (10000 in chips) out of hand (moved from another table into small blind)
Seat 5: chrichrac (10501 in chips) 
Seat 6: GabrielTho1 (20222 in chips) 
DR. ELDAR will be allowed to play after the button
maiconvol75: posts the ante 125
Aidy703: posts the ante 125
Eat_U_Up_ha: posts the ante 125
chrichrac: posts the ante 125
GabrielTho1: posts the ante 125
chrichrac: posts small blind 250
GabrielTho1: posts big blind 500
*** HOLE CARDS ***
maiconvol75: folds 
Aidy703: folds 
Eat_U_Up_ha: raises 600 to 1100
chrichrac: folds 
GabrielTho1: calls 600
*** FLOP *** [Jc Qs 8h]
GabrielTho1: checks 
Eat_U_Up_ha: bets 1250
GabrielTho1: calls 1250
*** TURN *** [Jc Qs 8h] [5s]
GabrielTho1: checks 
Eat_U_Up_ha: checks 
*** RIVER *** [Jc Qs 8h 5s] [8d]
GabrielTho1: checks 
Eat_U_Up_ha: checks 
*** SHOW DOWN ***
GabrielTho1: shows [4d Jd] (two pair, Jacks and Eights)
Eat_U_Up_ha: mucks hand 
GabrielTho1 collected 5575 from pot
*** SUMMARY ***
Total pot 5575 | Rake 0 
Board [Jc Qs 8h 5s 8d]
Seat 1: maiconvol75 folded before Flop (didn't bet)
Seat 2: Aidy703 folded before Flop (didn't bet)
Seat 3: Eat_U_Up_ha (button) mucked
Seat 5: chrichrac (small blind) folded before Flop
Seat 6: GabrielTho1 (big blind) showed [4d Jd] and won (5575) with two pair, Jacks and Eights

PokerStars Hand #251209562489: Tournament #3769361908, $52.38+$2.62 USD Hold'em No Limit - Level XI (250/500) - 2024/06/26 22:33:18 UTC [2024/06/26 18:33:18 ET]
Table '3769361908 10' 6-max Seat #5 is the button
Seat 1: maiconvol75 (15956 in chips) 
Seat 2: Aidy703 (9875 in chips) 
Seat 3: Eat_U_Up_ha (8838 in chips) 
Seat 4: DR. ELDAR (10000 in chips) 
Seat 5: chrichrac (10126 in chips) 
Seat 6: GabrielTho1 (23322 in chips) 
maiconvol75: posts the ante 125
Aidy703: posts the ante 125
Eat_U_Up_ha: posts the ante 125
DR. ELDAR: posts the ante 125
chrichrac: posts the ante 125
GabrielTho1: posts the ante 125
GabrielTho1: posts small blind 250
maiconvol75: posts big blind 500
*** HOLE CARDS ***
Aidy703: folds 
Eat_U_Up_ha: folds 
DR. ELDAR: folds 
chrichrac: folds 
GabrielTho1: raises 750 to 1250
maiconvol75: calls 750
*** FLOP *** [7c As 9s]
GabrielTho1: bets 813
maiconvol75: folds 
Uncalled bet (813) returned to GabrielTho1
GabrielTho1 collected 3250 from pot
GabrielTho1: doesn't show hand 
*** SUMMARY ***
Total pot 3250 | Rake 0 
Board [7c As 9s]
Seat 1: maiconvol75 (big blind) folded on the Flop
Seat 2: Aidy703 folded before Flop (didn't bet)
Seat 3: Eat_U_Up_ha folded before Flop (didn't bet)
Seat 4: DR. ELDAR folded before Flop (didn't bet)
Seat 5: chrichrac (button) folded before Flop (didn't bet)
Seat 6: GabrielTho1 (small blind) collected (3250)

PokerStars Hand #251209571089: Tournament #3769361908, $52.38+$2.62 USD Hold'em No Limit - Level XI (250/500) - 2024/06/26 22:33:50 UTC [2024/06/26 18:33:50 ET]
Table '3769361908 10' 6-max Seat #6 is the button
Seat 1: maiconvol75 (14581 in chips) 
Seat 2: Aidy703 (9750 in chips) 
Seat 3: Eat_U_Up_ha (8713 in chips) 
Seat 4: DR. ELDAR (9875 in chips) 
Seat 5: chrichrac (10001 in chips) 
Seat 6: GabrielTho1 (25197 in chips) 
maiconvol75: posts the ante 125
Aidy703: posts the ante 125
Eat_U_Up_ha: posts the ante 125
DR. ELDAR: posts the ante 125
chrichrac: posts the ante 125
GabrielTho1: posts the ante 125
maiconvol75: posts small blind 250
Aidy703: posts big blind 500
*** HOLE CARDS ***
Eat_U_Up_ha: folds 
DR. ELDAR: raises 550 to 1050
chrichrac: folds 
GabrielTho1: folds 
maiconvol75: folds 
Aidy703: calls 550
*** FLOP *** [Qd 7c 8d]
Aidy703: checks 
DR. ELDAR: bets 2573
Aidy703: folds 
Uncalled bet (2573) returned to DR. ELDAR
DR. ELDAR collected 3100 from pot
DR. ELDAR: doesn't show hand 
*** SUMMARY ***
Total pot 3100 | Rake 0 
Board [Qd 7c 8d]
Seat 1: maiconvol75 (small blind) folded before Flop
Seat 2: Aidy703 (big blind) folded on the Flop
Seat 3: Eat_U_Up_ha folded before Flop (didn't bet)
Seat 4: DR. ELDAR collected (3100)
Seat 5: chrichrac folded before Flop (didn't bet)
Seat 6: GabrielTho1 (button) folded before Flop (didn't bet)

PokerStars Hand #251209583063: Tournament #3769361908, $52.38+$2.62 USD Hold'em No Limit - Level XI (250/500) - 2024/06/26 22:34:34 UTC [2024/06/26 18:34:34 ET]
Table '3769361908 10' 6-max Seat #1 is the button
Seat 1: maiconvol75 (14206 in chips) 
Seat 2: Aidy703 (8575 in chips) 
Seat 3: Eat_U_Up_ha (8588 in chips) 
Seat 4: DR. ELDAR (11800 in chips) 
Seat 5: chrichrac (9876 in chips) 
Seat 6: GabrielTho1 (25072 in chips) 
maiconvol75: posts the ante 125
Aidy703: posts the ante 125
Eat_U_Up_ha: posts the ante 125
DR. ELDAR: posts the ante 125
chrichrac: posts the ante 125
GabrielTho1: posts the ante 125
Aidy703: posts small blind 250
Eat_U_Up_ha: posts big blind 500
*** HOLE CARDS ***
DR. ELDAR: folds 
chrichrac: folds 
GabrielTho1: folds 
maiconvol75: raises 1000 to 1500
Aidy703: folds 
Eat_U_Up_ha: folds 
Uncalled bet (1000) returned to maiconvol75
maiconvol75 collected 2000 from pot
maiconvol75: doesn't show hand 
*** SUMMARY ***
Total pot 2000 | Rake 0 
Seat 1: maiconvol75 (button) collected (2000)
Seat 2: Aidy703 (small blind) folded before Flop
Seat 3: Eat_U_Up_ha (big blind) folded before Flop
Seat 4: DR. ELDAR folded before Flop (didn't bet)
Seat 5: chrichrac folded before Flop (didn't bet)
Seat 6: GabrielTho1 folded before Flop (didn't bet)

PokerStars Hand #251209591104: Tournament #3769361908, $52.38+$2.62 USD Hold'em No Limit - Level XI (250/500) - 2024/06/26 22:35:04 UTC [2024/06/26 18:35:04 ET]
Table '3769361908 10' 6-max Seat #2 is the button
Seat 1: maiconvol75 (15581 in chips) 
Seat 2: Aidy703 (8200 in chips) 
Seat 3: Eat_U_Up_ha (7963 in chips) 
Seat 4: DR. ELDAR (11675 in chips) 
Seat 5: chrichrac (9751 in chips) 
Seat 6: GabrielTho1 (24947 in chips) 
maiconvol75: posts the ante 125
Aidy703: posts the ante 125
Eat_U_Up_ha: posts the ante 125
DR. ELDAR: posts the ante 125
chrichrac: posts the ante 125
GabrielTho1: posts the ante 125
Eat_U_Up_ha: posts small blind 250
DR. ELDAR: posts big blind 500
*** HOLE CARDS ***
chrichrac: folds 
GabrielTho1: raises 500 to 1000
maiconvol75: folds 
Aidy703: folds 
Eat_U_Up_ha: raises 6838 to 7838 and is all-in
DR. ELDAR: folds 
GabrielTho1: calls 6838
*** FLOP *** [4d 4h As]
*** TURN *** [4d 4h As] [Jc]
*** RIVER *** [4d 4h As Jc] [9c]
*** SHOW DOWN ***
Eat_U_Up_ha: shows [Ks Ts] (a pair of Fours)
GabrielTho1: shows [Qc Js] (two pair, Jacks and Fours)
GabrielTho1 collected 16926 from pot
Eat_U_Up_ha finished the tournament
*** SUMMARY ***
Total pot 16926 | Rake 0 
Board [4d 4h As Jc 9c]
Seat 1: maiconvol75 folded before Flop (didn't bet)
Seat 2: Aidy703 (button) folded before Flop (didn't bet)
Seat 3: Eat_U_Up_ha (small blind) showed [Ks Ts] and lost with a pair of Fours
Seat 4: DR. ELDAR (big blind) folded before Flop
Seat 5: chrichrac folded before Flop (didn't bet)
Seat 6: GabrielTho1 showed [Qc Js] and won (16926) with two pair, Jacks and Fours

PokerStars Hand #251209602448: Tournament #3769361908, $52.38+$2.62 USD Hold'em No Limit - Level XII (300/600) - 2024/06/26 22:35:46 UTC [2024/06/26 18:35:46 ET]
Table '3769361908 10' 6-max Seat #4 is the button
Seat 1: maiconvol75 (15456 in chips) 
Seat 2: Aidy703 (8075 in chips) 
Seat 4: DR. ELDAR (11050 in chips) 
Seat 5: chrichrac (9626 in chips) 
Seat 6: GabrielTho1 (33910 in chips) 
maiconvol75: posts the ante 150
Aidy703: posts the ante 150
DR. ELDAR: posts the ante 150
chrichrac: posts the ante 150
GabrielTho1: posts the ante 150
chrichrac: posts small blind 300
GabrielTho1: posts big blind 600
*** HOLE CARDS ***
maiconvol75: calls 600
Aidy703: folds 
DR. ELDAR: folds 
chrichrac: folds 
GabrielTho1: checks 
*** FLOP *** [3c 2h Jh]
GabrielTho1: checks 
maiconvol75: bets 1125
GabrielTho1: folds 
Uncalled bet (1125) returned to maiconvol75
maiconvol75 collected 2250 from pot
maiconvol75: doesn't show hand 
*** SUMMARY ***
Total pot 2250 | Rake 0 
Board [3c 2h Jh]
Seat 1: maiconvol75 collected (2250)
Seat 2: Aidy703 folded before Flop (didn't bet)
Seat 4: DR. ELDAR (button) folded before Flop (didn't bet)
Seat 5: chrichrac (small blind) folded before Flop
Seat 6: GabrielTho1 (big blind) folded on the Flop

PokerStars Hand #251209616154: Tournament #3769361908, $52.38+$2.62 USD Hold'em No Limit - Level XII (300/600) - 2024/06/26 22:36:37 UTC [2024/06/26 18:36:37 ET]
Table '3769361908 10' 6-max Seat #5 is the button
Seat 1: maiconvol75 (16956 in chips) 
Seat 2: Aidy703 (7925 in chips) 
Seat 4: DR. ELDAR (10900 in chips) 
Seat 5: chrichrac (9176 in chips) 
Seat 6: GabrielTho1 (33160 in chips) 
maiconvol75: posts the ante 150
Aidy703: posts the ante 150
DR. ELDAR: posts the ante 150
chrichrac: posts the ante 150
GabrielTho1: posts the ante 150
GabrielTho1: posts small blind 300
maiconvol75: posts big blind 600
*** HOLE CARDS ***
Aidy703: folds 
DR. ELDAR: folds 
chrichrac: raises 8426 to 9026 and is all-in
GabrielTho1: folds 
maiconvol75: folds 
Uncalled bet (8426) returned to chrichrac
chrichrac collected 2250 from pot
chrichrac: doesn't show hand 
*** SUMMARY ***
Total pot 2250 | Rake 0 
Seat 1: maiconvol75 (big blind) folded before Flop
Seat 2: Aidy703 folded before Flop (didn't bet)
Seat 4: DR. ELDAR folded before Flop (didn't bet)
Seat 5: chrichrac (button) collected (2250)
Seat 6: GabrielTho1 (small blind) folded before Flop

PokerStars Hand #251209621184: Tournament #3769361908, $52.38+$2.62 USD Hold'em No Limit - Level XII (300/600) - 2024/06/26 22:36:56 UTC [2024/06/26 18:36:56 ET]
Table '3769361908 10' 6-max Seat #6 is the button
Seat 1: maiconvol75 (16206 in chips) 
Seat 2: Aidy703 (7775 in chips) 
Seat 4: DR. ELDAR (10750 in chips) 
Seat 5: chrichrac (10676 in chips) 
Seat 6: GabrielTho1 (32710 in chips) 
maiconvol75: posts the ante 150
Aidy703: posts the ante 150
DR. ELDAR: posts the ante 150
chrichrac: posts the ante 150
GabrielTho1: posts the ante 150
maiconvol75: posts small blind 300
Aidy703: posts big blind 600
*** HOLE CARDS ***
DR. ELDAR: folds 
chrichrac: folds 
GabrielTho1: folds 
maiconvol75: calls 300
Aidy703: checks 
*** FLOP *** [Qs 7c 2d]
maiconvol75: bets 975
Aidy703: calls 975
*** TURN *** [Qs 7c 2d] [4h]
maiconvol75: bets 4200
Aidy703: raises 1850 to 6050 and is all-in
maiconvol75: calls 1850
*** RIVER *** [Qs 7c 2d 4h] [Ac]
*** SHOW DOWN ***
maiconvol75: shows [Qh Jd] (a pair of Queens)
Aidy703: shows [4c 7h] (two pair, Sevens and Fours)
Aidy703 collected 16000 from pot
*** SUMMARY ***
Total pot 16000 | Rake 0 
Board [Qs 7c 2d 4h Ac]
Seat 1: maiconvol75 (small blind) showed [Qh Jd] and lost with a pair of Queens
Seat 2: Aidy703 (big blind) showed [4c 7h] and won (16000) with two pair, Sevens and Fours
Seat 4: DR. ELDAR folded before Flop (didn't bet)
Seat 5: chrichrac folded before Flop (didn't bet)
Seat 6: GabrielTho1 (button) folded before Flop (didn't bet)

PokerStars Hand #251209634440: Tournament #3769361908, $52.38+$2.62 USD Hold'em No Limit - Level XII (300/600) - 2024/06/26 22:37:46 UTC [2024/06/26 18:37:46 ET]
Table '3769361908 10' 6-max Seat #1 is the button
Seat 1: maiconvol75 (8431 in chips) 
Seat 2: Aidy703 (16000 in chips) 
Seat 4: DR. ELDAR (10600 in chips) 
Seat 5: chrichrac (10526 in chips) 
Seat 6: GabrielTho1 (32560 in chips) 
maiconvol75: posts the ante 150
Aidy703: posts the ante 150
DR. ELDAR: posts the ante 150
chrichrac: posts the ante 150
GabrielTho1: posts the ante 150
Aidy703: posts small blind 300
DR. ELDAR: posts big blind 600
*** HOLE CARDS ***
chrichrac: folds 
GabrielTho1: folds 
maiconvol75: folds 
Aidy703: raises 600 to 1200
DR. ELDAR: raises 9250 to 10450 and is all-in
Aidy703: folds 
Uncalled bet (9250) returned to DR. ELDAR
DR. ELDAR collected 3150 from pot
DR. ELDAR: doesn't show hand 
*** SUMMARY ***
Total pot 3150 | Rake 0 
Seat 1: maiconvol75 (button) folded before Flop (didn't bet)
Seat 2: Aidy703 (small blind) folded before Flop
Seat 4: DR. ELDAR (big blind) collected (3150)
Seat 5: chrichrac folded before Flop (didn't bet)
Seat 6: GabrielTho1 folded before Flop (didn't bet)

PokerStars Hand #251209644719: Tournament #3769361908, $52.38+$2.62 USD Hold'em No Limit - Level XIII (400/800) - 2024/06/26 22:38:25 UTC [2024/06/26 18:38:25 ET]
Table '3769361908 10' 6-max Seat #2 is the button
Seat 1: maiconvol75 (8281 in chips) 
Seat 2: Aidy703 (14650 in chips) 
Seat 4: DR. ELDAR (12400 in chips) 
Seat 5: chrichrac (10376 in chips) 
Seat 6: GabrielTho1 (32410 in chips) 
maiconvol75: posts the ante 200
Aidy703: posts the ante 200
DR. ELDAR: posts the ante 200
chrichrac: posts the ante 200
GabrielTho1: posts the ante 200
DR. ELDAR: posts small blind 400
chrichrac: posts big blind 800
*** HOLE CARDS ***
GabrielTho1: raises 800 to 1600
maiconvol75: folds 
Aidy703: calls 1600
DR. ELDAR: folds 
chrichrac: folds 
*** FLOP *** [2c 9c Ks]
GabrielTho1: bets 1350
Aidy703: raises 2950 to 4300
joaoMathias is disconnected 
GabrielTho1: folds 
Uncalled bet (2950) returned to Aidy703
Aidy703 collected 8100 from pot
*** SUMMARY ***
Total pot 8100 | Rake 0 
Board [2c 9c Ks]
Seat 1: maiconvol75 folded before Flop (didn't bet)
Seat 2: Aidy703 (button) collected (8100)
Seat 4: DR. ELDAR (small blind) folded before Flop
Seat 5: chrichrac (big blind) folded before Flop
Seat 6: GabrielTho1 folded on the Flop

PokerStars Hand #251209657268: Tournament #3769361908, $52.38+$2.62 USD Hold'em No Limit - Level XIII (400/800) - 2024/06/26 22:39:11 UTC [2024/06/26 18:39:11 ET]
Table '3769361908 10' 6-max Seat #4 is the button
Seat 1: maiconvol75 (8081 in chips) 
Seat 2: Aidy703 (19600 in chips) 
Seat 3: joaoMathias (10000 in chips) 
Seat 4: DR. ELDAR (11800 in chips) 
Seat 5: chrichrac (9376 in chips) 
Seat 6: GabrielTho1 (29260 in chips) 
maiconvol75: posts the ante 200
Aidy703: posts the ante 200
joaoMathias: posts the ante 200
DR. ELDAR: posts the ante 200
chrichrac: posts the ante 200
GabrielTho1: posts the ante 200
chrichrac: posts small blind 400
GabrielTho1: posts big blind 800
*** HOLE CARDS ***
maiconvol75: raises 7081 to 7881 and is all-in
Aidy703: folds 
joaoMathias: folds 
DR. ELDAR: folds 
chrichrac: folds 
GabrielTho1: folds 
Uncalled bet (7081) returned to maiconvol75
maiconvol75 collected 3200 from pot
maiconvol75: doesn't show hand 
*** SUMMARY ***
Total pot 3200 | Rake 0 
Seat 1: maiconvol75 collected (3200)
Seat 2: Aidy703 folded before Flop (didn't bet)
Seat 3: joaoMathias folded before Flop (didn't bet)
Seat 4: DR. ELDAR (button) folded before Flop (didn't bet)
Seat 5: chrichrac (small blind) folded before Flop
Seat 6: GabrielTho1 (big blind) folded before Flop

PokerStars Hand #251209662207: Tournament #3769361908, $52.38+$2.62 USD Hold'em No Limit - Level XIII (400/800) - 2024/06/26 22:39:29 UTC [2024/06/26 18:39:29 ET]
Table '3769361908 10' 6-max Seat #5 is the button
Seat 1: maiconvol75 (10281 in chips) 
Seat 2: Aidy703 (19400 in chips) 
Seat 3: joaoMathias (9800 in chips) 
Seat 4: DR. ELDAR (11600 in chips) 
Seat 5: chrichrac (8776 in chips) 
Seat 6: GabrielTho1 (28260 in chips) 
maiconvol75: posts the ante 200
Aidy703: posts the ante 200
joaoMathias: posts the ante 200
DR. ELDAR: posts the ante 200
chrichrac: posts the ante 200
GabrielTho1: posts the ante 200
GabrielTho1: posts small blind 400
maiconvol75: posts big blind 800
*** HOLE CARDS ***
Aidy703: folds 
joaoMathias: folds 
DR. ELDAR: folds 
chrichrac: raises 7776 to 8576 and is all-in
GabrielTho1: folds 
maiconvol75: calls 7776
*** FLOP *** [7h Td Kd]
*** TURN *** [7h Td Kd] [3d]
*** RIVER *** [7h Td Kd 3d] [7d]
*** SHOW DOWN ***
maiconvol75: shows [9h Jh] (a pair of Sevens)
chrichrac: shows [Ts Qd] (a flush, King high)
chrichrac collected 18752 from pot
*** SUMMARY ***
Total pot 18752 | Rake 0 
Board [7h Td Kd 3d 7d]
Seat 1: maiconvol75 (big blind) showed [9h Jh] and lost with a pair of Sevens
Seat 2: Aidy703 folded before Flop (didn't bet)
Seat 3: joaoMathias folded before Flop (didn't bet)
Seat 4: DR. ELDAR folded before Flop (didn't bet)
Seat 5: chrichrac (button) showed [Ts Qd] and won (18752) with a flush, King high
Seat 6: GabrielTho1 (small blind) folded before Flop

PokerStars Hand #251209669617: Tournament #3769361908, $52.38+$2.62 USD Hold'em No Limit - Level XIII (400/800) - 2024/06/26 22:39:57 UTC [2024/06/26 18:39:57 ET]
Table '3769361908 10' 6-max Seat #6 is the button
Seat 1: maiconvol75 (1505 in chips) 
Seat 2: Aidy703 (19200 in chips) 
Seat 3: joaoMathias (9600 in chips) 
Seat 4: DR. ELDAR (11400 in chips) 
Seat 5: chrichrac (18752 in chips) 
Seat 6: GabrielTho1 (27660 in chips) 
maiconvol75: posts the ante 200
Aidy703: posts the ante 200
joaoMathias: posts the ante 200
DR. ELDAR: posts the ante 200
chrichrac: posts the ante 200
GabrielTho1: posts the ante 200
maiconvol75: posts small blind 400
Aidy703: posts big blind 800
*** HOLE CARDS ***
joaoMathias: folds 
DR. ELDAR: folds 
chrichrac: folds 
GabrielTho1: raises 26660 to 27460 and is all-in
maiconvol75: calls 905 and is all-in
Aidy703: folds 
Uncalled bet (26155) returned to GabrielTho1
*** FLOP *** [4s 2h 5c]
*** TURN *** [4s 2h 5c] [3h]
*** RIVER *** [4s 2h 5c 3h] [As]
*** SHOW DOWN ***
maiconvol75: shows [Qs Kd] (a straight, Ace to Five)
GabrielTho1: shows [9s Ah] (a straight, Ace to Five)
maiconvol75 collected 2305 from pot
GabrielTho1 collected 2305 from pot
*** SUMMARY ***
Total pot 4610 | Rake 0 
Board [4s 2h 5c 3h As]
Seat 1: maiconvol75 (small blind) showed [Qs Kd] and won (2305) with a straight, Ace to Five
Seat 2: Aidy703 (big blind) folded before Flop
Seat 3: joaoMathias folded before Flop (didn't bet)
Seat 4: DR. ELDAR folded before Flop (didn't bet)
Seat 5: chrichrac folded before Flop (didn't bet)
Seat 6: GabrielTho1 (button) showed [9s Ah] and won (2305) with a straight, Ace to Five

PokerStars Hand #251209679224: Tournament #3769361908, $52.38+$2.62 USD Hold'em No Limit - Level XIII (400/800) - 2024/06/26 22:40:34 UTC [2024/06/26 18:40:34 ET]
Table '3769361908 10' 6-max Seat #1 is the button
Seat 1: maiconvol75 (2305 in chips) 
Seat 2: Aidy703 (18200 in chips) 
Seat 3: joaoMathias (9400 in chips) 
Seat 4: DR. ELDAR (11200 in chips) 
Seat 5: chrichrac (18552 in chips) 
Seat 6: GabrielTho1 (28460 in chips) 
maiconvol75: posts the ante 200
Aidy703: posts the ante 200
joaoMathias: posts the ante 200
DR. ELDAR: posts the ante 200
chrichrac: posts the ante 200
GabrielTho1: posts the ante 200
Aidy703: posts small blind 400
joaoMathias: posts big blind 800
*** HOLE CARDS ***
DR. ELDAR: folds 
chrichrac: folds 
GabrielTho1: folds 
maiconvol75: raises 1305 to 2105 and is all-in
Aidy703: calls 1705
joaoMathias: calls 1305
*** FLOP *** [Qc 6c 4c]
Aidy703: checks 
joaoMathias: checks 
*** TURN *** [Qc 6c 4c] [9h]
Aidy703: bets 1600
joaoMathias: calls 1600
*** RIVER *** [Qc 6c 4c 9h] [Jc]
Aidy703: checks 
joaoMathias: checks 
*** SHOW DOWN ***
Aidy703: shows [Kd Th] (a straight, Nine to King)
joaoMathias: shows [7c 8s] (a flush, Queen high)
joaoMathias collected 3200 from side pot
maiconvol75: mucks hand 
joaoMathias collected 7515 from main pot
maiconvol75 finished the tournament
*** SUMMARY ***
Total pot 10715 Main pot 7515. Side pot 3200. | Rake 0 
Board [Qc 6c 4c 9h Jc]
Seat 1: maiconvol75 (button) mucked
Seat 2: Aidy703 (small blind) showed [Kd Th] and lost with a straight, Nine to King
Seat 3: joaoMathias (big blind) showed [7c 8s] and won (10715) with a flush, Queen high
Seat 4: DR. ELDAR folded before Flop (didn't bet)
Seat 5: chrichrac folded before Flop (didn't bet)
Seat 6: GabrielTho1 folded before Flop (didn't bet)

PokerStars Hand #251209694573: Tournament #3769361908, $52.38+$2.62 USD Hold'em No Limit - Level XIV (500/1000) - 2024/06/26 22:41:33 UTC [2024/06/26 18:41:33 ET]
Table '3769361908 10' 6-max Seat #2 is the button
Seat 2: Aidy703 (14295 in chips) 
Seat 3: joaoMathias (16210 in chips) 
Seat 4: DR. ELDAR (11000 in chips) 
Seat 5: chrichrac (18352 in chips) 
Seat 6: GabrielTho1 (28260 in chips) 
Aidy703: posts the ante 250
joaoMathias: posts the ante 250
DR. ELDAR: posts the ante 250
chrichrac: posts the ante 250
GabrielTho1: posts the ante 250
joaoMathias: posts small blind 500
DR. ELDAR: posts big blind 1000
*** HOLE CARDS ***
chrichrac: raises 17102 to 18102 and is all-in
GabrielTho1: folds 
Aidy703: folds 
mennck is disconnected 
joaoMathias: folds 
DR. ELDAR: folds 
Uncalled bet (17102) returned to chrichrac
chrichrac collected 3750 from pot
chrichrac: doesn't show hand 
*** SUMMARY ***
Total pot 3750 | Rake 0 
Seat 2: Aidy703 (button) folded before Flop (didn't bet)
Seat 3: joaoMathias (small blind) folded before Flop
Seat 4: DR. ELDAR (big blind) folded before Flop
Seat 5: chrichrac collected (3750)
Seat 6: GabrielTho1 folded before Flop (didn't bet)

PokerStars Hand #251209704642: Tournament #3769361908, $52.38+$2.62 USD Hold'em No Limit - Level XIV (500/1000) - 2024/06/26 22:42:12 UTC [2024/06/26 18:42:12 ET]
Table '3769361908 10' 6-max Seat #3 is the button
Seat 1: mennck (5743 in chips) 
Seat 2: Aidy703 (14045 in chips) 
Seat 3: joaoMathias (15460 in chips) 
Seat 4: DR. ELDAR (9750 in chips) 
Seat 5: chrichrac (20852 in chips) 
Seat 6: GabrielTho1 (28010 in chips) 
mennck: posts the ante 250
Aidy703: posts the ante 250
joaoMathias: posts the ante 250
DR. ELDAR: posts the ante 250
chrichrac: posts the ante 250
GabrielTho1: posts the ante 250
DR. ELDAR: posts small blind 500
chrichrac: posts big blind 1000
*** HOLE CARDS ***
GabrielTho1: raises 1000 to 2000
mennck: folds 
Aidy703: folds 
joaoMathias: folds 
DR. ELDAR: folds 
chrichrac: folds 
Uncalled bet (1000) returned to GabrielTho1
GabrielTho1 collected 4000 from pot
GabrielTho1: doesn't show hand 
*** SUMMARY ***
Total pot 4000 | Rake 0 
Seat 1: mennck folded before Flop (didn't bet)
Seat 2: Aidy703 folded before Flop (didn't bet)
Seat 3: joaoMathias (button) folded before Flop (didn't bet)
Seat 4: DR. ELDAR (small blind) folded before Flop
Seat 5: chrichrac (big blind) folded before Flop
Seat 6: GabrielTho1 collected (4000)

PokerStars Hand #251209713433: Tournament #3769361908, $52.38+$2.62 USD Hold'em No Limit - Level XIV (500/1000) - 2024/06/26 22:42:46 UTC [2024/06/26 18:42:46 ET]
Table '3769361908 10' 6-max Seat #4 is the button
Seat 1: mennck (5493 in chips) 
Seat 2: Aidy703 (13795 in chips) 
Seat 3: joaoMathias (15210 in chips) 
Seat 4: DR. ELDAR (9000 in chips) 
Seat 5: chrichrac (19602 in chips) 
Seat 6: GabrielTho1 (30760 in chips) 
mennck: posts the ante 250
Aidy703: posts the ante 250
joaoMathias: posts the ante 250
DR. ELDAR: posts the ante 250
chrichrac: posts the ante 250
GabrielTho1: posts the ante 250
chrichrac: posts small blind 500
GabrielTho1: posts big blind 1000
*** HOLE CARDS ***
mennck: raises 4243 to 5243 and is all-in
Aidy703: folds 
joaoMathias: folds 
DR. ELDAR: folds 
chrichrac: folds 
GabrielTho1: calls 4243
*** FLOP *** [5d Jc Tc]
*** TURN *** [5d Jc Tc] [3c]
*** RIVER *** [5d Jc Tc 3c] [3s]
*** SHOW DOWN ***
GabrielTho1: shows [Qd Jh] (two pair, Jacks and Threes)
mennck: shows [8h Ad] (a pair of Threes)
GabrielTho1 collected 12486 from pot
mennck finished the tournament
*** SUMMARY ***
Total pot 12486 | Rake 0 
Board [5d Jc Tc 3c 3s]
Seat 1: mennck showed [8h Ad] and lost with a pair of Threes
Seat 2: Aidy703 folded before Flop (didn't bet)
Seat 3: joaoMathias folded before Flop (didn't bet)
Seat 4: DR. ELDAR (button) folded before Flop (didn't bet)
Seat 5: chrichrac (small blind) folded before Flop
Seat 6: GabrielTho1 (big blind) showed [Qd Jh] and won (12486) with two pair, Jacks and Threes

PokerStars Hand #251209720886: Tournament #3769361908, $52.38+$2.62 USD Hold'em No Limit - Level XIV (500/1000) - 2024/06/26 22:43:15 UTC [2024/06/26 18:43:15 ET]
Table '3769361908 10' 6-max Seat #5 is the button
Seat 2: Aidy703 (13545 in chips) 
Seat 3: joaoMathias (14960 in chips) 
Seat 4: DR. ELDAR (8750 in chips) 
Seat 5: chrichrac (18852 in chips) 
Seat 6: GabrielTho1 (37753 in chips) 
Aidy703: posts the ante 250
joaoMathias: posts the ante 250
DR. ELDAR: posts the ante 250
chrichrac: posts the ante 250
GabrielTho1: posts the ante 250
GabrielTho1: posts small blind 500
Aidy703: posts big blind 1000
*** HOLE CARDS ***
joaoMathias: raises 13710 to 14710 and is all-in
DR. ELDAR: folds 
chrichrac: folds 
GabrielTho1: folds 
Aidy703: folds 
Uncalled bet (13710) returned to joaoMathias
joaoMathias collected 3750 from pot
joaoMathias: doesn't show hand 
*** SUMMARY ***
Total pot 3750 | Rake 0 
Seat 2: Aidy703 (big blind) folded before Flop
Seat 3: joaoMathias collected (3750)
Seat 4: DR. ELDAR folded before Flop (didn't bet)
Seat 5: chrichrac (button) folded before Flop (didn't bet)
Seat 6: GabrielTho1 (small blind) folded before Flop

PokerStars Hand #251209724040: Tournament #3769361908, $52.38+$2.62 USD Hold'em No Limit - Level XIV (500/1000) - 2024/06/26 22:43:28 UTC [2024/06/26 18:43:28 ET]
Table '3769361908 10' 6-max Seat #6 is the button
Seat 2: Aidy703 (12295 in chips) 
Seat 3: joaoMathias (17460 in chips) 
Seat 4: DR. ELDAR (8500 in chips) 
Seat 5: chrichrac (18602 in chips) 
Seat 6: GabrielTho1 (37003 in chips) 
Aidy703: posts the ante 250
joaoMathias: posts the ante 250
DR. ELDAR: posts the ante 250
chrichrac: posts the ante 250
GabrielTho1: posts the ante 250
Aidy703: posts small blind 500
joaoMathias: posts big blind 1000
*** HOLE CARDS ***
radek0444 is disconnected 
DR. ELDAR: folds 
chrichrac: folds 
GabrielTho1: folds 
Aidy703: folds 
Uncalled bet (500) returned to joaoMathias
joaoMathias collected 2250 from pot
joaoMathias: doesn't show hand 
*** SUMMARY ***
Total pot 2250 | Rake 0 
Seat 2: Aidy703 (small blind) folded before Flop
Seat 3: joaoMathias (big blind) collected (2250)
Seat 4: DR. ELDAR folded before Flop (didn't bet)
Seat 5: chrichrac folded before Flop (didn't bet)
Seat 6: GabrielTho1 (button) folded before Flop (didn't bet)

PokerStars Hand #251209730590: Tournament #3769361908, $52.38+$2.62 USD Hold'em No Limit - Level XIV (500/1000) - 2024/06/26 22:43:53 UTC [2024/06/26 18:43:53 ET]
Table '3769361908 10' 6-max Seat #2 is the button
Seat 1: radek0444 (10000 in chips) 
Seat 2: Aidy703 (11545 in chips) 
Seat 3: joaoMathias (18960 in chips) 
Seat 4: DR. ELDAR (8250 in chips) 
Seat 5: chrichrac (18352 in chips) 
Seat 6: GabrielTho1 (36753 in chips) 
radek0444: posts the ante 250
Aidy703: posts the ante 250
joaoMathias: posts the ante 250
DR. ELDAR: posts the ante 250
chrichrac: posts the ante 250
GabrielTho1: posts the ante 250
joaoMathias: posts small blind 500
DR. ELDAR: posts big blind 1000
*** HOLE CARDS ***
chrichrac: folds 
GabrielTho1: folds 
radek0444: folds 
Aidy703: folds 
joaoMathias: raises 17710 to 18710 and is all-in
DR. ELDAR: folds 
Uncalled bet (17710) returned to joaoMathias
joaoMathias collected 3500 from pot
joaoMathias: doesn't show hand 
*** SUMMARY ***
Total pot 3500 | Rake 0 
Seat 1: radek0444 folded before Flop (didn't bet)
Seat 2: Aidy703 (button) folded before Flop (didn't bet)
Seat 3: joaoMathias (small blind) collected (3500)
Seat 4: DR. ELDAR (big blind) folded before Flop
Seat 5: chrichrac folded before Flop (didn't bet)
Seat 6: GabrielTho1 folded before Flop (didn't bet)

PokerStars Hand #251209734702: Tournament #3769361908, $52.38+$2.62 USD Hold'em No Limit - Level XIV (500/1000) - 2024/06/26 22:44:09 UTC [2024/06/26 18:44:09 ET]
Table '3769361908 10' 6-max Seat #3 is the button
Seat 1: radek0444 (9750 in chips) 
Seat 2: Aidy703 (11295 in chips) 
Seat 3: joaoMathias (21210 in chips) 
Seat 4: DR. ELDAR (7000 in chips) 
Seat 5: chrichrac (18102 in chips) 
Seat 6: GabrielTho1 (36503 in chips) 
radek0444: posts the ante 250
Aidy703: posts the ante 250
joaoMathias: posts the ante 250
DR. ELDAR: posts the ante 250
chrichrac: posts the ante 250
GabrielTho1: posts the ante 250
DR. ELDAR: posts small blind 500
chrichrac: posts big blind 1000
*** HOLE CARDS ***
GabrielTho1: raises 35253 to 36253 and is all-in
radek0444: folds 
Aidy703: folds 
joaoMathias: folds 
DR. ELDAR: folds 
chrichrac: folds 
Uncalled bet (35253) returned to GabrielTho1
GabrielTho1 collected 4000 from pot
GabrielTho1: doesn't show hand 
*** SUMMARY ***
Total pot 4000 | Rake 0 
Seat 1: radek0444 folded before Flop (didn't bet)
Seat 2: Aidy703 folded before Flop (didn't bet)
Seat 3: joaoMathias (button) folded before Flop (didn't bet)
Seat 4: DR. ELDAR (small blind) folded before Flop
Seat 5: chrichrac (big blind) folded before Flop
Seat 6: GabrielTho1 collected (4000)

PokerStars Hand #251209742482: Tournament #3769361908, $52.38+$2.62 USD Hold'em No Limit - Level XV (600/1200) - 2024/06/26 22:44:40 UTC [2024/06/26 18:44:40 ET]
Table '3769361908 10' 6-max Seat #4 is the button
Seat 1: radek0444 (9500 in chips) 
Seat 2: Aidy703 (11045 in chips) 
Seat 3: joaoMathias (20960 in chips) 
Seat 4: DR. ELDAR (6250 in chips) 
Seat 5: chrichrac (16852 in chips) 
Seat 6: GabrielTho1 (39253 in chips) 
radek0444: posts the ante 300
Aidy703: posts the ante 300
joaoMathias: posts the ante 300
DR. ELDAR: posts the ante 300
chrichrac: posts the ante 300
GabrielTho1: posts the ante 300
chrichrac: posts small blind 600
GabrielTho1: posts big blind 1200
*** HOLE CARDS ***
radek0444: folds 
Aidy703: folds 
joaoMathias: raises 1200 to 2400
DR. ELDAR: folds 
chrichrac: folds 
GabrielTho1: calls 1200
*** FLOP *** [8d 3s 9c]
GabrielTho1: checks 
joaoMathias: bets 2520
GabrielTho1: raises 34033 to 36553 and is all-in
joaoMathias: folds 
Uncalled bet (34033) returned to GabrielTho1
GabrielTho1 collected 12240 from pot
GabrielTho1: doesn't show hand 
*** SUMMARY ***
Total pot 12240 | Rake 0 
Board [8d 3s 9c]
Seat 1: radek0444 folded before Flop (didn't bet)
Seat 2: Aidy703 folded before Flop (didn't bet)
Seat 3: joaoMathias folded on the Flop
Seat 4: DR. ELDAR (button) folded before Flop (didn't bet)
Seat 5: chrichrac (small blind) folded before Flop
Seat 6: GabrielTho1 (big blind) collected (12240)

PokerStars Hand #251209755377: Tournament #3769361908, $52.38+$2.62 USD Hold'em No Limit - Level XV (600/1200) - 2024/06/26 22:45:29 UTC [2024/06/26 18:45:29 ET]
Table '3769361908 10' 6-max Seat #5 is the button
Seat 1: radek0444 (9200 in chips) 
Seat 2: Aidy703 (10745 in chips) 
Seat 3: joaoMathias (15740 in chips) 
Seat 4: DR. ELDAR (5950 in chips) 
Seat 5: chrichrac (15952 in chips) 
Seat 6: GabrielTho1 (46273 in chips) 
radek0444: posts the ante 300
Aidy703: posts the ante 300
joaoMathias: posts the ante 300
DR. ELDAR: posts the ante 300
chrichrac: posts the ante 300
GabrielTho1: posts the ante 300
GabrielTho1: posts small blind 600
radek0444: posts big blind 1200
*** HOLE CARDS ***
Aidy703: folds 
joaoMathias: folds 
DR. ELDAR: folds 
chrichrac: raises 14452 to 15652 and is all-in
GabrielTho1: folds 
radek0444: calls 7700 and is all-in
Uncalled bet (6752) returned to chrichrac
*** FLOP *** [5c 2h 3c]
*** TURN *** [5c 2h 3c] [Qs]
*** RIVER *** [5c 2h 3c Qs] [3h]
*** SHOW DOWN ***
radek0444: shows [Ad Jh] (a pair of Threes)
chrichrac: shows [As 2s] (two pair, Threes and Deuces)
chrichrac collected 20200 from pot
radek0444 finished the tournament
*** SUMMARY ***
Total pot 20200 | Rake 0 
Board [5c 2h 3c Qs 3h]
Seat 1: radek0444 (big blind) showed [Ad Jh] and lost with a pair of Threes
Seat 2: Aidy703 folded before Flop (didn't bet)
Seat 3: joaoMathias folded before Flop (didn't bet)
Seat 4: DR. ELDAR folded before Flop (didn't bet)
Seat 5: chrichrac (button) showed [As 2s] and won (20200) with two pair, Threes and Deuces
Seat 6: GabrielTho1 (small blind) folded before Flop

PokerStars Hand #251209770267: Tournament #3769361908, $52.38+$2.62 USD Hold'em No Limit - Level XV (600/1200) - 2024/06/26 22:46:27 UTC [2024/06/26 18:46:27 ET]
Table '3769361908 10' 6-max Seat #6 is the button
Seat 2: Aidy703 (10445 in chips) 
Seat 3: joaoMathias (15440 in chips) 
Seat 4: DR. ELDAR (5650 in chips) 
Seat 5: chrichrac (26952 in chips) 
Seat 6: GabrielTho1 (45373 in chips) 
Aidy703: posts the ante 300
joaoMathias: posts the ante 300
DR. ELDAR: posts the ante 300
chrichrac: posts the ante 300
GabrielTho1: posts the ante 300
Aidy703: posts small blind 600
joaoMathias: posts big blind 1200
*** HOLE CARDS ***
DR. ELDAR: raises 2400 to 3600
chrichrac: folds 
GabrielTho1: folds 
Aidy703: folds 
LeslieGroves is disconnected 
joaoMathias: calls 2400
*** FLOP *** [Qd 9h Js]
joaoMathias: bets 1800
DR. ELDAR: calls 1750 and is all-in
Uncalled bet (50) returned to joaoMathias
*** TURN *** [Qd 9h Js] [2d]
*** RIVER *** [Qd 9h Js 2d] [4h]
*** SHOW DOWN ***
joaoMathias: shows [5s Qh] (a pair of Queens)
DR. ELDAR: shows [Kd Tc] (a straight, Nine to King)
DR. ELDAR collected 12800 from pot
*** SUMMARY ***
Total pot 12800 | Rake 0 
Board [Qd 9h Js 2d 4h]
Seat 2: Aidy703 (small blind) folded before Flop
Seat 3: joaoMathias (big blind) showed [5s Qh] and lost with a pair of Queens
Seat 4: DR. ELDAR showed [Kd Tc] and won (12800) with a straight, Nine to King
Seat 5: chrichrac folded before Flop (didn't bet)
Seat 6: GabrielTho1 (button) folded before Flop (didn't bet)

PokerStars Hand #251209781096: Tournament #3769361908, $52.38+$2.62 USD Hold'em No Limit - Level XV (600/1200) - 2024/06/26 22:47:09 UTC [2024/06/26 18:47:09 ET]
Table '3769361908 10' 6-max Seat #2 is the button
Seat 1: LeslieGroves (10000 in chips) 
Seat 2: Aidy703 (9545 in chips) 
Seat 3: joaoMathias (9790 in chips) 
Seat 4: DR. ELDAR (12800 in chips) 
Seat 5: chrichrac (26652 in chips) 
Seat 6: GabrielTho1 (45073 in chips) 
LeslieGroves: posts the ante 300
Aidy703: posts the ante 300
joaoMathias: posts the ante 300
DR. ELDAR: posts the ante 300
chrichrac: posts the ante 300
GabrielTho1: posts the ante 300
joaoMathias: posts small blind 600
DR. ELDAR: posts big blind 1200
*** HOLE CARDS ***
chrichrac: folds 
GabrielTho1: folds 
LeslieGroves: folds 
Aidy703: folds 
joaoMathias: raises 8290 to 9490 and is all-in
DR. ELDAR: folds 
Uncalled bet (8290) returned to joaoMathias
joaoMathias collected 4200 from pot
joaoMathias: doesn't show hand 
*** SUMMARY ***
Total pot 4200 | Rake 0 
Seat 1: LeslieGroves folded before Flop (didn't bet)
Seat 2: Aidy703 (button) folded before Flop (didn't bet)
Seat 3: joaoMathias (small blind) collected (4200)
Seat 4: DR. ELDAR (big blind) folded before Flop
Seat 5: chrichrac folded before Flop (didn't bet)
Seat 6: GabrielTho1 folded before Flop (didn't bet)

PokerStars Hand #251209786452: Tournament #3769361908, $52.38+$2.62 USD Hold'em No Limit - Level XVI (800/1600) - 2024/06/26 22:47:31 UTC [2024/06/26 18:47:31 ET]
Table '3769361908 10' 6-max Seat #3 is the button
Seat 1: LeslieGroves (9700 in chips) 
Seat 2: Aidy703 (9245 in chips) 
Seat 3: joaoMathias (12490 in chips) 
Seat 4: DR. ELDAR (11300 in chips) 
Seat 5: chrichrac (26352 in chips) 
Seat 6: GabrielTho1 (44773 in chips) 
LeslieGroves: posts the ante 400
Aidy703: posts the ante 400
joaoMathias: posts the ante 400
DR. ELDAR: posts the ante 400
chrichrac: posts the ante 400
GabrielTho1: posts the ante 400
DR. ELDAR: posts small blind 800
chrichrac: posts big blind 1600
*** HOLE CARDS ***
GabrielTho1: folds 
LeslieGroves: folds 
Aidy703: raises 7245 to 8845 and is all-in
joaoMathias: folds 
DR. ELDAR: folds 
chrichrac: folds 
Uncalled bet (7245) returned to Aidy703
Aidy703 collected 6400 from pot
*** SUMMARY ***
Total pot 6400 | Rake 0 
Seat 1: LeslieGroves folded before Flop (didn't bet)
Seat 2: Aidy703 collected (6400)
Seat 3: joaoMathias (button) folded before Flop (didn't bet)
Seat 4: DR. ELDAR (small blind) folded before Flop
Seat 5: chrichrac (big blind) folded before Flop
Seat 6: GabrielTho1 folded before Flop (didn't bet)

PokerStars Hand #251209792798: Tournament #3769361908, $52.38+$2.62 USD Hold'em No Limit - Level XVI (800/1600) - 2024/06/26 22:47:56 UTC [2024/06/26 18:47:56 ET]
Table '3769361908 10' 6-max Seat #4 is the button
Seat 1: LeslieGroves (9300 in chips) 
Seat 2: Aidy703 (13645 in chips) 
Seat 3: joaoMathias (12090 in chips) 
Seat 4: DR. ELDAR (10100 in chips) 
Seat 5: chrichrac (24352 in chips) 
Seat 6: GabrielTho1 (44373 in chips) 
LeslieGroves: posts the ante 400
Aidy703: posts the ante 400
joaoMathias: posts the ante 400
DR. ELDAR: posts the ante 400
chrichrac: posts the ante 400
GabrielTho1: posts the ante 400
chrichrac: posts small blind 800
GabrielTho1: posts big blind 1600
*** HOLE CARDS ***
LeslieGroves: folds 
Aidy703: folds 
joaoMathias: raises 10090 to 11690 and is all-in
DR. ELDAR: folds 
chrichrac: folds 
GabrielTho1: calls 10090
*** FLOP *** [6c 4s 6s]
*** TURN *** [6c 4s 6s] [Qs]
*** RIVER *** [6c 4s 6s Qs] [Jc]
*** SHOW DOWN ***
GabrielTho1: shows [Kh 8s] (a pair of Sixes)
joaoMathias: shows [Td 8d] (a pair of Sixes - lower kicker)
GabrielTho1 collected 26580 from pot
joaoMathias finished the tournament
*** SUMMARY ***
Total pot 26580 | Rake 0 
Board [6c 4s 6s Qs Jc]
Seat 1: LeslieGroves folded before Flop (didn't bet)
Seat 2: Aidy703 folded before Flop (didn't bet)
Seat 3: joaoMathias showed [Td 8d] and lost with a pair of Sixes
Seat 4: DR. ELDAR (button) folded before Flop (didn't bet)
Seat 5: chrichrac (small blind) folded before Flop
Seat 6: GabrielTho1 (big blind) showed [Kh 8s] and won (26580) with a pair of Sixes

PokerStars Hand #251209804313: Tournament #3769361908, $52.38+$2.62 USD Hold'em No Limit - Level XVI (800/1600) - 2024/06/26 22:48:41 UTC [2024/06/26 18:48:41 ET]
Table '3769361908 10' 6-max Seat #5 is the button
Seat 1: LeslieGroves (8900 in chips) 
Seat 2: Aidy703 (13245 in chips) 
Seat 4: DR. ELDAR (9700 in chips) 
Seat 5: chrichrac (23152 in chips) 
Seat 6: GabrielTho1 (58863 in chips) 
LeslieGroves: posts the ante 400
Aidy703: posts the ante 400
DR. ELDAR: posts the ante 400
chrichrac: posts the ante 400
GabrielTho1: posts the ante 400
GabrielTho1: posts small blind 800
LeslieGroves: posts big blind 1600
*** HOLE CARDS ***
Aidy703: folds 
DR. ELDAR: folds 
chrichrac: raises 21152 to 22752 and is all-in
GabrielTho1: folds 
Muringa.SP is disconnected 
LeslieGroves: calls 6900 and is all-in
Uncalled bet (14252) returned to chrichrac
*** FLOP *** [Td Qh Qd]
*** TURN *** [Td Qh Qd] [Jc]
*** RIVER *** [Td Qh Qd Jc] [3d]
*** SHOW DOWN ***
LeslieGroves: shows [8h As] (a pair of Queens)
chrichrac: shows [Ah 9c] (a pair of Queens)
LeslieGroves collected 9900 from pot
chrichrac collected 9900 from pot
*** SUMMARY ***
Total pot 19800 | Rake 0 
Board [Td Qh Qd Jc 3d]
Seat 1: LeslieGroves (big blind) showed [8h As] and won (9900) with a pair of Queens
Seat 2: Aidy703 folded before Flop (didn't bet)
Seat 4: DR. ELDAR folded before Flop (didn't bet)
Seat 5: chrichrac (button) showed [Ah 9c] and won (9900) with a pair of Queens
Seat 6: GabrielTho1 (small blind) folded before Flop

PokerStars Hand #251209815045: Tournament #3769361908, $52.38+$2.62 USD Hold'em No Limit - Level XVI (800/1600) - 2024/06/26 22:49:24 UTC [2024/06/26 18:49:24 ET]
Table '3769361908 10' 6-max Seat #6 is the button
Seat 1: LeslieGroves (9900 in chips) 
Seat 2: Aidy703 (12845 in chips) 
Seat 3: Muringa.SP (25775 in chips) 
Seat 4: DR. ELDAR (9300 in chips) 
Seat 5: chrichrac (24152 in chips) 
Seat 6: GabrielTho1 (57663 in chips) 
LeslieGroves: posts the ante 400
Aidy703: posts the ante 400
Muringa.SP: posts the ante 400
DR. ELDAR: posts the ante 400
chrichrac: posts the ante 400
GabrielTho1: posts the ante 400
LeslieGroves: posts small blind 800
Aidy703: posts big blind 1600
*** HOLE CARDS ***
Muringa.SP: folds 
DR. ELDAR: folds 
chrichrac: raises 22152 to 23752 and is all-in
GabrielTho1: raises 33511 to 57263 and is all-in
LeslieGroves: folds 
Aidy703: folds 
Uncalled bet (33511) returned to GabrielTho1
*** FLOP *** [Qs 4c 5h]
*** TURN *** [Qs 4c 5h] [7d]
*** RIVER *** [Qs 4c 5h 7d] [Js]
*** SHOW DOWN ***
chrichrac: shows [8s 8c] (a pair of Eights)
GabrielTho1: shows [Td As] (high card Ace)
chrichrac collected 52304 from pot
*** SUMMARY ***
Total pot 52304 | Rake 0 
Board [Qs 4c 5h 7d Js]
Seat 1: LeslieGroves (small blind) folded before Flop
Seat 2: Aidy703 (big blind) folded before Flop
Seat 3: Muringa.SP folded before Flop (didn't bet)
Seat 4: DR. ELDAR folded before Flop (didn't bet)
Seat 5: chrichrac showed [8s 8c] and won (52304) with a pair of Eights
Seat 6: GabrielTho1 (button) showed [Td As] and lost with high card Ace

PokerStars Hand #251209822629: Tournament #3769361908, $52.38+$2.62 USD Hold'em No Limit - Level XVI (800/1600) - 2024/06/26 22:49:55 UTC [2024/06/26 18:49:55 ET]
Table '3769361908 10' 6-max Seat #1 is the button
Seat 1: LeslieGroves (8700 in chips) 
Seat 2: Aidy703 (10845 in chips) 
Seat 3: Muringa.SP (25375 in chips) 
Seat 4: DR. ELDAR (8900 in chips) 
Seat 5: chrichrac (52304 in chips) 
Seat 6: GabrielTho1 (33511 in chips) 
LeslieGroves: posts the ante 400
Aidy703: posts the ante 400
Muringa.SP: posts the ante 400
DR. ELDAR: posts the ante 400
chrichrac: posts the ante 400
GabrielTho1: posts the ante 400
Aidy703: posts small blind 800
Muringa.SP: posts big blind 1600
*** HOLE CARDS ***
DR. ELDAR: raises 6900 to 8500 and is all-in
chrichrac: folds 
GabrielTho1: folds 
LeslieGroves: folds 
Aidy703: folds 
Muringa.SP: folds 
Uncalled bet (6900) returned to DR. ELDAR
DR. ELDAR collected 6400 from pot
DR. ELDAR: doesn't show hand 
*** SUMMARY ***
Total pot 6400 | Rake 0 
Seat 1: LeslieGroves (button) folded before Flop (didn't bet)
Seat 2: Aidy703 (small blind) folded before Flop
Seat 3: Muringa.SP (big blind) folded before Flop
Seat 4: DR. ELDAR collected (6400)
Seat 5: chrichrac folded before Flop (didn't bet)
Seat 6: GabrielTho1 folded before Flop (didn't bet)

PokerStars Hand #251209830336: Tournament #3769361908, $52.38+$2.62 USD Hold'em No Limit - Level XVII (1000/2000) - 2024/06/26 22:50:26 UTC [2024/06/26 18:50:26 ET]
Table '3769361908 10' 6-max Seat #2 is the button
Seat 1: LeslieGroves (8300 in chips) 
Seat 2: Aidy703 (9645 in chips) 
Seat 3: Muringa.SP (23375 in chips) 
Seat 4: DR. ELDAR (13300 in chips) 
Seat 5: chrichrac (51904 in chips) 
Seat 6: GabrielTho1 (33111 in chips) 
LeslieGroves: posts the ante 500
Aidy703: posts the ante 500
Muringa.SP: posts the ante 500
DR. ELDAR: posts the ante 500
chrichrac: posts the ante 500
GabrielTho1: posts the ante 500
Muringa.SP: posts small blind 1000
DR. ELDAR: posts big blind 2000
*** HOLE CARDS ***
chrichrac: folds 
GabrielTho1: folds 
LeslieGroves: raises 5800 to 7800 and is all-in
Aidy703: raises 1345 to 9145 and is all-in
Muringa.SP: folds 
DR. ELDAR: calls 7145
*** FLOP *** [3h 9d 7d]
*** TURN *** [3h 9d 7d] [8c]
*** RIVER *** [3h 9d 7d 8c] [9c]
*** SHOW DOWN ***
DR. ELDAR: shows [Jd Jh] (two pair, Jacks and Nines)
Aidy703: shows [As Qc] (a pair of Nines)
DR. ELDAR collected 2690 from side pot
LeslieGroves: shows [2d Ac] (a pair of Nines)
DR. ELDAR collected 27400 from main pot
Aidy703 finished the tournament in 103rd place
LeslieGroves finished the tournament in 104th place
*** SUMMARY ***
Total pot 30090 Main pot 27400. Side pot 2690. | Rake 0 
Board [3h 9d 7d 8c 9c]
Seat 1: LeslieGroves showed [2d Ac] and lost with a pair of Nines
Seat 2: Aidy703 (button) showed [As Qc] and lost with a pair of Nines
Seat 3: Muringa.SP (small blind) folded before Flop
Seat 4: DR. ELDAR (big blind) showed [Jd Jh] and won (30090) with two pair, Jacks and Nines
Seat 5: chrichrac folded before Flop (didn't bet)
Seat 6: GabrielTho1 folded before Flop (didn't bet)





PokerStars Hand #251209432006: Tournament #3769361908, $52.38+$2.62 USD Hold'em No Limit - Level VIII (125/250) - 2024/06/26 22:25:25 UTC [2024/06/26 18:25:25 ET]
Table '3769361908 5' 6-max Seat #3 is the button
Seat 1: assalbi (26362 in chips) is sitting out
Seat 2: marquinhosss (14590 in chips) 
Seat 3: despair515 (12353 in chips) 
Seat 4: AkwasYT (19836 in chips) 
Seat 5: zioeddy2312 (7240 in chips) 
Seat 6: ricardons8 (9880 in chips) 
assalbi: posts the ante 60
marquinhosss: posts the ante 60
despair515: posts the ante 60
AkwasYT: posts the ante 60
zioeddy2312: posts the ante 60
ricardons8: posts the ante 60
AkwasYT: posts small blind 125
zioeddy2312: posts big blind 250
*** HOLE CARDS ***
ricardons8: folds 
assalbi: folds 
marquinhosss: folds 
despair515: folds 
AkwasYT: calls 125
zioeddy2312: checks 
*** FLOP *** [8h 9s 9h]
AkwasYT: checks 
zioeddy2312: checks 
*** TURN *** [8h 9s 9h] [2d]
AkwasYT: checks 
zioeddy2312: checks 
*** RIVER *** [8h 9s 9h 2d] [2c]
AkwasYT: bets 500
zioeddy2312: folds 
Uncalled bet (500) returned to AkwasYT
AkwasYT collected 860 from pot
AkwasYT: doesn't show hand 
*** SUMMARY ***
Total pot 860 | Rake 0 
Board [8h 9s 9h 2d 2c]
Seat 1: assalbi folded before Flop (didn't bet)
Seat 2: marquinhosss folded before Flop (didn't bet)
Seat 3: despair515 (button) folded before Flop (didn't bet)
Seat 4: AkwasYT (small blind) collected (860)
Seat 5: zioeddy2312 (big blind) folded on the River
Seat 6: ricardons8 folded before Flop (didn't bet)

PokerStars Hand #251209440172: Tournament #3769361908, $52.38+$2.62 USD Hold'em No Limit - Level VIII (125/250) - 2024/06/26 22:25:55 UTC [2024/06/26 18:25:55 ET]
Table '3769361908 5' 6-max Seat #4 is the button
Seat 1: assalbi (26302 in chips) is sitting out
Seat 2: marquinhosss (14530 in chips) 
Seat 3: despair515 (12293 in chips) 
Seat 4: AkwasYT (20386 in chips) 
Seat 5: zioeddy2312 (6930 in chips) 
Seat 6: ricardons8 (9820 in chips) 
assalbi: posts the ante 60
marquinhosss: posts the ante 60
despair515: posts the ante 60
AkwasYT: posts the ante 60
zioeddy2312: posts the ante 60
ricardons8: posts the ante 60
zioeddy2312: posts small blind 125
ricardons8: posts big blind 250
*** HOLE CARDS ***
assalbi: folds 
marquinhosss: folds 
despair515: folds 
AkwasYT: folds 
zioeddy2312: calls 125
ricardons8: raises 625 to 875
zioeddy2312: folds 
Uncalled bet (625) returned to ricardons8
ricardons8 collected 860 from pot
ricardons8: doesn't show hand 
*** SUMMARY ***
Total pot 860 | Rake 0 
Seat 1: assalbi folded before Flop (didn't bet)
Seat 2: marquinhosss folded before Flop (didn't bet)
Seat 3: despair515 folded before Flop (didn't bet)
Seat 4: AkwasYT (button) folded before Flop (didn't bet)
Seat 5: zioeddy2312 (small blind) folded before Flop
Seat 6: ricardons8 (big blind) collected (860)

PokerStars Hand #251209447568: Tournament #3769361908, $52.38+$2.62 USD Hold'em No Limit - Level IX (150/300) - 2024/06/26 22:26:22 UTC [2024/06/26 18:26:22 ET]
Table '3769361908 5' 6-max Seat #5 is the button
Seat 1: assalbi (26242 in chips) is sitting out
Seat 2: marquinhosss (14470 in chips) 
Seat 3: despair515 (12233 in chips) 
Seat 4: AkwasYT (20326 in chips) 
Seat 5: zioeddy2312 (6620 in chips) 
Seat 6: ricardons8 (10370 in chips) 
assalbi: posts the ante 75
marquinhosss: posts the ante 75
despair515: posts the ante 75
AkwasYT: posts the ante 75
zioeddy2312: posts the ante 75
ricardons8: posts the ante 75
ricardons8: posts small blind 150
assalbi: posts big blind 300
*** HOLE CARDS ***
marquinhosss: folds 
despair515: folds 
AkwasYT: folds 
zioeddy2312: raises 600 to 900
ricardons8: raises 9395 to 10295 and is all-in
assalbi: folds 
zioeddy2312: calls 5645 and is all-in
Uncalled bet (3750) returned to ricardons8
*** FLOP *** [8d 4h 8s]
*** TURN *** [8d 4h 8s] [Jh]
*** RIVER *** [8d 4h 8s Jh] [Qs]
*** SHOW DOWN ***
ricardons8: shows [Tc As] (a pair of Eights)
zioeddy2312: shows [Jc Qc] (two pair, Queens and Jacks)
zioeddy2312 collected 13840 from pot
*** SUMMARY ***
Total pot 13840 | Rake 0 
Board [8d 4h 8s Jh Qs]
Seat 1: assalbi (big blind) folded before Flop
Seat 2: marquinhosss folded before Flop (didn't bet)
Seat 3: despair515 folded before Flop (didn't bet)
Seat 4: AkwasYT folded before Flop (didn't bet)
Seat 5: zioeddy2312 (button) showed [Jc Qc] and won (13840) with two pair, Queens and Jacks
Seat 6: ricardons8 (small blind) showed [Tc As] and lost with a pair of Eights

PokerStars Hand #251209457991: Tournament #3769361908, $52.38+$2.62 USD Hold'em No Limit - Level IX (150/300) - 2024/06/26 22:26:59 UTC [2024/06/26 18:26:59 ET]
Table '3769361908 5' 6-max Seat #6 is the button
Seat 1: assalbi (25867 in chips) is sitting out
Seat 2: marquinhosss (14395 in chips) 
Seat 3: despair515 (12158 in chips) 
Seat 4: AkwasYT (20251 in chips) 
Seat 5: zioeddy2312 (13840 in chips) 
Seat 6: ricardons8 (3750 in chips) 
assalbi: posts the ante 75
marquinhosss: posts the ante 75
despair515: posts the ante 75
AkwasYT: posts the ante 75
zioeddy2312: posts the ante 75
ricardons8: posts the ante 75
assalbi: posts small blind 150
marquinhosss: posts big blind 300
*** HOLE CARDS ***
despair515: folds 
AkwasYT: raises 300 to 600
zioeddy2312: folds 
ricardons8: raises 3075 to 3675 and is all-in
assalbi: folds 
marquinhosss: folds 
AkwasYT: calls 3075
*** FLOP *** [2d 8h 4d]
*** TURN *** [2d 8h 4d] [3s]
*** RIVER *** [2d 8h 4d 3s] [6d]
*** SHOW DOWN ***
AkwasYT: shows [Qd Qc] (a pair of Queens)
ricardons8: shows [Ah Ks] (high card Ace)
AkwasYT collected 8250 from pot
ricardons8 finished the tournament
*** SUMMARY ***
Total pot 8250 | Rake 0 
Board [2d 8h 4d 3s 6d]
Seat 1: assalbi (small blind) folded before Flop
Seat 2: marquinhosss (big blind) folded before Flop
Seat 3: despair515 folded before Flop (didn't bet)
Seat 4: AkwasYT showed [Qd Qc] and won (8250) with a pair of Queens
Seat 5: zioeddy2312 folded before Flop (didn't bet)
Seat 6: ricardons8 (button) showed [Ah Ks] and lost with high card Ace

PokerStars Hand #251209466510: Tournament #3769361908, $52.38+$2.62 USD Hold'em No Limit - Level IX (150/300) - 2024/06/26 22:27:30 UTC [2024/06/26 18:27:30 ET]
Table '3769361908 5' 6-max Seat #1 is the button
Seat 1: assalbi (25642 in chips) is sitting out
Seat 2: marquinhosss (14020 in chips) 
Seat 4: AkwasYT (24751 in chips) 
Seat 5: zioeddy2312 (13765 in chips) 
assalbi: posts the ante 75
marquinhosss: posts the ante 75
AkwasYT: posts the ante 75
zioeddy2312: posts the ante 75
marquinhosss: posts small blind 150
AkwasYT: posts big blind 300
*** HOLE CARDS ***
zioeddy2312: folds 
assalbi: folds 
burianjpb is disconnected 
marquinhosss: calls 150
AkwasYT: raises 300 to 600
marquinhosss: calls 300
*** FLOP *** [8c 4s 2c]
marquinhosss: checks 
AkwasYT: checks 
*** TURN *** [8c 4s 2c] [Tc]
marquinhosss: bets 495
AkwasYT: calls 495
*** RIVER *** [8c 4s 2c Tc] [Kd]
marquinhosss: bets 822
AkwasYT: folds 
Uncalled bet (822) returned to marquinhosss
marquinhosss collected 2490 from pot
marquinhosss: doesn't show hand 
*** SUMMARY ***
Total pot 2490 | Rake 0 
Board [8c 4s 2c Tc Kd]
Seat 1: assalbi (button) folded before Flop (didn't bet)
Seat 2: marquinhosss (small blind) collected (2490)
Seat 4: AkwasYT (big blind) folded on the River
Seat 5: zioeddy2312 folded before Flop (didn't bet)

PokerStars Hand #251209480145: Tournament #3769361908, $52.38+$2.62 USD Hold'em No Limit - Level IX (150/300) - 2024/06/26 22:28:19 UTC [2024/06/26 18:28:19 ET]
Table '3769361908 5' 6-max Seat #2 is the button
Seat 1: assalbi (25567 in chips) is sitting out
Seat 2: marquinhosss (15340 in chips) 
Seat 3: burianjpb (13090 in chips) out of hand (moved from another table into small blind)
Seat 4: AkwasYT (23581 in chips) 
Seat 5: zioeddy2312 (13690 in chips) 
burianjpb will be allowed to play after the button
assalbi: posts the ante 75
marquinhosss: posts the ante 75
AkwasYT: posts the ante 75
zioeddy2312: posts the ante 75
AkwasYT: posts small blind 150
zioeddy2312: posts big blind 300
*** HOLE CARDS ***
assalbi: folds 
marquinhosss: raises 300 to 600
AkwasYT: calls 450
zioeddy2312: folds 
*** FLOP *** [9s 2d Kd]
AkwasYT: checks 
marquinhosss: bets 594
AkwasYT: calls 594
*** TURN *** [9s 2d Kd] [7h]
AkwasYT: bets 900
marquinhosss: calls 900
*** RIVER *** [9s 2d Kd 7h] [4c]
AkwasYT: checks 
marquinhosss: checks 
*** SHOW DOWN ***
AkwasYT: shows [Kc Th] (a pair of Kings)
marquinhosss: mucks hand 
AkwasYT collected 4788 from pot
*** SUMMARY ***
Total pot 4788 | Rake 0 
Board [9s 2d Kd 7h 4c]
Seat 1: assalbi folded before Flop (didn't bet)
Seat 2: marquinhosss (button) mucked
Seat 4: AkwasYT (small blind) showed [Kc Th] and won (4788) with a pair of Kings
Seat 5: zioeddy2312 (big blind) folded before Flop

PokerStars Hand #251209491052: Tournament #3769361908, $52.38+$2.62 USD Hold'em No Limit - Level IX (150/300) - 2024/06/26 22:28:58 UTC [2024/06/26 18:28:58 ET]
Table '3769361908 5' 6-max Seat #4 is the button
Seat 1: assalbi (25492 in chips) is sitting out
Seat 2: marquinhosss (13171 in chips) 
Seat 3: burianjpb (13090 in chips) 
Seat 4: AkwasYT (26200 in chips) 
Seat 5: zioeddy2312 (13315 in chips) 
assalbi: posts the ante 75
marquinhosss: posts the ante 75
burianjpb: posts the ante 75
AkwasYT: posts the ante 75
zioeddy2312: posts the ante 75
zioeddy2312: posts small blind 150
assalbi: posts big blind 300
*** HOLE CARDS ***
marquinhosss: folds 
burianjpb: folds 
AkwasYT: folds 
zioeddy2312: raises 300 to 600
assalbi: folds 
Uncalled bet (300) returned to zioeddy2312
zioeddy2312 collected 975 from pot
*** SUMMARY ***
Total pot 975 | Rake 0 
Seat 1: assalbi (big blind) folded before Flop
Seat 2: marquinhosss folded before Flop (didn't bet)
Seat 3: burianjpb folded before Flop (didn't bet)
Seat 4: AkwasYT (button) folded before Flop (didn't bet)
Seat 5: zioeddy2312 (small blind) collected (975)

PokerStars Hand #251209497894: Tournament #3769361908, $52.38+$2.62 USD Hold'em No Limit - Level X (200/400) - 2024/06/26 22:29:23 UTC [2024/06/26 18:29:23 ET]
Table '3769361908 5' 6-max Seat #5 is the button
Seat 1: assalbi (25117 in chips) is sitting out
Seat 2: marquinhosss (13096 in chips) 
Seat 3: burianjpb (13015 in chips) 
Seat 4: AkwasYT (26125 in chips) 
Seat 5: zioeddy2312 (13915 in chips) 
assalbi: posts the ante 100
marquinhosss: posts the ante 100
burianjpb: posts the ante 100
AkwasYT: posts the ante 100
zioeddy2312: posts the ante 100
assalbi: posts small blind 200
marquinhosss: posts big blind 400
*** HOLE CARDS ***
burianjpb: folds 
AkwasYT: raises 400 to 800
zioeddy2312: folds 
assalbi: folds 
marquinhosss: calls 400
*** FLOP *** [3h 8c 7s]
marquinhosss: checks 
AkwasYT: checks 
*** TURN *** [3h 8c 7s] [5c]
marquinhosss: checks 
assalbi has returned
AkwasYT: bets 800
marquinhosss: calls 800
*** RIVER *** [3h 8c 7s 5c] [Qs]
marquinhosss: checks 
AkwasYT: bets 1200
marquinhosss: calls 1200
*** SHOW DOWN ***
AkwasYT: shows [Tc Ah] (high card Ace)
marquinhosss: mucks hand 
AkwasYT collected 6300 from pot
*** SUMMARY ***
Total pot 6300 | Rake 0 
Board [3h 8c 7s 5c Qs]
Seat 1: assalbi (small blind) folded before Flop
Seat 2: marquinhosss (big blind) mucked
Seat 3: burianjpb folded before Flop (didn't bet)
Seat 4: AkwasYT showed [Tc Ah] and won (6300) with high card Ace
Seat 5: zioeddy2312 (button) folded before Flop (didn't bet)

PokerStars Hand #251209511634: Tournament #3769361908, $52.38+$2.62 USD Hold'em No Limit - Level X (200/400) - 2024/06/26 22:30:11 UTC [2024/06/26 18:30:11 ET]
Table '3769361908 5' 6-max Seat #1 is the button
Seat 1: assalbi (24817 in chips) 
Seat 2: marquinhosss (10196 in chips) 
Seat 3: burianjpb (12915 in chips) 
Seat 4: AkwasYT (29525 in chips) 
Seat 5: zioeddy2312 (13815 in chips) 
Seat 6: antonisar (10000 in chips) 
assalbi: posts the ante 100
marquinhosss: posts the ante 100
burianjpb: posts the ante 100
AkwasYT: posts the ante 100
zioeddy2312: posts the ante 100
antonisar: posts the ante 100
marquinhosss: posts small blind 200
burianjpb: posts big blind 400
*** HOLE CARDS ***
AkwasYT: folds 
zioeddy2312: folds 
antonisar: folds 
assalbi has timed out
assalbi: folds 
assalbi is sitting out
marquinhosss: calls 200
burianjpb: raises 800 to 1200
marquinhosss: calls 800
*** FLOP *** [7s 5s 3d]
marquinhosss: checks 
burianjpb: checks 
*** TURN *** [7s 5s 3d] [9d]
marquinhosss: checks 
burianjpb: checks 
*** RIVER *** [7s 5s 3d 9d] [2h]
marquinhosss: checks 
burianjpb: checks 
*** SHOW DOWN ***
marquinhosss: shows [3c Ad] (a pair of Threes)
burianjpb: mucks hand 
marquinhosss collected 3000 from pot
*** SUMMARY ***
Total pot 3000 | Rake 0 
Board [7s 5s 3d 9d 2h]
Seat 1: assalbi (button) folded before Flop (didn't bet)
Seat 2: marquinhosss (small blind) showed [3c Ad] and won (3000) with a pair of Threes
Seat 3: burianjpb (big blind) mucked
Seat 4: AkwasYT folded before Flop (didn't bet)
Seat 5: zioeddy2312 folded before Flop (didn't bet)
Seat 6: antonisar folded before Flop (didn't bet)

PokerStars Hand #251209535093: Tournament #3769361908, $52.38+$2.62 USD Hold'em No Limit - Level X (200/400) - 2024/06/26 22:31:37 UTC [2024/06/26 18:31:37 ET]
Table '3769361908 5' 6-max Seat #2 is the button
Seat 1: assalbi (24717 in chips) is sitting out
Seat 2: marquinhosss (11896 in chips) 
Seat 3: burianjpb (11615 in chips) 
Seat 4: AkwasYT (29425 in chips) 
Seat 5: zioeddy2312 (13715 in chips) 
Seat 6: antonisar (9900 in chips) 
assalbi: posts the ante 100
marquinhosss: posts the ante 100
burianjpb: posts the ante 100
AkwasYT: posts the ante 100
zioeddy2312: posts the ante 100
antonisar: posts the ante 100
burianjpb: posts small blind 200
AkwasYT: posts big blind 400
*** HOLE CARDS ***
zioeddy2312: raises 800 to 1200
antonisar: calls 1200
assalbi: folds 
marquinhosss: raises 10596 to 11796 and is all-in
burianjpb: folds 
AkwasYT: folds 
zioeddy2312: folds 
antonisar: calls 8600 and is all-in
Uncalled bet (1996) returned to marquinhosss
*** FLOP *** [Ts Kd Kh]
*** TURN *** [Ts Kd Kh] [5c]
*** RIVER *** [Ts Kd Kh 5c] [9c]
*** SHOW DOWN ***
antonisar: shows [Js Ac] (a pair of Kings)
marquinhosss: shows [Kc As] (three of a kind, Kings)
marquinhosss collected 22000 from pot
antonisar finished the tournament
*** SUMMARY ***
Total pot 22000 | Rake 0 
Board [Ts Kd Kh 5c 9c]
Seat 1: assalbi folded before Flop (didn't bet)
Seat 2: marquinhosss (button) showed [Kc As] and won (22000) with three of a kind, Kings
Seat 3: burianjpb (small blind) folded before Flop
Seat 4: AkwasYT (big blind) folded before Flop
Seat 5: zioeddy2312 folded before Flop
Seat 6: antonisar showed [Js Ac] and lost with a pair of Kings

PokerStars Hand #251209551859: Tournament #3769361908, $52.38+$2.62 USD Hold'em No Limit - Level XI (250/500) - 2024/06/26 22:32:38 UTC [2024/06/26 18:32:38 ET]
Table '3769361908 5' 6-max Seat #3 is the button
Seat 1: assalbi (24617 in chips) is sitting out
Seat 2: marquinhosss (23996 in chips) 
Seat 3: burianjpb (11315 in chips) 
Seat 4: AkwasYT (28925 in chips) 
Seat 5: zioeddy2312 (12415 in chips) 
assalbi: posts the ante 125
marquinhosss: posts the ante 125
burianjpb: posts the ante 125
AkwasYT: posts the ante 125
zioeddy2312: posts the ante 125
AkwasYT: posts small blind 250
zioeddy2312: posts big blind 500
*** HOLE CARDS ***
assalbi: folds 
marquinhosss: folds 
burianjpb: folds 
AkwasYT: calls 250
zioeddy2312: checks 
*** FLOP *** [4d Ah 7c]
AkwasYT: checks 
zioeddy2312: checks 
*** TURN *** [4d Ah 7c] [8h]
AkwasYT: bets 1000
zioeddy2312: calls 1000
*** RIVER *** [4d Ah 7c 8h] [5h]
AkwasYT: checks 
zioeddy2312: bets 2500
AkwasYT: folds 
Uncalled bet (2500) returned to zioeddy2312
zioeddy2312 collected 3625 from pot
*** SUMMARY ***
Total pot 3625 | Rake 0 
Board [4d Ah 7c 8h 5h]
Seat 1: assalbi folded before Flop (didn't bet)
Seat 2: marquinhosss folded before Flop (didn't bet)
Seat 3: burianjpb (button) folded before Flop (didn't bet)
Seat 4: AkwasYT (small blind) folded on the River
Seat 5: zioeddy2312 (big blind) collected (3625)

PokerStars Hand #251209569606: Tournament #3769361908, $52.38+$2.62 USD Hold'em No Limit - Level XI (250/500) - 2024/06/26 22:33:45 UTC [2024/06/26 18:33:45 ET]
Table '3769361908 5' 6-max Seat #4 is the button
Seat 1: assalbi (24492 in chips) is sitting out
Seat 2: marquinhosss (23871 in chips) 
Seat 3: burianjpb (11190 in chips) 
Seat 4: AkwasYT (27300 in chips) 
Seat 5: zioeddy2312 (14415 in chips) 
assalbi: posts the ante 125
marquinhosss: posts the ante 125
burianjpb: posts the ante 125
AkwasYT: posts the ante 125
zioeddy2312: posts the ante 125
zioeddy2312: posts small blind 250
assalbi: posts big blind 500
*** HOLE CARDS ***
marquinhosss: folds 
burianjpb: folds 
AkwasYT: folds 
zioeddy2312: folds 
Uncalled bet (250) returned to assalbi
assalbi collected 1125 from pot
assalbi: doesn't show hand 
*** SUMMARY ***
Total pot 1125 | Rake 0 
Seat 1: assalbi (big blind) collected (1125)
Seat 2: marquinhosss folded before Flop (didn't bet)
Seat 3: burianjpb folded before Flop (didn't bet)
Seat 4: AkwasYT (button) folded before Flop (didn't bet)
Seat 5: zioeddy2312 (small blind) folded before Flop

PokerStars Hand #251209571950: Tournament #3769361908, $52.38+$2.62 USD Hold'em No Limit - Level XI (250/500) - 2024/06/26 22:33:53 UTC [2024/06/26 18:33:53 ET]
Table '3769361908 5' 6-max Seat #5 is the button
Seat 1: assalbi (25242 in chips) is sitting out
Seat 2: marquinhosss (23746 in chips) 
Seat 3: burianjpb (11065 in chips) 
Seat 4: AkwasYT (27175 in chips) 
Seat 5: zioeddy2312 (14040 in chips) 
assalbi: posts the ante 125
marquinhosss: posts the ante 125
burianjpb: posts the ante 125
AkwasYT: posts the ante 125
zioeddy2312: posts the ante 125
assalbi: posts small blind 250
marquinhosss: posts big blind 500
*** HOLE CARDS ***
burianjpb: folds 
AkwasYT: folds 
zioeddy2312: folds 
assalbi: folds 
Uncalled bet (250) returned to marquinhosss
marquinhosss collected 1125 from pot
marquinhosss: doesn't show hand 
*** SUMMARY ***
Total pot 1125 | Rake 0 
Seat 1: assalbi (small blind) folded before Flop
Seat 2: marquinhosss (big blind) collected (1125)
Seat 3: burianjpb folded before Flop (didn't bet)
Seat 4: AkwasYT folded before Flop (didn't bet)
Seat 5: zioeddy2312 (button) folded before Flop (didn't bet)

PokerStars Hand #251209574863: Tournament #3769361908, $52.38+$2.62 USD Hold'em No Limit - Level XI (250/500) - 2024/06/26 22:34:04 UTC [2024/06/26 18:34:04 ET]
Table '3769361908 5' 6-max Seat #1 is the button
Seat 1: assalbi (24867 in chips) is sitting out
Seat 2: marquinhosss (24496 in chips) 
Seat 3: burianjpb (10940 in chips) 
Seat 4: AkwasYT (27050 in chips) 
Seat 5: zioeddy2312 (13915 in chips) 
assalbi: posts the ante 125
marquinhosss: posts the ante 125
burianjpb: posts the ante 125
AkwasYT: posts the ante 125
zioeddy2312: posts the ante 125
marquinhosss: posts small blind 250
burianjpb: posts big blind 500
*** HOLE CARDS ***
AkwasYT: folds 
zioeddy2312: folds 
assalbi: folds 
marquinhosss: calls 250
burianjpb: checks 
*** FLOP *** [Tc 7s Kh]
marquinhosss: bets 500
burianjpb: calls 500
*** TURN *** [Tc 7s Kh] [Td]
marquinhosss: checks 
burianjpb: bets 865
marquinhosss: calls 865
*** RIVER *** [Tc 7s Kh Td] [6h]
marquinhosss: bets 3702
burianjpb: folds 
Uncalled bet (3702) returned to marquinhosss
marquinhosss collected 4355 from pot
marquinhosss: doesn't show hand 
*** SUMMARY ***
Total pot 4355 | Rake 0 
Board [Tc 7s Kh Td 6h]
Seat 1: assalbi (button) folded before Flop (didn't bet)
Seat 2: marquinhosss (small blind) collected (4355)
Seat 3: burianjpb (big blind) folded on the River
Seat 4: AkwasYT folded before Flop (didn't bet)
Seat 5: zioeddy2312 folded before Flop (didn't bet)

PokerStars Hand #251209588156: Tournament #3769361908, $52.38+$2.62 USD Hold'em No Limit - Level XI (250/500) - 2024/06/26 22:34:53 UTC [2024/06/26 18:34:53 ET]
Table '3769361908 5' 6-max Seat #2 is the button
Seat 1: assalbi (24742 in chips) is sitting out
Seat 2: marquinhosss (26861 in chips) 
Seat 3: burianjpb (8950 in chips) 
Seat 4: AkwasYT (26925 in chips) 
Seat 5: zioeddy2312 (13790 in chips) 
Seat 6: adrf1999 (10000 in chips) 
assalbi: posts the ante 125
marquinhosss: posts the ante 125
burianjpb: posts the ante 125
AkwasYT: posts the ante 125
zioeddy2312: posts the ante 125
adrf1999: posts the ante 125
burianjpb: posts small blind 250
AkwasYT: posts big blind 500
*** HOLE CARDS ***
zioeddy2312: folds 
adrf1999: raises 500 to 1000
assalbi: folds 
marquinhosss: folds 
burianjpb: calls 750
AkwasYT: calls 500
*** FLOP *** [4c Td Qc]
burianjpb: checks 
AkwasYT: checks 
adrf1999: bets 1000
burianjpb: calls 1000
AkwasYT: folds 
*** TURN *** [4c Td Qc] [Ks]
burianjpb: checks 
adrf1999: bets 2000
burianjpb: raises 4825 to 6825 and is all-in
adrf1999: calls 4825
*** RIVER *** [4c Td Qc Ks] [Qd]
*** SHOW DOWN ***
burianjpb: shows [Kd 9d] (two pair, Kings and Queens)
adrf1999: shows [4s 4d] (a full house, Fours full of Queens)
adrf1999 collected 19400 from pot
burianjpb finished the tournament
*** SUMMARY ***
Total pot 19400 | Rake 0 
Board [4c Td Qc Ks Qd]
Seat 1: assalbi folded before Flop (didn't bet)
Seat 2: marquinhosss (button) folded before Flop (didn't bet)
Seat 3: burianjpb (small blind) showed [Kd 9d] and lost with two pair, Kings and Queens
Seat 4: AkwasYT (big blind) folded on the Flop
Seat 5: zioeddy2312 folded before Flop (didn't bet)
Seat 6: adrf1999 showed [4s 4d] and won (19400) with a full house, Fours full of Queens

PokerStars Hand #251209607364: Tournament #3769361908, $52.38+$2.62 USD Hold'em No Limit - Level XII (300/600) - 2024/06/26 22:36:04 UTC [2024/06/26 18:36:04 ET]
Table '3769361908 5' 6-max Seat #4 is the button
Seat 1: assalbi (24617 in chips) is sitting out
Seat 2: marquinhosss (26736 in chips) 
Seat 4: AkwasYT (25800 in chips) 
Seat 5: zioeddy2312 (13665 in chips) 
Seat 6: adrf1999 (20450 in chips) 
assalbi: posts the ante 150
marquinhosss: posts the ante 150
AkwasYT: posts the ante 150
zioeddy2312: posts the ante 150
adrf1999: posts the ante 150
zioeddy2312: posts small blind 300
adrf1999: posts big blind 600
*** HOLE CARDS ***
assalbi: folds 
marquinhosss: folds 
AkwasYT: folds 
zioeddy2312: raises 1800 to 2400
adrf1999: raises 17900 to 20300 and is all-in
zioeddy2312: calls 11115 and is all-in
Uncalled bet (6785) returned to adrf1999
assalbi has returned
*** FLOP *** [As 7s Qh]
*** TURN *** [As 7s Qh] [Kd]
*** RIVER *** [As 7s Qh Kd] [6s]
*** SHOW DOWN ***
zioeddy2312: shows [Qd Ah] (two pair, Aces and Queens)
adrf1999: shows [Kh Jc] (a pair of Kings)
zioeddy2312 collected 27780 from pot
*** SUMMARY ***
Total pot 27780 | Rake 0 
Board [As 7s Qh Kd 6s]
Seat 1: assalbi folded before Flop (didn't bet)
Seat 2: marquinhosss folded before Flop (didn't bet)
Seat 4: AkwasYT (button) folded before Flop (didn't bet)
Seat 5: zioeddy2312 (small blind) showed [Qd Ah] and won (27780) with two pair, Aces and Queens
Seat 6: adrf1999 (big blind) showed [Kh Jc] and lost with a pair of Kings

PokerStars Hand #251209616827: Tournament #3769361908, $52.38+$2.62 USD Hold'em No Limit - Level XII (300/600) - 2024/06/26 22:36:40 UTC [2024/06/26 18:36:40 ET]
Table '3769361908 5' 6-max Seat #5 is the button
Seat 1: assalbi (24467 in chips) 
Seat 2: marquinhosss (26586 in chips) 
Seat 4: AkwasYT (25650 in chips) 
Seat 5: zioeddy2312 (27780 in chips) 
Seat 6: adrf1999 (6785 in chips) 
assalbi: posts the ante 150
marquinhosss: posts the ante 150
AkwasYT: posts the ante 150
zioeddy2312: posts the ante 150
adrf1999: posts the ante 150
adrf1999: posts small blind 300
assalbi: posts big blind 600
*** HOLE CARDS ***
marquinhosss: raises 600 to 1200
AkwasYT: folds 
zioeddy2312: folds 
adrf1999: folds 
assalbi: calls 600
*** FLOP *** [Jc 4d 9h]
assalbi: checks 
marquinhosss: bets 1139
assalbi: calls 1139
*** TURN *** [Jc 4d 9h] [8h]
assalbi: checks 
marquinhosss: bets 3780
assalbi: calls 3780
*** RIVER *** [Jc 4d 9h 8h] [6c]
assalbi: checks 
marquinhosss: checks 
*** SHOW DOWN ***
assalbi: shows [Td Kd] (high card King)
marquinhosss: shows [9d 8d] (two pair, Nines and Eights)
marquinhosss collected 13288 from pot
*** SUMMARY ***
Total pot 13288 | Rake 0 
Board [Jc 4d 9h 8h 6c]
Seat 1: assalbi (big blind) showed [Td Kd] and lost with high card King
Seat 2: marquinhosss showed [9d 8d] and won (13288) with two pair, Nines and Eights
Seat 4: AkwasYT folded before Flop (didn't bet)
Seat 5: zioeddy2312 (button) folded before Flop (didn't bet)
Seat 6: adrf1999 (small blind) folded before Flop

PokerStars Hand #251209629572: Tournament #3769361908, $52.38+$2.62 USD Hold'em No Limit - Level XII (300/600) - 2024/06/26 22:37:28 UTC [2024/06/26 18:37:28 ET]
Table '3769361908 5' 6-max Seat #6 is the button
Seat 1: assalbi (18198 in chips) 
Seat 2: marquinhosss (33605 in chips) 
Seat 3: Chuckster388 (10000 in chips) 
Seat 4: AkwasYT (25500 in chips) 
Seat 5: zioeddy2312 (27630 in chips) 
Seat 6: adrf1999 (6335 in chips) 
assalbi: posts the ante 150
marquinhosss: posts the ante 150
Chuckster388: posts the ante 150
AkwasYT: posts the ante 150
zioeddy2312: posts the ante 150
adrf1999: posts the ante 150
assalbi: posts small blind 300
marquinhosss: posts big blind 600
*** HOLE CARDS ***
Chuckster388: folds 
AkwasYT: raises 600 to 1200
zioeddy2312: folds 
adrf1999: folds 
assalbi: folds 
marquinhosss: calls 600
*** FLOP *** [As 7s 5s]
marquinhosss: checks 
AkwasYT: bets 1800
marquinhosss: raises 4500 to 6300
AkwasYT: folds [Kd Kc]
Uncalled bet (4500) returned to marquinhosss
marquinhosss collected 7200 from pot
marquinhosss: doesn't show hand 
*** SUMMARY ***
Total pot 7200 | Rake 0 
Board [As 7s 5s]
Seat 1: assalbi (small blind) folded before Flop
Seat 2: marquinhosss (big blind) collected (7200)
Seat 3: Chuckster388 folded before Flop (didn't bet)
Seat 4: AkwasYT folded on the Flop
Seat 5: zioeddy2312 folded before Flop (didn't bet)
Seat 6: adrf1999 (button) folded before Flop (didn't bet)

PokerStars Hand #251209646196: Tournament #3769361908, $52.38+$2.62 USD Hold'em No Limit - Level XIII (400/800) - 2024/06/26 22:38:30 UTC [2024/06/26 18:38:30 ET]
Table '3769361908 5' 6-max Seat #1 is the button
Seat 1: assalbi (17748 in chips) 
Seat 2: marquinhosss (37655 in chips) 
Seat 3: Chuckster388 (9850 in chips) 
Seat 4: AkwasYT (22350 in chips) 
Seat 5: zioeddy2312 (27480 in chips) 
Seat 6: adrf1999 (6185 in chips) 
assalbi: posts the ante 200
marquinhosss: posts the ante 200
Chuckster388: posts the ante 200
AkwasYT: posts the ante 200
zioeddy2312: posts the ante 200
adrf1999: posts the ante 200
marquinhosss: posts small blind 400
Chuckster388: posts big blind 800
*** HOLE CARDS ***
AkwasYT: folds 
zioeddy2312: raises 1600 to 2400
adrf1999: raises 3585 to 5985 and is all-in
assalbi: folds 
marquinhosss: calls 5585
Chuckster388: folds 
zioeddy2312: folds 
*** FLOP *** [Tc Kh Kc]
*** TURN *** [Tc Kh Kc] [Qc]
*** RIVER *** [Tc Kh Kc Qc] [8d]
*** SHOW DOWN ***
marquinhosss: shows [Ah Jd] (a straight, Ten to Ace)
adrf1999: shows [6c 6h] (two pair, Kings and Sixes)
marquinhosss collected 16370 from pot
adrf1999 finished the tournament
*** SUMMARY ***
Total pot 16370 | Rake 0 
Board [Tc Kh Kc Qc 8d]
Seat 1: assalbi (button) folded before Flop (didn't bet)
Seat 2: marquinhosss (small blind) showed [Ah Jd] and won (16370) with a straight, Ten to Ace
Seat 3: Chuckster388 (big blind) folded before Flop
Seat 4: AkwasYT folded before Flop (didn't bet)
Seat 5: zioeddy2312 folded before Flop
Seat 6: adrf1999 showed [6c 6h] and lost with two pair, Kings and Sixes

PokerStars Hand #251209655542: Tournament #3769361908, $52.38+$2.62 USD Hold'em No Limit - Level XIII (400/800) - 2024/06/26 22:39:05 UTC [2024/06/26 18:39:05 ET]
Table '3769361908 5' 6-max Seat #2 is the button
Seat 1: assalbi (17548 in chips) 
Seat 2: marquinhosss (47840 in chips) 
Seat 3: Chuckster388 (8850 in chips) 
Seat 4: AkwasYT (22150 in chips) 
Seat 5: zioeddy2312 (24880 in chips) 
assalbi: posts the ante 200
marquinhosss: posts the ante 200
Chuckster388: posts the ante 200
AkwasYT: posts the ante 200
zioeddy2312: posts the ante 200
Chuckster388: posts small blind 400
AkwasYT: posts big blind 800
*** HOLE CARDS ***
zioeddy2312: folds 
assalbi: raises 800 to 1600
marquinhosss: folds 
Chuckster388: folds 
AkwasYT: calls 800
*** FLOP *** [Qs Tc Kc]
AkwasYT: bets 2400
assalbi: calls 2400
*** TURN *** [Qs Tc Kc] [8s]
AkwasYT: checks 
assalbi: checks 
*** RIVER *** [Qs Tc Kc 8s] [4h]
AkwasYT: checks 
assalbi: checks 
*** SHOW DOWN ***
AkwasYT: shows [Ts 7c] (a pair of Tens)
assalbi: mucks hand 
AkwasYT collected 9400 from pot
*** SUMMARY ***
Total pot 9400 | Rake 0 
Board [Qs Tc Kc 8s 4h]
Seat 1: assalbi mucked
Seat 2: marquinhosss (button) folded before Flop (didn't bet)
Seat 3: Chuckster388 (small blind) folded before Flop
Seat 4: AkwasYT (big blind) showed [Ts 7c] and won (9400) with a pair of Tens
Seat 5: zioeddy2312 folded before Flop (didn't bet)

PokerStars Hand #251209668666: Tournament #3769361908, $52.38+$2.62 USD Hold'em No Limit - Level XIII (400/800) - 2024/06/26 22:39:54 UTC [2024/06/26 18:39:54 ET]
Table '3769361908 5' 6-max Seat #3 is the button
Seat 1: assalbi (13348 in chips) 
Seat 2: marquinhosss (47640 in chips) 
Seat 3: Chuckster388 (8250 in chips) 
Seat 4: AkwasYT (27350 in chips) 
Seat 5: zioeddy2312 (24680 in chips) 
Seat 6: sinister778 (34396 in chips) 
assalbi: posts the ante 200
marquinhosss: posts the ante 200
Chuckster388: posts the ante 200
AkwasYT: posts the ante 200
zioeddy2312: posts the ante 200
sinister778: posts the ante 200
AkwasYT: posts small blind 400
zioeddy2312: posts big blind 800
*** HOLE CARDS ***
sinister778: raises 800 to 1600
assalbi: folds 
marquinhosss: folds 
Chuckster388: folds 
AkwasYT: folds 
zioeddy2312: calls 800
*** FLOP *** [2c Ad Td]
zioeddy2312: checks 
sinister778: bets 2400
zioeddy2312: calls 2400
*** TURN *** [2c Ad Td] [Ks]
zioeddy2312: checks 
sinister778: bets 5600
zioeddy2312: calls 5600
*** RIVER *** [2c Ad Td Ks] [9c]
zioeddy2312: checks 
sinister778: bets 24596 and is all-in
zioeddy2312: folds 
Uncalled bet (24596) returned to sinister778
sinister778 collected 20800 from pot
*** SUMMARY ***
Total pot 20800 | Rake 0 
Board [2c Ad Td Ks 9c]
Seat 1: assalbi folded before Flop (didn't bet)
Seat 2: marquinhosss folded before Flop (didn't bet)
Seat 3: Chuckster388 (button) folded before Flop (didn't bet)
Seat 4: AkwasYT (small blind) folded before Flop
Seat 5: zioeddy2312 (big blind) folded on the River
Seat 6: sinister778 collected (20800)

PokerStars Hand #251209698479: Tournament #3769361908, $52.38+$2.62 USD Hold'em No Limit - Level XIV (500/1000) - 2024/06/26 22:41:48 UTC [2024/06/26 18:41:48 ET]
Table '3769361908 5' 6-max Seat #4 is the button
Seat 1: assalbi (13148 in chips) 
Seat 2: marquinhosss (47440 in chips) 
Seat 3: Chuckster388 (8050 in chips) 
Seat 4: AkwasYT (26750 in chips) 
Seat 5: zioeddy2312 (14880 in chips) 
Seat 6: sinister778 (45396 in chips) 
assalbi: posts the ante 250
marquinhosss: posts the ante 250
Chuckster388: posts the ante 250
AkwasYT: posts the ante 250
zioeddy2312: posts the ante 250
sinister778: posts the ante 250
zioeddy2312: posts small blind 500
sinister778: posts big blind 1000
*** HOLE CARDS ***
assalbi: folds 
marquinhosss: raises 1000 to 2000
Chuckster388: folds 
AkwasYT: folds 
zioeddy2312: folds 
sinister778: calls 1000
*** FLOP *** [Ad As 2c]
sinister778: checks 
marquinhosss: bets 1500
sinister778: folds 
Uncalled bet (1500) returned to marquinhosss
marquinhosss collected 6000 from pot
marquinhosss: doesn't show hand 
*** SUMMARY ***
Total pot 6000 | Rake 0 
Board [Ad As 2c]
Seat 1: assalbi folded before Flop (didn't bet)
Seat 2: marquinhosss collected (6000)
Seat 3: Chuckster388 folded before Flop (didn't bet)
Seat 4: AkwasYT (button) folded before Flop (didn't bet)
Seat 5: zioeddy2312 (small blind) folded before Flop
Seat 6: sinister778 (big blind) folded on the Flop

PokerStars Hand #251209712105: Tournament #3769361908, $52.38+$2.62 USD Hold'em No Limit - Level XIV (500/1000) - 2024/06/26 22:42:41 UTC [2024/06/26 18:42:41 ET]
Table '3769361908 5' 6-max Seat #5 is the button
Seat 1: assalbi (12898 in chips) 
Seat 2: marquinhosss (51190 in chips) 
Seat 3: Chuckster388 (7800 in chips) 
Seat 4: AkwasYT (26500 in chips) 
Seat 5: zioeddy2312 (14130 in chips) 
Seat 6: sinister778 (43146 in chips) 
assalbi: posts the ante 250
marquinhosss: posts the ante 250
Chuckster388: posts the ante 250
AkwasYT: posts the ante 250
zioeddy2312: posts the ante 250
sinister778: posts the ante 250
sinister778: posts small blind 500
assalbi: posts big blind 1000
*** HOLE CARDS ***
marquinhosss: folds 
Chuckster388: folds 
AkwasYT: raises 1000 to 2000
zioeddy2312: folds 
sinister778: folds 
assalbi: calls 1000
*** FLOP *** [4d 9c As]
assalbi: checks 
AkwasYT: bets 2000
assalbi: folds 
Uncalled bet (2000) returned to AkwasYT
AkwasYT collected 6000 from pot
AkwasYT: doesn't show hand 
*** SUMMARY ***
Total pot 6000 | Rake 0 
Board [4d 9c As]
Seat 1: assalbi (big blind) folded on the Flop
Seat 2: marquinhosss folded before Flop (didn't bet)
Seat 3: Chuckster388 folded before Flop (didn't bet)
Seat 4: AkwasYT collected (6000)
Seat 5: zioeddy2312 (button) folded before Flop (didn't bet)
Seat 6: sinister778 (small blind) folded before Flop

PokerStars Hand #251209721496: Tournament #3769361908, $52.38+$2.62 USD Hold'em No Limit - Level XIV (500/1000) - 2024/06/26 22:43:18 UTC [2024/06/26 18:43:18 ET]
Table '3769361908 5' 6-max Seat #6 is the button
Seat 1: assalbi (10648 in chips) 
Seat 2: marquinhosss (50940 in chips) 
Seat 3: Chuckster388 (7550 in chips) 
Seat 4: AkwasYT (30250 in chips) 
Seat 5: zioeddy2312 (13880 in chips) 
Seat 6: sinister778 (42396 in chips) 
assalbi: posts the ante 250
marquinhosss: posts the ante 250
Chuckster388: posts the ante 250
AkwasYT: posts the ante 250
zioeddy2312: posts the ante 250
sinister778: posts the ante 250
assalbi: posts small blind 500
marquinhosss: posts big blind 1000
*** HOLE CARDS ***
Chuckster388: folds 
AkwasYT: folds 
zioeddy2312: folds 
sinister778: raises 1000 to 2000
assalbi: folds 
marquinhosss: calls 1000
*** FLOP *** [6s Kh 8d]
marquinhosss: checks 
sinister778: bets 2500
marquinhosss: folds 
Uncalled bet (2500) returned to sinister778
sinister778 collected 6000 from pot
*** SUMMARY ***
Total pot 6000 | Rake 0 
Board [6s Kh 8d]
Seat 1: assalbi (small blind) folded before Flop
Seat 2: marquinhosss (big blind) folded on the Flop
Seat 3: Chuckster388 folded before Flop (didn't bet)
Seat 4: AkwasYT folded before Flop (didn't bet)
Seat 5: zioeddy2312 folded before Flop (didn't bet)
Seat 6: sinister778 (button) collected (6000)

PokerStars Hand #251209736206: Tournament #3769361908, $52.38+$2.62 USD Hold'em No Limit - Level XV (600/1200) - 2024/06/26 22:44:15 UTC [2024/06/26 18:44:15 ET]
Table '3769361908 5' 6-max Seat #1 is the button
Seat 1: assalbi (9898 in chips) 
Seat 2: marquinhosss (48690 in chips) 
Seat 3: Chuckster388 (7300 in chips) 
Seat 4: AkwasYT (30000 in chips) 
Seat 5: zioeddy2312 (13630 in chips) 
Seat 6: sinister778 (46146 in chips) 
assalbi: posts the ante 300
marquinhosss: posts the ante 300
Chuckster388: posts the ante 300
AkwasYT: posts the ante 300
zioeddy2312: posts the ante 300
sinister778: posts the ante 300
marquinhosss: posts small blind 600
Chuckster388: posts big blind 1200
*** HOLE CARDS ***
AkwasYT: raises 2400 to 3600
zioeddy2312: folds 
sinister778: folds 
assalbi: folds 
marquinhosss: folds 
Chuckster388: calls 2400
*** FLOP *** [Kh 9s 6c]
Chuckster388: bets 3400 and is all-in
AkwasYT: calls 3400
*** TURN *** [Kh 9s 6c] [5s]
*** RIVER *** [Kh 9s 6c 5s] [2s]
*** SHOW DOWN ***
Chuckster388: shows [6h Ah] (a pair of Sixes)
AkwasYT: shows [Qc As] (high card Ace)
Chuckster388 collected 16400 from pot
*** SUMMARY ***
Total pot 16400 | Rake 0 
Board [Kh 9s 6c 5s 2s]
Seat 1: assalbi (button) folded before Flop (didn't bet)
Seat 2: marquinhosss (small blind) folded before Flop
Seat 3: Chuckster388 (big blind) showed [6h Ah] and won (16400) with a pair of Sixes
Seat 4: AkwasYT showed [Qc As] and lost with high card Ace
Seat 5: zioeddy2312 folded before Flop (didn't bet)
Seat 6: sinister778 folded before Flop (didn't bet)

PokerStars Hand #251209747343: Tournament #3769361908, $52.38+$2.62 USD Hold'em No Limit - Level XV (600/1200) - 2024/06/26 22:44:58 UTC [2024/06/26 18:44:58 ET]
Table '3769361908 5' 6-max Seat #2 is the button
Seat 1: assalbi (9598 in chips) 
Seat 2: marquinhosss (47790 in chips) 
Seat 3: Chuckster388 (16400 in chips) 
Seat 4: AkwasYT (22700 in chips) 
Seat 5: zioeddy2312 (13330 in chips) 
Seat 6: sinister778 (45846 in chips) 
assalbi: posts the ante 300
marquinhosss: posts the ante 300
Chuckster388: posts the ante 300
AkwasYT: posts the ante 300
zioeddy2312: posts the ante 300
sinister778: posts the ante 300
Chuckster388: posts small blind 600
AkwasYT: posts big blind 1200
*** HOLE CARDS ***
zioeddy2312: raises 11830 to 13030 and is all-in
sinister778: folds 
assalbi: folds 
marquinhosss: folds 
Chuckster388: folds 
AkwasYT: folds 
Uncalled bet (11830) returned to zioeddy2312
zioeddy2312 collected 4800 from pot
*** SUMMARY ***
Total pot 4800 | Rake 0 
Seat 1: assalbi folded before Flop (didn't bet)
Seat 2: marquinhosss (button) folded before Flop (didn't bet)
Seat 3: Chuckster388 (small blind) folded before Flop
Seat 4: AkwasYT (big blind) folded before Flop
Seat 5: zioeddy2312 collected (4800)
Seat 6: sinister778 folded before Flop (didn't bet)

PokerStars Hand #251209751443: Tournament #3769361908, $52.38+$2.62 USD Hold'em No Limit - Level XV (600/1200) - 2024/06/26 22:45:14 UTC [2024/06/26 18:45:14 ET]
Table '3769361908 5' 6-max Seat #3 is the button
Seat 1: assalbi (9298 in chips) 
Seat 2: marquinhosss (47490 in chips) 
Seat 3: Chuckster388 (15500 in chips) 
Seat 4: AkwasYT (21200 in chips) 
Seat 5: zioeddy2312 (16630 in chips) 
Seat 6: sinister778 (45546 in chips) 
assalbi: posts the ante 300
marquinhosss: posts the ante 300
Chuckster388: posts the ante 300
AkwasYT: posts the ante 300
zioeddy2312: posts the ante 300
sinister778: posts the ante 300
AkwasYT: posts small blind 600
zioeddy2312: posts big blind 1200
*** HOLE CARDS ***
sinister778: raises 1200 to 2400
assalbi: raises 6598 to 8998 and is all-in
marquinhosss: folds 
Chuckster388: folds 
AkwasYT: raises 11902 to 20900 and is all-in
zioeddy2312: folds 
sinister778: calls 18500
*** FLOP *** [Js 2c Jh]
*** TURN *** [Js 2c Jh] [8h]
*** RIVER *** [Js 2c Jh 8h] [7d]
*** SHOW DOWN ***
AkwasYT: shows [Qd Td] (a pair of Jacks)
sinister778: shows [Ah Kh] (a pair of Jacks - Ace kicker)
sinister778 collected 23804 from side pot
assalbi: shows [Ts Ac] (a pair of Jacks - lower kicker)
sinister778 collected 29994 from main pot
AkwasYT finished the tournament
assalbi finished the tournament
IgorHKR is disconnected 
*** SUMMARY ***
Total pot 53798 Main pot 29994. Side pot 23804. | Rake 0 
Board [Js 2c Jh 8h 7d]
Seat 1: assalbi showed [Ts Ac] and lost with a pair of Jacks
Seat 2: marquinhosss folded before Flop (didn't bet)
Seat 3: Chuckster388 (button) folded before Flop (didn't bet)
Seat 4: AkwasYT (small blind) showed [Qd Td] and lost with a pair of Jacks
Seat 5: zioeddy2312 (big blind) folded before Flop
Seat 6: sinister778 showed [Ah Kh] and won (53798) with a pair of Jacks

PokerStars Hand #251209760768: Tournament #3769361908, $52.38+$2.62 USD Hold'em No Limit - Level XV (600/1200) - 2024/06/26 22:45:50 UTC [2024/06/26 18:45:50 ET]
Table '3769361908 5' 6-max Seat #5 is the button
Seat 1: IgorHKR (10000 in chips) 
Seat 2: marquinhosss (47190 in chips) 
Seat 3: Chuckster388 (15200 in chips) 
Seat 5: zioeddy2312 (15130 in chips) 
Seat 6: sinister778 (78144 in chips) 
IgorHKR: posts the ante 300
marquinhosss: posts the ante 300
Chuckster388: posts the ante 300
zioeddy2312: posts the ante 300
sinister778: posts the ante 300
sinister778: posts small blind 600
IgorHKR: posts big blind 1200
*** HOLE CARDS ***
marquinhosss: folds 
Chuckster388: raises 13700 to 14900 and is all-in
zioeddy2312: folds 
sinister778: folds 
IgorHKR: folds 
Uncalled bet (13700) returned to Chuckster388
Chuckster388 collected 4500 from pot
Chuckster388: doesn't show hand 
*** SUMMARY ***
Total pot 4500 | Rake 0 
Seat 1: IgorHKR (big blind) folded before Flop
Seat 2: marquinhosss folded before Flop (didn't bet)
Seat 3: Chuckster388 collected (4500)
Seat 5: zioeddy2312 (button) folded before Flop (didn't bet)
Seat 6: sinister778 (small blind) folded before Flop

PokerStars Hand #251209764897: Tournament #3769361908, $52.38+$2.62 USD Hold'em No Limit - Level XV (600/1200) - 2024/06/26 22:46:06 UTC [2024/06/26 18:46:06 ET]
Table '3769361908 5' 6-max Seat #6 is the button
Seat 1: IgorHKR (8500 in chips) 
Seat 2: marquinhosss (46890 in chips) 
Seat 3: Chuckster388 (18200 in chips) 
Seat 5: zioeddy2312 (14830 in chips) 
Seat 6: sinister778 (77244 in chips) 
IgorHKR: posts the ante 300
marquinhosss: posts the ante 300
Chuckster388: posts the ante 300
zioeddy2312: posts the ante 300
sinister778: posts the ante 300
IgorHKR: posts small blind 600
marquinhosss: posts big blind 1200
*** HOLE CARDS ***
Theo7171 is disconnected 
Chuckster388: raises 1320 to 2520
zioeddy2312: folds 
sinister778: folds 
IgorHKR: folds 
marquinhosss: folds 
Uncalled bet (1320) returned to Chuckster388
Chuckster388 collected 4500 from pot
Chuckster388: doesn't show hand 
*** SUMMARY ***
Total pot 4500 | Rake 0 
Seat 1: IgorHKR (small blind) folded before Flop
Seat 2: marquinhosss (big blind) folded before Flop
Seat 3: Chuckster388 collected (4500)
Seat 5: zioeddy2312 folded before Flop (didn't bet)
Seat 6: sinister778 (button) folded before Flop (didn't bet)

PokerStars Hand #251209770205: Tournament #3769361908, $52.38+$2.62 USD Hold'em No Limit - Level XV (600/1200) - 2024/06/26 22:46:27 UTC [2024/06/26 18:46:27 ET]
Table '3769361908 5' 6-max Seat #1 is the button
Seat 1: IgorHKR (7600 in chips) 
Seat 2: marquinhosss (45390 in chips) 
Seat 3: Chuckster388 (21200 in chips) 
Seat 4: Theo7171 (10000 in chips) 
Seat 5: zioeddy2312 (14530 in chips) 
Seat 6: sinister778 (76944 in chips) 
IgorHKR: posts the ante 300
marquinhosss: posts the ante 300
Chuckster388: posts the ante 300
Theo7171: posts the ante 300
zioeddy2312: posts the ante 300
sinister778: posts the ante 300
marquinhosss: posts small blind 600
Chuckster388: posts big blind 1200
*** HOLE CARDS ***
Theo7171: folds 
zioeddy2312: folds 
sinister778: folds 
IgorHKR: folds 
marquinhosss: raises 43890 to 45090 and is all-in
Chuckster388: folds 
Uncalled bet (43890) returned to marquinhosss
marquinhosss collected 4200 from pot
marquinhosss: doesn't show hand 
*** SUMMARY ***
Total pot 4200 | Rake 0 
Seat 1: IgorHKR (button) folded before Flop (didn't bet)
Seat 2: marquinhosss (small blind) collected (4200)
Seat 3: Chuckster388 (big blind) folded before Flop
Seat 4: Theo7171 folded before Flop (didn't bet)
Seat 5: zioeddy2312 folded before Flop (didn't bet)
Seat 6: sinister778 folded before Flop (didn't bet)

PokerStars Hand #251209775738: Tournament #3769361908, $52.38+$2.62 USD Hold'em No Limit - Level XV (600/1200) - 2024/06/26 22:46:49 UTC [2024/06/26 18:46:49 ET]
Table '3769361908 5' 6-max Seat #2 is the button
Seat 1: IgorHKR (7300 in chips) 
Seat 2: marquinhosss (48090 in chips) 
Seat 3: Chuckster388 (19700 in chips) 
Seat 4: Theo7171 (9700 in chips) 
Seat 5: zioeddy2312 (14230 in chips) 
Seat 6: sinister778 (76644 in chips) 
IgorHKR: posts the ante 300
marquinhosss: posts the ante 300
Chuckster388: posts the ante 300
Theo7171: posts the ante 300
zioeddy2312: posts the ante 300
sinister778: posts the ante 300
Chuckster388: posts small blind 600
Theo7171: posts big blind 1200
*** HOLE CARDS ***
zioeddy2312: folds 
sinister778: raises 1800 to 3000
IgorHKR: folds 
marquinhosss: folds 
Chuckster388: folds 
Theo7171: calls 1800
*** FLOP *** [9d 8s Ks]
Theo7171: bets 6400 and is all-in
sinister778: calls 6400
*** TURN *** [9d 8s Ks] [5s]
*** RIVER *** [9d 8s Ks 5s] [Tc]
*** SHOW DOWN ***
Theo7171: shows [Th Jd] (a pair of Tens)
sinister778: shows [Ts As] (a flush, Ace high)
sinister778 collected 21200 from pot
Theo7171 finished the tournament
*** SUMMARY ***
Total pot 21200 | Rake 0 
Board [9d 8s Ks 5s Tc]
Seat 1: IgorHKR folded before Flop (didn't bet)
Seat 2: marquinhosss (button) folded before Flop (didn't bet)
Seat 3: Chuckster388 (small blind) folded before Flop
Seat 4: Theo7171 (big blind) showed [Th Jd] and lost with a pair of Tens
Seat 5: zioeddy2312 folded before Flop (didn't bet)
Seat 6: sinister778 showed [Ts As] and won (21200) with a flush, Ace high

PokerStars Hand #251209784941: Tournament #3769361908, $52.38+$2.62 USD Hold'em No Limit - Level XVI (800/1600) - 2024/06/26 22:47:25 UTC [2024/06/26 18:47:25 ET]
Table '3769361908 5' 6-max Seat #3 is the button
Seat 1: IgorHKR (7000 in chips) 
Seat 2: marquinhosss (47790 in chips) 
Seat 3: Chuckster388 (18800 in chips) 
Seat 5: zioeddy2312 (13930 in chips) 
Seat 6: sinister778 (88144 in chips) 
IgorHKR: posts the ante 400
marquinhosss: posts the ante 400
Chuckster388: posts the ante 400
zioeddy2312: posts the ante 400
sinister778: posts the ante 400
zioeddy2312: posts small blind 800
sinister778: posts big blind 1600
*** HOLE CARDS ***
IgorHKR: raises 5000 to 6600 and is all-in
marquinhosss: folds 
Chuckster388: raises 11800 to 18400 and is all-in
zioeddy2312: folds 
sinister778: folds 
Uncalled bet (11800) returned to Chuckster388
*** FLOP *** [9s Jh 6d]
*** TURN *** [9s Jh 6d] [2s]
*** RIVER *** [9s Jh 6d 2s] [3d]
*** SHOW DOWN ***
IgorHKR: shows [8h 8d] (a pair of Eights)
Chuckster388: shows [Kc 9d] (a pair of Nines)
Chuckster388 collected 17600 from pot
IgorHKR finished the tournament
$ubuta1 is disconnected 
*** SUMMARY ***
Total pot 17600 | Rake 0 
Board [9s Jh 6d 2s 3d]
Seat 1: IgorHKR showed [8h 8d] and lost with a pair of Eights
Seat 2: marquinhosss folded before Flop (didn't bet)
Seat 3: Chuckster388 (button) showed [Kc 9d] and won (17600) with a pair of Nines
Seat 5: zioeddy2312 (small blind) folded before Flop
Seat 6: sinister778 (big blind) folded before Flop

PokerStars Hand #251209794496: Tournament #3769361908, $52.38+$2.62 USD Hold'em No Limit - Level XVI (800/1600) - 2024/06/26 22:48:03 UTC [2024/06/26 18:48:03 ET]
Table '3769361908 5' 6-max Seat #5 is the button
Seat 2: marquinhosss (47390 in chips) 
Seat 3: Chuckster388 (29400 in chips) 
Seat 4: $ubuta1 (19448 in chips) 
Seat 5: zioeddy2312 (12730 in chips) 
Seat 6: sinister778 (86144 in chips) 
marquinhosss: posts the ante 400
Chuckster388: posts the ante 400
$ubuta1: posts the ante 400
zioeddy2312: posts the ante 400
sinister778: posts the ante 400
sinister778: posts small blind 800
marquinhosss: posts big blind 1600
*** HOLE CARDS ***
Chuckster388: folds 
$ubuta1: folds 
zioeddy2312: folds 
DeathBrain09 is disconnected 
sinister778: calls 800
marquinhosss: checks 
*** FLOP *** [2d 7h 3s]
sinister778: bets 3200
marquinhosss: raises 8000 to 11200
sinister778: folds 
Uncalled bet (8000) returned to marquinhosss
marquinhosss collected 11600 from pot
marquinhosss: doesn't show hand 
*** SUMMARY ***
Total pot 11600 | Rake 0 
Board [2d 7h 3s]
Seat 2: marquinhosss (big blind) collected (11600)
Seat 3: Chuckster388 folded before Flop (didn't bet)
Seat 4: $ubuta1 folded before Flop (didn't bet)
Seat 5: zioeddy2312 (button) folded before Flop (didn't bet)
Seat 6: sinister778 (small blind) folded on the Flop

PokerStars Hand #251209805603: Tournament #3769361908, $52.38+$2.62 USD Hold'em No Limit - Level XVI (800/1600) - 2024/06/26 22:48:46 UTC [2024/06/26 18:48:46 ET]
Table '3769361908 5' 6-max Seat #6 is the button
Seat 1: DeathBrain09 (28700 in chips) out of hand (moved from another table into small blind)
Seat 2: marquinhosss (53790 in chips) 
Seat 3: Chuckster388 (29000 in chips) 
Seat 4: $ubuta1 (19048 in chips) 
Seat 5: zioeddy2312 (12330 in chips) 
Seat 6: sinister778 (80944 in chips) 
DeathBrain09 will be allowed to play after the button
marquinhosss: posts the ante 400
Chuckster388: posts the ante 400
$ubuta1: posts the ante 400
zioeddy2312: posts the ante 400
sinister778: posts the ante 400
marquinhosss: posts small blind 800
Chuckster388: posts big blind 1600
*** HOLE CARDS ***
$ubuta1: folds 
zioeddy2312: raises 10330 to 11930 and is all-in
sinister778: folds 
marquinhosss: folds 
Chuckster388: calls 10330
*** FLOP *** [As 7d 7h]
*** TURN *** [As 7d 7h] [4h]
*** RIVER *** [As 7d 7h 4h] [Qh]
*** SHOW DOWN ***
Chuckster388: shows [2s Ac] (two pair, Aces and Sevens)
zioeddy2312: shows [6d Ad] (two pair, Aces and Sevens)
Chuckster388 collected 13330 from pot
zioeddy2312 collected 13330 from pot
*** SUMMARY ***
Total pot 26660 | Rake 0 
Board [As 7d 7h 4h Qh]
Seat 2: marquinhosss (small blind) folded before Flop
Seat 3: Chuckster388 (big blind) showed [2s Ac] and won (13330) with two pair, Aces and Sevens
Seat 4: $ubuta1 folded before Flop (didn't bet)
Seat 5: zioeddy2312 showed [6d Ad] and won (13330) with two pair, Aces and Sevens
Seat 6: sinister778 (button) folded before Flop (didn't bet)

PokerStars Hand #251209813181: Tournament #3769361908, $52.38+$2.62 USD Hold'em No Limit - Level XVI (800/1600) - 2024/06/26 22:49:17 UTC [2024/06/26 18:49:17 ET]
Table '3769361908 5' 6-max Seat #2 is the button
Seat 1: DeathBrain09 (28700 in chips) 
Seat 2: marquinhosss (52590 in chips) 
Seat 3: Chuckster388 (30000 in chips) 
Seat 4: $ubuta1 (18648 in chips) 
Seat 5: zioeddy2312 (13330 in chips) 
Seat 6: sinister778 (80544 in chips) 
DeathBrain09: posts the ante 400
marquinhosss: posts the ante 400
Chuckster388: posts the ante 400
$ubuta1: posts the ante 400
zioeddy2312: posts the ante 400
sinister778: posts the ante 400
Chuckster388: posts small blind 800
$ubuta1: posts big blind 1600
*** HOLE CARDS ***
zioeddy2312: raises 11330 to 12930 and is all-in
sinister778: calls 12930
DeathBrain09: folds 
marquinhosss: folds 
Chuckster388: folds 
$ubuta1: folds 
*** FLOP *** [4d 6s Jd]
*** TURN *** [4d 6s Jd] [7s]
*** RIVER *** [4d 6s Jd 7s] [7c]
*** SHOW DOWN ***
zioeddy2312: shows [9d Ah] (a pair of Sevens)
sinister778: shows [Kd Jh] (two pair, Jacks and Sevens)
sinister778 collected 30660 from pot
zioeddy2312 finished the tournament in 116th place
*** SUMMARY ***
Total pot 30660 | Rake 0 
Board [4d 6s Jd 7s 7c]
Seat 1: DeathBrain09 folded before Flop (didn't bet)
Seat 2: marquinhosss (button) folded before Flop (didn't bet)
Seat 3: Chuckster388 (small blind) folded before Flop
Seat 4: $ubuta1 (big blind) folded before Flop
Seat 5: zioeddy2312 showed [9d Ah] and lost with a pair of Sevens
Seat 6: sinister778 showed [Kd Jh] and won (30660) with two pair, Jacks and Sevens

PokerStars Hand #251209820827: Tournament #3769361908, $52.38+$2.62 USD Hold'em No Limit - Level XVI (800/1600) - 2024/06/26 22:49:48 UTC [2024/06/26 18:49:48 ET]
Table '3769361908 5' 6-max Seat #3 is the button
Seat 1: DeathBrain09 (28300 in chips) 
Seat 2: marquinhosss (52190 in chips) 
Seat 3: Chuckster388 (28800 in chips) 
Seat 4: $ubuta1 (16648 in chips) 
Seat 6: sinister778 (97874 in chips) 
DeathBrain09: posts the ante 400
marquinhosss: posts the ante 400
Chuckster388: posts the ante 400
$ubuta1: posts the ante 400
sinister778: posts the ante 400
$ubuta1: posts small blind 800
sinister778: posts big blind 1600
*** HOLE CARDS ***
DeathBrain09: folds 
marquinhosss: folds 
Chuckster388: folds 
$ubuta1: raises 14648 to 16248 and is all-in
sinister778: calls 14648
*** FLOP *** [9h 6c 2h]
*** TURN *** [9h 6c 2h] [9s]
*** RIVER *** [9h 6c 2h 9s] [Kh]
*** SHOW DOWN ***
$ubuta1: shows [6s Ad] (two pair, Nines and Sixes)
sinister778: shows [4c Kd] (two pair, Kings and Nines)
sinister778 collected 34496 from pot
$ubuta1 finished the tournament in 110th place
*** SUMMARY ***
Total pot 34496 | Rake 0 
Board [9h 6c 2h 9s Kh]
Seat 1: DeathBrain09 folded before Flop (didn't bet)
Seat 2: marquinhosss folded before Flop (didn't bet)
Seat 3: Chuckster388 (button) folded before Flop (didn't bet)
Seat 4: $ubuta1 (small blind) showed [6s Ad] and lost with two pair, Nines and Sixes
Seat 6: sinister778 (big blind) showed [4c Kd] and won (34496) with two pair, Kings and Nines

PokerStars Hand #251209830105: Tournament #3769361908, $52.38+$2.62 USD Hold'em No Limit - Level XVII (1000/2000) - 2024/06/26 22:50:25 UTC [2024/06/26 18:50:25 ET]
Table '3769361908 5' 6-max Seat #6 is the button
Seat 1: DeathBrain09 (27900 in chips) 
Seat 2: marquinhosss (51790 in chips) 
Seat 3: Chuckster388 (28400 in chips) 
Seat 4: xxxppp (33800 in chips) 
Seat 5: SicKTHPS (62577 in chips) 
Seat 6: sinister778 (115722 in chips) 
DeathBrain09: posts the ante 500
marquinhosss: posts the ante 500
Chuckster388: posts the ante 500
xxxppp: posts the ante 500
SicKTHPS: posts the ante 500
sinister778: posts the ante 500
DeathBrain09: posts small blind 1000
marquinhosss: posts big blind 2000
*** HOLE CARDS ***
Chuckster388: folds 
xxxppp: folds 
SicKTHPS: raises 2000 to 4000
sinister778: calls 4000
DeathBrain09: folds 
marquinhosss: raises 47290 to 51290 and is all-in
SicKTHPS: folds 
sinister778: folds 
Uncalled bet (47290) returned to marquinhosss
marquinhosss collected 16000 from pot
marquinhosss: doesn't show hand 
*** SUMMARY ***
Total pot 16000 | Rake 0 
Seat 1: DeathBrain09 (small blind) folded before Flop
Seat 2: marquinhosss (big blind) collected (16000)
Seat 3: Chuckster388 folded before Flop (didn't bet)
Seat 4: xxxppp folded before Flop (didn't bet)
Seat 5: SicKTHPS folded before Flop
Seat 6: sinister778 (button) folded before Flop

PokerStars Hand #251209840285: Tournament #3769361908, $52.38+$2.62 USD Hold'em No Limit - Level XVII (1000/2000) - 2024/06/26 22:51:08 UTC [2024/06/26 18:51:08 ET]
Table '3769361908 5' 6-max Seat #1 is the button
Seat 1: DeathBrain09 (26400 in chips) 
Seat 2: marquinhosss (63290 in chips) 
Seat 3: Chuckster388 (27900 in chips) 
Seat 4: xxxppp (33300 in chips) 
Seat 5: SicKTHPS (58077 in chips) 
Seat 6: sinister778 (111222 in chips) 
DeathBrain09: posts the ante 500
marquinhosss: posts the ante 500
Chuckster388: posts the ante 500
xxxppp: posts the ante 500
SicKTHPS: posts the ante 500
sinister778: posts the ante 500
marquinhosss: posts small blind 1000
Chuckster388: posts big blind 2000
*** HOLE CARDS ***
xxxppp: raises 2000 to 4000
SicKTHPS: folds 
sinister778: folds 
DeathBrain09: folds 
marquinhosss: folds 
Chuckster388: calls 2000
*** FLOP *** [5d 7d Qh]
Chuckster388: checks 
xxxppp: bets 4000
Chuckster388: calls 4000
*** TURN *** [5d 7d Qh] [9c]
Chuckster388: checks 
xxxppp: checks 
*** RIVER *** [5d 7d Qh 9c] [5s]
Chuckster388: bets 6000
xxxppp: calls 6000
*** SHOW DOWN ***
Chuckster388: shows [3c Qc] (two pair, Queens and Fives)
xxxppp: mucks hand 
Chuckster388 collected 32000 from pot
*** SUMMARY ***
Total pot 32000 | Rake 0 
Board [5d 7d Qh 9c 5s]
Seat 1: DeathBrain09 (button) folded before Flop (didn't bet)
Seat 2: marquinhosss (small blind) folded before Flop
Seat 3: Chuckster388 (big blind) showed [3c Qc] and won (32000) with two pair, Queens and Fives
Seat 4: xxxppp mucked
Seat 5: SicKTHPS folded before Flop (didn't bet)
Seat 6: sinister778 folded before Flop (didn't bet)

PokerStars Hand #251209848835: Tournament #3769361908, $52.38+$2.62 USD Hold'em No Limit - Level XVII (1000/2000) - 2024/06/26 22:51:42 UTC [2024/06/26 18:51:42 ET]
Table '3769361908 5' 6-max Seat #2 is the button
Seat 1: DeathBrain09 (25900 in chips) 
Seat 2: marquinhosss (61790 in chips) 
Seat 3: Chuckster388 (45400 in chips) 
Seat 4: xxxppp (18800 in chips) 
Seat 5: SicKTHPS (57577 in chips) 
Seat 6: sinister778 (110722 in chips) 
DeathBrain09: posts the ante 500
marquinhosss: posts the ante 500
Chuckster388: posts the ante 500
xxxppp: posts the ante 500
SicKTHPS: posts the ante 500
sinister778: posts the ante 500
Chuckster388: posts small blind 1000
xxxppp: posts big blind 2000
*** HOLE CARDS ***
SicKTHPS: folds 
sinister778: folds 
DeathBrain09: folds 
marquinhosss: raises 2000 to 4000
Chuckster388: folds 
xxxppp: calls 2000
*** FLOP *** [8d 5h Kc]
xxxppp: checks 
marquinhosss: bets 2000
xxxppp: folds 
Uncalled bet (2000) returned to marquinhosss
marquinhosss collected 12000 from pot
marquinhosss: doesn't show hand 
*** SUMMARY ***
Total pot 12000 | Rake 0 
Board [8d 5h Kc]
Seat 1: DeathBrain09 folded before Flop (didn't bet)
Seat 2: marquinhosss (button) collected (12000)
Seat 3: Chuckster388 (small blind) folded before Flop
Seat 4: xxxppp (big blind) folded on the Flop
Seat 5: SicKTHPS folded before Flop (didn't bet)
Seat 6: sinister778 folded before Flop (didn't bet)

PokerStars Hand #251209854597: Tournament #3769361908, $52.38+$2.62 USD Hold'em No Limit - Level XVII (1000/2000) - 2024/06/26 22:52:06 UTC [2024/06/26 18:52:06 ET]
Table '3769361908 5' 6-max Seat #3 is the button
Seat 1: DeathBrain09 (25400 in chips) 
Seat 2: marquinhosss (69290 in chips) 
Seat 3: Chuckster388 (43900 in chips) 
Seat 4: xxxppp (14300 in chips) 
Seat 5: SicKTHPS (57077 in chips) 
Seat 6: sinister778 (110222 in chips) 
DeathBrain09: posts the ante 500
marquinhosss: posts the ante 500
Chuckster388: posts the ante 500
xxxppp: posts the ante 500
SicKTHPS: posts the ante 500
sinister778: posts the ante 500
xxxppp: posts small blind 1000
SicKTHPS: posts big blind 2000
*** HOLE CARDS ***
sinister778: folds 
DeathBrain09: folds 
marquinhosss: raises 2000 to 4000
Chuckster388: folds 
xxxppp: calls 3000
SicKTHPS: folds 
*** FLOP *** [Js 8d 2h]
xxxppp: bets 9800 and is all-in
marquinhosss: calls 9800
*** TURN *** [Js 8d 2h] [Th]
*** RIVER *** [Js 8d 2h Th] [6s]
*** SHOW DOWN ***
xxxppp: shows [Ks 4s] (high card King)
marquinhosss: shows [Tc Kh] (a pair of Tens)
marquinhosss collected 32600 from pot
xxxppp finished the tournament in 93rd place
*** SUMMARY ***
Total pot 32600 | Rake 0 
Board [Js 8d 2h Th 6s]
Seat 1: DeathBrain09 folded before Flop (didn't bet)
Seat 2: marquinhosss showed [Tc Kh] and won (32600) with a pair of Tens
Seat 3: Chuckster388 (button) folded before Flop (didn't bet)
Seat 4: xxxppp (small blind) showed [Ks 4s] and lost with high card King
Seat 5: SicKTHPS (big blind) folded before Flop
Seat 6: sinister778 folded before Flop (didn't bet)

PokerStars Hand #251209862488: Tournament #3769361908, $52.38+$2.62 USD Hold'em No Limit - Level XVII (1000/2000) - 2024/06/26 22:52:38 UTC [2024/06/26 18:52:38 ET]
Table '3769361908 5' 6-max Seat #5 is the button
Seat 1: DeathBrain09 (24900 in chips) 
Seat 2: marquinhosss (87590 in chips) 
Seat 3: Chuckster388 (43400 in chips) 
Seat 5: SicKTHPS (54577 in chips) 
Seat 6: sinister778 (109722 in chips) 
DeathBrain09: posts the ante 500
marquinhosss: posts the ante 500
Chuckster388: posts the ante 500
SicKTHPS: posts the ante 500
sinister778: posts the ante 500
sinister778: posts small blind 1000
DeathBrain09: posts big blind 2000
*** HOLE CARDS ***
marquinhosss: folds 
Chuckster388: raises 2000 to 4000
SicKTHPS: folds 
sinister778: folds 
DeathBrain09: calls 2000
*** FLOP *** [8d 2h 9d]
DeathBrain09: checks 
Chuckster388: checks 
*** TURN *** [8d 2h 9d] [5h]
DeathBrain09: bets 3680
Chuckster388: calls 3680
*** RIVER *** [8d 2h 9d 5h] [4c]
DeathBrain09: bets 16720 and is all-in
Chuckster388: folds 
Uncalled bet (16720) returned to DeathBrain09
DeathBrain09 collected 18860 from pot
*** SUMMARY ***
Total pot 18860 | Rake 0 
Board [8d 2h 9d 5h 4c]
Seat 1: DeathBrain09 (big blind) collected (18860)
Seat 2: marquinhosss folded before Flop (didn't bet)
Seat 3: Chuckster388 folded on the River
Seat 5: SicKTHPS (button) folded before Flop (didn't bet)
Seat 6: sinister778 (small blind) folded before Flop

PokerStars Hand #251209873218: Tournament #3769361908, $52.38+$2.62 USD Hold'em No Limit - Level XVIII (1200/2400) - 2024/06/26 22:53:22 UTC [2024/06/26 18:53:22 ET]
Table '3769361908 5' 6-max Seat #6 is the button
Seat 1: DeathBrain09 (35580 in chips) 
Seat 2: marquinhosss (87090 in chips) 
Seat 3: Chuckster388 (35220 in chips) 
Seat 4: jvieiradias8 (13900 in chips) 
Seat 5: SicKTHPS (54077 in chips) 
Seat 6: sinister778 (108222 in chips) 
DeathBrain09: posts the ante 600
marquinhosss: posts the ante 600
Chuckster388: posts the ante 600
jvieiradias8: posts the ante 600
SicKTHPS: posts the ante 600
sinister778: posts the ante 600
DeathBrain09: posts small blind 1200
marquinhosss: posts big blind 2400
*** HOLE CARDS ***
Chuckster388: folds 
jvieiradias8: raises 10900 to 13300 and is all-in
SicKTHPS: folds 
sinister778: folds 
DeathBrain09: folds 
marquinhosss: folds 
Uncalled bet (10900) returned to jvieiradias8
jvieiradias8 collected 9600 from pot
jvieiradias8: doesn't show hand 
*** SUMMARY ***
Total pot 9600 | Rake 0 
Seat 1: DeathBrain09 (small blind) folded before Flop
Seat 2: marquinhosss (big blind) folded before Flop
Seat 3: Chuckster388 folded before Flop (didn't bet)
Seat 4: jvieiradias8 collected (9600)
Seat 5: SicKTHPS folded before Flop (didn't bet)
Seat 6: sinister778 (button) folded before Flop (didn't bet)

PokerStars Hand #251209879638: Tournament #3769361908, $52.38+$2.62 USD Hold'em No Limit - Level XVIII (1200/2400) - 2024/06/26 22:53:48 UTC [2024/06/26 18:53:48 ET]
Table '3769361908 5' 6-max Seat #1 is the button
Seat 1: DeathBrain09 (33780 in chips) 
Seat 2: marquinhosss (84090 in chips) 
Seat 3: Chuckster388 (34620 in chips) 
Seat 4: jvieiradias8 (20500 in chips) 
Seat 5: SicKTHPS (53477 in chips) 
Seat 6: sinister778 (107622 in chips) 
DeathBrain09: posts the ante 600
marquinhosss: posts the ante 600
Chuckster388: posts the ante 600
jvieiradias8: posts the ante 600
SicKTHPS: posts the ante 600
sinister778: posts the ante 600
marquinhosss: posts small blind 1200
Chuckster388: posts big blind 2400
*** HOLE CARDS ***
jvieiradias8: folds 
SicKTHPS: folds 
sinister778: raises 2400 to 4800
DeathBrain09: folds 
marquinhosss: folds 
Chuckster388: folds 
Uncalled bet (2400) returned to sinister778
sinister778 collected 9600 from pot
*** SUMMARY ***
Total pot 9600 | Rake 0 
Seat 1: DeathBrain09 (button) folded before Flop (didn't bet)
Seat 2: marquinhosss (small blind) folded before Flop
Seat 3: Chuckster388 (big blind) folded before Flop
Seat 4: jvieiradias8 folded before Flop (didn't bet)
Seat 5: SicKTHPS folded before Flop (didn't bet)
Seat 6: sinister778 collected (9600)

PokerStars Hand #251209888555: Tournament #3769361908, $52.38+$2.62 USD Hold'em No Limit - Level XVIII (1200/2400) - 2024/06/26 22:54:25 UTC [2024/06/26 18:54:25 ET]
Table '3769361908 5' 6-max Seat #2 is the button
Seat 1: DeathBrain09 (33180 in chips) 
Seat 2: marquinhosss (82290 in chips) 
Seat 3: Chuckster388 (31620 in chips) 
Seat 4: jvieiradias8 (19900 in chips) 
Seat 5: SicKTHPS (52877 in chips) 
Seat 6: sinister778 (114222 in chips) 
DeathBrain09: posts the ante 600
marquinhosss: posts the ante 600
Chuckster388: posts the ante 600
jvieiradias8: posts the ante 600
SicKTHPS: posts the ante 600
sinister778: posts the ante 600
Chuckster388: posts small blind 1200
jvieiradias8: posts big blind 2400
*** HOLE CARDS ***
SicKTHPS: folds 
sinister778: folds 
DeathBrain09: folds 
marquinhosss: folds 
Chuckster388: raises 28620 to 31020 and is all-in
jvieiradias8: calls 16900 and is all-in
Uncalled bet (11720) returned to Chuckster388
*** FLOP *** [4c Ac 7d]
*** TURN *** [4c Ac 7d] [Tc]
*** RIVER *** [4c Ac 7d Tc] [Qs]
*** SHOW DOWN ***
Chuckster388: shows [2c Jc] (a flush, Ace high)
jvieiradias8: shows [Ah Qd] (two pair, Aces and Queens)
Chuckster388 collected 42200 from pot
jvieiradias8 finished the tournament in 78th place
*** SUMMARY ***
Total pot 42200 | Rake 0 
Board [4c Ac 7d Tc Qs]
Seat 1: DeathBrain09 folded before Flop (didn't bet)
Seat 2: marquinhosss (button) folded before Flop (didn't bet)
Seat 3: Chuckster388 (small blind) showed [2c Jc] and won (42200) with a flush, Ace high
Seat 4: jvieiradias8 (big blind) showed [Ah Qd] and lost with two pair, Aces and Queens
Seat 5: SicKTHPS folded before Flop (didn't bet)
Seat 6: sinister778 folded before Flop (didn't bet)

PokerStars Hand #251209964596: Tournament #3769361908, $52.38+$2.62 USD Hold'em No Limit - Level XVIII (1200/2400) - 2024/06/26 23:01:09 UTC [2024/06/26 19:01:09 ET]
Table '3769361908 5' 6-max Seat #3 is the button
Seat 1: DeathBrain09 (32580 in chips) 
Seat 2: marquinhosss (81690 in chips) 
Seat 3: Chuckster388 (53920 in chips) 
Seat 4: Earl of Poker V (31812 in chips) out of hand (moved from another table into small blind)
Seat 5: SicKTHPS (52277 in chips) 
Seat 6: sinister778 (113622 in chips) 
Earl of Poker V will be allowed to play after the button
DeathBrain09: posts the ante 600
marquinhosss: posts the ante 600
Chuckster388: posts the ante 600
SicKTHPS: posts the ante 600
sinister778: posts the ante 600
SicKTHPS: posts small blind 1200
sinister778: posts big blind 2400
*** HOLE CARDS ***
DeathBrain09: folds 
marquinhosss: raises 2400 to 4800
Chuckster388: folds 
SicKTHPS: folds 
sinister778: folds 
Uncalled bet (2400) returned to marquinhosss
marquinhosss collected 9000 from pot
marquinhosss: doesn't show hand 
*** SUMMARY ***
Total pot 9000 | Rake 0 
Seat 1: DeathBrain09 folded before Flop (didn't bet)
Seat 2: marquinhosss collected (9000)
Seat 3: Chuckster388 (button) folded before Flop (didn't bet)
Seat 5: SicKTHPS (small blind) folded before Flop
Seat 6: sinister778 (big blind) folded before Flop

PokerStars Hand #251209977028: Tournament #3769361908, $52.38+$2.62 USD Hold'em No Limit - Level XVIII (1200/2400) - 2024/06/26 23:02:04 UTC [2024/06/26 19:02:04 ET]
Table '3769361908 5' 6-max Seat #5 is the button
Seat 1: DeathBrain09 (31980 in chips) 
Seat 2: marquinhosss (87690 in chips) 
Seat 3: Chuckster388 (53320 in chips) 
Seat 4: Earl of Poker V (31812 in chips) 
Seat 5: SicKTHPS (50477 in chips) 
Seat 6: sinister778 (110622 in chips) 
DeathBrain09: posts the ante 600
marquinhosss: posts the ante 600
Chuckster388: posts the ante 600
Earl of Poker V: posts the ante 600
SicKTHPS: posts the ante 600
sinister778: posts the ante 600
sinister778: posts small blind 1200
DeathBrain09: posts big blind 2400
*** HOLE CARDS ***
marquinhosss: folds 
Chuckster388: folds 
Earl of Poker V: folds 
SicKTHPS: raises 2400 to 4800
sinister778: folds 
DeathBrain09: calls 2400
*** FLOP *** [Ac 8d 9h]
DeathBrain09: checks 
SicKTHPS: bets 4896
DeathBrain09: raises 4896 to 9792
SicKTHPS: raises 35285 to 45077 and is all-in
DeathBrain09: folds 
Uncalled bet (35285) returned to SicKTHPS
SicKTHPS collected 33984 from pot
SicKTHPS: doesn't show hand 
*** SUMMARY ***
Total pot 33984 | Rake 0 
Board [Ac 8d 9h]
Seat 1: DeathBrain09 (big blind) folded on the Flop
Seat 2: marquinhosss folded before Flop (didn't bet)
Seat 3: Chuckster388 folded before Flop (didn't bet)
Seat 4: Earl of Poker V folded before Flop (didn't bet)
Seat 5: SicKTHPS (button) collected (33984)
Seat 6: sinister778 (small blind) folded before Flop

PokerStars Hand #251209986131: Tournament #3769361908, $52.38+$2.62 USD Hold'em No Limit - Level XIX (1400/2800) - 2024/06/26 23:02:43 UTC [2024/06/26 19:02:43 ET]
Table '3769361908 5' 6-max Seat #6 is the button
Seat 1: DeathBrain09 (16788 in chips) 
Seat 2: marquinhosss (87090 in chips) 
Seat 3: Chuckster388 (52720 in chips) 
Seat 4: Earl of Poker V (31212 in chips) 
Seat 5: SicKTHPS (69269 in chips) 
Seat 6: sinister778 (108822 in chips) 
DeathBrain09: posts the ante 700
marquinhosss: posts the ante 700
Chuckster388: posts the ante 700
Earl of Poker V: posts the ante 700
SicKTHPS: posts the ante 700
sinister778: posts the ante 700
DeathBrain09: posts small blind 1400
marquinhosss: posts big blind 2800
*** HOLE CARDS ***
Chuckster388: raises 4060 to 6860
Earl of Poker V: folds 
SicKTHPS: folds 
sinister778: folds 
DeathBrain09: folds 
marquinhosss: calls 4060
*** FLOP *** [Jc Qs 2c]
marquinhosss: checks 
Chuckster388: bets 6376
marquinhosss: folds 
Uncalled bet (6376) returned to Chuckster388
Chuckster388 collected 19320 from pot
Chuckster388: doesn't show hand 
*** SUMMARY ***
Total pot 19320 | Rake 0 
Board [Jc Qs 2c]
Seat 1: DeathBrain09 (small blind) folded before Flop
Seat 2: marquinhosss (big blind) folded on the Flop
Seat 3: Chuckster388 collected (19320)
Seat 4: Earl of Poker V folded before Flop (didn't bet)
Seat 5: SicKTHPS folded before Flop (didn't bet)
Seat 6: sinister778 (button) folded before Flop (didn't bet)

PokerStars Hand #251209996362: Tournament #3769361908, $52.38+$2.62 USD Hold'em No Limit - Level XIX (1400/2800) - 2024/06/26 23:03:27 UTC [2024/06/26 19:03:27 ET]
Table '3769361908 5' 6-max Seat #1 is the button
Seat 1: DeathBrain09 (14688 in chips) 
Seat 2: marquinhosss (79530 in chips) 
Seat 3: Chuckster388 (64480 in chips) 
Seat 4: Earl of Poker V (30512 in chips) 
Seat 5: SicKTHPS (68569 in chips) 
Seat 6: sinister778 (108122 in chips) 
DeathBrain09: posts the ante 700
marquinhosss: posts the ante 700
Chuckster388: posts the ante 700
Earl of Poker V: posts the ante 700
SicKTHPS: posts the ante 700
sinister778: posts the ante 700
marquinhosss: posts small blind 1400
Chuckster388: posts big blind 2800
*** HOLE CARDS ***
Earl of Poker V: folds 
SicKTHPS: folds 
sinister778: folds 
DeathBrain09: raises 11188 to 13988 and is all-in
marquinhosss: folds 
Chuckster388: folds 
Uncalled bet (11188) returned to DeathBrain09
DeathBrain09 collected 11200 from pot
*** SUMMARY ***
Total pot 11200 | Rake 0 
Seat 1: DeathBrain09 (button) collected (11200)
Seat 2: marquinhosss (small blind) folded before Flop
Seat 3: Chuckster388 (big blind) folded before Flop
Seat 4: Earl of Poker V folded before Flop (didn't bet)
Seat 5: SicKTHPS folded before Flop (didn't bet)
Seat 6: sinister778 folded before Flop (didn't bet)

PokerStars Hand #251210001660: Tournament #3769361908, $52.38+$2.62 USD Hold'em No Limit - Level XIX (1400/2800) - 2024/06/26 23:03:50 UTC [2024/06/26 19:03:50 ET]
Table '3769361908 5' 6-max Seat #2 is the button
Seat 1: DeathBrain09 (22388 in chips) 
Seat 2: marquinhosss (77430 in chips) 
Seat 3: Chuckster388 (60980 in chips) 
Seat 4: Earl of Poker V (29812 in chips) 
Seat 5: SicKTHPS (67869 in chips) 
Seat 6: sinister778 (107422 in chips) 
DeathBrain09: posts the ante 700
marquinhosss: posts the ante 700
Chuckster388: posts the ante 700
Earl of Poker V: posts the ante 700
SicKTHPS: posts the ante 700
sinister778: posts the ante 700
Chuckster388: posts small blind 1400
Earl of Poker V: posts big blind 2800
*** HOLE CARDS ***
SicKTHPS: folds 
sinister778: folds 
DeathBrain09: raises 18888 to 21688 and is all-in
marquinhosss: folds 
Chuckster388: folds 
Earl of Poker V: calls 18888
*** FLOP *** [9c 7h 4d]
*** TURN *** [9c 7h 4d] [5d]
*** RIVER *** [9c 7h 4d 5d] [7d]
*** SHOW DOWN ***
Earl of Poker V: shows [Ac Ts] (a pair of Sevens)
DeathBrain09: shows [Jd Qs] (a pair of Sevens - lower kicker)
Earl of Poker V collected 48976 from pot
DeathBrain09 finished the tournament in 67th place
*** SUMMARY ***
Total pot 48976 | Rake 0 
Board [9c 7h 4d 5d 7d]
Seat 1: DeathBrain09 showed [Jd Qs] and lost with a pair of Sevens
Seat 2: marquinhosss (button) folded before Flop (didn't bet)
Seat 3: Chuckster388 (small blind) folded before Flop
Seat 4: Earl of Poker V (big blind) showed [Ac Ts] and won (48976) with a pair of Sevens
Seat 5: SicKTHPS folded before Flop (didn't bet)
Seat 6: sinister778 folded before Flop (didn't bet)


PokerStars Hand #251209533852: Tournament #3769361908, $52.38+$2.62 USD Hold'em No Limit - Level X (200/400) - 2024/06/26 22:31:32 UTC [2024/06/26 18:31:32 ET]
Table '3769361908 4' 6-max Seat #5 is the button
Seat 1: JamPanamJam (16410 in chips) 
Seat 2: maderinha22 (9060 in chips) 
Seat 3: @tetaschell (10000 in chips) 
Seat 4: muriLLoo.mrL (11077 in chips) 
Seat 5: Everbrun11 (7416 in chips) 
Seat 6: Rochinha2011 (7520 in chips) 
JamPanamJam: posts the ante 100
maderinha22: posts the ante 100
@tetaschell: posts the ante 100
muriLLoo.mrL: posts the ante 100
Everbrun11: posts the ante 100
Rochinha2011: posts the ante 100
Rochinha2011: posts small blind 200
JamPanamJam: posts big blind 400
*** HOLE CARDS ***
maderinha22: folds 
@tetaschell: folds 
muriLLoo.mrL: raises 400 to 800
Everbrun11: raises 6516 to 7316 and is all-in
Rochinha2011: folds 
JamPanamJam: folds 
muriLLoo.mrL: folds 
Uncalled bet (6516) returned to Everbrun11
Everbrun11 collected 2800 from pot
Everbrun11: doesn't show hand 
*** SUMMARY ***
Total pot 2800 | Rake 0 
Seat 1: JamPanamJam (big blind) folded before Flop
Seat 2: maderinha22 folded before Flop (didn't bet)
Seat 3: @tetaschell folded before Flop (didn't bet)
Seat 4: muriLLoo.mrL folded before Flop
Seat 5: Everbrun11 (button) collected (2800)
Seat 6: Rochinha2011 (small blind) folded before Flop

PokerStars Hand #251209541565: Tournament #3769361908, $52.38+$2.62 USD Hold'em No Limit - Level X (200/400) - 2024/06/26 22:32:01 UTC [2024/06/26 18:32:01 ET]
Table '3769361908 4' 6-max Seat #6 is the button
Seat 1: JamPanamJam (15910 in chips) 
Seat 2: maderinha22 (8960 in chips) 
Seat 3: @tetaschell (9900 in chips) 
Seat 4: muriLLoo.mrL (10177 in chips) 
Seat 5: Everbrun11 (9316 in chips) 
Seat 6: Rochinha2011 (7220 in chips) 
JamPanamJam: posts the ante 100
maderinha22: posts the ante 100
@tetaschell: posts the ante 100
muriLLoo.mrL: posts the ante 100
Everbrun11: posts the ante 100
Rochinha2011: posts the ante 100
JamPanamJam: posts small blind 200
maderinha22: posts big blind 400
*** HOLE CARDS ***
@tetaschell: folds 
muriLLoo.mrL: raises 400 to 800
Everbrun11: folds 
Rochinha2011: folds 
JamPanamJam: folds 
maderinha22: calls 400
*** FLOP *** [As 4d 6c]
maderinha22: checks 
muriLLoo.mrL: bets 792
maderinha22: folds 
Uncalled bet (792) returned to muriLLoo.mrL
muriLLoo.mrL collected 2400 from pot
muriLLoo.mrL: doesn't show hand 
*** SUMMARY ***
Total pot 2400 | Rake 0 
Board [As 4d 6c]
Seat 1: JamPanamJam (small blind) folded before Flop
Seat 2: maderinha22 (big blind) folded on the Flop
Seat 3: @tetaschell folded before Flop (didn't bet)
Seat 4: muriLLoo.mrL collected (2400)
Seat 5: Everbrun11 folded before Flop (didn't bet)
Seat 6: Rochinha2011 (button) folded before Flop (didn't bet)

PokerStars Hand #251209559639: Tournament #3769361908, $52.38+$2.62 USD Hold'em No Limit - Level XI (250/500) - 2024/06/26 22:33:07 UTC [2024/06/26 18:33:07 ET]
Table '3769361908 4' 6-max Seat #1 is the button
Seat 1: JamPanamJam (15610 in chips) 
Seat 2: maderinha22 (8060 in chips) 
Seat 3: @tetaschell (9800 in chips) 
Seat 4: muriLLoo.mrL (11677 in chips) 
Seat 5: Everbrun11 (9216 in chips) 
Seat 6: Rochinha2011 (7120 in chips) 
JamPanamJam: posts the ante 125
maderinha22: posts the ante 125
@tetaschell: posts the ante 125
muriLLoo.mrL: posts the ante 125
Everbrun11: posts the ante 125
Rochinha2011: posts the ante 125
maderinha22: posts small blind 250
@tetaschell: posts big blind 500
*** HOLE CARDS ***
muriLLoo.mrL: raises 500 to 1000
Everbrun11: raises 8091 to 9091 and is all-in
Rochinha2011: folds 
JamPanamJam: folds 
maderinha22: folds 
@tetaschell: folds 
muriLLoo.mrL: folds 
Uncalled bet (8091) returned to Everbrun11
Everbrun11 collected 3500 from pot
Everbrun11: doesn't show hand 
*** SUMMARY ***
Total pot 3500 | Rake 0 
Seat 1: JamPanamJam (button) folded before Flop (didn't bet)
Seat 2: maderinha22 (small blind) folded before Flop
Seat 3: @tetaschell (big blind) folded before Flop
Seat 4: muriLLoo.mrL folded before Flop
Seat 5: Everbrun11 collected (3500)
Seat 6: Rochinha2011 folded before Flop (didn't bet)

PokerStars Hand #251209568893: Tournament #3769361908, $52.38+$2.62 USD Hold'em No Limit - Level XI (250/500) - 2024/06/26 22:33:42 UTC [2024/06/26 18:33:42 ET]
Table '3769361908 4' 6-max Seat #2 is the button
Seat 1: JamPanamJam (15485 in chips) 
Seat 2: maderinha22 (7685 in chips) 
Seat 3: @tetaschell (9175 in chips) 
Seat 4: muriLLoo.mrL (10552 in chips) 
Seat 5: Everbrun11 (11591 in chips) 
Seat 6: Rochinha2011 (6995 in chips) 
JamPanamJam: posts the ante 125
maderinha22: posts the ante 125
@tetaschell: posts the ante 125
muriLLoo.mrL: posts the ante 125
Everbrun11: posts the ante 125
Rochinha2011: posts the ante 125
@tetaschell: posts small blind 250
muriLLoo.mrL: posts big blind 500
*** HOLE CARDS ***
Everbrun11: folds 
Rochinha2011: folds 
JamPanamJam: raises 500 to 1000
maderinha22: folds 
@tetaschell: folds 
muriLLoo.mrL: calls 500
*** FLOP *** [Qd Js Th]
muriLLoo.mrL: checks 
JamPanamJam: checks 
*** TURN *** [Qd Js Th] [Kh]
muriLLoo.mrL: checks 
JamPanamJam: bets 2310
muriLLoo.mrL: folds 
Uncalled bet (2310) returned to JamPanamJam
JamPanamJam collected 3000 from pot
JamPanamJam: doesn't show hand 
*** SUMMARY ***
Total pot 3000 | Rake 0 
Board [Qd Js Th Kh]
Seat 1: JamPanamJam collected (3000)
Seat 2: maderinha22 (button) folded before Flop (didn't bet)
Seat 3: @tetaschell (small blind) folded before Flop
Seat 4: muriLLoo.mrL (big blind) folded on the Turn
Seat 5: Everbrun11 folded before Flop (didn't bet)
Seat 6: Rochinha2011 folded before Flop (didn't bet)

PokerStars Hand #251209579019: Tournament #3769361908, $52.38+$2.62 USD Hold'em No Limit - Level XI (250/500) - 2024/06/26 22:34:19 UTC [2024/06/26 18:34:19 ET]
Table '3769361908 4' 6-max Seat #3 is the button
Seat 1: JamPanamJam (17360 in chips) 
Seat 2: maderinha22 (7560 in chips) 
Seat 3: @tetaschell (8800 in chips) 
Seat 4: muriLLoo.mrL (9427 in chips) 
Seat 5: Everbrun11 (11466 in chips) 
Seat 6: Rochinha2011 (6870 in chips) 
JamPanamJam: posts the ante 125
maderinha22: posts the ante 125
@tetaschell: posts the ante 125
muriLLoo.mrL: posts the ante 125
Everbrun11: posts the ante 125
Rochinha2011: posts the ante 125
muriLLoo.mrL: posts small blind 250
Everbrun11: posts big blind 500
*** HOLE CARDS ***
Rochinha2011: folds 
JamPanamJam: folds 
maderinha22: raises 6935 to 7435 and is all-in
@tetaschell: folds 
muriLLoo.mrL: folds 
Everbrun11: calls 6935
*** FLOP *** [2h Td Js]
*** TURN *** [2h Td Js] [6s]
*** RIVER *** [2h Td Js 6s] [9h]
*** SHOW DOWN ***
Everbrun11: shows [As Jd] (a pair of Jacks)
maderinha22: shows [3c 3s] (a pair of Threes)
Everbrun11 collected 15870 from pot
maderinha22 finished the tournament
*** SUMMARY ***
Total pot 15870 | Rake 0 
Board [2h Td Js 6s 9h]
Seat 1: JamPanamJam folded before Flop (didn't bet)
Seat 2: maderinha22 showed [3c 3s] and lost with a pair of Threes
Seat 3: @tetaschell (button) folded before Flop (didn't bet)
Seat 4: muriLLoo.mrL (small blind) folded before Flop
Seat 5: Everbrun11 (big blind) showed [As Jd] and won (15870) with a pair of Jacks
Seat 6: Rochinha2011 folded before Flop (didn't bet)

PokerStars Hand #251209587007: Tournament #3769361908, $52.38+$2.62 USD Hold'em No Limit - Level XI (250/500) - 2024/06/26 22:34:49 UTC [2024/06/26 18:34:49 ET]
Table '3769361908 4' 6-max Seat #4 is the button
Seat 1: JamPanamJam (17235 in chips) 
Seat 3: @tetaschell (8675 in chips) 
Seat 4: muriLLoo.mrL (9052 in chips) 
Seat 5: Everbrun11 (19776 in chips) 
Seat 6: Rochinha2011 (6745 in chips) 
JamPanamJam: posts the ante 125
@tetaschell: posts the ante 125
muriLLoo.mrL: posts the ante 125
Everbrun11: posts the ante 125
Rochinha2011: posts the ante 125
Everbrun11: posts small blind 250
Rochinha2011: posts big blind 500
*** HOLE CARDS ***
JamPanamJam: raises 500 to 1000
@tetaschell: folds 
muriLLoo.mrL: folds 
Everbrun11: folds 
Rochinha2011: folds 
Uncalled bet (500) returned to JamPanamJam
JamPanamJam collected 1875 from pot
JamPanamJam: doesn't show hand 
*** SUMMARY ***
Total pot 1875 | Rake 0 
Seat 1: JamPanamJam collected (1875)
Seat 3: @tetaschell folded before Flop (didn't bet)
Seat 4: muriLLoo.mrL (button) folded before Flop (didn't bet)
Seat 5: Everbrun11 (small blind) folded before Flop
Seat 6: Rochinha2011 (big blind) folded before Flop

PokerStars Hand #251209594770: Tournament #3769361908, $52.38+$2.62 USD Hold'em No Limit - Level XII (300/600) - 2024/06/26 22:35:18 UTC [2024/06/26 18:35:18 ET]
Table '3769361908 4' 6-max Seat #5 is the button
Seat 1: JamPanamJam (18485 in chips) 
Seat 3: @tetaschell (8550 in chips) 
Seat 4: muriLLoo.mrL (8927 in chips) 
Seat 5: Everbrun11 (19401 in chips) 
Seat 6: Rochinha2011 (6120 in chips) 
JamPanamJam: posts the ante 150
@tetaschell: posts the ante 150
muriLLoo.mrL: posts the ante 150
Everbrun11: posts the ante 150
Rochinha2011: posts the ante 150
Rochinha2011: posts small blind 300
JamPanamJam: posts big blind 600
*** HOLE CARDS ***
@tetaschell: folds 
muriLLoo.mrL: folds 
Everbrun11: folds 
Rochinha2011: folds 
Uncalled bet (300) returned to JamPanamJam
JamPanamJam collected 1350 from pot
JamPanamJam: doesn't show hand 
*** SUMMARY ***
Total pot 1350 | Rake 0 
Seat 1: JamPanamJam (big blind) collected (1350)
Seat 3: @tetaschell folded before Flop (didn't bet)
Seat 4: muriLLoo.mrL folded before Flop (didn't bet)
Seat 5: Everbrun11 (button) folded before Flop (didn't bet)
Seat 6: Rochinha2011 (small blind) folded before Flop

PokerStars Hand #251209599762: Tournament #3769361908, $52.38+$2.62 USD Hold'em No Limit - Level XII (300/600) - 2024/06/26 22:35:36 UTC [2024/06/26 18:35:36 ET]
Table '3769361908 4' 6-max Seat #6 is the button
Seat 1: JamPanamJam (19385 in chips) 
Seat 2: alexsarakini (10000 in chips) 
Seat 3: @tetaschell (8400 in chips) 
Seat 4: muriLLoo.mrL (8777 in chips) 
Seat 5: Everbrun11 (19251 in chips) 
Seat 6: Rochinha2011 (5670 in chips) 
JamPanamJam: posts the ante 150
alexsarakini: posts the ante 150
@tetaschell: posts the ante 150
muriLLoo.mrL: posts the ante 150
Everbrun11: posts the ante 150
Rochinha2011: posts the ante 150
JamPanamJam: posts small blind 300
alexsarakini: posts big blind 600
*** HOLE CARDS ***
@tetaschell: folds 
muriLLoo.mrL: folds 
Everbrun11: raises 600 to 1200
Rochinha2011: folds 
JamPanamJam: raises 18035 to 19235 and is all-in
alexsarakini: folds 
Everbrun11: calls 17901 and is all-in
Uncalled bet (134) returned to JamPanamJam
*** FLOP *** [7c 5s 7h]
*** TURN *** [7c 5s 7h] [Jd]
*** RIVER *** [7c 5s 7h Jd] [6h]
*** SHOW DOWN ***
JamPanamJam: shows [8h 8s] (two pair, Eights and Sevens)
Everbrun11: shows [Ts Th] (two pair, Tens and Sevens)
Everbrun11 collected 39702 from pot
*** SUMMARY ***
Total pot 39702 | Rake 0 
Board [7c 5s 7h Jd 6h]
Seat 1: JamPanamJam (small blind) showed [8h 8s] and lost with two pair, Eights and Sevens
Seat 2: alexsarakini (big blind) folded before Flop
Seat 3: @tetaschell folded before Flop (didn't bet)
Seat 4: muriLLoo.mrL folded before Flop (didn't bet)
Seat 5: Everbrun11 showed [Ts Th] and won (39702) with two pair, Tens and Sevens
Seat 6: Rochinha2011 (button) folded before Flop (didn't bet)

PokerStars Hand #251209611279: Tournament #3769361908, $52.38+$2.62 USD Hold'em No Limit - Level XII (300/600) - 2024/06/26 22:36:19 UTC [2024/06/26 18:36:19 ET]
Table '3769361908 4' 6-max Seat #1 is the button
Seat 1: JamPanamJam (134 in chips) 
Seat 2: alexsarakini (9250 in chips) 
Seat 3: @tetaschell (8250 in chips) 
Seat 4: muriLLoo.mrL (8627 in chips) 
Seat 5: Everbrun11 (39702 in chips) 
Seat 6: Rochinha2011 (5520 in chips) 
JamPanamJam: posts the ante 134 and is all-in
alexsarakini: posts the ante 150
@tetaschell: posts the ante 150
muriLLoo.mrL: posts the ante 150
Everbrun11: posts the ante 150
Rochinha2011: posts the ante 150
alexsarakini: posts small blind 300
@tetaschell: posts big blind 600
*** HOLE CARDS ***
muriLLoo.mrL: folds 
Everbrun11: folds 
Rochinha2011: raises 4770 to 5370 and is all-in
alexsarakini: folds 
@tetaschell: calls 4770
*** FLOP *** [2d 7s 5d]
*** TURN *** [2d 7s 5d] [Ks]
*** RIVER *** [2d 7s 5d Ks] [6h]
*** SHOW DOWN ***
@tetaschell: shows [Qc As] (high card Ace)
Rochinha2011: shows [8d Ah] (high card Ace - lower kicker)
@tetaschell collected 11120 from side pot
JamPanamJam: shows [6d 4h] (a pair of Sixes)
JamPanamJam collected 804 from main pot
Rochinha2011 finished the tournament
*** SUMMARY ***
Total pot 11924 Main pot 804. Side pot 11120. | Rake 0 
Board [2d 7s 5d Ks 6h]
Seat 1: JamPanamJam (button) showed [6d 4h] and won (804) with a pair of Sixes
Seat 2: alexsarakini (small blind) folded before Flop
Seat 3: @tetaschell (big blind) showed [Qc As] and won (11120) with high card Ace
Seat 4: muriLLoo.mrL folded before Flop (didn't bet)
Seat 5: Everbrun11 folded before Flop (didn't bet)
Seat 6: Rochinha2011 showed [8d Ah] and lost with high card Ace

PokerStars Hand #251209619225: Tournament #3769361908, $52.38+$2.62 USD Hold'em No Limit - Level XII (300/600) - 2024/06/26 22:36:49 UTC [2024/06/26 18:36:49 ET]
Table '3769361908 4' 6-max Seat #2 is the button
Seat 1: JamPanamJam (804 in chips) 
Seat 2: alexsarakini (8800 in chips) 
Seat 3: @tetaschell (13850 in chips) 
Seat 4: muriLLoo.mrL (8477 in chips) 
Seat 5: Everbrun11 (39552 in chips) 
JamPanamJam: posts the ante 150
alexsarakini: posts the ante 150
@tetaschell: posts the ante 150
muriLLoo.mrL: posts the ante 150
Everbrun11: posts the ante 150
@tetaschell: posts small blind 300
muriLLoo.mrL: posts big blind 600
*** HOLE CARDS ***
Everbrun11: raises 600 to 1200
JamPanamJam: folds 
alexsarakini: calls 1200
@tetaschell: folds 
muriLLoo.mrL: raises 7127 to 8327 and is all-in
Everbrun11: folds 
alexsarakini: folds 
Uncalled bet (7127) returned to muriLLoo.mrL
muriLLoo.mrL collected 4650 from pot
muriLLoo.mrL: doesn't show hand 
*** SUMMARY ***
Total pot 4650 | Rake 0 
Seat 1: JamPanamJam folded before Flop (didn't bet)
Seat 2: alexsarakini (button) folded before Flop
Seat 3: @tetaschell (small blind) folded before Flop
Seat 4: muriLLoo.mrL (big blind) collected (4650)
Seat 5: Everbrun11 folded before Flop

PokerStars Hand #251209624583: Tournament #3769361908, $52.38+$2.62 USD Hold'em No Limit - Level XII (300/600) - 2024/06/26 22:37:09 UTC [2024/06/26 18:37:09 ET]
Table '3769361908 4' 6-max Seat #3 is the button
Seat 1: JamPanamJam (654 in chips) 
Seat 2: alexsarakini (7450 in chips) 
Seat 3: @tetaschell (13400 in chips) 
Seat 4: muriLLoo.mrL (11777 in chips) 
Seat 5: Everbrun11 (38202 in chips) 
JamPanamJam: posts the ante 150
alexsarakini: posts the ante 150
@tetaschell: posts the ante 150
muriLLoo.mrL: posts the ante 150
Everbrun11: posts the ante 150
muriLLoo.mrL: posts small blind 300
Everbrun11: posts big blind 600
*** HOLE CARDS ***
JamPanamJam: calls 504 and is all-in
alexsarakini: folds 
@tetaschell: folds 
muriLLoo.mrL: calls 300
Everbrun11: raises 1200 to 1800
muriLLoo.mrL: folds 
Uncalled bet (1200) returned to Everbrun11
*** FLOP *** [Jc 3s Qc]
*** TURN *** [Jc 3s Qc] [6c]
*** RIVER *** [Jc 3s Qc 6c] [8s]
*** SHOW DOWN ***
Everbrun11: shows [Kc Kd] (a pair of Kings)
Everbrun11 collected 192 from side pot
JamPanamJam: shows [2s 8d] (a pair of Eights)
Everbrun11 collected 2262 from main pot
JamPanamJam finished the tournament
somnamna555 is disconnected 
*** SUMMARY ***
Total pot 2454 Main pot 2262. Side pot 192. | Rake 0 
Board [Jc 3s Qc 6c 8s]
Seat 1: JamPanamJam showed [2s 8d] and lost with a pair of Eights
Seat 2: alexsarakini folded before Flop (didn't bet)
Seat 3: @tetaschell (button) folded before Flop (didn't bet)
Seat 4: muriLLoo.mrL (small blind) folded before Flop
Seat 5: Everbrun11 (big blind) showed [Kc Kd] and won (2454) with a pair of Kings

PokerStars Hand #251209636110: Tournament #3769361908, $52.38+$2.62 USD Hold'em No Limit - Level XII (300/600) - 2024/06/26 22:37:52 UTC [2024/06/26 18:37:52 ET]
Table '3769361908 4' 6-max Seat #4 is the button
Seat 1: somnamna555 (13734 in chips) 
Seat 2: alexsarakini (7300 in chips) 
Seat 3: @tetaschell (13250 in chips) 
Seat 4: muriLLoo.mrL (11027 in chips) 
Seat 5: Everbrun11 (39906 in chips) 
somnamna555: posts the ante 150
alexsarakini: posts the ante 150
@tetaschell: posts the ante 150
muriLLoo.mrL: posts the ante 150
Everbrun11: posts the ante 150
Everbrun11: posts small blind 300
somnamna555: posts big blind 600
*** HOLE CARDS ***
alexsarakini: raises 1200 to 1800
@tetaschell: folds 
muriLLoo.mrL: folds 
Everbrun11: folds 
somnamna555: folds 
Uncalled bet (1200) returned to alexsarakini
alexsarakini collected 2250 from pot
*** SUMMARY ***
Total pot 2250 | Rake 0 
Seat 1: somnamna555 (big blind) folded before Flop
Seat 2: alexsarakini collected (2250)
Seat 3: @tetaschell folded before Flop (didn't bet)
Seat 4: muriLLoo.mrL (button) folded before Flop (didn't bet)
Seat 5: Everbrun11 (small blind) folded before Flop

PokerStars Hand #251209642433: Tournament #3769361908, $52.38+$2.62 USD Hold'em No Limit - Level XIII (400/800) - 2024/06/26 22:38:16 UTC [2024/06/26 18:38:16 ET]
Table '3769361908 4' 6-max Seat #5 is the button
Seat 1: somnamna555 (12984 in chips) 
Seat 2: alexsarakini (8800 in chips) 
Seat 3: @tetaschell (13100 in chips) 
Seat 4: muriLLoo.mrL (10877 in chips) 
Seat 5: Everbrun11 (39456 in chips) 
somnamna555: posts the ante 200
alexsarakini: posts the ante 200
@tetaschell: posts the ante 200
muriLLoo.mrL: posts the ante 200
Everbrun11: posts the ante 200
somnamna555: posts small blind 400
alexsarakini: posts big blind 800
*** HOLE CARDS ***
@tetaschell: folds 
muriLLoo.mrL: folds 
Everbrun11: folds 
somnamna555: folds 
Uncalled bet (400) returned to alexsarakini
alexsarakini collected 1800 from pot
*** SUMMARY ***
Total pot 1800 | Rake 0 
Seat 1: somnamna555 (small blind) folded before Flop
Seat 2: alexsarakini (big blind) collected (1800)
Seat 3: @tetaschell folded before Flop (didn't bet)
Seat 4: muriLLoo.mrL folded before Flop (didn't bet)
Seat 5: Everbrun11 (button) folded before Flop (didn't bet)

PokerStars Hand #251209645550: Tournament #3769361908, $52.38+$2.62 USD Hold'em No Limit - Level XIII (400/800) - 2024/06/26 22:38:28 UTC [2024/06/26 18:38:28 ET]
Table '3769361908 4' 6-max Seat #1 is the button
Seat 1: somnamna555 (12384 in chips) 
Seat 2: alexsarakini (10000 in chips) 
Seat 3: @tetaschell (12900 in chips) 
Seat 4: muriLLoo.mrL (10677 in chips) 
Seat 5: Everbrun11 (39256 in chips) 
somnamna555: posts the ante 200
alexsarakini: posts the ante 200
@tetaschell: posts the ante 200
muriLLoo.mrL: posts the ante 200
Everbrun11: posts the ante 200
alexsarakini: posts small blind 400
@tetaschell: posts big blind 800
*** HOLE CARDS ***
muriLLoo.mrL: folds 
Everbrun11: folds 
somnamna555: folds 
alexsarakini: folds 
Uncalled bet (400) returned to @tetaschell
@tetaschell collected 1800 from pot
@tetaschell: doesn't show hand 
*** SUMMARY ***
Total pot 1800 | Rake 0 
Seat 1: somnamna555 (button) folded before Flop (didn't bet)
Seat 2: alexsarakini (small blind) folded before Flop
Seat 3: @tetaschell (big blind) collected (1800)
Seat 4: muriLLoo.mrL folded before Flop (didn't bet)
Seat 5: Everbrun11 folded before Flop (didn't bet)

PokerStars Hand #251209647964: Tournament #3769361908, $52.38+$2.62 USD Hold'em No Limit - Level XIII (400/800) - 2024/06/26 22:38:37 UTC [2024/06/26 18:38:37 ET]
Table '3769361908 4' 6-max Seat #2 is the button
Seat 1: somnamna555 (12184 in chips) 
Seat 2: alexsarakini (9400 in chips) 
Seat 3: @tetaschell (14100 in chips) 
Seat 4: muriLLoo.mrL (10477 in chips) 
Seat 5: Everbrun11 (39056 in chips) 
somnamna555: posts the ante 200
alexsarakini: posts the ante 200
@tetaschell: posts the ante 200
muriLLoo.mrL: posts the ante 200
Everbrun11: posts the ante 200
@tetaschell: posts small blind 400
muriLLoo.mrL: posts big blind 800
*** HOLE CARDS ***
Everbrun11: folds 
somnamna555: folds 
alexsarakini: raises 800 to 1600
@tetaschell: folds 
muriLLoo.mrL: calls 800
*** FLOP *** [Td 6c 8s]
muriLLoo.mrL: checks 
alexsarakini: bets 1500
muriLLoo.mrL: folds 
Uncalled bet (1500) returned to alexsarakini
alexsarakini collected 4600 from pot
*** SUMMARY ***
Total pot 4600 | Rake 0 
Board [Td 6c 8s]
Seat 1: somnamna555 folded before Flop (didn't bet)
Seat 2: alexsarakini (button) collected (4600)
Seat 3: @tetaschell (small blind) folded before Flop
Seat 4: muriLLoo.mrL (big blind) folded on the Flop
Seat 5: Everbrun11 folded before Flop (didn't bet)

PokerStars Hand #251209658154: Tournament #3769361908, $52.38+$2.62 USD Hold'em No Limit - Level XIII (400/800) - 2024/06/26 22:39:15 UTC [2024/06/26 18:39:15 ET]
Table '3769361908 4' 6-max Seat #3 is the button
Seat 1: somnamna555 (11984 in chips) 
Seat 2: alexsarakini (12200 in chips) 
Seat 3: @tetaschell (13500 in chips) 
Seat 4: muriLLoo.mrL (8677 in chips) 
Seat 5: Everbrun11 (38856 in chips) 
somnamna555: posts the ante 200
alexsarakini: posts the ante 200
@tetaschell: posts the ante 200
muriLLoo.mrL: posts the ante 200
Everbrun11: posts the ante 200
muriLLoo.mrL: posts small blind 400
Everbrun11: posts big blind 800
*** HOLE CARDS ***
somnamna555: folds 
alexsarakini: folds 
@tetaschell: folds 
muriLLoo.mrL: calls 400
Everbrun11: raises 37856 to 38656 and is all-in
muriLLoo.mrL: calls 7677 and is all-in
Uncalled bet (30179) returned to Everbrun11
*** FLOP *** [4c 5h Qd]
*** TURN *** [4c 5h Qd] [9c]
*** RIVER *** [4c 5h Qd 9c] [Jc]
*** SHOW DOWN ***
muriLLoo.mrL: shows [Qc Qh] (three of a kind, Queens)
Everbrun11: shows [Ac 3s] (high card Ace)
muriLLoo.mrL collected 17954 from pot
*** SUMMARY ***
Total pot 17954 | Rake 0 
Board [4c 5h Qd 9c Jc]
Seat 1: somnamna555 folded before Flop (didn't bet)
Seat 2: alexsarakini folded before Flop (didn't bet)
Seat 3: @tetaschell (button) folded before Flop (didn't bet)
Seat 4: muriLLoo.mrL (small blind) showed [Qc Qh] and won (17954) with three of a kind, Queens
Seat 5: Everbrun11 (big blind) showed [Ac 3s] and lost with high card Ace

PokerStars Hand #251209665019: Tournament #3769361908, $52.38+$2.62 USD Hold'em No Limit - Level XIII (400/800) - 2024/06/26 22:39:40 UTC [2024/06/26 18:39:40 ET]
Table '3769361908 4' 6-max Seat #4 is the button
Seat 1: somnamna555 (11784 in chips) 
Seat 2: alexsarakini (12000 in chips) 
Seat 3: @tetaschell (13300 in chips) 
Seat 4: muriLLoo.mrL (17954 in chips) 
Seat 5: Everbrun11 (30179 in chips) 
Seat 6: anth0nypappa (2142 in chips) is sitting out
somnamna555: posts the ante 200
alexsarakini: posts the ante 200
@tetaschell: posts the ante 200
muriLLoo.mrL: posts the ante 200
Everbrun11: posts the ante 200
anth0nypappa: posts the ante 200
Everbrun11: posts small blind 400
anth0nypappa: posts big blind 800
*** HOLE CARDS ***
somnamna555: raises 10784 to 11584 and is all-in
alexsarakini: folds 
@tetaschell: folds 
muriLLoo.mrL: folds 
Everbrun11: folds 
anth0nypappa: folds 
Uncalled bet (10784) returned to somnamna555
somnamna555 collected 3200 from pot
somnamna555: doesn't show hand 
*** SUMMARY ***
Total pot 3200 | Rake 0 
Seat 1: somnamna555 collected (3200)
Seat 2: alexsarakini folded before Flop (didn't bet)
Seat 3: @tetaschell folded before Flop (didn't bet)
Seat 4: muriLLoo.mrL (button) folded before Flop (didn't bet)
Seat 5: Everbrun11 (small blind) folded before Flop
Seat 6: anth0nypappa (big blind) folded before Flop

PokerStars Hand #251209670103: Tournament #3769361908, $52.38+$2.62 USD Hold'em No Limit - Level XIII (400/800) - 2024/06/26 22:39:59 UTC [2024/06/26 18:39:59 ET]
Table '3769361908 4' 6-max Seat #5 is the button
Seat 1: somnamna555 (13984 in chips) 
Seat 2: alexsarakini (11800 in chips) 
Seat 3: @tetaschell (13100 in chips) 
Seat 4: muriLLoo.mrL (17754 in chips) 
Seat 5: Everbrun11 (29579 in chips) 
Seat 6: anth0nypappa (1142 in chips) is sitting out
somnamna555: posts the ante 200
alexsarakini: posts the ante 200
@tetaschell: posts the ante 200
muriLLoo.mrL: posts the ante 200
Everbrun11: posts the ante 200
anth0nypappa: posts the ante 200
anth0nypappa: posts small blind 400
somnamna555: posts big blind 800
*** HOLE CARDS ***
alexsarakini: folds 
@tetaschell: raises 800 to 1600
muriLLoo.mrL: folds 
Everbrun11: folds 
anth0nypappa: folds 
somnamna555: raises 12184 to 13784 and is all-in
@tetaschell: calls 11300 and is all-in
Uncalled bet (884) returned to somnamna555
*** FLOP *** [4h 6c 3h]
*** TURN *** [4h 6c 3h] [7c]
*** RIVER *** [4h 6c 3h 7c] [5d]
*** SHOW DOWN ***
somnamna555: shows [As 9s] (a straight, Three to Seven)
@tetaschell: shows [Qc Ah] (a straight, Three to Seven)
somnamna555 collected 13700 from pot
@tetaschell collected 13700 from pot
*** SUMMARY ***
Total pot 27400 | Rake 0 
Board [4h 6c 3h 7c 5d]
Seat 1: somnamna555 (big blind) showed [As 9s] and won (13700) with a straight, Three to Seven
Seat 2: alexsarakini folded before Flop (didn't bet)
Seat 3: @tetaschell showed [Qc Ah] and won (13700) with a straight, Three to Seven
Seat 4: muriLLoo.mrL folded before Flop (didn't bet)
Seat 5: Everbrun11 (button) folded before Flop (didn't bet)
Seat 6: anth0nypappa (small blind) folded before Flop

PokerStars Hand #251209676974: Tournament #3769361908, $52.38+$2.62 USD Hold'em No Limit - Level XIII (400/800) - 2024/06/26 22:40:25 UTC [2024/06/26 18:40:25 ET]
Table '3769361908 4' 6-max Seat #6 is the button
Seat 1: somnamna555 (14584 in chips) 
Seat 2: alexsarakini (11600 in chips) 
Seat 3: @tetaschell (13700 in chips) 
Seat 4: muriLLoo.mrL (17554 in chips) 
Seat 5: Everbrun11 (29379 in chips) 
Seat 6: anth0nypappa (542 in chips) is sitting out
somnamna555: posts the ante 200
alexsarakini: posts the ante 200
@tetaschell: posts the ante 200
muriLLoo.mrL: posts the ante 200
Everbrun11: posts the ante 200
anth0nypappa: posts the ante 200
somnamna555: posts small blind 400
alexsarakini: posts big blind 800
*** HOLE CARDS ***
@tetaschell: folds 
muriLLoo.mrL: folds 
Everbrun11: folds 
anth0nypappa: folds 
somnamna555: raises 13584 to 14384 and is all-in
alexsarakini: folds 
Uncalled bet (13584) returned to somnamna555
somnamna555 collected 2800 from pot
somnamna555: doesn't show hand 
*** SUMMARY ***
Total pot 2800 | Rake 0 
Seat 1: somnamna555 (small blind) collected (2800)
Seat 2: alexsarakini (big blind) folded before Flop
Seat 3: @tetaschell folded before Flop (didn't bet)
Seat 4: muriLLoo.mrL folded before Flop (didn't bet)
Seat 5: Everbrun11 folded before Flop (didn't bet)
Seat 6: anth0nypappa (button) folded before Flop (didn't bet)

PokerStars Hand #251209681960: Tournament #3769361908, $52.38+$2.62 USD Hold'em No Limit - Level XIII (400/800) - 2024/06/26 22:40:45 UTC [2024/06/26 18:40:45 ET]
Table '3769361908 4' 6-max Seat #1 is the button
Seat 1: somnamna555 (16384 in chips) 
Seat 2: alexsarakini (10600 in chips) 
Seat 3: @tetaschell (13500 in chips) 
Seat 4: muriLLoo.mrL (17354 in chips) 
Seat 5: Everbrun11 (29179 in chips) 
Seat 6: anth0nypappa (342 in chips) is sitting out
somnamna555: posts the ante 200
alexsarakini: posts the ante 200
@tetaschell: posts the ante 200
muriLLoo.mrL: posts the ante 200
Everbrun11: posts the ante 200
anth0nypappa: posts the ante 200
alexsarakini: posts small blind 400
@tetaschell: posts big blind 800
*** HOLE CARDS ***
muriLLoo.mrL: folds 
Everbrun11: raises 800 to 1600
anth0nypappa: folds 
somnamna555: folds 
alexsarakini: folds 
@tetaschell: calls 800
*** FLOP *** [As 8c 6d]
@tetaschell: checks 
Everbrun11: bets 1200
@tetaschell: folds 
Uncalled bet (1200) returned to Everbrun11
Everbrun11 collected 4800 from pot
Everbrun11: doesn't show hand 
*** SUMMARY ***
Total pot 4800 | Rake 0 
Board [As 8c 6d]
Seat 1: somnamna555 (button) folded before Flop (didn't bet)
Seat 2: alexsarakini (small blind) folded before Flop
Seat 3: @tetaschell (big blind) folded on the Flop
Seat 4: muriLLoo.mrL folded before Flop (didn't bet)
Seat 5: Everbrun11 collected (4800)
Seat 6: anth0nypappa folded before Flop (didn't bet)

PokerStars Hand #251209694908: Tournament #3769361908, $52.38+$2.62 USD Hold'em No Limit - Level XIV (500/1000) - 2024/06/26 22:41:34 UTC [2024/06/26 18:41:34 ET]
Table '3769361908 4' 6-max Seat #2 is the button
Seat 1: somnamna555 (16184 in chips) 
Seat 2: alexsarakini (10000 in chips) 
Seat 3: @tetaschell (11700 in chips) 
Seat 4: muriLLoo.mrL (17154 in chips) 
Seat 5: Everbrun11 (32179 in chips) 
Seat 6: anth0nypappa (142 in chips) is sitting out
somnamna555: posts the ante 250
alexsarakini: posts the ante 250
@tetaschell: posts the ante 250
muriLLoo.mrL: posts the ante 250
Everbrun11: posts the ante 250
anth0nypappa: posts the ante 142 and is all-in
@tetaschell: posts small blind 500
muriLLoo.mrL: posts big blind 1000
*** HOLE CARDS ***
Everbrun11: raises 1000 to 2000
anth0nypappa: folds 
somnamna555: folds 
alexsarakini: folds 
@tetaschell: folds 
muriLLoo.mrL: calls 1000
*** FLOP *** [Ad 8h 4h]
muriLLoo.mrL: checks 
Everbrun11: bets 1500
muriLLoo.mrL: raises 13404 to 14904 and is all-in
Everbrun11: folds 
Uncalled bet (13404) returned to muriLLoo.mrL
muriLLoo.mrL collected 8892 from pot
anth0nypappa finished the tournament
muriLLoo.mrL: doesn't show hand 
*** SUMMARY ***
Total pot 8892 | Rake 0 
Board [Ad 8h 4h]
Seat 1: somnamna555 folded before Flop (didn't bet)
Seat 2: alexsarakini (button) folded before Flop (didn't bet)
Seat 3: @tetaschell (small blind) folded before Flop
Seat 4: muriLLoo.mrL (big blind) collected (8892)
Seat 5: Everbrun11 folded on the Flop
Seat 6: anth0nypappa folded before Flop (didn't bet)

PokerStars Hand #251209706683: Tournament #3769361908, $52.38+$2.62 USD Hold'em No Limit - Level XIV (500/1000) - 2024/06/26 22:42:20 UTC [2024/06/26 18:42:20 ET]
Table '3769361908 4' 6-max Seat #3 is the button
Seat 1: somnamna555 (15934 in chips) 
Seat 2: alexsarakini (9750 in chips) 
Seat 3: @tetaschell (10950 in chips) 
Seat 4: muriLLoo.mrL (22296 in chips) 
Seat 5: Everbrun11 (28429 in chips) 
somnamna555: posts the ante 250
alexsarakini: posts the ante 250
@tetaschell: posts the ante 250
muriLLoo.mrL: posts the ante 250
Everbrun11: posts the ante 250
muriLLoo.mrL: posts small blind 500
Everbrun11: posts big blind 1000
*** HOLE CARDS ***
somnamna555: folds 
alexsarakini: folds 
@tetaschell: raises 9700 to 10700 and is all-in
muriLLoo.mrL: folds 
Everbrun11: folds 
Uncalled bet (9700) returned to @tetaschell
@tetaschell collected 3750 from pot
@tetaschell: doesn't show hand 
*** SUMMARY ***
Total pot 3750 | Rake 0 
Seat 1: somnamna555 folded before Flop (didn't bet)
Seat 2: alexsarakini folded before Flop (didn't bet)
Seat 3: @tetaschell (button) collected (3750)
Seat 4: muriLLoo.mrL (small blind) folded before Flop
Seat 5: Everbrun11 (big blind) folded before Flop

PokerStars Hand #251209711927: Tournament #3769361908, $52.38+$2.62 USD Hold'em No Limit - Level XIV (500/1000) - 2024/06/26 22:42:40 UTC [2024/06/26 18:42:40 ET]
Table '3769361908 4' 6-max Seat #4 is the button
Seat 1: somnamna555 (15684 in chips) 
Seat 2: alexsarakini (9500 in chips) 
Seat 3: @tetaschell (13450 in chips) 
Seat 4: muriLLoo.mrL (21546 in chips) 
Seat 5: Everbrun11 (27179 in chips) 
somnamna555: posts the ante 250
alexsarakini: posts the ante 250
@tetaschell: posts the ante 250
muriLLoo.mrL: posts the ante 250
Everbrun11: posts the ante 250
Everbrun11: posts small blind 500
somnamna555: posts big blind 1000
*** HOLE CARDS ***
alexsarakini: folds 
@tetaschell: folds 
muriLLoo.mrL: raises 1000 to 2000
Everbrun11: folds 
somnamna555: folds 
Uncalled bet (1000) returned to muriLLoo.mrL
muriLLoo.mrL collected 3750 from pot
muriLLoo.mrL: doesn't show hand 
*** SUMMARY ***
Total pot 3750 | Rake 0 
Seat 1: somnamna555 (big blind) folded before Flop
Seat 2: alexsarakini folded before Flop (didn't bet)
Seat 3: @tetaschell folded before Flop (didn't bet)
Seat 4: muriLLoo.mrL (button) collected (3750)
Seat 5: Everbrun11 (small blind) folded before Flop

PokerStars Hand #251209717782: Tournament #3769361908, $52.38+$2.62 USD Hold'em No Limit - Level XIV (500/1000) - 2024/06/26 22:43:03 UTC [2024/06/26 18:43:03 ET]
Table '3769361908 4' 6-max Seat #5 is the button
Seat 1: somnamna555 (14434 in chips) 
Seat 2: alexsarakini (9250 in chips) 
Seat 3: @tetaschell (13200 in chips) 
Seat 4: muriLLoo.mrL (24046 in chips) 
Seat 5: Everbrun11 (26429 in chips) 
somnamna555: posts the ante 250
alexsarakini: posts the ante 250
@tetaschell: posts the ante 250
muriLLoo.mrL: posts the ante 250
Everbrun11: posts the ante 250
somnamna555: posts small blind 500
alexsarakini: posts big blind 1000
*** HOLE CARDS ***
@tetaschell: raises 11950 to 12950 and is all-in
muriLLoo.mrL: raises 10846 to 23796 and is all-in
Everbrun11: folds 
somnamna555: folds 
alexsarakini: folds 
Uncalled bet (10846) returned to muriLLoo.mrL
*** FLOP *** [Js Ah 4c]
*** TURN *** [Js Ah 4c] [3c]
*** RIVER *** [Js Ah 4c 3c] [4d]
*** SHOW DOWN ***
@tetaschell: shows [Ks Qd] (a pair of Fours)
muriLLoo.mrL: shows [Ac 7c] (two pair, Aces and Fours)
muriLLoo.mrL collected 28650 from pot
@tetaschell finished the tournament
*** SUMMARY ***
Total pot 28650 | Rake 0 
Board [Js Ah 4c 3c 4d]
Seat 1: somnamna555 (small blind) folded before Flop
Seat 2: alexsarakini (big blind) folded before Flop
Seat 3: @tetaschell showed [Ks Qd] and lost with a pair of Fours
Seat 4: muriLLoo.mrL showed [Ac 7c] and won (28650) with two pair, Aces and Fours
Seat 5: Everbrun11 (button) folded before Flop (didn't bet)

PokerStars Hand #251209725506: Tournament #3769361908, $52.38+$2.62 USD Hold'em No Limit - Level XIV (500/1000) - 2024/06/26 22:43:33 UTC [2024/06/26 18:43:33 ET]
Table '3769361908 4' 6-max Seat #1 is the button
Seat 1: somnamna555 (13684 in chips) 
Seat 2: alexsarakini (8000 in chips) 
Seat 4: muriLLoo.mrL (39496 in chips) 
Seat 5: Everbrun11 (26179 in chips) 
somnamna555: posts the ante 250
alexsarakini: posts the ante 250
muriLLoo.mrL: posts the ante 250
Everbrun11: posts the ante 250
alexsarakini: posts small blind 500
muriLLoo.mrL: posts big blind 1000
*** HOLE CARDS ***
gwallgofddyn is disconnected 
Everbrun11: raises 1000 to 2000
somnamna555: folds 
alexsarakini: folds 
muriLLoo.mrL: calls 1000
*** FLOP *** [9d Qc Td]
muriLLoo.mrL: checks 
Everbrun11: bets 2000
muriLLoo.mrL: calls 2000
*** TURN *** [9d Qc Td] [Ah]
muriLLoo.mrL: checks 
Everbrun11: bets 6000
muriLLoo.mrL: raises 29246 to 35246 and is all-in
Everbrun11: calls 15929 and is all-in
Uncalled bet (13317) returned to muriLLoo.mrL
*** RIVER *** [9d Qc Td Ah] [6d]
*** SHOW DOWN ***
muriLLoo.mrL: shows [Ac 9h] (two pair, Aces and Nines)
Everbrun11: shows [Qs Ad] (two pair, Aces and Queens)
Everbrun11 collected 53358 from pot
*** SUMMARY ***
Total pot 53358 | Rake 0 
Board [9d Qc Td Ah 6d]
Seat 1: somnamna555 (button) folded before Flop (didn't bet)
Seat 2: alexsarakini (small blind) folded before Flop
Seat 4: muriLLoo.mrL (big blind) showed [Ac 9h] and lost with two pair, Aces and Nines
Seat 5: Everbrun11 showed [Qs Ad] and won (53358) with two pair, Aces and Queens

PokerStars Hand #251209736516: Tournament #3769361908, $52.38+$2.62 USD Hold'em No Limit - Level XV (600/1200) - 2024/06/26 22:44:16 UTC [2024/06/26 18:44:16 ET]
Table '3769361908 4' 6-max Seat #2 is the button
Seat 1: somnamna555 (13434 in chips) 
Seat 2: alexsarakini (7250 in chips) 
Seat 3: gwallgofddyn (12876 in chips) out of hand (moved from another table into small blind)
Seat 4: muriLLoo.mrL (13317 in chips) 
Seat 5: Everbrun11 (53358 in chips) 
gwallgofddyn will be allowed to play after the button
somnamna555: posts the ante 300
alexsarakini: posts the ante 300
muriLLoo.mrL: posts the ante 300
Everbrun11: posts the ante 300
muriLLoo.mrL: posts small blind 600
Everbrun11: posts big blind 1200
*** HOLE CARDS ***
somnamna555: folds 
alexsarakini: folds 
muriLLoo.mrL: raises 11817 to 13017 and is all-in
Everbrun11: folds 
Uncalled bet (11817) returned to muriLLoo.mrL
muriLLoo.mrL collected 3600 from pot
muriLLoo.mrL: doesn't show hand 
*** SUMMARY ***
Total pot 3600 | Rake 0 
Seat 1: somnamna555 folded before Flop (didn't bet)
Seat 2: alexsarakini (button) folded before Flop (didn't bet)
Seat 4: muriLLoo.mrL (small blind) collected (3600)
Seat 5: Everbrun11 (big blind) folded before Flop

PokerStars Hand #251209740100: Tournament #3769361908, $52.38+$2.62 USD Hold'em No Limit - Level XV (600/1200) - 2024/06/26 22:44:30 UTC [2024/06/26 18:44:30 ET]
Table '3769361908 4' 6-max Seat #4 is the button
Seat 1: somnamna555 (13134 in chips) 
Seat 2: alexsarakini (6950 in chips) 
Seat 3: gwallgofddyn (12876 in chips) 
Seat 4: muriLLoo.mrL (15417 in chips) 
Seat 5: Everbrun11 (51858 in chips) 
somnamna555: posts the ante 300
alexsarakini: posts the ante 300
gwallgofddyn: posts the ante 300
muriLLoo.mrL: posts the ante 300
Everbrun11: posts the ante 300
Everbrun11: posts small blind 600
somnamna555: posts big blind 1200
*** HOLE CARDS ***
alexsarakini: folds 
gwallgofddyn: raises 1200 to 2400
muriLLoo.mrL: folds 
BernardoDG is disconnected 
Everbrun11: folds 
somnamna555: folds 
Uncalled bet (1200) returned to gwallgofddyn
gwallgofddyn collected 4500 from pot
gwallgofddyn: doesn't show hand 
*** SUMMARY ***
Total pot 4500 | Rake 0 
Seat 1: somnamna555 (big blind) folded before Flop
Seat 2: alexsarakini folded before Flop (didn't bet)
Seat 3: gwallgofddyn collected (4500)
Seat 4: muriLLoo.mrL (button) folded before Flop (didn't bet)
Seat 5: Everbrun11 (small blind) folded before Flop

PokerStars Hand #251209746455: Tournament #3769361908, $52.38+$2.62 USD Hold'em No Limit - Level XV (600/1200) - 2024/06/26 22:44:55 UTC [2024/06/26 18:44:55 ET]
Table '3769361908 4' 6-max Seat #5 is the button
Seat 1: somnamna555 (11634 in chips) 
Seat 2: alexsarakini (6650 in chips) 
Seat 3: gwallgofddyn (15876 in chips) 
Seat 4: muriLLoo.mrL (15117 in chips) 
Seat 5: Everbrun11 (50958 in chips) 
Seat 6: BernardoDG (18951 in chips) out of hand (moved from another table into small blind)
BernardoDG will be allowed to play after the button
somnamna555: posts the ante 300
alexsarakini: posts the ante 300
gwallgofddyn: posts the ante 300
muriLLoo.mrL: posts the ante 300
Everbrun11: posts the ante 300
somnamna555: posts small blind 600
alexsarakini: posts big blind 1200
*** HOLE CARDS ***
gwallgofddyn: folds 
muriLLoo.mrL: raises 1200 to 2400
Everbrun11: folds 
somnamna555: folds 
alexsarakini: folds 
Uncalled bet (1200) returned to muriLLoo.mrL
muriLLoo.mrL collected 4500 from pot
muriLLoo.mrL: doesn't show hand 
*** SUMMARY ***
Total pot 4500 | Rake 0 
Seat 1: somnamna555 (small blind) folded before Flop
Seat 2: alexsarakini (big blind) folded before Flop
Seat 3: gwallgofddyn folded before Flop (didn't bet)
Seat 4: muriLLoo.mrL collected (4500)
Seat 5: Everbrun11 (button) folded before Flop (didn't bet)

PokerStars Hand #251209753640: Tournament #3769361908, $52.38+$2.62 USD Hold'em No Limit - Level XV (600/1200) - 2024/06/26 22:45:23 UTC [2024/06/26 18:45:23 ET]
Table '3769361908 4' 6-max Seat #1 is the button
Seat 1: somnamna555 (10734 in chips) 
Seat 2: alexsarakini (5150 in chips) 
Seat 3: gwallgofddyn (15576 in chips) 
Seat 4: muriLLoo.mrL (18117 in chips) 
Seat 5: Everbrun11 (50658 in chips) 
Seat 6: BernardoDG (18951 in chips) 
somnamna555: posts the ante 300
alexsarakini: posts the ante 300
gwallgofddyn: posts the ante 300
muriLLoo.mrL: posts the ante 300
Everbrun11: posts the ante 300
BernardoDG: posts the ante 300
alexsarakini: posts small blind 600
gwallgofddyn: posts big blind 1200
*** HOLE CARDS ***
muriLLoo.mrL: raises 16617 to 17817 and is all-in
Everbrun11: raises 16617 to 34434
BernardoDG: folds 
somnamna555: folds 
alexsarakini: calls 4250 and is all-in
gwallgofddyn: folds 
Uncalled bet (16617) returned to Everbrun11
*** FLOP *** [As 3s 9h]
*** TURN *** [As 3s 9h] [8h]
*** RIVER *** [As 3s 9h 8h] [4d]
*** SHOW DOWN ***
muriLLoo.mrL: shows [Kh Qs] (high card Ace)
Everbrun11: shows [Ad Jc] (a pair of Aces)
Everbrun11 collected 25934 from side pot
alexsarakini: shows [Ac 6h] (a pair of Aces - lower kicker)
Everbrun11 collected 17550 from main pot
muriLLoo.mrL finished the tournament
alexsarakini finished the tournament
*** SUMMARY ***
Total pot 43484 Main pot 17550. Side pot 25934. | Rake 0 
Board [As 3s 9h 8h 4d]
Seat 1: somnamna555 (button) folded before Flop (didn't bet)
Seat 2: alexsarakini (small blind) showed [Ac 6h] and lost with a pair of Aces
Seat 3: gwallgofddyn (big blind) folded before Flop
Seat 4: muriLLoo.mrL showed [Kh Qs] and lost with high card Ace
Seat 5: Everbrun11 showed [Ad Jc] and won (43484) with a pair of Aces
Seat 6: BernardoDG folded before Flop (didn't bet)

PokerStars Hand #251209759426: Tournament #3769361908, $52.38+$2.62 USD Hold'em No Limit - Level XV (600/1200) - 2024/06/26 22:45:45 UTC [2024/06/26 18:45:45 ET]
Table '3769361908 4' 6-max Seat #3 is the button
Seat 1: somnamna555 (10434 in chips) 
Seat 2: Biguethi339 (7600 in chips) 
Seat 3: gwallgofddyn (14076 in chips) 
Seat 5: Everbrun11 (76025 in chips) 
Seat 6: BernardoDG (18651 in chips) 
somnamna555: posts the ante 300
Biguethi339: posts the ante 300
gwallgofddyn: posts the ante 300
Everbrun11: posts the ante 300
BernardoDG: posts the ante 300
Everbrun11: posts small blind 600
BernardoDG: posts big blind 1200
*** HOLE CARDS ***
Biguethi339 is disconnected 
somnamna555: folds 
Biguethi339: folds 
gwallgofddyn: raises 12576 to 13776 and is all-in
Everbrun11: folds 
BernardoDG: folds 
Uncalled bet (12576) returned to gwallgofddyn
gwallgofddyn collected 4500 from pot
gwallgofddyn: doesn't show hand 
*** SUMMARY ***
Total pot 4500 | Rake 0 
Seat 1: somnamna555 folded before Flop (didn't bet)
Seat 2: Biguethi339 folded before Flop (didn't bet)
Seat 3: gwallgofddyn (button) collected (4500)
Seat 5: Everbrun11 (small blind) folded before Flop
Seat 6: BernardoDG (big blind) folded before Flop

PokerStars Hand #251209764347: Tournament #3769361908, $52.38+$2.62 USD Hold'em No Limit - Level XV (600/1200) - 2024/06/26 22:46:04 UTC [2024/06/26 18:46:04 ET]
Table '3769361908 4' 6-max Seat #5 is the button
Seat 1: somnamna555 (10134 in chips) 
Seat 2: Biguethi339 (7300 in chips) 
Seat 3: gwallgofddyn (17076 in chips) 
Seat 5: Everbrun11 (75125 in chips) 
Seat 6: BernardoDG (17151 in chips) 
somnamna555: posts the ante 300
Biguethi339: posts the ante 300
gwallgofddyn: posts the ante 300
Everbrun11: posts the ante 300
BernardoDG: posts the ante 300
BernardoDG: posts small blind 600
somnamna555: posts big blind 1200
*** HOLE CARDS ***
Biguethi339: folds 
gwallgofddyn: folds 
Everbrun11: folds 
hed777 is disconnected 
BernardoDG: raises 15651 to 16851 and is all-in
somnamna555: folds 
Uncalled bet (15651) returned to BernardoDG
BernardoDG collected 3900 from pot
BernardoDG: doesn't show hand 
*** SUMMARY ***
Total pot 3900 | Rake 0 
Seat 1: somnamna555 (big blind) folded before Flop
Seat 2: Biguethi339 folded before Flop (didn't bet)
Seat 3: gwallgofddyn folded before Flop (didn't bet)
Seat 5: Everbrun11 (button) folded before Flop (didn't bet)
Seat 6: BernardoDG (small blind) collected (3900)

PokerStars Hand #251209769569: Tournament #3769361908, $52.38+$2.62 USD Hold'em No Limit - Level XV (600/1200) - 2024/06/26 22:46:24 UTC [2024/06/26 18:46:24 ET]
Table '3769361908 4' 6-max Seat #6 is the button
Seat 1: somnamna555 (8634 in chips) 
Seat 2: Biguethi339 (7000 in chips) 
Seat 3: gwallgofddyn (16776 in chips) 
Seat 4: hed777 (10000 in chips) 
Seat 5: Everbrun11 (74825 in chips) 
Seat 6: BernardoDG (19551 in chips) 
somnamna555: posts the ante 300
Biguethi339: posts the ante 300
gwallgofddyn: posts the ante 300
hed777: posts the ante 300
Everbrun11: posts the ante 300
BernardoDG: posts the ante 300
somnamna555: posts small blind 600
Biguethi339: posts big blind 1200
*** HOLE CARDS ***
gwallgofddyn: folds 
hed777: folds 
Everbrun11: folds 
BernardoDG: raises 18051 to 19251 and is all-in
somnamna555: folds 
Biguethi339: calls 5500 and is all-in
Uncalled bet (12551) returned to BernardoDG
*** FLOP *** [Qd 3d Qh]
*** TURN *** [Qd 3d Qh] [Kc]
*** RIVER *** [Qd 3d Qh Kc] [2s]
*** SHOW DOWN ***
Biguethi339: shows [Kh 9s] (two pair, Kings and Queens)
BernardoDG: shows [8h 8s] (two pair, Queens and Eights)
Biguethi339 collected 15800 from pot
*** SUMMARY ***
Total pot 15800 | Rake 0 
Board [Qd 3d Qh Kc 2s]
Seat 1: somnamna555 (small blind) folded before Flop
Seat 2: Biguethi339 (big blind) showed [Kh 9s] and won (15800) with two pair, Kings and Queens
Seat 3: gwallgofddyn folded before Flop (didn't bet)
Seat 4: hed777 folded before Flop (didn't bet)
Seat 5: Everbrun11 folded before Flop (didn't bet)
Seat 6: BernardoDG (button) showed [8h 8s] and lost with two pair, Queens and Eights

PokerStars Hand #251209776500: Tournament #3769361908, $52.38+$2.62 USD Hold'em No Limit - Level XV (600/1200) - 2024/06/26 22:46:52 UTC [2024/06/26 18:46:52 ET]
Table '3769361908 4' 6-max Seat #1 is the button
Seat 1: somnamna555 (7734 in chips) 
Seat 2: Biguethi339 (15800 in chips) 
Seat 3: gwallgofddyn (16476 in chips) 
Seat 4: hed777 (9700 in chips) 
Seat 5: Everbrun11 (74525 in chips) 
Seat 6: BernardoDG (12551 in chips) 
somnamna555: posts the ante 300
Biguethi339: posts the ante 300
gwallgofddyn: posts the ante 300
hed777: posts the ante 300
Everbrun11: posts the ante 300
BernardoDG: posts the ante 300
Biguethi339: posts small blind 600
gwallgofddyn: posts big blind 1200
*** HOLE CARDS ***
hed777: folds 
Everbrun11: folds 
BernardoDG: raises 11051 to 12251 and is all-in
somnamna555: folds 
Biguethi339: folds 
gwallgofddyn: folds 
Uncalled bet (11051) returned to BernardoDG
BernardoDG collected 4800 from pot
BernardoDG: doesn't show hand 
*** SUMMARY ***
Total pot 4800 | Rake 0 
Seat 1: somnamna555 (button) folded before Flop (didn't bet)
Seat 2: Biguethi339 (small blind) folded before Flop
Seat 3: gwallgofddyn (big blind) folded before Flop
Seat 4: hed777 folded before Flop (didn't bet)
Seat 5: Everbrun11 folded before Flop (didn't bet)
Seat 6: BernardoDG collected (4800)

PokerStars Hand #251209782529: Tournament #3769361908, $52.38+$2.62 USD Hold'em No Limit - Level XVI (800/1600) - 2024/06/26 22:47:15 UTC [2024/06/26 18:47:15 ET]
Table '3769361908 4' 6-max Seat #2 is the button
Seat 1: somnamna555 (7434 in chips) 
Seat 2: Biguethi339 (14900 in chips) 
Seat 3: gwallgofddyn (14976 in chips) 
Seat 4: hed777 (9400 in chips) 
Seat 5: Everbrun11 (74225 in chips) 
Seat 6: BernardoDG (15851 in chips) 
somnamna555: posts the ante 400
Biguethi339: posts the ante 400
gwallgofddyn: posts the ante 400
hed777: posts the ante 400
Everbrun11: posts the ante 400
BernardoDG: posts the ante 400
gwallgofddyn: posts small blind 800
hed777: posts big blind 1600
*** HOLE CARDS ***
Everbrun11: raises 1600 to 3200
BernardoDG: raises 12251 to 15451 and is all-in
somnamna555: folds 
Biguethi339: folds 
gwallgofddyn: folds 
hed777: folds 
Everbrun11: calls 12251
*** FLOP *** [7c Ks 3c]
*** TURN *** [7c Ks 3c] [2h]
*** RIVER *** [7c Ks 3c 2h] [4s]
*** SHOW DOWN ***
Everbrun11: shows [Ad Ac] (a pair of Aces)
BernardoDG: shows [5c 5h] (a pair of Fives)
Everbrun11 collected 35702 from pot
BernardoDG finished the tournament
*** SUMMARY ***
Total pot 35702 | Rake 0 
Board [7c Ks 3c 2h 4s]
Seat 1: somnamna555 folded before Flop (didn't bet)
Seat 2: Biguethi339 (button) folded before Flop (didn't bet)
Seat 3: gwallgofddyn (small blind) folded before Flop
Seat 4: hed777 (big blind) folded before Flop
Seat 5: Everbrun11 showed [Ad Ac] and won (35702) with a pair of Aces
Seat 6: BernardoDG showed [5c 5h] and lost with a pair of Fives

PokerStars Hand #251209794896: Tournament #3769361908, $52.38+$2.62 USD Hold'em No Limit - Level XVI (800/1600) - 2024/06/26 22:48:04 UTC [2024/06/26 18:48:04 ET]
Table '3769361908 4' 6-max Seat #3 is the button
Seat 1: somnamna555 (7034 in chips) 
Seat 2: Biguethi339 (14500 in chips) 
Seat 3: gwallgofddyn (13776 in chips) 
Seat 4: hed777 (7400 in chips) 
Seat 5: Everbrun11 (94076 in chips) 
somnamna555: posts the ante 400
Biguethi339: posts the ante 400
gwallgofddyn: posts the ante 400
hed777: posts the ante 400
Everbrun11: posts the ante 400
hed777: posts small blind 800
Everbrun11: posts big blind 1600
*** HOLE CARDS ***
Berkowitz33 is disconnected 
somnamna555: raises 5034 to 6634 and is all-in
Biguethi339: folds 
gwallgofddyn: folds 
hed777: folds 
Everbrun11: calls 5034
*** FLOP *** [Qc 7c 2s]
*** TURN *** [Qc 7c 2s] [Jd]
*** RIVER *** [Qc 7c 2s Jd] [Td]
*** SHOW DOWN ***
Everbrun11: shows [6s 9h] (high card Queen)
somnamna555: shows [7h Ah] (a pair of Sevens)
somnamna555 collected 16068 from pot
*** SUMMARY ***
Total pot 16068 | Rake 0 
Board [Qc 7c 2s Jd Td]
Seat 1: somnamna555 showed [7h Ah] and won (16068) with a pair of Sevens
Seat 2: Biguethi339 folded before Flop (didn't bet)
Seat 3: gwallgofddyn (button) folded before Flop (didn't bet)
Seat 4: hed777 (small blind) folded before Flop
Seat 5: Everbrun11 (big blind) showed [6s 9h] and lost with high card Queen

PokerStars Hand #251209803710: Tournament #3769361908, $52.38+$2.62 USD Hold'em No Limit - Level XVI (800/1600) - 2024/06/26 22:48:39 UTC [2024/06/26 18:48:39 ET]
Table '3769361908 4' 6-max Seat #4 is the button
Seat 1: somnamna555 (16068 in chips) 
Seat 2: Biguethi339 (14100 in chips) 
Seat 3: gwallgofddyn (13376 in chips) 
Seat 4: hed777 (6200 in chips) 
Seat 5: Everbrun11 (87042 in chips) 
Seat 6: Berkowitz33 (13666 in chips) 
somnamna555: posts the ante 400
Biguethi339: posts the ante 400
gwallgofddyn: posts the ante 400
hed777: posts the ante 400
Everbrun11: posts the ante 400
Berkowitz33: posts the ante 400
Everbrun11: posts small blind 800
Berkowitz33: posts big blind 1600
*** HOLE CARDS ***
somnamna555: raises 14068 to 15668 and is all-in
Biguethi339: folds 
gwallgofddyn: folds 
hed777: folds 
Everbrun11: folds 
Berkowitz33: folds 
Uncalled bet (14068) returned to somnamna555
somnamna555 collected 6400 from pot
somnamna555: doesn't show hand 
*** SUMMARY ***
Total pot 6400 | Rake 0 
Seat 1: somnamna555 collected (6400)
Seat 2: Biguethi339 folded before Flop (didn't bet)
Seat 3: gwallgofddyn folded before Flop (didn't bet)
Seat 4: hed777 (button) folded before Flop (didn't bet)
Seat 5: Everbrun11 (small blind) folded before Flop
Seat 6: Berkowitz33 (big blind) folded before Flop

PokerStars Hand #251209808170: Tournament #3769361908, $52.38+$2.62 USD Hold'em No Limit - Level XVI (800/1600) - 2024/06/26 22:48:56 UTC [2024/06/26 18:48:56 ET]
Table '3769361908 4' 6-max Seat #5 is the button
Seat 2: Biguethi339 (13700 in chips) 
Seat 3: gwallgofddyn (12976 in chips) 
Seat 4: hed777 (5800 in chips) 
Seat 5: Everbrun11 (85842 in chips) 
Seat 6: Berkowitz33 (11666 in chips) 
Biguethi339: posts the ante 400
gwallgofddyn: posts the ante 400
hed777: posts the ante 400
Everbrun11: posts the ante 400
Berkowitz33: posts the ante 400
Berkowitz33: posts small blind 800
Biguethi339: posts big blind 1600
*** HOLE CARDS ***
gwallgofddyn: folds 
hed777: raises 3800 to 5400 and is all-in
C0rpsbal is disconnected 
Everbrun11: folds 
Berkowitz33: folds 
Biguethi339: calls 3800
*** FLOP *** [Kc 4h 8c]
*** TURN *** [Kc 4h 8c] [9d]
*** RIVER *** [Kc 4h 8c 9d] [3s]
*** SHOW DOWN ***
Biguethi339: shows [Th 7d] (high card King)
hed777: shows [4d As] (a pair of Fours)
hed777 collected 13600 from pot
*** SUMMARY ***
Total pot 13600 | Rake 0 
Board [Kc 4h 8c 9d 3s]
Seat 2: Biguethi339 (big blind) showed [Th 7d] and lost with high card King
Seat 3: gwallgofddyn folded before Flop (didn't bet)
Seat 4: hed777 showed [4d As] and won (13600) with a pair of Fours
Seat 5: Everbrun11 (button) folded before Flop (didn't bet)
Seat 6: Berkowitz33 (small blind) folded before Flop

PokerStars Hand #251209818951: Tournament #3769361908, $52.38+$2.62 USD Hold'em No Limit - Level XVI (800/1600) - 2024/06/26 22:49:40 UTC [2024/06/26 18:49:40 ET]
Table '3769361908 4' 6-max Seat #6 is the button
Seat 1: C0rpsbal (21826 in chips) out of hand (moved from another table into small blind)
Seat 2: Biguethi339 (7900 in chips) 
Seat 3: gwallgofddyn (12576 in chips) 
Seat 4: hed777 (13600 in chips) 
Seat 5: Everbrun11 (85442 in chips) 
Seat 6: Berkowitz33 (10466 in chips) 
C0rpsbal will be allowed to play after the button
Biguethi339: posts the ante 400
gwallgofddyn: posts the ante 400
hed777: posts the ante 400
Everbrun11: posts the ante 400
Berkowitz33: posts the ante 400
Biguethi339: posts small blind 800
gwallgofddyn: posts big blind 1600
*** HOLE CARDS ***
hed777: folds 
Everbrun11: folds 
Berkowitz33: folds 
Biguethi339: folds 
Uncalled bet (800) returned to gwallgofddyn
gwallgofddyn collected 3600 from pot
gwallgofddyn: doesn't show hand 
*** SUMMARY ***
Total pot 3600 | Rake 0 
Seat 2: Biguethi339 (small blind) folded before Flop
Seat 3: gwallgofddyn (big blind) collected (3600)
Seat 4: hed777 folded before Flop (didn't bet)
Seat 5: Everbrun11 folded before Flop (didn't bet)
Seat 6: Berkowitz33 (button) folded before Flop (didn't bet)

PokerStars Hand #251209821256: Tournament #3769361908, $52.38+$2.62 USD Hold'em No Limit - Level XVI (800/1600) - 2024/06/26 22:49:49 UTC [2024/06/26 18:49:49 ET]
Table '3769361908 4' 6-max Seat #2 is the button
Seat 1: C0rpsbal (21826 in chips) 
Seat 2: Biguethi339 (6700 in chips) 
Seat 3: gwallgofddyn (14976 in chips) 
Seat 4: hed777 (13200 in chips) 
Seat 5: Everbrun11 (85042 in chips) 
Seat 6: Berkowitz33 (10066 in chips) 
C0rpsbal: posts the ante 400
Biguethi339: posts the ante 400
gwallgofddyn: posts the ante 400
hed777: posts the ante 400
Everbrun11: posts the ante 400
Berkowitz33: posts the ante 400
gwallgofddyn: posts small blind 800
hed777: posts big blind 1600
*** HOLE CARDS ***
Everbrun11: folds 
Berkowitz33: raises 8066 to 9666 and is all-in
C0rpsbal: folds 
Biguethi339: calls 6300 and is all-in
gwallgofddyn: folds 
hed777: folds 
Uncalled bet (3366) returned to Berkowitz33
*** FLOP *** [6c 7c 9s]
*** TURN *** [6c 7c 9s] [Qs]
*** RIVER *** [6c 7c 9s Qs] [Jc]
*** SHOW DOWN ***
Berkowitz33: shows [Qd Ad] (a pair of Queens)
Biguethi339: shows [Qh Jh] (two pair, Queens and Jacks)
Biguethi339 collected 17400 from pot
*** SUMMARY ***
Total pot 17400 | Rake 0 
Board [6c 7c 9s Qs Jc]
Seat 1: C0rpsbal folded before Flop (didn't bet)
Seat 2: Biguethi339 (button) showed [Qh Jh] and won (17400) with two pair, Queens and Jacks
Seat 3: gwallgofddyn (small blind) folded before Flop
Seat 4: hed777 (big blind) folded before Flop
Seat 5: Everbrun11 folded before Flop (didn't bet)
Seat 6: Berkowitz33 showed [Qd Ad] and lost with a pair of Queens

PokerStars Hand #251209834253: Tournament #3769361908, $52.38+$2.62 USD Hold'em No Limit - Level XVII (1000/2000) - 2024/06/26 22:50:42 UTC [2024/06/26 18:50:42 ET]
Table '3769361908 4' 6-max Seat #3 is the button
Seat 1: C0rpsbal (21426 in chips) 
Seat 2: Biguethi339 (17400 in chips) 
Seat 3: gwallgofddyn (13776 in chips) 
Seat 4: hed777 (11200 in chips) 
Seat 5: Everbrun11 (84642 in chips) 
Seat 6: Berkowitz33 (3366 in chips) 
C0rpsbal: posts the ante 500
Biguethi339: posts the ante 500
gwallgofddyn: posts the ante 500
hed777: posts the ante 500
Everbrun11: posts the ante 500
Berkowitz33: posts the ante 500
hed777: posts small blind 1000
Everbrun11: posts big blind 2000
*** HOLE CARDS ***
Berkowitz33: folds 
C0rpsbal: folds 
Biguethi339: folds 
gwallgofddyn: folds 
hed777: raises 8700 to 10700 and is all-in
Everbrun11: calls 8700
*** FLOP *** [9c 4h Qs]
*** TURN *** [9c 4h Qs] [As]
*** RIVER *** [9c 4h Qs As] [Ac]
*** SHOW DOWN ***
hed777: shows [Jc Ks] (a pair of Aces)
Everbrun11: shows [Th Qc] (two pair, Aces and Queens)
Everbrun11 collected 24400 from pot
hed777 finished the tournament in 105th place
*** SUMMARY ***
Total pot 24400 | Rake 0 
Board [9c 4h Qs As Ac]
Seat 1: C0rpsbal folded before Flop (didn't bet)
Seat 2: Biguethi339 folded before Flop (didn't bet)
Seat 3: gwallgofddyn (button) folded before Flop (didn't bet)
Seat 4: hed777 (small blind) showed [Jc Ks] and lost with a pair of Aces
Seat 5: Everbrun11 (big blind) showed [Th Qc] and won (24400) with two pair, Aces and Queens
Seat 6: Berkowitz33 folded before Flop (didn't bet)

PokerStars Hand #251209841343: Tournament #3769361908, $52.38+$2.62 USD Hold'em No Limit - Level XVII (1000/2000) - 2024/06/26 22:51:12 UTC [2024/06/26 18:51:12 ET]
Table '3769361908 4' 6-max Seat #5 is the button
Seat 1: C0rpsbal (20926 in chips) 
Seat 2: Biguethi339 (16900 in chips) 
Seat 3: gwallgofddyn (13276 in chips) 
Seat 5: Everbrun11 (97842 in chips) 
Seat 6: Berkowitz33 (2866 in chips) 
C0rpsbal: posts the ante 500
Biguethi339: posts the ante 500
gwallgofddyn: posts the ante 500
Everbrun11: posts the ante 500
Berkowitz33: posts the ante 500
Berkowitz33: posts small blind 1000
C0rpsbal: posts big blind 2000
*** HOLE CARDS ***
Biguethi339: folds 
gwallgofddyn: folds 
Everbrun11: folds 
DR. ELDAR is disconnected 
Berkowitz33: raises 366 to 2366 and is all-in
C0rpsbal: calls 366
*** FLOP *** [Qh 9h 4s]
*** TURN *** [Qh 9h 4s] [Ts]
*** RIVER *** [Qh 9h 4s Ts] [Qs]
*** SHOW DOWN ***
Berkowitz33: shows [3s 5d] (a pair of Queens)
C0rpsbal: shows [Qd Jh] (three of a kind, Queens)
C0rpsbal collected 7232 from pot
Berkowitz33 finished the tournament in 102nd place
*** SUMMARY ***
Total pot 7232 | Rake 0 
Board [Qh 9h 4s Ts Qs]
Seat 1: C0rpsbal (big blind) showed [Qd Jh] and won (7232) with three of a kind, Queens
Seat 2: Biguethi339 folded before Flop (didn't bet)
Seat 3: gwallgofddyn folded before Flop (didn't bet)
Seat 5: Everbrun11 (button) folded before Flop (didn't bet)
Seat 6: Berkowitz33 (small blind) showed [3s 5d] and lost with a pair of Queens

PokerStars Hand #251209847215: Tournament #3769361908, $52.38+$2.62 USD Hold'em No Limit - Level XVII (1000/2000) - 2024/06/26 22:51:36 UTC [2024/06/26 18:51:36 ET]
Table '3769361908 4' 6-max Seat #1 is the button
Seat 1: C0rpsbal (25292 in chips) 
Seat 2: Biguethi339 (16400 in chips) 
Seat 3: gwallgofddyn (12776 in chips) 
Seat 4: DR. ELDAR (33745 in chips) 
Seat 5: Everbrun11 (97342 in chips) 
C0rpsbal: posts the ante 500
Biguethi339: posts the ante 500
gwallgofddyn: posts the ante 500
DR. ELDAR: posts the ante 500
Everbrun11: posts the ante 500
Biguethi339: posts small blind 1000
gwallgofddyn: posts big blind 2000
*** HOLE CARDS ***
DR. ELDAR: folds 
Everbrun11: folds 
C0rpsbal: folds 
Biguethi339: raises 13900 to 15900 and is all-in
gwallgofddyn: folds 
Uncalled bet (13900) returned to Biguethi339
Biguethi339 collected 6500 from pot
Biguethi339: doesn't show hand 
*** SUMMARY ***
Total pot 6500 | Rake 0 
Seat 1: C0rpsbal (button) folded before Flop (didn't bet)
Seat 2: Biguethi339 (small blind) collected (6500)
Seat 3: gwallgofddyn (big blind) folded before Flop
Seat 4: DR. ELDAR folded before Flop (didn't bet)
Seat 5: Everbrun11 folded before Flop (didn't bet)

PokerStars Hand #251209851160: Tournament #3769361908, $52.38+$2.62 USD Hold'em No Limit - Level XVII (1000/2000) - 2024/06/26 22:51:52 UTC [2024/06/26 18:51:52 ET]
Table '3769361908 4' 6-max Seat #2 is the button
Seat 1: C0rpsbal (24792 in chips) 
Seat 2: Biguethi339 (20400 in chips) 
Seat 3: gwallgofddyn (10276 in chips) 
Seat 4: DR. ELDAR (33245 in chips) 
Seat 5: Everbrun11 (96842 in chips) 
C0rpsbal: posts the ante 500
Biguethi339: posts the ante 500
gwallgofddyn: posts the ante 500
DR. ELDAR: posts the ante 500
Everbrun11: posts the ante 500
gwallgofddyn: posts small blind 1000
DR. ELDAR: posts big blind 2000
*** HOLE CARDS ***
Everbrun11: folds 
C0rpsbal: raises 2000 to 4000
viniperri is disconnected 
Biguethi339: folds 
gwallgofddyn: raises 5776 to 9776 and is all-in
DR. ELDAR: folds 
C0rpsbal: calls 5776
*** FLOP *** [Jd 2h Ks]
*** TURN *** [Jd 2h Ks] [5d]
*** RIVER *** [Jd 2h Ks 5d] [5s]
*** SHOW DOWN ***
gwallgofddyn: shows [3d Ac] (a pair of Fives)
C0rpsbal: shows [4c Kc] (two pair, Kings and Fives)
C0rpsbal collected 24052 from pot
gwallgofddyn finished the tournament in 94th place
*** SUMMARY ***
Total pot 24052 | Rake 0 
Board [Jd 2h Ks 5d 5s]
Seat 1: C0rpsbal showed [4c Kc] and won (24052) with two pair, Kings and Fives
Seat 2: Biguethi339 (button) folded before Flop (didn't bet)
Seat 3: gwallgofddyn (small blind) showed [3d Ac] and lost with a pair of Fives
Seat 4: DR. ELDAR (big blind) folded before Flop
Seat 5: Everbrun11 folded before Flop (didn't bet)

PokerStars Hand #251209860579: Tournament #3769361908, $52.38+$2.62 USD Hold'em No Limit - Level XVII (1000/2000) - 2024/06/26 22:52:30 UTC [2024/06/26 18:52:30 ET]
Table '3769361908 4' 6-max Seat #4 is the button
Seat 1: C0rpsbal (38568 in chips) 
Seat 2: Biguethi339 (19900 in chips) 
Seat 4: DR. ELDAR (30745 in chips) 
Seat 5: Everbrun11 (96342 in chips) 
Seat 6: viniperri (81901 in chips) 
C0rpsbal: posts the ante 500
Biguethi339: posts the ante 500
DR. ELDAR: posts the ante 500
Everbrun11: posts the ante 500
viniperri: posts the ante 500
Everbrun11: posts small blind 1000
viniperri: posts big blind 2000
*** HOLE CARDS ***
C0rpsbal: folds 
Biguethi339: raises 17400 to 19400 and is all-in
DR. ELDAR: folds 
Everbrun11: folds 
viniperri: folds 
Uncalled bet (17400) returned to Biguethi339
Biguethi339 collected 7500 from pot
Biguethi339: doesn't show hand 
*** SUMMARY ***
Total pot 7500 | Rake 0 
Seat 1: C0rpsbal folded before Flop (didn't bet)
Seat 2: Biguethi339 collected (7500)
Seat 4: DR. ELDAR (button) folded before Flop (didn't bet)
Seat 5: Everbrun11 (small blind) folded before Flop
Seat 6: viniperri (big blind) folded before Flop

PokerStars Hand #251209865684: Tournament #3769361908, $52.38+$2.62 USD Hold'em No Limit - Level XVII (1000/2000) - 2024/06/26 22:52:51 UTC [2024/06/26 18:52:51 ET]
Table '3769361908 4' 6-max Seat #5 is the button
Seat 1: C0rpsbal (38068 in chips) 
Seat 2: Biguethi339 (24900 in chips) 
Seat 3: jerdno0 (19434 in chips) 
Seat 4: DR. ELDAR (30245 in chips) 
Seat 5: Everbrun11 (94842 in chips) 
Seat 6: viniperri (79401 in chips) 
C0rpsbal: posts the ante 500
Biguethi339: posts the ante 500
jerdno0: posts the ante 500
DR. ELDAR: posts the ante 500
Everbrun11: posts the ante 500
viniperri: posts the ante 500
viniperri: posts small blind 1000
C0rpsbal: posts big blind 2000
*** HOLE CARDS ***
Biguethi339: raises 2000 to 4000
jerdno0: folds 
DR. ELDAR: folds 
Everbrun11: folds 
viniperri: folds 
C0rpsbal: calls 2000
*** FLOP *** [Jh Jd 9s]
C0rpsbal: checks 
Biguethi339: bets 2000
C0rpsbal: calls 2000
*** TURN *** [Jh Jd 9s] [Jc]
C0rpsbal: checks 
Biguethi339: bets 3200
C0rpsbal: raises 22400 to 25600
Biguethi339: folds 
Uncalled bet (22400) returned to C0rpsbal
C0rpsbal collected 22400 from pot
C0rpsbal: doesn't show hand 
*** SUMMARY ***
Total pot 22400 | Rake 0 
Board [Jh Jd 9s Jc]
Seat 1: C0rpsbal (big blind) collected (22400)
Seat 2: Biguethi339 folded on the Turn
Seat 3: jerdno0 folded before Flop (didn't bet)
Seat 4: DR. ELDAR folded before Flop (didn't bet)
Seat 5: Everbrun11 (button) folded before Flop (didn't bet)
Seat 6: viniperri (small blind) folded before Flop

PokerStars Hand #251209881021: Tournament #3769361908, $52.38+$2.62 USD Hold'em No Limit - Level XVIII (1200/2400) - 2024/06/26 22:53:54 UTC [2024/06/26 18:53:54 ET]
Table '3769361908 4' 6-max Seat #6 is the button
Seat 1: C0rpsbal (50768 in chips) 
Seat 2: Biguethi339 (15200 in chips) 
Seat 3: jerdno0 (18934 in chips) 
Seat 4: DR. ELDAR (29745 in chips) 
Seat 5: Everbrun11 (94342 in chips) 
Seat 6: viniperri (77901 in chips) 
C0rpsbal: posts the ante 600
Biguethi339: posts the ante 600
jerdno0: posts the ante 600
DR. ELDAR: posts the ante 600
Everbrun11: posts the ante 600
viniperri: posts the ante 600
C0rpsbal: posts small blind 1200
Biguethi339: posts big blind 2400
*** HOLE CARDS ***
jerdno0: folds 
DR. ELDAR: raises 2640 to 5040
Everbrun11: folds 
viniperri: folds 
C0rpsbal: folds 
Biguethi339: folds 
Uncalled bet (2640) returned to DR. ELDAR
DR. ELDAR collected 9600 from pot
DR. ELDAR: doesn't show hand 
*** SUMMARY ***
Total pot 9600 | Rake 0 
Seat 1: C0rpsbal (small blind) folded before Flop
Seat 2: Biguethi339 (big blind) folded before Flop
Seat 3: jerdno0 folded before Flop (didn't bet)
Seat 4: DR. ELDAR collected (9600)
Seat 5: Everbrun11 folded before Flop (didn't bet)
Seat 6: viniperri (button) folded before Flop (didn't bet)

PokerStars Hand #251209888262: Tournament #3769361908, $52.38+$2.62 USD Hold'em No Limit - Level XVIII (1200/2400) - 2024/06/26 22:54:24 UTC [2024/06/26 18:54:24 ET]
Table '3769361908 4' 6-max Seat #1 is the button
Seat 1: C0rpsbal (48968 in chips) 
Seat 2: Biguethi339 (12200 in chips) 
Seat 3: jerdno0 (18334 in chips) 
Seat 5: Everbrun11 (93742 in chips) 
Seat 6: viniperri (77301 in chips) 
C0rpsbal: posts the ante 600
Biguethi339: posts the ante 600
jerdno0: posts the ante 600
Everbrun11: posts the ante 600
viniperri: posts the ante 600
Biguethi339: posts small blind 1200
jerdno0: posts big blind 2400
*** HOLE CARDS ***
Everbrun11: raises 3600 to 6000
viniperri: folds 
C0rpsbal: folds 
Biguethi339: folds 
jerdno0: folds 
Uncalled bet (3600) returned to Everbrun11
Everbrun11 collected 9000 from pot
Everbrun11: doesn't show hand 
*** SUMMARY ***
Total pot 9000 | Rake 0 
Seat 1: C0rpsbal (button) folded before Flop (didn't bet)
Seat 2: Biguethi339 (small blind) folded before Flop
Seat 3: jerdno0 (big blind) folded before Flop
Seat 5: Everbrun11 collected (9000)
Seat 6: viniperri folded before Flop (didn't bet)

PokerStars Hand #251209894287: Tournament #3769361908, $52.38+$2.62 USD Hold'em No Limit - Level XVIII (1200/2400) - 2024/06/26 22:54:49 UTC [2024/06/26 18:54:49 ET]
Table '3769361908 4' 6-max Seat #2 is the button
Seat 1: C0rpsbal (48368 in chips) 
Seat 2: Biguethi339 (10400 in chips) 
Seat 3: jerdno0 (15334 in chips) 
Seat 5: Everbrun11 (99742 in chips) 
Seat 6: viniperri (76701 in chips) 
C0rpsbal: posts the ante 600
Biguethi339: posts the ante 600
jerdno0: posts the ante 600
Everbrun11: posts the ante 600
viniperri: posts the ante 600
jerdno0: posts small blind 1200
Everbrun11: posts big blind 2400
*** HOLE CARDS ***
viniperri: folds 
C0rpsbal: folds 
Biguethi339: folds 
jerdno0: raises 4800 to 7200
Lecher1991 is disconnected 
Everbrun11: raises 9600 to 16800
jerdno0: calls 7534 and is all-in
Uncalled bet (2066) returned to Everbrun11
*** FLOP *** [9s Ks Qh]
*** TURN *** [9s Ks Qh] [9h]
*** RIVER *** [9s Ks Qh 9h] [4d]
*** SHOW DOWN ***
jerdno0: shows [As Ac] (two pair, Aces and Nines)
Everbrun11: shows [Ad Th] (a pair of Nines)
jerdno0 collected 32468 from pot
*** SUMMARY ***
Total pot 32468 | Rake 0 
Board [9s Ks Qh 9h 4d]
Seat 1: C0rpsbal folded before Flop (didn't bet)
Seat 2: Biguethi339 (button) folded before Flop (didn't bet)
Seat 3: jerdno0 (small blind) showed [As Ac] and won (32468) with two pair, Aces and Nines
Seat 5: Everbrun11 (big blind) showed [Ad Th] and lost with a pair of Nines
Seat 6: viniperri folded before Flop (didn't bet)

PokerStars Hand #251209964595: Tournament #3769361908, $52.38+$2.62 USD Hold'em No Limit - Level XVIII (1200/2400) - 2024/06/26 23:01:09 UTC [2024/06/26 19:01:09 ET]
Table '3769361908 4' 6-max Seat #3 is the button
Seat 1: C0rpsbal (47768 in chips) 
Seat 2: Biguethi339 (9800 in chips) 
Seat 3: jerdno0 (32468 in chips) 
Seat 4: Lecher1991 (61456 in chips) out of hand (moved from another table into small blind)
Seat 5: Everbrun11 (84408 in chips) 
Seat 6: viniperri (76101 in chips) 
Lecher1991 will be allowed to play after the button
C0rpsbal: posts the ante 600
Biguethi339: posts the ante 600
jerdno0: posts the ante 600
Everbrun11: posts the ante 600
viniperri: posts the ante 600
Everbrun11: posts small blind 1200
viniperri: posts big blind 2400
*** HOLE CARDS ***
C0rpsbal: folds 
Biguethi339: folds 
jerdno0: folds 
Everbrun11: calls 1200
viniperri: checks 
*** FLOP *** [Qs 2h Td]
Everbrun11: checks 
viniperri: checks 
*** TURN *** [Qs 2h Td] [Kc]
Everbrun11: bets 2400
viniperri: calls 2400
*** RIVER *** [Qs 2h Td Kc] [7s]
Everbrun11: bets 8400
viniperri: folds 
Uncalled bet (8400) returned to Everbrun11
Everbrun11 collected 12600 from pot
Everbrun11: doesn't show hand 
*** SUMMARY ***
Total pot 12600 | Rake 0 
Board [Qs 2h Td Kc 7s]
Seat 1: C0rpsbal folded before Flop (didn't bet)
Seat 2: Biguethi339 folded before Flop (didn't bet)
Seat 3: jerdno0 (button) folded before Flop (didn't bet)
Seat 5: Everbrun11 (small blind) collected (12600)
Seat 6: viniperri (big blind) folded on the River

PokerStars Hand #251209981054: Tournament #3769361908, $52.38+$2.62 USD Hold'em No Limit - Level XIX (1400/2800) - 2024/06/26 23:02:21 UTC [2024/06/26 19:02:21 ET]
Table '3769361908 4' 6-max Seat #5 is the button
Seat 1: C0rpsbal (47168 in chips) 
Seat 2: Biguethi339 (9200 in chips) 
Seat 3: jerdno0 (31868 in chips) 
Seat 4: Lecher1991 (61456 in chips) 
Seat 5: Everbrun11 (91608 in chips) 
Seat 6: viniperri (70701 in chips) 
C0rpsbal: posts the ante 700
Biguethi339: posts the ante 700
jerdno0: posts the ante 700
Lecher1991: posts the ante 700
Everbrun11: posts the ante 700
viniperri: posts the ante 700
viniperri: posts small blind 1400
C0rpsbal: posts big blind 2800
*** HOLE CARDS ***
Biguethi339: raises 5700 to 8500 and is all-in
jerdno0: calls 8500
Lecher1991: folds 
Everbrun11: folds 
viniperri: folds 
C0rpsbal: folds 
*** FLOP *** [Ad Jc Ts]
*** TURN *** [Ad Jc Ts] [8d]
*** RIVER *** [Ad Jc Ts 8d] [3d]
*** SHOW DOWN ***
Biguethi339: shows [Kc Td] (a pair of Tens)
jerdno0: shows [5h Ah] (a pair of Aces)
jerdno0 collected 25400 from pot
Biguethi339 finished the tournament in 70th place
*** SUMMARY ***
Total pot 25400 | Rake 0 
Board [Ad Jc Ts 8d 3d]
Seat 1: C0rpsbal (big blind) folded before Flop
Seat 2: Biguethi339 showed [Kc Td] and lost with a pair of Tens
Seat 3: jerdno0 showed [5h Ah] and won (25400) with a pair of Aces
Seat 4: Lecher1991 folded before Flop (didn't bet)
Seat 5: Everbrun11 (button) folded before Flop (didn't bet)
Seat 6: viniperri (small blind) folded before Flop

PokerStars Hand #251209989190: Tournament #3769361908, $52.38+$2.62 USD Hold'em No Limit - Level XIX (1400/2800) - 2024/06/26 23:02:56 UTC [2024/06/26 19:02:56 ET]
Table '3769361908 4' 6-max Seat #6 is the button
Seat 1: C0rpsbal (43668 in chips) 
Seat 3: jerdno0 (48068 in chips) 
Seat 4: Lecher1991 (60756 in chips) 
Seat 5: Everbrun11 (90908 in chips) 
Seat 6: viniperri (68601 in chips) 
C0rpsbal: posts the ante 700
jerdno0: posts the ante 700
Lecher1991: posts the ante 700
Everbrun11: posts the ante 700
viniperri: posts the ante 700
C0rpsbal: posts small blind 1400
jerdno0: posts big blind 2800
*** HOLE CARDS ***
Lecher1991: folds 
Everbrun11: folds 
viniperri: folds 
C0rpsbal: raises 40168 to 42968 and is all-in
jerdno0: folds 
Uncalled bet (40168) returned to C0rpsbal
C0rpsbal collected 9100 from pot
C0rpsbal: doesn't show hand 
*** SUMMARY ***
Total pot 9100 | Rake 0 
Seat 1: C0rpsbal (small blind) collected (9100)
Seat 3: jerdno0 (big blind) folded before Flop
Seat 4: Lecher1991 folded before Flop (didn't bet)
Seat 5: Everbrun11 folded before Flop (didn't bet)
Seat 6: viniperri (button) folded before Flop (didn't bet)

PokerStars Hand #251209997527: Tournament #3769361908, $52.38+$2.62 USD Hold'em No Limit - Level XIX (1400/2800) - 2024/06/26 23:03:32 UTC [2024/06/26 19:03:32 ET]
Table '3769361908 4' 6-max Seat #1 is the button
Seat 1: C0rpsbal (49268 in chips) 
Seat 3: jerdno0 (44568 in chips) 
Seat 4: Lecher1991 (60056 in chips) 
Seat 5: Everbrun11 (90208 in chips) 
Seat 6: viniperri (67901 in chips) 
C0rpsbal: posts the ante 700
jerdno0: posts the ante 700
Lecher1991: posts the ante 700
Everbrun11: posts the ante 700
viniperri: posts the ante 700
jerdno0: posts small blind 1400
Lecher1991: posts big blind 2800
*** HOLE CARDS ***
Everbrun11: folds 
viniperri: folds 
C0rpsbal: folds 
jerdno0: folds 
Uncalled bet (1400) returned to Lecher1991
Lecher1991 collected 6300 from pot
*** SUMMARY ***
Total pot 6300 | Rake 0 
Seat 1: C0rpsbal (button) folded before Flop (didn't bet)
Seat 3: jerdno0 (small blind) folded before Flop
Seat 4: Lecher1991 (big blind) collected (6300)
Seat 5: Everbrun11 folded before Flop (didn't bet)
Seat 6: viniperri folded before Flop (didn't bet)

PokerStars Hand #251210005825: Tournament #3769361908, $52.38+$2.62 USD Hold'em No Limit - Level XIX (1400/2800) - 2024/06/26 23:04:08 UTC [2024/06/26 19:04:08 ET]
Table '3769361908 4' 6-max Seat #3 is the button
Seat 1: C0rpsbal (48568 in chips) 
Seat 3: jerdno0 (42468 in chips) 
Seat 4: Lecher1991 (64256 in chips) 
Seat 5: Everbrun11 (89508 in chips) 
Seat 6: viniperri (67201 in chips) 
C0rpsbal: posts the ante 700
jerdno0: posts the ante 700
Lecher1991: posts the ante 700
Everbrun11: posts the ante 700
viniperri: posts the ante 700
Lecher1991: posts small blind 1400
Everbrun11: posts big blind 2800
*** HOLE CARDS ***
viniperri: folds 
C0rpsbal: folds 
jerdno0: folds 
Chuckster388 is disconnected 
Lecher1991: folds 
Uncalled bet (1400) returned to Everbrun11
Everbrun11 collected 6300 from pot
Everbrun11: doesn't show hand 
*** SUMMARY ***
Total pot 6300 | Rake 0 
Seat 1: C0rpsbal folded before Flop (didn't bet)
Seat 3: jerdno0 (button) folded before Flop (didn't bet)
Seat 4: Lecher1991 (small blind) folded before Flop
Seat 5: Everbrun11 (big blind) collected (6300)
Seat 6: viniperri folded before Flop (didn't bet)

PokerStars Hand #251210010407: Tournament #3769361908, $52.38+$2.62 USD Hold'em No Limit - Level XIX (1400/2800) - 2024/06/26 23:04:27 UTC [2024/06/26 19:04:27 ET]
Table '3769361908 4' 6-max Seat #4 is the button
Seat 1: C0rpsbal (47868 in chips) 
Seat 2: Chuckster388 (58880 in chips) 
Seat 3: jerdno0 (41768 in chips) 
Seat 4: Lecher1991 (62156 in chips) 
Seat 5: Everbrun11 (93708 in chips) 
Seat 6: viniperri (66501 in chips) 
C0rpsbal: posts the ante 700
Chuckster388: posts the ante 700
jerdno0: posts the ante 700
Lecher1991: posts the ante 700
Everbrun11: posts the ante 700
viniperri: posts the ante 700
Everbrun11: posts small blind 1400
viniperri: posts big blind 2800
*** HOLE CARDS ***
C0rpsbal: folds 
Chuckster388: folds 
jerdno0: folds 
Lecher1991: folds 
Everbrun11: calls 1400
viniperri: checks 
*** FLOP *** [4h Jh 3s]
Everbrun11: bets 2800
viniperri: calls 2800
*** TURN *** [4h Jh 3s] [4d]
Everbrun11: checks 
viniperri: bets 9800
Everbrun11: calls 9800
*** RIVER *** [4h Jh 3s 4d] [9d]
Everbrun11: checks 
viniperri: bets 42000
Everbrun11: folds 
Uncalled bet (42000) returned to viniperri
viniperri collected 35000 from pot
viniperri: doesn't show hand 
*** SUMMARY ***
Total pot 35000 | Rake 0 
Board [4h Jh 3s 4d 9d]
Seat 1: C0rpsbal folded before Flop (didn't bet)
Seat 2: Chuckster388 folded before Flop (didn't bet)
Seat 3: jerdno0 folded before Flop (didn't bet)
Seat 4: Lecher1991 (button) folded before Flop (didn't bet)
Seat 5: Everbrun11 (small blind) folded on the River
Seat 6: viniperri (big blind) collected (35000)

PokerStars Hand #251210037661: Tournament #3769361908, $52.38+$2.62 USD Hold'em No Limit - Level XX (1600/3200) - 2024/06/26 23:06:26 UTC [2024/06/26 19:06:26 ET]
Table '3769361908 4' 6-max Seat #5 is the button
Seat 1: C0rpsbal (47168 in chips) 
Seat 2: Chuckster388 (58180 in chips) 
Seat 3: jerdno0 (41068 in chips) 
Seat 4: Lecher1991 (61456 in chips) 
Seat 5: Everbrun11 (77608 in chips) 
Seat 6: viniperri (85401 in chips) 
C0rpsbal: posts the ante 800
Chuckster388: posts the ante 800
jerdno0: posts the ante 800
Lecher1991: posts the ante 800
Everbrun11: posts the ante 800
viniperri: posts the ante 800
viniperri: posts small blind 1600
C0rpsbal: posts big blind 3200
*** HOLE CARDS ***
Chuckster388: folds 
jerdno0: calls 3200
Lecher1991: folds 
Everbrun11: folds 
viniperri: calls 1600
C0rpsbal: checks 
*** FLOP *** [2s 7h 3h]
viniperri: checks 
C0rpsbal: checks 
jerdno0: bets 4000
viniperri: calls 4000
C0rpsbal: folds 
*** TURN *** [2s 7h 3h] [2d]
viniperri: checks 
jerdno0: bets 8000
viniperri: folds 
Uncalled bet (8000) returned to jerdno0
jerdno0 collected 22400 from pot
*** SUMMARY ***
Total pot 22400 | Rake 0 
Board [2s 7h 3h 2d]
Seat 1: C0rpsbal (big blind) folded on the Flop
Seat 2: Chuckster388 folded before Flop (didn't bet)
Seat 3: jerdno0 collected (22400)
Seat 4: Lecher1991 folded before Flop (didn't bet)
Seat 5: Everbrun11 (button) folded before Flop (didn't bet)
Seat 6: viniperri (small blind) folded on the Turn

PokerStars Hand #251210059333: Tournament #3769361908, $52.38+$2.62 USD Hold'em No Limit - Level XX (1600/3200) - 2024/06/26 23:08:01 UTC [2024/06/26 19:08:01 ET]
Table '3769361908 4' 6-max Seat #6 is the button
Seat 1: C0rpsbal (43168 in chips) 
Seat 2: Chuckster388 (57380 in chips) 
Seat 3: jerdno0 (55468 in chips) 
Seat 4: Lecher1991 (60656 in chips) 
Seat 5: Everbrun11 (76808 in chips) 
Seat 6: viniperri (77401 in chips) 
C0rpsbal: posts the ante 800
Chuckster388: posts the ante 800
jerdno0: posts the ante 800
Lecher1991: posts the ante 800
Everbrun11: posts the ante 800
viniperri: posts the ante 800
C0rpsbal: posts small blind 1600
Chuckster388: posts big blind 3200
*** HOLE CARDS ***
jerdno0: folds 
Lecher1991: folds 
Everbrun11: folds 
viniperri: raises 3200 to 6400
C0rpsbal: folds 
Chuckster388: folds 
Uncalled bet (3200) returned to viniperri
viniperri collected 12800 from pot
viniperri: doesn't show hand 
*** SUMMARY ***
Total pot 12800 | Rake 0 
Seat 1: C0rpsbal (small blind) folded before Flop
Seat 2: Chuckster388 (big blind) folded before Flop
Seat 3: jerdno0 folded before Flop (didn't bet)
Seat 4: Lecher1991 folded before Flop (didn't bet)
Seat 5: Everbrun11 folded before Flop (didn't bet)
Seat 6: viniperri (button) collected (12800)

PokerStars Hand #251210065769: Tournament #3769361908, $52.38+$2.62 USD Hold'em No Limit - Level XXI (1800/3600) - 2024/06/26 23:08:30 UTC [2024/06/26 19:08:30 ET]
Table '3769361908 4' 6-max Seat #1 is the button
Seat 1: C0rpsbal (40768 in chips) 
Seat 2: Chuckster388 (53380 in chips) 
Seat 3: jerdno0 (54668 in chips) 
Seat 4: Lecher1991 (59856 in chips) 
Seat 5: Everbrun11 (76008 in chips) 
Seat 6: viniperri (86201 in chips) 
C0rpsbal: posts the ante 900
Chuckster388: posts the ante 900
jerdno0: posts the ante 900
Lecher1991: posts the ante 900
Everbrun11: posts the ante 900
viniperri: posts the ante 900
Chuckster388: posts small blind 1800
jerdno0: posts big blind 3600
*** HOLE CARDS ***
Lecher1991: folds 
Everbrun11: folds 
viniperri: folds 
C0rpsbal: folds 
Chuckster388: folds 
Uncalled bet (1800) returned to jerdno0
jerdno0 collected 9000 from pot
*** SUMMARY ***
Total pot 9000 | Rake 0 
Seat 1: C0rpsbal (button) folded before Flop (didn't bet)
Seat 2: Chuckster388 (small blind) folded before Flop
Seat 3: jerdno0 (big blind) collected (9000)
Seat 4: Lecher1991 folded before Flop (didn't bet)
Seat 5: Everbrun11 folded before Flop (didn't bet)
Seat 6: viniperri folded before Flop (didn't bet)

PokerStars Hand #251210070463: Tournament #3769361908, $52.38+$2.62 USD Hold'em No Limit - Level XXI (1800/3600) - 2024/06/26 23:08:52 UTC [2024/06/26 19:08:52 ET]
Table '3769361908 4' 6-max Seat #2 is the button
Seat 1: C0rpsbal (39868 in chips) 
Seat 2: Chuckster388 (50680 in chips) 
Seat 3: jerdno0 (60968 in chips) 
Seat 4: Lecher1991 (58956 in chips) 
Seat 5: Everbrun11 (75108 in chips) 
Seat 6: viniperri (85301 in chips) 
C0rpsbal: posts the ante 900
Chuckster388: posts the ante 900
jerdno0: posts the ante 900
Lecher1991: posts the ante 900
Everbrun11: posts the ante 900
viniperri: posts the ante 900
jerdno0: posts small blind 1800
Lecher1991: posts big blind 3600
*** HOLE CARDS ***
Everbrun11: folds 
viniperri: raises 3600 to 7200
C0rpsbal: folds 
Chuckster388: folds 
jerdno0: folds 
Lecher1991: folds 
Uncalled bet (3600) returned to viniperri
viniperri collected 14400 from pot
viniperri: doesn't show hand 
*** SUMMARY ***
Total pot 14400 | Rake 0 
Seat 1: C0rpsbal folded before Flop (didn't bet)
Seat 2: Chuckster388 (button) folded before Flop (didn't bet)
Seat 3: jerdno0 (small blind) folded before Flop
Seat 4: Lecher1991 (big blind) folded before Flop
Seat 5: Everbrun11 folded before Flop (didn't bet)
Seat 6: viniperri collected (14400)

PokerStars Hand #251210077169: Tournament #3769361908, $52.38+$2.62 USD Hold'em No Limit - Level XXI (1800/3600) - 2024/06/26 23:09:22 UTC [2024/06/26 19:09:22 ET]
Table '3769361908 4' 6-max Seat #3 is the button
Seat 1: C0rpsbal (38968 in chips) 
Seat 2: Chuckster388 (49780 in chips) 
Seat 3: jerdno0 (58268 in chips) 
Seat 4: Lecher1991 (54456 in chips) 
Seat 5: Everbrun11 (74208 in chips) 
Seat 6: viniperri (95201 in chips) 
C0rpsbal: posts the ante 900
Chuckster388: posts the ante 900
jerdno0: posts the ante 900
Lecher1991: posts the ante 900
Everbrun11: posts the ante 900
viniperri: posts the ante 900
Lecher1991: posts small blind 1800
Everbrun11: posts big blind 3600
*** HOLE CARDS ***
viniperri: folds 
C0rpsbal: folds 
Chuckster388: folds 
jerdno0: calls 3600
Lecher1991: calls 1800
Everbrun11: checks 
*** FLOP *** [2h 6d 3c]
Lecher1991: checks 
Everbrun11: bets 5346
jerdno0: folds 
Lecher1991: folds 
Uncalled bet (5346) returned to Everbrun11
Everbrun11 collected 16200 from pot
Everbrun11: doesn't show hand 
*** SUMMARY ***
Total pot 16200 | Rake 0 
Board [2h 6d 3c]
Seat 1: C0rpsbal folded before Flop (didn't bet)
Seat 2: Chuckster388 folded before Flop (didn't bet)
Seat 3: jerdno0 (button) folded on the Flop
Seat 4: Lecher1991 (small blind) folded on the Flop
Seat 5: Everbrun11 (big blind) collected (16200)
Seat 6: viniperri folded before Flop (didn't bet)

PokerStars Hand #251210090872: Tournament #3769361908, $52.38+$2.62 USD Hold'em No Limit - Level XXI (1800/3600) - 2024/06/26 23:10:24 UTC [2024/06/26 19:10:24 ET]
Table '3769361908 4' 6-max Seat #4 is the button
Seat 1: C0rpsbal (38068 in chips) 
Seat 2: Chuckster388 (48880 in chips) 
Seat 3: jerdno0 (53768 in chips) 
Seat 4: Lecher1991 (49956 in chips) 
Seat 5: Everbrun11 (85908 in chips) 
Seat 6: viniperri (94301 in chips) 
C0rpsbal: posts the ante 900
Chuckster388: posts the ante 900
jerdno0: posts the ante 900
Lecher1991: posts the ante 900
Everbrun11: posts the ante 900
viniperri: posts the ante 900
Everbrun11: posts small blind 1800
viniperri: posts big blind 3600
*** HOLE CARDS ***
C0rpsbal: folds 
Chuckster388: folds 
jerdno0: calls 3600
Lecher1991: folds 
Everbrun11: calls 1800
viniperri: checks 
*** FLOP *** [Qs 2h 6s]
Everbrun11: checks 
viniperri: checks 
jerdno0: bets 8100
Everbrun11: folds 
viniperri: folds 
Uncalled bet (8100) returned to jerdno0
jerdno0 collected 16200 from pot
*** SUMMARY ***
Total pot 16200 | Rake 0 
Board [Qs 2h 6s]
Seat 1: C0rpsbal folded before Flop (didn't bet)
Seat 2: Chuckster388 folded before Flop (didn't bet)
Seat 3: jerdno0 collected (16200)
Seat 4: Lecher1991 (button) folded before Flop (didn't bet)
Seat 5: Everbrun11 (small blind) folded on the Flop
Seat 6: viniperri (big blind) folded on the Flop

PokerStars Hand #251210105836: Tournament #3769361908, $52.38+$2.62 USD Hold'em No Limit - Level XXII (2000/4000) - 2024/06/26 23:11:32 UTC [2024/06/26 19:11:32 ET]
Table '3769361908 4' 6-max Seat #5 is the button
Seat 1: C0rpsbal (37168 in chips) 
Seat 2: Chuckster388 (47980 in chips) 
Seat 3: jerdno0 (65468 in chips) 
Seat 4: Lecher1991 (49056 in chips) 
Seat 5: Everbrun11 (81408 in chips) 
Seat 6: viniperri (89801 in chips) 
C0rpsbal: posts the ante 1000
Chuckster388: posts the ante 1000
jerdno0: posts the ante 1000
Lecher1991: posts the ante 1000
Everbrun11: posts the ante 1000
viniperri: posts the ante 1000
viniperri: posts small blind 2000
C0rpsbal: posts big blind 4000
*** HOLE CARDS ***
Chuckster388: folds 
jerdno0: folds 
Lecher1991: folds 
Everbrun11: folds 
viniperri: raises 84801 to 88801 and is all-in
C0rpsbal: folds 
Uncalled bet (84801) returned to viniperri
viniperri collected 14000 from pot
viniperri: doesn't show hand 
*** SUMMARY ***
Total pot 14000 | Rake 0 
Seat 1: C0rpsbal (big blind) folded before Flop
Seat 2: Chuckster388 folded before Flop (didn't bet)
Seat 3: jerdno0 folded before Flop (didn't bet)
Seat 4: Lecher1991 folded before Flop (didn't bet)
Seat 5: Everbrun11 (button) folded before Flop (didn't bet)
Seat 6: viniperri (small blind) collected (14000)

PokerStars Hand #251210113056: Tournament #3769361908, $52.38+$2.62 USD Hold'em No Limit - Level XXII (2000/4000) - 2024/06/26 23:12:06 UTC [2024/06/26 19:12:06 ET]
Table '3769361908 4' 6-max Seat #6 is the button
Seat 1: C0rpsbal (32168 in chips) 
Seat 2: Chuckster388 (46980 in chips) 
Seat 3: jerdno0 (64468 in chips) 
Seat 4: Lecher1991 (48056 in chips) 
Seat 5: Everbrun11 (80408 in chips) 
Seat 6: viniperri (98801 in chips) 
C0rpsbal: posts the ante 1000
Chuckster388: posts the ante 1000
jerdno0: posts the ante 1000
Lecher1991: posts the ante 1000
Everbrun11: posts the ante 1000
viniperri: posts the ante 1000
C0rpsbal: posts small blind 2000
Chuckster388: posts big blind 4000
*** HOLE CARDS ***
jerdno0: folds 
Lecher1991: folds 
Everbrun11: raises 4000 to 8000
viniperri: folds 
C0rpsbal: folds 
Chuckster388: calls 4000
*** FLOP *** [2c Kd 9s]
Chuckster388: checks 
Everbrun11: bets 6000
Chuckster388: calls 6000
*** TURN *** [2c Kd 9s] [5s]
Chuckster388: checks 
Everbrun11: bets 12000
Chuckster388: folds 
Uncalled bet (12000) returned to Everbrun11
Everbrun11 collected 36000 from pot
Everbrun11: doesn't show hand 
*** SUMMARY ***
Total pot 36000 | Rake 0 
Board [2c Kd 9s 5s]
Seat 1: C0rpsbal (small blind) folded before Flop
Seat 2: Chuckster388 (big blind) folded on the Turn
Seat 3: jerdno0 folded before Flop (didn't bet)
Seat 4: Lecher1991 folded before Flop (didn't bet)
Seat 5: Everbrun11 collected (36000)
Seat 6: viniperri (button) folded before Flop (didn't bet)

PokerStars Hand #251210129602: Tournament #3769361908, $52.38+$2.62 USD Hold'em No Limit - Level XXII (2000/4000) - 2024/06/26 23:13:22 UTC [2024/06/26 19:13:22 ET]
Table '3769361908 4' 6-max Seat #1 is the button
Seat 1: C0rpsbal (29168 in chips) 
Seat 2: Chuckster388 (31980 in chips) 
Seat 3: jerdno0 (63468 in chips) 
Seat 4: Lecher1991 (47056 in chips) 
Seat 5: Everbrun11 (101408 in chips) 
Seat 6: viniperri (97801 in chips) 
C0rpsbal: posts the ante 1000
Chuckster388: posts the ante 1000
jerdno0: posts the ante 1000
Lecher1991: posts the ante 1000
Everbrun11: posts the ante 1000
viniperri: posts the ante 1000
Chuckster388: posts small blind 2000
jerdno0: posts big blind 4000
*** HOLE CARDS ***
Lecher1991: folds 
Everbrun11: folds 
viniperri: raises 4000 to 8000
C0rpsbal: folds 
Chuckster388: raises 22980 to 30980 and is all-in
jerdno0: folds 
viniperri: calls 22980
*** FLOP *** [Jc 3h 8d]
*** TURN *** [Jc 3h 8d] [Tc]
*** RIVER *** [Jc 3h 8d Tc] [Ks]
*** SHOW DOWN ***
Chuckster388: shows [5c Ac] (high card Ace)
viniperri: shows [6h Ad] (high card Ace)
Chuckster388 collected 35980 from pot
viniperri collected 35980 from pot
*** SUMMARY ***
Total pot 71960 | Rake 0 
Board [Jc 3h 8d Tc Ks]
Seat 1: C0rpsbal (button) folded before Flop (didn't bet)
Seat 2: Chuckster388 (small blind) showed [5c Ac] and won (35980) with high card Ace
Seat 3: jerdno0 (big blind) folded before Flop
Seat 4: Lecher1991 folded before Flop (didn't bet)
Seat 5: Everbrun11 folded before Flop (didn't bet)
Seat 6: viniperri showed [6h Ad] and won (35980) with high card Ace

PokerStars Hand #251210139144: Tournament #3769361908, $52.38+$2.62 USD Hold'em No Limit - Level XXII (2000/4000) - 2024/06/26 23:14:07 UTC [2024/06/26 19:14:07 ET]
Table '3769361908 4' 6-max Seat #2 is the button
Seat 1: C0rpsbal (28168 in chips) 
Seat 2: Chuckster388 (35980 in chips) 
Seat 3: jerdno0 (58468 in chips) 
Seat 4: Lecher1991 (46056 in chips) 
Seat 5: Everbrun11 (100408 in chips) 
Seat 6: viniperri (101801 in chips) 
C0rpsbal: posts the ante 1000
Chuckster388: posts the ante 1000
jerdno0: posts the ante 1000
Lecher1991: posts the ante 1000
Everbrun11: posts the ante 1000
viniperri: posts the ante 1000
jerdno0: posts small blind 2000
Lecher1991: posts big blind 4000
*** HOLE CARDS ***
Everbrun11: folds 
viniperri: folds 
C0rpsbal: folds 
Chuckster388: folds 
jerdno0: folds 
Uncalled bet (2000) returned to Lecher1991
Lecher1991 collected 10000 from pot
*** SUMMARY ***
Total pot 10000 | Rake 0 
Seat 1: C0rpsbal folded before Flop (didn't bet)
Seat 2: Chuckster388 (button) folded before Flop (didn't bet)
Seat 3: jerdno0 (small blind) folded before Flop
Seat 4: Lecher1991 (big blind) collected (10000)
Seat 5: Everbrun11 folded before Flop (didn't bet)
Seat 6: viniperri folded before Flop (didn't bet)

PokerStars Hand #251210143376: Tournament #3769361908, $52.38+$2.62 USD Hold'em No Limit - Level XXIII (2500/5000) - 2024/06/26 23:14:26 UTC [2024/06/26 19:14:26 ET]
Table '3769361908 4' 6-max Seat #3 is the button
Seat 1: C0rpsbal (27168 in chips) 
Seat 2: Chuckster388 (34980 in chips) 
Seat 3: jerdno0 (55468 in chips) 
Seat 4: Lecher1991 (53056 in chips) 
Seat 5: Everbrun11 (99408 in chips) 
Seat 6: viniperri (100801 in chips) 
C0rpsbal: posts the ante 1250
Chuckster388: posts the ante 1250
jerdno0: posts the ante 1250
Lecher1991: posts the ante 1250
Everbrun11: posts the ante 1250
viniperri: posts the ante 1250
Lecher1991: posts small blind 2500
Everbrun11: posts big blind 5000
*** HOLE CARDS ***
viniperri: raises 5000 to 10000
C0rpsbal: folds 
Chuckster388: folds 
jerdno0: folds 
Lecher1991: folds 
Everbrun11: calls 5000
*** FLOP *** [Qs Jh Ks]
Everbrun11: checks 
viniperri: bets 7500
Everbrun11: calls 7500
*** TURN *** [Qs Jh Ks] [7d]
Everbrun11: checks 
viniperri: checks 
*** RIVER *** [Qs Jh Ks 7d] [4d]
Everbrun11: bets 15000
viniperri: calls 15000
*** SHOW DOWN ***
Everbrun11: shows [Ts Ah] (a straight, Ten to Ace)
viniperri: mucks hand 
Everbrun11 collected 75000 from pot
*** SUMMARY ***
Total pot 75000 | Rake 0 
Board [Qs Jh Ks 7d 4d]
Seat 1: C0rpsbal folded before Flop (didn't bet)
Seat 2: Chuckster388 folded before Flop (didn't bet)
Seat 3: jerdno0 (button) folded before Flop (didn't bet)
Seat 4: Lecher1991 (small blind) folded before Flop
Seat 5: Everbrun11 (big blind) showed [Ts Ah] and won (75000) with a straight, Ten to Ace
Seat 6: viniperri mucked

PokerStars Hand #251210158020: Tournament #3769361908, $52.38+$2.62 USD Hold'em No Limit - Level XXIII (2500/5000) - 2024/06/26 23:15:35 UTC [2024/06/26 19:15:35 ET]
Table '3769361908 4' 6-max Seat #4 is the button
Seat 1: C0rpsbal (25918 in chips) 
Seat 2: Chuckster388 (33730 in chips) 
Seat 3: jerdno0 (54218 in chips) 
Seat 4: Lecher1991 (49306 in chips) 
Seat 5: Everbrun11 (140658 in chips) 
Seat 6: viniperri (67051 in chips) 
C0rpsbal: posts the ante 1250
Chuckster388: posts the ante 1250
jerdno0: posts the ante 1250
Lecher1991: posts the ante 1250
Everbrun11: posts the ante 1250
viniperri: posts the ante 1250
Everbrun11: posts small blind 2500
viniperri: posts big blind 5000
*** HOLE CARDS ***
C0rpsbal: folds 
Chuckster388: raises 27480 to 32480 and is all-in
jerdno0: folds 
Lecher1991: folds 
Everbrun11: folds 
viniperri: calls 27480
*** FLOP *** [Qc 3c 3s]
*** TURN *** [Qc 3c 3s] [7s]
*** RIVER *** [Qc 3c 3s 7s] [9h]
*** SHOW DOWN ***
viniperri: shows [Ad 4h] (a pair of Threes)
Chuckster388: shows [2c 2s] (two pair, Threes and Deuces)
Chuckster388 collected 74960 from pot
*** SUMMARY ***
Total pot 74960 | Rake 0 
Board [Qc 3c 3s 7s 9h]
Seat 1: C0rpsbal folded before Flop (didn't bet)
Seat 2: Chuckster388 showed [2c 2s] and won (74960) with two pair, Threes and Deuces
Seat 3: jerdno0 folded before Flop (didn't bet)
Seat 4: Lecher1991 (button) folded before Flop (didn't bet)
Seat 5: Everbrun11 (small blind) folded before Flop
Seat 6: viniperri (big blind) showed [Ad 4h] and lost with a pair of Threes

PokerStars Hand #251210166273: Tournament #3769361908, $52.38+$2.62 USD Hold'em No Limit - Level XXIII (2500/5000) - 2024/06/26 23:16:13 UTC [2024/06/26 19:16:13 ET]
Table '3769361908 4' 6-max Seat #5 is the button
Seat 1: C0rpsbal (24668 in chips) 
Seat 2: Chuckster388 (74960 in chips) 
Seat 3: jerdno0 (52968 in chips) 
Seat 4: Lecher1991 (48056 in chips) 
Seat 5: Everbrun11 (136908 in chips) 
Seat 6: viniperri (33321 in chips) 
C0rpsbal: posts the ante 1250
Chuckster388: posts the ante 1250
jerdno0: posts the ante 1250
Lecher1991: posts the ante 1250
Everbrun11: posts the ante 1250
viniperri: posts the ante 1250
viniperri: posts small blind 2500
C0rpsbal: posts big blind 5000
*** HOLE CARDS ***
Chuckster388: folds 
jerdno0: folds 
Lecher1991: folds 
Everbrun11: raises 130658 to 135658 and is all-in
viniperri: folds 
C0rpsbal: folds 
Uncalled bet (130658) returned to Everbrun11
Everbrun11 collected 20000 from pot
Everbrun11: doesn't show hand 
*** SUMMARY ***
Total pot 20000 | Rake 0 
Seat 1: C0rpsbal (big blind) folded before Flop
Seat 2: Chuckster388 folded before Flop (didn't bet)
Seat 3: jerdno0 folded before Flop (didn't bet)
Seat 4: Lecher1991 folded before Flop (didn't bet)
Seat 5: Everbrun11 (button) collected (20000)
Seat 6: viniperri (small blind) folded before Flop

PokerStars Hand #251210173976: Tournament #3769361908, $52.38+$2.62 USD Hold'em No Limit - Level XXIII (2500/5000) - 2024/06/26 23:16:49 UTC [2024/06/26 19:16:49 ET]
Table '3769361908 4' 6-max Seat #6 is the button
Seat 1: C0rpsbal (18418 in chips) 
Seat 2: Chuckster388 (73710 in chips) 
Seat 3: jerdno0 (51718 in chips) 
Seat 4: Lecher1991 (46806 in chips) 
Seat 5: Everbrun11 (150658 in chips) 
Seat 6: viniperri (29571 in chips) 
C0rpsbal: posts the ante 1250
Chuckster388: posts the ante 1250
jerdno0: posts the ante 1250
Lecher1991: posts the ante 1250
Everbrun11: posts the ante 1250
viniperri: posts the ante 1250
C0rpsbal: posts small blind 2500
Chuckster388: posts big blind 5000
*** HOLE CARDS ***
jerdno0: folds 
Lecher1991: folds 
Everbrun11: folds 
viniperri: raises 23321 to 28321 and is all-in
C0rpsbal: calls 14668 and is all-in
Chuckster388: folds 
Uncalled bet (11153) returned to viniperri
*** FLOP *** [Ad Jd 2h]
*** TURN *** [Ad Jd 2h] [8h]
*** RIVER *** [Ad Jd 2h 8h] [3d]
*** SHOW DOWN ***
C0rpsbal: shows [Kc 9s] (high card Ace)
viniperri: shows [Qs 6d] (high card Ace - lower kicker)
C0rpsbal collected 46836 from pot
*** SUMMARY ***
Total pot 46836 | Rake 0 
Board [Ad Jd 2h 8h 3d]
Seat 1: C0rpsbal (small blind) showed [Kc 9s] and won (46836) with high card Ace
Seat 2: Chuckster388 (big blind) folded before Flop
Seat 3: jerdno0 folded before Flop (didn't bet)
Seat 4: Lecher1991 folded before Flop (didn't bet)
Seat 5: Everbrun11 folded before Flop (didn't bet)
Seat 6: viniperri (button) showed [Qs 6d] and lost with high card Ace

PokerStars Hand #251210181535: Tournament #3769361908, $52.38+$2.62 USD Hold'em No Limit - Level XXIV (3000/6000) - 2024/06/26 23:17:24 UTC [2024/06/26 19:17:24 ET]
Table '3769361908 4' 6-max Seat #1 is the button
Seat 1: C0rpsbal (46836 in chips) 
Seat 2: Chuckster388 (67460 in chips) 
Seat 3: jerdno0 (50468 in chips) 
Seat 4: Lecher1991 (45556 in chips) 
Seat 5: Everbrun11 (149408 in chips) 
Seat 6: viniperri (11153 in chips) 
C0rpsbal: posts the ante 1500
Chuckster388: posts the ante 1500
jerdno0: posts the ante 1500
Lecher1991: posts the ante 1500
Everbrun11: posts the ante 1500
viniperri: posts the ante 1500
Chuckster388: posts small blind 3000
jerdno0: posts big blind 6000
*** HOLE CARDS ***
Lecher1991: folds 
Everbrun11: folds 
viniperri: folds 
C0rpsbal: folds 
Chuckster388: calls 3000
jerdno0: checks 
*** FLOP *** [3d 4c 8c]
Chuckster388: bets 59960 and is all-in
jerdno0: folds 
Uncalled bet (59960) returned to Chuckster388
Chuckster388 collected 21000 from pot
Chuckster388: doesn't show hand 
*** SUMMARY ***
Total pot 21000 | Rake 0 
Board [3d 4c 8c]
Seat 1: C0rpsbal (button) folded before Flop (didn't bet)
Seat 2: Chuckster388 (small blind) collected (21000)
Seat 3: jerdno0 (big blind) folded on the Flop
Seat 4: Lecher1991 folded before Flop (didn't bet)
Seat 5: Everbrun11 folded before Flop (didn't bet)
Seat 6: viniperri folded before Flop (didn't bet)

PokerStars Hand #251210189440: Tournament #3769361908, $52.38+$2.62 USD Hold'em No Limit - Level XXIV (3000/6000) - 2024/06/26 23:18:02 UTC [2024/06/26 19:18:02 ET]
Table '3769361908 4' 6-max Seat #2 is the button
Seat 1: C0rpsbal (45336 in chips) 
Seat 2: Chuckster388 (80960 in chips) 
Seat 3: jerdno0 (42968 in chips) 
Seat 4: Lecher1991 (44056 in chips) 
Seat 5: Everbrun11 (147908 in chips) 
Seat 6: viniperri (9653 in chips) 
C0rpsbal: posts the ante 1500
Chuckster388: posts the ante 1500
jerdno0: posts the ante 1500
Lecher1991: posts the ante 1500
Everbrun11: posts the ante 1500
viniperri: posts the ante 1500
jerdno0: posts small blind 3000
Lecher1991: posts big blind 6000
*** HOLE CARDS ***
Everbrun11: folds 
viniperri: folds 
C0rpsbal: folds 
Chuckster388: folds 
jerdno0: calls 3000
Lecher1991: raises 36556 to 42556 and is all-in
jerdno0: calls 35468 and is all-in
Uncalled bet (1088) returned to Lecher1991
*** FLOP *** [5d Jd 9h]
*** TURN *** [5d Jd 9h] [4c]
*** RIVER *** [5d Jd 9h 4c] [Qh]
*** SHOW DOWN ***
jerdno0: shows [Kc Js] (a pair of Jacks)
Lecher1991: shows [7d 8c] (high card Queen)
jerdno0 collected 91936 from pot
*** SUMMARY ***
Total pot 91936 | Rake 0 
Board [5d Jd 9h 4c Qh]
Seat 1: C0rpsbal folded before Flop (didn't bet)
Seat 2: Chuckster388 (button) folded before Flop (didn't bet)
Seat 3: jerdno0 (small blind) showed [Kc Js] and won (91936) with a pair of Jacks
Seat 4: Lecher1991 (big blind) showed [7d 8c] and lost with high card Queen
Seat 5: Everbrun11 folded before Flop (didn't bet)
Seat 6: viniperri folded before Flop (didn't bet)

PokerStars Hand #251210198526: Tournament #3769361908, $52.38+$2.62 USD Hold'em No Limit - Level XXIV (3000/6000) - 2024/06/26 23:18:45 UTC [2024/06/26 19:18:45 ET]
Table '3769361908 4' 6-max Seat #3 is the button
Seat 1: C0rpsbal (43836 in chips) 
Seat 2: Chuckster388 (79460 in chips) 
Seat 3: jerdno0 (91936 in chips) 
Seat 4: Lecher1991 (1088 in chips) 
Seat 5: Everbrun11 (146408 in chips) 
Seat 6: viniperri (8153 in chips) 
C0rpsbal: posts the ante 1500
Chuckster388: posts the ante 1500
jerdno0: posts the ante 1500
Lecher1991: posts the ante 1088 and is all-in
Everbrun11: posts the ante 1500
viniperri: posts the ante 1500
Everbrun11: posts big blind 6000
*** HOLE CARDS ***
viniperri: raises 653 to 6653 and is all-in
C0rpsbal: folds 
Chuckster388: folds 
jerdno0: folds 
Everbrun11: calls 653
*** FLOP *** [Kc 8d Jh]
*** TURN *** [Kc 8d Jh] [Qd]
*** RIVER *** [Kc 8d Jh Qd] [Ac]
*** SHOW DOWN ***
Everbrun11: shows [7s Th] (a straight, Ten to Ace)
viniperri: shows [5s Kh] (a pair of Kings)
Everbrun11 collected 15366 from side pot
Lecher1991: shows [9h 3s] (high card Ace)
Everbrun11 collected 6528 from main pot
viniperri finished the tournament in 38th place and received $111.65.
Lecher1991 finished the tournament in 39th place and received $111.65.
*** SUMMARY ***
Total pot 21894 Main pot 6528. Side pot 15366. | Rake 0 
Board [Kc 8d Jh Qd Ac]
Seat 1: C0rpsbal folded before Flop (didn't bet)
Seat 2: Chuckster388 folded before Flop (didn't bet)
Seat 3: jerdno0 (button) folded before Flop (didn't bet)
Seat 4: Lecher1991 showed [9h 3s] and lost with high card Ace
Seat 5: Everbrun11 (big blind) showed [7s Th] and won (21894) with a straight, Ten to Ace
Seat 6: viniperri showed [5s Kh] and lost with a pair of Kings

PokerStars Hand #251210203595: Tournament #3769361908, $52.38+$2.62 USD Hold'em No Limit - Level XXIV (3000/6000) - 2024/06/26 23:19:09 UTC [2024/06/26 19:19:09 ET]
Table '3769361908 4' 6-max Seat #5 is the button
Seat 1: C0rpsbal (42336 in chips) 
Seat 2: Chuckster388 (77960 in chips) 
Seat 3: jerdno0 (90436 in chips) 
Seat 5: Everbrun11 (160149 in chips) 
C0rpsbal: posts the ante 1500
Chuckster388: posts the ante 1500
jerdno0: posts the ante 1500
Everbrun11: posts the ante 1500
C0rpsbal: posts small blind 3000
Chuckster388: posts big blind 6000
*** HOLE CARDS ***
jerdno0: calls 6000
Everbrun11: folds 
C0rpsbal: folds 
Chuckster388: checks 
*** FLOP *** [3d 7s Ah]
Pseudo Fruto is disconnected 
Acai Brend is disconnected 
Chuckster388: checks 
jerdno0: bets 10500
Chuckster388: folds 
Uncalled bet (10500) returned to jerdno0
jerdno0 collected 21000 from pot
*** SUMMARY ***
Total pot 21000 | Rake 0 
Board [3d 7s Ah]
Seat 1: C0rpsbal (small blind) folded before Flop
Seat 2: Chuckster388 (big blind) folded on the Flop
Seat 3: jerdno0 collected (21000)
Seat 5: Everbrun11 (button) folded before Flop (didn't bet)

PokerStars Hand #251210210677: Tournament #3769361908, $52.38+$2.62 USD Hold'em No Limit - Level XXIV (3000/6000) - 2024/06/26 23:19:43 UTC [2024/06/26 19:19:43 ET]
Table '3769361908 4' 6-max Seat #1 is the button
Seat 1: C0rpsbal (37836 in chips) 
Seat 2: Chuckster388 (70460 in chips) 
Seat 3: jerdno0 (103936 in chips) 
Seat 4: Pseudo Fruto (106930 in chips) 
Seat 5: Everbrun11 (158649 in chips) 
Seat 6: Acai Brend (29566 in chips) 
C0rpsbal: posts the ante 1500
Chuckster388: posts the ante 1500
jerdno0: posts the ante 1500
Pseudo Fruto: posts the ante 1500
Everbrun11: posts the ante 1500
Acai Brend: posts the ante 1500
Chuckster388: posts small blind 3000
jerdno0: posts big blind 6000
*** HOLE CARDS ***
Pseudo Fruto: folds 
Everbrun11: folds 
Acai Brend: raises 22066 to 28066 and is all-in
C0rpsbal: raises 8270 to 36336 and is all-in
Chuckster388: folds 
jerdno0: folds 
Uncalled bet (8270) returned to C0rpsbal
*** FLOP *** [5h 6s 3h]
*** TURN *** [5h 6s 3h] [Jd]
*** RIVER *** [5h 6s 3h Jd] [6c]
*** SHOW DOWN ***
Acai Brend: shows [Th Kh] (a pair of Sixes)
C0rpsbal: shows [7d As] (a pair of Sixes - Ace kicker)
C0rpsbal collected 74132 from pot
Acai Brend finished the tournament in 34th place and received $111.65.
*** SUMMARY ***
Total pot 74132 | Rake 0 
Board [5h 6s 3h Jd 6c]
Seat 1: C0rpsbal (button) showed [7d As] and won (74132) with a pair of Sixes
Seat 2: Chuckster388 (small blind) folded before Flop
Seat 3: jerdno0 (big blind) folded before Flop
Seat 4: Pseudo Fruto folded before Flop (didn't bet)
Seat 5: Everbrun11 folded before Flop (didn't bet)
Seat 6: Acai Brend showed [Th Kh] and lost with a pair of Sixes

PokerStars Hand #251210220025: Tournament #3769361908, $52.38+$2.62 USD Hold'em No Limit - Level XXV (3500/7000) - 2024/06/26 23:20:28 UTC [2024/06/26 19:20:28 ET]
Table '3769361908 4' 6-max Seat #2 is the button
Seat 1: C0rpsbal (82402 in chips) 
Seat 2: Chuckster388 (65960 in chips) 
Seat 3: jerdno0 (96436 in chips) 
Seat 4: Pseudo Fruto (105430 in chips) 
Seat 5: Everbrun11 (157149 in chips) 
C0rpsbal: posts the ante 1750
Chuckster388: posts the ante 1750
jerdno0: posts the ante 1750
Pseudo Fruto: posts the ante 1750
Everbrun11: posts the ante 1750
jerdno0: posts small blind 3500
Pseudo Fruto: posts big blind 7000
*** HOLE CARDS ***
Everbrun11: folds 
C0rpsbal: folds 
Chuckster388: folds 
jerdno0: calls 3500
Pseudo Fruto: checks 
*** FLOP *** [Ah Ad 9h]
jerdno0: bets 7000
Pseudo Fruto: folds 
Uncalled bet (7000) returned to jerdno0
jerdno0 collected 22750 from pot
*** SUMMARY ***
Total pot 22750 | Rake 0 
Board [Ah Ad 9h]
Seat 1: C0rpsbal folded before Flop (didn't bet)
Seat 2: Chuckster388 (button) folded before Flop (didn't bet)
Seat 3: jerdno0 (small blind) collected (22750)
Seat 4: Pseudo Fruto (big blind) folded on the Flop
Seat 5: Everbrun11 folded before Flop (didn't bet)

PokerStars Hand #251210231895: Tournament #3769361908, $52.38+$2.62 USD Hold'em No Limit - Level XXV (3500/7000) - 2024/06/26 23:21:25 UTC [2024/06/26 19:21:25 ET]
Table '3769361908 4' 6-max Seat #3 is the button
Seat 1: C0rpsbal (80652 in chips) 
Seat 2: Chuckster388 (64210 in chips) 
Seat 3: jerdno0 (110436 in chips) 
Seat 4: Pseudo Fruto (96680 in chips) 
Seat 5: Everbrun11 (155399 in chips) 
Seat 6: VxVendetta00 (146970 in chips) 
C0rpsbal: posts the ante 1750
Chuckster388: posts the ante 1750
jerdno0: posts the ante 1750
Pseudo Fruto: posts the ante 1750
Everbrun11: posts the ante 1750
VxVendetta00: posts the ante 1750
Pseudo Fruto: posts small blind 3500
Everbrun11: posts big blind 7000
*** HOLE CARDS ***
VxVendetta00: folds 
C0rpsbal: folds 
Chuckster388: folds 
jerdno0: calls 7000
Pseudo Fruto: folds 
Everbrun11: checks 
*** FLOP *** [9s 5d 6c]
Everbrun11: checks 
jerdno0: bets 7000
Everbrun11: calls 7000
*** TURN *** [9s 5d 6c] [Kc]
Everbrun11: checks 
jerdno0: checks 
*** RIVER *** [9s 5d 6c Kc] [Qd]
Everbrun11: bets 13860
jerdno0: folds 
Uncalled bet (13860) returned to Everbrun11
Everbrun11 collected 42000 from pot
Everbrun11: doesn't show hand 
*** SUMMARY ***
Total pot 42000 | Rake 0 
Board [9s 5d 6c Kc Qd]
Seat 1: C0rpsbal folded before Flop (didn't bet)
Seat 2: Chuckster388 folded before Flop (didn't bet)
Seat 3: jerdno0 (button) folded on the River
Seat 4: Pseudo Fruto (small blind) folded before Flop
Seat 5: Everbrun11 (big blind) collected (42000)
Seat 6: VxVendetta00 folded before Flop (didn't bet)

PokerStars Hand #251210244527: Tournament #3769361908, $52.38+$2.62 USD Hold'em No Limit - Level XXV (3500/7000) - 2024/06/26 23:22:26 UTC [2024/06/26 19:22:26 ET]
Table '3769361908 4' 6-max Seat #4 is the button
Seat 1: C0rpsbal (78902 in chips) 
Seat 2: Chuckster388 (62460 in chips) 
Seat 3: jerdno0 (94686 in chips) 
Seat 4: Pseudo Fruto (91430 in chips) 
Seat 5: Everbrun11 (181649 in chips) 
Seat 6: VxVendetta00 (145220 in chips) 
C0rpsbal: posts the ante 1750
Chuckster388: posts the ante 1750
jerdno0: posts the ante 1750
Pseudo Fruto: posts the ante 1750
Everbrun11: posts the ante 1750
VxVendetta00: posts the ante 1750
Everbrun11: posts small blind 3500
VxVendetta00: posts big blind 7000
*** HOLE CARDS ***
C0rpsbal: folds 
Chuckster388: folds 
jerdno0: folds 
Pseudo Fruto: folds 
Everbrun11: raises 17500 to 24500
VxVendetta00: folds 
Uncalled bet (17500) returned to Everbrun11
Everbrun11 collected 24500 from pot
Everbrun11: doesn't show hand 
*** SUMMARY ***
Total pot 24500 | Rake 0 
Seat 1: C0rpsbal folded before Flop (didn't bet)
Seat 2: Chuckster388 folded before Flop (didn't bet)
Seat 3: jerdno0 folded before Flop (didn't bet)
Seat 4: Pseudo Fruto (button) folded before Flop (didn't bet)
Seat 5: Everbrun11 (small blind) collected (24500)
Seat 6: VxVendetta00 (big blind) folded before Flop

PokerStars Hand #251210250600: Tournament #3769361908, $52.38+$2.62 USD Hold'em No Limit - Level XXV (3500/7000) - 2024/06/26 23:22:55 UTC [2024/06/26 19:22:55 ET]
Table '3769361908 4' 6-max Seat #5 is the button
Seat 1: C0rpsbal (77152 in chips) 
Seat 2: Chuckster388 (60710 in chips) 
Seat 4: Pseudo Fruto (89680 in chips) 
Seat 5: Everbrun11 (197399 in chips) 
Seat 6: VxVendetta00 (136470 in chips) 
C0rpsbal: posts the ante 1750
Chuckster388: posts the ante 1750
Pseudo Fruto: posts the ante 1750
Everbrun11: posts the ante 1750
VxVendetta00: posts the ante 1750
VxVendetta00: posts small blind 3500
C0rpsbal: posts big blind 7000
*** HOLE CARDS ***
Chuckster388: folds 
Pseudo Fruto: raises 80930 to 87930 and is all-in
Everbrun11: folds 
VxVendetta00: folds 
C0rpsbal: folds 
Uncalled bet (80930) returned to Pseudo Fruto
Pseudo Fruto collected 26250 from pot
Pseudo Fruto: doesn't show hand 
*** SUMMARY ***
Total pot 26250 | Rake 0 
Seat 1: C0rpsbal (big blind) folded before Flop
Seat 2: Chuckster388 folded before Flop (didn't bet)
Seat 4: Pseudo Fruto collected (26250)
Seat 5: Everbrun11 (button) folded before Flop (didn't bet)
Seat 6: VxVendetta00 (small blind) folded before Flop

PokerStars Hand #251210254434: Tournament #3769361908, $52.38+$2.62 USD Hold'em No Limit - Level XXV (3500/7000) - 2024/06/26 23:23:14 UTC [2024/06/26 19:23:14 ET]
Table '3769361908 4' 6-max Seat #6 is the button
Seat 1: C0rpsbal (68402 in chips) 
Seat 2: Chuckster388 (58960 in chips) 
Seat 4: Pseudo Fruto (107180 in chips) 
Seat 5: Everbrun11 (195649 in chips) 
Seat 6: VxVendetta00 (131220 in chips) 
C0rpsbal: posts the ante 1750
Chuckster388: posts the ante 1750
Pseudo Fruto: posts the ante 1750
Everbrun11: posts the ante 1750
VxVendetta00: posts the ante 1750
C0rpsbal: posts small blind 3500
Chuckster388: posts big blind 7000
*** HOLE CARDS ***
Pseudo Fruto: folds 
Everbrun11: raises 7000 to 14000
VxVendetta00: folds 
C0rpsbal: folds 
Chuckster388: folds 
Uncalled bet (7000) returned to Everbrun11
Everbrun11 collected 26250 from pot
Everbrun11: doesn't show hand 
*** SUMMARY ***
Total pot 26250 | Rake 0 
Seat 1: C0rpsbal (small blind) folded before Flop
Seat 2: Chuckster388 (big blind) folded before Flop
Seat 4: Pseudo Fruto folded before Flop (didn't bet)
Seat 5: Everbrun11 collected (26250)
Seat 6: VxVendetta00 (button) folded before Flop (didn't bet)

PokerStars Hand #251210261229: Tournament #3769361908, $52.38+$2.62 USD Hold'em No Limit - Level XXVI (4000/8000) - 2024/06/26 23:23:47 UTC [2024/06/26 19:23:47 ET]
Table '3769361908 4' 6-max Seat #1 is the button
Seat 1: C0rpsbal (63152 in chips) 
Seat 2: Chuckster388 (50210 in chips) 
Seat 4: Pseudo Fruto (105430 in chips) 
Seat 5: Everbrun11 (213149 in chips) 
Seat 6: VxVendetta00 (129470 in chips) 
C0rpsbal: posts the ante 2000
Chuckster388: posts the ante 2000
Pseudo Fruto: posts the ante 2000
Everbrun11: posts the ante 2000
VxVendetta00: posts the ante 2000
Chuckster388: posts small blind 4000
Pseudo Fruto: posts big blind 8000
*** HOLE CARDS ***
Everbrun11: raises 8000 to 16000
VxVendetta00: folds 
C0rpsbal: folds 
Chuckster388: folds 
Pseudo Fruto: folds 
Uncalled bet (8000) returned to Everbrun11
Everbrun11 collected 30000 from pot
Everbrun11: doesn't show hand 
*** SUMMARY ***
Total pot 30000 | Rake 0 
Seat 1: C0rpsbal (button) folded before Flop (didn't bet)
Seat 2: Chuckster388 (small blind) folded before Flop
Seat 4: Pseudo Fruto (big blind) folded before Flop
Seat 5: Everbrun11 collected (30000)
Seat 6: VxVendetta00 folded before Flop (didn't bet)

PokerStars Hand #251210265582: Tournament #3769361908, $52.38+$2.62 USD Hold'em No Limit - Level XXVI (4000/8000) - 2024/06/26 23:24:08 UTC [2024/06/26 19:24:08 ET]
Table '3769361908 4' 6-max Seat #2 is the button
Seat 1: C0rpsbal (61152 in chips) 
Seat 2: Chuckster388 (44210 in chips) 
Seat 4: Pseudo Fruto (95430 in chips) 
Seat 5: Everbrun11 (233149 in chips) 
Seat 6: VxVendetta00 (127470 in chips) 
C0rpsbal: posts the ante 2000
Chuckster388: posts the ante 2000
Pseudo Fruto: posts the ante 2000
Everbrun11: posts the ante 2000
VxVendetta00: posts the ante 2000
Pseudo Fruto: posts small blind 4000
Everbrun11: posts big blind 8000
*** HOLE CARDS ***
VxVendetta00: folds 
C0rpsbal: folds 
Chuckster388: folds 
Pseudo Fruto: calls 4000
Everbrun11: checks 
*** FLOP *** [Kh 9s 4h]
Pseudo Fruto: bets 8000
Everbrun11: folds 
Uncalled bet (8000) returned to Pseudo Fruto
Pseudo Fruto collected 26000 from pot
Pseudo Fruto: doesn't show hand 
*** SUMMARY ***
Total pot 26000 | Rake 0 
Board [Kh 9s 4h]
Seat 1: C0rpsbal folded before Flop (didn't bet)
Seat 2: Chuckster388 (button) folded before Flop (didn't bet)
Seat 4: Pseudo Fruto (small blind) collected (26000)
Seat 5: Everbrun11 (big blind) folded on the Flop
Seat 6: VxVendetta00 folded before Flop (didn't bet)

PokerStars Hand #251210269356: Tournament #3769361908, $52.38+$2.62 USD Hold'em No Limit - Level XXVI (4000/8000) - 2024/06/26 23:24:26 UTC [2024/06/26 19:24:26 ET]
Table '3769361908 4' 6-max Seat #4 is the button
Seat 1: C0rpsbal (59152 in chips) 
Seat 2: Chuckster388 (42210 in chips) 
Seat 4: Pseudo Fruto (111430 in chips) 
Seat 5: Everbrun11 (223149 in chips) 
Seat 6: VxVendetta00 (125470 in chips) 
C0rpsbal: posts the ante 2000
Chuckster388: posts the ante 2000
Pseudo Fruto: posts the ante 2000
Everbrun11: posts the ante 2000
VxVendetta00: posts the ante 2000
Everbrun11: posts small blind 4000
VxVendetta00: posts big blind 8000
*** HOLE CARDS ***
C0rpsbal: folds 
Chuckster388: folds 
Pseudo Fruto: folds 
Everbrun11: raises 16000 to 24000
VxVendetta00: folds 
Uncalled bet (16000) returned to Everbrun11
Everbrun11 collected 26000 from pot
Everbrun11: doesn't show hand 
*** SUMMARY ***
Total pot 26000 | Rake 0 
Seat 1: C0rpsbal folded before Flop (didn't bet)
Seat 2: Chuckster388 folded before Flop (didn't bet)
Seat 4: Pseudo Fruto (button) folded before Flop (didn't bet)
Seat 5: Everbrun11 (small blind) collected (26000)
Seat 6: VxVendetta00 (big blind) folded before Flop

PokerStars Hand #251210275101: Tournament #3769361908, $52.38+$2.62 USD Hold'em No Limit - Level XXVI (4000/8000) - 2024/06/26 23:24:54 UTC [2024/06/26 19:24:54 ET]
Table '3769361908 4' 6-max Seat #5 is the button
Seat 1: C0rpsbal (57152 in chips) 
Seat 2: Chuckster388 (40210 in chips) 
Seat 4: Pseudo Fruto (109430 in chips) 
Seat 5: Everbrun11 (239149 in chips) 
Seat 6: VxVendetta00 (115470 in chips) 
C0rpsbal: posts the ante 2000
Chuckster388: posts the ante 2000
Pseudo Fruto: posts the ante 2000
Everbrun11: posts the ante 2000
VxVendetta00: posts the ante 2000
VxVendetta00: posts small blind 4000
C0rpsbal: posts big blind 8000
*** HOLE CARDS ***
Chuckster388: folds 
Pseudo Fruto: folds 
Everbrun11: folds 
VxVendetta00: folds 
Uncalled bet (4000) returned to C0rpsbal
C0rpsbal collected 18000 from pot
C0rpsbal: doesn't show hand 
*** SUMMARY ***
Total pot 18000 | Rake 0 
Seat 1: C0rpsbal (big blind) collected (18000)
Seat 2: Chuckster388 folded before Flop (didn't bet)
Seat 4: Pseudo Fruto folded before Flop (didn't bet)
Seat 5: Everbrun11 (button) folded before Flop (didn't bet)
Seat 6: VxVendetta00 (small blind) folded before Flop

PokerStars Hand #251210278059: Tournament #3769361908, $52.38+$2.62 USD Hold'em No Limit - Level XXVI (4000/8000) - 2024/06/26 23:25:09 UTC [2024/06/26 19:25:09 ET]
Table '3769361908 4' 6-max Seat #6 is the button
Seat 1: C0rpsbal (69152 in chips) 
Seat 2: Chuckster388 (38210 in chips) 
Seat 4: Pseudo Fruto (107430 in chips) 
Seat 5: Everbrun11 (237149 in chips) 
Seat 6: VxVendetta00 (109470 in chips) 
C0rpsbal: posts the ante 2000
Chuckster388: posts the ante 2000
Pseudo Fruto: posts the ante 2000
Everbrun11: posts the ante 2000
VxVendetta00: posts the ante 2000
C0rpsbal: posts small blind 4000
Chuckster388: posts big blind 8000
*** HOLE CARDS ***
Pseudo Fruto: folds 
Everbrun11: folds 
VxVendetta00: folds 
C0rpsbal: folds 
Uncalled bet (4000) returned to Chuckster388
Chuckster388 collected 18000 from pot
Chuckster388: doesn't show hand 
*** SUMMARY ***
Total pot 18000 | Rake 0 
Seat 1: C0rpsbal (small blind) folded before Flop
Seat 2: Chuckster388 (big blind) collected (18000)
Seat 4: Pseudo Fruto folded before Flop (didn't bet)
Seat 5: Everbrun11 folded before Flop (didn't bet)
Seat 6: VxVendetta00 (button) folded before Flop (didn't bet)

PokerStars Hand #251210281026: Tournament #3769361908, $52.38+$2.62 USD Hold'em No Limit - Level XXVI (4000/8000) - 2024/06/26 23:25:23 UTC [2024/06/26 19:25:23 ET]
Table '3769361908 4' 6-max Seat #1 is the button
Seat 1: C0rpsbal (63152 in chips) 
Seat 2: Chuckster388 (50210 in chips) 
Seat 4: Pseudo Fruto (105430 in chips) 
Seat 5: Everbrun11 (235149 in chips) 
Seat 6: VxVendetta00 (107470 in chips) 
C0rpsbal: posts the ante 2000
Chuckster388: posts the ante 2000
Pseudo Fruto: posts the ante 2000
Everbrun11: posts the ante 2000
VxVendetta00: posts the ante 2000
Chuckster388: posts small blind 4000
Pseudo Fruto: posts big blind 8000
*** HOLE CARDS ***
Everbrun11: folds 
VxVendetta00: folds 
C0rpsbal: folds 
Chuckster388: raises 40210 to 48210 and is all-in
Pseudo Fruto: calls 40210
*** FLOP *** [8s 7c Js]
*** TURN *** [8s 7c Js] [Qc]
*** RIVER *** [8s 7c Js Qc] [9s]
*** SHOW DOWN ***
Chuckster388: shows [5d Th] (a straight, Eight to Queen)
Pseudo Fruto: shows [Ks 3h] (high card King)
Chuckster388 collected 106420 from pot
*** SUMMARY ***
Total pot 106420 | Rake 0 
Board [8s 7c Js Qc 9s]
Seat 1: C0rpsbal (button) folded before Flop (didn't bet)
Seat 2: Chuckster388 (small blind) showed [5d Th] and won (106420) with a straight, Eight to Queen
Seat 4: Pseudo Fruto (big blind) showed [Ks 3h] and lost with high card King
Seat 5: Everbrun11 folded before Flop (didn't bet)
Seat 6: VxVendetta00 folded before Flop (didn't bet)

PokerStars Hand #251210285946: Tournament #3769361908, $52.38+$2.62 USD Hold'em No Limit - Level XXVI (4000/8000) - 2024/06/26 23:25:47 UTC [2024/06/26 19:25:47 ET]
Table '3769361908 4' 6-max Seat #2 is the button
Seat 1: C0rpsbal (61152 in chips) 
Seat 2: Chuckster388 (106420 in chips) 
Seat 4: Pseudo Fruto (55220 in chips) 
Seat 5: Everbrun11 (233149 in chips) 
Seat 6: VxVendetta00 (105470 in chips) 
C0rpsbal: posts the ante 2000
Chuckster388: posts the ante 2000
Pseudo Fruto: posts the ante 2000
Everbrun11: posts the ante 2000
VxVendetta00: posts the ante 2000
Pseudo Fruto: posts small blind 4000
Everbrun11: posts big blind 8000
*** HOLE CARDS ***
VxVendetta00: folds 
C0rpsbal: raises 8000 to 16000
Chuckster388: folds 
Pseudo Fruto: folds 
Everbrun11: calls 8000
*** FLOP *** [3h Qc 5h]
Everbrun11: checks 
C0rpsbal: bets 8000
Everbrun11: folds 
Uncalled bet (8000) returned to C0rpsbal
C0rpsbal collected 46000 from pot
C0rpsbal: doesn't show hand 
*** SUMMARY ***
Total pot 46000 | Rake 0 
Board [3h Qc 5h]
Seat 1: C0rpsbal collected (46000)
Seat 2: Chuckster388 (button) folded before Flop (didn't bet)
Seat 4: Pseudo Fruto (small blind) folded before Flop
Seat 5: Everbrun11 (big blind) folded on the Flop
Seat 6: VxVendetta00 folded before Flop (didn't bet)

PokerStars Hand #251210294016: Tournament #3769361908, $52.38+$2.62 USD Hold'em No Limit - Level XXVII (4500/9000) - 2024/06/26 23:26:27 UTC [2024/06/26 19:26:27 ET]
Table '3769361908 4' 6-max Seat #4 is the button
Seat 1: C0rpsbal (89152 in chips) 
Seat 2: Chuckster388 (104420 in chips) 
Seat 4: Pseudo Fruto (49220 in chips) 
Seat 5: Everbrun11 (215149 in chips) 
Seat 6: VxVendetta00 (103470 in chips) 
C0rpsbal: posts the ante 2250
Chuckster388: posts the ante 2250
Pseudo Fruto: posts the ante 2250
Everbrun11: posts the ante 2250
VxVendetta00: posts the ante 2250
Everbrun11: posts small blind 4500
VxVendetta00: posts big blind 9000
*** HOLE CARDS ***
C0rpsbal: raises 77902 to 86902 and is all-in
Chuckster388: folds 
Pseudo Fruto: folds 
Everbrun11: folds 
VxVendetta00: folds 
Uncalled bet (77902) returned to C0rpsbal
C0rpsbal collected 33750 from pot
C0rpsbal: doesn't show hand 
*** SUMMARY ***
Total pot 33750 | Rake 0 
Seat 1: C0rpsbal collected (33750)
Seat 2: Chuckster388 folded before Flop (didn't bet)
Seat 4: Pseudo Fruto (button) folded before Flop (didn't bet)
Seat 5: Everbrun11 (small blind) folded before Flop
Seat 6: VxVendetta00 (big blind) folded before Flop

PokerStars Hand #251210298383: Tournament #3769361908, $52.38+$2.62 USD Hold'em No Limit - Level XXVII (4500/9000) - 2024/06/26 23:26:48 UTC [2024/06/26 19:26:48 ET]
Table '3769361908 4' 6-max Seat #5 is the button
Seat 1: C0rpsbal (111652 in chips) 
Seat 2: Chuckster388 (102170 in chips) 
Seat 4: Pseudo Fruto (46970 in chips) 
Seat 5: Everbrun11 (208399 in chips) 
Seat 6: VxVendetta00 (92220 in chips) 
C0rpsbal: posts the ante 2250
Chuckster388: posts the ante 2250
Pseudo Fruto: posts the ante 2250
Everbrun11: posts the ante 2250
VxVendetta00: posts the ante 2250
VxVendetta00: posts small blind 4500
C0rpsbal: posts big blind 9000
*** HOLE CARDS ***
Chuckster388: folds 
Pseudo Fruto: folds 
Everbrun11: raises 197149 to 206149 and is all-in
VxVendetta00: folds 
C0rpsbal: folds 
Uncalled bet (197149) returned to Everbrun11
Everbrun11 collected 33750 from pot
Everbrun11: doesn't show hand 
*** SUMMARY ***
Total pot 33750 | Rake 0 
Seat 1: C0rpsbal (big blind) folded before Flop
Seat 2: Chuckster388 folded before Flop (didn't bet)
Seat 4: Pseudo Fruto folded before Flop (didn't bet)
Seat 5: Everbrun11 (button) collected (33750)
Seat 6: VxVendetta00 (small blind) folded before Flop

PokerStars Hand #251210302507: Tournament #3769361908, $52.38+$2.62 USD Hold'em No Limit - Level XXVII (4500/9000) - 2024/06/26 23:27:09 UTC [2024/06/26 19:27:09 ET]
Table '3769361908 4' 6-max Seat #6 is the button
Seat 1: C0rpsbal (100402 in chips) 
Seat 2: Chuckster388 (99920 in chips) 
Seat 4: Pseudo Fruto (44720 in chips) 
Seat 5: Everbrun11 (230899 in chips) 
Seat 6: VxVendetta00 (85470 in chips) 
C0rpsbal: posts the ante 2250
Chuckster388: posts the ante 2250
Pseudo Fruto: posts the ante 2250
Everbrun11: posts the ante 2250
VxVendetta00: posts the ante 2250
C0rpsbal: posts small blind 4500
Chuckster388: posts big blind 9000
*** HOLE CARDS ***
Pseudo Fruto: raises 33470 to 42470 and is all-in
Everbrun11: folds 
VxVendetta00: folds 
C0rpsbal: raises 55682 to 98152 and is all-in
Chuckster388: folds 
Uncalled bet (55682) returned to C0rpsbal
*** FLOP *** [9c 5s Td]
*** TURN *** [9c 5s Td] [3h]
*** RIVER *** [9c 5s Td 3h] [4h]
*** SHOW DOWN ***
C0rpsbal: shows [Ah Ad] (a pair of Aces)
Pseudo Fruto: shows [Kc 7c] (high card King)
C0rpsbal collected 105190 from pot
Pseudo Fruto finished the tournament in 26th place and received $135.63.
MjLK MAN is disconnected 
aapetrone91 is disconnected 
*** SUMMARY ***
Total pot 105190 | Rake 0 
Board [9c 5s Td 3h 4h]
Seat 1: C0rpsbal (small blind) showed [Ah Ad] and won (105190) with a pair of Aces
Seat 2: Chuckster388 (big blind) folded before Flop
Seat 4: Pseudo Fruto showed [Kc 7c] and lost with high card King
Seat 5: Everbrun11 folded before Flop (didn't bet)
Seat 6: VxVendetta00 (button) folded before Flop (didn't bet)

PokerStars Hand #251210311580: Tournament #3769361908, $52.38+$2.62 USD Hold'em No Limit - Level XXVII (4500/9000) - 2024/06/26 23:27:54 UTC [2024/06/26 19:27:54 ET]
Table '3769361908 4' 6-max Seat #1 is the button
Seat 1: C0rpsbal (160872 in chips) 
Seat 2: Chuckster388 (88670 in chips) 
Seat 3: MjLK MAN (268227 in chips) 
Seat 4: aapetrone91 (186848 in chips) 
Seat 5: Everbrun11 (228649 in chips) 
Seat 6: VxVendetta00 (83220 in chips) 
C0rpsbal: posts the ante 2250
Chuckster388: posts the ante 2250
MjLK MAN: posts the ante 2250
aapetrone91: posts the ante 2250
Everbrun11: posts the ante 2250
VxVendetta00: posts the ante 2250
Chuckster388: posts small blind 4500
MjLK MAN: posts big blind 9000
*** HOLE CARDS ***
aapetrone91: folds 
Everbrun11: folds 
VxVendetta00: raises 71970 to 80970 and is all-in
C0rpsbal: folds 
Chuckster388: folds 
MjLK MAN has timed out
MjLK MAN: folds 
MjLK MAN is sitting out
Uncalled bet (71970) returned to VxVendetta00
VxVendetta00 collected 36000 from pot
MjLK MAN has returned
*** SUMMARY ***
Total pot 36000 | Rake 0 
Seat 1: C0rpsbal (button) folded before Flop (didn't bet)
Seat 2: Chuckster388 (small blind) folded before Flop
Seat 3: MjLK MAN (big blind) folded before Flop
Seat 4: aapetrone91 folded before Flop (didn't bet)
Seat 5: Everbrun11 folded before Flop (didn't bet)
Seat 6: VxVendetta00 collected (36000)

PokerStars Hand #251210317409: Tournament #3769361908, $52.38+$2.62 USD Hold'em No Limit - Level XXVII (4500/9000) - 2024/06/26 23:28:23 UTC [2024/06/26 19:28:23 ET]
Table '3769361908 4' 6-max Seat #2 is the button
Seat 1: C0rpsbal (158622 in chips) 
Seat 2: Chuckster388 (81920 in chips) 
Seat 3: MjLK MAN (256977 in chips) 
Seat 4: aapetrone91 (184598 in chips) 
Seat 5: Everbrun11 (226399 in chips) 
Seat 6: VxVendetta00 (107970 in chips) 
C0rpsbal: posts the ante 2250
Chuckster388: posts the ante 2250
MjLK MAN: posts the ante 2250
aapetrone91: posts the ante 2250
Everbrun11: posts the ante 2250
VxVendetta00: posts the ante 2250
MjLK MAN: posts small blind 4500
aapetrone91: posts big blind 9000
*** HOLE CARDS ***
Everbrun11: folds 
VxVendetta00: folds 
C0rpsbal: folds 
Chuckster388: folds 
MjLK MAN has timed out
MjLK MAN: folds 
MjLK MAN is sitting out
Uncalled bet (4500) returned to aapetrone91
aapetrone91 collected 22500 from pot
MjLK MAN has returned
*** SUMMARY ***
Total pot 22500 | Rake 0 
Seat 1: C0rpsbal folded before Flop (didn't bet)
Seat 2: Chuckster388 (button) folded before Flop (didn't bet)
Seat 3: MjLK MAN (small blind) folded before Flop
Seat 4: aapetrone91 (big blind) collected (22500)
Seat 5: Everbrun11 folded before Flop (didn't bet)
Seat 6: VxVendetta00 folded before Flop (didn't bet)

PokerStars Hand #251210323162: Tournament #3769361908, $52.38+$2.62 USD Hold'em No Limit - Level XXVII (4500/9000) - 2024/06/26 23:28:52 UTC [2024/06/26 19:28:52 ET]
Table '3769361908 4' 6-max Seat #3 is the button
Seat 1: C0rpsbal (156372 in chips) 
Seat 2: Chuckster388 (79670 in chips) 
Seat 3: MjLK MAN (250227 in chips) 
Seat 4: aapetrone91 (200348 in chips) 
Seat 5: Everbrun11 (224149 in chips) 
Seat 6: VxVendetta00 (105720 in chips) 
C0rpsbal: posts the ante 2250
Chuckster388: posts the ante 2250
MjLK MAN: posts the ante 2250
aapetrone91: posts the ante 2250
Everbrun11: posts the ante 2250
VxVendetta00: posts the ante 2250
aapetrone91: posts small blind 4500
Everbrun11: posts big blind 9000
*** HOLE CARDS ***
VxVendetta00: folds 
C0rpsbal: raises 9000 to 18000
Chuckster388: folds 
MjLK MAN has timed out
MjLK MAN: folds 
MjLK MAN is sitting out
MjLK MAN has returned
aapetrone91: folds 
Everbrun11: calls 9000
*** FLOP *** [3s 5c Ad]
Everbrun11: checks 
C0rpsbal: bets 16200
Everbrun11: raises 19800 to 36000
C0rpsbal: calls 19800
*** TURN *** [3s 5c Ad] [4d]
Everbrun11: bets 40500
C0rpsbal: folds 
Uncalled bet (40500) returned to Everbrun11
Everbrun11 collected 126000 from pot
Everbrun11: doesn't show hand 
*** SUMMARY ***
Total pot 126000 | Rake 0 
Board [3s 5c Ad 4d]
Seat 1: C0rpsbal folded on the Turn
Seat 2: Chuckster388 folded before Flop (didn't bet)
Seat 3: MjLK MAN (button) folded before Flop (didn't bet)
Seat 4: aapetrone91 (small blind) folded before Flop
Seat 5: Everbrun11 (big blind) collected (126000)
Seat 6: VxVendetta00 folded before Flop (didn't bet)

PokerStars Hand #251210340729: Tournament #3769361908, $52.38+$2.62 USD Hold'em No Limit - Level XXVIII (5000/10000) - 2024/06/26 23:30:20 UTC [2024/06/26 19:30:20 ET]
Table '3769361908 4' 6-max Seat #4 is the button
Seat 1: C0rpsbal (100122 in chips) 
Seat 2: Chuckster388 (77420 in chips) 
Seat 3: MjLK MAN (247977 in chips) 
Seat 4: aapetrone91 (193598 in chips) 
Seat 5: Everbrun11 (293899 in chips) 
Seat 6: VxVendetta00 (103470 in chips) 
C0rpsbal: posts the ante 2500
Chuckster388: posts the ante 2500
MjLK MAN: posts the ante 2500
aapetrone91: posts the ante 2500
Everbrun11: posts the ante 2500
VxVendetta00: posts the ante 2500
Everbrun11: posts small blind 5000
VxVendetta00: posts big blind 10000
*** HOLE CARDS ***
C0rpsbal: raises 87622 to 97622 and is all-in
Chuckster388: folds 
MjLK MAN: folds 
aapetrone91: folds 
Everbrun11: folds 
VxVendetta00: folds 
Uncalled bet (87622) returned to C0rpsbal
C0rpsbal collected 40000 from pot
C0rpsbal: doesn't show hand 
*** SUMMARY ***
Total pot 40000 | Rake 0 
Seat 1: C0rpsbal collected (40000)
Seat 2: Chuckster388 folded before Flop (didn't bet)
Seat 3: MjLK MAN folded before Flop (didn't bet)
Seat 4: aapetrone91 (button) folded before Flop (didn't bet)
Seat 5: Everbrun11 (small blind) folded before Flop
Seat 6: VxVendetta00 (big blind) folded before Flop

PokerStars Hand #251210346489: Tournament #3769361908, $52.38+$2.62 USD Hold'em No Limit - Level XXVIII (5000/10000) - 2024/06/26 23:30:48 UTC [2024/06/26 19:30:48 ET]
Table '3769361908 4' 6-max Seat #5 is the button
Seat 1: C0rpsbal (127622 in chips) 
Seat 3: MjLK MAN (245477 in chips) 
Seat 4: aapetrone91 (191098 in chips) 
Seat 5: Everbrun11 (286399 in chips) 
Seat 6: VxVendetta00 (90970 in chips) 
C0rpsbal: posts the ante 2500
MjLK MAN: posts the ante 2500
aapetrone91: posts the ante 2500
Everbrun11: posts the ante 2500
VxVendetta00: posts the ante 2500
VxVendetta00: posts small blind 5000
C0rpsbal: posts big blind 10000
*** HOLE CARDS ***
MjLK MAN: folds 
aapetrone91: folds 
Everbrun11: folds 
VxVendetta00: raises 78470 to 88470 and is all-in
C0rpsbal: folds 
Uncalled bet (78470) returned to VxVendetta00
VxVendetta00 collected 32500 from pot
*** SUMMARY ***
Total pot 32500 | Rake 0 
Seat 1: C0rpsbal (big blind) folded before Flop
Seat 3: MjLK MAN folded before Flop (didn't bet)
Seat 4: aapetrone91 folded before Flop (didn't bet)
Seat 5: Everbrun11 (button) folded before Flop (didn't bet)
Seat 6: VxVendetta00 (small blind) collected (32500)

PokerStars Hand #251210349519: Tournament #3769361908, $52.38+$2.62 USD Hold'em No Limit - Level XXVIII (5000/10000) - 2024/06/26 23:31:04 UTC [2024/06/26 19:31:04 ET]
Table '3769361908 4' 6-max Seat #6 is the button
Seat 1: C0rpsbal (115122 in chips) 
Seat 3: MjLK MAN (242977 in chips) 
Seat 4: aapetrone91 (188598 in chips) 
Seat 5: Everbrun11 (283899 in chips) 
Seat 6: VxVendetta00 (110970 in chips) 
C0rpsbal: posts the ante 2500
MjLK MAN: posts the ante 2500
aapetrone91: posts the ante 2500
Everbrun11: posts the ante 2500
VxVendetta00: posts the ante 2500
C0rpsbal: posts small blind 5000
MjLK MAN: posts big blind 10000
*** HOLE CARDS ***
aapetrone91: folds 
Everbrun11: folds 
VxVendetta00: folds 
C0rpsbal: raises 102622 to 112622 and is all-in
MjLK MAN: calls 102622
*** FLOP *** [Td 3c 9s]
*** TURN *** [Td 3c 9s] [8d]
*** RIVER *** [Td 3c 9s 8d] [4d]
*** SHOW DOWN ***
C0rpsbal: shows [5h Kh] (high card King)
MjLK MAN: shows [7c Ad] (high card Ace)
MjLK MAN collected 237744 from pot
C0rpsbal finished the tournament in 20th place and received $164.76.
*** SUMMARY ***
Total pot 237744 | Rake 0 
Board [Td 3c 9s 8d 4d]
Seat 1: C0rpsbal (small blind) showed [5h Kh] and lost with high card King
Seat 3: MjLK MAN (big blind) showed [7c Ad] and won (237744) with high card Ace
Seat 4: aapetrone91 folded before Flop (didn't bet)
Seat 5: Everbrun11 folded before Flop (didn't bet)
Seat 6: VxVendetta00 (button) folded before Flop (didn't bet)

PokerStars Hand #251210353655: Tournament #3769361908, $52.38+$2.62 USD Hold'em No Limit - Level XXVIII (5000/10000) - 2024/06/26 23:31:24 UTC [2024/06/26 19:31:24 ET]
Table '3769361908 4' 6-max Seat #3 is the button
Seat 3: MjLK MAN (365599 in chips) 
Seat 4: aapetrone91 (186098 in chips) 
Seat 5: Everbrun11 (281399 in chips) 
Seat 6: VxVendetta00 (108470 in chips) 
MjLK MAN: posts the ante 2500
aapetrone91: posts the ante 2500
Everbrun11: posts the ante 2500
VxVendetta00: posts the ante 2500
aapetrone91: posts small blind 5000
Everbrun11: posts big blind 10000
*** HOLE CARDS ***
VxVendetta00: raises 95970 to 105970 and is all-in
MjLK MAN: folds 
aapetrone91: folds 
Everbrun11: folds 
Uncalled bet (95970) returned to VxVendetta00
VxVendetta00 collected 35000 from pot
*** SUMMARY ***
Total pot 35000 | Rake 0 
Seat 3: MjLK MAN (button) folded before Flop (didn't bet)
Seat 4: aapetrone91 (small blind) folded before Flop
Seat 5: Everbrun11 (big blind) folded before Flop
Seat 6: VxVendetta00 collected (35000)

PokerStars Hand #251210355938: Tournament #3769361908, $52.38+$2.62 USD Hold'em No Limit - Level XXVIII (5000/10000) - 2024/06/26 23:31:36 UTC [2024/06/26 19:31:36 ET]
Table '3769361908 4' 6-max Seat #4 is the button
Seat 3: MjLK MAN (363099 in chips) 
Seat 4: aapetrone91 (178598 in chips) 
Seat 5: Everbrun11 (268899 in chips) 
Seat 6: VxVendetta00 (130970 in chips) 
MjLK MAN: posts the ante 2500
aapetrone91: posts the ante 2500
Everbrun11: posts the ante 2500
VxVendetta00: posts the ante 2500
Everbrun11: posts small blind 5000
VxVendetta00: posts big blind 10000
*** HOLE CARDS ***
MjLK MAN: raises 10000 to 20000
aapetrone91: raises 30000 to 50000
Everbrun11: folds 
VxVendetta00: folds 
MjLK MAN: calls 30000
*** FLOP *** [Qc 8s 2d]
MjLK MAN: checks 
aapetrone91: bets 27500
MjLK MAN: calls 27500
*** TURN *** [Qc 8s 2d] [3s]
MjLK MAN: checks 
aapetrone91: bets 98598 and is all-in
MjLK MAN: calls 98598
*** RIVER *** [Qc 8s 2d 3s] [9d]
*** SHOW DOWN ***
MjLK MAN: shows [Ah Ad] (a pair of Aces)
aapetrone91: shows [Jh Jc] (a pair of Jacks)
MjLK MAN collected 377196 from pot
aapetrone91 finished the tournament in 18th place and received $164.76.
*** SUMMARY ***
Total pot 377196 | Rake 0 
Board [Qc 8s 2d 3s 9d]
Seat 3: MjLK MAN showed [Ah Ad] and won (377196) with a pair of Aces
Seat 4: aapetrone91 (button) showed [Jh Jc] and lost with a pair of Jacks
Seat 5: Everbrun11 (small blind) folded before Flop
Seat 6: VxVendetta00 (big blind) folded before Flop

PokerStars Hand #251210372977: Tournament #3769361908, $52.38+$2.62 USD Hold'em No Limit - Level XXIX (6000/12000) - 2024/06/26 23:33:03 UTC [2024/06/26 19:33:03 ET]
Table '3769361908 4' 6-max Seat #5 is the button
Seat 1: DR. ELDAR (193614 in chips) 
Seat 2: mila is best (32638 in chips) 
Seat 3: MjLK MAN (561697 in chips) 
Seat 5: Everbrun11 (261399 in chips) 
Seat 6: VxVendetta00 (118470 in chips) 
DR. ELDAR: posts the ante 3000
mila is best: posts the ante 3000
MjLK MAN: posts the ante 3000
Everbrun11: posts the ante 3000
VxVendetta00: posts the ante 3000
VxVendetta00: posts small blind 6000
DR. ELDAR: posts big blind 12000
*** HOLE CARDS ***
mila is best: folds 
MjLK MAN: raises 12000 to 24000
Everbrun11: folds 
VxVendetta00: folds 
DR. ELDAR: raises 166614 to 190614 and is all-in
MjLK MAN: folds 
Uncalled bet (166614) returned to DR. ELDAR
DR. ELDAR collected 69000 from pot
DR. ELDAR: doesn't show hand 
*** SUMMARY ***
Total pot 69000 | Rake 0 
Seat 1: DR. ELDAR (big blind) collected (69000)
Seat 2: mila is best folded before Flop (didn't bet)
Seat 3: MjLK MAN folded before Flop
Seat 5: Everbrun11 (button) folded before Flop (didn't bet)
Seat 6: VxVendetta00 (small blind) folded before Flop

PokerStars Hand #251210378494: Tournament #3769361908, $52.38+$2.62 USD Hold'em No Limit - Level XXIX (6000/12000) - 2024/06/26 23:33:31 UTC [2024/06/26 19:33:31 ET]
Table '3769361908 4' 6-max Seat #6 is the button
Seat 1: DR. ELDAR (235614 in chips) 
Seat 2: mila is best (29638 in chips) 
Seat 3: MjLK MAN (534697 in chips) 
Seat 5: Everbrun11 (258399 in chips) 
Seat 6: VxVendetta00 (109470 in chips) 
DR. ELDAR: posts the ante 3000
mila is best: posts the ante 3000
MjLK MAN: posts the ante 3000
Everbrun11: posts the ante 3000
VxVendetta00: posts the ante 3000
DR. ELDAR: posts small blind 6000
mila is best: posts big blind 12000
*** HOLE CARDS ***
MjLK MAN: folds 
Everbrun11: raises 12000 to 24000
VxVendetta00: folds 
DR. ELDAR: folds 
mila is best: raises 2638 to 26638 and is all-in
Everbrun11: calls 2638
*** FLOP *** [5d Qd Ks]
*** TURN *** [5d Qd Ks] [3d]
*** RIVER *** [5d Qd Ks 3d] [Js]
*** SHOW DOWN ***
mila is best: shows [Ts Td] (a pair of Tens)
Everbrun11: shows [Qh As] (a pair of Queens)
Everbrun11 collected 74276 from pot
mila is best finished the tournament in 17th place and received $200.15.
*** SUMMARY ***
Total pot 74276 | Rake 0 
Board [5d Qd Ks 3d Js]
Seat 1: DR. ELDAR (small blind) folded before Flop
Seat 2: mila is best (big blind) showed [Ts Td] and lost with a pair of Tens
Seat 3: MjLK MAN folded before Flop (didn't bet)
Seat 5: Everbrun11 showed [Qh As] and won (74276) with a pair of Queens
Seat 6: VxVendetta00 (button) folded before Flop (didn't bet)

PokerStars Hand #251210383372: Tournament #3769361908, $52.38+$2.62 USD Hold'em No Limit - Level XXIX (6000/12000) - 2024/06/26 23:33:55 UTC [2024/06/26 19:33:55 ET]
Table '3769361908 4' 6-max Seat #1 is the button
Seat 1: DR. ELDAR (226614 in chips) 
Seat 3: MjLK MAN (531697 in chips) 
Seat 5: Everbrun11 (303037 in chips) 
Seat 6: VxVendetta00 (106470 in chips) 
DR. ELDAR: posts the ante 3000
MjLK MAN: posts the ante 3000
Everbrun11: posts the ante 3000
VxVendetta00: posts the ante 3000
MjLK MAN: posts small blind 6000
Everbrun11: posts big blind 12000
*** HOLE CARDS ***
Muril0souza is disconnected 
VxVendetta00: folds 
DR. ELDAR: folds 
MjLK MAN: raises 24000 to 36000
Everbrun11: folds 
Uncalled bet (24000) returned to MjLK MAN
MjLK MAN collected 36000 from pot
MjLK MAN: doesn't show hand 
*** SUMMARY ***
Total pot 36000 | Rake 0 
Seat 1: DR. ELDAR (button) folded before Flop (didn't bet)
Seat 3: MjLK MAN (small blind) collected (36000)
Seat 5: Everbrun11 (big blind) folded before Flop
Seat 6: VxVendetta00 folded before Flop (didn't bet)

PokerStars Hand #251210387413: Tournament #3769361908, $52.38+$2.62 USD Hold'em No Limit - Level XXIX (6000/12000) - 2024/06/26 23:34:15 UTC [2024/06/26 19:34:15 ET]
Table '3769361908 4' 6-max Seat #3 is the button
Seat 1: DR. ELDAR (223614 in chips) 
Seat 3: MjLK MAN (552697 in chips) 
Seat 4: Muril0souza (90798 in chips) out of hand (moved from another table into small blind)
Seat 5: Everbrun11 (288037 in chips) 
Seat 6: VxVendetta00 (103470 in chips) 
Muril0souza will be allowed to play after the button
DR. ELDAR: posts the ante 3000
MjLK MAN: posts the ante 3000
Everbrun11: posts the ante 3000
VxVendetta00: posts the ante 3000
Everbrun11: posts small blind 6000
VxVendetta00: posts big blind 12000
*** HOLE CARDS ***
DR. ELDAR: folds 
MjLK MAN: raises 537697 to 549697 and is all-in
Everbrun11: folds 
VxVendetta00: folds 
Uncalled bet (537697) returned to MjLK MAN
MjLK MAN collected 42000 from pot
MjLK MAN: doesn't show hand 
*** SUMMARY ***
Total pot 42000 | Rake 0 
Seat 1: DR. ELDAR folded before Flop (didn't bet)
Seat 3: MjLK MAN (button) collected (42000)
Seat 5: Everbrun11 (small blind) folded before Flop
Seat 6: VxVendetta00 (big blind) folded before Flop

PokerStars Hand #251210389844: Tournament #3769361908, $52.38+$2.62 USD Hold'em No Limit - Level XXIX (6000/12000) - 2024/06/26 23:34:27 UTC [2024/06/26 19:34:27 ET]
Table '3769361908 4' 6-max Seat #5 is the button
Seat 1: DR. ELDAR (220614 in chips) 
Seat 3: MjLK MAN (579697 in chips) 
Seat 4: Muril0souza (90798 in chips) 
Seat 5: Everbrun11 (279037 in chips) 
Seat 6: VxVendetta00 (88470 in chips) 
DR. ELDAR: posts the ante 3000
MjLK MAN: posts the ante 3000
Muril0souza: posts the ante 3000
Everbrun11: posts the ante 3000
VxVendetta00: posts the ante 3000
VxVendetta00: posts small blind 6000
DR. ELDAR: posts big blind 12000
*** HOLE CARDS ***
MjLK MAN: folds 
Muril0souza: raises 75798 to 87798 and is all-in
Everbrun11: folds 
VxVendetta00: folds 
DR. ELDAR: folds 
Uncalled bet (75798) returned to Muril0souza
Muril0souza collected 45000 from pot
*** SUMMARY ***
Total pot 45000 | Rake 0 
Seat 1: DR. ELDAR (big blind) folded before Flop
Seat 3: MjLK MAN folded before Flop (didn't bet)
Seat 4: Muril0souza collected (45000)
Seat 5: Everbrun11 (button) folded before Flop (didn't bet)
Seat 6: VxVendetta00 (small blind) folded before Flop

PokerStars Hand #251210392858: Tournament #3769361908, $52.38+$2.62 USD Hold'em No Limit - Level XXIX (6000/12000) - 2024/06/26 23:34:42 UTC [2024/06/26 19:34:42 ET]
Table '3769361908 4' 6-max Seat #6 is the button
Seat 1: DR. ELDAR (205614 in chips) 
Seat 3: MjLK MAN (576697 in chips) 
Seat 4: Muril0souza (120798 in chips) 
Seat 5: Everbrun11 (276037 in chips) 
Seat 6: VxVendetta00 (79470 in chips) 
DR. ELDAR: posts the ante 3000
MjLK MAN: posts the ante 3000
Muril0souza: posts the ante 3000
Everbrun11: posts the ante 3000
VxVendetta00: posts the ante 3000
DR. ELDAR: posts small blind 6000
MjLK MAN: posts big blind 12000
*** HOLE CARDS ***
Muril0souza: raises 105798 to 117798 and is all-in
Everbrun11: folds 
VxVendetta00: folds 
DR. ELDAR: folds 
MjLK MAN: folds 
Uncalled bet (105798) returned to Muril0souza
Muril0souza collected 45000 from pot
*** SUMMARY ***
Total pot 45000 | Rake 0 
Seat 1: DR. ELDAR (small blind) folded before Flop
Seat 3: MjLK MAN (big blind) folded before Flop
Seat 4: Muril0souza collected (45000)
Seat 5: Everbrun11 folded before Flop (didn't bet)
Seat 6: VxVendetta00 (button) folded before Flop (didn't bet)

PokerStars Hand #251210397751: Tournament #3769361908, $52.38+$2.62 USD Hold'em No Limit - Level XXIX (6000/12000) - 2024/06/26 23:35:07 UTC [2024/06/26 19:35:07 ET]
Table '3769361908 4' 6-max Seat #1 is the button
Seat 1: DR. ELDAR (196614 in chips) 
Seat 3: MjLK MAN (561697 in chips) 
Seat 4: Muril0souza (150798 in chips) 
Seat 5: Everbrun11 (273037 in chips) 
Seat 6: VxVendetta00 (76470 in chips) 
DR. ELDAR: posts the ante 3000
MjLK MAN: posts the ante 3000
Muril0souza: posts the ante 3000
Everbrun11: posts the ante 3000
VxVendetta00: posts the ante 3000
MjLK MAN: posts small blind 6000
Muril0souza: posts big blind 12000
*** HOLE CARDS ***
Everbrun11: folds 
VxVendetta00: folds 
DR. ELDAR: folds 
MjLK MAN: folds 
Uncalled bet (6000) returned to Muril0souza
Muril0souza collected 27000 from pot
*** SUMMARY ***
Total pot 27000 | Rake 0 
Seat 1: DR. ELDAR (button) folded before Flop (didn't bet)
Seat 3: MjLK MAN (small blind) folded before Flop
Seat 4: Muril0souza (big blind) collected (27000)
Seat 5: Everbrun11 folded before Flop (didn't bet)
Seat 6: VxVendetta00 folded before Flop (didn't bet)

PokerStars Hand #251210402684: Tournament #3769361908, $52.38+$2.62 USD Hold'em No Limit - Level XXX (8000/16000) - 2024/06/26 23:35:32 UTC [2024/06/26 19:35:32 ET]
Table '3769361908 4' 6-max Seat #3 is the button
Seat 1: DR. ELDAR (193614 in chips) 
Seat 3: MjLK MAN (552697 in chips) 
Seat 4: Muril0souza (168798 in chips) 
Seat 5: Everbrun11 (270037 in chips) 
Seat 6: VxVendetta00 (73470 in chips) 
DR. ELDAR: posts the ante 4000
MjLK MAN: posts the ante 4000
Muril0souza: posts the ante 4000
Everbrun11: posts the ante 4000
VxVendetta00: posts the ante 4000
Muril0souza: posts small blind 8000
Everbrun11: posts big blind 16000
*** HOLE CARDS ***
VxVendetta00: folds 
DR. ELDAR: raises 173614 to 189614 and is all-in
MjLK MAN: folds 
Muril0souza: folds 
Everbrun11: folds 
Uncalled bet (173614) returned to DR. ELDAR
DR. ELDAR collected 60000 from pot
DR. ELDAR: doesn't show hand 
*** SUMMARY ***
Total pot 60000 | Rake 0 
Seat 1: DR. ELDAR collected (60000)
Seat 3: MjLK MAN (button) folded before Flop (didn't bet)
Seat 4: Muril0souza (small blind) folded before Flop
Seat 5: Everbrun11 (big blind) folded before Flop
Seat 6: VxVendetta00 folded before Flop (didn't bet)

PokerStars Hand #251210408160: Tournament #3769361908, $52.38+$2.62 USD Hold'em No Limit - Level XXX (8000/16000) - 2024/06/26 23:36:00 UTC [2024/06/26 19:36:00 ET]
Table '3769361908 4' 6-max Seat #4 is the button
Seat 1: DR. ELDAR (233614 in chips) 
Seat 3: MjLK MAN (548697 in chips) 
Seat 4: Muril0souza (156798 in chips) 
Seat 5: Everbrun11 (250037 in chips) 
Seat 6: VxVendetta00 (69470 in chips) 
DR. ELDAR: posts the ante 4000
MjLK MAN: posts the ante 4000
Muril0souza: posts the ante 4000
Everbrun11: posts the ante 4000
VxVendetta00: posts the ante 4000
Everbrun11: posts small blind 8000
VxVendetta00: posts big blind 16000
*** HOLE CARDS ***
DR. ELDAR: folds 
MjLK MAN: folds 
Muril0souza: raises 136798 to 152798 and is all-in
Everbrun11: folds 
VxVendetta00: folds 
Uncalled bet (136798) returned to Muril0souza
Muril0souza collected 60000 from pot
*** SUMMARY ***
Total pot 60000 | Rake 0 
Seat 1: DR. ELDAR folded before Flop (didn't bet)
Seat 3: MjLK MAN folded before Flop (didn't bet)
Seat 4: Muril0souza (button) collected (60000)
Seat 5: Everbrun11 (small blind) folded before Flop
Seat 6: VxVendetta00 (big blind) folded before Flop

PokerStars Hand #251210411163: Tournament #3769361908, $52.38+$2.62 USD Hold'em No Limit - Level XXX (8000/16000) - 2024/06/26 23:36:14 UTC [2024/06/26 19:36:14 ET]
Table '3769361908 4' 6-max Seat #5 is the button
Seat 1: DR. ELDAR (229614 in chips) 
Seat 3: MjLK MAN (544697 in chips) 
Seat 4: Muril0souza (196798 in chips) 
Seat 5: Everbrun11 (238037 in chips) 
Seat 6: VxVendetta00 (49470 in chips) 
DR. ELDAR: posts the ante 4000
MjLK MAN: posts the ante 4000
Muril0souza: posts the ante 4000
Everbrun11: posts the ante 4000
VxVendetta00: posts the ante 4000
VxVendetta00: posts small blind 8000
DR. ELDAR: posts big blind 16000
*** HOLE CARDS ***
MjLK MAN: folds 
Muril0souza: folds 
Everbrun11: folds 
VxVendetta00: raises 29470 to 45470 and is all-in
DR. ELDAR: calls 29470
*** FLOP *** [6d 8s Ah]
*** TURN *** [6d 8s Ah] [5h]
*** RIVER *** [6d 8s Ah 5h] [Ac]
*** SHOW DOWN ***
VxVendetta00: shows [8h Qc] (two pair, Aces and Eights)
DR. ELDAR: shows [As 3h] (three of a kind, Aces)
DR. ELDAR collected 110940 from pot
VxVendetta00 finished the tournament in 13th place and received $243.14.
*** SUMMARY ***
Total pot 110940 | Rake 0 
Board [6d 8s Ah 5h Ac]
Seat 1: DR. ELDAR (big blind) showed [As 3h] and won (110940) with three of a kind, Aces
Seat 3: MjLK MAN folded before Flop (didn't bet)
Seat 4: Muril0souza folded before Flop (didn't bet)
Seat 5: Everbrun11 (button) folded before Flop (didn't bet)
Seat 6: VxVendetta00 (small blind) showed [8h Qc] and lost with two pair, Aces and Eights






PokerStars Hand #251209099115: Tournament #3769361908, $52.38+$2.62 USD Hold'em No Limit - Level II (30/60) - 2024/06/26 22:05:55 UTC [2024/06/26 18:05:55 ET]
Table '3769361908 1' 6-max Seat #5 is the button
Seat 1: 67KOSTAS (10108 in chips) 
Seat 2: jessecesar (8748 in chips) 
Seat 3: sinister778 (9985 in chips) 
Seat 4: mehditheboss (10144 in chips) 
Seat 5: lidi77777 (11373 in chips) 
Seat 6: Link_fNK (9913 in chips) 
67KOSTAS: posts the ante 15
jessecesar: posts the ante 15
sinister778: posts the ante 15
mehditheboss: posts the ante 15
lidi77777: posts the ante 15
Link_fNK: posts the ante 15
Link_fNK: posts small blind 30
67KOSTAS: posts big blind 60
*** HOLE CARDS ***
jessecesar: folds 
sinister778: folds 
mehditheboss: folds 
lidi77777: raises 60 to 120
Link_fNK: raises 420 to 540
67KOSTAS: folds 
lidi77777: folds 
Uncalled bet (420) returned to Link_fNK
Link_fNK collected 390 from pot
Link_fNK: doesn't show hand 
*** SUMMARY ***
Total pot 390 | Rake 0 
Seat 1: 67KOSTAS (big blind) folded before Flop
Seat 2: jessecesar folded before Flop (didn't bet)
Seat 3: sinister778 folded before Flop (didn't bet)
Seat 4: mehditheboss folded before Flop (didn't bet)
Seat 5: lidi77777 (button) folded before Flop
Seat 6: Link_fNK (small blind) collected (390)

PokerStars Hand #251209107040: Tournament #3769361908, $52.38+$2.62 USD Hold'em No Limit - Level II (30/60) - 2024/06/26 22:06:22 UTC [2024/06/26 18:06:22 ET]
Table '3769361908 1' 6-max Seat #6 is the button
Seat 1: 67KOSTAS (10033 in chips) 
Seat 3: sinister778 (9970 in chips) 
Seat 4: mehditheboss (10129 in chips) 
Seat 5: lidi77777 (11238 in chips) 
Seat 6: Link_fNK (10168 in chips) 
67KOSTAS: posts the ante 15
sinister778: posts the ante 15
mehditheboss: posts the ante 15
lidi77777: posts the ante 15
Link_fNK: posts the ante 15
67KOSTAS: posts small blind 30
sinister778: posts big blind 60
*** HOLE CARDS ***
mehditheboss: raises 72 to 132
lidi77777: calls 132
Link_fNK: folds 
67KOSTAS: folds 
sinister778: calls 72
*** FLOP *** [3c 4s Ac]
sinister778: checks 
mehditheboss: bets 160
clareou0408 is disconnected 
lidi77777: calls 160
sinister778: folds 
*** TURN *** [3c 4s Ac] [2s]
mehditheboss: checks 
lidi77777: bets 471
mehditheboss: calls 471
*** RIVER *** [3c 4s Ac 2s] [9d]
mehditheboss: checks 
lidi77777: checks 
*** SHOW DOWN ***
mehditheboss: shows [Td Ah] (a pair of Aces)
lidi77777: shows [Ad Jd] (a pair of Aces - Jack kicker)
lidi77777 collected 1763 from pot
*** SUMMARY ***
Total pot 1763 | Rake 0 
Board [3c 4s Ac 2s 9d]
Seat 1: 67KOSTAS (small blind) folded before Flop
Seat 3: sinister778 (big blind) folded on the Flop
Seat 4: mehditheboss showed [Td Ah] and lost with a pair of Aces
Seat 5: lidi77777 showed [Ad Jd] and won (1763) with a pair of Aces
Seat 6: Link_fNK (button) folded before Flop (didn't bet)

PokerStars Hand #251209122496: Tournament #3769361908, $52.38+$2.62 USD Hold'em No Limit - Level II (30/60) - 2024/06/26 22:07:15 UTC [2024/06/26 18:07:15 ET]
Table '3769361908 1' 6-max Seat #1 is the button
Seat 1: 67KOSTAS (9988 in chips) 
Seat 2: clareou0408 (10000 in chips) out of hand (moved from another table into small blind)
Seat 3: sinister778 (9823 in chips) 
Seat 4: mehditheboss (9351 in chips) 
Seat 5: lidi77777 (12223 in chips) 
Seat 6: Link_fNK (10153 in chips) 
clareou0408 will be allowed to play after the button
67KOSTAS: posts the ante 15
sinister778: posts the ante 15
mehditheboss: posts the ante 15
lidi77777: posts the ante 15
Link_fNK: posts the ante 15
sinister778: posts small blind 30
mehditheboss: posts big blind 60
*** HOLE CARDS ***
lidi77777: folds 
Link_fNK: folds 
67KOSTAS: raises 120 to 180
sinister778: calls 150
mehditheboss: folds 
*** FLOP *** [3c 2d 9s]
sinister778: checks 
67KOSTAS: checks 
*** TURN *** [3c 2d 9s] [6c]
sinister778: bets 180
67KOSTAS: calls 180
*** RIVER *** [3c 2d 9s 6c] [Qc]
sinister778: bets 488
67KOSTAS: folds 
Uncalled bet (488) returned to sinister778
sinister778 collected 855 from pot
*** SUMMARY ***
Total pot 855 | Rake 0 
Board [3c 2d 9s 6c Qc]
Seat 1: 67KOSTAS (button) folded on the River
Seat 3: sinister778 (small blind) collected (855)
Seat 4: mehditheboss (big blind) folded before Flop
Seat 5: lidi77777 folded before Flop (didn't bet)
Seat 6: Link_fNK folded before Flop (didn't bet)

PokerStars Hand #251209139991: Tournament #3769361908, $52.38+$2.62 USD Hold'em No Limit - Level III (40/80) - 2024/06/26 22:08:15 UTC [2024/06/26 18:08:15 ET]
Table '3769361908 1' 6-max Seat #3 is the button
Seat 1: 67KOSTAS (9613 in chips) 
Seat 2: clareou0408 (10000 in chips) 
Seat 3: sinister778 (10303 in chips) 
Seat 4: mehditheboss (9276 in chips) 
Seat 5: lidi77777 (12208 in chips) 
Seat 6: Link_fNK (10138 in chips) 
67KOSTAS: posts the ante 20
clareou0408: posts the ante 20
sinister778: posts the ante 20
mehditheboss: posts the ante 20
lidi77777: posts the ante 20
Link_fNK: posts the ante 20
mehditheboss: posts small blind 40
lidi77777: posts big blind 80
*** HOLE CARDS ***
Link_fNK: folds 
67KOSTAS: raises 160 to 240
clareou0408: calls 240
sinister778: folds 
mehditheboss: folds 
lidi77777: raises 880 to 1120
67KOSTAS: calls 880
clareou0408: folds 
*** FLOP *** [9c 9s 5c]
lidi77777: bets 1320
67KOSTAS: calls 1320
*** TURN *** [9c 9s 5c] [6c]
lidi77777: bets 9748 and is all-in
67KOSTAS: folds 
Uncalled bet (9748) returned to lidi77777
lidi77777 collected 5280 from pot
*** SUMMARY ***
Total pot 5280 | Rake 0 
Board [9c 9s 5c 6c]
Seat 1: 67KOSTAS folded on the Turn
Seat 2: clareou0408 folded before Flop
Seat 3: sinister778 (button) folded before Flop (didn't bet)
Seat 4: mehditheboss (small blind) folded before Flop
Seat 5: lidi77777 (big blind) collected (5280)
Seat 6: Link_fNK folded before Flop (didn't bet)

PokerStars Hand #251209152459: Tournament #3769361908, $52.38+$2.62 USD Hold'em No Limit - Level III (40/80) - 2024/06/26 22:08:57 UTC [2024/06/26 18:08:57 ET]
Table '3769361908 1' 6-max Seat #4 is the button
Seat 1: 67KOSTAS (7153 in chips) 
Seat 2: clareou0408 (9740 in chips) 
Seat 3: sinister778 (10283 in chips) 
Seat 4: mehditheboss (9216 in chips) 
Seat 5: lidi77777 (15028 in chips) 
Seat 6: Link_fNK (10118 in chips) 
67KOSTAS: posts the ante 20
clareou0408: posts the ante 20
sinister778: posts the ante 20
mehditheboss: posts the ante 20
lidi77777: posts the ante 20
Link_fNK: posts the ante 20
lidi77777: posts small blind 40
Link_fNK: posts big blind 80
*** HOLE CARDS ***
67KOSTAS: folds 
clareou0408: folds 
sinister778: raises 80 to 160
mehditheboss: folds 
lidi77777: folds 
Link_fNK: folds 
Uncalled bet (80) returned to sinister778
sinister778 collected 320 from pot
*** SUMMARY ***
Total pot 320 | Rake 0 
Seat 1: 67KOSTAS folded before Flop (didn't bet)
Seat 2: clareou0408 folded before Flop (didn't bet)
Seat 3: sinister778 collected (320)
Seat 4: mehditheboss (button) folded before Flop (didn't bet)
Seat 5: lidi77777 (small blind) folded before Flop
Seat 6: Link_fNK (big blind) folded before Flop

PokerStars Hand #251209162121: Tournament #3769361908, $52.38+$2.62 USD Hold'em No Limit - Level III (40/80) - 2024/06/26 22:09:30 UTC [2024/06/26 18:09:30 ET]
Table '3769361908 1' 6-max Seat #5 is the button
Seat 1: 67KOSTAS (7133 in chips) 
Seat 2: clareou0408 (9720 in chips) 
Seat 3: sinister778 (10503 in chips) 
Seat 4: mehditheboss (9196 in chips) 
Seat 5: lidi77777 (14968 in chips) 
Seat 6: Link_fNK (10018 in chips) 
67KOSTAS: posts the ante 20
clareou0408: posts the ante 20
sinister778: posts the ante 20
mehditheboss: posts the ante 20
lidi77777: posts the ante 20
Link_fNK: posts the ante 20
Link_fNK: posts small blind 40
67KOSTAS: posts big blind 80
*** HOLE CARDS ***
clareou0408: folds 
sinister778: raises 80 to 160
mehditheboss: calls 160
lidi77777: calls 160
Link_fNK: folds 
67KOSTAS: raises 800 to 960
sinister778: calls 800
mehditheboss: calls 800
lidi77777: calls 800
*** FLOP *** [7c 2d 5d]
67KOSTAS: bets 2000
sinister778: folds 
mehditheboss: calls 2000
lidi77777: raises 5000 to 7000
67KOSTAS: calls 4153 and is all-in
mehditheboss: folds 
Uncalled bet (847) returned to lidi77777
*** TURN *** [7c 2d 5d] [6h]
*** RIVER *** [7c 2d 5d 6h] [As]
*** SHOW DOWN ***
67KOSTAS: shows [9d 9s] (a pair of Nines)
lidi77777: shows [9c 9h] (a pair of Nines)
67KOSTAS collected 9153 from pot
lidi77777 collected 9153 from pot
*** SUMMARY ***
Total pot 18306 | Rake 0 
Board [7c 2d 5d 6h As]
Seat 1: 67KOSTAS (big blind) showed [9d 9s] and won (9153) with a pair of Nines
Seat 2: clareou0408 folded before Flop (didn't bet)
Seat 3: sinister778 folded on the Flop
Seat 4: mehditheboss folded on the Flop
Seat 5: lidi77777 (button) showed [9c 9h] and won (9153) with a pair of Nines
Seat 6: Link_fNK (small blind) folded before Flop

PokerStars Hand #251209182619: Tournament #3769361908, $52.38+$2.62 USD Hold'em No Limit - Level III (40/80) - 2024/06/26 22:10:40 UTC [2024/06/26 18:10:40 ET]
Table '3769361908 1' 6-max Seat #6 is the button
Seat 1: 67KOSTAS (9153 in chips) 
Seat 2: clareou0408 (9700 in chips) 
Seat 3: sinister778 (9523 in chips) 
Seat 4: mehditheboss (6216 in chips) 
Seat 5: lidi77777 (16988 in chips) 
Seat 6: Link_fNK (9958 in chips) 
67KOSTAS: posts the ante 20
clareou0408: posts the ante 20
sinister778: posts the ante 20
mehditheboss: posts the ante 20
lidi77777: posts the ante 20
Link_fNK: posts the ante 20
67KOSTAS: posts small blind 40
clareou0408: posts big blind 80
*** HOLE CARDS ***
sinister778: raises 80 to 160
mehditheboss: raises 6036 to 6196 and is all-in
lidi77777: folds 
Link_fNK: folds 
67KOSTAS: folds 
clareou0408: folds 
sinister778: calls 6036
*** FLOP *** [5h 6c 3s]
*** TURN *** [5h 6c 3s] [Kd]
*** RIVER *** [5h 6c 3s Kd] [Js]
*** SHOW DOWN ***
sinister778: shows [4c 4s] (a pair of Fours)
mehditheboss: shows [Kh Ad] (a pair of Kings)
mehditheboss collected 12632 from pot
*** SUMMARY ***
Total pot 12632 | Rake 0 
Board [5h 6c 3s Kd Js]
Seat 1: 67KOSTAS (small blind) folded before Flop
Seat 2: clareou0408 (big blind) folded before Flop
Seat 3: sinister778 showed [4c 4s] and lost with a pair of Fours
Seat 4: mehditheboss showed [Kh Ad] and won (12632) with a pair of Kings
Seat 5: lidi77777 folded before Flop (didn't bet)
Seat 6: Link_fNK (button) folded before Flop (didn't bet)

PokerStars Hand #251209195289: Tournament #3769361908, $52.38+$2.62 USD Hold'em No Limit - Level IV (50/100) - 2024/06/26 22:11:25 UTC [2024/06/26 18:11:25 ET]
Table '3769361908 1' 6-max Seat #1 is the button
Seat 1: 67KOSTAS (9093 in chips) 
Seat 2: clareou0408 (9600 in chips) 
Seat 3: sinister778 (3307 in chips) 
Seat 4: mehditheboss (12632 in chips) 
Seat 5: lidi77777 (16968 in chips) 
Seat 6: Link_fNK (9938 in chips) 
67KOSTAS: posts the ante 25
clareou0408: posts the ante 25
sinister778: posts the ante 25
mehditheboss: posts the ante 25
lidi77777: posts the ante 25
Link_fNK: posts the ante 25
clareou0408: posts small blind 50
sinister778: posts big blind 100
*** HOLE CARDS ***
mehditheboss: raises 120 to 220
lidi77777: folds 
Link_fNK: folds 
67KOSTAS: raises 740 to 960
clareou0408: folds 
sinister778: folds 
mehditheboss: folds 
Uncalled bet (740) returned to 67KOSTAS
67KOSTAS collected 740 from pot
67KOSTAS: doesn't show hand 
*** SUMMARY ***
Total pot 740 | Rake 0 
Seat 1: 67KOSTAS (button) collected (740)
Seat 2: clareou0408 (small blind) folded before Flop
Seat 3: sinister778 (big blind) folded before Flop
Seat 4: mehditheboss folded before Flop
Seat 5: lidi77777 folded before Flop (didn't bet)
Seat 6: Link_fNK folded before Flop (didn't bet)

PokerStars Hand #251209200398: Tournament #3769361908, $52.38+$2.62 USD Hold'em No Limit - Level IV (50/100) - 2024/06/26 22:11:42 UTC [2024/06/26 18:11:42 ET]
Table '3769361908 1' 6-max Seat #2 is the button
Seat 2: clareou0408 (9525 in chips) 
Seat 3: sinister778 (3182 in chips) 
Seat 4: mehditheboss (12387 in chips) 
Seat 5: lidi77777 (16943 in chips) 
Seat 6: Link_fNK (9913 in chips) 
clareou0408: posts the ante 25
sinister778: posts the ante 25
mehditheboss: posts the ante 25
lidi77777: posts the ante 25
Link_fNK: posts the ante 25
sinister778: posts small blind 50
mehditheboss: posts big blind 100
*** HOLE CARDS ***
lidi77777: folds 
Link_fNK: folds 
clareou0408: raises 100 to 200
sinister778: calls 150
mehditheboss: folds 
*** FLOP *** [9d Kd 3c]
sinister778: checks 
clareou0408: bets 167
sinister778: calls 167
*** TURN *** [9d Kd 3c] [Td]
sinister778: checks 
clareou0408: checks 
*** RIVER *** [9d Kd 3c Td] [7h]
sinister778: checks 
clareou0408: checks 
*** SHOW DOWN ***
sinister778: shows [9h 8s] (a pair of Nines)
clareou0408: mucks hand 
sinister778 collected 959 from pot
*** SUMMARY ***
Total pot 959 | Rake 0 
Board [9d Kd 3c Td 7h]
Seat 2: clareou0408 (button) mucked
Seat 3: sinister778 (small blind) showed [9h 8s] and won (959) with a pair of Nines
Seat 4: mehditheboss (big blind) folded before Flop
Seat 5: lidi77777 folded before Flop (didn't bet)
Seat 6: Link_fNK folded before Flop (didn't bet)

PokerStars Hand #251209224634: Tournament #3769361908, $52.38+$2.62 USD Hold'em No Limit - Level IV (50/100) - 2024/06/26 22:13:07 UTC [2024/06/26 18:13:07 ET]
Table '3769361908 1' 6-max Seat #3 is the button
Seat 2: clareou0408 (9133 in chips) 
Seat 3: sinister778 (3749 in chips) 
Seat 4: mehditheboss (12262 in chips) 
Seat 5: lidi77777 (16918 in chips) 
Seat 6: Link_fNK (9888 in chips) 
clareou0408: posts the ante 25
sinister778: posts the ante 25
mehditheboss: posts the ante 25
lidi77777: posts the ante 25
Link_fNK: posts the ante 25
mehditheboss: posts small blind 50
lidi77777: posts big blind 100
*** HOLE CARDS ***
Link_fNK: folds 
clareou0408: folds 
sinister778: raises 300 to 400
mehditheboss: folds 
lidi77777: folds 
Uncalled bet (300) returned to sinister778
sinister778 collected 375 from pot
*** SUMMARY ***
Total pot 375 | Rake 0 
Seat 2: clareou0408 folded before Flop (didn't bet)
Seat 3: sinister778 (button) collected (375)
Seat 4: mehditheboss (small blind) folded before Flop
Seat 5: lidi77777 (big blind) folded before Flop
Seat 6: Link_fNK folded before Flop (didn't bet)

PokerStars Hand #251209231236: Tournament #3769361908, $52.38+$2.62 USD Hold'em No Limit - Level IV (50/100) - 2024/06/26 22:13:30 UTC [2024/06/26 18:13:30 ET]
Table '3769361908 1' 6-max Seat #4 is the button
Seat 2: clareou0408 (9108 in chips) 
Seat 3: sinister778 (3999 in chips) 
Seat 4: mehditheboss (12187 in chips) 
Seat 5: lidi77777 (16793 in chips) 
Seat 6: Link_fNK (9863 in chips) 
clareou0408: posts the ante 25
sinister778: posts the ante 25
mehditheboss: posts the ante 25
lidi77777: posts the ante 25
Link_fNK: posts the ante 25
lidi77777: posts small blind 50
Link_fNK: posts big blind 100
*** HOLE CARDS ***
lucaromanoo1 is disconnected 
clareou0408: folds 
sinister778: folds 
mehditheboss: raises 100 to 200
lidi77777: calls 150
Link_fNK: folds 
*** FLOP *** [4d 8d Th]
lidi77777: checks 
mehditheboss: checks 
*** TURN *** [4d 8d Th] [4s]
lidi77777: checks 
mehditheboss: bets 313
lidi77777: raises 626 to 939
mehditheboss: calls 626
*** RIVER *** [4d 8d Th 4s] [Qd]
lidi77777: bets 2452
mehditheboss: folds 
Uncalled bet (2452) returned to lidi77777
lidi77777 collected 2503 from pot
*** SUMMARY ***
Total pot 2503 | Rake 0 
Board [4d 8d Th 4s Qd]
Seat 2: clareou0408 folded before Flop (didn't bet)
Seat 3: sinister778 folded before Flop (didn't bet)
Seat 4: mehditheboss (button) folded on the River
Seat 5: lidi77777 (small blind) collected (2503)
Seat 6: Link_fNK (big blind) folded before Flop

PokerStars Hand #251209252257: Tournament #3769361908, $52.38+$2.62 USD Hold'em No Limit - Level V (60/120) - 2024/06/26 22:14:43 UTC [2024/06/26 18:14:43 ET]
Table '3769361908 1' 6-max Seat #5 is the button
Seat 1: lucaromanoo1 (10000 in chips) 
Seat 2: clareou0408 (9083 in chips) 
Seat 3: sinister778 (3974 in chips) 
Seat 4: mehditheboss (11023 in chips) 
Seat 5: lidi77777 (18132 in chips) 
Seat 6: Link_fNK (9738 in chips) 
lucaromanoo1: posts the ante 30
clareou0408: posts the ante 30
sinister778: posts the ante 30
mehditheboss: posts the ante 30
lidi77777: posts the ante 30
Link_fNK: posts the ante 30
Link_fNK: posts small blind 60
lucaromanoo1: posts big blind 120
*** HOLE CARDS ***
clareou0408: folds 
sinister778: folds 
mehditheboss: folds 
lidi77777: folds 
Link_fNK: raises 300 to 420
lucaromanoo1: calls 300
*** FLOP *** [Kc 2s 7s]
Link_fNK: bets 229
lucaromanoo1: calls 229
*** TURN *** [Kc 2s 7s] [8c]
Link_fNK: bets 1050
lucaromanoo1: calls 1050
*** RIVER *** [Kc 2s 7s 8c] [Js]
Link_fNK: checks 
lucaromanoo1: bets 8271 and is all-in
Link_fNK: folds 
Uncalled bet (8271) returned to lucaromanoo1
lucaromanoo1 collected 3578 from pot
lucaromanoo1: doesn't show hand 
*** SUMMARY ***
Total pot 3578 | Rake 0 
Board [Kc 2s 7s 8c Js]
Seat 1: lucaromanoo1 (big blind) collected (3578)
Seat 2: clareou0408 folded before Flop (didn't bet)
Seat 3: sinister778 folded before Flop (didn't bet)
Seat 4: mehditheboss folded before Flop (didn't bet)
Seat 5: lidi77777 (button) folded before Flop (didn't bet)
Seat 6: Link_fNK (small blind) folded on the River

PokerStars Hand #251209283203: Tournament #3769361908, $52.38+$2.62 USD Hold'em No Limit - Level V (60/120) - 2024/06/26 22:16:33 UTC [2024/06/26 18:16:33 ET]
Table '3769361908 1' 6-max Seat #6 is the button
Seat 1: lucaromanoo1 (11849 in chips) 
Seat 2: clareou0408 (9053 in chips) 
Seat 3: sinister778 (3944 in chips) 
Seat 4: mehditheboss (10993 in chips) 
Seat 5: lidi77777 (18102 in chips) 
Seat 6: Link_fNK (8009 in chips) 
lucaromanoo1: posts the ante 30
clareou0408: posts the ante 30
sinister778: posts the ante 30
mehditheboss: posts the ante 30
lidi77777: posts the ante 30
Link_fNK: posts the ante 30
lucaromanoo1: posts small blind 60
clareou0408: posts big blind 120
*** HOLE CARDS ***
sinister778: raises 120 to 240
mehditheboss: folds 
lidi77777: folds 
Link_fNK: raises 600 to 840
lucaromanoo1: folds 
clareou0408: folds 
sinister778: folds 
Uncalled bet (600) returned to Link_fNK
Link_fNK collected 840 from pot
Link_fNK: doesn't show hand 
*** SUMMARY ***
Total pot 840 | Rake 0 
Seat 1: lucaromanoo1 (small blind) folded before Flop
Seat 2: clareou0408 (big blind) folded before Flop
Seat 3: sinister778 folded before Flop
Seat 4: mehditheboss folded before Flop (didn't bet)
Seat 5: lidi77777 folded before Flop (didn't bet)
Seat 6: Link_fNK (button) collected (840)

PokerStars Hand #251209293039: Tournament #3769361908, $52.38+$2.62 USD Hold'em No Limit - Level V (60/120) - 2024/06/26 22:17:08 UTC [2024/06/26 18:17:08 ET]
Table '3769361908 1' 6-max Seat #1 is the button
Seat 1: lucaromanoo1 (11759 in chips) 
Seat 2: clareou0408 (8903 in chips) 
Seat 3: sinister778 (3674 in chips) 
Seat 4: mehditheboss (10963 in chips) 
Seat 5: lidi77777 (18072 in chips) 
Seat 6: Link_fNK (8579 in chips) 
lucaromanoo1: posts the ante 30
clareou0408: posts the ante 30
sinister778: posts the ante 30
mehditheboss: posts the ante 30
lidi77777: posts the ante 30
Link_fNK: posts the ante 30
clareou0408: posts small blind 60
sinister778: posts big blind 120
*** HOLE CARDS ***
mehditheboss: raises 120 to 240
lidi77777: folds 
Link_fNK: calls 240
lucaromanoo1: folds 
clareou0408: folds 
sinister778: raises 720 to 960
mehditheboss: folds 
Link_fNK: folds 
Uncalled bet (720) returned to sinister778
sinister778 collected 960 from pot
*** SUMMARY ***
Total pot 960 | Rake 0 
Seat 1: lucaromanoo1 (button) folded before Flop (didn't bet)
Seat 2: clareou0408 (small blind) folded before Flop
Seat 3: sinister778 (big blind) collected (960)
Seat 4: mehditheboss folded before Flop
Seat 5: lidi77777 folded before Flop (didn't bet)
Seat 6: Link_fNK folded before Flop

PokerStars Hand #251209300839: Tournament #3769361908, $52.38+$2.62 USD Hold'em No Limit - Level VI (80/160) - 2024/06/26 22:17:35 UTC [2024/06/26 18:17:35 ET]
Table '3769361908 1' 6-max Seat #2 is the button
Seat 1: lucaromanoo1 (11729 in chips) 
Seat 2: clareou0408 (8813 in chips) 
Seat 3: sinister778 (4364 in chips) 
Seat 4: mehditheboss (10693 in chips) 
Seat 5: lidi77777 (18042 in chips) 
Seat 6: Link_fNK (8309 in chips) 
lucaromanoo1: posts the ante 40
clareou0408: posts the ante 40
sinister778: posts the ante 40
mehditheboss: posts the ante 40
lidi77777: posts the ante 40
Link_fNK: posts the ante 40
sinister778: posts small blind 80
mehditheboss: posts big blind 160
*** HOLE CARDS ***
lidi77777: folds 
Link_fNK: folds 
lucaromanoo1: raises 192 to 352
clareou0408: calls 352
sinister778: folds 
mehditheboss: calls 192
*** FLOP *** [4s 9c Ah]
mehditheboss: checks 
lucaromanoo1: bets 440
clareou0408: calls 440
mehditheboss: raises 863 to 1303
lucaromanoo1: calls 863
clareou0408: folds 
*** TURN *** [4s 9c Ah] [6h]
mehditheboss: bets 2560
lucaromanoo1: calls 2560
*** RIVER *** [4s 9c Ah 6h] [Kd]
mehditheboss: bets 6438 and is all-in
lucaromanoo1: folds 
Uncalled bet (6438) returned to mehditheboss
mehditheboss collected 9542 from pot
mehditheboss: doesn't show hand 
*** SUMMARY ***
Total pot 9542 | Rake 0 
Board [4s 9c Ah 6h Kd]
Seat 1: lucaromanoo1 folded on the River
Seat 2: clareou0408 (button) folded on the Flop
Seat 3: sinister778 (small blind) folded before Flop
Seat 4: mehditheboss (big blind) collected (9542)
Seat 5: lidi77777 folded before Flop (didn't bet)
Seat 6: Link_fNK folded before Flop (didn't bet)

PokerStars Hand #251209330006: Tournament #3769361908, $52.38+$2.62 USD Hold'em No Limit - Level VI (80/160) - 2024/06/26 22:19:19 UTC [2024/06/26 18:19:19 ET]
Table '3769361908 1' 6-max Seat #3 is the button
Seat 1: lucaromanoo1 (7474 in chips) 
Seat 2: clareou0408 (7981 in chips) 
Seat 3: sinister778 (4244 in chips) 
Seat 4: mehditheboss (15980 in chips) 
Seat 5: lidi77777 (18002 in chips) 
Seat 6: Link_fNK (8269 in chips) 
lucaromanoo1: posts the ante 40
clareou0408: posts the ante 40
sinister778: posts the ante 40
mehditheboss: posts the ante 40
lidi77777: posts the ante 40
Link_fNK: posts the ante 40
mehditheboss: posts small blind 80
lidi77777: posts big blind 160
*** HOLE CARDS ***
Link_fNK: folds 
lucaromanoo1: raises 160 to 320
clareou0408: folds 
sinister778: folds 
mehditheboss: folds 
lidi77777: calls 160
*** FLOP *** [Ac Ts 2s]
lidi77777: checks 
lucaromanoo1: bets 560
lidi77777: calls 560
*** TURN *** [Ac Ts 2s] [2d]
lidi77777: checks 
lucaromanoo1: bets 1680
lidi77777: calls 1680
*** RIVER *** [Ac Ts 2s 2d] [Js]
lidi77777: checks 
lucaromanoo1: bets 4874 and is all-in
lidi77777: calls 4874
*** SHOW DOWN ***
lucaromanoo1: shows [Ad Qd] (two pair, Aces and Deuces)
lidi77777: shows [9h As] (two pair, Aces and Deuces - lower kicker)
lucaromanoo1 collected 15188 from pot
*** SUMMARY ***
Total pot 15188 | Rake 0 
Board [Ac Ts 2s 2d Js]
Seat 1: lucaromanoo1 showed [Ad Qd] and won (15188) with two pair, Aces and Deuces
Seat 2: clareou0408 folded before Flop (didn't bet)
Seat 3: sinister778 (button) folded before Flop (didn't bet)
Seat 4: mehditheboss (small blind) folded before Flop
Seat 5: lidi77777 (big blind) showed [9h As] and lost with two pair, Aces and Deuces
Seat 6: Link_fNK folded before Flop (didn't bet)

PokerStars Hand #251209348754: Tournament #3769361908, $52.38+$2.62 USD Hold'em No Limit - Level VII (100/200) - 2024/06/26 22:20:27 UTC [2024/06/26 18:20:27 ET]
Table '3769361908 1' 6-max Seat #4 is the button
Seat 1: lucaromanoo1 (15188 in chips) 
Seat 3: sinister778 (4204 in chips) 
Seat 4: mehditheboss (15860 in chips) 
Seat 5: lidi77777 (10528 in chips) 
Seat 6: Link_fNK (8229 in chips) 
lucaromanoo1: posts the ante 50
sinister778: posts the ante 50
mehditheboss: posts the ante 50
lidi77777: posts the ante 50
Link_fNK: posts the ante 50
lidi77777: posts small blind 100
Link_fNK: posts big blind 200
*** HOLE CARDS ***
lucaromanoo1: raises 200 to 400
sinister778: folds 
mehditheboss: folds 
lidi77777: calls 300
Link_fNK: folds 
*** FLOP *** [3h 4h 5d]
lidi77777: checks 
lucaromanoo1: bets 400
lidi77777: raises 1225 to 1625
lucaromanoo1: folds 
Uncalled bet (1225) returned to lidi77777
lidi77777 collected 2050 from pot
*** SUMMARY ***
Total pot 2050 | Rake 0 
Board [3h 4h 5d]
Seat 1: lucaromanoo1 folded on the Flop
Seat 3: sinister778 folded before Flop (didn't bet)
Seat 4: mehditheboss (button) folded before Flop (didn't bet)
Seat 5: lidi77777 (small blind) collected (2050)
Seat 6: Link_fNK (big blind) folded before Flop

PokerStars Hand #251209356462: Tournament #3769361908, $52.38+$2.62 USD Hold'em No Limit - Level VII (100/200) - 2024/06/26 22:20:54 UTC [2024/06/26 18:20:54 ET]
Table '3769361908 1' 6-max Seat #5 is the button
Seat 1: lucaromanoo1 (14338 in chips) 
Seat 3: sinister778 (4154 in chips) 
Seat 4: mehditheboss (15810 in chips) 
Seat 5: lidi77777 (11728 in chips) 
Seat 6: Link_fNK (7979 in chips) 
lucaromanoo1: posts the ante 50
sinister778: posts the ante 50
mehditheboss: posts the ante 50
lidi77777: posts the ante 50
Link_fNK: posts the ante 50
Link_fNK: posts small blind 100
lucaromanoo1: posts big blind 200
*** HOLE CARDS ***
sinister778: folds 
mehditheboss: raises 200 to 400
lidi77777: raises 1350 to 1750
Link_fNK: folds 
lucaromanoo1: folds 
mehditheboss: folds 
Uncalled bet (1350) returned to lidi77777
lidi77777 collected 1350 from pot
*** SUMMARY ***
Total pot 1350 | Rake 0 
Seat 1: lucaromanoo1 (big blind) folded before Flop
Seat 3: sinister778 folded before Flop (didn't bet)
Seat 4: mehditheboss folded before Flop
Seat 5: lidi77777 (button) collected (1350)
Seat 6: Link_fNK (small blind) folded before Flop

PokerStars Hand #251209362477: Tournament #3769361908, $52.38+$2.62 USD Hold'em No Limit - Level VII (100/200) - 2024/06/26 22:21:16 UTC [2024/06/26 18:21:16 ET]
Table '3769361908 1' 6-max Seat #6 is the button
Seat 1: lucaromanoo1 (14088 in chips) 
Seat 3: sinister778 (4104 in chips) 
Seat 4: mehditheboss (15360 in chips) 
Seat 5: lidi77777 (12628 in chips) 
Seat 6: Link_fNK (7829 in chips) 
lucaromanoo1: posts the ante 50
sinister778: posts the ante 50
mehditheboss: posts the ante 50
lidi77777: posts the ante 50
Link_fNK: posts the ante 50
lucaromanoo1: posts small blind 100
sinister778: posts big blind 200
*** HOLE CARDS ***
mehditheboss: folds 
lidi77777: folds 
anth0nypappa is disconnected 
Link_fNK: raises 200 to 400
lucaromanoo1: folds 
sinister778: calls 200
*** FLOP *** [8s 4d 5h]
sinister778: checks 
Link_fNK: checks 
*** TURN *** [8s 4d 5h] [3d]
lucaromanoo1 is disconnected 
sinister778: bets 800
Link_fNK: folds 
Uncalled bet (800) returned to sinister778
sinister778 collected 1150 from pot
*** SUMMARY ***
Total pot 1150 | Rake 0 
Board [8s 4d 5h 3d]
Seat 1: lucaromanoo1 (small blind) folded before Flop
Seat 3: sinister778 (big blind) collected (1150)
Seat 4: mehditheboss folded before Flop (didn't bet)
Seat 5: lidi77777 folded before Flop (didn't bet)
Seat 6: Link_fNK (button) folded on the Turn

PokerStars Hand #251209375889: Tournament #3769361908, $52.38+$2.62 USD Hold'em No Limit - Level VII (100/200) - 2024/06/26 22:22:04 UTC [2024/06/26 18:22:04 ET]
Table '3769361908 1' 6-max Seat #1 is the button
Seat 1: lucaromanoo1 (13938 in chips) 
Seat 2: anth0nypappa (10000 in chips) out of hand (moved from another table into small blind)
Seat 3: sinister778 (4804 in chips) 
Seat 4: mehditheboss (15310 in chips) 
Seat 5: lidi77777 (12578 in chips) 
Seat 6: Link_fNK (7379 in chips) 
anth0nypappa will be allowed to play after the button
lucaromanoo1: posts the ante 50
sinister778: posts the ante 50
mehditheboss: posts the ante 50
lidi77777: posts the ante 50
Link_fNK: posts the ante 50
sinister778: posts small blind 100
mehditheboss: posts big blind 200
*** HOLE CARDS ***
lidi77777: folds 
Link_fNK: folds 
lucaromanoo1: folds 
sinister778: raises 400 to 600
mehditheboss: folds 
Uncalled bet (400) returned to sinister778
sinister778 collected 650 from pot
*** SUMMARY ***
Total pot 650 | Rake 0 
Seat 1: lucaromanoo1 (button) folded before Flop (didn't bet)
Seat 3: sinister778 (small blind) collected (650)
Seat 4: mehditheboss (big blind) folded before Flop
Seat 5: lidi77777 folded before Flop (didn't bet)
Seat 6: Link_fNK folded before Flop (didn't bet)

PokerStars Hand #251209383596: Tournament #3769361908, $52.38+$2.62 USD Hold'em No Limit - Level VII (100/200) - 2024/06/26 22:22:31 UTC [2024/06/26 18:22:31 ET]
Table '3769361908 1' 6-max Seat #3 is the button
Seat 1: lucaromanoo1 (13888 in chips) 
Seat 2: anth0nypappa (10000 in chips) 
Seat 3: sinister778 (5204 in chips) 
Seat 4: mehditheboss (15060 in chips) 
Seat 5: lidi77777 (12528 in chips) 
Seat 6: Link_fNK (7329 in chips) 
lucaromanoo1: posts the ante 50
anth0nypappa: posts the ante 50
sinister778: posts the ante 50
mehditheboss: posts the ante 50
lidi77777: posts the ante 50
Link_fNK: posts the ante 50
mehditheboss: posts small blind 100
lidi77777: posts big blind 200
*** HOLE CARDS ***
Link_fNK: folds 
lucaromanoo1: folds 
anth0nypappa: folds 
sinister778: raises 400 to 600
mehditheboss: calls 500
lidi77777: folds 
*** FLOP *** [6d 7d Jd]
mehditheboss: checks 
sinister778: bets 4554 and is all-in
mehditheboss: folds 
Uncalled bet (4554) returned to sinister778
sinister778 collected 1700 from pot
*** SUMMARY ***
Total pot 1700 | Rake 0 
Board [6d 7d Jd]
Seat 1: lucaromanoo1 folded before Flop (didn't bet)
Seat 2: anth0nypappa folded before Flop (didn't bet)
Seat 3: sinister778 (button) collected (1700)
Seat 4: mehditheboss (small blind) folded on the Flop
Seat 5: lidi77777 (big blind) folded before Flop
Seat 6: Link_fNK folded before Flop (didn't bet)

PokerStars Hand #251209397685: Tournament #3769361908, $52.38+$2.62 USD Hold'em No Limit - Level VIII (125/250) - 2024/06/26 22:23:22 UTC [2024/06/26 18:23:22 ET]
Table '3769361908 1' 6-max Seat #4 is the button
Seat 1: lucaromanoo1 (13838 in chips) 
Seat 2: anth0nypappa (9950 in chips) 
Seat 3: sinister778 (6254 in chips) 
Seat 4: mehditheboss (14410 in chips) 
Seat 5: lidi77777 (12278 in chips) 
Seat 6: Link_fNK (7279 in chips) 
lucaromanoo1: posts the ante 60
anth0nypappa: posts the ante 60
sinister778: posts the ante 60
mehditheboss: posts the ante 60
lidi77777: posts the ante 60
Link_fNK: posts the ante 60
lidi77777: posts small blind 125
Link_fNK: posts big blind 250
*** HOLE CARDS ***
lucaromanoo1: folds 
anth0nypappa: folds 
sinister778: raises 250 to 500
mehditheboss: folds 
lidi77777: folds 
Link_fNK: calls 250
*** FLOP *** [9s Qh 2c]
Link_fNK: checks 
sinister778: checks 
*** TURN *** [9s Qh 2c] [5s]
Link_fNK: checks 
sinister778: checks 
*** RIVER *** [9s Qh 2c 5s] [7d]
Link_fNK: checks 
sinister778: checks 
*** SHOW DOWN ***
Link_fNK: shows [6h Kc] (high card King)
sinister778: shows [7h 8h] (a pair of Sevens)
sinister778 collected 1485 from pot
*** SUMMARY ***
Total pot 1485 | Rake 0 
Board [9s Qh 2c 5s 7d]
Seat 1: lucaromanoo1 folded before Flop (didn't bet)
Seat 2: anth0nypappa folded before Flop (didn't bet)
Seat 3: sinister778 showed [7h 8h] and won (1485) with a pair of Sevens
Seat 4: mehditheboss (button) folded before Flop (didn't bet)
Seat 5: lidi77777 (small blind) folded before Flop
Seat 6: Link_fNK (big blind) showed [6h Kc] and lost with high card King

PokerStars Hand #251209411751: Tournament #3769361908, $52.38+$2.62 USD Hold'em No Limit - Level VIII (125/250) - 2024/06/26 22:24:13 UTC [2024/06/26 18:24:13 ET]
Table '3769361908 1' 6-max Seat #5 is the button
Seat 1: lucaromanoo1 (13778 in chips) 
Seat 2: anth0nypappa (9890 in chips) 
Seat 3: sinister778 (7179 in chips) 
Seat 4: mehditheboss (14350 in chips) 
Seat 5: lidi77777 (12093 in chips) 
Seat 6: Link_fNK (6719 in chips) 
lucaromanoo1: posts the ante 60
anth0nypappa: posts the ante 60
sinister778: posts the ante 60
mehditheboss: posts the ante 60
lidi77777: posts the ante 60
Link_fNK: posts the ante 60
Link_fNK: posts small blind 125
lucaromanoo1: posts big blind 250
*** HOLE CARDS ***
anth0nypappa: folds 
sinister778: folds 
mehditheboss: folds 
lidi77777: folds 
Link_fNK: raises 500 to 750
lucaromanoo1: raises 12968 to 13718 and is all-in
Link_fNK: calls 5909 and is all-in
Uncalled bet (7059) returned to lucaromanoo1
*** FLOP *** [5c 7c Qh]
*** TURN *** [5c 7c Qh] [Ac]
*** RIVER *** [5c 7c Qh Ac] [8h]
*** SHOW DOWN ***
Link_fNK: shows [9h Ah] (a pair of Aces)
lucaromanoo1: shows [4c 4d] (a pair of Fours)
Link_fNK collected 13678 from pot
*** SUMMARY ***
Total pot 13678 | Rake 0 
Board [5c 7c Qh Ac 8h]
Seat 1: lucaromanoo1 (big blind) showed [4c 4d] and lost with a pair of Fours
Seat 2: anth0nypappa folded before Flop (didn't bet)
Seat 3: sinister778 folded before Flop (didn't bet)
Seat 4: mehditheboss folded before Flop (didn't bet)
Seat 5: lidi77777 (button) folded before Flop (didn't bet)
Seat 6: Link_fNK (small blind) showed [9h Ah] and won (13678) with a pair of Aces

PokerStars Hand #251209421037: Tournament #3769361908, $52.38+$2.62 USD Hold'em No Limit - Level VIII (125/250) - 2024/06/26 22:24:46 UTC [2024/06/26 18:24:46 ET]
Table '3769361908 1' 6-max Seat #6 is the button
Seat 1: lucaromanoo1 (7059 in chips) 
Seat 2: anth0nypappa (9830 in chips) 
Seat 3: sinister778 (7119 in chips) 
Seat 4: mehditheboss (14290 in chips) 
Seat 5: lidi77777 (12033 in chips) 
Seat 6: Link_fNK (13678 in chips) 
lucaromanoo1: posts the ante 60
anth0nypappa: posts the ante 60
sinister778: posts the ante 60
mehditheboss: posts the ante 60
lidi77777: posts the ante 60
Link_fNK: posts the ante 60
lucaromanoo1: posts small blind 125
anth0nypappa: posts big blind 250
*** HOLE CARDS ***
sinister778: folds 
mehditheboss: raises 300 to 550
lidi77777: calls 550
Link_fNK: raises 1635 to 2185
lucaromanoo1: folds 
anth0nypappa: folds 
mehditheboss: calls 1635
lidi77777: calls 1635
*** FLOP *** [Js Kh 3d]
mehditheboss: checks 
lidi77777: checks 
Link_fNK: checks 
*** TURN *** [Js Kh 3d] [5c]
mehditheboss: checks 
lidi77777: bets 3395
Link_fNK: folds 
mehditheboss: folds 
Uncalled bet (3395) returned to lidi77777
lidi77777 collected 7290 from pot
*** SUMMARY ***
Total pot 7290 | Rake 0 
Board [Js Kh 3d 5c]
Seat 1: lucaromanoo1 (small blind) folded before Flop
Seat 2: anth0nypappa (big blind) folded before Flop
Seat 3: sinister778 folded before Flop (didn't bet)
Seat 4: mehditheboss folded on the Turn
Seat 5: lidi77777 collected (7290)
Seat 6: Link_fNK (button) folded on the Turn

PokerStars Hand #251209438245: Tournament #3769361908, $52.38+$2.62 USD Hold'em No Limit - Level VIII (125/250) - 2024/06/26 22:25:48 UTC [2024/06/26 18:25:48 ET]
Table '3769361908 1' 6-max Seat #1 is the button
Seat 1: lucaromanoo1 (6874 in chips) 
Seat 2: anth0nypappa (9520 in chips) 
Seat 3: sinister778 (7059 in chips) 
Seat 4: mehditheboss (12045 in chips) 
Seat 5: lidi77777 (17078 in chips) 
Seat 6: Link_fNK (11433 in chips) 
lucaromanoo1: posts the ante 60
anth0nypappa: posts the ante 60
sinister778: posts the ante 60
mehditheboss: posts the ante 60
lidi77777: posts the ante 60
Link_fNK: posts the ante 60
anth0nypappa: posts small blind 125
sinister778: posts big blind 250
*** HOLE CARDS ***
mehditheboss: folds 
lidi77777: folds 
Link_fNK: folds 
lucaromanoo1: folds 
anth0nypappa: calls 125
sinister778: checks 
*** FLOP *** [Jd 8d 7c]
anth0nypappa: checks 
sinister778: checks 
*** TURN *** [Jd 8d 7c] [3d]
anth0nypappa: checks 
sinister778: checks 
*** RIVER *** [Jd 8d 7c 3d] [9c]
anth0nypappa: checks 
sinister778: checks 
*** SHOW DOWN ***
anth0nypappa: shows [4h Kh] (high card King)
sinister778: mucks hand 
anth0nypappa collected 860 from pot
*** SUMMARY ***
Total pot 860 | Rake 0 
Board [Jd 8d 7c 3d 9c]
Seat 1: lucaromanoo1 (button) folded before Flop (didn't bet)
Seat 2: anth0nypappa (small blind) showed [4h Kh] and won (860) with high card King
Seat 3: sinister778 (big blind) mucked
Seat 4: mehditheboss folded before Flop (didn't bet)
Seat 5: lidi77777 folded before Flop (didn't bet)
Seat 6: Link_fNK folded before Flop (didn't bet)

PokerStars Hand #251209451773: Tournament #3769361908, $52.38+$2.62 USD Hold'em No Limit - Level IX (150/300) - 2024/06/26 22:26:37 UTC [2024/06/26 18:26:37 ET]
Table '3769361908 1' 6-max Seat #2 is the button
Seat 1: lucaromanoo1 (6814 in chips) 
Seat 2: anth0nypappa (10070 in chips) 
Seat 3: sinister778 (6749 in chips) 
Seat 4: mehditheboss (11985 in chips) 
Seat 5: lidi77777 (17018 in chips) 
Seat 6: Link_fNK (11373 in chips) 
lucaromanoo1: posts the ante 75
anth0nypappa: posts the ante 75
sinister778: posts the ante 75
mehditheboss: posts the ante 75
lidi77777: posts the ante 75
Link_fNK: posts the ante 75
sinister778: posts small blind 150
mehditheboss: posts big blind 300
*** HOLE CARDS ***
lidi77777: folds 
Link_fNK: folds 
lucaromanoo1: folds 
anth0nypappa: raises 333 to 633
sinister778: folds 
mehditheboss: folds 
Uncalled bet (333) returned to anth0nypappa
anth0nypappa collected 1200 from pot
anth0nypappa: doesn't show hand 
*** SUMMARY ***
Total pot 1200 | Rake 0 
Seat 1: lucaromanoo1 folded before Flop (didn't bet)
Seat 2: anth0nypappa (button) collected (1200)
Seat 3: sinister778 (small blind) folded before Flop
Seat 4: mehditheboss (big blind) folded before Flop
Seat 5: lidi77777 folded before Flop (didn't bet)
Seat 6: Link_fNK folded before Flop (didn't bet)

PokerStars Hand #251209463242: Tournament #3769361908, $52.38+$2.62 USD Hold'em No Limit - Level IX (150/300) - 2024/06/26 22:27:18 UTC [2024/06/26 18:27:18 ET]
Table '3769361908 1' 6-max Seat #3 is the button
Seat 1: lucaromanoo1 (6739 in chips) 
Seat 2: anth0nypappa (10895 in chips) 
Seat 3: sinister778 (6524 in chips) 
Seat 4: mehditheboss (11610 in chips) 
Seat 5: lidi77777 (16943 in chips) 
Seat 6: Link_fNK (11298 in chips) 
lucaromanoo1: posts the ante 75
anth0nypappa: posts the ante 75
sinister778: posts the ante 75
mehditheboss: posts the ante 75
lidi77777: posts the ante 75
Link_fNK: posts the ante 75
mehditheboss: posts small blind 150
lidi77777: posts big blind 300
*** HOLE CARDS ***
Link_fNK: raises 300 to 600
lucaromanoo1: folds 
anth0nypappa: folds 
sinister778: folds 
mehditheboss: folds 
lidi77777: calls 300
*** FLOP *** [6d As 2s]
lidi77777: checks 
Link_fNK: bets 495
lidi77777: folds 
Uncalled bet (495) returned to Link_fNK
Link_fNK collected 1800 from pot
Link_fNK: doesn't show hand 
*** SUMMARY ***
Total pot 1800 | Rake 0 
Board [6d As 2s]
Seat 1: lucaromanoo1 folded before Flop (didn't bet)
Seat 2: anth0nypappa folded before Flop (didn't bet)
Seat 3: sinister778 (button) folded before Flop (didn't bet)
Seat 4: mehditheboss (small blind) folded before Flop
Seat 5: lidi77777 (big blind) folded on the Flop
Seat 6: Link_fNK collected (1800)

PokerStars Hand #251209476942: Tournament #3769361908, $52.38+$2.62 USD Hold'em No Limit - Level IX (150/300) - 2024/06/26 22:28:07 UTC [2024/06/26 18:28:07 ET]
Table '3769361908 1' 6-max Seat #4 is the button
Seat 1: lucaromanoo1 (6664 in chips) 
Seat 2: anth0nypappa (10820 in chips) 
Seat 3: sinister778 (6449 in chips) 
Seat 4: mehditheboss (11385 in chips) 
Seat 5: lidi77777 (16268 in chips) 
Seat 6: Link_fNK (12423 in chips) 
lucaromanoo1: posts the ante 75
anth0nypappa: posts the ante 75
sinister778: posts the ante 75
mehditheboss: posts the ante 75
lidi77777: posts the ante 75
Link_fNK: posts the ante 75
lidi77777: posts small blind 150
Link_fNK: posts big blind 300
*** HOLE CARDS ***
lucaromanoo1: folds 
anth0nypappa: raises 300 to 600
sinister778: raises 5774 to 6374 and is all-in
mehditheboss: folds 
lidi77777: folds 
Link_fNK: folds 
anth0nypappa: folds 
Uncalled bet (5774) returned to sinister778
sinister778 collected 2100 from pot
*** SUMMARY ***
Total pot 2100 | Rake 0 
Seat 1: lucaromanoo1 folded before Flop (didn't bet)
Seat 2: anth0nypappa folded before Flop
Seat 3: sinister778 collected (2100)
Seat 4: mehditheboss (button) folded before Flop (didn't bet)
Seat 5: lidi77777 (small blind) folded before Flop
Seat 6: Link_fNK (big blind) folded before Flop

PokerStars Hand #251209485257: Tournament #3769361908, $52.38+$2.62 USD Hold'em No Limit - Level IX (150/300) - 2024/06/26 22:28:37 UTC [2024/06/26 18:28:37 ET]
Table '3769361908 1' 6-max Seat #5 is the button
Seat 1: lucaromanoo1 (6589 in chips) 
Seat 2: anth0nypappa (10145 in chips) 
Seat 3: sinister778 (7874 in chips) 
Seat 4: mehditheboss (11310 in chips) 
Seat 5: lidi77777 (16043 in chips) 
Seat 6: Link_fNK (12048 in chips) 
lucaromanoo1: posts the ante 75
anth0nypappa: posts the ante 75
sinister778: posts the ante 75
mehditheboss: posts the ante 75
lidi77777: posts the ante 75
Link_fNK: posts the ante 75
Link_fNK: posts small blind 150
lucaromanoo1: posts big blind 300
*** HOLE CARDS ***
anth0nypappa: folds 
sinister778: folds 
mehditheboss: folds 
lidi77777: raises 300 to 600
Link_fNK: raises 1650 to 2250
lucaromanoo1: folds 
lidi77777: calls 1650
*** FLOP *** [Ac 2c Ad]
Link_fNK: bets 1380
lidi77777: calls 1380
*** TURN *** [Ac 2c Ad] [7c]
Link_fNK: bets 2669
lidi77777: calls 2669
*** RIVER *** [Ac 2c Ad 7c] [5c]
Link_fNK: bets 5674 and is all-in
lidi77777: calls 5674
*** SHOW DOWN ***
Link_fNK: shows [Kc As] (a flush, Ace high)
lidi77777: shows [8c Qc] (a flush, Ace high - lower cards)
Link_fNK collected 24696 from pot
*** SUMMARY ***
Total pot 24696 | Rake 0 
Board [Ac 2c Ad 7c 5c]
Seat 1: lucaromanoo1 (big blind) folded before Flop
Seat 2: anth0nypappa folded before Flop (didn't bet)
Seat 3: sinister778 folded before Flop (didn't bet)
Seat 4: mehditheboss folded before Flop (didn't bet)
Seat 5: lidi77777 (button) showed [8c Qc] and lost with a flush, Ace high
Seat 6: Link_fNK (small blind) showed [Kc As] and won (24696) with a flush, Ace high

PokerStars Hand #251209513937: Tournament #3769361908, $52.38+$2.62 USD Hold'em No Limit - Level X (200/400) - 2024/06/26 22:30:20 UTC [2024/06/26 18:30:20 ET]
Table '3769361908 1' 6-max Seat #6 is the button
Seat 1: lucaromanoo1 (6214 in chips) 
Seat 2: anth0nypappa (10070 in chips) 
Seat 3: sinister778 (7799 in chips) 
Seat 4: mehditheboss (11235 in chips) 
Seat 5: lidi77777 (3995 in chips) 
Seat 6: Link_fNK (24696 in chips) 
lucaromanoo1: posts the ante 100
anth0nypappa: posts the ante 100
sinister778: posts the ante 100
mehditheboss: posts the ante 100
lidi77777: posts the ante 100
Link_fNK: posts the ante 100
lucaromanoo1: posts small blind 200
anth0nypappa: posts big blind 400
*** HOLE CARDS ***
sinister778: folds 
mehditheboss: raises 400 to 800
lidi77777: raises 3095 to 3895 and is all-in
Link_fNK: folds 
lucaromanoo1: folds 
anth0nypappa: folds 
mehditheboss: calls 3095
*** FLOP *** [7d Kh 6d]
*** TURN *** [7d Kh 6d] [Js]
*** RIVER *** [7d Kh 6d Js] [Td]
*** SHOW DOWN ***
mehditheboss: shows [9s 7s] (a pair of Sevens)
lidi77777: shows [Kc Tc] (two pair, Kings and Tens)
lidi77777 collected 8990 from pot
*** SUMMARY ***
Total pot 8990 | Rake 0 
Board [7d Kh 6d Js Td]
Seat 1: lucaromanoo1 (small blind) folded before Flop
Seat 2: anth0nypappa (big blind) folded before Flop
Seat 3: sinister778 folded before Flop (didn't bet)
Seat 4: mehditheboss showed [9s 7s] and lost with a pair of Sevens
Seat 5: lidi77777 showed [Kc Tc] and won (8990) with two pair, Kings and Tens
Seat 6: Link_fNK (button) folded before Flop (didn't bet)

PokerStars Hand #251209521767: Tournament #3769361908, $52.38+$2.62 USD Hold'em No Limit - Level X (200/400) - 2024/06/26 22:30:48 UTC [2024/06/26 18:30:48 ET]
Table '3769361908 1' 6-max Seat #1 is the button
Seat 1: lucaromanoo1 (5914 in chips) 
Seat 2: anth0nypappa (9570 in chips) 
Seat 3: sinister778 (7699 in chips) 
Seat 4: mehditheboss (7240 in chips) 
Seat 5: lidi77777 (8990 in chips) 
Seat 6: Link_fNK (24596 in chips) 
lucaromanoo1: posts the ante 100
anth0nypappa: posts the ante 100
sinister778: posts the ante 100
mehditheboss: posts the ante 100
lidi77777: posts the ante 100
Link_fNK: posts the ante 100
anth0nypappa: posts small blind 200
sinister778: posts big blind 400
*** HOLE CARDS ***
mehditheboss: folds 
lidi77777: folds 
Link_fNK: folds 
lucaromanoo1: folds 
anth0nypappa: raises 9070 to 9470 and is all-in
sinister778: calls 7199 and is all-in
Uncalled bet (1871) returned to anth0nypappa
*** FLOP *** [Ad Kd 4h]
*** TURN *** [Ad Kd 4h] [Ts]
*** RIVER *** [Ad Kd 4h Ts] [Kh]
*** SHOW DOWN ***
anth0nypappa: shows [Jc 9h] (a pair of Kings)
sinister778: shows [2s Kc] (three of a kind, Kings)
sinister778 collected 15798 from pot
*** SUMMARY ***
Total pot 15798 | Rake 0 
Board [Ad Kd 4h Ts Kh]
Seat 1: lucaromanoo1 (button) folded before Flop (didn't bet)
Seat 2: anth0nypappa (small blind) showed [Jc 9h] and lost with a pair of Kings
Seat 3: sinister778 (big blind) showed [2s Kc] and won (15798) with three of a kind, Kings
Seat 4: mehditheboss folded before Flop (didn't bet)
Seat 5: lidi77777 folded before Flop (didn't bet)
Seat 6: Link_fNK folded before Flop (didn't bet)

PokerStars Hand #251209527139: Tournament #3769361908, $52.38+$2.62 USD Hold'em No Limit - Level X (200/400) - 2024/06/26 22:31:08 UTC [2024/06/26 18:31:08 ET]
Table '3769361908 1' 6-max Seat #2 is the button
Seat 1: lucaromanoo1 (5814 in chips) 
Seat 2: anth0nypappa (1871 in chips) 
Seat 3: sinister778 (15798 in chips) 
Seat 5: lidi77777 (8890 in chips) 
Seat 6: Link_fNK (24496 in chips) 
lucaromanoo1: posts the ante 100
anth0nypappa: posts the ante 100
sinister778: posts the ante 100
lidi77777: posts the ante 100
Link_fNK: posts the ante 100
sinister778: posts small blind 200
lidi77777: posts big blind 400
*** HOLE CARDS ***
Link_fNK: folds 
lucaromanoo1: raises 5314 to 5714 and is all-in
phcrf is disconnected 
anth0nypappa: folds 
sinister778: folds 
lidi77777: folds 
Uncalled bet (5314) returned to lucaromanoo1
lucaromanoo1 collected 1500 from pot
*** SUMMARY ***
Total pot 1500 | Rake 0 
Seat 1: lucaromanoo1 collected (1500)
Seat 2: anth0nypappa (button) folded before Flop (didn't bet)
Seat 3: sinister778 (small blind) folded before Flop
Seat 5: lidi77777 (big blind) folded before Flop
Seat 6: Link_fNK folded before Flop (didn't bet)

PokerStars Hand #251209534160: Tournament #3769361908, $52.38+$2.62 USD Hold'em No Limit - Level X (200/400) - 2024/06/26 22:31:33 UTC [2024/06/26 18:31:33 ET]
Table '3769361908 1' 6-max Seat #3 is the button
Seat 1: lucaromanoo1 (6814 in chips) 
Seat 2: anth0nypappa (1771 in chips) 
Seat 3: sinister778 (15498 in chips) 
Seat 4: phcrf (10000 in chips) out of hand (moved from another table into small blind)
Seat 5: lidi77777 (8390 in chips) 
Seat 6: Link_fNK (24396 in chips) 
phcrf will be allowed to play after the button
lucaromanoo1: posts the ante 100
anth0nypappa: posts the ante 100
sinister778: posts the ante 100
lidi77777: posts the ante 100
Link_fNK: posts the ante 100
lidi77777: posts small blind 200
Link_fNK: posts big blind 400
*** HOLE CARDS ***
lucaromanoo1: folds 
anth0nypappa: folds 
sinister778: folds 
lidi77777: raises 7890 to 8290 and is all-in
Link_fNK: folds 
Uncalled bet (7890) returned to lidi77777
lidi77777 collected 1300 from pot
*** SUMMARY ***
Total pot 1300 | Rake 0 
Seat 1: lucaromanoo1 folded before Flop (didn't bet)
Seat 2: anth0nypappa folded before Flop (didn't bet)
Seat 3: sinister778 (button) folded before Flop (didn't bet)
Seat 5: lidi77777 (small blind) collected (1300)
Seat 6: Link_fNK (big blind) folded before Flop

PokerStars Hand #251209537700: Tournament #3769361908, $52.38+$2.62 USD Hold'em No Limit - Level X (200/400) - 2024/06/26 22:31:46 UTC [2024/06/26 18:31:46 ET]
Table '3769361908 1' 6-max Seat #5 is the button
Seat 1: lucaromanoo1 (6714 in chips) 
Seat 2: anth0nypappa (1671 in chips) 
Seat 3: sinister778 (15398 in chips) 
Seat 4: phcrf (10000 in chips) 
Seat 5: lidi77777 (9190 in chips) 
Seat 6: Link_fNK (23896 in chips) 
lucaromanoo1: posts the ante 100
anth0nypappa: posts the ante 100
sinister778: posts the ante 100
phcrf: posts the ante 100
lidi77777: posts the ante 100
Link_fNK: posts the ante 100
Link_fNK: posts small blind 200
lucaromanoo1: posts big blind 400
*** HOLE CARDS ***
anth0nypappa: folds 
sinister778: folds 
phcrf: raises 400 to 800
lidi77777: calls 800
Link_fNK: folds 
lucaromanoo1: folds 
*** FLOP *** [Js 9h 9c]
phcrf: checks 
lidi77777: bets 800
phcrf: calls 800
*** TURN *** [Js 9h 9c] [Qh]
phcrf: checks 
lidi77777: bets 1800
phcrf: calls 1800
*** RIVER *** [Js 9h 9c Qh] [Ah]
phcrf: checks 
lidi77777: checks 
*** SHOW DOWN ***
phcrf: shows [Jh Jc] (a full house, Jacks full of Nines)
lidi77777: mucks hand 
phcrf collected 8000 from pot
*** SUMMARY ***
Total pot 8000 | Rake 0 
Board [Js 9h 9c Qh Ah]
Seat 1: lucaromanoo1 (big blind) folded before Flop
Seat 2: anth0nypappa folded before Flop (didn't bet)
Seat 3: sinister778 folded before Flop (didn't bet)
Seat 4: phcrf showed [Jh Jc] and won (8000) with a full house, Jacks full of Nines
Seat 5: lidi77777 (button) mucked
Seat 6: Link_fNK (small blind) folded before Flop

PokerStars Hand #251209555068: Tournament #3769361908, $52.38+$2.62 USD Hold'em No Limit - Level XI (250/500) - 2024/06/26 22:32:50 UTC [2024/06/26 18:32:50 ET]
Table '3769361908 1' 6-max Seat #6 is the button
Seat 1: lucaromanoo1 (6214 in chips) 
Seat 2: anth0nypappa (1571 in chips) 
Seat 3: sinister778 (15298 in chips) 
Seat 4: phcrf (14500 in chips) 
Seat 5: lidi77777 (5690 in chips) 
Seat 6: Link_fNK (23596 in chips) 
lucaromanoo1: posts the ante 125
anth0nypappa: posts the ante 125
sinister778: posts the ante 125
phcrf: posts the ante 125
lidi77777: posts the ante 125
Link_fNK: posts the ante 125
lucaromanoo1: posts small blind 250
anth0nypappa: posts big blind 500
*** HOLE CARDS ***
sinister778: folds 
phcrf: folds 
lidi77777: raises 5065 to 5565 and is all-in
Link_fNK: folds 
lucaromanoo1: folds 
anth0nypappa: calls 946 and is all-in
Uncalled bet (4119) returned to lidi77777
*** FLOP *** [2c 3s Jc]
*** TURN *** [2c 3s Jc] [6h]
*** RIVER *** [2c 3s Jc 6h] [4s]
*** SHOW DOWN ***
anth0nypappa: shows [2d 8d] (a pair of Deuces)
lidi77777: shows [Kd 9s] (high card King)
anth0nypappa collected 3892 from pot
*** SUMMARY ***
Total pot 3892 | Rake 0 
Board [2c 3s Jc 6h 4s]
Seat 1: lucaromanoo1 (small blind) folded before Flop
Seat 2: anth0nypappa (big blind) showed [2d 8d] and won (3892) with a pair of Deuces
Seat 3: sinister778 folded before Flop (didn't bet)
Seat 4: phcrf folded before Flop (didn't bet)
Seat 5: lidi77777 showed [Kd 9s] and lost with high card King
Seat 6: Link_fNK (button) folded before Flop (didn't bet)

PokerStars Hand #251209561660: Tournament #3769361908, $52.38+$2.62 USD Hold'em No Limit - Level XI (250/500) - 2024/06/26 22:33:15 UTC [2024/06/26 18:33:15 ET]
Table '3769361908 1' 6-max Seat #1 is the button
Seat 1: lucaromanoo1 (5839 in chips) 
Seat 2: anth0nypappa (3892 in chips) 
Seat 3: sinister778 (15173 in chips) 
Seat 4: phcrf (14375 in chips) 
Seat 5: lidi77777 (4119 in chips) 
Seat 6: Link_fNK (23471 in chips) 
lucaromanoo1: posts the ante 125
anth0nypappa: posts the ante 125
sinister778: posts the ante 125
phcrf: posts the ante 125
lidi77777: posts the ante 125
Link_fNK: posts the ante 125
anth0nypappa: posts small blind 250
sinister778: posts big blind 500
*** HOLE CARDS ***
phcrf: folds 
lidi77777: raises 3494 to 3994 and is all-in
Link_fNK: folds 
lucaromanoo1: folds 
anth0nypappa: folds 
sinister778: folds 
Uncalled bet (3494) returned to lidi77777
lidi77777 collected 2000 from pot
*** SUMMARY ***
Total pot 2000 | Rake 0 
Seat 1: lucaromanoo1 (button) folded before Flop (didn't bet)
Seat 2: anth0nypappa (small blind) folded before Flop
Seat 3: sinister778 (big blind) folded before Flop
Seat 4: phcrf folded before Flop (didn't bet)
Seat 5: lidi77777 collected (2000)
Seat 6: Link_fNK folded before Flop (didn't bet)

PokerStars Hand #251209567503: Tournament #3769361908, $52.38+$2.62 USD Hold'em No Limit - Level XI (250/500) - 2024/06/26 22:33:37 UTC [2024/06/26 18:33:37 ET]
Table '3769361908 1' 6-max Seat #2 is the button
Seat 1: lucaromanoo1 (5714 in chips) 
Seat 2: anth0nypappa (3517 in chips) 
Seat 3: sinister778 (14548 in chips) 
Seat 4: phcrf (14250 in chips) 
Seat 5: lidi77777 (5494 in chips) 
Seat 6: Link_fNK (23346 in chips) 
lucaromanoo1: posts the ante 125
anth0nypappa: posts the ante 125
sinister778: posts the ante 125
phcrf: posts the ante 125
lidi77777: posts the ante 125
Link_fNK: posts the ante 125
sinister778: posts small blind 250
phcrf: posts big blind 500
*** HOLE CARDS ***
lidi77777: calls 500
Link_fNK: folds 
lucaromanoo1: raises 5089 to 5589 and is all-in
anth0nypappa: folds 
sinister778: folds 
phcrf: folds 
lidi77777: calls 4869 and is all-in
Uncalled bet (220) returned to lucaromanoo1
*** FLOP *** [2d Qc 6c]
*** TURN *** [2d Qc 6c] [6s]
*** RIVER *** [2d Qc 6c 6s] [6h]
*** SHOW DOWN ***
lidi77777: shows [Ad Ah] (a full house, Sixes full of Aces)
lucaromanoo1: shows [8s 8d] (a full house, Sixes full of Eights)
lidi77777 collected 12238 from pot
*** SUMMARY ***
Total pot 12238 | Rake 0 
Board [2d Qc 6c 6s 6h]
Seat 1: lucaromanoo1 showed [8s 8d] and lost with a full house, Sixes full of Eights
Seat 2: anth0nypappa (button) folded before Flop (didn't bet)
Seat 3: sinister778 (small blind) folded before Flop
Seat 4: phcrf (big blind) folded before Flop
Seat 5: lidi77777 showed [Ad Ah] and won (12238) with a full house, Sixes full of Aces
Seat 6: Link_fNK folded before Flop (didn't bet)

PokerStars Hand #251209576426: Tournament #3769361908, $52.38+$2.62 USD Hold'em No Limit - Level XI (250/500) - 2024/06/26 22:34:10 UTC [2024/06/26 18:34:10 ET]
Table '3769361908 1' 6-max Seat #3 is the button
Seat 1: lucaromanoo1 (220 in chips) 
Seat 2: anth0nypappa (3392 in chips) 
Seat 3: sinister778 (14173 in chips) 
Seat 4: phcrf (13625 in chips) 
Seat 5: lidi77777 (12238 in chips) 
Seat 6: Link_fNK (23221 in chips) 
lucaromanoo1: posts the ante 125
anth0nypappa: posts the ante 125
sinister778: posts the ante 125
phcrf: posts the ante 125
lidi77777: posts the ante 125
Link_fNK: posts the ante 125
phcrf: posts small blind 250
lidi77777: posts big blind 500
*** HOLE CARDS ***
Link_fNK: raises 500 to 1000
lucaromanoo1: folds 
anth0nypappa: folds 
sinister778: calls 1000
phcrf: folds 
lidi77777: folds 
*** FLOP *** [6s Kd Qh]
Link_fNK: checks 
sinister778: bets 1500
Link_fNK: folds 
Uncalled bet (1500) returned to sinister778
sinister778 collected 3500 from pot
*** SUMMARY ***
Total pot 3500 | Rake 0 
Board [6s Kd Qh]
Seat 1: lucaromanoo1 folded before Flop (didn't bet)
Seat 2: anth0nypappa folded before Flop (didn't bet)
Seat 3: sinister778 (button) collected (3500)
Seat 4: phcrf (small blind) folded before Flop
Seat 5: lidi77777 (big blind) folded before Flop
Seat 6: Link_fNK folded on the Flop

PokerStars Hand #251209588785: Tournament #3769361908, $52.38+$2.62 USD Hold'em No Limit - Level XI (250/500) - 2024/06/26 22:34:55 UTC [2024/06/26 18:34:55 ET]
Table '3769361908 1' 6-max Seat #4 is the button
Seat 1: lucaromanoo1 (95 in chips) 
Seat 2: anth0nypappa (3267 in chips) 
Seat 3: sinister778 (16548 in chips) 
Seat 4: phcrf (13250 in chips) 
Seat 5: lidi77777 (11613 in chips) 
Seat 6: Link_fNK (22096 in chips) 
lucaromanoo1: posts the ante 95 and is all-in
anth0nypappa: posts the ante 125
sinister778: posts the ante 125
phcrf: posts the ante 125
lidi77777: posts the ante 125
Link_fNK: posts the ante 125
lidi77777: posts small blind 250
Link_fNK: posts big blind 500
*** HOLE CARDS ***
anth0nypappa is disconnected 
anth0nypappa has timed out while disconnected
anth0nypappa: folds 
anth0nypappa is sitting out
sinister778: folds 
phcrf: folds 
lucaromanoo1 is disconnected 
lidi77777: raises 10988 to 11488 and is all-in
Link_fNK: calls 10988
*** FLOP *** [7d 5c 5s]
*** TURN *** [7d 5c 5s] [6d]
*** RIVER *** [7d 5c 5s 6d] [2c]
*** SHOW DOWN ***
lidi77777: shows [2h 7h] (two pair, Sevens and Fives)
Link_fNK: shows [Qs Qh] (two pair, Queens and Fives)
Link_fNK collected 23126 from side pot
lucaromanoo1: shows [4s Qd] (a pair of Fives)
lucaromanoo1 is disconnected 
Link_fNK collected 570 from main pot
lidi77777 finished the tournament
lucaromanoo1 finished the tournament
*** SUMMARY ***
Total pot 23696 Main pot 570. Side pot 23126. | Rake 0 
Board [7d 5c 5s 6d 2c]
Seat 1: lucaromanoo1 showed [4s Qd] and lost with a pair of Fives
Seat 2: anth0nypappa folded before Flop (didn't bet)
Seat 3: sinister778 folded before Flop (didn't bet)
Seat 4: phcrf (button) folded before Flop (didn't bet)
Seat 5: lidi77777 (small blind) showed [2h 7h] and lost with two pair, Sevens and Fives
Seat 6: Link_fNK (big blind) showed [Qs Qh] and won (23696) with two pair, Queens and Fives

PokerStars Hand #251209607786: Tournament #3769361908, $52.38+$2.62 USD Hold'em No Limit - Level XII (300/600) - 2024/06/26 22:36:06 UTC [2024/06/26 18:36:06 ET]
Table '3769361908 1' 6-max Seat #6 is the button
Seat 1: Accio Aces1 (37044 in chips) out of hand (moved from another table into small blind)
Seat 2: anth0nypappa (3142 in chips) is sitting out
Seat 3: sinister778 (16423 in chips) 
Seat 4: phcrf (13125 in chips) 
Seat 6: Link_fNK (34179 in chips) 
Accio Aces1 will be allowed to play after the button
anth0nypappa: posts the ante 150
sinister778: posts the ante 150
phcrf: posts the ante 150
Link_fNK: posts the ante 150
anth0nypappa: posts small blind 300
sinister778: posts big blind 600
*** HOLE CARDS ***
joaoMathias is disconnected 
phcrf: folds 
Link_fNK: raises 600 to 1200
anth0nypappa: folds 
sinister778: calls 600
*** FLOP *** [2s Js 9s]
sinister778: checks 
Link_fNK: bets 825
sinister778: calls 825
*** TURN *** [2s Js 9s] [Td]
sinister778: checks 
Link_fNK: bets 3720
sinister778: calls 3720
*** RIVER *** [2s Js 9s Td] [5d]
sinister778: checks 
Link_fNK: bets 12390
sinister778: calls 10528 and is all-in
Uncalled bet (1862) returned to Link_fNK
*** SHOW DOWN ***
Link_fNK: shows [Ad 3s] (high card Ace)
sinister778: shows [Th Jd] (two pair, Jacks and Tens)
sinister778 collected 33446 from pot
*** SUMMARY ***
Total pot 33446 | Rake 0 
Board [2s Js 9s Td 5d]
Seat 2: anth0nypappa (small blind) folded before Flop
Seat 3: sinister778 (big blind) showed [Th Jd] and won (33446) with two pair, Jacks and Tens
Seat 4: phcrf folded before Flop (didn't bet)
Seat 6: Link_fNK (button) showed [Ad 3s] and lost with high card Ace

PokerStars Hand #251209634091: Tournament #3769361908, $52.38+$2.62 USD Hold'em No Limit - Level XII (300/600) - 2024/06/26 22:37:45 UTC [2024/06/26 18:37:45 ET]
Table '3769361908 1' 6-max Seat #2 is the button
Seat 1: Accio Aces1 (37044 in chips) 
Seat 2: anth0nypappa (2692 in chips) is sitting out
Seat 3: sinister778 (33446 in chips) 
Seat 4: phcrf (12975 in chips) 
Seat 5: joaoMathias (9850 in chips) 
Seat 6: Link_fNK (17756 in chips) 
Accio Aces1: posts the ante 150
anth0nypappa: posts the ante 150
sinister778: posts the ante 150
phcrf: posts the ante 150
joaoMathias: posts the ante 150
Link_fNK: posts the ante 150
sinister778: posts small blind 300
phcrf: posts big blind 600
*** HOLE CARDS ***
joaoMathias: folds 
Link_fNK: folds 
Accio Aces1: folds 
anth0nypappa: folds 
sinister778: raises 1200 to 1800
phcrf: folds [2c]
Uncalled bet (1200) returned to sinister778
sinister778 collected 2100 from pot
*** SUMMARY ***
Total pot 2100 | Rake 0 
Seat 1: Accio Aces1 folded before Flop (didn't bet)
Seat 2: anth0nypappa (button) folded before Flop (didn't bet)
Seat 3: sinister778 (small blind) collected (2100)
Seat 4: phcrf (big blind) folded before Flop
Seat 5: joaoMathias folded before Flop (didn't bet)
Seat 6: Link_fNK folded before Flop (didn't bet)

PokerStars Hand #251209645530: Tournament #3769361908, $52.38+$2.62 USD Hold'em No Limit - Level XIII (400/800) - 2024/06/26 22:38:27 UTC [2024/06/26 18:38:27 ET]
Table '3769361908 1' 6-max Seat #3 is the button
Seat 1: Accio Aces1 (36894 in chips) 
Seat 2: anth0nypappa (2542 in chips) is sitting out
Seat 3: sinister778 (34796 in chips) 
Seat 4: phcrf (12225 in chips) 
Seat 5: joaoMathias (9700 in chips) 
Seat 6: Link_fNK (17606 in chips) 
Accio Aces1: posts the ante 200
anth0nypappa: posts the ante 200
sinister778: posts the ante 200
phcrf: posts the ante 200
joaoMathias: posts the ante 200
Link_fNK: posts the ante 200
phcrf: posts small blind 400
joaoMathias: posts big blind 800
*** HOLE CARDS ***
Link_fNK: folds 
Accio Aces1: folds 
anth0nypappa: folds 
sinister778: folds 
phcrf: raises 11225 to 12025 and is all-in
joaoMathias: calls 8700 and is all-in
Uncalled bet (2525) returned to phcrf
*** FLOP *** [5h Kc Th]
*** TURN *** [5h Kc Th] [Ks]
*** RIVER *** [5h Kc Th Ks] [Jd]
*** SHOW DOWN ***
phcrf: shows [Js 6s] (two pair, Kings and Jacks)
joaoMathias: shows [9h 9s] (two pair, Kings and Nines)
phcrf collected 20200 from pot
joaoMathias finished the tournament
*** SUMMARY ***
Total pot 20200 | Rake 0 
Board [5h Kc Th Ks Jd]
Seat 1: Accio Aces1 folded before Flop (didn't bet)
Seat 2: anth0nypappa folded before Flop (didn't bet)
Seat 3: sinister778 (button) folded before Flop (didn't bet)
Seat 4: phcrf (small blind) showed [Js 6s] and won (20200) with two pair, Kings and Jacks
Seat 5: joaoMathias (big blind) showed [9h 9s] and lost with two pair, Kings and Nines
Seat 6: Link_fNK folded before Flop (didn't bet)

PokerStars Hand #251209652982: Tournament #3769361908, $52.38+$2.62 USD Hold'em No Limit - Level XIII (400/800) - 2024/06/26 22:38:55 UTC [2024/06/26 18:38:55 ET]
Table '3769361908 1' 6-max Seat #4 is the button
Seat 1: Accio Aces1 (36694 in chips) 
Seat 2: anth0nypappa (2342 in chips) is sitting out
Seat 3: sinister778 (34596 in chips) 
Seat 4: phcrf (22725 in chips) 
Seat 6: Link_fNK (17406 in chips) 
Accio Aces1: posts the ante 200
anth0nypappa: posts the ante 200
sinister778: posts the ante 200
phcrf: posts the ante 200
Link_fNK: posts the ante 200
Link_fNK: posts small blind 400
Accio Aces1: posts big blind 800
*** HOLE CARDS ***
anth0nypappa: folds 
sinister778: folds 
phcrf: raises 800 to 1600
Link_fNK: folds 
Accio Aces1: raises 34894 to 36494 and is all-in
phcrf: calls 20925 and is all-in
Uncalled bet (13969) returned to Accio Aces1
*** FLOP *** [Qh 9c 8s]
*** TURN *** [Qh 9c 8s] [4h]
*** RIVER *** [Qh 9c 8s 4h] [5d]
*** SHOW DOWN ***
Accio Aces1: shows [5s 4s] (two pair, Fives and Fours)
phcrf: shows [As Kh] (high card Ace)
Accio Aces1 collected 46450 from pot
phcrf finished the tournament
*** SUMMARY ***
Total pot 46450 | Rake 0 
Board [Qh 9c 8s 4h 5d]
Seat 1: Accio Aces1 (big blind) showed [5s 4s] and won (46450) with two pair, Fives and Fours
Seat 2: anth0nypappa folded before Flop (didn't bet)
Seat 3: sinister778 folded before Flop (didn't bet)
Seat 4: phcrf (button) showed [As Kh] and lost with high card Ace
Seat 6: Link_fNK (small blind) folded before Flop


PokerStars Hand #251209421633: Tournament #3769361908, $52.38+$2.62 USD Hold'em No Limit - Level VIII (125/250) - 2024/06/26 22:24:48 UTC [2024/06/26 18:24:48 ET]
Table '3769361908 16' 6-max Seat #4 is the button
Seat 1: fofAAoBR (24308 in chips) 
Seat 2: SAS_IDS0804 (9940 in chips) 
Seat 3: JonzStars (4132 in chips) 
Seat 4: MagoDelBaralho (8756 in chips) 
Seat 5: VICTOR TXR1 (9617 in chips) 
Seat 6: XxJoaoFeraxX (11346 in chips) 
fofAAoBR: posts the ante 60
SAS_IDS0804: posts the ante 60
JonzStars: posts the ante 60
MagoDelBaralho: posts the ante 60
VICTOR TXR1: posts the ante 60
XxJoaoFeraxX: posts the ante 60
VICTOR TXR1: posts small blind 125
XxJoaoFeraxX: posts big blind 250
*** HOLE CARDS ***
fofAAoBR: folds 
SAS_IDS0804: folds 
JonzStars: raises 250 to 500
MagoDelBaralho: folds 
VICTOR TXR1: folds 
XxJoaoFeraxX: folds 
Uncalled bet (250) returned to JonzStars
JonzStars collected 985 from pot
*** SUMMARY ***
Total pot 985 | Rake 0 
Seat 1: fofAAoBR folded before Flop (didn't bet)
Seat 2: SAS_IDS0804 folded before Flop (didn't bet)
Seat 3: JonzStars collected (985)
Seat 4: MagoDelBaralho (button) folded before Flop (didn't bet)
Seat 5: VICTOR TXR1 (small blind) folded before Flop
Seat 6: XxJoaoFeraxX (big blind) folded before Flop

PokerStars Hand #251209428726: Tournament #3769361908, $52.38+$2.62 USD Hold'em No Limit - Level VIII (125/250) - 2024/06/26 22:25:14 UTC [2024/06/26 18:25:14 ET]
Table '3769361908 16' 6-max Seat #5 is the button
Seat 1: fofAAoBR (24248 in chips) 
Seat 2: SAS_IDS0804 (9880 in chips) 
Seat 3: JonzStars (4807 in chips) 
Seat 4: MagoDelBaralho (8696 in chips) 
Seat 5: VICTOR TXR1 (9432 in chips) 
Seat 6: XxJoaoFeraxX (11036 in chips) 
fofAAoBR: posts the ante 60
SAS_IDS0804: posts the ante 60
JonzStars: posts the ante 60
MagoDelBaralho: posts the ante 60
VICTOR TXR1: posts the ante 60
XxJoaoFeraxX: posts the ante 60
XxJoaoFeraxX: posts small blind 125
fofAAoBR: posts big blind 250
*** HOLE CARDS ***
SAS_IDS0804: folds 
JonzStars: folds 
MagoDelBaralho: folds 
VICTOR TXR1: folds 
XxJoaoFeraxX: calls 125
fofAAoBR: raises 750 to 1000
XxJoaoFeraxX: folds 
Uncalled bet (750) returned to fofAAoBR
fofAAoBR collected 860 from pot
fofAAoBR: doesn't show hand 
*** SUMMARY ***
Total pot 860 | Rake 0 
Seat 1: fofAAoBR (big blind) collected (860)
Seat 2: SAS_IDS0804 folded before Flop (didn't bet)
Seat 3: JonzStars folded before Flop (didn't bet)
Seat 4: MagoDelBaralho folded before Flop (didn't bet)
Seat 5: VICTOR TXR1 (button) folded before Flop (didn't bet)
Seat 6: XxJoaoFeraxX (small blind) folded before Flop

PokerStars Hand #251209440366: Tournament #3769361908, $52.38+$2.62 USD Hold'em No Limit - Level VIII (125/250) - 2024/06/26 22:25:56 UTC [2024/06/26 18:25:56 ET]
Table '3769361908 16' 6-max Seat #6 is the button
Seat 1: fofAAoBR (24798 in chips) 
Seat 2: SAS_IDS0804 (9820 in chips) 
Seat 3: JonzStars (4747 in chips) 
Seat 4: MagoDelBaralho (8636 in chips) 
Seat 5: VICTOR TXR1 (9372 in chips) 
Seat 6: XxJoaoFeraxX (10726 in chips) 
fofAAoBR: posts the ante 60
SAS_IDS0804: posts the ante 60
JonzStars: posts the ante 60
MagoDelBaralho: posts the ante 60
VICTOR TXR1: posts the ante 60
XxJoaoFeraxX: posts the ante 60
fofAAoBR: posts small blind 125
SAS_IDS0804: posts big blind 250
*** HOLE CARDS ***
JonzStars: folds 
MagoDelBaralho: folds 
VICTOR TXR1: folds 
XxJoaoFeraxX: raises 250 to 500
fofAAoBR: calls 375
SAS_IDS0804: calls 250
*** FLOP *** [2d Jd Qd]
fofAAoBR: checks 
SAS_IDS0804: checks 
XxJoaoFeraxX: checks 
*** TURN *** [2d Jd Qd] [Tc]
fofAAoBR: checks 
SAS_IDS0804: checks 
XxJoaoFeraxX: checks 
*** RIVER *** [2d Jd Qd Tc] [Th]
fofAAoBR: checks 
SAS_IDS0804: checks 
XxJoaoFeraxX: bets 614
fofAAoBR: folds 
SAS_IDS0804: folds 
Uncalled bet (614) returned to XxJoaoFeraxX
XxJoaoFeraxX collected 1860 from pot
XxJoaoFeraxX: doesn't show hand 
*** SUMMARY ***
Total pot 1860 | Rake 0 
Board [2d Jd Qd Tc Th]
Seat 1: fofAAoBR (small blind) folded on the River
Seat 2: SAS_IDS0804 (big blind) folded on the River
Seat 3: JonzStars folded before Flop (didn't bet)
Seat 4: MagoDelBaralho folded before Flop (didn't bet)
Seat 5: VICTOR TXR1 folded before Flop (didn't bet)
Seat 6: XxJoaoFeraxX (button) collected (1860)

PokerStars Hand #251209470341: Tournament #3769361908, $52.38+$2.62 USD Hold'em No Limit - Level IX (150/300) - 2024/06/26 22:27:44 UTC [2024/06/26 18:27:44 ET]
Table '3769361908 16' 6-max Seat #1 is the button
Seat 1: fofAAoBR (24238 in chips) 
Seat 2: SAS_IDS0804 (9260 in chips) 
Seat 3: JonzStars (4687 in chips) 
Seat 4: MagoDelBaralho (8576 in chips) 
Seat 5: VICTOR TXR1 (9312 in chips) 
Seat 6: XxJoaoFeraxX (12026 in chips) 
fofAAoBR: posts the ante 75
SAS_IDS0804: posts the ante 75
JonzStars: posts the ante 75
MagoDelBaralho: posts the ante 75
VICTOR TXR1: posts the ante 75
XxJoaoFeraxX: posts the ante 75
SAS_IDS0804: posts small blind 150
JonzStars: posts big blind 300
*** HOLE CARDS ***
MagoDelBaralho: folds 
VICTOR TXR1: raises 348 to 648
XxJoaoFeraxX: folds 
fofAAoBR: calls 648
SAS_IDS0804: folds 
JonzStars: folds 
*** FLOP *** [9h Ks 3s]
VICTOR TXR1: checks 
fofAAoBR: checks 
*** TURN *** [9h Ks 3s] [7c]
VICTOR TXR1: bets 1500
fofAAoBR: calls 1500
*** RIVER *** [9h Ks 3s 7c] [5d]
VICTOR TXR1: checks 
fofAAoBR: checks 
*** SHOW DOWN ***
VICTOR TXR1: shows [Ah 5h] (a pair of Fives)
fofAAoBR: shows [Jh Jd] (a pair of Jacks)
fofAAoBR collected 5196 from pot
*** SUMMARY ***
Total pot 5196 | Rake 0 
Board [9h Ks 3s 7c 5d]
Seat 1: fofAAoBR (button) showed [Jh Jd] and won (5196) with a pair of Jacks
Seat 2: SAS_IDS0804 (small blind) folded before Flop
Seat 3: JonzStars (big blind) folded before Flop
Seat 4: MagoDelBaralho folded before Flop (didn't bet)
Seat 5: VICTOR TXR1 showed [Ah 5h] and lost with a pair of Fives
Seat 6: XxJoaoFeraxX folded before Flop (didn't bet)

PokerStars Hand #251209485644: Tournament #3769361908, $52.38+$2.62 USD Hold'em No Limit - Level IX (150/300) - 2024/06/26 22:28:38 UTC [2024/06/26 18:28:38 ET]
Table '3769361908 16' 6-max Seat #2 is the button
Seat 1: fofAAoBR (27211 in chips) 
Seat 2: SAS_IDS0804 (9035 in chips) 
Seat 3: JonzStars (4312 in chips) 
Seat 4: MagoDelBaralho (8501 in chips) 
Seat 5: VICTOR TXR1 (7089 in chips) 
Seat 6: XxJoaoFeraxX (11951 in chips) 
fofAAoBR: posts the ante 75
SAS_IDS0804: posts the ante 75
JonzStars: posts the ante 75
MagoDelBaralho: posts the ante 75
VICTOR TXR1: posts the ante 75
XxJoaoFeraxX: posts the ante 75
JonzStars: posts small blind 150
MagoDelBaralho: posts big blind 300
*** HOLE CARDS ***
VICTOR TXR1: folds 
XxJoaoFeraxX: folds 
fofAAoBR: raises 300 to 600
SAS_IDS0804: folds 
JonzStars: raises 3637 to 4237 and is all-in
MagoDelBaralho: folds 
fofAAoBR: folds 
Uncalled bet (3637) returned to JonzStars
JonzStars collected 1950 from pot
*** SUMMARY ***
Total pot 1950 | Rake 0 
Seat 1: fofAAoBR folded before Flop
Seat 2: SAS_IDS0804 (button) folded before Flop (didn't bet)
Seat 3: JonzStars (small blind) collected (1950)
Seat 4: MagoDelBaralho (big blind) folded before Flop
Seat 5: VICTOR TXR1 folded before Flop (didn't bet)
Seat 6: XxJoaoFeraxX folded before Flop (didn't bet)

PokerStars Hand #251209492386: Tournament #3769361908, $52.38+$2.62 USD Hold'em No Limit - Level IX (150/300) - 2024/06/26 22:29:03 UTC [2024/06/26 18:29:03 ET]
Table '3769361908 16' 6-max Seat #3 is the button
Seat 1: fofAAoBR (26536 in chips) 
Seat 2: SAS_IDS0804 (8960 in chips) 
Seat 3: JonzStars (5587 in chips) 
Seat 4: MagoDelBaralho (8126 in chips) 
Seat 6: XxJoaoFeraxX (11876 in chips) 
fofAAoBR: posts the ante 75
SAS_IDS0804: posts the ante 75
JonzStars: posts the ante 75
MagoDelBaralho: posts the ante 75
XxJoaoFeraxX: posts the ante 75
MagoDelBaralho: posts small blind 150
XxJoaoFeraxX: posts big blind 300
*** HOLE CARDS ***
fofAAoBR: folds 
SAS_IDS0804: folds 
JonzStars: folds 
MagoDelBaralho: folds 
Uncalled bet (150) returned to XxJoaoFeraxX
XxJoaoFeraxX collected 675 from pot
XxJoaoFeraxX: doesn't show hand 
*** SUMMARY ***
Total pot 675 | Rake 0 
Seat 1: fofAAoBR folded before Flop (didn't bet)
Seat 2: SAS_IDS0804 folded before Flop (didn't bet)
Seat 3: JonzStars (button) folded before Flop (didn't bet)
Seat 4: MagoDelBaralho (small blind) folded before Flop
Seat 6: XxJoaoFeraxX (big blind) collected (675)

PokerStars Hand #251209502783: Tournament #3769361908, $52.38+$2.62 USD Hold'em No Limit - Level X (200/400) - 2024/06/26 22:29:40 UTC [2024/06/26 18:29:40 ET]
Table '3769361908 16' 6-max Seat #4 is the button
Seat 1: fofAAoBR (26461 in chips) 
Seat 2: SAS_IDS0804 (8885 in chips) 
Seat 3: JonzStars (5512 in chips) 
Seat 4: MagoDelBaralho (7901 in chips) 
Seat 6: XxJoaoFeraxX (12326 in chips) 
fofAAoBR: posts the ante 100
SAS_IDS0804: posts the ante 100
JonzStars: posts the ante 100
MagoDelBaralho: posts the ante 100
XxJoaoFeraxX: posts the ante 100
XxJoaoFeraxX: posts small blind 200
fofAAoBR: posts big blind 400
*** HOLE CARDS ***
SAS_IDS0804: folds 
JonzStars: folds 
MagoDelBaralho: folds 
XxJoaoFeraxX: calls 200
fofAAoBR: checks 
*** FLOP *** [5h Tc Ad]
XxJoaoFeraxX: checks 
fofAAoBR: bets 400
XxJoaoFeraxX: calls 400
*** TURN *** [5h Tc Ad] [2d]
XxJoaoFeraxX: checks 
fofAAoBR: bets 1470
XxJoaoFeraxX: folds 
Uncalled bet (1470) returned to fofAAoBR
fofAAoBR collected 2100 from pot
fofAAoBR: doesn't show hand 
*** SUMMARY ***
Total pot 2100 | Rake 0 
Board [5h Tc Ad 2d]
Seat 1: fofAAoBR (big blind) collected (2100)
Seat 2: SAS_IDS0804 folded before Flop (didn't bet)
Seat 3: JonzStars folded before Flop (didn't bet)
Seat 4: MagoDelBaralho (button) folded before Flop (didn't bet)
Seat 6: XxJoaoFeraxX (small blind) folded on the Turn

PokerStars Hand #251209516322: Tournament #3769361908, $52.38+$2.62 USD Hold'em No Limit - Level X (200/400) - 2024/06/26 22:30:28 UTC [2024/06/26 18:30:28 ET]
Table '3769361908 16' 6-max Seat #6 is the button
Seat 1: fofAAoBR (27661 in chips) 
Seat 2: SAS_IDS0804 (8785 in chips) 
Seat 3: JonzStars (5412 in chips) 
Seat 4: MagoDelBaralho (7801 in chips) 
Seat 6: XxJoaoFeraxX (11426 in chips) 
fofAAoBR: posts the ante 100
SAS_IDS0804: posts the ante 100
JonzStars: posts the ante 100
MagoDelBaralho: posts the ante 100
XxJoaoFeraxX: posts the ante 100
fofAAoBR: posts small blind 200
SAS_IDS0804: posts big blind 400
*** HOLE CARDS ***
JonzStars: folds 
MagoDelBaralho: folds 
XxJoaoFeraxX: raises 400 to 800
fofAAoBR: folds 
SAS_IDS0804: calls 400
*** FLOP *** [5s Qh 3s]
SAS_IDS0804: checks 
XxJoaoFeraxX: checks 
*** TURN *** [5s Qh 3s] [As]
SAS_IDS0804: checks 
XxJoaoFeraxX: checks 
*** RIVER *** [5s Qh 3s As] [2d]
SAS_IDS0804: bets 7885 and is all-in
XxJoaoFeraxX: folds 
Uncalled bet (7885) returned to SAS_IDS0804
SAS_IDS0804 collected 2300 from pot
SAS_IDS0804: doesn't show hand 
*** SUMMARY ***
Total pot 2300 | Rake 0 
Board [5s Qh 3s As 2d]
Seat 1: fofAAoBR (small blind) folded before Flop
Seat 2: SAS_IDS0804 (big blind) collected (2300)
Seat 3: JonzStars folded before Flop (didn't bet)
Seat 4: MagoDelBaralho folded before Flop (didn't bet)
Seat 6: XxJoaoFeraxX (button) folded on the River

PokerStars Hand #251209539009: Tournament #3769361908, $52.38+$2.62 USD Hold'em No Limit - Level X (200/400) - 2024/06/26 22:31:51 UTC [2024/06/26 18:31:51 ET]
Table '3769361908 16' 6-max Seat #1 is the button
Seat 1: fofAAoBR (27361 in chips) 
Seat 2: SAS_IDS0804 (10185 in chips) 
Seat 3: JonzStars (5312 in chips) 
Seat 4: MagoDelBaralho (7701 in chips) 
Seat 5: mila is best (10000 in chips) 
Seat 6: XxJoaoFeraxX (10526 in chips) 
fofAAoBR: posts the ante 100
SAS_IDS0804: posts the ante 100
JonzStars: posts the ante 100
MagoDelBaralho: posts the ante 100
mila is best: posts the ante 100
XxJoaoFeraxX: posts the ante 100
SAS_IDS0804: posts small blind 200
JonzStars: posts big blind 400
*** HOLE CARDS ***
MagoDelBaralho: folds 
mila is best: raises 400 to 800
XxJoaoFeraxX: folds 
fofAAoBR: calls 800
SAS_IDS0804: folds 
JonzStars: calls 400
*** FLOP *** [Ad Td 5d]
JonzStars: checks 
mila is best: checks 
fofAAoBR: checks 
*** TURN *** [Ad Td 5d] [Jc]
JonzStars: checks 
mila is best: checks 
fofAAoBR: checks 
*** RIVER *** [Ad Td 5d Jc] [Kh]
JonzStars: checks 
mila is best: checks 
fofAAoBR: checks 
*** SHOW DOWN ***
JonzStars: shows [7d Th] (a pair of Tens)
mila is best: shows [Ts 8s] (a pair of Tens)
fofAAoBR: mucks hand 
JonzStars collected 1600 from pot
mila is best collected 1600 from pot
*** SUMMARY ***
Total pot 3200 | Rake 0 
Board [Ad Td 5d Jc Kh]
Seat 1: fofAAoBR (button) mucked
Seat 2: SAS_IDS0804 (small blind) folded before Flop
Seat 3: JonzStars (big blind) showed [7d Th] and won (1600) with a pair of Tens
Seat 4: MagoDelBaralho folded before Flop (didn't bet)
Seat 5: mila is best showed [Ts 8s] and won (1600) with a pair of Tens
Seat 6: XxJoaoFeraxX folded before Flop (didn't bet)

PokerStars Hand #251209556302: Tournament #3769361908, $52.38+$2.62 USD Hold'em No Limit - Level XI (250/500) - 2024/06/26 22:32:55 UTC [2024/06/26 18:32:55 ET]
Table '3769361908 16' 6-max Seat #2 is the button
Seat 1: fofAAoBR (26461 in chips) 
Seat 2: SAS_IDS0804 (9885 in chips) 
Seat 3: JonzStars (6012 in chips) 
Seat 4: MagoDelBaralho (7601 in chips) 
Seat 5: mila is best (10700 in chips) 
Seat 6: XxJoaoFeraxX (10426 in chips) 
fofAAoBR: posts the ante 125
SAS_IDS0804: posts the ante 125
JonzStars: posts the ante 125
MagoDelBaralho: posts the ante 125
mila is best: posts the ante 125
XxJoaoFeraxX: posts the ante 125
JonzStars: posts small blind 250
MagoDelBaralho: posts big blind 500
*** HOLE CARDS ***
mila is best: folds 
XxJoaoFeraxX: raises 500 to 1000
fofAAoBR: folds 
SAS_IDS0804: folds 
JonzStars: folds 
MagoDelBaralho: raises 6476 to 7476 and is all-in
XxJoaoFeraxX: folds 
Uncalled bet (6476) returned to MagoDelBaralho
MagoDelBaralho collected 3000 from pot
*** SUMMARY ***
Total pot 3000 | Rake 0 
Seat 1: fofAAoBR folded before Flop (didn't bet)
Seat 2: SAS_IDS0804 (button) folded before Flop (didn't bet)
Seat 3: JonzStars (small blind) folded before Flop
Seat 4: MagoDelBaralho (big blind) collected (3000)
Seat 5: mila is best folded before Flop (didn't bet)
Seat 6: XxJoaoFeraxX folded before Flop

PokerStars Hand #251209564298: Tournament #3769361908, $52.38+$2.62 USD Hold'em No Limit - Level XI (250/500) - 2024/06/26 22:33:24 UTC [2024/06/26 18:33:24 ET]
Table '3769361908 16' 6-max Seat #3 is the button
Seat 1: fofAAoBR (26336 in chips) 
Seat 2: SAS_IDS0804 (9760 in chips) 
Seat 3: JonzStars (5637 in chips) 
Seat 4: MagoDelBaralho (9476 in chips) 
Seat 5: mila is best (10575 in chips) 
Seat 6: XxJoaoFeraxX (9301 in chips) 
fofAAoBR: posts the ante 125
SAS_IDS0804: posts the ante 125
JonzStars: posts the ante 125
MagoDelBaralho: posts the ante 125
mila is best: posts the ante 125
XxJoaoFeraxX: posts the ante 125
MagoDelBaralho: posts small blind 250
mila is best: posts big blind 500
*** HOLE CARDS ***
XxJoaoFeraxX: raises 500 to 1000
fofAAoBR: folds 
SAS_IDS0804: folds 
JonzStars: folds 
MagoDelBaralho: folds 
mila is best: raises 9450 to 10450 and is all-in
XxJoaoFeraxX: folds 
Uncalled bet (9450) returned to mila is best
mila is best collected 3000 from pot
*** SUMMARY ***
Total pot 3000 | Rake 0 
Seat 1: fofAAoBR folded before Flop (didn't bet)
Seat 2: SAS_IDS0804 folded before Flop (didn't bet)
Seat 3: JonzStars (button) folded before Flop (didn't bet)
Seat 4: MagoDelBaralho (small blind) folded before Flop
Seat 5: mila is best (big blind) collected (3000)
Seat 6: XxJoaoFeraxX folded before Flop

PokerStars Hand #251209574005: Tournament #3769361908, $52.38+$2.62 USD Hold'em No Limit - Level XI (250/500) - 2024/06/26 22:34:01 UTC [2024/06/26 18:34:01 ET]
Table '3769361908 16' 6-max Seat #4 is the button
Seat 1: fofAAoBR (26211 in chips) 
Seat 2: SAS_IDS0804 (9635 in chips) 
Seat 3: JonzStars (5512 in chips) 
Seat 4: MagoDelBaralho (9101 in chips) 
Seat 5: mila is best (12450 in chips) 
Seat 6: XxJoaoFeraxX (8176 in chips) 
fofAAoBR: posts the ante 125
SAS_IDS0804: posts the ante 125
JonzStars: posts the ante 125
MagoDelBaralho: posts the ante 125
mila is best: posts the ante 125
XxJoaoFeraxX: posts the ante 125
mila is best: posts small blind 250
XxJoaoFeraxX: posts big blind 500
*** HOLE CARDS ***
fofAAoBR: raises 500 to 1000
SAS_IDS0804: folds 
JonzStars: folds 
MagoDelBaralho: folds 
mila is best: folds 
XxJoaoFeraxX: calls 500
*** FLOP *** [9s 5s 8h]
XxJoaoFeraxX: checks 
fofAAoBR: checks 
*** TURN *** [9s 5s 8h] [Ah]
XxJoaoFeraxX: checks 
fofAAoBR: bets 1500
XxJoaoFeraxX: calls 1500
*** RIVER *** [9s 5s 8h Ah] [Ac]
XxJoaoFeraxX: checks 
fofAAoBR: checks 
*** SHOW DOWN ***
XxJoaoFeraxX: shows [6c As] (three of a kind, Aces)
fofAAoBR: mucks hand 
XxJoaoFeraxX collected 6000 from pot
*** SUMMARY ***
Total pot 6000 | Rake 0 
Board [9s 5s 8h Ah Ac]
Seat 1: fofAAoBR mucked
Seat 2: SAS_IDS0804 folded before Flop (didn't bet)
Seat 3: JonzStars folded before Flop (didn't bet)
Seat 4: MagoDelBaralho (button) folded before Flop (didn't bet)
Seat 5: mila is best (small blind) folded before Flop
Seat 6: XxJoaoFeraxX (big blind) showed [6c As] and won (6000) with three of a kind, Aces

PokerStars Hand #251209588098: Tournament #3769361908, $52.38+$2.62 USD Hold'em No Limit - Level XI (250/500) - 2024/06/26 22:34:53 UTC [2024/06/26 18:34:53 ET]
Table '3769361908 16' 6-max Seat #5 is the button
Seat 1: fofAAoBR (23586 in chips) 
Seat 2: SAS_IDS0804 (9510 in chips) 
Seat 3: JonzStars (5387 in chips) 
Seat 4: MagoDelBaralho (8976 in chips) 
Seat 5: mila is best (12075 in chips) 
Seat 6: XxJoaoFeraxX (11551 in chips) 
fofAAoBR: posts the ante 125
SAS_IDS0804: posts the ante 125
JonzStars: posts the ante 125
MagoDelBaralho: posts the ante 125
mila is best: posts the ante 125
XxJoaoFeraxX: posts the ante 125
XxJoaoFeraxX: posts small blind 250
fofAAoBR: posts big blind 500
*** HOLE CARDS ***
SAS_IDS0804: folds 
JonzStars: raises 4762 to 5262 and is all-in
MagoDelBaralho: folds 
mila is best: folds 
XxJoaoFeraxX: folds 
fofAAoBR: folds 
Uncalled bet (4762) returned to JonzStars
JonzStars collected 2000 from pot
*** SUMMARY ***
Total pot 2000 | Rake 0 
Seat 1: fofAAoBR (big blind) folded before Flop
Seat 2: SAS_IDS0804 folded before Flop (didn't bet)
Seat 3: JonzStars collected (2000)
Seat 4: MagoDelBaralho folded before Flop (didn't bet)
Seat 5: mila is best (button) folded before Flop (didn't bet)
Seat 6: XxJoaoFeraxX (small blind) folded before Flop

PokerStars Hand #251209593806: Tournament #3769361908, $52.38+$2.62 USD Hold'em No Limit - Level XII (300/600) - 2024/06/26 22:35:14 UTC [2024/06/26 18:35:14 ET]
Table '3769361908 16' 6-max Seat #6 is the button
Seat 1: fofAAoBR (22961 in chips) 
Seat 2: SAS_IDS0804 (9385 in chips) 
Seat 3: JonzStars (6762 in chips) 
Seat 4: MagoDelBaralho (8851 in chips) 
Seat 5: mila is best (11950 in chips) 
Seat 6: XxJoaoFeraxX (11176 in chips) 
fofAAoBR: posts the ante 150
SAS_IDS0804: posts the ante 150
JonzStars: posts the ante 150
MagoDelBaralho: posts the ante 150
mila is best: posts the ante 150
XxJoaoFeraxX: posts the ante 150
fofAAoBR: posts small blind 300
SAS_IDS0804: posts big blind 600
*** HOLE CARDS ***
JonzStars: raises 6012 to 6612 and is all-in
MagoDelBaralho: folds 
mila is best: folds 
XxJoaoFeraxX: folds 
fofAAoBR: folds 
SAS_IDS0804: folds 
Uncalled bet (6012) returned to JonzStars
JonzStars collected 2400 from pot
*** SUMMARY ***
Total pot 2400 | Rake 0 
Seat 1: fofAAoBR (small blind) folded before Flop
Seat 2: SAS_IDS0804 (big blind) folded before Flop
Seat 3: JonzStars collected (2400)
Seat 4: MagoDelBaralho folded before Flop (didn't bet)
Seat 5: mila is best folded before Flop (didn't bet)
Seat 6: XxJoaoFeraxX (button) folded before Flop (didn't bet)

PokerStars Hand #251209600919: Tournament #3769361908, $52.38+$2.62 USD Hold'em No Limit - Level XII (300/600) - 2024/06/26 22:35:41 UTC [2024/06/26 18:35:41 ET]
Table '3769361908 16' 6-max Seat #1 is the button
Seat 1: fofAAoBR (22511 in chips) 
Seat 2: SAS_IDS0804 (8635 in chips) 
Seat 3: JonzStars (8412 in chips) 
Seat 4: MagoDelBaralho (8701 in chips) 
Seat 5: mila is best (11800 in chips) 
Seat 6: XxJoaoFeraxX (11026 in chips) 
fofAAoBR: posts the ante 150
SAS_IDS0804: posts the ante 150
JonzStars: posts the ante 150
MagoDelBaralho: posts the ante 150
mila is best: posts the ante 150
XxJoaoFeraxX: posts the ante 150
SAS_IDS0804: posts small blind 300
JonzStars: posts big blind 600
*** HOLE CARDS ***
MagoDelBaralho: folds 
mila is best: raises 600 to 1200
XxJoaoFeraxX: folds 
fofAAoBR: raises 1800 to 3000
SAS_IDS0804: folds 
JonzStars: folds 
mila is best: calls 1800
*** FLOP *** [9c Kc 2h]
mila is best: checks 
fofAAoBR: bets 900
mila is best: calls 900
*** TURN *** [9c Kc 2h] [As]
mila is best: checks 
fofAAoBR: bets 2100
mila is best: folds 
Uncalled bet (2100) returned to fofAAoBR
fofAAoBR collected 9600 from pot
fofAAoBR: doesn't show hand 
*** SUMMARY ***
Total pot 9600 | Rake 0 
Board [9c Kc 2h As]
Seat 1: fofAAoBR (button) collected (9600)
Seat 2: SAS_IDS0804 (small blind) folded before Flop
Seat 3: JonzStars (big blind) folded before Flop
Seat 4: MagoDelBaralho folded before Flop (didn't bet)
Seat 5: mila is best folded on the Turn
Seat 6: XxJoaoFeraxX folded before Flop (didn't bet)

PokerStars Hand #251209616592: Tournament #3769361908, $52.38+$2.62 USD Hold'em No Limit - Level XII (300/600) - 2024/06/26 22:36:39 UTC [2024/06/26 18:36:39 ET]
Table '3769361908 16' 6-max Seat #2 is the button
Seat 1: fofAAoBR (28061 in chips) 
Seat 2: SAS_IDS0804 (8185 in chips) 
Seat 3: JonzStars (7662 in chips) 
Seat 4: MagoDelBaralho (8551 in chips) 
Seat 5: mila is best (7750 in chips) 
Seat 6: XxJoaoFeraxX (10876 in chips) 
fofAAoBR: posts the ante 150
SAS_IDS0804: posts the ante 150
JonzStars: posts the ante 150
MagoDelBaralho: posts the ante 150
mila is best: posts the ante 150
XxJoaoFeraxX: posts the ante 150
JonzStars: posts small blind 300
MagoDelBaralho: posts big blind 600
*** HOLE CARDS ***
mila is best: folds 
XxJoaoFeraxX: raises 600 to 1200
fofAAoBR: folds 
SAS_IDS0804: folds 
JonzStars: folds 
MagoDelBaralho: raises 7201 to 8401 and is all-in
XxJoaoFeraxX: folds 
Uncalled bet (7201) returned to MagoDelBaralho
MagoDelBaralho collected 3600 from pot
*** SUMMARY ***
Total pot 3600 | Rake 0 
Seat 1: fofAAoBR folded before Flop (didn't bet)
Seat 2: SAS_IDS0804 (button) folded before Flop (didn't bet)
Seat 3: JonzStars (small blind) folded before Flop
Seat 4: MagoDelBaralho (big blind) collected (3600)
Seat 5: mila is best folded before Flop (didn't bet)
Seat 6: XxJoaoFeraxX folded before Flop

PokerStars Hand #251209627110: Tournament #3769361908, $52.38+$2.62 USD Hold'em No Limit - Level XII (300/600) - 2024/06/26 22:37:19 UTC [2024/06/26 18:37:19 ET]
Table '3769361908 16' 6-max Seat #3 is the button
Seat 1: fofAAoBR (27911 in chips) 
Seat 2: SAS_IDS0804 (8035 in chips) 
Seat 3: JonzStars (7212 in chips) 
Seat 4: MagoDelBaralho (10801 in chips) 
Seat 5: mila is best (7600 in chips) 
Seat 6: XxJoaoFeraxX (9526 in chips) 
fofAAoBR: posts the ante 150
SAS_IDS0804: posts the ante 150
JonzStars: posts the ante 150
MagoDelBaralho: posts the ante 150
mila is best: posts the ante 150
XxJoaoFeraxX: posts the ante 150
MagoDelBaralho: posts small blind 300
mila is best: posts big blind 600
*** HOLE CARDS ***
XxJoaoFeraxX: folds 
fofAAoBR: raises 720 to 1320
SAS_IDS0804: folds 
JonzStars: folds 
MagoDelBaralho: folds 
mila is best: calls 720
*** FLOP *** [3s Qc 7h]
mila is best: checks 
fofAAoBR: bets 1267
mila is best: calls 1267
*** TURN *** [3s Qc 7h] [Th]
mila is best: checks 
fofAAoBR: checks 
*** RIVER *** [3s Qc 7h Th] [6d]
mila is best: checks 
fofAAoBR: checks 
*** SHOW DOWN ***
mila is best: shows [3c 6c] (two pair, Sixes and Threes)
fofAAoBR: mucks hand 
mila is best collected 6374 from pot
*** SUMMARY ***
Total pot 6374 | Rake 0 
Board [3s Qc 7h Th 6d]
Seat 1: fofAAoBR mucked
Seat 2: SAS_IDS0804 folded before Flop (didn't bet)
Seat 3: JonzStars (button) folded before Flop (didn't bet)
Seat 4: MagoDelBaralho (small blind) folded before Flop
Seat 5: mila is best (big blind) showed [3c 6c] and won (6374) with two pair, Sixes and Threes
Seat 6: XxJoaoFeraxX folded before Flop (didn't bet)

PokerStars Hand #251209639696: Tournament #3769361908, $52.38+$2.62 USD Hold'em No Limit - Level XII (300/600) - 2024/06/26 22:38:06 UTC [2024/06/26 18:38:06 ET]
Table '3769361908 16' 6-max Seat #4 is the button
Seat 1: fofAAoBR (25174 in chips) 
Seat 2: SAS_IDS0804 (7885 in chips) 
Seat 3: JonzStars (7062 in chips) 
Seat 4: MagoDelBaralho (10351 in chips) 
Seat 5: mila is best (11237 in chips) 
Seat 6: XxJoaoFeraxX (9376 in chips) 
fofAAoBR: posts the ante 150
SAS_IDS0804: posts the ante 150
JonzStars: posts the ante 150
MagoDelBaralho: posts the ante 150
mila is best: posts the ante 150
XxJoaoFeraxX: posts the ante 150
mila is best: posts small blind 300
XxJoaoFeraxX: posts big blind 600
*** HOLE CARDS ***
fofAAoBR: folds 
SAS_IDS0804: raises 600 to 1200
JonzStars: folds 
MagoDelBaralho: folds 
mila is best: folds 
XxJoaoFeraxX: folds 
Uncalled bet (600) returned to SAS_IDS0804
SAS_IDS0804 collected 2400 from pot
SAS_IDS0804: doesn't show hand 
*** SUMMARY ***
Total pot 2400 | Rake 0 
Seat 1: fofAAoBR folded before Flop (didn't bet)
Seat 2: SAS_IDS0804 collected (2400)
Seat 3: JonzStars folded before Flop (didn't bet)
Seat 4: MagoDelBaralho (button) folded before Flop (didn't bet)
Seat 5: mila is best (small blind) folded before Flop
Seat 6: XxJoaoFeraxX (big blind) folded before Flop

PokerStars Hand #251209649665: Tournament #3769361908, $52.38+$2.62 USD Hold'em No Limit - Level XIII (400/800) - 2024/06/26 22:38:43 UTC [2024/06/26 18:38:43 ET]
Table '3769361908 16' 6-max Seat #5 is the button
Seat 1: fofAAoBR (25024 in chips) 
Seat 2: SAS_IDS0804 (9535 in chips) 
Seat 3: JonzStars (6912 in chips) 
Seat 4: MagoDelBaralho (10201 in chips) 
Seat 5: mila is best (10787 in chips) 
Seat 6: XxJoaoFeraxX (8626 in chips) 
fofAAoBR: posts the ante 200
SAS_IDS0804: posts the ante 200
JonzStars: posts the ante 200
MagoDelBaralho: posts the ante 200
mila is best: posts the ante 200
XxJoaoFeraxX: posts the ante 200
XxJoaoFeraxX: posts small blind 400
fofAAoBR: posts big blind 800
*** HOLE CARDS ***
SAS_IDS0804: folds 
JonzStars: raises 800 to 1600
MagoDelBaralho: folds 
mila is best: folds 
XxJoaoFeraxX: folds 
fofAAoBR: calls 800
*** FLOP *** [Td Kh Qs]
fofAAoBR: checks 
JonzStars: bets 5112 and is all-in
fofAAoBR: folds 
Uncalled bet (5112) returned to JonzStars
JonzStars collected 4800 from pot
*** SUMMARY ***
Total pot 4800 | Rake 0 
Board [Td Kh Qs]
Seat 1: fofAAoBR (big blind) folded on the Flop
Seat 2: SAS_IDS0804 folded before Flop (didn't bet)
Seat 3: JonzStars collected (4800)
Seat 4: MagoDelBaralho folded before Flop (didn't bet)
Seat 5: mila is best (button) folded before Flop (didn't bet)
Seat 6: XxJoaoFeraxX (small blind) folded before Flop

PokerStars Hand #251209657584: Tournament #3769361908, $52.38+$2.62 USD Hold'em No Limit - Level XIII (400/800) - 2024/06/26 22:39:13 UTC [2024/06/26 18:39:13 ET]
Table '3769361908 16' 6-max Seat #6 is the button
Seat 1: fofAAoBR (23224 in chips) 
Seat 2: SAS_IDS0804 (9335 in chips) 
Seat 3: JonzStars (9912 in chips) 
Seat 4: MagoDelBaralho (10001 in chips) 
Seat 5: mila is best (10587 in chips) 
Seat 6: XxJoaoFeraxX (8026 in chips) 
fofAAoBR: posts the ante 200
SAS_IDS0804: posts the ante 200
JonzStars: posts the ante 200
MagoDelBaralho: posts the ante 200
mila is best: posts the ante 200
XxJoaoFeraxX: posts the ante 200
fofAAoBR: posts small blind 400
SAS_IDS0804: posts big blind 800
*** HOLE CARDS ***
JonzStars: folds 
MagoDelBaralho: folds 
mila is best: raises 9587 to 10387 and is all-in
XxJoaoFeraxX: folds 
fofAAoBR: folds 
SAS_IDS0804: calls 8335 and is all-in
Uncalled bet (1252) returned to mila is best
*** FLOP *** [Js 6c Jh]
*** TURN *** [Js 6c Jh] [7d]
*** RIVER *** [Js 6c Jh 7d] [Qh]
*** SHOW DOWN ***
SAS_IDS0804: shows [As 3d] (a pair of Jacks)
mila is best: shows [Ad Kc] (a pair of Jacks - Ace+King kicker)
mila is best collected 19870 from pot
SAS_IDS0804 finished the tournament
*** SUMMARY ***
Total pot 19870 | Rake 0 
Board [Js 6c Jh 7d Qh]
Seat 1: fofAAoBR (small blind) folded before Flop
Seat 2: SAS_IDS0804 (big blind) showed [As 3d] and lost with a pair of Jacks
Seat 3: JonzStars folded before Flop (didn't bet)
Seat 4: MagoDelBaralho folded before Flop (didn't bet)
Seat 5: mila is best showed [Ad Kc] and won (19870) with a pair of Jacks
Seat 6: XxJoaoFeraxX (button) folded before Flop (didn't bet)

PokerStars Hand #251209666190: Tournament #3769361908, $52.38+$2.62 USD Hold'em No Limit - Level XIII (400/800) - 2024/06/26 22:39:45 UTC [2024/06/26 18:39:45 ET]
Table '3769361908 16' 6-max Seat #1 is the button
Seat 1: fofAAoBR (22624 in chips) 
Seat 3: JonzStars (9712 in chips) 
Seat 4: MagoDelBaralho (9801 in chips) 
Seat 5: mila is best (21122 in chips) 
Seat 6: XxJoaoFeraxX (7826 in chips) 
fofAAoBR: posts the ante 200
JonzStars: posts the ante 200
MagoDelBaralho: posts the ante 200
mila is best: posts the ante 200
XxJoaoFeraxX: posts the ante 200
JonzStars: posts small blind 400
MagoDelBaralho: posts big blind 800
*** HOLE CARDS ***
mila is best: folds 
XxJoaoFeraxX: raises 6826 to 7626 and is all-in
fofAAoBR: folds 
JonzStars: folds 
MagoDelBaralho: folds 
Uncalled bet (6826) returned to XxJoaoFeraxX
XxJoaoFeraxX collected 3000 from pot
XxJoaoFeraxX: doesn't show hand 
*** SUMMARY ***
Total pot 3000 | Rake 0 
Seat 1: fofAAoBR (button) folded before Flop (didn't bet)
Seat 3: JonzStars (small blind) folded before Flop
Seat 4: MagoDelBaralho (big blind) folded before Flop
Seat 5: mila is best folded before Flop (didn't bet)
Seat 6: XxJoaoFeraxX collected (3000)

PokerStars Hand #251209672029: Tournament #3769361908, $52.38+$2.62 USD Hold'em No Limit - Level XIII (400/800) - 2024/06/26 22:40:07 UTC [2024/06/26 18:40:07 ET]
Table '3769361908 16' 6-max Seat #3 is the button
Seat 1: fofAAoBR (22424 in chips) 
Seat 3: JonzStars (9112 in chips) 
Seat 4: MagoDelBaralho (8801 in chips) 
Seat 5: mila is best (20922 in chips) 
Seat 6: XxJoaoFeraxX (9826 in chips) 
fofAAoBR: posts the ante 200
JonzStars: posts the ante 200
MagoDelBaralho: posts the ante 200
mila is best: posts the ante 200
XxJoaoFeraxX: posts the ante 200
MagoDelBaralho: posts small blind 400
mila is best: posts big blind 800
*** HOLE CARDS ***
XxJoaoFeraxX: folds 
fofAAoBR: raises 800 to 1600
passat1g is disconnected 
JonzStars: folds 
MagoDelBaralho: folds 
mila is best: calls 800
*** FLOP *** [Jd 6s Jh]
mila is best: checks 
fofAAoBR: bets 1518
mila is best: calls 1518
*** TURN *** [Jd 6s Jh] [7h]
mila is best: checks 
fofAAoBR: bets 4800
mila is best: folds 
Uncalled bet (4800) returned to fofAAoBR
fofAAoBR collected 7636 from pot
fofAAoBR: doesn't show hand 
*** SUMMARY ***
Total pot 7636 | Rake 0 
Board [Jd 6s Jh 7h]
Seat 1: fofAAoBR collected (7636)
Seat 3: JonzStars (button) folded before Flop (didn't bet)
Seat 4: MagoDelBaralho (small blind) folded before Flop
Seat 5: mila is best (big blind) folded on the Turn
Seat 6: XxJoaoFeraxX folded before Flop (didn't bet)

PokerStars Hand #251209685063: Tournament #3769361908, $52.38+$2.62 USD Hold'em No Limit - Level XIII (400/800) - 2024/06/26 22:40:57 UTC [2024/06/26 18:40:57 ET]
Table '3769361908 16' 6-max Seat #4 is the button
Seat 2: passat1g (15144 in chips) 
Seat 3: JonzStars (8912 in chips) 
Seat 4: MagoDelBaralho (8201 in chips) 
Seat 5: mila is best (17604 in chips) 
Seat 6: XxJoaoFeraxX (9626 in chips) 
passat1g: posts the ante 200
JonzStars: posts the ante 200
MagoDelBaralho: posts the ante 200
mila is best: posts the ante 200
XxJoaoFeraxX: posts the ante 200
mila is best: posts small blind 400
XxJoaoFeraxX: posts big blind 800
*** HOLE CARDS ***
passat1g: raises 800 to 1600
JonzStars: folds 
MagoDelBaralho: folds 
mila is best: calls 1200
nzlking is disconnected 
XxJoaoFeraxX: folds 
*** FLOP *** [Th Jd Qh]
mila is best: checks 
passat1g: bets 3550
mila is best: raises 12254 to 15804 and is all-in
passat1g: calls 9794 and is all-in
Uncalled bet (2460) returned to mila is best
*** TURN *** [Th Jd Qh] [Qc]
*** RIVER *** [Th Jd Qh Qc] [Ad]
*** SHOW DOWN ***
mila is best: shows [9h 8d] (a straight, Eight to Queen)
passat1g: shows [Ts Js] (two pair, Queens and Jacks)
mila is best collected 31688 from pot
passat1g finished the tournament
*** SUMMARY ***
Total pot 31688 | Rake 0 
Board [Th Jd Qh Qc Ad]
Seat 2: passat1g showed [Ts Js] and lost with two pair, Queens and Jacks
Seat 3: JonzStars folded before Flop (didn't bet)
Seat 4: MagoDelBaralho (button) folded before Flop (didn't bet)
Seat 5: mila is best (small blind) showed [9h 8d] and won (31688) with a straight, Eight to Queen
Seat 6: XxJoaoFeraxX (big blind) folded before Flop

PokerStars Hand #251209698954: Tournament #3769361908, $52.38+$2.62 USD Hold'em No Limit - Level XIV (500/1000) - 2024/06/26 22:41:50 UTC [2024/06/26 18:41:50 ET]
Table '3769361908 16' 6-max Seat #5 is the button
Seat 1: nzlking (10000 in chips) 
Seat 3: JonzStars (8712 in chips) 
Seat 4: MagoDelBaralho (8001 in chips) 
Seat 5: mila is best (34148 in chips) 
Seat 6: XxJoaoFeraxX (8626 in chips) 
nzlking: posts the ante 250
JonzStars: posts the ante 250
MagoDelBaralho: posts the ante 250
mila is best: posts the ante 250
XxJoaoFeraxX: posts the ante 250
XxJoaoFeraxX: posts small blind 500
nzlking: posts big blind 1000
*** HOLE CARDS ***
JonzStars: folds 
MagoDelBaralho: raises 6751 to 7751 and is all-in
mila is best: folds 
XxJoaoFeraxX: folds 
nzlking: calls 6751
*** FLOP *** [Kc 8c Qs]
*** TURN *** [Kc 8c Qs] [3s]
*** RIVER *** [Kc 8c Qs 3s] [Ac]
*** SHOW DOWN ***
nzlking: shows [Td Ad] (a pair of Aces)
MagoDelBaralho: shows [Ks 5s] (a pair of Kings)
nzlking collected 17252 from pot
MagoDelBaralho finished the tournament
Joe Santana is disconnected 
*** SUMMARY ***
Total pot 17252 | Rake 0 
Board [Kc 8c Qs 3s Ac]
Seat 1: nzlking (big blind) showed [Td Ad] and won (17252) with a pair of Aces
Seat 3: JonzStars folded before Flop (didn't bet)
Seat 4: MagoDelBaralho showed [Ks 5s] and lost with a pair of Kings
Seat 5: mila is best (button) folded before Flop (didn't bet)
Seat 6: XxJoaoFeraxX (small blind) folded before Flop

PokerStars Hand #251209707489: Tournament #3769361908, $52.38+$2.62 USD Hold'em No Limit - Level XIV (500/1000) - 2024/06/26 22:42:23 UTC [2024/06/26 18:42:23 ET]
Table '3769361908 16' 6-max Seat #6 is the button
Seat 1: nzlking (19251 in chips) 
Seat 2: Joe Santana (13150 in chips) 
Seat 3: JonzStars (8462 in chips) 
Seat 5: mila is best (33898 in chips) 
Seat 6: XxJoaoFeraxX (7876 in chips) 
nzlking: posts the ante 250
Joe Santana: posts the ante 250
JonzStars: posts the ante 250
mila is best: posts the ante 250
XxJoaoFeraxX: posts the ante 250
nzlking: posts small blind 500
Joe Santana: posts big blind 1000
*** HOLE CARDS ***
JonzStars: raises 7212 to 8212 and is all-in
mila is best: folds 
XxJoaoFeraxX: folds 
nzlking: folds 
Joe Santana: folds 
Uncalled bet (7212) returned to JonzStars
JonzStars collected 3750 from pot
*** SUMMARY ***
Total pot 3750 | Rake 0 
Seat 1: nzlking (small blind) folded before Flop
Seat 2: Joe Santana (big blind) folded before Flop
Seat 3: JonzStars collected (3750)
Seat 5: mila is best folded before Flop (didn't bet)
Seat 6: XxJoaoFeraxX (button) folded before Flop (didn't bet)

PokerStars Hand #251209719767: Tournament #3769361908, $52.38+$2.62 USD Hold'em No Limit - Level XIV (500/1000) - 2024/06/26 22:43:11 UTC [2024/06/26 18:43:11 ET]
Table '3769361908 16' 6-max Seat #1 is the button
Seat 1: nzlking (18501 in chips) 
Seat 2: Joe Santana (11900 in chips) 
Seat 3: JonzStars (10962 in chips) 
Seat 5: mila is best (33648 in chips) 
Seat 6: XxJoaoFeraxX (7626 in chips) 
nzlking: posts the ante 250
Joe Santana: posts the ante 250
JonzStars: posts the ante 250
mila is best: posts the ante 250
XxJoaoFeraxX: posts the ante 250
Joe Santana: posts small blind 500
JonzStars: posts big blind 1000
*** HOLE CARDS ***
mila is best: folds 
XxJoaoFeraxX: folds 
nzlking: folds 
Earl of Poker V is disconnected 
Joe Santana: folds 
Uncalled bet (500) returned to JonzStars
JonzStars collected 2250 from pot
*** SUMMARY ***
Total pot 2250 | Rake 0 
Seat 1: nzlking (button) folded before Flop (didn't bet)
Seat 2: Joe Santana (small blind) folded before Flop
Seat 3: JonzStars (big blind) collected (2250)
Seat 5: mila is best folded before Flop (didn't bet)
Seat 6: XxJoaoFeraxX folded before Flop (didn't bet)

PokerStars Hand #251209730981: Tournament #3769361908, $52.38+$2.62 USD Hold'em No Limit - Level XIV (500/1000) - 2024/06/26 22:43:55 UTC [2024/06/26 18:43:55 ET]
Table '3769361908 16' 6-max Seat #2 is the button
Seat 1: nzlking (18251 in chips) 
Seat 2: Joe Santana (11150 in chips) 
Seat 3: JonzStars (12462 in chips) 
Seat 4: Earl of Poker V (10000 in chips) 
Seat 5: mila is best (33398 in chips) 
Seat 6: XxJoaoFeraxX (7376 in chips) 
nzlking: posts the ante 250
Joe Santana: posts the ante 250
JonzStars: posts the ante 250
Earl of Poker V: posts the ante 250
mila is best: posts the ante 250
XxJoaoFeraxX: posts the ante 250
JonzStars: posts small blind 500
Earl of Poker V: posts big blind 1000
*** HOLE CARDS ***
mila is best: raises 1000 to 2000
XxJoaoFeraxX: folds 
nzlking: folds 
Joe Santana: folds 
JonzStars: folds 
Earl of Poker V: folds 
Uncalled bet (1000) returned to mila is best
mila is best collected 4000 from pot
*** SUMMARY ***
Total pot 4000 | Rake 0 
Seat 1: nzlking folded before Flop (didn't bet)
Seat 2: Joe Santana (button) folded before Flop (didn't bet)
Seat 3: JonzStars (small blind) folded before Flop
Seat 4: Earl of Poker V (big blind) folded before Flop
Seat 5: mila is best collected (4000)
Seat 6: XxJoaoFeraxX folded before Flop (didn't bet)

PokerStars Hand #251209734654: Tournament #3769361908, $52.38+$2.62 USD Hold'em No Limit - Level XIV (500/1000) - 2024/06/26 22:44:09 UTC [2024/06/26 18:44:09 ET]
Table '3769361908 16' 6-max Seat #3 is the button
Seat 1: nzlking (18001 in chips) 
Seat 2: Joe Santana (10900 in chips) 
Seat 3: JonzStars (11712 in chips) 
Seat 4: Earl of Poker V (8750 in chips) 
Seat 5: mila is best (36148 in chips) 
Seat 6: XxJoaoFeraxX (7126 in chips) 
nzlking: posts the ante 250
Joe Santana: posts the ante 250
JonzStars: posts the ante 250
Earl of Poker V: posts the ante 250
mila is best: posts the ante 250
XxJoaoFeraxX: posts the ante 250
Earl of Poker V: posts small blind 500
mila is best: posts big blind 1000
*** HOLE CARDS ***
XxJoaoFeraxX: raises 5876 to 6876 and is all-in
nzlking: folds 
Joe Santana: folds 
JonzStars: folds 
Earl of Poker V: folds 
mila is best: calls 5876
*** FLOP *** [4c 7c 8s]
*** TURN *** [4c 7c 8s] [3c]
*** RIVER *** [4c 7c 8s 3c] [4s]
*** SHOW DOWN ***
mila is best: shows [3h Qh] (two pair, Fours and Threes)
XxJoaoFeraxX: shows [Jh Kd] (a pair of Fours)
mila is best collected 15752 from pot
XxJoaoFeraxX finished the tournament
*** SUMMARY ***
Total pot 15752 | Rake 0 
Board [4c 7c 8s 3c 4s]
Seat 1: nzlking folded before Flop (didn't bet)
Seat 2: Joe Santana folded before Flop (didn't bet)
Seat 3: JonzStars (button) folded before Flop (didn't bet)
Seat 4: Earl of Poker V (small blind) folded before Flop
Seat 5: mila is best (big blind) showed [3h Qh] and won (15752) with two pair, Fours and Threes
Seat 6: XxJoaoFeraxX showed [Jh Kd] and lost with a pair of Fours

PokerStars Hand #251209742837: Tournament #3769361908, $52.38+$2.62 USD Hold'em No Limit - Level XV (600/1200) - 2024/06/26 22:44:41 UTC [2024/06/26 18:44:41 ET]
Table '3769361908 16' 6-max Seat #4 is the button
Seat 1: nzlking (17751 in chips) 
Seat 2: Joe Santana (10650 in chips) 
Seat 3: JonzStars (11462 in chips) 
Seat 4: Earl of Poker V (8000 in chips) 
Seat 5: mila is best (44774 in chips) 
nzlking: posts the ante 300
Joe Santana: posts the ante 300
JonzStars: posts the ante 300
Earl of Poker V: posts the ante 300
mila is best: posts the ante 300
mila is best: posts small blind 600
nzlking: posts big blind 1200
*** HOLE CARDS ***
Joe Santana: folds 
escabofildo is disconnected 
JonzStars: folds 
Earl of Poker V: raises 6500 to 7700 and is all-in
mila is best: folds 
nzlking: folds 
Uncalled bet (6500) returned to Earl of Poker V
Earl of Poker V collected 4500 from pot
Earl of Poker V: doesn't show hand 
*** SUMMARY ***
Total pot 4500 | Rake 0 
Seat 1: nzlking (big blind) folded before Flop
Seat 2: Joe Santana folded before Flop (didn't bet)
Seat 3: JonzStars folded before Flop (didn't bet)
Seat 4: Earl of Poker V (button) collected (4500)
Seat 5: mila is best (small blind) folded before Flop

PokerStars Hand #251209749124: Tournament #3769361908, $52.38+$2.62 USD Hold'em No Limit - Level XV (600/1200) - 2024/06/26 22:45:05 UTC [2024/06/26 18:45:05 ET]
Table '3769361908 16' 6-max Seat #5 is the button
Seat 1: nzlking (16251 in chips) 
Seat 3: JonzStars (11162 in chips) 
Seat 4: Earl of Poker V (11000 in chips) 
Seat 5: mila is best (43874 in chips) 
Seat 6: escabofildo (10000 in chips) out of hand (moved from another table into small blind)
escabofildo will be allowed to play after the button
nzlking: posts the ante 300
JonzStars: posts the ante 300
Earl of Poker V: posts the ante 300
mila is best: posts the ante 300
nzlking: posts small blind 600
JonzStars: posts big blind 1200
*** HOLE CARDS ***
Earl of Poker V: folds 
mila is best: raises 1200 to 2400
4sasss is disconnected 
nzlking: folds 
JonzStars: calls 1200
*** FLOP *** [Qc 5s Tc]
JonzStars: checks 
mila is best: checks 
*** TURN *** [Qc 5s Tc] [Jd]
JonzStars: checks 
mila is best: checks 
*** RIVER *** [Qc 5s Tc Jd] [3h]
JonzStars: checks 
mila is best: bets 2400
JonzStars: folds 
Uncalled bet (2400) returned to mila is best
mila is best collected 6600 from pot
*** SUMMARY ***
Total pot 6600 | Rake 0 
Board [Qc 5s Tc Jd 3h]
Seat 1: nzlking (small blind) folded before Flop
Seat 3: JonzStars (big blind) folded on the River
Seat 4: Earl of Poker V folded before Flop (didn't bet)
Seat 5: mila is best (button) collected (6600)

PokerStars Hand #251209760257: Tournament #3769361908, $52.38+$2.62 USD Hold'em No Limit - Level XV (600/1200) - 2024/06/26 22:45:48 UTC [2024/06/26 18:45:48 ET]
Table '3769361908 16' 6-max Seat #1 is the button
Seat 1: nzlking (15351 in chips) 
Seat 2: 4sasss (10000 in chips) out of hand (moved from another table into small blind)
Seat 3: JonzStars (8462 in chips) 
Seat 4: Earl of Poker V (10700 in chips) 
Seat 5: mila is best (47774 in chips) 
Seat 6: escabofildo (10000 in chips) 
4sasss will be allowed to play after the button
nzlking: posts the ante 300
JonzStars: posts the ante 300
Earl of Poker V: posts the ante 300
mila is best: posts the ante 300
escabofildo: posts the ante 300
JonzStars: posts small blind 600
Earl of Poker V: posts big blind 1200
*** HOLE CARDS ***
mila is best: folds 
escabofildo: folds 
nzlking: folds 
JonzStars: raises 6600 to 7800
Earl of Poker V: folds 
Uncalled bet (6600) returned to JonzStars
JonzStars collected 3900 from pot
*** SUMMARY ***
Total pot 3900 | Rake 0 
Seat 1: nzlking (button) folded before Flop (didn't bet)
Seat 3: JonzStars (small blind) collected (3900)
Seat 4: Earl of Poker V (big blind) folded before Flop
Seat 5: mila is best folded before Flop (didn't bet)
Seat 6: escabofildo folded before Flop (didn't bet)

PokerStars Hand #251209764202: Tournament #3769361908, $52.38+$2.62 USD Hold'em No Limit - Level XV (600/1200) - 2024/06/26 22:46:04 UTC [2024/06/26 18:46:04 ET]
Table '3769361908 16' 6-max Seat #3 is the button
Seat 1: nzlking (15051 in chips) 
Seat 2: 4sasss (10000 in chips) 
Seat 3: JonzStars (10862 in chips) 
Seat 4: Earl of Poker V (9200 in chips) 
Seat 5: mila is best (47474 in chips) 
Seat 6: escabofildo (9700 in chips) 
nzlking: posts the ante 300
4sasss: posts the ante 300
JonzStars: posts the ante 300
Earl of Poker V: posts the ante 300
mila is best: posts the ante 300
escabofildo: posts the ante 300
Earl of Poker V: posts small blind 600
mila is best: posts big blind 1200
*** HOLE CARDS ***
escabofildo: folds 
nzlking: folds 
4sasss: raises 8500 to 9700 and is all-in
JonzStars: folds 
Earl of Poker V: calls 8300 and is all-in
mila is best: folds 
Uncalled bet (800) returned to 4sasss
*** FLOP *** [As Kc 7d]
*** TURN *** [As Kc 7d] [4d]
*** RIVER *** [As Kc 7d 4d] [9s]
*** SHOW DOWN ***
Earl of Poker V: shows [9d Kh] (two pair, Kings and Nines)
4sasss: shows [3h Ac] (a pair of Aces)
Earl of Poker V collected 20800 from pot
*** SUMMARY ***
Total pot 20800 | Rake 0 
Board [As Kc 7d 4d 9s]
Seat 1: nzlking folded before Flop (didn't bet)
Seat 2: 4sasss showed [3h Ac] and lost with a pair of Aces
Seat 3: JonzStars (button) folded before Flop (didn't bet)
Seat 4: Earl of Poker V (small blind) showed [9d Kh] and won (20800) with two pair, Kings and Nines
Seat 5: mila is best (big blind) folded before Flop
Seat 6: escabofildo folded before Flop (didn't bet)

PokerStars Hand #251209772343: Tournament #3769361908, $52.38+$2.62 USD Hold'em No Limit - Level XV (600/1200) - 2024/06/26 22:46:35 UTC [2024/06/26 18:46:35 ET]
Table '3769361908 16' 6-max Seat #4 is the button
Seat 1: nzlking (14751 in chips) 
Seat 2: 4sasss (800 in chips) 
Seat 3: JonzStars (10562 in chips) 
Seat 4: Earl of Poker V (20800 in chips) 
Seat 5: mila is best (45974 in chips) 
Seat 6: escabofildo (9400 in chips) 
nzlking: posts the ante 300
4sasss: posts the ante 300
JonzStars: posts the ante 300
Earl of Poker V: posts the ante 300
mila is best: posts the ante 300
escabofildo: posts the ante 300
mila is best: posts small blind 600
escabofildo: posts big blind 1200
*** HOLE CARDS ***
nzlking: folds 
4sasss: calls 500 and is all-in
JonzStars: folds 
Earl of Poker V: raises 19300 to 20500 and is all-in
mila is best: folds 
escabofildo: calls 7900 and is all-in
Uncalled bet (11400) returned to Earl of Poker V
*** FLOP *** [4s 2d 7h]
*** TURN *** [4s 2d 7h] [Kc]
*** RIVER *** [4s 2d 7h Kc] [6h]
*** SHOW DOWN ***
escabofildo: shows [As Ks] (a pair of Kings)
Earl of Poker V: shows [Td Qd] (high card King)
escabofildo collected 17300 from side pot
4sasss: shows [4c 2h] (two pair, Fours and Deuces)
4sasss collected 3800 from main pot
*** SUMMARY ***
Total pot 21100 Main pot 3800. Side pot 17300. | Rake 0 
Board [4s 2d 7h Kc 6h]
Seat 1: nzlking folded before Flop (didn't bet)
Seat 2: 4sasss showed [4c 2h] and won (3800) with two pair, Fours and Deuces
Seat 3: JonzStars folded before Flop (didn't bet)
Seat 4: Earl of Poker V (button) showed [Td Qd] and lost with high card King
Seat 5: mila is best (small blind) folded before Flop
Seat 6: escabofildo (big blind) showed [As Ks] and won (17300) with a pair of Kings

PokerStars Hand #251209779752: Tournament #3769361908, $52.38+$2.62 USD Hold'em No Limit - Level XV (600/1200) - 2024/06/26 22:47:04 UTC [2024/06/26 18:47:04 ET]
Table '3769361908 16' 6-max Seat #5 is the button
Seat 1: nzlking (14451 in chips) 
Seat 2: 4sasss (3800 in chips) 
Seat 3: JonzStars (10262 in chips) 
Seat 4: Earl of Poker V (11400 in chips) 
Seat 5: mila is best (45074 in chips) 
Seat 6: escabofildo (17300 in chips) 
nzlking: posts the ante 300
4sasss: posts the ante 300
JonzStars: posts the ante 300
Earl of Poker V: posts the ante 300
mila is best: posts the ante 300
escabofildo: posts the ante 300
escabofildo: posts small blind 600
nzlking: posts big blind 1200
*** HOLE CARDS ***
4sasss: raises 2300 to 3500 and is all-in
JonzStars: folds 
Earl of Poker V: folds 
mila is best: raises 41274 to 44774 and is all-in
escabofildo: folds 
nzlking: folds 
Uncalled bet (41274) returned to mila is best
*** FLOP *** [Ks Ts Qd]
*** TURN *** [Ks Ts Qd] [7c]
*** RIVER *** [Ks Ts Qd 7c] [Qh]
*** SHOW DOWN ***
4sasss: shows [8d As] (a pair of Queens)
mila is best: shows [Ad 8c] (a pair of Queens)
4sasss collected 5300 from pot
mila is best collected 5300 from pot
*** SUMMARY ***
Total pot 10600 | Rake 0 
Board [Ks Ts Qd 7c Qh]
Seat 1: nzlking (big blind) folded before Flop
Seat 2: 4sasss showed [8d As] and won (5300) with a pair of Queens
Seat 3: JonzStars folded before Flop (didn't bet)
Seat 4: Earl of Poker V folded before Flop (didn't bet)
Seat 5: mila is best (button) showed [Ad 8c] and won (5300) with a pair of Queens
Seat 6: escabofildo (small blind) folded before Flop

PokerStars Hand #251209786581: Tournament #3769361908, $52.38+$2.62 USD Hold'em No Limit - Level XVI (800/1600) - 2024/06/26 22:47:31 UTC [2024/06/26 18:47:31 ET]
Table '3769361908 16' 6-max Seat #6 is the button
Seat 1: nzlking (12951 in chips) 
Seat 2: 4sasss (5300 in chips) 
Seat 3: JonzStars (9962 in chips) 
Seat 4: Earl of Poker V (11100 in chips) 
Seat 5: mila is best (46574 in chips) 
Seat 6: escabofildo (16400 in chips) 
nzlking: posts the ante 400
4sasss: posts the ante 400
JonzStars: posts the ante 400
Earl of Poker V: posts the ante 400
mila is best: posts the ante 400
escabofildo: posts the ante 400
nzlking: posts small blind 800
4sasss: posts big blind 1600
*** HOLE CARDS ***
JonzStars: raises 7962 to 9562 and is all-in
Earl of Poker V: raises 1138 to 10700 and is all-in
mila is best: folds 
escabofildo: folds 
nzlking: folds 
4sasss: folds 
Uncalled bet (1138) returned to Earl of Poker V
*** FLOP *** [Kd 9d Kh]
*** TURN *** [Kd 9d Kh] [8s]
*** RIVER *** [Kd 9d Kh 8s] [9h]
*** SHOW DOWN ***
JonzStars: shows [6c 6s] (two pair, Kings and Nines)
Earl of Poker V: shows [Ac Qc] (two pair, Kings and Nines - Ace kicker)
Earl of Poker V collected 23924 from pot
JonzStars finished the tournament
*** SUMMARY ***
Total pot 23924 | Rake 0 
Board [Kd 9d Kh 8s 9h]
Seat 1: nzlking (small blind) folded before Flop
Seat 2: 4sasss (big blind) folded before Flop
Seat 3: JonzStars showed [6c 6s] and lost with two pair, Kings and Nines
Seat 4: Earl of Poker V showed [Ac Qc] and won (23924) with two pair, Kings and Nines
Seat 5: mila is best folded before Flop (didn't bet)
Seat 6: escabofildo (button) folded before Flop (didn't bet)

PokerStars Hand #251209793516: Tournament #3769361908, $52.38+$2.62 USD Hold'em No Limit - Level XVI (800/1600) - 2024/06/26 22:47:59 UTC [2024/06/26 18:47:59 ET]
Table '3769361908 16' 6-max Seat #1 is the button
Seat 1: nzlking (11751 in chips) 
Seat 2: 4sasss (3300 in chips) 
Seat 4: Earl of Poker V (25062 in chips) 
Seat 5: mila is best (46174 in chips) 
Seat 6: escabofildo (16000 in chips) 
nzlking: posts the ante 400
4sasss: posts the ante 400
Earl of Poker V: posts the ante 400
mila is best: posts the ante 400
escabofildo: posts the ante 400
4sasss: posts small blind 800
Earl of Poker V: posts big blind 1600
*** HOLE CARDS ***
mila is best: folds 
escabofildo: raises 14000 to 15600 and is all-in
nzlking: folds 
4sasss: folds 
Earl of Poker V: calls 14000
*** FLOP *** [Ah Kc 4c]
lintumies12 is disconnected 
*** TURN *** [Ah Kc 4c] [9h]
*** RIVER *** [Ah Kc 4c 9h] [6s]
*** SHOW DOWN ***
Earl of Poker V: shows [Ac 8s] (a pair of Aces)
escabofildo: shows [As 9d] (two pair, Aces and Nines)
escabofildo collected 34000 from pot
*** SUMMARY ***
Total pot 34000 | Rake 0 
Board [Ah Kc 4c 9h 6s]
Seat 1: nzlking (button) folded before Flop (didn't bet)
Seat 2: 4sasss (small blind) folded before Flop
Seat 4: Earl of Poker V (big blind) showed [Ac 8s] and lost with a pair of Aces
Seat 5: mila is best folded before Flop (didn't bet)
Seat 6: escabofildo showed [As 9d] and won (34000) with two pair, Aces and Nines

PokerStars Hand #251209798904: Tournament #3769361908, $52.38+$2.62 USD Hold'em No Limit - Level XVI (800/1600) - 2024/06/26 22:48:20 UTC [2024/06/26 18:48:20 ET]
Table '3769361908 16' 6-max Seat #2 is the button
Seat 1: nzlking (11351 in chips) 
Seat 2: 4sasss (2100 in chips) 
Seat 3: lintumies12 (17370 in chips) out of hand (moved from another table into small blind)
Seat 4: Earl of Poker V (9062 in chips) 
Seat 5: mila is best (45774 in chips) 
Seat 6: escabofildo (34000 in chips) 
lintumies12 will be allowed to play after the button
nzlking: posts the ante 400
4sasss: posts the ante 400
Earl of Poker V: posts the ante 400
mila is best: posts the ante 400
escabofildo: posts the ante 400
Earl of Poker V: posts small blind 800
mila is best: posts big blind 1600
*** HOLE CARDS ***
escabofildo: folds 
nzlking: folds 
4sasss: raises 100 to 1700 and is all-in
Earl of Poker V: raises 6962 to 8662 and is all-in
mila is best: calls 7062
*** FLOP *** [7d 6d 9d]
*** TURN *** [7d 6d 9d] [Th]
*** RIVER *** [7d 6d 9d Th] [8c]
*** SHOW DOWN ***
Earl of Poker V: shows [Kh 7s] (a straight, Six to Ten)
mila is best: shows [3c 3h] (a straight, Six to Ten)
Earl of Poker V collected 6962 from side pot
mila is best collected 6962 from side pot
4sasss: shows [3d Kd] (a flush, King high)
4sasss collected 7100 from main pot
*** SUMMARY ***
Total pot 21024 Main pot 7100. Side pot 13924. | Rake 0 
Board [7d 6d 9d Th 8c]
Seat 1: nzlking folded before Flop (didn't bet)
Seat 2: 4sasss (button) showed [3d Kd] and won (7100) with a flush, King high
Seat 4: Earl of Poker V (small blind) showed [Kh 7s] and won (6962) with a straight, Six to Ten
Seat 5: mila is best (big blind) showed [3c 3h] and won (6962) with a straight, Six to Ten
Seat 6: escabofildo folded before Flop (didn't bet)

PokerStars Hand #251209805854: Tournament #3769361908, $52.38+$2.62 USD Hold'em No Limit - Level XVI (800/1600) - 2024/06/26 22:48:47 UTC [2024/06/26 18:48:47 ET]
Table '3769361908 16' 6-max Seat #4 is the button
Seat 1: nzlking (10951 in chips) 
Seat 2: 4sasss (7100 in chips) 
Seat 3: lintumies12 (17370 in chips) 
Seat 4: Earl of Poker V (6962 in chips) 
Seat 5: mila is best (43674 in chips) 
Seat 6: escabofildo (33600 in chips) 
nzlking: posts the ante 400
4sasss: posts the ante 400
lintumies12: posts the ante 400
Earl of Poker V: posts the ante 400
mila is best: posts the ante 400
escabofildo: posts the ante 400
mila is best: posts small blind 800
escabofildo: posts big blind 1600
*** HOLE CARDS ***
nzlking: folds 
4sasss: raises 5100 to 6700 and is all-in
lintumies12: folds 
Earl of Poker V: folds 
mila is best: folds 
escabofildo: calls 5100
*** FLOP *** [3c 5c 8s]
*** TURN *** [3c 5c 8s] [Th]
*** RIVER *** [3c 5c 8s Th] [Kh]
*** SHOW DOWN ***
escabofildo: shows [Ad Jc] (high card Ace)
4sasss: shows [Kc Jd] (a pair of Kings)
4sasss collected 16600 from pot
*** SUMMARY ***
Total pot 16600 | Rake 0 
Board [3c 5c 8s Th Kh]
Seat 1: nzlking folded before Flop (didn't bet)
Seat 2: 4sasss showed [Kc Jd] and won (16600) with a pair of Kings
Seat 3: lintumies12 folded before Flop (didn't bet)
Seat 4: Earl of Poker V (button) folded before Flop (didn't bet)
Seat 5: mila is best (small blind) folded before Flop
Seat 6: escabofildo (big blind) showed [Ad Jc] and lost with high card Ace

PokerStars Hand #251209815640: Tournament #3769361908, $52.38+$2.62 USD Hold'em No Limit - Level XVI (800/1600) - 2024/06/26 22:49:27 UTC [2024/06/26 18:49:27 ET]
Table '3769361908 16' 6-max Seat #5 is the button
Seat 1: nzlking (10551 in chips) 
Seat 2: 4sasss (16600 in chips) 
Seat 3: lintumies12 (16970 in chips) 
Seat 4: Earl of Poker V (6562 in chips) 
Seat 5: mila is best (42474 in chips) 
Seat 6: escabofildo (26500 in chips) 
nzlking: posts the ante 400
4sasss: posts the ante 400
lintumies12: posts the ante 400
Earl of Poker V: posts the ante 400
mila is best: posts the ante 400
escabofildo: posts the ante 400
escabofildo: posts small blind 800
nzlking: posts big blind 1600
*** HOLE CARDS ***
4sasss: folds 
lintumies12: folds 
Earl of Poker V: folds 
mila is best: folds 
escabofildo: raises 24500 to 26100 and is all-in
nzlking: calls 8551 and is all-in
Uncalled bet (15949) returned to escabofildo
*** FLOP *** [Kc Ad 5h]
*** TURN *** [Kc Ad 5h] [As]
*** RIVER *** [Kc Ad 5h As] [8c]
*** SHOW DOWN ***
escabofildo: shows [3d Ts] (a pair of Aces)
nzlking: shows [6c Qc] (a pair of Aces - King+Queen kicker)
nzlking collected 22702 from pot
*** SUMMARY ***
Total pot 22702 | Rake 0 
Board [Kc Ad 5h As 8c]
Seat 1: nzlking (big blind) showed [6c Qc] and won (22702) with a pair of Aces
Seat 2: 4sasss folded before Flop (didn't bet)
Seat 3: lintumies12 folded before Flop (didn't bet)
Seat 4: Earl of Poker V folded before Flop (didn't bet)
Seat 5: mila is best (button) folded before Flop (didn't bet)
Seat 6: escabofildo (small blind) showed [3d Ts] and lost with a pair of Aces

PokerStars Hand #251209828910: Tournament #3769361908, $52.38+$2.62 USD Hold'em No Limit - Level XVII (1000/2000) - 2024/06/26 22:50:20 UTC [2024/06/26 18:50:20 ET]
Table '3769361908 16' 6-max Seat #6 is the button
Seat 1: nzlking (22702 in chips) 
Seat 2: 4sasss (16200 in chips) 
Seat 3: lintumies12 (16570 in chips) 
Seat 4: Earl of Poker V (6162 in chips) 
Seat 5: mila is best (42074 in chips) 
Seat 6: escabofildo (15949 in chips) 
nzlking: posts the ante 500
4sasss: posts the ante 500
lintumies12: posts the ante 500
Earl of Poker V: posts the ante 500
mila is best: posts the ante 500
escabofildo: posts the ante 500
nzlking: posts small blind 1000
4sasss: posts big blind 2000
*** HOLE CARDS ***
lintumies12: folds 
Earl of Poker V: raises 3662 to 5662 and is all-in
mila is best: folds 
escabofildo: folds 
nzlking: folds 
4sasss: calls 3662
*** FLOP *** [Js Ts Ac]
*** TURN *** [Js Ts Ac] [3c]
*** RIVER *** [Js Ts Ac 3c] [2s]
*** SHOW DOWN ***
4sasss: shows [6c Kh] (high card Ace)
Earl of Poker V: shows [Jd 8d] (a pair of Jacks)
Earl of Poker V collected 15324 from pot
*** SUMMARY ***
Total pot 15324 | Rake 0 
Board [Js Ts Ac 3c 2s]
Seat 1: nzlking (small blind) folded before Flop
Seat 2: 4sasss (big blind) showed [6c Kh] and lost with high card Ace
Seat 3: lintumies12 folded before Flop (didn't bet)
Seat 4: Earl of Poker V showed [Jd 8d] and won (15324) with a pair of Jacks
Seat 5: mila is best folded before Flop (didn't bet)
Seat 6: escabofildo (button) folded before Flop (didn't bet)

PokerStars Hand #251209838244: Tournament #3769361908, $52.38+$2.62 USD Hold'em No Limit - Level XVII (1000/2000) - 2024/06/26 22:50:59 UTC [2024/06/26 18:50:59 ET]
Table '3769361908 16' 6-max Seat #1 is the button
Seat 1: nzlking (21202 in chips) 
Seat 2: 4sasss (10038 in chips) 
Seat 3: lintumies12 (16070 in chips) 
Seat 4: Earl of Poker V (15324 in chips) 
Seat 5: mila is best (41574 in chips) 
Seat 6: escabofildo (15449 in chips) 
nzlking: posts the ante 500
4sasss: posts the ante 500
lintumies12: posts the ante 500
Earl of Poker V: posts the ante 500
mila is best: posts the ante 500
escabofildo: posts the ante 500
4sasss: posts small blind 1000
lintumies12: posts big blind 2000
*** HOLE CARDS ***
Earl of Poker V: folds 
mila is best: folds 
escabofildo: raises 12949 to 14949 and is all-in
nzlking: folds 
4sasss: folds 
lintumies12: calls 12949
*** FLOP *** [5s Qc 6d]
*** TURN *** [5s Qc 6d] [6h]
*** RIVER *** [5s Qc 6d 6h] [Qh]
*** SHOW DOWN ***
lintumies12: shows [Jd Qd] (a full house, Queens full of Sixes)
escabofildo: shows [Ks Ah] (two pair, Queens and Sixes)
lintumies12 collected 33898 from pot
escabofildo finished the tournament in 98th place
*** SUMMARY ***
Total pot 33898 | Rake 0 
Board [5s Qc 6d 6h Qh]
Seat 1: nzlking (button) folded before Flop (didn't bet)
Seat 2: 4sasss (small blind) folded before Flop
Seat 3: lintumies12 (big blind) showed [Jd Qd] and won (33898) with a full house, Queens full of Sixes
Seat 4: Earl of Poker V folded before Flop (didn't bet)
Seat 5: mila is best folded before Flop (didn't bet)
Seat 6: escabofildo showed [Ks Ah] and lost with two pair, Queens and Sixes

PokerStars Hand #251209850724: Tournament #3769361908, $52.38+$2.62 USD Hold'em No Limit - Level XVII (1000/2000) - 2024/06/26 22:51:50 UTC [2024/06/26 18:51:50 ET]
Table '3769361908 16' 6-max Seat #2 is the button
Seat 1: nzlking (20702 in chips) 
Seat 2: 4sasss (8538 in chips) 
Seat 3: lintumies12 (34519 in chips) 
Seat 4: Earl of Poker V (14824 in chips) 
Seat 5: mila is best (41074 in chips) 
nzlking: posts the ante 500
4sasss: posts the ante 500
lintumies12: posts the ante 500
Earl of Poker V: posts the ante 500
mila is best: posts the ante 500
lintumies12: posts small blind 1000
Earl of Poker V: posts big blind 2000
*** HOLE CARDS ***
GabrielTho1 is disconnected 
mila is best: folds 
nzlking: raises 18202 to 20202 and is all-in
4sasss: calls 8038 and is all-in
lintumies12: folds 
Earl of Poker V: folds 
Uncalled bet (12164) returned to nzlking
*** FLOP *** [2d 3d Td]
*** TURN *** [2d 3d Td] [6c]
*** RIVER *** [2d 3d Td 6c] [9d]
*** SHOW DOWN ***
nzlking: shows [As 5s] (high card Ace)
4sasss: shows [Qd Kd] (a flush, King high)
4sasss collected 21576 from pot
*** SUMMARY ***
Total pot 21576 | Rake 0 
Board [2d 3d Td 6c 9d]
Seat 1: nzlking showed [As 5s] and lost with high card Ace
Seat 2: 4sasss (button) showed [Qd Kd] and won (21576) with a flush, King high
Seat 3: lintumies12 (small blind) folded before Flop
Seat 4: Earl of Poker V (big blind) folded before Flop
Seat 5: mila is best folded before Flop (didn't bet)

PokerStars Hand #251209861204: Tournament #3769361908, $52.38+$2.62 USD Hold'em No Limit - Level XVII (1000/2000) - 2024/06/26 22:52:33 UTC [2024/06/26 18:52:33 ET]
Table '3769361908 16' 6-max Seat #3 is the button
Seat 1: nzlking (12164 in chips) 
Seat 2: 4sasss (21576 in chips) 
Seat 3: lintumies12 (33019 in chips) 
Seat 4: Earl of Poker V (12324 in chips) 
Seat 5: mila is best (40574 in chips) 
Seat 6: GabrielTho1 (32111 in chips) 
nzlking: posts the ante 500
4sasss: posts the ante 500
lintumies12: posts the ante 500
Earl of Poker V: posts the ante 500
mila is best: posts the ante 500
GabrielTho1: posts the ante 500
Earl of Poker V: posts small blind 1000
mila is best: posts big blind 2000
*** HOLE CARDS ***
GabrielTho1: folds 
nzlking: folds 
4sasss: raises 19076 to 21076 and is all-in
lintumies12: folds 
Earl of Poker V: folds 
mila is best: folds 
Uncalled bet (19076) returned to 4sasss
4sasss collected 8000 from pot
*** SUMMARY ***
Total pot 8000 | Rake 0 
Seat 1: nzlking folded before Flop (didn't bet)
Seat 2: 4sasss collected (8000)
Seat 3: lintumies12 (button) folded before Flop (didn't bet)
Seat 4: Earl of Poker V (small blind) folded before Flop
Seat 5: mila is best (big blind) folded before Flop
Seat 6: GabrielTho1 folded before Flop (didn't bet)

PokerStars Hand #251209869427: Tournament #3769361908, $52.38+$2.62 USD Hold'em No Limit - Level XVII (1000/2000) - 2024/06/26 22:53:06 UTC [2024/06/26 18:53:06 ET]
Table '3769361908 16' 6-max Seat #4 is the button
Seat 1: nzlking (11664 in chips) 
Seat 2: 4sasss (27076 in chips) 
Seat 3: lintumies12 (32519 in chips) 
Seat 4: Earl of Poker V (10824 in chips) 
Seat 5: mila is best (38074 in chips) 
Seat 6: GabrielTho1 (31611 in chips) 
nzlking: posts the ante 500
4sasss: posts the ante 500
lintumies12: posts the ante 500
Earl of Poker V: posts the ante 500
mila is best: posts the ante 500
GabrielTho1: posts the ante 500
mila is best: posts small blind 1000
GabrielTho1: posts big blind 2000
*** HOLE CARDS ***
nzlking: folds 
4sasss: folds 
lintumies12: raises 30019 to 32019 and is all-in
Earl of Poker V: folds 
mila is best: folds 
GabrielTho1: folds 
Uncalled bet (30019) returned to lintumies12
lintumies12 collected 8000 from pot
lintumies12: doesn't show hand 
*** SUMMARY ***
Total pot 8000 | Rake 0 
Seat 1: nzlking folded before Flop (didn't bet)
Seat 2: 4sasss folded before Flop (didn't bet)
Seat 3: lintumies12 collected (8000)
Seat 4: Earl of Poker V (button) folded before Flop (didn't bet)
Seat 5: mila is best (small blind) folded before Flop
Seat 6: GabrielTho1 (big blind) folded before Flop

PokerStars Hand #251209884120: Tournament #3769361908, $52.38+$2.62 USD Hold'em No Limit - Level XVIII (1200/2400) - 2024/06/26 22:54:07 UTC [2024/06/26 18:54:07 ET]
Table '3769361908 16' 6-max Seat #5 is the button
Seat 1: nzlking (11164 in chips) 
Seat 2: 4sasss (26576 in chips) 
Seat 3: lintumies12 (38019 in chips) 
Seat 4: Earl of Poker V (10324 in chips) 
Seat 5: mila is best (36574 in chips) 
Seat 6: GabrielTho1 (29111 in chips) 
nzlking: posts the ante 600
4sasss: posts the ante 600
lintumies12: posts the ante 600
Earl of Poker V: posts the ante 600
mila is best: posts the ante 600
GabrielTho1: posts the ante 600
GabrielTho1: posts small blind 1200
nzlking: posts big blind 2400
*** HOLE CARDS ***
4sasss: raises 3600 to 6000
lintumies12: folds 
Earl of Poker V: folds 
mila is best: folds 
GabrielTho1: folds 
nzlking: folds 
Uncalled bet (3600) returned to 4sasss
4sasss collected 9600 from pot
*** SUMMARY ***
Total pot 9600 | Rake 0 
Seat 1: nzlking (big blind) folded before Flop
Seat 2: 4sasss collected (9600)
Seat 3: lintumies12 folded before Flop (didn't bet)
Seat 4: Earl of Poker V folded before Flop (didn't bet)
Seat 5: mila is best (button) folded before Flop (didn't bet)
Seat 6: GabrielTho1 (small blind) folded before Flop

PokerStars Hand #251209893086: Tournament #3769361908, $52.38+$2.62 USD Hold'em No Limit - Level XVIII (1200/2400) - 2024/06/26 22:54:44 UTC [2024/06/26 18:54:44 ET]
Table '3769361908 16' 6-max Seat #6 is the button
Seat 1: nzlking (8164 in chips) 
Seat 2: 4sasss (33176 in chips) 
Seat 3: lintumies12 (37419 in chips) 
Seat 4: Earl of Poker V (9724 in chips) 
Seat 5: mila is best (35974 in chips) 
Seat 6: GabrielTho1 (27311 in chips) 
nzlking: posts the ante 600
4sasss: posts the ante 600
lintumies12: posts the ante 600
Earl of Poker V: posts the ante 600
mila is best: posts the ante 600
GabrielTho1: posts the ante 600
nzlking: posts small blind 1200
4sasss: posts big blind 2400
*** HOLE CARDS ***
lintumies12: raises 34419 to 36819 and is all-in
Earl of Poker V: calls 9124 and is all-in
mila is best: folds 
GabrielTho1: folds 
nzlking: calls 6364 and is all-in
4sasss: folds 
Uncalled bet (27695) returned to lintumies12
*** FLOP *** [Jh Td Jc]
*** TURN *** [Jh Td Jc] [2s]
*** RIVER *** [Jh Td Jc 2s] [9c]
*** SHOW DOWN ***
lintumies12: shows [Ad Kc] (a pair of Jacks)
Earl of Poker V: shows [Th Ts] (a full house, Tens full of Jacks)
Earl of Poker V collected 3120 from side pot
nzlking: shows [6h 6d] (two pair, Jacks and Sixes)
Earl of Poker V collected 28692 from main pot
nzlking finished the tournament in 73rd place
*** SUMMARY ***
Total pot 31812 Main pot 28692. Side pot 3120. | Rake 0 
Board [Jh Td Jc 2s 9c]
Seat 1: nzlking (small blind) showed [6h 6d] and lost with two pair, Jacks and Sixes
Seat 2: 4sasss (big blind) folded before Flop
Seat 3: lintumies12 showed [Ad Kc] and lost with a pair of Jacks
Seat 4: Earl of Poker V showed [Th Ts] and won (31812) with a full house, Tens full of Jacks
Seat 5: mila is best folded before Flop (didn't bet)
Seat 6: GabrielTho1 (button) folded before Flop (didn't bet)




PokerStars Hand #251209148851: Tournament #3769361908, $52.38+$2.62 USD Hold'em No Limit - Level III (40/80) - 2024/06/26 22:08:45 UTC [2024/06/26 18:08:45 ET]
Table '3769361908 14' 6-max Seat #5 is the button
Seat 1: dulek_jason (11287 in chips) 
Seat 2: jessecesar (8520 in chips) 
Seat 3: whaleptt (9605 in chips) 
Seat 4: Go4ElvIS (8330 in chips) 
Seat 5: mennck (6434 in chips) 
dulek_jason: posts the ante 20
jessecesar: posts the ante 20
whaleptt: posts the ante 20
Go4ElvIS: posts the ante 20
mennck: posts the ante 20
dulek_jason: posts small blind 40
jessecesar: posts big blind 80
*** HOLE CARDS ***
whaleptt: folds 
Go4ElvIS: folds 
mennck: folds 
dulek_jason: calls 40
$aymon9 is disconnected 
jessecesar: raises 240 to 320
dulek_jason: calls 240
*** FLOP *** [Qc Ac 8s]
dulek_jason: checks 
jessecesar: checks 
*** TURN *** [Qc Ac 8s] [3c]
dulek_jason: checks 
jessecesar: checks 
*** RIVER *** [Qc Ac 8s 3c] [5h]
dulek_jason: bets 548
jessecesar: folds 
Uncalled bet (548) returned to dulek_jason
dulek_jason collected 740 from pot
dulek_jason: doesn't show hand 
*** SUMMARY ***
Total pot 740 | Rake 0 
Board [Qc Ac 8s 3c 5h]
Seat 1: dulek_jason (small blind) collected (740)
Seat 2: jessecesar (big blind) folded on the River
Seat 3: whaleptt folded before Flop (didn't bet)
Seat 4: Go4ElvIS folded before Flop (didn't bet)
Seat 5: mennck (button) folded before Flop (didn't bet)

PokerStars Hand #251209174666: Tournament #3769361908, $52.38+$2.62 USD Hold'em No Limit - Level III (40/80) - 2024/06/26 22:10:13 UTC [2024/06/26 18:10:13 ET]
Table '3769361908 14' 6-max Seat #1 is the button
Seat 1: dulek_jason (11687 in chips) 
Seat 2: jessecesar (8180 in chips) 
Seat 3: whaleptt (9585 in chips) 
Seat 4: Go4ElvIS (8310 in chips) 
Seat 5: mennck (6414 in chips) 
Seat 6: $aymon9 (10000 in chips) 
dulek_jason: posts the ante 20
jessecesar: posts the ante 20
whaleptt: posts the ante 20
Go4ElvIS: posts the ante 20
mennck: posts the ante 20
$aymon9: posts the ante 20
jessecesar: posts small blind 40
whaleptt: posts big blind 80
*** HOLE CARDS ***
Go4ElvIS: folds 
mennck: folds 
$aymon9: folds 
dulek_jason: raises 91 to 171
jessecesar: calls 131
whaleptt: folds 
*** FLOP *** [5h Kc 7c]
jessecesar: checks 
dulek_jason: bets 179
jessecesar: raises 621 to 800
dulek_jason: folds 
Uncalled bet (621) returned to jessecesar
jessecesar collected 900 from pot
jessecesar: doesn't show hand 
*** SUMMARY ***
Total pot 900 | Rake 0 
Board [5h Kc 7c]
Seat 1: dulek_jason (button) folded on the Flop
Seat 2: jessecesar (small blind) collected (900)
Seat 3: whaleptt (big blind) folded before Flop
Seat 4: Go4ElvIS folded before Flop (didn't bet)
Seat 5: mennck folded before Flop (didn't bet)
Seat 6: $aymon9 folded before Flop (didn't bet)

PokerStars Hand #251209192049: Tournament #3769361908, $52.38+$2.62 USD Hold'em No Limit - Level IV (50/100) - 2024/06/26 22:11:13 UTC [2024/06/26 18:11:13 ET]
Table '3769361908 14' 6-max Seat #2 is the button
Seat 1: dulek_jason (11317 in chips) 
Seat 2: jessecesar (8710 in chips) 
Seat 3: whaleptt (9485 in chips) 
Seat 4: Go4ElvIS (8290 in chips) 
Seat 5: mennck (6394 in chips) 
Seat 6: $aymon9 (9980 in chips) 
dulek_jason: posts the ante 25
jessecesar: posts the ante 25
whaleptt: posts the ante 25
Go4ElvIS: posts the ante 25
mennck: posts the ante 25
$aymon9: posts the ante 25
whaleptt: posts small blind 50
Go4ElvIS: posts big blind 100
*** HOLE CARDS ***
mennck: folds 
$aymon9: raises 100 to 200
dulek_jason: folds 
jessecesar: calls 200
whaleptt: calls 150
Go4ElvIS: calls 100
*** FLOP *** [9c 6s 2d]
whaleptt: checks 
Go4ElvIS: checks 
$aymon9: bets 314
jessecesar: folds 
whaleptt: calls 314
Go4ElvIS: folds 
*** TURN *** [9c 6s 2d] [6d]
whaleptt: bets 395
$aymon9: calls 395
*** RIVER *** [9c 6s 2d 6d] [Qd]
whaleptt: bets 1965
$aymon9: calls 1965
*** SHOW DOWN ***
whaleptt: shows [7s As] (a pair of Sixes)
$aymon9: shows [Tc Td] (two pair, Tens and Sixes)
$aymon9 collected 6298 from pot
*** SUMMARY ***
Total pot 6298 | Rake 0 
Board [9c 6s 2d 6d Qd]
Seat 1: dulek_jason folded before Flop (didn't bet)
Seat 2: jessecesar (button) folded on the Flop
Seat 3: whaleptt (small blind) showed [7s As] and lost with a pair of Sixes
Seat 4: Go4ElvIS (big blind) folded on the Flop
Seat 5: mennck folded before Flop (didn't bet)
Seat 6: $aymon9 showed [Tc Td] and won (6298) with two pair, Tens and Sixes

PokerStars Hand #251209221124: Tournament #3769361908, $52.38+$2.62 USD Hold'em No Limit - Level IV (50/100) - 2024/06/26 22:12:54 UTC [2024/06/26 18:12:54 ET]
Table '3769361908 14' 6-max Seat #3 is the button
Seat 1: dulek_jason (11292 in chips) 
Seat 2: jessecesar (8485 in chips) 
Seat 3: whaleptt (6586 in chips) 
Seat 4: Go4ElvIS (8065 in chips) 
Seat 5: mennck (6369 in chips) 
Seat 6: $aymon9 (13379 in chips) 
dulek_jason: posts the ante 25
jessecesar: posts the ante 25
whaleptt: posts the ante 25
Go4ElvIS: posts the ante 25
mennck: posts the ante 25
$aymon9: posts the ante 25
Go4ElvIS: posts small blind 50
mennck: posts big blind 100
*** HOLE CARDS ***
$aymon9: raises 100 to 200
dulek_jason: folds 
jessecesar: folds 
whaleptt: folds 
Go4ElvIS: raises 400 to 600
mennck: folds 
$aymon9: calls 400
*** FLOP *** [8c Qs 4c]
Go4ElvIS: bets 479
$aymon9: calls 479
*** TURN *** [8c Qs 4c] [5c]
Go4ElvIS: checks 
$aymon9: checks 
*** RIVER *** [8c Qs 4c 5c] [2d]
Go4ElvIS: checks 
$aymon9: bets 1350
Go4ElvIS: calls 1350
*** SHOW DOWN ***
$aymon9: shows [Qc Ad] (a pair of Queens)
Go4ElvIS: mucks hand 
$aymon9 collected 5108 from pot
*** SUMMARY ***
Total pot 5108 | Rake 0 
Board [8c Qs 4c 5c 2d]
Seat 1: dulek_jason folded before Flop (didn't bet)
Seat 2: jessecesar folded before Flop (didn't bet)
Seat 3: whaleptt (button) folded before Flop (didn't bet)
Seat 4: Go4ElvIS (small blind) mucked
Seat 5: mennck (big blind) folded before Flop
Seat 6: $aymon9 showed [Qc Ad] and won (5108) with a pair of Queens

PokerStars Hand #251209239944: Tournament #3769361908, $52.38+$2.62 USD Hold'em No Limit - Level IV (50/100) - 2024/06/26 22:14:00 UTC [2024/06/26 18:14:00 ET]
Table '3769361908 14' 6-max Seat #4 is the button
Seat 1: dulek_jason (11267 in chips) 
Seat 2: jessecesar (8460 in chips) 
Seat 3: whaleptt (6561 in chips) 
Seat 4: Go4ElvIS (5611 in chips) 
Seat 5: mennck (6244 in chips) 
Seat 6: $aymon9 (16033 in chips) 
dulek_jason: posts the ante 25
jessecesar: posts the ante 25
whaleptt: posts the ante 25
Go4ElvIS: posts the ante 25
mennck: posts the ante 25
$aymon9: posts the ante 25
mennck: posts small blind 50
$aymon9: posts big blind 100
*** HOLE CARDS ***
dulek_jason: folds 
jessecesar: folds 
whaleptt: raises 120 to 220
Go4ElvIS: folds 
mennck: folds 
$aymon9: calls 120
*** FLOP *** [Ad 8c 5s]
$aymon9: checks 
whaleptt: bets 160
$aymon9: calls 160
*** TURN *** [Ad 8c 5s] [Qc]
$aymon9: checks 
whaleptt: checks 
*** RIVER *** [Ad 8c 5s Qc] [9c]
$aymon9: bets 600
whaleptt: folds 
Uncalled bet (600) returned to $aymon9
$aymon9 collected 960 from pot
*** SUMMARY ***
Total pot 960 | Rake 0 
Board [Ad 8c 5s Qc 9c]
Seat 1: dulek_jason folded before Flop (didn't bet)
Seat 2: jessecesar folded before Flop (didn't bet)
Seat 3: whaleptt folded on the River
Seat 4: Go4ElvIS (button) folded before Flop (didn't bet)
Seat 5: mennck (small blind) folded before Flop
Seat 6: $aymon9 (big blind) collected (960)

PokerStars Hand #251209261585: Tournament #3769361908, $52.38+$2.62 USD Hold'em No Limit - Level V (60/120) - 2024/06/26 22:15:16 UTC [2024/06/26 18:15:16 ET]
Table '3769361908 14' 6-max Seat #5 is the button
Seat 1: dulek_jason (11242 in chips) 
Seat 2: jessecesar (8435 in chips) 
Seat 3: whaleptt (6156 in chips) 
Seat 4: Go4ElvIS (5586 in chips) 
Seat 5: mennck (6169 in chips) 
Seat 6: $aymon9 (16588 in chips) 
dulek_jason: posts the ante 30
jessecesar: posts the ante 30
whaleptt: posts the ante 30
Go4ElvIS: posts the ante 30
mennck: posts the ante 30
$aymon9: posts the ante 30
$aymon9: posts small blind 60
dulek_jason: posts big blind 120
*** HOLE CARDS ***
jessecesar: raises 120 to 240
whaleptt: folds 
Go4ElvIS: folds 
mennck: folds 
$aymon9: raises 720 to 960
dulek_jason: folds 
jessecesar: folds 
Uncalled bet (720) returned to $aymon9
$aymon9 collected 780 from pot
*** SUMMARY ***
Total pot 780 | Rake 0 
Seat 1: dulek_jason (big blind) folded before Flop
Seat 2: jessecesar folded before Flop
Seat 3: whaleptt folded before Flop (didn't bet)
Seat 4: Go4ElvIS folded before Flop (didn't bet)
Seat 5: mennck (button) folded before Flop (didn't bet)
Seat 6: $aymon9 (small blind) collected (780)

PokerStars Hand #251209269202: Tournament #3769361908, $52.38+$2.62 USD Hold'em No Limit - Level V (60/120) - 2024/06/26 22:15:43 UTC [2024/06/26 18:15:43 ET]
Table '3769361908 14' 6-max Seat #6 is the button
Seat 1: dulek_jason (11092 in chips) 
Seat 2: jessecesar (8165 in chips) 
Seat 3: whaleptt (6126 in chips) 
Seat 4: Go4ElvIS (5556 in chips) 
Seat 5: mennck (6139 in chips) 
Seat 6: $aymon9 (17098 in chips) 
dulek_jason: posts the ante 30
jessecesar: posts the ante 30
whaleptt: posts the ante 30
Go4ElvIS: posts the ante 30
mennck: posts the ante 30
$aymon9: posts the ante 30
dulek_jason: posts small blind 60
jessecesar: posts big blind 120
*** HOLE CARDS ***
whaleptt: folds 
Go4ElvIS: raises 132 to 252
mennck: folds 
$aymon9: raises 468 to 720
dulek_jason: folds 
jessecesar: folds 
Go4ElvIS: raises 4806 to 5526 and is all-in
$aymon9: folds 
Uncalled bet (4806) returned to Go4ElvIS
Go4ElvIS collected 1800 from pot
Go4ElvIS: doesn't show hand 
*** SUMMARY ***
Total pot 1800 | Rake 0 
Seat 1: dulek_jason (small blind) folded before Flop
Seat 2: jessecesar (big blind) folded before Flop
Seat 3: whaleptt folded before Flop (didn't bet)
Seat 4: Go4ElvIS collected (1800)
Seat 5: mennck folded before Flop (didn't bet)
Seat 6: $aymon9 (button) folded before Flop

PokerStars Hand #251209281404: Tournament #3769361908, $52.38+$2.62 USD Hold'em No Limit - Level V (60/120) - 2024/06/26 22:16:26 UTC [2024/06/26 18:16:26 ET]
Table '3769361908 14' 6-max Seat #1 is the button
Seat 1: dulek_jason (11002 in chips) 
Seat 2: jessecesar (8015 in chips) 
Seat 3: whaleptt (6096 in chips) 
Seat 4: Go4ElvIS (6606 in chips) 
Seat 5: mennck (6109 in chips) 
Seat 6: $aymon9 (16348 in chips) 
dulek_jason: posts the ante 30
jessecesar: posts the ante 30
whaleptt: posts the ante 30
Go4ElvIS: posts the ante 30
mennck: posts the ante 30
$aymon9: posts the ante 30
jessecesar: posts small blind 60
whaleptt: posts big blind 120
*** HOLE CARDS ***
Go4ElvIS: folds 
mennck: raises 156 to 276
$aymon9: folds 
dulek_jason: folds 
jessecesar: folds 
whaleptt: calls 156
*** FLOP *** [Td 8h 9c]
whaleptt: checks 
mennck: checks 
*** TURN *** [Td 8h 9c] [2c]
whaleptt: checks 
mennck: checks 
*** RIVER *** [Td 8h 9c 2c] [2d]
whaleptt: checks 
mennck: bets 436
whaleptt: folds 
Uncalled bet (436) returned to mennck
mennck collected 792 from pot
mennck: doesn't show hand 
*** SUMMARY ***
Total pot 792 | Rake 0 
Board [Td 8h 9c 2c 2d]
Seat 1: dulek_jason (button) folded before Flop (didn't bet)
Seat 2: jessecesar (small blind) folded before Flop
Seat 3: whaleptt (big blind) folded on the River
Seat 4: Go4ElvIS folded before Flop (didn't bet)
Seat 5: mennck collected (792)
Seat 6: $aymon9 folded before Flop (didn't bet)

PokerStars Hand #251209296699: Tournament #3769361908, $52.38+$2.62 USD Hold'em No Limit - Level VI (80/160) - 2024/06/26 22:17:21 UTC [2024/06/26 18:17:21 ET]
Table '3769361908 14' 6-max Seat #2 is the button
Seat 1: dulek_jason (10972 in chips) 
Seat 2: jessecesar (7925 in chips) 
Seat 3: whaleptt (5790 in chips) 
Seat 4: Go4ElvIS (6576 in chips) 
Seat 5: mennck (6595 in chips) 
Seat 6: $aymon9 (16318 in chips) 
dulek_jason: posts the ante 40
jessecesar: posts the ante 40
whaleptt: posts the ante 40
Go4ElvIS: posts the ante 40
mennck: posts the ante 40
$aymon9: posts the ante 40
whaleptt: posts small blind 80
Go4ElvIS: posts big blind 160
*** HOLE CARDS ***
mennck: folds 
$aymon9: folds 
dulek_jason: folds 
jessecesar: raises 160 to 320
whaleptt: folds 
Go4ElvIS: folds 
Uncalled bet (160) returned to jessecesar
jessecesar collected 640 from pot
jessecesar: doesn't show hand 
*** SUMMARY ***
Total pot 640 | Rake 0 
Seat 1: dulek_jason folded before Flop (didn't bet)
Seat 2: jessecesar (button) collected (640)
Seat 3: whaleptt (small blind) folded before Flop
Seat 4: Go4ElvIS (big blind) folded before Flop
Seat 5: mennck folded before Flop (didn't bet)
Seat 6: $aymon9 folded before Flop (didn't bet)

PokerStars Hand #251209302238: Tournament #3769361908, $52.38+$2.62 USD Hold'em No Limit - Level VI (80/160) - 2024/06/26 22:17:40 UTC [2024/06/26 18:17:40 ET]
Table '3769361908 14' 6-max Seat #3 is the button
Seat 1: dulek_jason (10932 in chips) 
Seat 2: jessecesar (8365 in chips) 
Seat 3: whaleptt (5670 in chips) 
Seat 4: Go4ElvIS (6376 in chips) 
Seat 5: mennck (6555 in chips) 
Seat 6: $aymon9 (16278 in chips) 
dulek_jason: posts the ante 40
jessecesar: posts the ante 40
whaleptt: posts the ante 40
Go4ElvIS: posts the ante 40
mennck: posts the ante 40
$aymon9: posts the ante 40
Go4ElvIS: posts small blind 80
mennck: posts big blind 160
*** HOLE CARDS ***
$aymon9: folds 
dulek_jason: raises 182 to 342
jessecesar: raises 698 to 1040
whaleptt: folds 
Go4ElvIS: folds 
mennck: folds 
dulek_jason: calls 698
*** FLOP *** [4c 7s 2c]
dulek_jason: checks 
jessecesar: bets 844
dulek_jason: raises 1402 to 2246
jessecesar: raises 5039 to 7285 and is all-in
dulek_jason: calls 5039
*** TURN *** [4c 7s 2c] [Ts]
*** RIVER *** [4c 7s 2c Ts] [6h]
*** SHOW DOWN ***
dulek_jason: shows [9c 9d] (a pair of Nines)
jessecesar: shows [Th Td] (three of a kind, Tens)
jessecesar collected 17130 from pot
*** SUMMARY ***
Total pot 17130 | Rake 0 
Board [4c 7s 2c Ts 6h]
Seat 1: dulek_jason showed [9c 9d] and lost with a pair of Nines
Seat 2: jessecesar showed [Th Td] and won (17130) with three of a kind, Tens
Seat 3: whaleptt (button) folded before Flop (didn't bet)
Seat 4: Go4ElvIS (small blind) folded before Flop
Seat 5: mennck (big blind) folded before Flop
Seat 6: $aymon9 folded before Flop (didn't bet)

PokerStars Hand #251209321426: Tournament #3769361908, $52.38+$2.62 USD Hold'em No Limit - Level VI (80/160) - 2024/06/26 22:18:48 UTC [2024/06/26 18:18:48 ET]
Table '3769361908 14' 6-max Seat #4 is the button
Seat 1: dulek_jason (2567 in chips) 
Seat 2: jessecesar (17130 in chips) 
Seat 3: whaleptt (5630 in chips) 
Seat 4: Go4ElvIS (6256 in chips) 
Seat 5: mennck (6355 in chips) 
Seat 6: $aymon9 (16238 in chips) 
dulek_jason: posts the ante 40
jessecesar: posts the ante 40
whaleptt: posts the ante 40
Go4ElvIS: posts the ante 40
mennck: posts the ante 40
$aymon9: posts the ante 40
mennck: posts small blind 80
$aymon9: posts big blind 160
*** HOLE CARDS ***
dulek_jason: raises 160 to 320
jessecesar: raises 480 to 800
whaleptt: folds 
Go4ElvIS: folds 
mennck: folds 
$aymon9: folds 
dulek_jason: folds 
Uncalled bet (480) returned to jessecesar
jessecesar collected 1120 from pot
jessecesar: doesn't show hand 
*** SUMMARY ***
Total pot 1120 | Rake 0 
Seat 1: dulek_jason folded before Flop
Seat 2: jessecesar collected (1120)
Seat 3: whaleptt folded before Flop (didn't bet)
Seat 4: Go4ElvIS (button) folded before Flop (didn't bet)
Seat 5: mennck (small blind) folded before Flop
Seat 6: $aymon9 (big blind) folded before Flop

PokerStars Hand #251209330082: Tournament #3769361908, $52.38+$2.62 USD Hold'em No Limit - Level VI (80/160) - 2024/06/26 22:19:20 UTC [2024/06/26 18:19:20 ET]
Table '3769361908 14' 6-max Seat #5 is the button
Seat 1: dulek_jason (2207 in chips) 
Seat 2: jessecesar (17890 in chips) 
Seat 3: whaleptt (5590 in chips) 
Seat 4: Go4ElvIS (6216 in chips) 
Seat 5: mennck (6235 in chips) 
Seat 6: $aymon9 (16038 in chips) 
dulek_jason: posts the ante 40
jessecesar: posts the ante 40
whaleptt: posts the ante 40
Go4ElvIS: posts the ante 40
mennck: posts the ante 40
$aymon9: posts the ante 40
$aymon9: posts small blind 80
dulek_jason: posts big blind 160
*** HOLE CARDS ***
jessecesar: folds 
whaleptt: folds 
Go4ElvIS: folds 
mennck: folds 
$aymon9: raises 15838 to 15998 and is all-in
dulek_jason: calls 2007 and is all-in
Uncalled bet (13831) returned to $aymon9
*** FLOP *** [7h 5d Qc]
*** TURN *** [7h 5d Qc] [Kc]
*** RIVER *** [7h 5d Qc Kc] [7s]
*** SHOW DOWN ***
$aymon9: shows [Th 9d] (a pair of Sevens)
dulek_jason: shows [Ks 6s] (two pair, Kings and Sevens)
dulek_jason collected 4574 from pot
*** SUMMARY ***
Total pot 4574 | Rake 0 
Board [7h 5d Qc Kc 7s]
Seat 1: dulek_jason (big blind) showed [Ks 6s] and won (4574) with two pair, Kings and Sevens
Seat 2: jessecesar folded before Flop (didn't bet)
Seat 3: whaleptt folded before Flop (didn't bet)
Seat 4: Go4ElvIS folded before Flop (didn't bet)
Seat 5: mennck (button) folded before Flop (didn't bet)
Seat 6: $aymon9 (small blind) showed [Th 9d] and lost with a pair of Sevens

PokerStars Hand #251209337605: Tournament #3769361908, $52.38+$2.62 USD Hold'em No Limit - Level VI (80/160) - 2024/06/26 22:19:46 UTC [2024/06/26 18:19:46 ET]
Table '3769361908 14' 6-max Seat #6 is the button
Seat 1: dulek_jason (4574 in chips) 
Seat 2: jessecesar (17850 in chips) 
Seat 3: whaleptt (5550 in chips) 
Seat 4: Go4ElvIS (6176 in chips) 
Seat 5: mennck (6195 in chips) 
Seat 6: $aymon9 (13831 in chips) 
dulek_jason: posts the ante 40
jessecesar: posts the ante 40
whaleptt: posts the ante 40
Go4ElvIS: posts the ante 40
mennck: posts the ante 40
$aymon9: posts the ante 40
dulek_jason: posts small blind 80
jessecesar: posts big blind 160
*** HOLE CARDS ***
whaleptt: folds 
Go4ElvIS: folds 
mennck: folds 
$aymon9: folds 
dulek_jason: calls 80
jessecesar: checks 
*** FLOP *** [3s Ks Ad]
dulek_jason: bets 160
jessecesar: folds 
Uncalled bet (160) returned to dulek_jason
dulek_jason collected 560 from pot
dulek_jason: doesn't show hand 
*** SUMMARY ***
Total pot 560 | Rake 0 
Board [3s Ks Ad]
Seat 1: dulek_jason (small blind) collected (560)
Seat 2: jessecesar (big blind) folded on the Flop
Seat 3: whaleptt folded before Flop (didn't bet)
Seat 4: Go4ElvIS folded before Flop (didn't bet)
Seat 5: mennck folded before Flop (didn't bet)
Seat 6: $aymon9 (button) folded before Flop (didn't bet)

PokerStars Hand #251209350481: Tournament #3769361908, $52.38+$2.62 USD Hold'em No Limit - Level VII (100/200) - 2024/06/26 22:20:33 UTC [2024/06/26 18:20:33 ET]
Table '3769361908 14' 6-max Seat #1 is the button
Seat 1: dulek_jason (4934 in chips) 
Seat 2: jessecesar (17650 in chips) 
Seat 3: whaleptt (5510 in chips) 
Seat 4: Go4ElvIS (6136 in chips) 
Seat 5: mennck (6155 in chips) 
Seat 6: $aymon9 (13791 in chips) 
dulek_jason: posts the ante 50
jessecesar: posts the ante 50
whaleptt: posts the ante 50
Go4ElvIS: posts the ante 50
mennck: posts the ante 50
$aymon9: posts the ante 50
jessecesar: posts small blind 100
whaleptt: posts big blind 200
*** HOLE CARDS ***
Go4ElvIS: folds 
mennck: folds 
$aymon9: raises 200 to 400
dulek_jason: folds 
jessecesar: folds 
whaleptt: calls 200
*** FLOP *** [5s 9s 3c]
whaleptt: checks 
$aymon9: bets 396
whaleptt: calls 396
*** TURN *** [5s 9s 3c] [2h]
whaleptt: checks 
$aymon9: checks 
*** RIVER *** [5s 9s 3c 2h] [2c]
whaleptt: bets 657
$aymon9: folds 
Uncalled bet (657) returned to whaleptt
whaleptt collected 1992 from pot
whaleptt: doesn't show hand 
*** SUMMARY ***
Total pot 1992 | Rake 0 
Board [5s 9s 3c 2h 2c]
Seat 1: dulek_jason (button) folded before Flop (didn't bet)
Seat 2: jessecesar (small blind) folded before Flop
Seat 3: whaleptt (big blind) collected (1992)
Seat 4: Go4ElvIS folded before Flop (didn't bet)
Seat 5: mennck folded before Flop (didn't bet)
Seat 6: $aymon9 folded on the River

PokerStars Hand #251209371267: Tournament #3769361908, $52.38+$2.62 USD Hold'em No Limit - Level VII (100/200) - 2024/06/26 22:21:47 UTC [2024/06/26 18:21:47 ET]
Table '3769361908 14' 6-max Seat #2 is the button
Seat 1: dulek_jason (4884 in chips) 
Seat 2: jessecesar (17500 in chips) 
Seat 3: whaleptt (6656 in chips) 
Seat 4: Go4ElvIS (6086 in chips) 
Seat 5: mennck (6105 in chips) 
Seat 6: $aymon9 (12945 in chips) 
dulek_jason: posts the ante 50
jessecesar: posts the ante 50
whaleptt: posts the ante 50
Go4ElvIS: posts the ante 50
mennck: posts the ante 50
$aymon9: posts the ante 50
whaleptt: posts small blind 100
Go4ElvIS: posts big blind 200
*** HOLE CARDS ***
mennck: folds 
$aymon9: folds 
dulek_jason: raises 200 to 400
jessecesar: folds 
whaleptt: folds 
Go4ElvIS: folds 
Uncalled bet (200) returned to dulek_jason
dulek_jason collected 800 from pot
dulek_jason: doesn't show hand 
*** SUMMARY ***
Total pot 800 | Rake 0 
Seat 1: dulek_jason collected (800)
Seat 2: jessecesar (button) folded before Flop (didn't bet)
Seat 3: whaleptt (small blind) folded before Flop
Seat 4: Go4ElvIS (big blind) folded before Flop
Seat 5: mennck folded before Flop (didn't bet)
Seat 6: $aymon9 folded before Flop (didn't bet)

PokerStars Hand #251209377245: Tournament #3769361908, $52.38+$2.62 USD Hold'em No Limit - Level VII (100/200) - 2024/06/26 22:22:08 UTC [2024/06/26 18:22:08 ET]
Table '3769361908 14' 6-max Seat #3 is the button
Seat 1: dulek_jason (5434 in chips) 
Seat 2: jessecesar (17450 in chips) 
Seat 3: whaleptt (6506 in chips) 
Seat 4: Go4ElvIS (5836 in chips) 
Seat 5: mennck (6055 in chips) 
Seat 6: $aymon9 (12895 in chips) 
dulek_jason: posts the ante 50
jessecesar: posts the ante 50
whaleptt: posts the ante 50
Go4ElvIS: posts the ante 50
mennck: posts the ante 50
$aymon9: posts the ante 50
Go4ElvIS: posts small blind 100
mennck: posts big blind 200
*** HOLE CARDS ***
$aymon9: folds 
dulek_jason: folds 
jessecesar: folds 
whaleptt: raises 200 to 400
Go4ElvIS: calls 300
mennck: calls 200
*** FLOP *** [Ad 4d Ts]
Go4ElvIS: checks 
mennck: checks 
whaleptt: checks 
*** TURN *** [Ad 4d Ts] [8h]
Go4ElvIS: bets 1000
mennck: folds 
whaleptt: folds 
Uncalled bet (1000) returned to Go4ElvIS
Go4ElvIS collected 1500 from pot
Go4ElvIS: doesn't show hand 
*** SUMMARY ***
Total pot 1500 | Rake 0 
Board [Ad 4d Ts 8h]
Seat 1: dulek_jason folded before Flop (didn't bet)
Seat 2: jessecesar folded before Flop (didn't bet)
Seat 3: whaleptt (button) folded on the Turn
Seat 4: Go4ElvIS (small blind) collected (1500)
Seat 5: mennck (big blind) folded on the Turn
Seat 6: $aymon9 folded before Flop (didn't bet)

PokerStars Hand #251209391219: Tournament #3769361908, $52.38+$2.62 USD Hold'em No Limit - Level VII (100/200) - 2024/06/26 22:22:58 UTC [2024/06/26 18:22:58 ET]
Table '3769361908 14' 6-max Seat #4 is the button
Seat 1: dulek_jason (5384 in chips) 
Seat 2: jessecesar (17400 in chips) 
Seat 3: whaleptt (6056 in chips) 
Seat 4: Go4ElvIS (6886 in chips) 
Seat 5: mennck (5605 in chips) 
Seat 6: $aymon9 (12845 in chips) 
dulek_jason: posts the ante 50
jessecesar: posts the ante 50
whaleptt: posts the ante 50
Go4ElvIS: posts the ante 50
mennck: posts the ante 50
$aymon9: posts the ante 50
mennck: posts small blind 100
$aymon9: posts big blind 200
*** HOLE CARDS ***
dulek_jason: folds 
jessecesar: folds 
whaleptt: raises 200 to 400
Go4ElvIS: folds 
mennck: folds 
$aymon9: calls 200
*** FLOP *** [Kh 9s 9c]
$aymon9: checks 
whaleptt: bets 300
$aymon9: calls 300
*** TURN *** [Kh 9s 9c] [5s]
$aymon9: checks 
whaleptt: checks 
*** RIVER *** [Kh 9s 9c 5s] [9h]
$aymon9: bets 1200
whaleptt: calls 1200
*** SHOW DOWN ***
$aymon9: shows [Td Jd] (three of a kind, Nines)
whaleptt: shows [8c Ad] (three of a kind, Nines - Ace kicker)
whaleptt collected 4200 from pot
*** SUMMARY ***
Total pot 4200 | Rake 0 
Board [Kh 9s 9c 5s 9h]
Seat 1: dulek_jason folded before Flop (didn't bet)
Seat 2: jessecesar folded before Flop (didn't bet)
Seat 3: whaleptt showed [8c Ad] and won (4200) with three of a kind, Nines
Seat 4: Go4ElvIS (button) folded before Flop (didn't bet)
Seat 5: mennck (small blind) folded before Flop
Seat 6: $aymon9 (big blind) showed [Td Jd] and lost with three of a kind, Nines

PokerStars Hand #251209420638: Tournament #3769361908, $52.38+$2.62 USD Hold'em No Limit - Level VIII (125/250) - 2024/06/26 22:24:45 UTC [2024/06/26 18:24:45 ET]
Table '3769361908 14' 6-max Seat #5 is the button
Seat 1: dulek_jason (5334 in chips) 
Seat 2: jessecesar (17350 in chips) 
Seat 3: whaleptt (8306 in chips) 
Seat 4: Go4ElvIS (6836 in chips) 
Seat 5: mennck (5455 in chips) 
Seat 6: $aymon9 (10895 in chips) 
dulek_jason: posts the ante 60
jessecesar: posts the ante 60
whaleptt: posts the ante 60
Go4ElvIS: posts the ante 60
mennck: posts the ante 60
$aymon9: posts the ante 60
$aymon9: posts small blind 125
dulek_jason: posts big blind 250
*** HOLE CARDS ***
jessecesar: raises 250 to 500
whaleptt: folds 
Go4ElvIS: folds 
mennck: folds 
$aymon9: folds 
dulek_jason: folds 
Uncalled bet (250) returned to jessecesar
jessecesar collected 985 from pot
jessecesar: doesn't show hand 
*** SUMMARY ***
Total pot 985 | Rake 0 
Seat 1: dulek_jason (big blind) folded before Flop
Seat 2: jessecesar collected (985)
Seat 3: whaleptt folded before Flop (didn't bet)
Seat 4: Go4ElvIS folded before Flop (didn't bet)
Seat 5: mennck (button) folded before Flop (didn't bet)
Seat 6: $aymon9 (small blind) folded before Flop

PokerStars Hand #251209428525: Tournament #3769361908, $52.38+$2.62 USD Hold'em No Limit - Level VIII (125/250) - 2024/06/26 22:25:13 UTC [2024/06/26 18:25:13 ET]
Table '3769361908 14' 6-max Seat #6 is the button
Seat 1: dulek_jason (5024 in chips) 
Seat 2: jessecesar (18025 in chips) 
Seat 3: whaleptt (8246 in chips) 
Seat 4: Go4ElvIS (6776 in chips) 
Seat 5: mennck (5395 in chips) 
Seat 6: $aymon9 (10710 in chips) 
dulek_jason: posts the ante 60
jessecesar: posts the ante 60
whaleptt: posts the ante 60
Go4ElvIS: posts the ante 60
mennck: posts the ante 60
$aymon9: posts the ante 60
dulek_jason: posts small blind 125
jessecesar: posts big blind 250
*** HOLE CARDS ***
whaleptt: raises 250 to 500
Go4ElvIS: raises 6216 to 6716 and is all-in
mennck: folds 
$aymon9: folds 
dulek_jason: folds 
jessecesar: folds 
whaleptt: folds 
Uncalled bet (6216) returned to Go4ElvIS
Go4ElvIS collected 1735 from pot
Go4ElvIS: doesn't show hand 
*** SUMMARY ***
Total pot 1735 | Rake 0 
Seat 1: dulek_jason (small blind) folded before Flop
Seat 2: jessecesar (big blind) folded before Flop
Seat 3: whaleptt folded before Flop
Seat 4: Go4ElvIS collected (1735)
Seat 5: mennck folded before Flop (didn't bet)
Seat 6: $aymon9 (button) folded before Flop (didn't bet)

PokerStars Hand #251209437100: Tournament #3769361908, $52.38+$2.62 USD Hold'em No Limit - Level VIII (125/250) - 2024/06/26 22:25:44 UTC [2024/06/26 18:25:44 ET]
Table '3769361908 14' 6-max Seat #1 is the button
Seat 1: dulek_jason (4839 in chips) 
Seat 2: jessecesar (17715 in chips) 
Seat 3: whaleptt (7686 in chips) 
Seat 4: Go4ElvIS (7951 in chips) 
Seat 5: mennck (5335 in chips) 
Seat 6: $aymon9 (10650 in chips) 
dulek_jason: posts the ante 60
jessecesar: posts the ante 60
whaleptt: posts the ante 60
Go4ElvIS: posts the ante 60
mennck: posts the ante 60
$aymon9: posts the ante 60
jessecesar: posts small blind 125
whaleptt: posts big blind 250
*** HOLE CARDS ***
Go4ElvIS: folds 
mennck: folds 
$aymon9: raises 250 to 500
dulek_jason: raises 750 to 1250
jessecesar: folds 
whaleptt: folds 
$aymon9: raises 9340 to 10590 and is all-in
dulek_jason: calls 3529 and is all-in
Uncalled bet (5811) returned to $aymon9
*** FLOP *** [Qd 6d 8c]
*** TURN *** [Qd 6d 8c] [Td]
*** RIVER *** [Qd 6d 8c Td] [3s]
*** SHOW DOWN ***
$aymon9: shows [2d 2h] (a pair of Deuces)
dulek_jason: shows [Jh Jc] (a pair of Jacks)
dulek_jason collected 10293 from pot
*** SUMMARY ***
Total pot 10293 | Rake 0 
Board [Qd 6d 8c Td 3s]
Seat 1: dulek_jason (button) showed [Jh Jc] and won (10293) with a pair of Jacks
Seat 2: jessecesar (small blind) folded before Flop
Seat 3: whaleptt (big blind) folded before Flop
Seat 4: Go4ElvIS folded before Flop (didn't bet)
Seat 5: mennck folded before Flop (didn't bet)
Seat 6: $aymon9 showed [2d 2h] and lost with a pair of Deuces

PokerStars Hand #251209449480: Tournament #3769361908, $52.38+$2.62 USD Hold'em No Limit - Level IX (150/300) - 2024/06/26 22:26:29 UTC [2024/06/26 18:26:29 ET]
Table '3769361908 14' 6-max Seat #2 is the button
Seat 1: dulek_jason (10293 in chips) 
Seat 2: jessecesar (17530 in chips) 
Seat 3: whaleptt (7376 in chips) 
Seat 4: Go4ElvIS (7891 in chips) 
Seat 5: mennck (5275 in chips) 
Seat 6: $aymon9 (5811 in chips) 
dulek_jason: posts the ante 75
jessecesar: posts the ante 75
whaleptt: posts the ante 75
Go4ElvIS: posts the ante 75
mennck: posts the ante 75
$aymon9: posts the ante 75
whaleptt: posts small blind 150
Go4ElvIS: posts big blind 300
*** HOLE CARDS ***
mennck: folds 
$aymon9: folds 
dulek_jason: raises 300 to 600
jessecesar: raises 1200 to 1800
whaleptt: raises 5501 to 7301 and is all-in
Go4ElvIS: folds 
dulek_jason: folds 
jessecesar: folds 
Uncalled bet (5501) returned to whaleptt
whaleptt collected 4950 from pot
whaleptt: doesn't show hand 
*** SUMMARY ***
Total pot 4950 | Rake 0 
Seat 1: dulek_jason folded before Flop
Seat 2: jessecesar (button) folded before Flop
Seat 3: whaleptt (small blind) collected (4950)
Seat 4: Go4ElvIS (big blind) folded before Flop
Seat 5: mennck folded before Flop (didn't bet)
Seat 6: $aymon9 folded before Flop (didn't bet)

PokerStars Hand #251209461010: Tournament #3769361908, $52.38+$2.62 USD Hold'em No Limit - Level IX (150/300) - 2024/06/26 22:27:10 UTC [2024/06/26 18:27:10 ET]
Table '3769361908 14' 6-max Seat #3 is the button
Seat 1: dulek_jason (9618 in chips) 
Seat 2: jessecesar (15655 in chips) 
Seat 3: whaleptt (10451 in chips) 
Seat 4: Go4ElvIS (7516 in chips) 
Seat 5: mennck (5200 in chips) 
Seat 6: $aymon9 (5736 in chips) 
dulek_jason: posts the ante 75
jessecesar: posts the ante 75
whaleptt: posts the ante 75
Go4ElvIS: posts the ante 75
mennck: posts the ante 75
$aymon9: posts the ante 75
Go4ElvIS: posts small blind 150
mennck: posts big blind 300
*** HOLE CARDS ***
$aymon9: folds 
dulek_jason: folds 
jessecesar: folds 
whaleptt: raises 300 to 600
Go4ElvIS: raises 6841 to 7441 and is all-in
mennck: folds 
whaleptt: folds 
Uncalled bet (6841) returned to Go4ElvIS
Go4ElvIS collected 1950 from pot
Go4ElvIS: doesn't show hand 
*** SUMMARY ***
Total pot 1950 | Rake 0 
Seat 1: dulek_jason folded before Flop (didn't bet)
Seat 2: jessecesar folded before Flop (didn't bet)
Seat 3: whaleptt (button) folded before Flop
Seat 4: Go4ElvIS (small blind) collected (1950)
Seat 5: mennck (big blind) folded before Flop
Seat 6: $aymon9 folded before Flop (didn't bet)

PokerStars Hand #251209469081: Tournament #3769361908, $52.38+$2.62 USD Hold'em No Limit - Level IX (150/300) - 2024/06/26 22:27:39 UTC [2024/06/26 18:27:39 ET]
Table '3769361908 14' 6-max Seat #4 is the button
Seat 1: dulek_jason (9543 in chips) 
Seat 2: jessecesar (15580 in chips) 
Seat 3: whaleptt (9776 in chips) 
Seat 4: Go4ElvIS (8791 in chips) 
Seat 5: mennck (4825 in chips) 
Seat 6: $aymon9 (5661 in chips) 
dulek_jason: posts the ante 75
jessecesar: posts the ante 75
whaleptt: posts the ante 75
Go4ElvIS: posts the ante 75
mennck: posts the ante 75
$aymon9: posts the ante 75
mennck: posts small blind 150
$aymon9: posts big blind 300
*** HOLE CARDS ***
dulek_jason: raises 300 to 600
jessecesar: folds 
whaleptt: raises 900 to 1500
Go4ElvIS: folds 
mennck: folds 
$aymon9: folds 
dulek_jason: calls 900
*** FLOP *** [Ts Qh 6d]
dulek_jason: checks 
whaleptt: bets 1287
dulek_jason: calls 1287
*** TURN *** [Ts Qh 6d] [2c]
dulek_jason: checks 
whaleptt: bets 6914 and is all-in
dulek_jason: calls 6681 and is all-in
Uncalled bet (233) returned to whaleptt
*** RIVER *** [Ts Qh 6d 2c] [6c]
*** SHOW DOWN ***
dulek_jason: shows [Ad Ah] (two pair, Aces and Sixes)
whaleptt: shows [Jh Ac] (a pair of Sixes)
dulek_jason collected 19836 from pot
*** SUMMARY ***
Total pot 19836 | Rake 0 
Board [Ts Qh 6d 2c 6c]
Seat 1: dulek_jason showed [Ad Ah] and won (19836) with two pair, Aces and Sixes
Seat 2: jessecesar folded before Flop (didn't bet)
Seat 3: whaleptt showed [Jh Ac] and lost with a pair of Sixes
Seat 4: Go4ElvIS (button) folded before Flop (didn't bet)
Seat 5: mennck (small blind) folded before Flop
Seat 6: $aymon9 (big blind) folded before Flop

PokerStars Hand #251209484500: Tournament #3769361908, $52.38+$2.62 USD Hold'em No Limit - Level IX (150/300) - 2024/06/26 22:28:34 UTC [2024/06/26 18:28:34 ET]
Table '3769361908 14' 6-max Seat #5 is the button
Seat 1: dulek_jason (19836 in chips) 
Seat 2: jessecesar (15505 in chips) 
Seat 3: whaleptt (233 in chips) 
Seat 4: Go4ElvIS (8716 in chips) 
Seat 5: mennck (4600 in chips) 
Seat 6: $aymon9 (5286 in chips) 
dulek_jason: posts the ante 75
jessecesar: posts the ante 75
whaleptt: posts the ante 75
Go4ElvIS: posts the ante 75
mennck: posts the ante 75
$aymon9: posts the ante 75
$aymon9: posts small blind 150
dulek_jason: posts big blind 300
*** HOLE CARDS ***
jessecesar: folds 
whaleptt: calls 158 and is all-in
Go4ElvIS: folds 
mennck: folds 
$aymon9: folds 
Uncalled bet (142) returned to dulek_jason
*** FLOP *** [8c Qd 5h]
*** TURN *** [8c Qd 5h] [7s]
*** RIVER *** [8c Qd 5h 7s] [Ah]
*** SHOW DOWN ***
dulek_jason: shows [4s 2h] (high card Ace)
whaleptt: shows [Ad 5c] (two pair, Aces and Fives)
whaleptt collected 916 from pot
*** SUMMARY ***
Total pot 916 | Rake 0 
Board [8c Qd 5h 7s Ah]
Seat 1: dulek_jason (big blind) showed [4s 2h] and lost with high card Ace
Seat 2: jessecesar folded before Flop (didn't bet)
Seat 3: whaleptt showed [Ad 5c] and won (916) with two pair, Aces and Fives
Seat 4: Go4ElvIS folded before Flop (didn't bet)
Seat 5: mennck (button) folded before Flop (didn't bet)
Seat 6: $aymon9 (small blind) folded before Flop

PokerStars Hand #251209493269: Tournament #3769361908, $52.38+$2.62 USD Hold'em No Limit - Level IX (150/300) - 2024/06/26 22:29:06 UTC [2024/06/26 18:29:06 ET]
Table '3769361908 14' 6-max Seat #6 is the button
Seat 1: dulek_jason (19603 in chips) 
Seat 2: jessecesar (15430 in chips) 
Seat 3: whaleptt (916 in chips) 
Seat 4: Go4ElvIS (8641 in chips) 
Seat 5: mennck (4525 in chips) 
Seat 6: $aymon9 (5061 in chips) 
dulek_jason: posts the ante 75
jessecesar: posts the ante 75
whaleptt: posts the ante 75
Go4ElvIS: posts the ante 75
mennck: posts the ante 75
$aymon9: posts the ante 75
dulek_jason: posts small blind 150
jessecesar: posts big blind 300
*** HOLE CARDS ***
whaleptt: folds 
Go4ElvIS: raises 330 to 630
mennck: folds 
$aymon9: folds 
dulek_jason: folds 
jessecesar: calls 330
*** FLOP *** [Th 2c 9d]
jessecesar: checks 
Go4ElvIS: checks 
*** TURN *** [Th 2c 9d] [Qh]
jessecesar: checks 
Go4ElvIS: checks 
*** RIVER *** [Th 2c 9d Qh] [4d]
jessecesar: bets 615
Go4ElvIS: folds 
Uncalled bet (615) returned to jessecesar
jessecesar collected 1860 from pot
jessecesar: doesn't show hand 
*** SUMMARY ***
Total pot 1860 | Rake 0 
Board [Th 2c 9d Qh 4d]
Seat 1: dulek_jason (small blind) folded before Flop
Seat 2: jessecesar (big blind) collected (1860)
Seat 3: whaleptt folded before Flop (didn't bet)
Seat 4: Go4ElvIS folded on the River
Seat 5: mennck folded before Flop (didn't bet)
Seat 6: $aymon9 (button) folded before Flop (didn't bet)

PokerStars Hand #251209509711: Tournament #3769361908, $52.38+$2.62 USD Hold'em No Limit - Level X (200/400) - 2024/06/26 22:30:05 UTC [2024/06/26 18:30:05 ET]
Table '3769361908 14' 6-max Seat #1 is the button
Seat 1: dulek_jason (19378 in chips) 
Seat 2: jessecesar (16585 in chips) 
Seat 3: whaleptt (841 in chips) 
Seat 4: Go4ElvIS (7936 in chips) 
Seat 5: mennck (4450 in chips) 
Seat 6: $aymon9 (4986 in chips) 
dulek_jason: posts the ante 100
jessecesar: posts the ante 100
whaleptt: posts the ante 100
Go4ElvIS: posts the ante 100
mennck: posts the ante 100
$aymon9: posts the ante 100
jessecesar: posts small blind 200
whaleptt: posts big blind 400
*** HOLE CARDS ***
Go4ElvIS: folds 
mennck: raises 3950 to 4350 and is all-in
$aymon9: folds 
dulek_jason: folds 
jessecesar: folds 
whaleptt: calls 341 and is all-in
Uncalled bet (3609) returned to mennck
*** FLOP *** [2h 2s Kc]
*** TURN *** [2h 2s Kc] [Jd]
*** RIVER *** [2h 2s Kc Jd] [Js]
*** SHOW DOWN ***
whaleptt: shows [Jc 6s] (a full house, Jacks full of Deuces)
mennck: shows [Tc Td] (two pair, Jacks and Tens)
whaleptt collected 2282 from pot
*** SUMMARY ***
Total pot 2282 | Rake 0 
Board [2h 2s Kc Jd Js]
Seat 1: dulek_jason (button) folded before Flop (didn't bet)
Seat 2: jessecesar (small blind) folded before Flop
Seat 3: whaleptt (big blind) showed [Jc 6s] and won (2282) with a full house, Jacks full of Deuces
Seat 4: Go4ElvIS folded before Flop (didn't bet)
Seat 5: mennck showed [Tc Td] and lost with two pair, Jacks and Tens
Seat 6: $aymon9 folded before Flop (didn't bet)

PokerStars Hand #251209517112: Tournament #3769361908, $52.38+$2.62 USD Hold'em No Limit - Level X (200/400) - 2024/06/26 22:30:31 UTC [2024/06/26 18:30:31 ET]
Table '3769361908 14' 6-max Seat #2 is the button
Seat 1: dulek_jason (19278 in chips) 
Seat 2: jessecesar (16285 in chips) 
Seat 3: whaleptt (2282 in chips) 
Seat 4: Go4ElvIS (7836 in chips) 
Seat 5: mennck (3609 in chips) 
Seat 6: $aymon9 (4886 in chips) 
dulek_jason: posts the ante 100
jessecesar: posts the ante 100
whaleptt: posts the ante 100
Go4ElvIS: posts the ante 100
mennck: posts the ante 100
$aymon9: posts the ante 100
whaleptt: posts small blind 200
Go4ElvIS: posts big blind 400
*** HOLE CARDS ***
mennck: folds 
$aymon9: raises 400 to 800
dulek_jason: folds 
jessecesar: folds 
whaleptt: folds 
Go4ElvIS: folds 
Uncalled bet (400) returned to $aymon9
$aymon9 collected 1600 from pot
*** SUMMARY ***
Total pot 1600 | Rake 0 
Seat 1: dulek_jason folded before Flop (didn't bet)
Seat 2: jessecesar (button) folded before Flop (didn't bet)
Seat 3: whaleptt (small blind) folded before Flop
Seat 4: Go4ElvIS (big blind) folded before Flop
Seat 5: mennck folded before Flop (didn't bet)
Seat 6: $aymon9 collected (1600)

PokerStars Hand #251209524166: Tournament #3769361908, $52.38+$2.62 USD Hold'em No Limit - Level X (200/400) - 2024/06/26 22:30:57 UTC [2024/06/26 18:30:57 ET]
Table '3769361908 14' 6-max Seat #3 is the button
Seat 1: dulek_jason (19178 in chips) 
Seat 2: jessecesar (16185 in chips) 
Seat 3: whaleptt (1982 in chips) 
Seat 4: Go4ElvIS (7336 in chips) 
Seat 5: mennck (3509 in chips) 
Seat 6: $aymon9 (5986 in chips) 
dulek_jason: posts the ante 100
jessecesar: posts the ante 100
whaleptt: posts the ante 100
Go4ElvIS: posts the ante 100
mennck: posts the ante 100
$aymon9: posts the ante 100
Go4ElvIS: posts small blind 200
mennck: posts big blind 400
*** HOLE CARDS ***
$aymon9: folds 
dulek_jason: folds 
jessecesar: folds 
whaleptt: folds 
Go4ElvIS: folds 
Uncalled bet (200) returned to mennck
mennck collected 1000 from pot
mennck: doesn't show hand 
*** SUMMARY ***
Total pot 1000 | Rake 0 
Seat 1: dulek_jason folded before Flop (didn't bet)
Seat 2: jessecesar folded before Flop (didn't bet)
Seat 3: whaleptt (button) folded before Flop (didn't bet)
Seat 4: Go4ElvIS (small blind) folded before Flop
Seat 5: mennck (big blind) collected (1000)
Seat 6: $aymon9 folded before Flop (didn't bet)

PokerStars Hand #251209528970: Tournament #3769361908, $52.38+$2.62 USD Hold'em No Limit - Level X (200/400) - 2024/06/26 22:31:15 UTC [2024/06/26 18:31:15 ET]
Table '3769361908 14' 6-max Seat #4 is the button
Seat 1: dulek_jason (19078 in chips) 
Seat 2: jessecesar (16085 in chips) 
Seat 3: whaleptt (1882 in chips) 
Seat 4: Go4ElvIS (7036 in chips) 
Seat 5: mennck (4209 in chips) 
Seat 6: $aymon9 (5886 in chips) 
dulek_jason: posts the ante 100
jessecesar: posts the ante 100
whaleptt: posts the ante 100
Go4ElvIS: posts the ante 100
mennck: posts the ante 100
$aymon9: posts the ante 100
mennck: posts small blind 200
$aymon9: posts big blind 400
*** HOLE CARDS ***
dulek_jason: folds 
jessecesar: raises 400 to 800
whaleptt: folds 
Go4ElvIS: folds 
mennck: folds 
$aymon9: raises 4986 to 5786 and is all-in
jessecesar: folds 
Uncalled bet (4986) returned to $aymon9
$aymon9 collected 2400 from pot
*** SUMMARY ***
Total pot 2400 | Rake 0 
Seat 1: dulek_jason folded before Flop (didn't bet)
Seat 2: jessecesar folded before Flop
Seat 3: whaleptt folded before Flop (didn't bet)
Seat 4: Go4ElvIS (button) folded before Flop (didn't bet)
Seat 5: mennck (small blind) folded before Flop
Seat 6: $aymon9 (big blind) collected (2400)

PokerStars Hand #251209537528: Tournament #3769361908, $52.38+$2.62 USD Hold'em No Limit - Level X (200/400) - 2024/06/26 22:31:46 UTC [2024/06/26 18:31:46 ET]
Table '3769361908 14' 6-max Seat #5 is the button
Seat 1: dulek_jason (18978 in chips) 
Seat 2: jessecesar (15185 in chips) 
Seat 3: whaleptt (1782 in chips) 
Seat 4: Go4ElvIS (6936 in chips) 
Seat 5: mennck (3909 in chips) 
Seat 6: $aymon9 (7386 in chips) 
dulek_jason: posts the ante 100
jessecesar: posts the ante 100
whaleptt: posts the ante 100
Go4ElvIS: posts the ante 100
mennck: posts the ante 100
$aymon9: posts the ante 100
$aymon9: posts small blind 200
dulek_jason: posts big blind 400
*** HOLE CARDS ***
jessecesar: folds 
whaleptt: folds 
Go4ElvIS: folds 
mennck: folds 
$aymon9: calls 200
dulek_jason: checks 
*** FLOP *** [4d 8s Ah]
$aymon9: bets 400
dulek_jason: calls 400
*** TURN *** [4d 8s Ah] [5h]
$aymon9: checks 
dulek_jason: bets 1126
$aymon9: calls 1126
*** RIVER *** [4d 8s Ah 5h] [2h]
$aymon9: checks 
dulek_jason: bets 16952 and is all-in
$aymon9: folds 
Uncalled bet (16952) returned to dulek_jason
dulek_jason collected 4452 from pot
dulek_jason: doesn't show hand 
*** SUMMARY ***
Total pot 4452 | Rake 0 
Board [4d 8s Ah 5h 2h]
Seat 1: dulek_jason (big blind) collected (4452)
Seat 2: jessecesar folded before Flop (didn't bet)
Seat 3: whaleptt folded before Flop (didn't bet)
Seat 4: Go4ElvIS folded before Flop (didn't bet)
Seat 5: mennck (button) folded before Flop (didn't bet)
Seat 6: $aymon9 (small blind) folded on the River

PokerStars Hand #251209559353: Tournament #3769361908, $52.38+$2.62 USD Hold'em No Limit - Level XI (250/500) - 2024/06/26 22:33:06 UTC [2024/06/26 18:33:06 ET]
Table '3769361908 14' 6-max Seat #6 is the button
Seat 1: dulek_jason (21404 in chips) 
Seat 2: jessecesar (15085 in chips) 
Seat 3: whaleptt (1682 in chips) 
Seat 4: Go4ElvIS (6836 in chips) 
Seat 5: mennck (3809 in chips) 
Seat 6: $aymon9 (5360 in chips) 
dulek_jason: posts the ante 125
jessecesar: posts the ante 125
whaleptt: posts the ante 125
Go4ElvIS: posts the ante 125
mennck: posts the ante 125
$aymon9: posts the ante 125
dulek_jason: posts small blind 250
jessecesar: posts big blind 500
*** HOLE CARDS ***
whaleptt: folds 
Go4ElvIS: folds 
mennck: raises 3184 to 3684 and is all-in
$aymon9: folds 
dulek_jason: folds 
jessecesar: folds 
Uncalled bet (3184) returned to mennck
mennck collected 2000 from pot
mennck: doesn't show hand 
*** SUMMARY ***
Total pot 2000 | Rake 0 
Seat 1: dulek_jason (small blind) folded before Flop
Seat 2: jessecesar (big blind) folded before Flop
Seat 3: whaleptt folded before Flop (didn't bet)
Seat 4: Go4ElvIS folded before Flop (didn't bet)
Seat 5: mennck collected (2000)
Seat 6: $aymon9 (button) folded before Flop (didn't bet)

PokerStars Hand #251209564146: Tournament #3769361908, $52.38+$2.62 USD Hold'em No Limit - Level XI (250/500) - 2024/06/26 22:33:24 UTC [2024/06/26 18:33:24 ET]
Table '3769361908 14' 6-max Seat #1 is the button
Seat 1: dulek_jason (21029 in chips) 
Seat 2: jessecesar (14460 in chips) 
Seat 3: whaleptt (1557 in chips) 
Seat 4: Go4ElvIS (6711 in chips) 
Seat 5: mennck (5184 in chips) 
Seat 6: $aymon9 (5235 in chips) 
dulek_jason: posts the ante 125
jessecesar: posts the ante 125
whaleptt: posts the ante 125
Go4ElvIS: posts the ante 125
mennck: posts the ante 125
$aymon9: posts the ante 125
jessecesar: posts small blind 250
whaleptt: posts big blind 500
*** HOLE CARDS ***
Go4ElvIS: folds 
mennck: folds 
$aymon9: raises 4610 to 5110 and is all-in
dulek_jason: folds 
jessecesar: folds 
whaleptt: calls 932 and is all-in
Uncalled bet (3678) returned to $aymon9
*** FLOP *** [7d 2c Jh]
*** TURN *** [7d 2c Jh] [6h]
*** RIVER *** [7d 2c Jh 6h] [Kd]
*** SHOW DOWN ***
whaleptt: shows [3s Js] (a pair of Jacks)
$aymon9: shows [Jc Ad] (a pair of Jacks - Ace kicker)
$aymon9 collected 3864 from pot
whaleptt finished the tournament
*** SUMMARY ***
Total pot 3864 | Rake 0 
Board [7d 2c Jh 6h Kd]
Seat 1: dulek_jason (button) folded before Flop (didn't bet)
Seat 2: jessecesar (small blind) folded before Flop
Seat 3: whaleptt (big blind) showed [3s Js] and lost with a pair of Jacks
Seat 4: Go4ElvIS folded before Flop (didn't bet)
Seat 5: mennck folded before Flop (didn't bet)
Seat 6: $aymon9 showed [Jc Ad] and won (3864) with a pair of Jacks

PokerStars Hand #251209572575: Tournament #3769361908, $52.38+$2.62 USD Hold'em No Limit - Level XI (250/500) - 2024/06/26 22:33:55 UTC [2024/06/26 18:33:55 ET]
Table '3769361908 14' 6-max Seat #2 is the button
Seat 1: dulek_jason (20904 in chips) 
Seat 2: jessecesar (14085 in chips) 
Seat 4: Go4ElvIS (6586 in chips) 
Seat 5: mennck (5059 in chips) 
Seat 6: $aymon9 (7542 in chips) 
dulek_jason: posts the ante 125
jessecesar: posts the ante 125
Go4ElvIS: posts the ante 125
mennck: posts the ante 125
$aymon9: posts the ante 125
Go4ElvIS: posts small blind 250
mennck: posts big blind 500
*** HOLE CARDS ***
$aymon9: raises 500 to 1000
dulek_jason: folds 
jessecesar: folds 
Go4ElvIS: folds 
mennck: calls 500
*** FLOP *** [8h 3h 3s]
mennck: checks 
Gsmith13 is disconnected 
$aymon9: bets 750
mennck: raises 3184 to 3934 and is all-in
$aymon9: calls 3184
*** TURN *** [8h 3h 3s] [Kh]
*** RIVER *** [8h 3h 3s Kh] [Qc]
*** SHOW DOWN ***
mennck: shows [8d Qh] (two pair, Queens and Eights)
$aymon9: shows [Ad 9h] (a pair of Threes)
mennck collected 10743 from pot
*** SUMMARY ***
Total pot 10743 | Rake 0 
Board [8h 3h 3s Kh Qc]
Seat 1: dulek_jason folded before Flop (didn't bet)
Seat 2: jessecesar (button) folded before Flop (didn't bet)
Seat 4: Go4ElvIS (small blind) folded before Flop
Seat 5: mennck (big blind) showed [8d Qh] and won (10743) with two pair, Queens and Eights
Seat 6: $aymon9 showed [Ad 9h] and lost with a pair of Threes

PokerStars Hand #251209585945: Tournament #3769361908, $52.38+$2.62 USD Hold'em No Limit - Level XI (250/500) - 2024/06/26 22:34:45 UTC [2024/06/26 18:34:45 ET]
Table '3769361908 14' 6-max Seat #4 is the button
Seat 1: dulek_jason (20779 in chips) 
Seat 2: jessecesar (13960 in chips) 
Seat 3: Gsmith13 (10000 in chips) 
Seat 4: Go4ElvIS (6211 in chips) 
Seat 5: mennck (10743 in chips) 
Seat 6: $aymon9 (2483 in chips) 
dulek_jason: posts the ante 125
jessecesar: posts the ante 125
Gsmith13: posts the ante 125
Go4ElvIS: posts the ante 125
mennck: posts the ante 125
$aymon9: posts the ante 125
mennck: posts small blind 250
$aymon9: posts big blind 500
*** HOLE CARDS ***
dulek_jason: folds 
jessecesar: folds 
Gsmith13: folds 
Go4ElvIS: folds 
mennck: folds 
Uncalled bet (250) returned to $aymon9
$aymon9 collected 1250 from pot
*** SUMMARY ***
Total pot 1250 | Rake 0 
Seat 1: dulek_jason folded before Flop (didn't bet)
Seat 2: jessecesar folded before Flop (didn't bet)
Seat 3: Gsmith13 folded before Flop (didn't bet)
Seat 4: Go4ElvIS (button) folded before Flop (didn't bet)
Seat 5: mennck (small blind) folded before Flop
Seat 6: $aymon9 (big blind) collected (1250)

PokerStars Hand #251209590578: Tournament #3769361908, $52.38+$2.62 USD Hold'em No Limit - Level XI (250/500) - 2024/06/26 22:35:02 UTC [2024/06/26 18:35:02 ET]
Table '3769361908 14' 6-max Seat #5 is the button
Seat 1: dulek_jason (20654 in chips) 
Seat 2: jessecesar (13835 in chips) 
Seat 3: Gsmith13 (9875 in chips) 
Seat 4: Go4ElvIS (6086 in chips) 
Seat 5: mennck (10368 in chips) 
Seat 6: $aymon9 (3358 in chips) 
dulek_jason: posts the ante 125
jessecesar: posts the ante 125
Gsmith13: posts the ante 125
Go4ElvIS: posts the ante 125
mennck: posts the ante 125
$aymon9: posts the ante 125
$aymon9: posts small blind 250
dulek_jason: posts big blind 500
*** HOLE CARDS ***
jessecesar: folds 
Gsmith13: folds 
Go4ElvIS: folds 
mennck: folds 
$aymon9: raises 2733 to 3233 and is all-in
dulek_jason: calls 2733
*** FLOP *** [5d 5s Kd]
*** TURN *** [5d 5s Kd] [8h]
*** RIVER *** [5d 5s Kd 8h] [4s]
*** SHOW DOWN ***
$aymon9: shows [Th Td] (two pair, Tens and Fives)
dulek_jason: shows [2s Ac] (a pair of Fives)
$aymon9 collected 7216 from pot
*** SUMMARY ***
Total pot 7216 | Rake 0 
Board [5d 5s Kd 8h 4s]
Seat 1: dulek_jason (big blind) showed [2s Ac] and lost with a pair of Fives
Seat 2: jessecesar folded before Flop (didn't bet)
Seat 3: Gsmith13 folded before Flop (didn't bet)
Seat 4: Go4ElvIS folded before Flop (didn't bet)
Seat 5: mennck (button) folded before Flop (didn't bet)
Seat 6: $aymon9 (small blind) showed [Th Td] and won (7216) with two pair, Tens and Fives

PokerStars Hand #251209599285: Tournament #3769361908, $52.38+$2.62 USD Hold'em No Limit - Level XII (300/600) - 2024/06/26 22:35:34 UTC [2024/06/26 18:35:34 ET]
Table '3769361908 14' 6-max Seat #6 is the button
Seat 1: dulek_jason (17296 in chips) 
Seat 2: jessecesar (13710 in chips) 
Seat 3: Gsmith13 (9750 in chips) 
Seat 4: Go4ElvIS (5961 in chips) 
Seat 5: mennck (10243 in chips) 
Seat 6: $aymon9 (7216 in chips) 
dulek_jason: posts the ante 150
jessecesar: posts the ante 150
Gsmith13: posts the ante 150
Go4ElvIS: posts the ante 150
mennck: posts the ante 150
$aymon9: posts the ante 150
dulek_jason: posts small blind 300
jessecesar: posts big blind 600
*** HOLE CARDS ***
Gsmith13: folds 
Go4ElvIS: folds 
mennck: folds 
$aymon9: folds 
dulek_jason: calls 300
jessecesar: checks 
*** FLOP *** [5s Ts Qd]
dulek_jason: checks 
jessecesar: checks 
*** TURN *** [5s Ts Qd] [Jc]
dulek_jason: checks 
jessecesar: checks 
*** RIVER *** [5s Ts Qd Jc] [7c]
dulek_jason: bets 1554
jessecesar: folds 
Uncalled bet (1554) returned to dulek_jason
dulek_jason collected 2100 from pot
dulek_jason: doesn't show hand 
*** SUMMARY ***
Total pot 2100 | Rake 0 
Board [5s Ts Qd Jc 7c]
Seat 1: dulek_jason (small blind) collected (2100)
Seat 2: jessecesar (big blind) folded on the River
Seat 3: Gsmith13 folded before Flop (didn't bet)
Seat 4: Go4ElvIS folded before Flop (didn't bet)
Seat 5: mennck folded before Flop (didn't bet)
Seat 6: $aymon9 (button) folded before Flop (didn't bet)

PokerStars Hand #251209611919: Tournament #3769361908, $52.38+$2.62 USD Hold'em No Limit - Level XII (300/600) - 2024/06/26 22:36:21 UTC [2024/06/26 18:36:21 ET]
Table '3769361908 14' 6-max Seat #1 is the button
Seat 1: dulek_jason (18646 in chips) 
Seat 2: jessecesar (12960 in chips) 
Seat 3: Gsmith13 (9600 in chips) 
Seat 4: Go4ElvIS (5811 in chips) 
Seat 5: mennck (10093 in chips) 
Seat 6: $aymon9 (7066 in chips) 
dulek_jason: posts the ante 150
jessecesar: posts the ante 150
Gsmith13: posts the ante 150
Go4ElvIS: posts the ante 150
mennck: posts the ante 150
$aymon9: posts the ante 150
jessecesar: posts small blind 300
Gsmith13: posts big blind 600
*** HOLE CARDS ***
Go4ElvIS: raises 660 to 1260
mennck: folds 
$aymon9: folds 
dulek_jason: folds 
jessecesar: folds 
Gsmith13: folds 
Uncalled bet (660) returned to Go4ElvIS
Go4ElvIS collected 2400 from pot
Go4ElvIS: doesn't show hand 
*** SUMMARY ***
Total pot 2400 | Rake 0 
Seat 1: dulek_jason (button) folded before Flop (didn't bet)
Seat 2: jessecesar (small blind) folded before Flop
Seat 3: Gsmith13 (big blind) folded before Flop
Seat 4: Go4ElvIS collected (2400)
Seat 5: mennck folded before Flop (didn't bet)
Seat 6: $aymon9 folded before Flop (didn't bet)

PokerStars Hand #251209616977: Tournament #3769361908, $52.38+$2.62 USD Hold'em No Limit - Level XII (300/600) - 2024/06/26 22:36:40 UTC [2024/06/26 18:36:40 ET]
Table '3769361908 14' 6-max Seat #2 is the button
Seat 1: dulek_jason (18496 in chips) 
Seat 2: jessecesar (12510 in chips) 
Seat 3: Gsmith13 (8850 in chips) 
Seat 4: Go4ElvIS (7461 in chips) 
Seat 5: mennck (9943 in chips) 
Seat 6: $aymon9 (6916 in chips) 
dulek_jason: posts the ante 150
jessecesar: posts the ante 150
Gsmith13: posts the ante 150
Go4ElvIS: posts the ante 150
mennck: posts the ante 150
$aymon9: posts the ante 150
Gsmith13: posts small blind 300
Go4ElvIS: posts big blind 600
*** HOLE CARDS ***
mennck: folds 
$aymon9: folds 
dulek_jason: raises 17746 to 18346 and is all-in
jessecesar: folds 
Gsmith13: folds 
Go4ElvIS: folds 
Uncalled bet (17746) returned to dulek_jason
dulek_jason collected 2400 from pot
dulek_jason: doesn't show hand 
*** SUMMARY ***
Total pot 2400 | Rake 0 
Seat 1: dulek_jason collected (2400)
Seat 2: jessecesar (button) folded before Flop (didn't bet)
Seat 3: Gsmith13 (small blind) folded before Flop
Seat 4: Go4ElvIS (big blind) folded before Flop
Seat 5: mennck folded before Flop (didn't bet)
Seat 6: $aymon9 folded before Flop (didn't bet)

PokerStars Hand #251209623262: Tournament #3769361908, $52.38+$2.62 USD Hold'em No Limit - Level XII (300/600) - 2024/06/26 22:37:04 UTC [2024/06/26 18:37:04 ET]
Table '3769361908 14' 6-max Seat #3 is the button
Seat 1: dulek_jason (20146 in chips) 
Seat 2: jessecesar (12360 in chips) 
Seat 3: Gsmith13 (8400 in chips) 
Seat 4: Go4ElvIS (6711 in chips) 
Seat 5: mennck (9793 in chips) 
Seat 6: $aymon9 (6766 in chips) 
dulek_jason: posts the ante 150
jessecesar: posts the ante 150
Gsmith13: posts the ante 150
Go4ElvIS: posts the ante 150
mennck: posts the ante 150
$aymon9: posts the ante 150
Go4ElvIS: posts small blind 300
mennck: posts big blind 600
*** HOLE CARDS ***
$aymon9: raises 600 to 1200
dulek_jason: folds 
jessecesar: raises 11010 to 12210 and is all-in
Gsmith13: folds 
Go4ElvIS: calls 6261 and is all-in
mennck: folds 
$aymon9: folds 
Uncalled bet (5649) returned to jessecesar
*** FLOP *** [6h Qh 8c]
*** TURN *** [6h Qh 8c] [9h]
*** RIVER *** [6h Qh 8c 9h] [As]
*** SHOW DOWN ***
Go4ElvIS: shows [9s 9d] (three of a kind, Nines)
jessecesar: shows [Kd Td] (high card Ace)
Go4ElvIS collected 15822 from pot
*** SUMMARY ***
Total pot 15822 | Rake 0 
Board [6h Qh 8c 9h As]
Seat 1: dulek_jason folded before Flop (didn't bet)
Seat 2: jessecesar showed [Kd Td] and lost with high card Ace
Seat 3: Gsmith13 (button) folded before Flop (didn't bet)
Seat 4: Go4ElvIS (small blind) showed [9s 9d] and won (15822) with three of a kind, Nines
Seat 5: mennck (big blind) folded before Flop
Seat 6: $aymon9 folded before Flop

PokerStars Hand #251209632578: Tournament #3769361908, $52.38+$2.62 USD Hold'em No Limit - Level XII (300/600) - 2024/06/26 22:37:39 UTC [2024/06/26 18:37:39 ET]
Table '3769361908 14' 6-max Seat #4 is the button
Seat 1: dulek_jason (19996 in chips) 
Seat 2: jessecesar (5649 in chips) 
Seat 3: Gsmith13 (8250 in chips) 
Seat 4: Go4ElvIS (15822 in chips) 
Seat 5: mennck (9043 in chips) 
Seat 6: $aymon9 (5416 in chips) 
dulek_jason: posts the ante 150
jessecesar: posts the ante 150
Gsmith13: posts the ante 150
Go4ElvIS: posts the ante 150
mennck: posts the ante 150
$aymon9: posts the ante 150
mennck: posts small blind 300
$aymon9: posts big blind 600
*** HOLE CARDS ***
dulek_jason: folds 
jessecesar: raises 4899 to 5499 and is all-in
Gsmith13: folds 
Go4ElvIS: raises 10173 to 15672 and is all-in
mennck: folds 
$aymon9: folds 
Uncalled bet (10173) returned to Go4ElvIS
*** FLOP *** [8c 8h 4h]
*** TURN *** [8c 8h 4h] [3c]
*** RIVER *** [8c 8h 4h 3c] [Kd]
*** SHOW DOWN ***
jessecesar: shows [Ah 3d] (two pair, Eights and Threes)
Go4ElvIS: shows [5c Ad] (a pair of Eights)
jessecesar collected 12798 from pot
*** SUMMARY ***
Total pot 12798 | Rake 0 
Board [8c 8h 4h 3c Kd]
Seat 1: dulek_jason folded before Flop (didn't bet)
Seat 2: jessecesar showed [Ah 3d] and won (12798) with two pair, Eights and Threes
Seat 3: Gsmith13 folded before Flop (didn't bet)
Seat 4: Go4ElvIS (button) showed [5c Ad] and lost with a pair of Eights
Seat 5: mennck (small blind) folded before Flop
Seat 6: $aymon9 (big blind) folded before Flop

PokerStars Hand #251209645086: Tournament #3769361908, $52.38+$2.62 USD Hold'em No Limit - Level XIII (400/800) - 2024/06/26 22:38:26 UTC [2024/06/26 18:38:26 ET]
Table '3769361908 14' 6-max Seat #5 is the button
Seat 1: dulek_jason (19846 in chips) 
Seat 2: jessecesar (12798 in chips) 
Seat 3: Gsmith13 (8100 in chips) 
Seat 4: Go4ElvIS (10173 in chips) 
Seat 5: mennck (8593 in chips) 
Seat 6: $aymon9 (4666 in chips) 
dulek_jason: posts the ante 200
jessecesar: posts the ante 200
Gsmith13: posts the ante 200
Go4ElvIS: posts the ante 200
mennck: posts the ante 200
$aymon9: posts the ante 200
$aymon9: posts small blind 400
dulek_jason: posts big blind 800
*** HOLE CARDS ***
jessecesar: folds 
Gsmith13: folds 
Go4ElvIS: folds 
mennck: folds 
$aymon9: raises 3666 to 4466 and is all-in
dulek_jason: calls 3666
*** FLOP *** [6h Js 7s]
*** TURN *** [6h Js 7s] [6s]
*** RIVER *** [6h Js 7s 6s] [7c]
*** SHOW DOWN ***
$aymon9: shows [Qh 2d] (two pair, Sevens and Sixes)
dulek_jason: shows [5c Qc] (two pair, Sevens and Sixes)
$aymon9 collected 5066 from pot
dulek_jason collected 5066 from pot
*** SUMMARY ***
Total pot 10132 | Rake 0 
Board [6h Js 7s 6s 7c]
Seat 1: dulek_jason (big blind) showed [5c Qc] and won (5066) with two pair, Sevens and Sixes
Seat 2: jessecesar folded before Flop (didn't bet)
Seat 3: Gsmith13 folded before Flop (didn't bet)
Seat 4: Go4ElvIS folded before Flop (didn't bet)
Seat 5: mennck (button) folded before Flop (didn't bet)
Seat 6: $aymon9 (small blind) showed [Qh 2d] and won (5066) with two pair, Sevens and Sixes

PokerStars Hand #251209652822: Tournament #3769361908, $52.38+$2.62 USD Hold'em No Limit - Level XIII (400/800) - 2024/06/26 22:38:54 UTC [2024/06/26 18:38:54 ET]
Table '3769361908 14' 6-max Seat #6 is the button
Seat 1: dulek_jason (20246 in chips) 
Seat 2: jessecesar (12598 in chips) 
Seat 3: Gsmith13 (7900 in chips) 
Seat 4: Go4ElvIS (9973 in chips) 
Seat 5: mennck (8393 in chips) 
Seat 6: $aymon9 (5066 in chips) 
dulek_jason: posts the ante 200
jessecesar: posts the ante 200
Gsmith13: posts the ante 200
Go4ElvIS: posts the ante 200
mennck: posts the ante 200
$aymon9: posts the ante 200
dulek_jason: posts small blind 400
jessecesar: posts big blind 800
*** HOLE CARDS ***
Gsmith13: folds 
Go4ElvIS: raises 8973 to 9773 and is all-in
mennck: folds 
$aymon9: folds 
dulek_jason: folds 
jessecesar: calls 8973
*** FLOP *** [Kh Th 2h]
*** TURN *** [Kh Th 2h] [6h]
*** RIVER *** [Kh Th 2h 6h] [Qh]
*** SHOW DOWN ***
jessecesar: shows [9s Ad] (a flush, King high)
Go4ElvIS: shows [As 6d] (a flush, King high)
jessecesar collected 10573 from pot
Go4ElvIS collected 10573 from pot
*** SUMMARY ***
Total pot 21146 | Rake 0 
Board [Kh Th 2h 6h Qh]
Seat 1: dulek_jason (small blind) folded before Flop
Seat 2: jessecesar (big blind) showed [9s Ad] and won (10573) with a flush, King high
Seat 3: Gsmith13 folded before Flop (didn't bet)
Seat 4: Go4ElvIS showed [As 6d] and won (10573) with a flush, King high
Seat 5: mennck folded before Flop (didn't bet)
Seat 6: $aymon9 (button) folded before Flop (didn't bet)

PokerStars Hand #251209661865: Tournament #3769361908, $52.38+$2.62 USD Hold'em No Limit - Level XIII (400/800) - 2024/06/26 22:39:28 UTC [2024/06/26 18:39:28 ET]
Table '3769361908 14' 6-max Seat #1 is the button
Seat 1: dulek_jason (19646 in chips) 
Seat 2: jessecesar (13198 in chips) 
Seat 3: Gsmith13 (7700 in chips) 
Seat 4: Go4ElvIS (10573 in chips) 
Seat 5: mennck (8193 in chips) 
Seat 6: $aymon9 (4866 in chips) 
dulek_jason: posts the ante 200
jessecesar: posts the ante 200
Gsmith13: posts the ante 200
Go4ElvIS: posts the ante 200
mennck: posts the ante 200
$aymon9: posts the ante 200
jessecesar: posts small blind 400
Gsmith13: posts big blind 800
*** HOLE CARDS ***
Go4ElvIS: raises 9573 to 10373 and is all-in
mennck: folds 
$aymon9: folds 
dulek_jason: folds 
jessecesar: folds 
Gsmith13: folds 
Uncalled bet (9573) returned to Go4ElvIS
Go4ElvIS collected 3200 from pot
Go4ElvIS: doesn't show hand 
*** SUMMARY ***
Total pot 3200 | Rake 0 
Seat 1: dulek_jason (button) folded before Flop (didn't bet)
Seat 2: jessecesar (small blind) folded before Flop
Seat 3: Gsmith13 (big blind) folded before Flop
Seat 4: Go4ElvIS collected (3200)
Seat 5: mennck folded before Flop (didn't bet)
Seat 6: $aymon9 folded before Flop (didn't bet)

PokerStars Hand #251209668351: Tournament #3769361908, $52.38+$2.62 USD Hold'em No Limit - Level XIII (400/800) - 2024/06/26 22:39:53 UTC [2024/06/26 18:39:53 ET]
Table '3769361908 14' 6-max Seat #2 is the button
Seat 1: dulek_jason (19446 in chips) 
Seat 2: jessecesar (12598 in chips) 
Seat 3: Gsmith13 (6700 in chips) 
Seat 4: Go4ElvIS (12773 in chips) 
Seat 5: mennck (7993 in chips) 
Seat 6: $aymon9 (4666 in chips) 
dulek_jason: posts the ante 200
jessecesar: posts the ante 200
Gsmith13: posts the ante 200
Go4ElvIS: posts the ante 200
mennck: posts the ante 200
$aymon9: posts the ante 200
Gsmith13: posts small blind 400
Go4ElvIS: posts big blind 800
*** HOLE CARDS ***
mennck: folds 
$aymon9: raises 3666 to 4466 and is all-in
dulek_jason: folds 
jessecesar: folds 
Gsmith13: folds 
Go4ElvIS: calls 3666
*** FLOP *** [Qc 7h Qd]
*** TURN *** [Qc 7h Qd] [9c]
*** RIVER *** [Qc 7h Qd 9c] [3d]
*** SHOW DOWN ***
Go4ElvIS: shows [As Jc] (a pair of Queens)
$aymon9: shows [Ks Qs] (three of a kind, Queens)
$aymon9 collected 10532 from pot
*** SUMMARY ***
Total pot 10532 | Rake 0 
Board [Qc 7h Qd 9c 3d]
Seat 1: dulek_jason folded before Flop (didn't bet)
Seat 2: jessecesar (button) folded before Flop (didn't bet)
Seat 3: Gsmith13 (small blind) folded before Flop
Seat 4: Go4ElvIS (big blind) showed [As Jc] and lost with a pair of Queens
Seat 5: mennck folded before Flop (didn't bet)
Seat 6: $aymon9 showed [Ks Qs] and won (10532) with three of a kind, Queens

PokerStars Hand #251209674359: Tournament #3769361908, $52.38+$2.62 USD Hold'em No Limit - Level XIII (400/800) - 2024/06/26 22:40:16 UTC [2024/06/26 18:40:16 ET]
Table '3769361908 14' 6-max Seat #3 is the button
Seat 1: dulek_jason (19246 in chips) 
Seat 2: jessecesar (12398 in chips) 
Seat 3: Gsmith13 (6100 in chips) 
Seat 4: Go4ElvIS (8107 in chips) 
Seat 5: mennck (7793 in chips) 
Seat 6: $aymon9 (10532 in chips) 
dulek_jason: posts the ante 200
jessecesar: posts the ante 200
Gsmith13: posts the ante 200
Go4ElvIS: posts the ante 200
mennck: posts the ante 200
$aymon9: posts the ante 200
Go4ElvIS: posts small blind 400
mennck: posts big blind 800
*** HOLE CARDS ***
$aymon9: folds 
dulek_jason: folds 
jessecesar: folds 
Gsmith13: folds 
Go4ElvIS: raises 7107 to 7907 and is all-in
mennck: folds 
Uncalled bet (7107) returned to Go4ElvIS
Go4ElvIS collected 2800 from pot
Go4ElvIS: doesn't show hand 
*** SUMMARY ***
Total pot 2800 | Rake 0 
Seat 1: dulek_jason folded before Flop (didn't bet)
Seat 2: jessecesar folded before Flop (didn't bet)
Seat 3: Gsmith13 (button) folded before Flop (didn't bet)
Seat 4: Go4ElvIS (small blind) collected (2800)
Seat 5: mennck (big blind) folded before Flop
Seat 6: $aymon9 folded before Flop (didn't bet)

PokerStars Hand #251209680632: Tournament #3769361908, $52.38+$2.62 USD Hold'em No Limit - Level XIII (400/800) - 2024/06/26 22:40:39 UTC [2024/06/26 18:40:39 ET]
Table '3769361908 14' 6-max Seat #4 is the button
Seat 1: dulek_jason (19046 in chips) 
Seat 2: jessecesar (12198 in chips) 
Seat 3: Gsmith13 (5900 in chips) 
Seat 4: Go4ElvIS (9907 in chips) 
Seat 5: mennck (6793 in chips) 
Seat 6: $aymon9 (10332 in chips) 
dulek_jason: posts the ante 200
jessecesar: posts the ante 200
Gsmith13: posts the ante 200
Go4ElvIS: posts the ante 200
mennck: posts the ante 200
$aymon9: posts the ante 200
mennck: posts small blind 400
$aymon9: posts big blind 800
*** HOLE CARDS ***
dulek_jason: folds 
jessecesar: folds 
Gsmith13: raises 4900 to 5700 and is all-in
Go4ElvIS: folds 
mennck: folds 
$aymon9: folds 
Uncalled bet (4900) returned to Gsmith13
Gsmith13 collected 3200 from pot
Gsmith13: doesn't show hand 
*** SUMMARY ***
Total pot 3200 | Rake 0 
Seat 1: dulek_jason folded before Flop (didn't bet)
Seat 2: jessecesar folded before Flop (didn't bet)
Seat 3: Gsmith13 collected (3200)
Seat 4: Go4ElvIS (button) folded before Flop (didn't bet)
Seat 5: mennck (small blind) folded before Flop
Seat 6: $aymon9 (big blind) folded before Flop

PokerStars Hand #251209687465: Tournament #3769361908, $52.38+$2.62 USD Hold'em No Limit - Level XIII (400/800) - 2024/06/26 22:41:06 UTC [2024/06/26 18:41:06 ET]
Table '3769361908 14' 6-max Seat #5 is the button
Seat 1: dulek_jason (18846 in chips) 
Seat 2: jessecesar (11998 in chips) 
Seat 3: Gsmith13 (8100 in chips) 
Seat 4: Go4ElvIS (9707 in chips) 
Seat 5: mennck (6193 in chips) 
Seat 6: $aymon9 (9332 in chips) 
dulek_jason: posts the ante 200
jessecesar: posts the ante 200
Gsmith13: posts the ante 200
Go4ElvIS: posts the ante 200
mennck: posts the ante 200
$aymon9: posts the ante 200
$aymon9: posts small blind 400
dulek_jason: posts big blind 800
*** HOLE CARDS ***
jessecesar: raises 800 to 1600
Gsmith13: folds 
Go4ElvIS: folds 
mennck: folds 
$aymon9: folds 
dulek_jason: folds 
Uncalled bet (800) returned to jessecesar
jessecesar collected 3200 from pot
jessecesar: doesn't show hand 
*** SUMMARY ***
Total pot 3200 | Rake 0 
Seat 1: dulek_jason (big blind) folded before Flop
Seat 2: jessecesar collected (3200)
Seat 3: Gsmith13 folded before Flop (didn't bet)
Seat 4: Go4ElvIS folded before Flop (didn't bet)
Seat 5: mennck (button) folded before Flop (didn't bet)
Seat 6: $aymon9 (small blind) folded before Flop

PokerStars Hand #251209695603: Tournament #3769361908, $52.38+$2.62 USD Hold'em No Limit - Level XIV (500/1000) - 2024/06/26 22:41:37 UTC [2024/06/26 18:41:37 ET]
Table '3769361908 14' 6-max Seat #6 is the button
Seat 1: dulek_jason (17846 in chips) 
Seat 2: jessecesar (14198 in chips) 
Seat 3: Gsmith13 (7900 in chips) 
Seat 4: Go4ElvIS (9507 in chips) 
Seat 5: mennck (5993 in chips) 
Seat 6: $aymon9 (8732 in chips) 
dulek_jason: posts the ante 250
jessecesar: posts the ante 250
Gsmith13: posts the ante 250
Go4ElvIS: posts the ante 250
mennck: posts the ante 250
$aymon9: posts the ante 250
dulek_jason: posts small blind 500
jessecesar: posts big blind 1000
*** HOLE CARDS ***
Gsmith13: folds 
Go4ElvIS: raises 8257 to 9257 and is all-in
mennck: folds 
$aymon9: folds 
dulek_jason: folds 
jessecesar: calls 8257
*** FLOP *** [Qh Th Js]
*** TURN *** [Qh Th Js] [As]
*** RIVER *** [Qh Th Js As] [Td]
*** SHOW DOWN ***
jessecesar: shows [Qd Ah] (two pair, Aces and Queens)
Go4ElvIS: shows [Ad Jc] (two pair, Aces and Jacks)
jessecesar collected 20514 from pot
Go4ElvIS finished the tournament
*** SUMMARY ***
Total pot 20514 | Rake 0 
Board [Qh Th Js As Td]
Seat 1: dulek_jason (small blind) folded before Flop
Seat 2: jessecesar (big blind) showed [Qd Ah] and won (20514) with two pair, Aces and Queens
Seat 3: Gsmith13 folded before Flop (didn't bet)
Seat 4: Go4ElvIS showed [Ad Jc] and lost with two pair, Aces and Jacks
Seat 5: mennck folded before Flop (didn't bet)
Seat 6: $aymon9 (button) folded before Flop (didn't bet)


PokerStars Hand #251209384555: Tournament #3769361908, $52.38+$2.62 USD Hold'em No Limit - Level VII (100/200) - 2024/06/26 22:22:34 UTC [2024/06/26 18:22:34 ET]
Table '3769361908 13' 6-max Seat #1 is the button
Seat 1: sanatamaria (11150 in chips) 
Seat 3: giftmyra (5838 in chips) 
Seat 4: fernandoefv (10310 in chips) 
Seat 5: laapin (11010 in chips) 
Seat 6: ratitoBR (11965 in chips) 
sanatamaria: posts the ante 50
giftmyra: posts the ante 50
fernandoefv: posts the ante 50
laapin: posts the ante 50
ratitoBR: posts the ante 50
giftmyra: posts small blind 100
fernandoefv: posts big blind 200
*** HOLE CARDS ***
laapin: raises 300 to 500
ratitoBR: folds 
sanatamaria: folds 
giftmyra: folds 
fernandoefv: calls 300
*** FLOP *** [4c Jd Kh]
fernandoefv: checks 
laapin: bets 959
fernandoefv: calls 959
*** TURN *** [4c Jd Kh] [4d]
fernandoefv: checks 
laapin: checks 
*** RIVER *** [4c Jd Kh 4d] [9s]
handsfull69 is disconnected 
fernandoefv: checks 
laapin: checks 
*** SHOW DOWN ***
fernandoefv: shows [Td Qs] (a straight, Nine to King)
laapin: mucks hand 
fernandoefv collected 3268 from pot
*** SUMMARY ***
Total pot 3268 | Rake 0 
Board [4c Jd Kh 4d 9s]
Seat 1: sanatamaria (button) folded before Flop (didn't bet)
Seat 3: giftmyra (small blind) folded before Flop
Seat 4: fernandoefv (big blind) showed [Td Qs] and won (3268) with a straight, Nine to King
Seat 5: laapin mucked
Seat 6: ratitoBR folded before Flop (didn't bet)

PokerStars Hand #251209404882: Tournament #3769361908, $52.38+$2.62 USD Hold'em No Limit - Level VIII (125/250) - 2024/06/26 22:23:48 UTC [2024/06/26 18:23:48 ET]
Table '3769361908 13' 6-max Seat #3 is the button
Seat 1: sanatamaria (11100 in chips) 
Seat 2: handsfull69 (10000 in chips) 
Seat 3: giftmyra (5688 in chips) 
Seat 4: fernandoefv (12069 in chips) 
Seat 5: laapin (9501 in chips) 
Seat 6: ratitoBR (11915 in chips) 
sanatamaria: posts the ante 60
handsfull69: posts the ante 60
giftmyra: posts the ante 60
fernandoefv: posts the ante 60
laapin: posts the ante 60
ratitoBR: posts the ante 60
fernandoefv: posts small blind 125
laapin: posts big blind 250
*** HOLE CARDS ***
ratitoBR: raises 250 to 500
sanatamaria: calls 500
handsfull69: folds 
giftmyra: folds 
fernandoefv: folds 
laapin: folds 
*** FLOP *** [2d Kd 4h]
ratitoBR: checks 
sanatamaria: checks 
*** TURN *** [2d Kd 4h] [3h]
ratitoBR: checks 
sanatamaria: checks 
*** RIVER *** [2d Kd 4h 3h] [Ad]
ratitoBR: bets 500
sanatamaria: calls 500
*** SHOW DOWN ***
ratitoBR: shows [Jc Qd] (high card Ace)
sanatamaria: shows [9h As] (a pair of Aces)
sanatamaria collected 2735 from pot
*** SUMMARY ***
Total pot 2735 | Rake 0 
Board [2d Kd 4h 3h Ad]
Seat 1: sanatamaria showed [9h As] and won (2735) with a pair of Aces
Seat 2: handsfull69 folded before Flop (didn't bet)
Seat 3: giftmyra (button) folded before Flop (didn't bet)
Seat 4: fernandoefv (small blind) folded before Flop
Seat 5: laapin (big blind) folded before Flop
Seat 6: ratitoBR showed [Jc Qd] and lost with high card Ace

PokerStars Hand #251209416027: Tournament #3769361908, $52.38+$2.62 USD Hold'em No Limit - Level VIII (125/250) - 2024/06/26 22:24:28 UTC [2024/06/26 18:24:28 ET]
Table '3769361908 13' 6-max Seat #4 is the button
Seat 1: sanatamaria (12775 in chips) 
Seat 2: handsfull69 (9940 in chips) 
Seat 3: giftmyra (5628 in chips) 
Seat 4: fernandoefv (11884 in chips) 
Seat 5: laapin (9191 in chips) 
Seat 6: ratitoBR (10855 in chips) 
sanatamaria: posts the ante 60
handsfull69: posts the ante 60
giftmyra: posts the ante 60
fernandoefv: posts the ante 60
laapin: posts the ante 60
ratitoBR: posts the ante 60
laapin: posts small blind 125
ratitoBR: posts big blind 250
*** HOLE CARDS ***
sanatamaria: calls 250
handsfull69: folds 
giftmyra: raises 275 to 525
fernandoefv: folds 
laapin: raises 8606 to 9131 and is all-in
ratitoBR: folds 
sanatamaria: folds 
giftmyra: calls 5043 and is all-in
Uncalled bet (3563) returned to laapin
*** FLOP *** [6h 9c Ts]
*** TURN *** [6h 9c Ts] [Kc]
*** RIVER *** [6h 9c Ts Kc] [3c]
*** SHOW DOWN ***
laapin: shows [Ah Jd] (high card Ace)
giftmyra: shows [As Td] (a pair of Tens)
giftmyra collected 11996 from pot
*** SUMMARY ***
Total pot 11996 | Rake 0 
Board [6h 9c Ts Kc 3c]
Seat 1: sanatamaria folded before Flop
Seat 2: handsfull69 folded before Flop (didn't bet)
Seat 3: giftmyra showed [As Td] and won (11996) with a pair of Tens
Seat 4: fernandoefv (button) folded before Flop (didn't bet)
Seat 5: laapin (small blind) showed [Ah Jd] and lost with high card Ace
Seat 6: ratitoBR (big blind) folded before Flop

PokerStars Hand #251209433415: Tournament #3769361908, $52.38+$2.62 USD Hold'em No Limit - Level VIII (125/250) - 2024/06/26 22:25:31 UTC [2024/06/26 18:25:31 ET]
Table '3769361908 13' 6-max Seat #5 is the button
Seat 1: sanatamaria (12465 in chips) 
Seat 2: handsfull69 (9880 in chips) 
Seat 3: giftmyra (11996 in chips) 
Seat 4: fernandoefv (11824 in chips) 
Seat 5: laapin (3563 in chips) 
Seat 6: ratitoBR (10545 in chips) 
sanatamaria: posts the ante 60
handsfull69: posts the ante 60
giftmyra: posts the ante 60
fernandoefv: posts the ante 60
laapin: posts the ante 60
ratitoBR: posts the ante 60
ratitoBR: posts small blind 125
sanatamaria: posts big blind 250
*** HOLE CARDS ***
handsfull69: folds 
giftmyra: folds 
fernandoefv: folds 
laapin: raises 3253 to 3503 and is all-in
ratitoBR: raises 6982 to 10485 and is all-in
sanatamaria: calls 10235
*** FLOP *** [Ts 7d 2d]
*** TURN *** [Ts 7d 2d] [Ah]
*** RIVER *** [Ts 7d 2d Ah] [9c]
*** SHOW DOWN ***
ratitoBR: shows [4d 4h] (a pair of Fours)
sanatamaria: shows [Qc Kh] (high card Ace)
ratitoBR collected 13964 from side pot
laapin: shows [5h 7s] (a pair of Sevens)
laapin collected 10869 from main pot
*** SUMMARY ***
Total pot 24833 Main pot 10869. Side pot 13964. | Rake 0 
Board [Ts 7d 2d Ah 9c]
Seat 1: sanatamaria (big blind) showed [Qc Kh] and lost with high card Ace
Seat 2: handsfull69 folded before Flop (didn't bet)
Seat 3: giftmyra folded before Flop (didn't bet)
Seat 4: fernandoefv folded before Flop (didn't bet)
Seat 5: laapin (button) showed [5h 7s] and won (10869) with a pair of Sevens
Seat 6: ratitoBR (small blind) showed [4d 4h] and won (13964) with a pair of Fours

PokerStars Hand #251209440873: Tournament #3769361908, $52.38+$2.62 USD Hold'em No Limit - Level VIII (125/250) - 2024/06/26 22:25:58 UTC [2024/06/26 18:25:58 ET]
Table '3769361908 13' 6-max Seat #6 is the button
Seat 1: sanatamaria (1920 in chips) 
Seat 2: handsfull69 (9820 in chips) 
Seat 3: giftmyra (11936 in chips) 
Seat 4: fernandoefv (11764 in chips) 
Seat 5: laapin (10869 in chips) 
Seat 6: ratitoBR (13964 in chips) 
sanatamaria: posts the ante 60
handsfull69: posts the ante 60
giftmyra: posts the ante 60
fernandoefv: posts the ante 60
laapin: posts the ante 60
ratitoBR: posts the ante 60
sanatamaria: posts small blind 125
handsfull69: posts big blind 250
*** HOLE CARDS ***
giftmyra: folds 
fernandoefv: folds 
laapin: folds 
ratitoBR: folds 
sanatamaria: raises 1610 to 1860 and is all-in
handsfull69: calls 1610
*** FLOP *** [Qd 3s 5d]
*** TURN *** [Qd 3s 5d] [9h]
*** RIVER *** [Qd 3s 5d 9h] [4h]
*** SHOW DOWN ***
sanatamaria: shows [Js Tc] (high card Queen)
handsfull69: shows [Jh 7h] (high card Queen - lower kicker)
sanatamaria collected 4080 from pot
*** SUMMARY ***
Total pot 4080 | Rake 0 
Board [Qd 3s 5d 9h 4h]
Seat 1: sanatamaria (small blind) showed [Js Tc] and won (4080) with high card Queen
Seat 2: handsfull69 (big blind) showed [Jh 7h] and lost with high card Queen
Seat 3: giftmyra folded before Flop (didn't bet)
Seat 4: fernandoefv folded before Flop (didn't bet)
Seat 5: laapin folded before Flop (didn't bet)
Seat 6: ratitoBR (button) folded before Flop (didn't bet)

PokerStars Hand #251209452520: Tournament #3769361908, $52.38+$2.62 USD Hold'em No Limit - Level IX (150/300) - 2024/06/26 22:26:40 UTC [2024/06/26 18:26:40 ET]
Table '3769361908 13' 6-max Seat #1 is the button
Seat 1: sanatamaria (4080 in chips) 
Seat 2: handsfull69 (7900 in chips) 
Seat 3: giftmyra (11876 in chips) 
Seat 4: fernandoefv (11704 in chips) 
Seat 5: laapin (10809 in chips) 
Seat 6: ratitoBR (13904 in chips) 
sanatamaria: posts the ante 75
handsfull69: posts the ante 75
giftmyra: posts the ante 75
fernandoefv: posts the ante 75
laapin: posts the ante 75
ratitoBR: posts the ante 75
handsfull69: posts small blind 150
giftmyra: posts big blind 300
*** HOLE CARDS ***
fernandoefv: raises 300 to 600
laapin: folds 
ratitoBR: folds 
sanatamaria: folds 
handsfull69: calls 450
giftmyra: folds 
*** FLOP *** [Jd 8d Jc]
handsfull69: bets 975
fernandoefv: folds 
Uncalled bet (975) returned to handsfull69
handsfull69 collected 1950 from pot
*** SUMMARY ***
Total pot 1950 | Rake 0 
Board [Jd 8d Jc]
Seat 1: sanatamaria (button) folded before Flop (didn't bet)
Seat 2: handsfull69 (small blind) collected (1950)
Seat 3: giftmyra (big blind) folded before Flop
Seat 4: fernandoefv folded on the Flop
Seat 5: laapin folded before Flop (didn't bet)
Seat 6: ratitoBR folded before Flop (didn't bet)

PokerStars Hand #251209467806: Tournament #3769361908, $52.38+$2.62 USD Hold'em No Limit - Level IX (150/300) - 2024/06/26 22:27:35 UTC [2024/06/26 18:27:35 ET]
Table '3769361908 13' 6-max Seat #2 is the button
Seat 1: sanatamaria (4005 in chips) 
Seat 2: handsfull69 (9175 in chips) 
Seat 3: giftmyra (11501 in chips) 
Seat 5: laapin (10734 in chips) 
Seat 6: ratitoBR (13829 in chips) 
sanatamaria: posts the ante 75
handsfull69: posts the ante 75
giftmyra: posts the ante 75
laapin: posts the ante 75
ratitoBR: posts the ante 75
giftmyra: posts small blind 150
laapin: posts big blind 300
*** HOLE CARDS ***
ratitoBR: folds 
sanatamaria: folds 
handsfull69: raises 300 to 600
giftmyra: folds 
laapin: folds 
Uncalled bet (300) returned to handsfull69
handsfull69 collected 1125 from pot
*** SUMMARY ***
Total pot 1125 | Rake 0 
Seat 1: sanatamaria folded before Flop (didn't bet)
Seat 2: handsfull69 (button) collected (1125)
Seat 3: giftmyra (small blind) folded before Flop
Seat 5: laapin (big blind) folded before Flop
Seat 6: ratitoBR folded before Flop (didn't bet)

PokerStars Hand #251209472811: Tournament #3769361908, $52.38+$2.62 USD Hold'em No Limit - Level IX (150/300) - 2024/06/26 22:27:52 UTC [2024/06/26 18:27:52 ET]
Table '3769361908 13' 6-max Seat #3 is the button
Seat 1: sanatamaria (3930 in chips) 
Seat 2: handsfull69 (9925 in chips) 
Seat 3: giftmyra (11276 in chips) 
Seat 5: laapin (10359 in chips) 
Seat 6: ratitoBR (13754 in chips) 
sanatamaria: posts the ante 75
handsfull69: posts the ante 75
giftmyra: posts the ante 75
laapin: posts the ante 75
ratitoBR: posts the ante 75
laapin: posts small blind 150
ratitoBR: posts big blind 300
*** HOLE CARDS ***
sanatamaria: folds 
handsfull69: raises 300 to 600
giftmyra: folds 
laapin: folds 
ratitoBR: calls 300
*** FLOP *** [Jh 8c 7c]
ratitoBR: checks 
vip_1985Z is disconnected 
handsfull69: checks 
*** TURN *** [Jh 8c 7c] [2h]
ratitoBR: checks 
handsfull69: checks 
*** RIVER *** [Jh 8c 7c 2h] [9d]
ratitoBR: checks 
handsfull69: checks 
*** SHOW DOWN ***
ratitoBR: shows [2s Ah] (a pair of Deuces)
handsfull69: shows [4d 4s] (a pair of Fours)
handsfull69 collected 1725 from pot
*** SUMMARY ***
Total pot 1725 | Rake 0 
Board [Jh 8c 7c 2h 9d]
Seat 1: sanatamaria folded before Flop (didn't bet)
Seat 2: handsfull69 showed [4d 4s] and won (1725) with a pair of Fours
Seat 3: giftmyra (button) folded before Flop (didn't bet)
Seat 5: laapin (small blind) folded before Flop
Seat 6: ratitoBR (big blind) showed [2s Ah] and lost with a pair of Deuces

PokerStars Hand #251209485972: Tournament #3769361908, $52.38+$2.62 USD Hold'em No Limit - Level IX (150/300) - 2024/06/26 22:28:40 UTC [2024/06/26 18:28:40 ET]
Table '3769361908 13' 6-max Seat #5 is the button
Seat 1: sanatamaria (3855 in chips) 
Seat 2: handsfull69 (10975 in chips) 
Seat 3: giftmyra (11201 in chips) 
Seat 4: vip_1985Z (10000 in chips) 
Seat 5: laapin (10134 in chips) 
Seat 6: ratitoBR (13079 in chips) 
sanatamaria: posts the ante 75
handsfull69: posts the ante 75
giftmyra: posts the ante 75
vip_1985Z: posts the ante 75
laapin: posts the ante 75
ratitoBR: posts the ante 75
ratitoBR: posts small blind 150
sanatamaria: posts big blind 300
*** HOLE CARDS ***
handsfull69: raises 300 to 600
giftmyra: folds 
vip_1985Z: folds 
laapin: folds 
ratitoBR: folds 
sanatamaria: calls 300
*** FLOP *** [Ks Qs 2h]
sanatamaria: checks 
handsfull69: checks 
*** TURN *** [Ks Qs 2h] [7s]
sanatamaria: checks 
handsfull69: checks 
*** RIVER *** [Ks Qs 2h 7s] [4h]
sanatamaria: bets 3180 and is all-in
handsfull69: calls 3180
*** SHOW DOWN ***
sanatamaria: shows [9d Kh] (a pair of Kings)
handsfull69: shows [6h 6s] (a pair of Sixes)
sanatamaria collected 8160 from pot
*** SUMMARY ***
Total pot 8160 | Rake 0 
Board [Ks Qs 2h 7s 4h]
Seat 1: sanatamaria (big blind) showed [9d Kh] and won (8160) with a pair of Kings
Seat 2: handsfull69 showed [6h 6s] and lost with a pair of Sixes
Seat 3: giftmyra folded before Flop (didn't bet)
Seat 4: vip_1985Z folded before Flop (didn't bet)
Seat 5: laapin (button) folded before Flop (didn't bet)
Seat 6: ratitoBR (small blind) folded before Flop

PokerStars Hand #251209496462: Tournament #3769361908, $52.38+$2.62 USD Hold'em No Limit - Level X (200/400) - 2024/06/26 22:29:17 UTC [2024/06/26 18:29:17 ET]
Table '3769361908 13' 6-max Seat #6 is the button
Seat 1: sanatamaria (8160 in chips) 
Seat 2: handsfull69 (7120 in chips) 
Seat 3: giftmyra (11126 in chips) 
Seat 4: vip_1985Z (9925 in chips) 
Seat 5: laapin (10059 in chips) 
Seat 6: ratitoBR (12854 in chips) 
sanatamaria: posts the ante 100
handsfull69: posts the ante 100
giftmyra: posts the ante 100
vip_1985Z: posts the ante 100
laapin: posts the ante 100
ratitoBR: posts the ante 100
sanatamaria: posts small blind 200
handsfull69: posts big blind 400
*** HOLE CARDS ***
giftmyra: folds 
vip_1985Z: folds 
laapin: folds 
ratitoBR: folds 
sanatamaria: folds 
Uncalled bet (200) returned to handsfull69
handsfull69 collected 1000 from pot
*** SUMMARY ***
Total pot 1000 | Rake 0 
Seat 1: sanatamaria (small blind) folded before Flop
Seat 2: handsfull69 (big blind) collected (1000)
Seat 3: giftmyra folded before Flop (didn't bet)
Seat 4: vip_1985Z folded before Flop (didn't bet)
Seat 5: laapin folded before Flop (didn't bet)
Seat 6: ratitoBR (button) folded before Flop (didn't bet)

PokerStars Hand #251209505300: Tournament #3769361908, $52.38+$2.62 USD Hold'em No Limit - Level X (200/400) - 2024/06/26 22:29:49 UTC [2024/06/26 18:29:49 ET]
Table '3769361908 13' 6-max Seat #1 is the button
Seat 1: sanatamaria (7860 in chips) 
Seat 2: handsfull69 (7820 in chips) 
Seat 3: giftmyra (11026 in chips) 
Seat 4: vip_1985Z (9825 in chips) 
Seat 5: laapin (9959 in chips) 
Seat 6: ratitoBR (12754 in chips) 
sanatamaria: posts the ante 100
handsfull69: posts the ante 100
giftmyra: posts the ante 100
vip_1985Z: posts the ante 100
laapin: posts the ante 100
ratitoBR: posts the ante 100
handsfull69: posts small blind 200
giftmyra: posts big blind 400
*** HOLE CARDS ***
vip_1985Z: folds 
laapin: folds 
ratitoBR: folds 
sanatamaria: folds 
handsfull69: raises 7320 to 7720 and is all-in
giftmyra: folds 
Uncalled bet (7320) returned to handsfull69
handsfull69 collected 1400 from pot
*** SUMMARY ***
Total pot 1400 | Rake 0 
Seat 1: sanatamaria (button) folded before Flop (didn't bet)
Seat 2: handsfull69 (small blind) collected (1400)
Seat 3: giftmyra (big blind) folded before Flop
Seat 4: vip_1985Z folded before Flop (didn't bet)
Seat 5: laapin folded before Flop (didn't bet)
Seat 6: ratitoBR folded before Flop (didn't bet)

PokerStars Hand #251209514978: Tournament #3769361908, $52.38+$2.62 USD Hold'em No Limit - Level X (200/400) - 2024/06/26 22:30:23 UTC [2024/06/26 18:30:23 ET]
Table '3769361908 13' 6-max Seat #2 is the button
Seat 1: sanatamaria (7760 in chips) 
Seat 2: handsfull69 (8720 in chips) 
Seat 3: giftmyra (10526 in chips) 
Seat 4: vip_1985Z (9725 in chips) 
Seat 5: laapin (9859 in chips) 
Seat 6: ratitoBR (12654 in chips) 
sanatamaria: posts the ante 100
handsfull69: posts the ante 100
giftmyra: posts the ante 100
vip_1985Z: posts the ante 100
laapin: posts the ante 100
ratitoBR: posts the ante 100
giftmyra: posts small blind 200
vip_1985Z: posts big blind 400
*** HOLE CARDS ***
laapin: folds 
ratitoBR: folds 
sanatamaria: folds 
handsfull69: folds 
giftmyra: folds 
Uncalled bet (200) returned to vip_1985Z
vip_1985Z collected 1000 from pot
vip_1985Z: doesn't show hand 
*** SUMMARY ***
Total pot 1000 | Rake 0 
Seat 1: sanatamaria folded before Flop (didn't bet)
Seat 2: handsfull69 (button) folded before Flop (didn't bet)
Seat 3: giftmyra (small blind) folded before Flop
Seat 4: vip_1985Z (big blind) collected (1000)
Seat 5: laapin folded before Flop (didn't bet)
Seat 6: ratitoBR folded before Flop (didn't bet)

PokerStars Hand #251209525409: Tournament #3769361908, $52.38+$2.62 USD Hold'em No Limit - Level X (200/400) - 2024/06/26 22:31:01 UTC [2024/06/26 18:31:01 ET]
Table '3769361908 13' 6-max Seat #3 is the button
Seat 1: sanatamaria (7660 in chips) 
Seat 2: handsfull69 (8620 in chips) 
Seat 3: giftmyra (10226 in chips) 
Seat 4: vip_1985Z (10425 in chips) 
Seat 5: laapin (9759 in chips) 
Seat 6: ratitoBR (12554 in chips) 
sanatamaria: posts the ante 100
handsfull69: posts the ante 100
giftmyra: posts the ante 100
vip_1985Z: posts the ante 100
laapin: posts the ante 100
ratitoBR: posts the ante 100
vip_1985Z: posts small blind 200
laapin: posts big blind 400
*** HOLE CARDS ***
ratitoBR: folds 
sanatamaria: raises 7160 to 7560 and is all-in
handsfull69: raises 960 to 8520 and is all-in
giftmyra: folds 
vip_1985Z: folds 
laapin: calls 8120
*** FLOP *** [Jd Ks 3s]
*** TURN *** [Jd Ks 3s] [6h]
*** RIVER *** [Jd Ks 3s 6h] [2c]
*** SHOW DOWN ***
laapin: shows [5c 5s] (a pair of Fives)
handsfull69: shows [9d 9s] (a pair of Nines)
handsfull69 collected 1920 from side pot
sanatamaria: shows [Th Kh] (a pair of Kings)
sanatamaria collected 23480 from main pot
*** SUMMARY ***
Total pot 25400 Main pot 23480. Side pot 1920. | Rake 0 
Board [Jd Ks 3s 6h 2c]
Seat 1: sanatamaria showed [Th Kh] and won (23480) with a pair of Kings
Seat 2: handsfull69 showed [9d 9s] and won (1920) with a pair of Nines
Seat 3: giftmyra (button) folded before Flop (didn't bet)
Seat 4: vip_1985Z (small blind) folded before Flop
Seat 5: laapin (big blind) showed [5c 5s] and lost with a pair of Fives
Seat 6: ratitoBR folded before Flop (didn't bet)

PokerStars Hand #251209534378: Tournament #3769361908, $52.38+$2.62 USD Hold'em No Limit - Level X (200/400) - 2024/06/26 22:31:34 UTC [2024/06/26 18:31:34 ET]
Table '3769361908 13' 6-max Seat #4 is the button
Seat 1: sanatamaria (23480 in chips) 
Seat 2: handsfull69 (1920 in chips) 
Seat 3: giftmyra (10126 in chips) 
Seat 4: vip_1985Z (10125 in chips) 
Seat 5: laapin (1139 in chips) 
Seat 6: ratitoBR (12454 in chips) 
sanatamaria: posts the ante 100
handsfull69: posts the ante 100
giftmyra: posts the ante 100
vip_1985Z: posts the ante 100
laapin: posts the ante 100
ratitoBR: posts the ante 100
laapin: posts small blind 200
ratitoBR: posts big blind 400
*** HOLE CARDS ***
sanatamaria: folds 
handsfull69: raises 1420 to 1820 and is all-in
giftmyra: folds 
vip_1985Z: calls 1820
laapin: calls 839 and is all-in
ratitoBR: folds 
*** FLOP *** [Tc 5c 3d]
*** TURN *** [Tc 5c 3d] [3c]
*** RIVER *** [Tc 5c 3d 3c] [6s]
*** SHOW DOWN ***
handsfull69: shows [Jd 4h] (a pair of Threes)
vip_1985Z: shows [Ah As] (two pair, Aces and Threes)
vip_1985Z collected 1562 from side pot
laapin: shows [3h 2h] (three of a kind, Threes)
laapin collected 4117 from main pot
handsfull69 finished the tournament
*** SUMMARY ***
Total pot 5679 Main pot 4117. Side pot 1562. | Rake 0 
Board [Tc 5c 3d 3c 6s]
Seat 1: sanatamaria folded before Flop (didn't bet)
Seat 2: handsfull69 showed [Jd 4h] and lost with a pair of Threes
Seat 3: giftmyra folded before Flop (didn't bet)
Seat 4: vip_1985Z (button) showed [Ah As] and won (1562) with two pair, Aces and Threes
Seat 5: laapin (small blind) showed [3h 2h] and won (4117) with three of a kind, Threes
Seat 6: ratitoBR (big blind) folded before Flop

PokerStars Hand #251209540693: Tournament #3769361908, $52.38+$2.62 USD Hold'em No Limit - Level X (200/400) - 2024/06/26 22:31:57 UTC [2024/06/26 18:31:57 ET]
Table '3769361908 13' 6-max Seat #5 is the button
Seat 1: sanatamaria (23380 in chips) 
Seat 3: giftmyra (10026 in chips) 
Seat 4: vip_1985Z (9767 in chips) 
Seat 5: laapin (4117 in chips) 
Seat 6: ratitoBR (11954 in chips) 
sanatamaria: posts the ante 100
giftmyra: posts the ante 100
vip_1985Z: posts the ante 100
laapin: posts the ante 100
ratitoBR: posts the ante 100
ratitoBR: posts small blind 200
sanatamaria: posts big blind 400
*** HOLE CARDS ***
giftmyra: folds 
vip_1985Z: folds 
PIUlimeira is disconnected 
laapin: raises 3617 to 4017 and is all-in
ratitoBR: calls 3817
sanatamaria: folds 
*** FLOP *** [Kd 8d Kc]
*** TURN *** [Kd 8d Kc] [Ah]
*** RIVER *** [Kd 8d Kc Ah] [Qh]
*** SHOW DOWN ***
ratitoBR: shows [2s As] (two pair, Aces and Kings)
laapin: shows [5d 6h] (a pair of Kings)
ratitoBR collected 8934 from pot
laapin finished the tournament
*** SUMMARY ***
Total pot 8934 | Rake 0 
Board [Kd 8d Kc Ah Qh]
Seat 1: sanatamaria (big blind) folded before Flop
Seat 3: giftmyra folded before Flop (didn't bet)
Seat 4: vip_1985Z folded before Flop (didn't bet)
Seat 5: laapin (button) showed [5d 6h] and lost with a pair of Kings
Seat 6: ratitoBR (small blind) showed [2s As] and won (8934) with two pair, Aces and Kings

PokerStars Hand #251209550127: Tournament #3769361908, $52.38+$2.62 USD Hold'em No Limit - Level XI (250/500) - 2024/06/26 22:32:32 UTC [2024/06/26 18:32:32 ET]
Table '3769361908 13' 6-max Seat #6 is the button
Seat 1: sanatamaria (22880 in chips) 
Seat 2: PIUlimeira (10000 in chips) 
Seat 3: giftmyra (9926 in chips) 
Seat 4: vip_1985Z (9667 in chips) 
Seat 6: ratitoBR (16771 in chips) 
sanatamaria: posts the ante 125
PIUlimeira: posts the ante 125
giftmyra: posts the ante 125
vip_1985Z: posts the ante 125
ratitoBR: posts the ante 125
sanatamaria: posts small blind 250
PIUlimeira: posts big blind 500
*** HOLE CARDS ***
giftmyra: folds 
vip_1985Z: folds 
ratitoBR: folds 
sanatamaria: calls 250
PIUlimeira: checks 
*** FLOP *** [7h 4s 4h]
sanatamaria: bets 500
PIUlimeira: folds 
Uncalled bet (500) returned to sanatamaria
sanatamaria collected 1625 from pot
sanatamaria: doesn't show hand 
*** SUMMARY ***
Total pot 1625 | Rake 0 
Board [7h 4s 4h]
Seat 1: sanatamaria (small blind) collected (1625)
Seat 2: PIUlimeira (big blind) folded on the Flop
Seat 3: giftmyra folded before Flop (didn't bet)
Seat 4: vip_1985Z folded before Flop (didn't bet)
Seat 6: ratitoBR (button) folded before Flop (didn't bet)

PokerStars Hand #251209559655: Tournament #3769361908, $52.38+$2.62 USD Hold'em No Limit - Level XI (250/500) - 2024/06/26 22:33:07 UTC [2024/06/26 18:33:07 ET]
Table '3769361908 13' 6-max Seat #1 is the button
Seat 1: sanatamaria (23880 in chips) 
Seat 2: PIUlimeira (9375 in chips) 
Seat 3: giftmyra (9801 in chips) 
Seat 4: vip_1985Z (9542 in chips) 
Seat 6: ratitoBR (16646 in chips) 
sanatamaria: posts the ante 125
PIUlimeira: posts the ante 125
giftmyra: posts the ante 125
vip_1985Z: posts the ante 125
ratitoBR: posts the ante 125
PIUlimeira: posts small blind 250
giftmyra: posts big blind 500
*** HOLE CARDS ***
vip_1985Z: raises 600 to 1100
ratitoBR: folds 
sanatamaria: folds 
PIUlimeira: folds 
giftmyra: calls 600
*** FLOP *** [8h Qh 5s]
giftmyra: checks 
vip_1985Z: bets 923
giftmyra: calls 923
*** TURN *** [8h Qh 5s] [5h]
giftmyra: checks 
vip_1985Z: checks 
*** RIVER *** [8h Qh 5s 5h] [7c]
giftmyra: bets 1624
vip_1985Z: folds 
Uncalled bet (1624) returned to giftmyra
giftmyra collected 4921 from pot
giftmyra: doesn't show hand 
*** SUMMARY ***
Total pot 4921 | Rake 0 
Board [8h Qh 5s 5h 7c]
Seat 1: sanatamaria (button) folded before Flop (didn't bet)
Seat 2: PIUlimeira (small blind) folded before Flop
Seat 3: giftmyra (big blind) collected (4921)
Seat 4: vip_1985Z folded on the River
Seat 6: ratitoBR folded before Flop (didn't bet)

PokerStars Hand #251209579286: Tournament #3769361908, $52.38+$2.62 USD Hold'em No Limit - Level XI (250/500) - 2024/06/26 22:34:20 UTC [2024/06/26 18:34:20 ET]
Table '3769361908 13' 6-max Seat #2 is the button
Seat 1: sanatamaria (23755 in chips) 
Seat 2: PIUlimeira (9000 in chips) 
Seat 3: giftmyra (12574 in chips) 
Seat 4: vip_1985Z (7394 in chips) 
Seat 6: ratitoBR (16521 in chips) 
sanatamaria: posts the ante 125
PIUlimeira: posts the ante 125
giftmyra: posts the ante 125
vip_1985Z: posts the ante 125
ratitoBR: posts the ante 125
giftmyra: posts small blind 250
vip_1985Z: posts big blind 500
*** HOLE CARDS ***
ratitoBR: folds 
sanatamaria: folds 
PIUlimeira: folds 
giftmyra: calls 250
vip_1985Z: checks 
*** FLOP *** [Ac Ad 7h]
giftmyra: bets 500
vip_1985Z: folds 
Uncalled bet (500) returned to giftmyra
giftmyra collected 1625 from pot
giftmyra: doesn't show hand 
*** SUMMARY ***
Total pot 1625 | Rake 0 
Board [Ac Ad 7h]
Seat 1: sanatamaria folded before Flop (didn't bet)
Seat 2: PIUlimeira (button) folded before Flop (didn't bet)
Seat 3: giftmyra (small blind) collected (1625)
Seat 4: vip_1985Z (big blind) folded on the Flop
Seat 6: ratitoBR folded before Flop (didn't bet)

PokerStars Hand #251209587507: Tournament #3769361908, $52.38+$2.62 USD Hold'em No Limit - Level XI (250/500) - 2024/06/26 22:34:51 UTC [2024/06/26 18:34:51 ET]
Table '3769361908 13' 6-max Seat #3 is the button
Seat 1: sanatamaria (23630 in chips) 
Seat 2: PIUlimeira (8875 in chips) 
Seat 3: giftmyra (13574 in chips) 
Seat 4: vip_1985Z (6769 in chips) 
Seat 6: ratitoBR (16396 in chips) 
sanatamaria: posts the ante 125
PIUlimeira: posts the ante 125
giftmyra: posts the ante 125
vip_1985Z: posts the ante 125
ratitoBR: posts the ante 125
vip_1985Z: posts small blind 250
ratitoBR: posts big blind 500
*** HOLE CARDS ***
sanatamaria: folds 
PIUlimeira: folds 
giftmyra: folds 
vip_1985Z: folds 
Uncalled bet (250) returned to ratitoBR
ratitoBR collected 1125 from pot
ratitoBR: doesn't show hand 
*** SUMMARY ***
Total pot 1125 | Rake 0 
Seat 1: sanatamaria folded before Flop (didn't bet)
Seat 2: PIUlimeira folded before Flop (didn't bet)
Seat 3: giftmyra (button) folded before Flop (didn't bet)
Seat 4: vip_1985Z (small blind) folded before Flop
Seat 6: ratitoBR (big blind) collected (1125)

PokerStars Hand #251209597714: Tournament #3769361908, $52.38+$2.62 USD Hold'em No Limit - Level XII (300/600) - 2024/06/26 22:35:29 UTC [2024/06/26 18:35:29 ET]
Table '3769361908 13' 6-max Seat #4 is the button
Seat 1: sanatamaria (23505 in chips) 
Seat 2: PIUlimeira (8750 in chips) 
Seat 3: giftmyra (13449 in chips) 
Seat 4: vip_1985Z (6394 in chips) 
Seat 6: ratitoBR (17146 in chips) 
sanatamaria: posts the ante 150
PIUlimeira: posts the ante 150
giftmyra: posts the ante 150
vip_1985Z: posts the ante 150
ratitoBR: posts the ante 150
ratitoBR: posts small blind 300
sanatamaria: posts big blind 600
*** HOLE CARDS ***
PIUlimeira: folds 
giftmyra: folds 
vip_1985Z: folds 
ratitoBR: calls 300
sanatamaria: checks 
*** FLOP *** [7s 9h 3c]
ratitoBR: bets 600
sanatamaria: folds 
Uncalled bet (600) returned to ratitoBR
ratitoBR collected 1950 from pot
ratitoBR: doesn't show hand 
*** SUMMARY ***
Total pot 1950 | Rake 0 
Board [7s 9h 3c]
Seat 1: sanatamaria (big blind) folded on the Flop
Seat 2: PIUlimeira folded before Flop (didn't bet)
Seat 3: giftmyra folded before Flop (didn't bet)
Seat 4: vip_1985Z (button) folded before Flop (didn't bet)
Seat 6: ratitoBR (small blind) collected (1950)

PokerStars Hand #251209607619: Tournament #3769361908, $52.38+$2.62 USD Hold'em No Limit - Level XII (300/600) - 2024/06/26 22:36:05 UTC [2024/06/26 18:36:05 ET]
Table '3769361908 13' 6-max Seat #6 is the button
Seat 1: sanatamaria (22755 in chips) 
Seat 2: PIUlimeira (8600 in chips) 
Seat 3: giftmyra (13299 in chips) 
Seat 4: vip_1985Z (6244 in chips) 
Seat 6: ratitoBR (18346 in chips) 
sanatamaria: posts the ante 150
PIUlimeira: posts the ante 150
giftmyra: posts the ante 150
vip_1985Z: posts the ante 150
ratitoBR: posts the ante 150
sanatamaria: posts small blind 300
PIUlimeira: posts big blind 600
*** HOLE CARDS ***
giftmyra: folds 
vip_1985Z: folds 
ratitoBR: raises 600 to 1200
sanatamaria: folds 
PIUlimeira: folds 
Uncalled bet (600) returned to ratitoBR
ratitoBR collected 2250 from pot
ratitoBR: doesn't show hand 
*** SUMMARY ***
Total pot 2250 | Rake 0 
Seat 1: sanatamaria (small blind) folded before Flop
Seat 2: PIUlimeira (big blind) folded before Flop
Seat 3: giftmyra folded before Flop (didn't bet)
Seat 4: vip_1985Z folded before Flop (didn't bet)
Seat 6: ratitoBR (button) collected (2250)

PokerStars Hand #251209614731: Tournament #3769361908, $52.38+$2.62 USD Hold'em No Limit - Level XII (300/600) - 2024/06/26 22:36:32 UTC [2024/06/26 18:36:32 ET]
Table '3769361908 13' 6-max Seat #1 is the button
Seat 1: sanatamaria (22305 in chips) 
Seat 2: PIUlimeira (7850 in chips) 
Seat 3: giftmyra (13149 in chips) 
Seat 4: vip_1985Z (6094 in chips) 
Seat 6: ratitoBR (19846 in chips) 
sanatamaria: posts the ante 150
PIUlimeira: posts the ante 150
giftmyra: posts the ante 150
vip_1985Z: posts the ante 150
ratitoBR: posts the ante 150
PIUlimeira: posts small blind 300
giftmyra: posts big blind 600
*** HOLE CARDS ***
vip_1985Z: folds 
ratitoBR: folds 
sanatamaria: folds 
PIUlimeira: raises 7100 to 7700 and is all-in
giftmyra: folds 
Uncalled bet (7100) returned to PIUlimeira
PIUlimeira collected 1950 from pot
*** SUMMARY ***
Total pot 1950 | Rake 0 
Seat 1: sanatamaria (button) folded before Flop (didn't bet)
Seat 2: PIUlimeira (small blind) collected (1950)
Seat 3: giftmyra (big blind) folded before Flop
Seat 4: vip_1985Z folded before Flop (didn't bet)
Seat 6: ratitoBR folded before Flop (didn't bet)

PokerStars Hand #251209619887: Tournament #3769361908, $52.38+$2.62 USD Hold'em No Limit - Level XII (300/600) - 2024/06/26 22:36:52 UTC [2024/06/26 18:36:52 ET]
Table '3769361908 13' 6-max Seat #2 is the button
Seat 1: sanatamaria (22155 in chips) 
Seat 2: PIUlimeira (9050 in chips) 
Seat 3: giftmyra (12399 in chips) 
Seat 4: vip_1985Z (5944 in chips) 
Seat 6: ratitoBR (19696 in chips) 
sanatamaria: posts the ante 150
PIUlimeira: posts the ante 150
giftmyra: posts the ante 150
vip_1985Z: posts the ante 150
ratitoBR: posts the ante 150
giftmyra: posts small blind 300
vip_1985Z: posts big blind 600
*** HOLE CARDS ***
ratitoBR: raises 900 to 1500
sanatamaria: folds 
PIUlimeira: folds 
leocir25 is disconnected 
giftmyra: folds 
vip_1985Z: folds 
Uncalled bet (900) returned to ratitoBR
ratitoBR collected 2250 from pot
ratitoBR: doesn't show hand 
*** SUMMARY ***
Total pot 2250 | Rake 0 
Seat 1: sanatamaria folded before Flop (didn't bet)
Seat 2: PIUlimeira (button) folded before Flop (didn't bet)
Seat 3: giftmyra (small blind) folded before Flop
Seat 4: vip_1985Z (big blind) folded before Flop
Seat 6: ratitoBR collected (2250)

PokerStars Hand #251209626125: Tournament #3769361908, $52.38+$2.62 USD Hold'em No Limit - Level XII (300/600) - 2024/06/26 22:37:15 UTC [2024/06/26 18:37:15 ET]
Table '3769361908 13' 6-max Seat #3 is the button
Seat 1: sanatamaria (22005 in chips) 
Seat 2: PIUlimeira (8900 in chips) 
Seat 3: giftmyra (11949 in chips) 
Seat 4: vip_1985Z (5194 in chips) 
Seat 5: leocir25 (10000 in chips) 
Seat 6: ratitoBR (21196 in chips) 
sanatamaria: posts the ante 150
PIUlimeira: posts the ante 150
giftmyra: posts the ante 150
vip_1985Z: posts the ante 150
leocir25: posts the ante 150
ratitoBR: posts the ante 150
vip_1985Z: posts small blind 300
leocir25: posts big blind 600
*** HOLE CARDS ***
ratitoBR: raises 600 to 1200
sanatamaria: folds 
PIUlimeira: folds 
giftmyra: folds 
vip_1985Z: folds 
leocir25: calls 600
*** FLOP *** [Qs 4s 9s]
leocir25: checks 
ratitoBR: bets 1100
leocir25: calls 1100
*** TURN *** [Qs 4s 9s] [Jh]
leocir25: checks 
ratitoBR: bets 2800
leocir25: calls 2800
*** RIVER *** [Qs 4s 9s Jh] [7d]
leocir25: checks 
ratitoBR: checks 
*** SHOW DOWN ***
leocir25: shows [9c Qh] (two pair, Queens and Nines)
ratitoBR: mucks hand 
leocir25 collected 11400 from pot
*** SUMMARY ***
Total pot 11400 | Rake 0 
Board [Qs 4s 9s Jh 7d]
Seat 1: sanatamaria folded before Flop (didn't bet)
Seat 2: PIUlimeira folded before Flop (didn't bet)
Seat 3: giftmyra (button) folded before Flop (didn't bet)
Seat 4: vip_1985Z (small blind) folded before Flop
Seat 5: leocir25 (big blind) showed [9c Qh] and won (11400) with two pair, Queens and Nines
Seat 6: ratitoBR mucked

PokerStars Hand #251209653112: Tournament #3769361908, $52.38+$2.62 USD Hold'em No Limit - Level XIII (400/800) - 2024/06/26 22:38:55 UTC [2024/06/26 18:38:55 ET]
Table '3769361908 13' 6-max Seat #4 is the button
Seat 1: sanatamaria (21855 in chips) 
Seat 2: PIUlimeira (8750 in chips) 
Seat 3: giftmyra (11799 in chips) 
Seat 4: vip_1985Z (4744 in chips) 
Seat 5: leocir25 (16150 in chips) 
Seat 6: ratitoBR (15946 in chips) 
sanatamaria: posts the ante 200
PIUlimeira: posts the ante 200
giftmyra: posts the ante 200
vip_1985Z: posts the ante 200
leocir25: posts the ante 200
ratitoBR: posts the ante 200
leocir25: posts small blind 400
ratitoBR: posts big blind 800
*** HOLE CARDS ***
sanatamaria: folds 
PIUlimeira: folds 
giftmyra: folds 
vip_1985Z: folds 
leocir25: calls 400
ratitoBR: checks 
*** FLOP *** [5s Qc Kc]
leocir25: bets 2328
ratitoBR: calls 2328
*** TURN *** [5s Qc Kc] [Kh]
leocir25: bets 3728
ratitoBR: calls 3728
*** RIVER *** [5s Qc Kc Kh] [3h]
leocir25: bets 9094 and is all-in
ratitoBR: calls 8890 and is all-in
Uncalled bet (204) returned to leocir25
*** SHOW DOWN ***
leocir25: shows [Tc Ks] (three of a kind, Kings)
ratitoBR: shows [Jc Qs] (two pair, Kings and Queens)
leocir25 collected 32692 from pot
ratitoBR finished the tournament
*** SUMMARY ***
Total pot 32692 | Rake 0 
Board [5s Qc Kc Kh 3h]
Seat 1: sanatamaria folded before Flop (didn't bet)
Seat 2: PIUlimeira folded before Flop (didn't bet)
Seat 3: giftmyra folded before Flop (didn't bet)
Seat 4: vip_1985Z (button) folded before Flop (didn't bet)
Seat 5: leocir25 (small blind) showed [Tc Ks] and won (32692) with three of a kind, Kings
Seat 6: ratitoBR (big blind) showed [Jc Qs] and lost with two pair, Kings and Queens

PokerStars Hand #251209676767: Tournament #3769361908, $52.38+$2.62 USD Hold'em No Limit - Level XIII (400/800) - 2024/06/26 22:40:25 UTC [2024/06/26 18:40:25 ET]
Table '3769361908 13' 6-max Seat #5 is the button
Seat 1: sanatamaria (21655 in chips) 
Seat 2: PIUlimeira (8550 in chips) 
Seat 3: giftmyra (11599 in chips) 
Seat 4: vip_1985Z (4544 in chips) 
Seat 5: leocir25 (32896 in chips) 
sanatamaria: posts the ante 200
PIUlimeira: posts the ante 200
giftmyra: posts the ante 200
vip_1985Z: posts the ante 200
leocir25: posts the ante 200
sanatamaria: posts small blind 400
PIUlimeira: posts big blind 800
*** HOLE CARDS ***
vavan199212 is disconnected 
giftmyra: folds 
vip_1985Z: raises 3544 to 4344 and is all-in
leocir25: folds 
sanatamaria: raises 3544 to 7888
PIUlimeira: folds 
Uncalled bet (3544) returned to sanatamaria
*** FLOP *** [Kh Tc 2h]
*** TURN *** [Kh Tc 2h] [8c]
*** RIVER *** [Kh Tc 2h 8c] [5s]
*** SHOW DOWN ***
sanatamaria: shows [Kd Ks] (three of a kind, Kings)
vip_1985Z: shows [As Qs] (high card Ace)
sanatamaria collected 10488 from pot
vip_1985Z finished the tournament
*** SUMMARY ***
Total pot 10488 | Rake 0 
Board [Kh Tc 2h 8c 5s]
Seat 1: sanatamaria (small blind) showed [Kd Ks] and won (10488) with three of a kind, Kings
Seat 2: PIUlimeira (big blind) folded before Flop
Seat 3: giftmyra folded before Flop (didn't bet)
Seat 4: vip_1985Z showed [As Qs] and lost with high card Ace
Seat 5: leocir25 (button) folded before Flop (didn't bet)

PokerStars Hand #251209687836: Tournament #3769361908, $52.38+$2.62 USD Hold'em No Limit - Level XIII (400/800) - 2024/06/26 22:41:07 UTC [2024/06/26 18:41:07 ET]
Table '3769361908 13' 6-max Seat #1 is the button
Seat 1: sanatamaria (27599 in chips) 
Seat 2: PIUlimeira (7550 in chips) 
Seat 3: giftmyra (11399 in chips) 
Seat 5: leocir25 (32696 in chips) 
Seat 6: vavan199212 (10000 in chips) 
sanatamaria: posts the ante 200
PIUlimeira: posts the ante 200
giftmyra: posts the ante 200
leocir25: posts the ante 200
vavan199212: posts the ante 200
PIUlimeira: posts small blind 400
giftmyra: posts big blind 800
*** HOLE CARDS ***
leocir25: raises 800 to 1600
vavan199212: folds 
sanatamaria: folds 
PIUlimeira: folds 
giftmyra: calls 800
*** FLOP *** [Ad 8c Th]
giftmyra: checks 
leocir25: bets 1152
giftmyra: raises 2278 to 3430
leocir25: raises 22962 to 26392
giftmyra: calls 6169 and is all-in
Uncalled bet (16793) returned to leocir25
*** TURN *** [Ad 8c Th] [5c]
*** RIVER *** [Ad 8c Th 5c] [3s]
*** SHOW DOWN ***
giftmyra: shows [7c 9s] (high card Ace)
leocir25: shows [Qh Qc] (a pair of Queens)
leocir25 collected 23798 from pot
giftmyra finished the tournament
Gsmith13 is disconnected 
*** SUMMARY ***
Total pot 23798 | Rake 0 
Board [Ad 8c Th 5c 3s]
Seat 1: sanatamaria (button) folded before Flop (didn't bet)
Seat 2: PIUlimeira (small blind) folded before Flop
Seat 3: giftmyra (big blind) showed [7c 9s] and lost with high card Ace
Seat 5: leocir25 showed [Qh Qc] and won (23798) with a pair of Queens
Seat 6: vavan199212 folded before Flop (didn't bet)

PokerStars Hand #251209702939: Tournament #3769361908, $52.38+$2.62 USD Hold'em No Limit - Level XIV (500/1000) - 2024/06/26 22:42:06 UTC [2024/06/26 18:42:06 ET]
Table '3769361908 13' 6-max Seat #2 is the button
Seat 1: sanatamaria (27399 in chips) 
Seat 2: PIUlimeira (6950 in chips) 
Seat 3: jessecesar (25205 in chips) out of hand (moved from another table into small blind)
Seat 4: Gsmith13 (7650 in chips) out of hand (moved from another table into small blind)
Seat 5: leocir25 (45095 in chips) 
Seat 6: vavan199212 (9800 in chips) 
jessecesar will be allowed to play after the button
Gsmith13 will be allowed to play after the button
sanatamaria: posts the ante 250
PIUlimeira: posts the ante 250
leocir25: posts the ante 250
vavan199212: posts the ante 250
leocir25: posts small blind 500
vavan199212: posts big blind 1000
*** HOLE CARDS ***
sanatamaria: folds 
PIUlimeira: raises 5700 to 6700 and is all-in
leocir25: raises 5700 to 12400
vavan199212: folds 
Uncalled bet (5700) returned to leocir25
*** FLOP *** [9h Ts 3d]
*** TURN *** [9h Ts 3d] [Jh]
*** RIVER *** [9h Ts 3d Jh] [7s]
*** SHOW DOWN ***
leocir25: shows [Kc Jd] (a pair of Jacks)
PIUlimeira: shows [Kh 7d] (a pair of Sevens)
leocir25 collected 15400 from pot
PIUlimeira finished the tournament
*** SUMMARY ***
Total pot 15400 | Rake 0 
Board [9h Ts 3d Jh 7s]
Seat 1: sanatamaria folded before Flop (didn't bet)
Seat 2: PIUlimeira (button) showed [Kh 7d] and lost with a pair of Sevens
Seat 5: leocir25 (small blind) showed [Kc Jd] and won (15400) with a pair of Jacks
Seat 6: vavan199212 (big blind) folded before Flop

PokerStars Hand #251209709534: Tournament #3769361908, $52.38+$2.62 USD Hold'em No Limit - Level XIV (500/1000) - 2024/06/26 22:42:31 UTC [2024/06/26 18:42:31 ET]
Table '3769361908 13' 6-max Seat #5 is the button
Seat 1: sanatamaria (27149 in chips) 
Seat 3: jessecesar (25205 in chips) 
Seat 4: Gsmith13 (7650 in chips) 
Seat 5: leocir25 (53545 in chips) 
Seat 6: vavan199212 (8550 in chips) 
sanatamaria: posts the ante 250
jessecesar: posts the ante 250
Gsmith13: posts the ante 250
leocir25: posts the ante 250
vavan199212: posts the ante 250
vavan199212: posts small blind 500
sanatamaria: posts big blind 1000
*** HOLE CARDS ***
jessecesar: folds 
Gsmith13: raises 6400 to 7400 and is all-in
tom6969222 is disconnected 
leocir25: folds 
vavan199212: folds 
sanatamaria: calls 6400
*** FLOP *** [4s 9d Qd]
*** TURN *** [4s 9d Qd] [8c]
*** RIVER *** [4s 9d Qd 8c] [Td]
*** SHOW DOWN ***
sanatamaria: shows [Th Kd] (a pair of Tens)
Gsmith13: shows [Ks 7s] (high card King)
sanatamaria collected 16550 from pot
Gsmith13 finished the tournament
*** SUMMARY ***
Total pot 16550 | Rake 0 
Board [4s 9d Qd 8c Td]
Seat 1: sanatamaria (big blind) showed [Th Kd] and won (16550) with a pair of Tens
Seat 3: jessecesar folded before Flop (didn't bet)
Seat 4: Gsmith13 showed [Ks 7s] and lost with high card King
Seat 5: leocir25 (button) folded before Flop (didn't bet)
Seat 6: vavan199212 (small blind) folded before Flop

PokerStars Hand #251209716783: Tournament #3769361908, $52.38+$2.62 USD Hold'em No Limit - Level XIV (500/1000) - 2024/06/26 22:42:59 UTC [2024/06/26 18:42:59 ET]
Table '3769361908 13' 6-max Seat #6 is the button
Seat 1: sanatamaria (36049 in chips) 
Seat 2: tom6969222 (10000 in chips) 
Seat 3: jessecesar (24955 in chips) 
Seat 5: leocir25 (53295 in chips) 
Seat 6: vavan199212 (7800 in chips) 
sanatamaria: posts the ante 250
tom6969222: posts the ante 250
jessecesar: posts the ante 250
leocir25: posts the ante 250
vavan199212: posts the ante 250
sanatamaria: posts small blind 500
tom6969222: posts big blind 1000
*** HOLE CARDS ***
jessecesar: folds 
leocir25: folds 
vavan199212: folds 
sanatamaria: folds 
Uncalled bet (500) returned to tom6969222
tom6969222 collected 2250 from pot
tom6969222: doesn't show hand 
*** SUMMARY ***
Total pot 2250 | Rake 0 
Seat 1: sanatamaria (small blind) folded before Flop
Seat 2: tom6969222 (big blind) collected (2250)
Seat 3: jessecesar folded before Flop (didn't bet)
Seat 5: leocir25 folded before Flop (didn't bet)
Seat 6: vavan199212 (button) folded before Flop (didn't bet)

PokerStars Hand #251209719026: Tournament #3769361908, $52.38+$2.62 USD Hold'em No Limit - Level XIV (500/1000) - 2024/06/26 22:43:08 UTC [2024/06/26 18:43:08 ET]
Table '3769361908 13' 6-max Seat #1 is the button
Seat 1: sanatamaria (35299 in chips) 
Seat 2: tom6969222 (11500 in chips) 
Seat 3: jessecesar (24705 in chips) 
Seat 5: leocir25 (53045 in chips) 
Seat 6: vavan199212 (7550 in chips) 
sanatamaria: posts the ante 250
tom6969222: posts the ante 250
jessecesar: posts the ante 250
leocir25: posts the ante 250
vavan199212: posts the ante 250
tom6969222: posts small blind 500
jessecesar: posts big blind 1000
*** HOLE CARDS ***
leocir25: folds 
vavan199212: folds 
sanatamaria: folds 
tom6969222: folds 
Uncalled bet (500) returned to jessecesar
jessecesar collected 2250 from pot
jessecesar: doesn't show hand 
*** SUMMARY ***
Total pot 2250 | Rake 0 
Seat 1: sanatamaria (button) folded before Flop (didn't bet)
Seat 2: tom6969222 (small blind) folded before Flop
Seat 3: jessecesar (big blind) collected (2250)
Seat 5: leocir25 folded before Flop (didn't bet)
Seat 6: vavan199212 folded before Flop (didn't bet)

PokerStars Hand #251209721426: Tournament #3769361908, $52.38+$2.62 USD Hold'em No Limit - Level XIV (500/1000) - 2024/06/26 22:43:17 UTC [2024/06/26 18:43:17 ET]
Table '3769361908 13' 6-max Seat #2 is the button
Seat 1: sanatamaria (35049 in chips) 
Seat 2: tom6969222 (10750 in chips) 
Seat 3: jessecesar (26205 in chips) 
Seat 5: leocir25 (52795 in chips) 
Seat 6: vavan199212 (7300 in chips) 
sanatamaria: posts the ante 250
tom6969222: posts the ante 250
jessecesar: posts the ante 250
leocir25: posts the ante 250
vavan199212: posts the ante 250
jessecesar: posts small blind 500
leocir25: posts big blind 1000
*** HOLE CARDS ***
vavan199212: raises 6050 to 7050 and is all-in
sanatamaria: folds 
tom6969222: folds 
jessecesar: folds 
leocir25: folds 
Uncalled bet (6050) returned to vavan199212
vavan199212 collected 3750 from pot
vavan199212: doesn't show hand 
*** SUMMARY ***
Total pot 3750 | Rake 0 
Seat 1: sanatamaria folded before Flop (didn't bet)
Seat 2: tom6969222 (button) folded before Flop (didn't bet)
Seat 3: jessecesar (small blind) folded before Flop
Seat 5: leocir25 (big blind) folded before Flop
Seat 6: vavan199212 collected (3750)

PokerStars Hand #251209729286: Tournament #3769361908, $52.38+$2.62 USD Hold'em No Limit - Level XIV (500/1000) - 2024/06/26 22:43:48 UTC [2024/06/26 18:43:48 ET]
Table '3769361908 13' 6-max Seat #3 is the button
Seat 1: sanatamaria (34799 in chips) 
Seat 2: tom6969222 (10500 in chips) 
Seat 3: jessecesar (25455 in chips) 
Seat 5: leocir25 (51545 in chips) 
Seat 6: vavan199212 (9800 in chips) 
sanatamaria: posts the ante 250
tom6969222: posts the ante 250
jessecesar: posts the ante 250
leocir25: posts the ante 250
vavan199212: posts the ante 250
leocir25: posts small blind 500
vavan199212: posts big blind 1000
*** HOLE CARDS ***
sanatamaria: folds 
tom6969222: folds 
jessecesar: folds 
DarkSkies21 is disconnected 
leocir25: calls 500
vavan199212: checks 
*** FLOP *** [Qc Ac 7d]
leocir25: bets 2000
vavan199212: folds 
Uncalled bet (2000) returned to leocir25
leocir25 collected 3250 from pot
*** SUMMARY ***
Total pot 3250 | Rake 0 
Board [Qc Ac 7d]
Seat 1: sanatamaria folded before Flop (didn't bet)
Seat 2: tom6969222 folded before Flop (didn't bet)
Seat 3: jessecesar (button) folded before Flop (didn't bet)
Seat 5: leocir25 (small blind) collected (3250)
Seat 6: vavan199212 (big blind) folded on the Flop

PokerStars Hand #251209736012: Tournament #3769361908, $52.38+$2.62 USD Hold'em No Limit - Level XV (600/1200) - 2024/06/26 22:44:14 UTC [2024/06/26 18:44:14 ET]
Table '3769361908 13' 6-max Seat #5 is the button
Seat 1: sanatamaria (34549 in chips) 
Seat 2: tom6969222 (10250 in chips) 
Seat 3: jessecesar (25205 in chips) 
Seat 4: DarkSkies21 (26834 in chips) 
Seat 5: leocir25 (53545 in chips) 
Seat 6: vavan199212 (8550 in chips) 
sanatamaria: posts the ante 300
tom6969222: posts the ante 300
jessecesar: posts the ante 300
DarkSkies21: posts the ante 300
leocir25: posts the ante 300
vavan199212: posts the ante 300
vavan199212: posts small blind 600
sanatamaria: posts big blind 1200
*** HOLE CARDS ***
tom6969222: folds 
jessecesar: folds 
DarkSkies21: folds 
leocir25: raises 1200 to 2400
vavan199212: raises 5850 to 8250 and is all-in
sanatamaria: folds 
leocir25: calls 5850
*** FLOP *** [Jh 6d Th]
*** TURN *** [Jh 6d Th] [Ts]
*** RIVER *** [Jh 6d Th Ts] [4s]
*** SHOW DOWN ***
vavan199212: shows [9c Ah] (a pair of Tens)
leocir25: shows [Tc Js] (a full house, Tens full of Jacks)
leocir25 collected 19500 from pot
vavan199212 finished the tournament
teamcucha10 is disconnected 
*** SUMMARY ***
Total pot 19500 | Rake 0 
Board [Jh 6d Th Ts 4s]
Seat 1: sanatamaria (big blind) folded before Flop
Seat 2: tom6969222 folded before Flop (didn't bet)
Seat 3: jessecesar folded before Flop (didn't bet)
Seat 4: DarkSkies21 folded before Flop (didn't bet)
Seat 5: leocir25 (button) showed [Tc Js] and won (19500) with a full house, Tens full of Jacks
Seat 6: vavan199212 (small blind) showed [9c Ah] and lost with a pair of Tens

PokerStars Hand #251209744139: Tournament #3769361908, $52.38+$2.62 USD Hold'em No Limit - Level XV (600/1200) - 2024/06/26 22:44:46 UTC [2024/06/26 18:44:46 ET]
Table '3769361908 13' 6-max Seat #1 is the button
Seat 1: sanatamaria (33049 in chips) 
Seat 2: tom6969222 (9950 in chips) 
Seat 3: jessecesar (24905 in chips) 
Seat 4: DarkSkies21 (26534 in chips) 
Seat 5: leocir25 (64495 in chips) 
Seat 6: teamcucha10 (29564 in chips) 
sanatamaria: posts the ante 300
tom6969222: posts the ante 300
jessecesar: posts the ante 300
DarkSkies21: posts the ante 300
leocir25: posts the ante 300
teamcucha10: posts the ante 300
tom6969222: posts small blind 600
jessecesar: posts big blind 1200
*** HOLE CARDS ***
DarkSkies21: folds 
leocir25: folds 
teamcucha10: folds 
sanatamaria: folds 
tom6969222: raises 8450 to 9650 and is all-in
jessecesar: folds 
Uncalled bet (8450) returned to tom6969222
tom6969222 collected 4200 from pot
tom6969222: doesn't show hand 
*** SUMMARY ***
Total pot 4200 | Rake 0 
Seat 1: sanatamaria (button) folded before Flop (didn't bet)
Seat 2: tom6969222 (small blind) collected (4200)
Seat 3: jessecesar (big blind) folded before Flop
Seat 4: DarkSkies21 folded before Flop (didn't bet)
Seat 5: leocir25 folded before Flop (didn't bet)
Seat 6: teamcucha10 folded before Flop (didn't bet)

PokerStars Hand #251209753367: Tournament #3769361908, $52.38+$2.62 USD Hold'em No Limit - Level XV (600/1200) - 2024/06/26 22:45:22 UTC [2024/06/26 18:45:22 ET]
Table '3769361908 13' 6-max Seat #2 is the button
Seat 1: sanatamaria (32749 in chips) 
Seat 2: tom6969222 (12650 in chips) 
Seat 3: jessecesar (23405 in chips) 
Seat 4: DarkSkies21 (26234 in chips) 
Seat 5: leocir25 (64195 in chips) 
Seat 6: teamcucha10 (29264 in chips) 
sanatamaria: posts the ante 300
tom6969222: posts the ante 300
jessecesar: posts the ante 300
DarkSkies21: posts the ante 300
leocir25: posts the ante 300
teamcucha10: posts the ante 300
jessecesar: posts small blind 600
DarkSkies21: posts big blind 1200
*** HOLE CARDS ***
leocir25: folds 
teamcucha10: folds 
sanatamaria: folds 
tom6969222: raises 2400 to 3600
jessecesar: folds 
DarkSkies21: folds 
Uncalled bet (2400) returned to tom6969222
tom6969222 collected 4800 from pot
tom6969222: doesn't show hand 
*** SUMMARY ***
Total pot 4800 | Rake 0 
Seat 1: sanatamaria folded before Flop (didn't bet)
Seat 2: tom6969222 (button) collected (4800)
Seat 3: jessecesar (small blind) folded before Flop
Seat 4: DarkSkies21 (big blind) folded before Flop
Seat 5: leocir25 folded before Flop (didn't bet)
Seat 6: teamcucha10 folded before Flop (didn't bet)

PokerStars Hand #251209762270: Tournament #3769361908, $52.38+$2.62 USD Hold'em No Limit - Level XV (600/1200) - 2024/06/26 22:45:56 UTC [2024/06/26 18:45:56 ET]
Table '3769361908 13' 6-max Seat #3 is the button
Seat 1: sanatamaria (32449 in chips) 
Seat 2: tom6969222 (15950 in chips) 
Seat 3: jessecesar (22505 in chips) 
Seat 4: DarkSkies21 (24734 in chips) 
Seat 5: leocir25 (63895 in chips) 
Seat 6: teamcucha10 (28964 in chips) 
sanatamaria: posts the ante 300
tom6969222: posts the ante 300
jessecesar: posts the ante 300
DarkSkies21: posts the ante 300
leocir25: posts the ante 300
teamcucha10: posts the ante 300
DarkSkies21: posts small blind 600
leocir25: posts big blind 1200
*** HOLE CARDS ***
teamcucha10: folds 
sanatamaria: folds 
tom6969222: raises 2400 to 3600
jessecesar: folds 
DarkSkies21: folds 
leocir25: folds 
Uncalled bet (2400) returned to tom6969222
tom6969222 collected 4800 from pot
tom6969222: doesn't show hand 
*** SUMMARY ***
Total pot 4800 | Rake 0 
Seat 1: sanatamaria folded before Flop (didn't bet)
Seat 2: tom6969222 collected (4800)
Seat 3: jessecesar (button) folded before Flop (didn't bet)
Seat 4: DarkSkies21 (small blind) folded before Flop
Seat 5: leocir25 (big blind) folded before Flop
Seat 6: teamcucha10 folded before Flop (didn't bet)

PokerStars Hand #251209770409: Tournament #3769361908, $52.38+$2.62 USD Hold'em No Limit - Level XV (600/1200) - 2024/06/26 22:46:28 UTC [2024/06/26 18:46:28 ET]
Table '3769361908 13' 6-max Seat #4 is the button
Seat 1: sanatamaria (32149 in chips) 
Seat 2: tom6969222 (19250 in chips) 
Seat 3: jessecesar (22205 in chips) 
Seat 4: DarkSkies21 (23834 in chips) 
Seat 5: leocir25 (62395 in chips) 
Seat 6: teamcucha10 (28664 in chips) 
sanatamaria: posts the ante 300
tom6969222: posts the ante 300
jessecesar: posts the ante 300
DarkSkies21: posts the ante 300
leocir25: posts the ante 300
teamcucha10: posts the ante 300
leocir25: posts small blind 600
teamcucha10: posts big blind 1200
*** HOLE CARDS ***
sanatamaria: folds 
tom6969222: folds 
jessecesar: folds 
DarkSkies21: folds 
leocir25: calls 600
teamcucha10: checks 
*** FLOP *** [8s 9d 3c]
leocir25: checks 
teamcucha10: bets 1200
leocir25: calls 1200
*** TURN *** [8s 9d 3c] [5h]
leocir25: checks 
teamcucha10: bets 3600
leocir25: calls 3600
*** RIVER *** [8s 9d 3c 5h] [4h]
leocir25: checks 
teamcucha10: bets 11550
leocir25: folds 
Uncalled bet (11550) returned to teamcucha10
teamcucha10 collected 13800 from pot
teamcucha10: doesn't show hand 
*** SUMMARY ***
Total pot 13800 | Rake 0 
Board [8s 9d 3c 5h 4h]
Seat 1: sanatamaria folded before Flop (didn't bet)
Seat 2: tom6969222 folded before Flop (didn't bet)
Seat 3: jessecesar folded before Flop (didn't bet)
Seat 4: DarkSkies21 (button) folded before Flop (didn't bet)
Seat 5: leocir25 (small blind) folded on the River
Seat 6: teamcucha10 (big blind) collected (13800)

PokerStars Hand #251209801230: Tournament #3769361908, $52.38+$2.62 USD Hold'em No Limit - Level XVI (800/1600) - 2024/06/26 22:48:29 UTC [2024/06/26 18:48:29 ET]
Table '3769361908 13' 6-max Seat #5 is the button
Seat 1: sanatamaria (31849 in chips) 
Seat 2: tom6969222 (18950 in chips) 
Seat 3: jessecesar (21905 in chips) 
Seat 4: DarkSkies21 (23534 in chips) 
Seat 5: leocir25 (56095 in chips) 
Seat 6: teamcucha10 (36164 in chips) 
sanatamaria: posts the ante 400
tom6969222: posts the ante 400
jessecesar: posts the ante 400
DarkSkies21: posts the ante 400
leocir25: posts the ante 400
teamcucha10: posts the ante 400
teamcucha10: posts small blind 800
sanatamaria: posts big blind 1600
*** HOLE CARDS ***
tom6969222: folds 
jessecesar: folds 
DarkSkies21: folds 
leocir25: raises 1600 to 3200
teamcucha10: folds 
sanatamaria: folds 
Uncalled bet (1600) returned to leocir25
leocir25 collected 6400 from pot
*** SUMMARY ***
Total pot 6400 | Rake 0 
Seat 1: sanatamaria (big blind) folded before Flop
Seat 2: tom6969222 folded before Flop (didn't bet)
Seat 3: jessecesar folded before Flop (didn't bet)
Seat 4: DarkSkies21 folded before Flop (didn't bet)
Seat 5: leocir25 (button) collected (6400)
Seat 6: teamcucha10 (small blind) folded before Flop

PokerStars Hand #251209814161: Tournament #3769361908, $52.38+$2.62 USD Hold'em No Limit - Level XVI (800/1600) - 2024/06/26 22:49:21 UTC [2024/06/26 18:49:21 ET]
Table '3769361908 13' 6-max Seat #6 is the button
Seat 1: sanatamaria (29849 in chips) 
Seat 2: tom6969222 (18550 in chips) 
Seat 3: jessecesar (21505 in chips) 
Seat 4: DarkSkies21 (23134 in chips) 
Seat 5: leocir25 (60495 in chips) 
Seat 6: teamcucha10 (34964 in chips) 
sanatamaria: posts the ante 400
tom6969222: posts the ante 400
jessecesar: posts the ante 400
DarkSkies21: posts the ante 400
leocir25: posts the ante 400
teamcucha10: posts the ante 400
sanatamaria: posts small blind 800
tom6969222: posts big blind 1600
*** HOLE CARDS ***
jessecesar: folds 
DarkSkies21: folds 
leocir25: folds 
teamcucha10: raises 32964 to 34564 and is all-in
sanatamaria: folds 
tom6969222: calls 16550 and is all-in
Uncalled bet (16414) returned to teamcucha10
*** FLOP *** [3c 5s As]
*** TURN *** [3c 5s As] [7h]
*** RIVER *** [3c 5s As 7h] [6s]
*** SHOW DOWN ***
tom6969222: shows [Kc Tc] (high card Ace)
teamcucha10: shows [Qc Kd] (high card Ace - King+Queen kicker)
teamcucha10 collected 39500 from pot
tom6969222 finished the tournament in 111th place
*** SUMMARY ***
Total pot 39500 | Rake 0 
Board [3c 5s As 7h 6s]
Seat 1: sanatamaria (small blind) folded before Flop
Seat 2: tom6969222 (big blind) showed [Kc Tc] and lost with high card Ace
Seat 3: jessecesar folded before Flop (didn't bet)
Seat 4: DarkSkies21 folded before Flop (didn't bet)
Seat 5: leocir25 folded before Flop (didn't bet)
Seat 6: teamcucha10 (button) showed [Qc Kd] and won (39500) with high card Ace

PokerStars Hand #251209824371: Tournament #3769361908, $52.38+$2.62 USD Hold'em No Limit - Level XVI (800/1600) - 2024/06/26 22:50:02 UTC [2024/06/26 18:50:02 ET]
Table '3769361908 13' 6-max Seat #1 is the button
Seat 1: sanatamaria (28649 in chips) 
Seat 3: jessecesar (21105 in chips) 
Seat 4: DarkSkies21 (22734 in chips) 
Seat 5: leocir25 (60095 in chips) 
Seat 6: teamcucha10 (55914 in chips) 
sanatamaria: posts the ante 400
jessecesar: posts the ante 400
DarkSkies21: posts the ante 400
leocir25: posts the ante 400
teamcucha10: posts the ante 400
jessecesar: posts small blind 800
DarkSkies21: posts big blind 1600
*** HOLE CARDS ***
leocir25: folds 
teamcucha10: raises 1760 to 3360
sanatamaria: folds 
jessecesar: folds 
MezuuÜuuT is disconnected 
DarkSkies21: raises 18974 to 22334 and is all-in
teamcucha10: calls 18974
*** FLOP *** [8s 5c 8h]
*** TURN *** [8s 5c 8h] [Td]
*** RIVER *** [8s 5c 8h Td] [3s]
*** SHOW DOWN ***
DarkSkies21: shows [6c 6h] (two pair, Eights and Sixes)
teamcucha10: shows [Th Tc] (a full house, Tens full of Eights)
teamcucha10 collected 47468 from pot
DarkSkies21 finished the tournament in 108th place
*** SUMMARY ***
Total pot 47468 | Rake 0 
Board [8s 5c 8h Td 3s]
Seat 1: sanatamaria (button) folded before Flop (didn't bet)
Seat 3: jessecesar (small blind) folded before Flop
Seat 4: DarkSkies21 (big blind) showed [6c 6h] and lost with two pair, Eights and Sixes
Seat 5: leocir25 folded before Flop (didn't bet)
Seat 6: teamcucha10 showed [Th Tc] and won (47468) with a full house, Tens full of Eights

PokerStars Hand #251209833374: Tournament #3769361908, $52.38+$2.62 USD Hold'em No Limit - Level XVII (1000/2000) - 2024/06/26 22:50:39 UTC [2024/06/26 18:50:39 ET]
Table '3769361908 13' 6-max Seat #3 is the button
Seat 1: sanatamaria (28249 in chips) 
Seat 2: MezuuÜuuT (12800 in chips) 
Seat 3: jessecesar (19905 in chips) 
Seat 5: leocir25 (59695 in chips) 
Seat 6: teamcucha10 (80648 in chips) 
sanatamaria: posts the ante 500
MezuuÜuuT: posts the ante 500
jessecesar: posts the ante 500
leocir25: posts the ante 500
teamcucha10: posts the ante 500
leocir25: posts small blind 1000
teamcucha10: posts big blind 2000
*** HOLE CARDS ***
sanatamaria: folds 
MezuuÜuuT: raises 10300 to 12300 and is all-in
jessecesar: folds 
leocir25: folds 
teamcucha10: folds 
Uncalled bet (10300) returned to MezuuÜuuT
MezuuÜuuT collected 7500 from pot
MezuuÜuuT: doesn't show hand 
*** SUMMARY ***
Total pot 7500 | Rake 0 
Seat 1: sanatamaria folded before Flop (didn't bet)
Seat 2: MezuuÜuuT collected (7500)
Seat 3: jessecesar (button) folded before Flop (didn't bet)
Seat 5: leocir25 (small blind) folded before Flop
Seat 6: teamcucha10 (big blind) folded before Flop

PokerStars Hand #251209843086: Tournament #3769361908, $52.38+$2.62 USD Hold'em No Limit - Level XVII (1000/2000) - 2024/06/26 22:51:19 UTC [2024/06/26 18:51:19 ET]
Table '3769361908 13' 6-max Seat #5 is the button
Seat 1: sanatamaria (27749 in chips) 
Seat 2: MezuuÜuuT (17800 in chips) 
Seat 3: jessecesar (19405 in chips) 
Seat 5: leocir25 (58195 in chips) 
Seat 6: teamcucha10 (78148 in chips) 
sanatamaria: posts the ante 500
MezuuÜuuT: posts the ante 500
jessecesar: posts the ante 500
leocir25: posts the ante 500
teamcucha10: posts the ante 500
teamcucha10: posts small blind 1000
sanatamaria: posts big blind 2000
*** HOLE CARDS ***
Muringa.SP is disconnected 
MezuuÜuuT: folds 
jessecesar: raises 16905 to 18905 and is all-in
leocir25: folds 
teamcucha10: folds 
sanatamaria: folds 
Uncalled bet (16905) returned to jessecesar
jessecesar collected 7500 from pot
jessecesar: doesn't show hand 
*** SUMMARY ***
Total pot 7500 | Rake 0 
Seat 1: sanatamaria (big blind) folded before Flop
Seat 2: MezuuÜuuT folded before Flop (didn't bet)
Seat 3: jessecesar collected (7500)
Seat 5: leocir25 (button) folded before Flop (didn't bet)
Seat 6: teamcucha10 (small blind) folded before Flop

PokerStars Hand #251209850260: Tournament #3769361908, $52.38+$2.62 USD Hold'em No Limit - Level XVII (1000/2000) - 2024/06/26 22:51:48 UTC [2024/06/26 18:51:48 ET]
Table '3769361908 13' 6-max Seat #6 is the button
Seat 1: sanatamaria (25249 in chips) 
Seat 2: MezuuÜuuT (17300 in chips) 
Seat 3: jessecesar (24405 in chips) 
Seat 4: Muringa.SP (21875 in chips) 
Seat 5: leocir25 (57695 in chips) 
Seat 6: teamcucha10 (76648 in chips) 
sanatamaria: posts the ante 500
MezuuÜuuT: posts the ante 500
jessecesar: posts the ante 500
Muringa.SP: posts the ante 500
leocir25: posts the ante 500
teamcucha10: posts the ante 500
sanatamaria: posts small blind 1000
MezuuÜuuT: posts big blind 2000
*** HOLE CARDS ***
jessecesar: folds 
Muringa.SP: folds 
leocir25: raises 2000 to 4000
teamcucha10: folds 
sanatamaria: folds 
MezuuÜuuT: calls 2000
*** FLOP *** [Td 9h Th]
MezuuÜuuT: bets 12800 and is all-in
leocir25: calls 12800
*** TURN *** [Td 9h Th] [2s]
*** RIVER *** [Td 9h Th 2s] [4d]
*** SHOW DOWN ***
MezuuÜuuT: shows [7d Jh] (a pair of Tens)
leocir25: shows [6d Ad] (a pair of Tens - Ace kicker)
leocir25 collected 37600 from pot
MezuuÜuuT finished the tournament in 95th place
*** SUMMARY ***
Total pot 37600 | Rake 0 
Board [Td 9h Th 2s 4d]
Seat 1: sanatamaria (small blind) folded before Flop
Seat 2: MezuuÜuuT (big blind) showed [7d Jh] and lost with a pair of Tens
Seat 3: jessecesar folded before Flop (didn't bet)
Seat 4: Muringa.SP folded before Flop (didn't bet)
Seat 5: leocir25 showed [6d Ad] and won (37600) with a pair of Tens
Seat 6: teamcucha10 (button) folded before Flop (didn't bet)

PokerStars Hand #251209859743: Tournament #3769361908, $52.38+$2.62 USD Hold'em No Limit - Level XVII (1000/2000) - 2024/06/26 22:52:27 UTC [2024/06/26 18:52:27 ET]
Table '3769361908 13' 6-max Seat #1 is the button
Seat 1: sanatamaria (23749 in chips) 
Seat 3: jessecesar (23905 in chips) 
Seat 4: Muringa.SP (21375 in chips) 
Seat 5: leocir25 (77995 in chips) 
Seat 6: teamcucha10 (76148 in chips) 
sanatamaria: posts the ante 500
jessecesar: posts the ante 500
Muringa.SP: posts the ante 500
leocir25: posts the ante 500
teamcucha10: posts the ante 500
jessecesar: posts small blind 1000
Muringa.SP: posts big blind 2000
*** HOLE CARDS ***
leocir25: raises 2000 to 4000
teamcucha10: folds 
podiiii is disconnected 
sanatamaria: folds 
jessecesar: folds 
Muringa.SP: calls 2000
*** FLOP *** [7d 2c 4h]
Muringa.SP: checks 
leocir25: checks 
*** TURN *** [7d 2c 4h] [Ac]
Muringa.SP: checks 
leocir25: checks 
*** RIVER *** [7d 2c 4h Ac] [Jd]
Muringa.SP: checks 
leocir25: checks 
*** SHOW DOWN ***
Muringa.SP: shows [9s Qh] (high card Ace)
leocir25: shows [3s 3h] (a pair of Threes)
leocir25 collected 11500 from pot
*** SUMMARY ***
Total pot 11500 | Rake 0 
Board [7d 2c 4h Ac Jd]
Seat 1: sanatamaria (button) folded before Flop (didn't bet)
Seat 3: jessecesar (small blind) folded before Flop
Seat 4: Muringa.SP (big blind) showed [9s Qh] and lost with high card Ace
Seat 5: leocir25 showed [3s 3h] and won (11500) with a pair of Threes
Seat 6: teamcucha10 folded before Flop (didn't bet)

PokerStars Hand #251209873515: Tournament #3769361908, $52.38+$2.62 USD Hold'em No Limit - Level XVIII (1200/2400) - 2024/06/26 22:53:23 UTC [2024/06/26 18:53:23 ET]
Table '3769361908 13' 6-max Seat #3 is the button
Seat 1: sanatamaria (23249 in chips) 
Seat 2: podiiii (29236 in chips) 
Seat 3: jessecesar (22405 in chips) 
Seat 4: Muringa.SP (16875 in chips) 
Seat 5: leocir25 (84995 in chips) 
Seat 6: teamcucha10 (75648 in chips) 
sanatamaria: posts the ante 600
podiiii: posts the ante 600
jessecesar: posts the ante 600
Muringa.SP: posts the ante 600
leocir25: posts the ante 600
teamcucha10: posts the ante 600
Muringa.SP: posts small blind 1200
leocir25: posts big blind 2400
*** HOLE CARDS ***
teamcucha10: folds 
sanatamaria: folds 
podiiii: folds 
jessecesar: folds 
Muringa.SP: raises 13875 to 16275 and is all-in
leocir25: calls 13875
*** FLOP *** [8d Qs Td]
*** TURN *** [8d Qs Td] [8h]
*** RIVER *** [8d Qs Td 8h] [3d]
*** SHOW DOWN ***
Muringa.SP: shows [4s Ts] (two pair, Tens and Eights)
leocir25: shows [Qh 9s] (two pair, Queens and Eights)
leocir25 collected 36150 from pot
Muringa.SP finished the tournament in 85th place
*** SUMMARY ***
Total pot 36150 | Rake 0 
Board [8d Qs Td 8h 3d]
Seat 1: sanatamaria folded before Flop (didn't bet)
Seat 2: podiiii folded before Flop (didn't bet)
Seat 3: jessecesar (button) folded before Flop (didn't bet)
Seat 4: Muringa.SP (small blind) showed [4s Ts] and lost with two pair, Tens and Eights
Seat 5: leocir25 (big blind) showed [Qh 9s] and won (36150) with two pair, Queens and Eights
Seat 6: teamcucha10 folded before Flop (didn't bet)


PokerStars Hand #251209502112: Tournament #3769361908, $52.38+$2.62 USD Hold'em No Limit - Level X (200/400) - 2024/06/26 22:29:37 UTC [2024/06/26 18:29:37 ET]
Table '3769361908 12' 6-max Seat #4 is the button
Seat 1: Baca4b (18647 in chips) 
Seat 2: lamer0k (4470 in chips) 
Seat 3: Tom_Poker_NL (11767 in chips) 
Seat 4: jvieiradias8 (19635 in chips) 
Seat 5: MPB2502 (5372 in chips) 
Seat 6: goshaleg (9850 in chips) 
Baca4b: posts the ante 100
lamer0k: posts the ante 100
Tom_Poker_NL: posts the ante 100
jvieiradias8: posts the ante 100
MPB2502: posts the ante 100
goshaleg: posts the ante 100
MPB2502: posts small blind 200
goshaleg: posts big blind 400
*** HOLE CARDS ***
Baca4b: raises 400 to 800
lamer0k: folds 
Tom_Poker_NL: folds 
jvieiradias8: folds 
MPB2502: raises 4472 to 5272 and is all-in
goshaleg: folds 
Baca4b: folds 
Uncalled bet (4472) returned to MPB2502
MPB2502 collected 2600 from pot
MPB2502: doesn't show hand 
*** SUMMARY ***
Total pot 2600 | Rake 0 
Seat 1: Baca4b folded before Flop
Seat 2: lamer0k folded before Flop (didn't bet)
Seat 3: Tom_Poker_NL folded before Flop (didn't bet)
Seat 4: jvieiradias8 (button) folded before Flop (didn't bet)
Seat 5: MPB2502 (small blind) collected (2600)
Seat 6: goshaleg (big blind) folded before Flop

PokerStars Hand #251209512976: Tournament #3769361908, $52.38+$2.62 USD Hold'em No Limit - Level X (200/400) - 2024/06/26 22:30:16 UTC [2024/06/26 18:30:16 ET]
Table '3769361908 12' 6-max Seat #5 is the button
Seat 1: Baca4b (17747 in chips) 
Seat 2: lamer0k (4370 in chips) 
Seat 3: Tom_Poker_NL (11667 in chips) 
Seat 4: jvieiradias8 (19535 in chips) 
Seat 5: MPB2502 (7072 in chips) 
Seat 6: goshaleg (9350 in chips) 
Baca4b: posts the ante 100
lamer0k: posts the ante 100
Tom_Poker_NL: posts the ante 100
jvieiradias8: posts the ante 100
MPB2502: posts the ante 100
goshaleg: posts the ante 100
goshaleg: posts small blind 200
Baca4b: posts big blind 400
*** HOLE CARDS ***
lamer0k: folds 
Tom_Poker_NL: raises 400 to 800
jvieiradias8: folds 
MPB2502: folds 
goshaleg: folds 
Baca4b: raises 1800 to 2600
Tom_Poker_NL: calls 1800
*** FLOP *** [Kc 3h 7d]
Baca4b: bets 1000
Tom_Poker_NL: calls 1000
*** TURN *** [Kc 3h 7d] [4c]
Baca4b: bets 2400
Tom_Poker_NL: folds 
Uncalled bet (2400) returned to Baca4b
Baca4b collected 8000 from pot
Baca4b: doesn't show hand 
*** SUMMARY ***
Total pot 8000 | Rake 0 
Board [Kc 3h 7d 4c]
Seat 1: Baca4b (big blind) collected (8000)
Seat 2: lamer0k folded before Flop (didn't bet)
Seat 3: Tom_Poker_NL folded on the Turn
Seat 4: jvieiradias8 folded before Flop (didn't bet)
Seat 5: MPB2502 (button) folded before Flop (didn't bet)
Seat 6: goshaleg (small blind) folded before Flop

PokerStars Hand #251209535856: Tournament #3769361908, $52.38+$2.62 USD Hold'em No Limit - Level X (200/400) - 2024/06/26 22:31:40 UTC [2024/06/26 18:31:40 ET]
Table '3769361908 12' 6-max Seat #6 is the button
Seat 1: Baca4b (22047 in chips) 
Seat 2: lamer0k (4270 in chips) 
Seat 3: Tom_Poker_NL (7967 in chips) 
Seat 4: jvieiradias8 (19435 in chips) 
Seat 5: MPB2502 (6972 in chips) 
Seat 6: goshaleg (9050 in chips) 
Baca4b: posts the ante 100
lamer0k: posts the ante 100
Tom_Poker_NL: posts the ante 100
jvieiradias8: posts the ante 100
MPB2502: posts the ante 100
goshaleg: posts the ante 100
Baca4b: posts small blind 200
lamer0k: posts big blind 400
*** HOLE CARDS ***
Tom_Poker_NL: folds 
jvieiradias8: raises 400 to 800
MPB2502: folds 
goshaleg: folds 
Baca4b: folds 
lamer0k: calls 400
*** FLOP *** [4s Jd Qd]
lamer0k: checks 
jvieiradias8: bets 600
lamer0k: raises 2770 to 3370 and is all-in
jvieiradias8: calls 2770
*** TURN *** [4s Jd Qd] [5d]
*** RIVER *** [4s Jd Qd 5d] [6s]
*** SHOW DOWN ***
lamer0k: shows [Kd 6d] (a flush, King high)
jvieiradias8: shows [9s Js] (a pair of Jacks)
lamer0k collected 9140 from pot
*** SUMMARY ***
Total pot 9140 | Rake 0 
Board [4s Jd Qd 5d 6s]
Seat 1: Baca4b (small blind) folded before Flop
Seat 2: lamer0k (big blind) showed [Kd 6d] and won (9140) with a flush, King high
Seat 3: Tom_Poker_NL folded before Flop (didn't bet)
Seat 4: jvieiradias8 showed [9s Js] and lost with a pair of Jacks
Seat 5: MPB2502 folded before Flop (didn't bet)
Seat 6: goshaleg (button) folded before Flop (didn't bet)

PokerStars Hand #251209558219: Tournament #3769361908, $52.38+$2.62 USD Hold'em No Limit - Level XI (250/500) - 2024/06/26 22:33:02 UTC [2024/06/26 18:33:02 ET]
Table '3769361908 12' 6-max Seat #1 is the button
Seat 1: Baca4b (21747 in chips) 
Seat 2: lamer0k (9140 in chips) 
Seat 3: Tom_Poker_NL (7867 in chips) 
Seat 4: jvieiradias8 (15165 in chips) 
Seat 5: MPB2502 (6872 in chips) 
Seat 6: goshaleg (8950 in chips) 
Baca4b: posts the ante 125
lamer0k: posts the ante 125
Tom_Poker_NL: posts the ante 125
jvieiradias8: posts the ante 125
MPB2502: posts the ante 125
goshaleg: posts the ante 125
lamer0k: posts small blind 250
Tom_Poker_NL: posts big blind 500
*** HOLE CARDS ***
jvieiradias8: raises 500 to 1000
MPB2502: folds 
goshaleg: folds 
Baca4b: folds 
lamer0k: calls 750
Tom_Poker_NL: calls 500
*** FLOP *** [Jh 3d Kh]
lamer0k: checks 
Tom_Poker_NL: checks 
jvieiradias8: bets 1240
lamer0k: calls 1240
Tom_Poker_NL: folds 
*** TURN *** [Jh 3d Kh] [Qc]
lamer0k: checks 
jvieiradias8: bets 2565
lamer0k: raises 4210 to 6775 and is all-in
jvieiradias8: calls 4210
*** RIVER *** [Jh 3d Kh Qc] [6c]
*** SHOW DOWN ***
lamer0k: shows [Qd Ah] (a pair of Queens)
jvieiradias8: shows [Kc Td] (a pair of Kings)
jvieiradias8 collected 19780 from pot
lamer0k finished the tournament
*** SUMMARY ***
Total pot 19780 | Rake 0 
Board [Jh 3d Kh Qc 6c]
Seat 1: Baca4b (button) folded before Flop (didn't bet)
Seat 2: lamer0k (small blind) showed [Qd Ah] and lost with a pair of Queens
Seat 3: Tom_Poker_NL (big blind) folded on the Flop
Seat 4: jvieiradias8 showed [Kc Td] and won (19780) with a pair of Kings
Seat 5: MPB2502 folded before Flop (didn't bet)
Seat 6: goshaleg folded before Flop (didn't bet)

PokerStars Hand #251209580694: Tournament #3769361908, $52.38+$2.62 USD Hold'em No Limit - Level XI (250/500) - 2024/06/26 22:34:25 UTC [2024/06/26 18:34:25 ET]
Table '3769361908 12' 6-max Seat #3 is the button
Seat 1: Baca4b (21622 in chips) 
Seat 3: Tom_Poker_NL (6742 in chips) 
Seat 4: jvieiradias8 (25805 in chips) 
Seat 5: MPB2502 (6747 in chips) 
Seat 6: goshaleg (8825 in chips) 
Baca4b: posts the ante 125
Tom_Poker_NL: posts the ante 125
jvieiradias8: posts the ante 125
MPB2502: posts the ante 125
goshaleg: posts the ante 125
jvieiradias8: posts small blind 250
MPB2502: posts big blind 500
*** HOLE CARDS ***
goshaleg: folds 
Baca4b: folds 
Tom_Poker_NL: folds 
jvieiradias8: raises 25180 to 25680 and is all-in
MPB2502: calls 6122 and is all-in
Uncalled bet (19058) returned to jvieiradias8
*** FLOP *** [5c Th Jd]
*** TURN *** [5c Th Jd] [Kh]
*** RIVER *** [5c Th Jd Kh] [4c]
*** SHOW DOWN ***
jvieiradias8: shows [7h Kd] (a pair of Kings)
MPB2502: shows [Qs Td] (a pair of Tens)
jvieiradias8 collected 13869 from pot
MPB2502 finished the tournament
*** SUMMARY ***
Total pot 13869 | Rake 0 
Board [5c Th Jd Kh 4c]
Seat 1: Baca4b folded before Flop (didn't bet)
Seat 3: Tom_Poker_NL (button) folded before Flop (didn't bet)
Seat 4: jvieiradias8 (small blind) showed [7h Kd] and won (13869) with a pair of Kings
Seat 5: MPB2502 (big blind) showed [Qs Td] and lost with a pair of Tens
Seat 6: goshaleg folded before Flop (didn't bet)

PokerStars Hand #251209589312: Tournament #3769361908, $52.38+$2.62 USD Hold'em No Limit - Level XI (250/500) - 2024/06/26 22:34:57 UTC [2024/06/26 18:34:57 ET]
Table '3769361908 12' 6-max Seat #4 is the button
Seat 1: Baca4b (21497 in chips) 
Seat 3: Tom_Poker_NL (6617 in chips) 
Seat 4: jvieiradias8 (32927 in chips) 
Seat 6: goshaleg (8700 in chips) 
Baca4b: posts the ante 125
Tom_Poker_NL: posts the ante 125
jvieiradias8: posts the ante 125
goshaleg: posts the ante 125
goshaleg: posts small blind 250
Baca4b: posts big blind 500
*** HOLE CARDS ***
RenALLiin is disconnected 
Tom_Poker_NL: folds 
jvieiradias8: folds 
goshaleg: folds 
Uncalled bet (250) returned to Baca4b
Baca4b collected 1000 from pot
Baca4b: doesn't show hand 
*** SUMMARY ***
Total pot 1000 | Rake 0 
Seat 1: Baca4b (big blind) collected (1000)
Seat 3: Tom_Poker_NL folded before Flop (didn't bet)
Seat 4: jvieiradias8 (button) folded before Flop (didn't bet)
Seat 6: goshaleg (small blind) folded before Flop

PokerStars Hand #251209594411: Tournament #3769361908, $52.38+$2.62 USD Hold'em No Limit - Level XII (300/600) - 2024/06/26 22:35:16 UTC [2024/06/26 18:35:16 ET]
Table '3769361908 12' 6-max Seat #6 is the button
Seat 1: Baca4b (22122 in chips) 
Seat 2: RenALLiin (13125 in chips) 
Seat 3: Tom_Poker_NL (6492 in chips) 
Seat 4: jvieiradias8 (32802 in chips) 
Seat 6: goshaleg (8325 in chips) 
Baca4b: posts the ante 150
RenALLiin: posts the ante 150
Tom_Poker_NL: posts the ante 150
jvieiradias8: posts the ante 150
goshaleg: posts the ante 150
Baca4b: posts small blind 300
RenALLiin: posts big blind 600
*** HOLE CARDS ***
Tom_Poker_NL: raises 5742 to 6342 and is all-in
jvieiradias8: raises 26310 to 32652 and is all-in
goshaleg: folds 
Baca4b: folds 
RenALLiin: folds 
Uncalled bet (26310) returned to jvieiradias8
*** FLOP *** [As 8d Jd]
*** TURN *** [As 8d Jd] [6d]
*** RIVER *** [As 8d Jd 6d] [7s]
*** SHOW DOWN ***
Tom_Poker_NL: shows [Jh Qd] (a pair of Jacks)
jvieiradias8: shows [7c 7d] (three of a kind, Sevens)
jvieiradias8 collected 14334 from pot
Tom_Poker_NL finished the tournament
*** SUMMARY ***
Total pot 14334 | Rake 0 
Board [As 8d Jd 6d 7s]
Seat 1: Baca4b (small blind) folded before Flop
Seat 2: RenALLiin (big blind) folded before Flop
Seat 3: Tom_Poker_NL showed [Jh Qd] and lost with a pair of Jacks
Seat 4: jvieiradias8 showed [7c 7d] and won (14334) with three of a kind, Sevens
Seat 6: goshaleg (button) folded before Flop (didn't bet)

PokerStars Hand #251209601707: Tournament #3769361908, $52.38+$2.62 USD Hold'em No Limit - Level XII (300/600) - 2024/06/26 22:35:43 UTC [2024/06/26 18:35:43 ET]
Table '3769361908 12' 6-max Seat #1 is the button
Seat 1: Baca4b (21672 in chips) 
Seat 2: RenALLiin (12375 in chips) 
Seat 4: jvieiradias8 (40644 in chips) 
Seat 6: goshaleg (8175 in chips) 
Baca4b: posts the ante 150
RenALLiin: posts the ante 150
jvieiradias8: posts the ante 150
goshaleg: posts the ante 150
RenALLiin: posts small blind 300
jvieiradias8: posts big blind 600
*** HOLE CARDS ***
LadyLuke2010 is disconnected 
goshaleg: folds 
Baca4b: folds 
RenALLiin: raises 11625 to 12225 and is all-in
jvieiradias8: folds 
Uncalled bet (11625) returned to RenALLiin
Scorgiej is disconnected 
RenALLiin collected 1800 from pot
RenALLiin: doesn't show hand 
*** SUMMARY ***
Total pot 1800 | Rake 0 
Seat 1: Baca4b (button) folded before Flop (didn't bet)
Seat 2: RenALLiin (small blind) collected (1800)
Seat 4: jvieiradias8 (big blind) folded before Flop
Seat 6: goshaleg folded before Flop (didn't bet)

PokerStars Hand #251209608988: Tournament #3769361908, $52.38+$2.62 USD Hold'em No Limit - Level XII (300/600) - 2024/06/26 22:36:10 UTC [2024/06/26 18:36:10 ET]
Table '3769361908 12' 6-max Seat #2 is the button
Seat 1: Baca4b (21522 in chips) 
Seat 2: RenALLiin (13425 in chips) 
Seat 3: LadyLuke2010 (5350 in chips) out of hand (moved from another table into small blind)
Seat 4: jvieiradias8 (39894 in chips) 
Seat 5: Scorgiej (9975 in chips) 
Seat 6: goshaleg (8025 in chips) 
LadyLuke2010 will be allowed to play after the button
Baca4b: posts the ante 150
RenALLiin: posts the ante 150
jvieiradias8: posts the ante 150
Scorgiej: posts the ante 150
goshaleg: posts the ante 150
jvieiradias8: posts small blind 300
Scorgiej: posts big blind 600
*** HOLE CARDS ***
goshaleg: raises 7275 to 7875 and is all-in
Baca4b: folds 
RenALLiin: folds 
jvieiradias8: folds 
Scorgiej: folds 
Uncalled bet (7275) returned to goshaleg
goshaleg collected 2250 from pot
goshaleg: doesn't show hand 
*** SUMMARY ***
Total pot 2250 | Rake 0 
Seat 1: Baca4b folded before Flop (didn't bet)
Seat 2: RenALLiin (button) folded before Flop (didn't bet)
Seat 4: jvieiradias8 (small blind) folded before Flop
Seat 5: Scorgiej (big blind) folded before Flop
Seat 6: goshaleg collected (2250)

PokerStars Hand #251209613544: Tournament #3769361908, $52.38+$2.62 USD Hold'em No Limit - Level XII (300/600) - 2024/06/26 22:36:27 UTC [2024/06/26 18:36:27 ET]
Table '3769361908 12' 6-max Seat #4 is the button
Seat 1: Baca4b (21372 in chips) 
Seat 2: RenALLiin (13275 in chips) 
Seat 3: LadyLuke2010 (5350 in chips) 
Seat 4: jvieiradias8 (39444 in chips) 
Seat 5: Scorgiej (9225 in chips) 
Seat 6: goshaleg (9525 in chips) 
Baca4b: posts the ante 150
RenALLiin: posts the ante 150
LadyLuke2010: posts the ante 150
jvieiradias8: posts the ante 150
Scorgiej: posts the ante 150
goshaleg: posts the ante 150
Scorgiej: posts small blind 300
goshaleg: posts big blind 600
*** HOLE CARDS ***
Baca4b: folds 
RenALLiin: folds 
LadyLuke2010: raises 4600 to 5200 and is all-in
jvieiradias8: folds 
Scorgiej: folds 
goshaleg: calls 4600
*** FLOP *** [9c 6c Td]
*** TURN *** [9c 6c Td] [2d]
*** RIVER *** [9c 6c Td 2d] [Ts]
*** SHOW DOWN ***
goshaleg: shows [4d 4c] (two pair, Tens and Fours)
LadyLuke2010: shows [Qh Ac] (a pair of Tens)
goshaleg collected 11600 from pot
LadyLuke2010 finished the tournament
*** SUMMARY ***
Total pot 11600 | Rake 0 
Board [9c 6c Td 2d Ts]
Seat 1: Baca4b folded before Flop (didn't bet)
Seat 2: RenALLiin folded before Flop (didn't bet)
Seat 3: LadyLuke2010 showed [Qh Ac] and lost with a pair of Tens
Seat 4: jvieiradias8 (button) folded before Flop (didn't bet)
Seat 5: Scorgiej (small blind) folded before Flop
Seat 6: goshaleg (big blind) showed [4d 4c] and won (11600) with two pair, Tens and Fours

PokerStars Hand #251209619547: Tournament #3769361908, $52.38+$2.62 USD Hold'em No Limit - Level XII (300/600) - 2024/06/26 22:36:50 UTC [2024/06/26 18:36:50 ET]
Table '3769361908 12' 6-max Seat #5 is the button
Seat 1: Baca4b (21222 in chips) 
Seat 2: RenALLiin (13125 in chips) 
Seat 4: jvieiradias8 (39294 in chips) 
Seat 5: Scorgiej (8775 in chips) 
Seat 6: goshaleg (15775 in chips) 
Baca4b: posts the ante 150
RenALLiin: posts the ante 150
jvieiradias8: posts the ante 150
Scorgiej: posts the ante 150
goshaleg: posts the ante 150
goshaleg: posts small blind 300
Baca4b: posts big blind 600
*** HOLE CARDS ***
RenALLiin: folds 
LadyLuke2010 is disconnected 
jvieiradias8: folds 
Scorgiej: raises 8025 to 8625 and is all-in
goshaleg: folds 
Baca4b: folds 
Uncalled bet (8025) returned to Scorgiej
Scorgiej collected 2250 from pot
Scorgiej: doesn't show hand 
*** SUMMARY ***
Total pot 2250 | Rake 0 
Seat 1: Baca4b (big blind) folded before Flop
Seat 2: RenALLiin folded before Flop (didn't bet)
Seat 4: jvieiradias8 folded before Flop (didn't bet)
Seat 5: Scorgiej (button) collected (2250)
Seat 6: goshaleg (small blind) folded before Flop

PokerStars Hand #251209623747: Tournament #3769361908, $52.38+$2.62 USD Hold'em No Limit - Level XII (300/600) - 2024/06/26 22:37:06 UTC [2024/06/26 18:37:06 ET]
Table '3769361908 12' 6-max Seat #6 is the button
Seat 1: Baca4b (20472 in chips) 
Seat 2: RenALLiin (12975 in chips) 
Seat 3: LadyLuke2010 (10000 in chips) 
Seat 4: jvieiradias8 (39144 in chips) 
Seat 5: Scorgiej (10275 in chips) 
Seat 6: goshaleg (15325 in chips) 
Baca4b: posts the ante 150
RenALLiin: posts the ante 150
LadyLuke2010: posts the ante 150
jvieiradias8: posts the ante 150
Scorgiej: posts the ante 150
goshaleg: posts the ante 150
Baca4b: posts small blind 300
RenALLiin: posts big blind 600
*** HOLE CARDS ***
LadyLuke2010: folds 
jvieiradias8: folds 
Scorgiej: raises 600 to 1200
goshaleg: folds 
Baca4b: folds 
RenALLiin: calls 600
*** FLOP *** [7s Ts 4d]
RenALLiin: checks 
Scorgiej: checks 
*** TURN *** [7s Ts 4d] [Jd]
RenALLiin: bets 1188
Scorgiej: calls 1188
*** RIVER *** [7s Ts 4d Jd] [2d]
RenALLiin: bets 1494
Scorgiej: calls 1494
*** SHOW DOWN ***
RenALLiin: shows [Td Qs] (a pair of Tens)
Scorgiej: mucks hand 
RenALLiin collected 8964 from pot
*** SUMMARY ***
Total pot 8964 | Rake 0 
Board [7s Ts 4d Jd 2d]
Seat 1: Baca4b (small blind) folded before Flop
Seat 2: RenALLiin (big blind) showed [Td Qs] and won (8964) with a pair of Tens
Seat 3: LadyLuke2010 folded before Flop (didn't bet)
Seat 4: jvieiradias8 folded before Flop (didn't bet)
Seat 5: Scorgiej mucked
Seat 6: goshaleg (button) folded before Flop (didn't bet)

PokerStars Hand #251209637143: Tournament #3769361908, $52.38+$2.62 USD Hold'em No Limit - Level XII (300/600) - 2024/06/26 22:37:56 UTC [2024/06/26 18:37:56 ET]
Table '3769361908 12' 6-max Seat #1 is the button
Seat 1: Baca4b (20022 in chips) 
Seat 2: RenALLiin (17907 in chips) 
Seat 3: LadyLuke2010 (9850 in chips) 
Seat 4: jvieiradias8 (38994 in chips) 
Seat 5: Scorgiej (6243 in chips) 
Seat 6: goshaleg (15175 in chips) 
Baca4b: posts the ante 150
RenALLiin: posts the ante 150
LadyLuke2010: posts the ante 150
jvieiradias8: posts the ante 150
Scorgiej: posts the ante 150
goshaleg: posts the ante 150
RenALLiin: posts small blind 300
LadyLuke2010: posts big blind 600
*** HOLE CARDS ***
jvieiradias8: folds 
Scorgiej: folds 
goshaleg: raises 600 to 1200
Baca4b: folds 
RenALLiin: raises 16557 to 17757 and is all-in
LadyLuke2010: folds 
goshaleg: folds 
Uncalled bet (16557) returned to RenALLiin
RenALLiin collected 3900 from pot
RenALLiin: doesn't show hand 
*** SUMMARY ***
Total pot 3900 | Rake 0 
Seat 1: Baca4b (button) folded before Flop (didn't bet)
Seat 2: RenALLiin (small blind) collected (3900)
Seat 3: LadyLuke2010 (big blind) folded before Flop
Seat 4: jvieiradias8 folded before Flop (didn't bet)
Seat 5: Scorgiej folded before Flop (didn't bet)
Seat 6: goshaleg folded before Flop

PokerStars Hand #251209646366: Tournament #3769361908, $52.38+$2.62 USD Hold'em No Limit - Level XIII (400/800) - 2024/06/26 22:38:30 UTC [2024/06/26 18:38:30 ET]
Table '3769361908 12' 6-max Seat #2 is the button
Seat 1: Baca4b (19872 in chips) 
Seat 2: RenALLiin (20457 in chips) 
Seat 3: LadyLuke2010 (9100 in chips) 
Seat 4: jvieiradias8 (38844 in chips) 
Seat 5: Scorgiej (6093 in chips) 
Seat 6: goshaleg (13825 in chips) 
Baca4b: posts the ante 200
RenALLiin: posts the ante 200
LadyLuke2010: posts the ante 200
jvieiradias8: posts the ante 200
Scorgiej: posts the ante 200
goshaleg: posts the ante 200
LadyLuke2010: posts small blind 400
jvieiradias8: posts big blind 800
*** HOLE CARDS ***
Scorgiej: folds 
goshaleg: calls 800
Baca4b: folds 
RenALLiin: calls 800
LadyLuke2010: calls 400
jvieiradias8: raises 4000 to 4800
goshaleg: folds 
RenALLiin: folds 
LadyLuke2010: folds 
Uncalled bet (4000) returned to jvieiradias8
jvieiradias8 collected 4400 from pot
jvieiradias8: doesn't show hand 
*** SUMMARY ***
Total pot 4400 | Rake 0 
Seat 1: Baca4b folded before Flop (didn't bet)
Seat 2: RenALLiin (button) folded before Flop
Seat 3: LadyLuke2010 (small blind) folded before Flop
Seat 4: jvieiradias8 (big blind) collected (4400)
Seat 5: Scorgiej folded before Flop (didn't bet)
Seat 6: goshaleg folded before Flop

PokerStars Hand #251209661136: Tournament #3769361908, $52.38+$2.62 USD Hold'em No Limit - Level XIII (400/800) - 2024/06/26 22:39:26 UTC [2024/06/26 18:39:26 ET]
Table '3769361908 12' 6-max Seat #4 is the button
Seat 1: Baca4b (19672 in chips) 
Seat 2: RenALLiin (19457 in chips) 
Seat 4: jvieiradias8 (42244 in chips) 
Seat 5: Scorgiej (5893 in chips) 
Seat 6: goshaleg (12825 in chips) 
Baca4b: posts the ante 200
RenALLiin: posts the ante 200
jvieiradias8: posts the ante 200
Scorgiej: posts the ante 200
goshaleg: posts the ante 200
Scorgiej: posts small blind 400
goshaleg: posts big blind 800
*** HOLE CARDS ***
Baca4b: folds 
Link_fNK is disconnected 
RenALLiin: raises 800 to 1600
jvieiradias8: calls 1600
Scorgiej: folds 
goshaleg: folds 
*** FLOP *** [3h 3s 6c]
RenALLiin: checks 
jvieiradias8: checks 
*** TURN *** [3h 3s 6c] [2c]
RenALLiin: bets 3564
jvieiradias8: calls 3564
*** RIVER *** [3h 3s 6c 2c] [Ks]
RenALLiin: bets 14093 and is all-in
jvieiradias8: folds 
Uncalled bet (14093) returned to RenALLiin
RenALLiin collected 12528 from pot
RenALLiin: doesn't show hand 
*** SUMMARY ***
Total pot 12528 | Rake 0 
Board [3h 3s 6c 2c Ks]
Seat 1: Baca4b folded before Flop (didn't bet)
Seat 2: RenALLiin collected (12528)
Seat 4: jvieiradias8 (button) folded on the River
Seat 5: Scorgiej (small blind) folded before Flop
Seat 6: goshaleg (big blind) folded before Flop

PokerStars Hand #251209678484: Tournament #3769361908, $52.38+$2.62 USD Hold'em No Limit - Level XIII (400/800) - 2024/06/26 22:40:31 UTC [2024/06/26 18:40:31 ET]
Table '3769361908 12' 6-max Seat #5 is the button
Seat 1: Baca4b (19472 in chips) 
Seat 2: RenALLiin (26621 in chips) 
Seat 3: Link_fNK (16806 in chips) 
Seat 4: jvieiradias8 (36880 in chips) 
Seat 5: Scorgiej (5293 in chips) 
Seat 6: goshaleg (11825 in chips) 
Baca4b: posts the ante 200
RenALLiin: posts the ante 200
Link_fNK: posts the ante 200
jvieiradias8: posts the ante 200
Scorgiej: posts the ante 200
goshaleg: posts the ante 200
goshaleg: posts small blind 400
Baca4b: posts big blind 800
*** HOLE CARDS ***
RenALLiin: folds 
Link_fNK: folds 
jvieiradias8: folds 
Scorgiej: folds 
goshaleg: calls 400
Baca4b: checks 
*** FLOP *** [Js 2d Td]
goshaleg: checks 
Baca4b: bets 800
goshaleg: folds 
Uncalled bet (800) returned to Baca4b
Baca4b collected 2800 from pot
Baca4b: doesn't show hand 
*** SUMMARY ***
Total pot 2800 | Rake 0 
Board [Js 2d Td]
Seat 1: Baca4b (big blind) collected (2800)
Seat 2: RenALLiin folded before Flop (didn't bet)
Seat 3: Link_fNK folded before Flop (didn't bet)
Seat 4: jvieiradias8 folded before Flop (didn't bet)
Seat 5: Scorgiej (button) folded before Flop (didn't bet)
Seat 6: goshaleg (small blind) folded on the Flop

PokerStars Hand #251209687889: Tournament #3769361908, $52.38+$2.62 USD Hold'em No Limit - Level XIII (400/800) - 2024/06/26 22:41:08 UTC [2024/06/26 18:41:08 ET]
Table '3769361908 12' 6-max Seat #6 is the button
Seat 1: Baca4b (21272 in chips) 
Seat 2: RenALLiin (26421 in chips) 
Seat 3: Link_fNK (16606 in chips) 
Seat 4: jvieiradias8 (36680 in chips) 
Seat 5: Scorgiej (5093 in chips) 
Seat 6: goshaleg (10825 in chips) 
Baca4b: posts the ante 200
RenALLiin: posts the ante 200
Link_fNK: posts the ante 200
jvieiradias8: posts the ante 200
Scorgiej: posts the ante 200
goshaleg: posts the ante 200
Baca4b: posts small blind 400
RenALLiin: posts big blind 800
*** HOLE CARDS ***
Link_fNK: folds 
jvieiradias8: raises 800 to 1600
Scorgiej: folds 
goshaleg: folds 
Baca4b: folds 
RenALLiin: calls 800
*** FLOP *** [7c Jh 8c]
RenALLiin: checks 
jvieiradias8: checks 
*** TURN *** [7c Jh 8c] [6s]
RenALLiin: checks 
jvieiradias8: checks 
*** RIVER *** [7c Jh 8c 6s] [5s]
RenALLiin: bets 2400
jvieiradias8: folds 
Uncalled bet (2400) returned to RenALLiin
RenALLiin collected 4800 from pot
RenALLiin: doesn't show hand 
*** SUMMARY ***
Total pot 4800 | Rake 0 
Board [7c Jh 8c 6s 5s]
Seat 1: Baca4b (small blind) folded before Flop
Seat 2: RenALLiin (big blind) collected (4800)
Seat 3: Link_fNK folded before Flop (didn't bet)
Seat 4: jvieiradias8 folded on the River
Seat 5: Scorgiej folded before Flop (didn't bet)
Seat 6: goshaleg (button) folded before Flop (didn't bet)

PokerStars Hand #251209708806: Tournament #3769361908, $52.38+$2.62 USD Hold'em No Limit - Level XIV (500/1000) - 2024/06/26 22:42:28 UTC [2024/06/26 18:42:28 ET]
Table '3769361908 12' 6-max Seat #1 is the button
Seat 1: Baca4b (20672 in chips) 
Seat 2: RenALLiin (29421 in chips) 
Seat 3: Link_fNK (16406 in chips) 
Seat 4: jvieiradias8 (34880 in chips) 
Seat 5: Scorgiej (4893 in chips) 
Seat 6: goshaleg (10625 in chips) 
Baca4b: posts the ante 250
RenALLiin: posts the ante 250
Link_fNK: posts the ante 250
jvieiradias8: posts the ante 250
Scorgiej: posts the ante 250
goshaleg: posts the ante 250
RenALLiin: posts small blind 500
Link_fNK: posts big blind 1000
*** HOLE CARDS ***
jvieiradias8: folds 
Scorgiej: folds 
goshaleg: raises 9375 to 10375 and is all-in
Baca4b: folds 
RenALLiin: raises 9375 to 19750
Link_fNK: calls 15156 and is all-in
Uncalled bet (3594) returned to RenALLiin
*** FLOP *** [9h 5s 5c]
*** TURN *** [9h 5s 5c] [8d]
*** RIVER *** [9h 5s 5c 8d] [Jc]
*** SHOW DOWN ***
RenALLiin: shows [Ah Qd] (a pair of Fives)
Link_fNK: shows [Qh As] (a pair of Fives)
RenALLiin collected 5781 from side pot
Link_fNK collected 5781 from side pot
goshaleg: shows [Ks 8s] (two pair, Eights and Fives)
goshaleg collected 32625 from main pot
*** SUMMARY ***
Total pot 44187 Main pot 32625. Side pot 11562. | Rake 0 
Board [9h 5s 5c 8d Jc]
Seat 1: Baca4b (button) folded before Flop (didn't bet)
Seat 2: RenALLiin (small blind) showed [Ah Qd] and won (5781) with a pair of Fives
Seat 3: Link_fNK (big blind) showed [Qh As] and won (5781) with a pair of Fives
Seat 4: jvieiradias8 folded before Flop (didn't bet)
Seat 5: Scorgiej folded before Flop (didn't bet)
Seat 6: goshaleg showed [Ks 8s] and won (32625) with two pair, Eights and Fives

PokerStars Hand #251209717984: Tournament #3769361908, $52.38+$2.62 USD Hold'em No Limit - Level XIV (500/1000) - 2024/06/26 22:43:04 UTC [2024/06/26 18:43:04 ET]
Table '3769361908 12' 6-max Seat #2 is the button
Seat 1: Baca4b (20422 in chips) 
Seat 2: RenALLiin (18796 in chips) 
Seat 3: Link_fNK (5781 in chips) 
Seat 4: jvieiradias8 (34630 in chips) 
Seat 5: Scorgiej (4643 in chips) 
Seat 6: goshaleg (32625 in chips) 
Baca4b: posts the ante 250
RenALLiin: posts the ante 250
Link_fNK: posts the ante 250
jvieiradias8: posts the ante 250
Scorgiej: posts the ante 250
goshaleg: posts the ante 250
Link_fNK: posts small blind 500
jvieiradias8: posts big blind 1000
*** HOLE CARDS ***
Scorgiej: raises 3393 to 4393 and is all-in
goshaleg: folds 
Baca4b: folds 
RenALLiin: folds 
Link_fNK: folds 
jvieiradias8: folds 
Uncalled bet (3393) returned to Scorgiej
Scorgiej collected 4000 from pot
Scorgiej: doesn't show hand 
*** SUMMARY ***
Total pot 4000 | Rake 0 
Seat 1: Baca4b folded before Flop (didn't bet)
Seat 2: RenALLiin (button) folded before Flop (didn't bet)
Seat 3: Link_fNK (small blind) folded before Flop
Seat 4: jvieiradias8 (big blind) folded before Flop
Seat 5: Scorgiej collected (4000)
Seat 6: goshaleg folded before Flop (didn't bet)

PokerStars Hand #251209723964: Tournament #3769361908, $52.38+$2.62 USD Hold'em No Limit - Level XIV (500/1000) - 2024/06/26 22:43:27 UTC [2024/06/26 18:43:27 ET]
Table '3769361908 12' 6-max Seat #3 is the button
Seat 1: Baca4b (20172 in chips) 
Seat 2: RenALLiin (18546 in chips) 
Seat 3: Link_fNK (5031 in chips) 
Seat 4: jvieiradias8 (33380 in chips) 
Seat 5: Scorgiej (7393 in chips) 
Seat 6: goshaleg (32375 in chips) 
Baca4b: posts the ante 250
RenALLiin: posts the ante 250
Link_fNK: posts the ante 250
jvieiradias8: posts the ante 250
Scorgiej: posts the ante 250
goshaleg: posts the ante 250
jvieiradias8: posts small blind 500
Scorgiej: posts big blind 1000
*** HOLE CARDS ***
goshaleg: folds 
Baca4b: folds 
RenALLiin: folds 
Link_fNK: raises 3781 to 4781 and is all-in
jvieiradias8: raises 3781 to 8562
Scorgiej: calls 6143 and is all-in
Uncalled bet (1419) returned to jvieiradias8
*** FLOP *** [7c 3s 3h]
*** TURN *** [7c 3s 3h] [7h]
*** RIVER *** [7c 3s 3h 7h] [Jd]
*** SHOW DOWN ***
jvieiradias8: shows [Qc 9c] (two pair, Sevens and Threes)
Scorgiej: shows [Ah Ad] (two pair, Aces and Sevens)
Scorgiej collected 4724 from side pot
Link_fNK: shows [6d Ac] (two pair, Sevens and Threes)
Scorgiej collected 15843 from main pot
Link_fNK finished the tournament
*** SUMMARY ***
Total pot 20567 Main pot 15843. Side pot 4724. | Rake 0 
Board [7c 3s 3h 7h Jd]
Seat 1: Baca4b folded before Flop (didn't bet)
Seat 2: RenALLiin folded before Flop (didn't bet)
Seat 3: Link_fNK (button) showed [6d Ac] and lost with two pair, Sevens and Threes
Seat 4: jvieiradias8 (small blind) showed [Qc 9c] and lost with two pair, Sevens and Threes
Seat 5: Scorgiej (big blind) showed [Ah Ad] and won (20567) with two pair, Aces and Sevens
Seat 6: goshaleg folded before Flop (didn't bet)

PokerStars Hand #251209730364: Tournament #3769361908, $52.38+$2.62 USD Hold'em No Limit - Level XIV (500/1000) - 2024/06/26 22:43:52 UTC [2024/06/26 18:43:52 ET]
Table '3769361908 12' 6-max Seat #4 is the button
Seat 1: Baca4b (19922 in chips) 
Seat 2: RenALLiin (18296 in chips) 
Seat 4: jvieiradias8 (25987 in chips) 
Seat 5: Scorgiej (20567 in chips) 
Seat 6: goshaleg (32125 in chips) 
Baca4b: posts the ante 250
RenALLiin: posts the ante 250
jvieiradias8: posts the ante 250
Scorgiej: posts the ante 250
goshaleg: posts the ante 250
Scorgiej: posts small blind 500
goshaleg: posts big blind 1000
*** HOLE CARDS ***
Baca4b: folds 
RenALLiin: folds 
jvieiradias8: raises 1000 to 2000
Scorgiej: raises 18317 to 20317 and is all-in
@tetaschell is disconnected 
goshaleg: folds 
jvieiradias8: calls 18317
*** FLOP *** [5c Js 6s]
*** TURN *** [5c Js 6s] [Qd]
*** RIVER *** [5c Js 6s Qd] [As]
*** SHOW DOWN ***
Scorgiej: shows [5s Ac] (two pair, Aces and Fives)
jvieiradias8: shows [7d 7s] (a pair of Sevens)
Scorgiej collected 42884 from pot
*** SUMMARY ***
Total pot 42884 | Rake 0 
Board [5c Js 6s Qd As]
Seat 1: Baca4b folded before Flop (didn't bet)
Seat 2: RenALLiin folded before Flop (didn't bet)
Seat 4: jvieiradias8 (button) showed [7d 7s] and lost with a pair of Sevens
Seat 5: Scorgiej (small blind) showed [5s Ac] and won (42884) with two pair, Aces and Fives
Seat 6: goshaleg (big blind) folded before Flop

PokerStars Hand #251209740627: Tournament #3769361908, $52.38+$2.62 USD Hold'em No Limit - Level XV (600/1200) - 2024/06/26 22:44:32 UTC [2024/06/26 18:44:32 ET]
Table '3769361908 12' 6-max Seat #5 is the button
Seat 1: Baca4b (19672 in chips) 
Seat 2: RenALLiin (18046 in chips) 
Seat 3: @tetaschell (10000 in chips) 
Seat 4: jvieiradias8 (5420 in chips) 
Seat 5: Scorgiej (42884 in chips) 
Seat 6: goshaleg (30875 in chips) 
Baca4b: posts the ante 300
RenALLiin: posts the ante 300
@tetaschell: posts the ante 300
jvieiradias8: posts the ante 300
Scorgiej: posts the ante 300
goshaleg: posts the ante 300
goshaleg: posts small blind 600
Baca4b: posts big blind 1200
*** HOLE CARDS ***
RenALLiin: folds 
@tetaschell: raises 8500 to 9700 and is all-in
jvieiradias8: folds 
Scorgiej: raises 32884 to 42584 and is all-in
goshaleg: folds 
Baca4b: folds 
Uncalled bet (32884) returned to Scorgiej
*** FLOP *** [4d 7h 8s]
*** TURN *** [4d 7h 8s] [Th]
*** RIVER *** [4d 7h 8s Th] [Js]
*** SHOW DOWN ***
@tetaschell: shows [Qh Qd] (a pair of Queens)
Scorgiej: shows [As Kd] (high card Ace)
@tetaschell collected 23000 from pot
*** SUMMARY ***
Total pot 23000 | Rake 0 
Board [4d 7h 8s Th Js]
Seat 1: Baca4b (big blind) folded before Flop
Seat 2: RenALLiin folded before Flop (didn't bet)
Seat 3: @tetaschell showed [Qh Qd] and won (23000) with a pair of Queens
Seat 4: jvieiradias8 folded before Flop (didn't bet)
Seat 5: Scorgiej (button) showed [As Kd] and lost with high card Ace
Seat 6: goshaleg (small blind) folded before Flop

PokerStars Hand #251209752025: Tournament #3769361908, $52.38+$2.62 USD Hold'em No Limit - Level XV (600/1200) - 2024/06/26 22:45:16 UTC [2024/06/26 18:45:16 ET]
Table '3769361908 12' 6-max Seat #6 is the button
Seat 1: Baca4b (18172 in chips) 
Seat 2: RenALLiin (17746 in chips) 
Seat 3: @tetaschell (23000 in chips) 
Seat 4: jvieiradias8 (5120 in chips) 
Seat 5: Scorgiej (32884 in chips) 
Seat 6: goshaleg (29975 in chips) 
Baca4b: posts the ante 300
RenALLiin: posts the ante 300
@tetaschell: posts the ante 300
jvieiradias8: posts the ante 300
Scorgiej: posts the ante 300
goshaleg: posts the ante 300
Baca4b: posts small blind 600
RenALLiin: posts big blind 1200
*** HOLE CARDS ***
@tetaschell: folds 
jvieiradias8: raises 3620 to 4820 and is all-in
Scorgiej: raises 27764 to 32584 and is all-in
goshaleg: folds 
Baca4b: folds 
RenALLiin: folds 
Uncalled bet (27764) returned to Scorgiej
*** FLOP *** [2s 2d Qc]
*** TURN *** [2s 2d Qc] [7d]
*** RIVER *** [2s 2d Qc 7d] [Tc]
*** SHOW DOWN ***
jvieiradias8: shows [Js Kd] (a pair of Deuces)
Scorgiej: shows [8h 8d] (two pair, Eights and Deuces)
Scorgiej collected 13240 from pot
jvieiradias8 finished the tournament
*** SUMMARY ***
Total pot 13240 | Rake 0 
Board [2s 2d Qc 7d Tc]
Seat 1: Baca4b (small blind) folded before Flop
Seat 2: RenALLiin (big blind) folded before Flop
Seat 3: @tetaschell folded before Flop (didn't bet)
Seat 4: jvieiradias8 showed [Js Kd] and lost with a pair of Deuces
Seat 5: Scorgiej showed [8h 8d] and won (13240) with two pair, Eights and Deuces
Seat 6: goshaleg (button) folded before Flop (didn't bet)

PokerStars Hand #251209763900: Tournament #3769361908, $52.38+$2.62 USD Hold'em No Limit - Level XV (600/1200) - 2024/06/26 22:46:02 UTC [2024/06/26 18:46:02 ET]
Table '3769361908 12' 6-max Seat #1 is the button
Seat 1: Baca4b (17272 in chips) 
Seat 2: RenALLiin (16246 in chips) 
Seat 3: @tetaschell (22700 in chips) 
Seat 5: Scorgiej (41004 in chips) 
Seat 6: goshaleg (29675 in chips) 
Baca4b: posts the ante 300
RenALLiin: posts the ante 300
@tetaschell: posts the ante 300
Scorgiej: posts the ante 300
goshaleg: posts the ante 300
RenALLiin: posts small blind 600
@tetaschell: posts big blind 1200
*** HOLE CARDS ***
Scorgiej: raises 1200 to 2400
goshaleg: folds 
Baca4b: folds 
RenALLiin: folds 
@tetaschell: calls 1200
*** FLOP *** [9h 5c 9c]
@tetaschell: checks 
Scorgiej: checks 
*** TURN *** [9h 5c 9c] [2c]
@tetaschell: bets 2400
Scorgiej: calls 2400
*** RIVER *** [9h 5c 9c 2c] [Tc]
@tetaschell: bets 2661
Monsieur Foutre is disconnected 
Scorgiej: folds 
Uncalled bet (2661) returned to @tetaschell
@tetaschell collected 11700 from pot
@tetaschell: doesn't show hand 
*** SUMMARY ***
Total pot 11700 | Rake 0 
Board [9h 5c 9c 2c Tc]
Seat 1: Baca4b (button) folded before Flop (didn't bet)
Seat 2: RenALLiin (small blind) folded before Flop
Seat 3: @tetaschell (big blind) collected (11700)
Seat 5: Scorgiej folded on the River
Seat 6: goshaleg folded before Flop (didn't bet)

PokerStars Hand #251209780520: Tournament #3769361908, $52.38+$2.62 USD Hold'em No Limit - Level XV (600/1200) - 2024/06/26 22:47:07 UTC [2024/06/26 18:47:07 ET]
Table '3769361908 12' 6-max Seat #2 is the button
Seat 1: Baca4b (16972 in chips) 
Seat 2: RenALLiin (15346 in chips) 
Seat 3: @tetaschell (29300 in chips) 
Seat 4: Monsieur Foutre (10000 in chips) 
Seat 5: Scorgiej (35904 in chips) 
Seat 6: goshaleg (29375 in chips) 
Baca4b: posts the ante 300
RenALLiin: posts the ante 300
@tetaschell: posts the ante 300
Monsieur Foutre: posts the ante 300
Scorgiej: posts the ante 300
goshaleg: posts the ante 300
@tetaschell: posts small blind 600
Monsieur Foutre: posts big blind 1200
*** HOLE CARDS ***
Scorgiej: raises 1200 to 2400
goshaleg: folds 
Baca4b: folds 
RenALLiin: folds 
@tetaschell: folds 
Monsieur Foutre: calls 1200
*** FLOP *** [7c 7h 2c]
Monsieur Foutre: checks 
Scorgiej: bets 1200
Monsieur Foutre: raises 6100 to 7300 and is all-in
Scorgiej: calls 6100
*** TURN *** [7c 7h 2c] [8c]
*** RIVER *** [7c 7h 2c 8c] [3c]
*** SHOW DOWN ***
Monsieur Foutre: shows [As 3d] (two pair, Sevens and Threes)
Scorgiej: shows [Th Ts] (two pair, Tens and Sevens)
Scorgiej collected 21800 from pot
Monsieur Foutre finished the tournament
*** SUMMARY ***
Total pot 21800 | Rake 0 
Board [7c 7h 2c 8c 3c]
Seat 1: Baca4b folded before Flop (didn't bet)
Seat 2: RenALLiin (button) folded before Flop (didn't bet)
Seat 3: @tetaschell (small blind) folded before Flop
Seat 4: Monsieur Foutre (big blind) showed [As 3d] and lost with two pair, Sevens and Threes
Seat 5: Scorgiej showed [Th Ts] and won (21800) with two pair, Tens and Sevens
Seat 6: goshaleg folded before Flop (didn't bet)

PokerStars Hand #251209794207: Tournament #3769361908, $52.38+$2.62 USD Hold'em No Limit - Level XVI (800/1600) - 2024/06/26 22:48:01 UTC [2024/06/26 18:48:01 ET]
Table '3769361908 12' 6-max Seat #3 is the button
Seat 1: Baca4b (16672 in chips) 
Seat 2: RenALLiin (15046 in chips) 
Seat 3: @tetaschell (28400 in chips) 
Seat 5: Scorgiej (47704 in chips) 
Seat 6: goshaleg (29075 in chips) 
Baca4b: posts the ante 400
RenALLiin: posts the ante 400
@tetaschell: posts the ante 400
Scorgiej: posts the ante 400
goshaleg: posts the ante 400
Scorgiej: posts small blind 800
goshaleg: posts big blind 1600
*** HOLE CARDS ***
Baca4b: folds 
RenALLiin: raises 13046 to 14646 and is all-in
@tetaschell: folds 
Scorgiej: raises 32658 to 47304 and is all-in
goshaleg: folds 
Uncalled bet (32658) returned to Scorgiej
*** FLOP *** [3s 9s Qs]
*** TURN *** [3s 9s Qs] [Td]
*** RIVER *** [3s 9s Qs Td] [3h]
*** SHOW DOWN ***
Scorgiej: shows [As Ad] (two pair, Aces and Threes)
RenALLiin: shows [5d 5c] (two pair, Fives and Threes)
Scorgiej collected 32892 from pot
RenALLiin finished the tournament
*** SUMMARY ***
Total pot 32892 | Rake 0 
Board [3s 9s Qs Td 3h]
Seat 1: Baca4b folded before Flop (didn't bet)
Seat 2: RenALLiin showed [5d 5c] and lost with two pair, Fives and Threes
Seat 3: @tetaschell (button) folded before Flop (didn't bet)
Seat 5: Scorgiej (small blind) showed [As Ad] and won (32892) with two pair, Aces and Threes
Seat 6: goshaleg (big blind) folded before Flop

PokerStars Hand #251209801194: Tournament #3769361908, $52.38+$2.62 USD Hold'em No Limit - Level XVI (800/1600) - 2024/06/26 22:48:29 UTC [2024/06/26 18:48:29 ET]
Table '3769361908 12' 6-max Seat #5 is the button
Seat 1: Baca4b (16272 in chips) 
Seat 3: @tetaschell (28000 in chips) 
Seat 5: Scorgiej (65550 in chips) 
Seat 6: goshaleg (27075 in chips) 
Baca4b: posts the ante 400
@tetaschell: posts the ante 400
Scorgiej: posts the ante 400
goshaleg: posts the ante 400
goshaleg: posts small blind 800
Baca4b: posts big blind 1600
*** HOLE CARDS ***
@tetaschell: folds 
Scorgiej: raises 2080 to 3680
goshaleg: folds 
Baca4b: calls 2080
*** FLOP *** [4c 2c Jh]
Baca4b: checks 
Scorgiej: checks 
*** TURN *** [4c 2c Jh] [2s]
Baca4b: checks 
Scorgiej: checks 
*** RIVER *** [4c 2c Jh 2s] [6d]
Baca4b: bets 4880
Scorgiej: folds 
Uncalled bet (4880) returned to Baca4b
Baca4b collected 9760 from pot
Baca4b: doesn't show hand 
*** SUMMARY ***
Total pot 9760 | Rake 0 
Board [4c 2c Jh 2s 6d]
Seat 1: Baca4b (big blind) collected (9760)
Seat 3: @tetaschell folded before Flop (didn't bet)
Seat 5: Scorgiej (button) folded on the River
Seat 6: goshaleg (small blind) folded before Flop

PokerStars Hand #251209814087: Tournament #3769361908, $52.38+$2.62 USD Hold'em No Limit - Level XVI (800/1600) - 2024/06/26 22:49:20 UTC [2024/06/26 18:49:20 ET]
Table '3769361908 12' 6-max Seat #6 is the button
Seat 1: Baca4b (21952 in chips) 
Seat 2: jklñjklñ (7410 in chips) 
Seat 3: @tetaschell (27600 in chips) 
Seat 5: Scorgiej (61470 in chips) 
Seat 6: goshaleg (25875 in chips) 
Baca4b: posts the ante 400
jklñjklñ: posts the ante 400
@tetaschell: posts the ante 400
Scorgiej: posts the ante 400
goshaleg: posts the ante 400
Baca4b: posts small blind 800
jklñjklñ: posts big blind 1600
*** HOLE CARDS ***
@tetaschell: folds 
vitor762 is disconnected 
Scorgiej: raises 1600 to 3200
goshaleg: folds 
Baca4b: folds 
jklñjklñ: folds 
Uncalled bet (1600) returned to Scorgiej
Scorgiej collected 6000 from pot
Scorgiej: doesn't show hand 
*** SUMMARY ***
Total pot 6000 | Rake 0 
Seat 1: Baca4b (small blind) folded before Flop
Seat 2: jklñjklñ (big blind) folded before Flop
Seat 3: @tetaschell folded before Flop (didn't bet)
Seat 5: Scorgiej collected (6000)
Seat 6: goshaleg (button) folded before Flop (didn't bet)

PokerStars Hand #251209819951: Tournament #3769361908, $52.38+$2.62 USD Hold'em No Limit - Level XVI (800/1600) - 2024/06/26 22:49:44 UTC [2024/06/26 18:49:44 ET]
Table '3769361908 12' 6-max Seat #1 is the button
Seat 1: Baca4b (20752 in chips) 
Seat 2: jklñjklñ (5410 in chips) 
Seat 3: @tetaschell (27200 in chips) 
Seat 4: vitor762 (14070 in chips) 
Seat 5: Scorgiej (65470 in chips) 
Seat 6: goshaleg (25475 in chips) 
Baca4b: posts the ante 400
jklñjklñ: posts the ante 400
@tetaschell: posts the ante 400
vitor762: posts the ante 400
Scorgiej: posts the ante 400
goshaleg: posts the ante 400
jklñjklñ: posts small blind 800
@tetaschell: posts big blind 1600
*** HOLE CARDS ***
vitor762: folds 
Scorgiej: folds 
goshaleg: raises 1600 to 3200
Baca4b: folds 
jklñjklñ: folds 
@tetaschell: raises 4000 to 7200
goshaleg: folds 
Uncalled bet (4000) returned to @tetaschell
@tetaschell collected 9600 from pot
@tetaschell: doesn't show hand 
*** SUMMARY ***
Total pot 9600 | Rake 0 
Seat 1: Baca4b (button) folded before Flop (didn't bet)
Seat 2: jklñjklñ (small blind) folded before Flop
Seat 3: @tetaschell (big blind) collected (9600)
Seat 4: vitor762 folded before Flop (didn't bet)
Seat 5: Scorgiej folded before Flop (didn't bet)
Seat 6: goshaleg folded before Flop

PokerStars Hand #251209830418: Tournament #3769361908, $52.38+$2.62 USD Hold'em No Limit - Level XVII (1000/2000) - 2024/06/26 22:50:26 UTC [2024/06/26 18:50:26 ET]
Table '3769361908 12' 6-max Seat #2 is the button
Seat 1: Baca4b (20352 in chips) 
Seat 2: jklñjklñ (4210 in chips) 
Seat 3: @tetaschell (33200 in chips) 
Seat 4: vitor762 (13670 in chips) 
Seat 5: Scorgiej (65070 in chips) 
Seat 6: goshaleg (21875 in chips) 
Baca4b: posts the ante 500
jklñjklñ: posts the ante 500
@tetaschell: posts the ante 500
vitor762: posts the ante 500
Scorgiej: posts the ante 500
goshaleg: posts the ante 500
@tetaschell: posts small blind 1000
vitor762: posts big blind 2000
*** HOLE CARDS ***
Scorgiej: folds 
goshaleg: folds 
Baca4b: folds 
jklñjklñ: raises 1710 to 3710 and is all-in
@tetaschell: raises 28990 to 32700 and is all-in
vitor762: calls 11170 and is all-in
Uncalled bet (19530) returned to @tetaschell
*** FLOP *** [2s Th 4h]
*** TURN *** [2s Th 4h] [6c]
*** RIVER *** [2s Th 4h 6c] [3d]
*** SHOW DOWN ***
@tetaschell: shows [6d 8d] (a pair of Sixes)
vitor762: shows [8h 8c] (a pair of Eights)
vitor762 collected 18920 from side pot
jklñjklñ: shows [Qd Qs] (a pair of Queens)
jklñjklñ collected 14130 from main pot
*** SUMMARY ***
Total pot 33050 Main pot 14130. Side pot 18920. | Rake 0 
Board [2s Th 4h 6c 3d]
Seat 1: Baca4b folded before Flop (didn't bet)
Seat 2: jklñjklñ (button) showed [Qd Qs] and won (14130) with a pair of Queens
Seat 3: @tetaschell (small blind) showed [6d 8d] and lost with a pair of Sixes
Seat 4: vitor762 (big blind) showed [8h 8c] and won (18920) with a pair of Eights
Seat 5: Scorgiej folded before Flop (didn't bet)
Seat 6: goshaleg folded before Flop (didn't bet)

PokerStars Hand #251209838074: Tournament #3769361908, $52.38+$2.62 USD Hold'em No Limit - Level XVII (1000/2000) - 2024/06/26 22:50:58 UTC [2024/06/26 18:50:58 ET]
Table '3769361908 12' 6-max Seat #3 is the button
Seat 1: Baca4b (19852 in chips) 
Seat 2: jklñjklñ (14130 in chips) 
Seat 3: @tetaschell (19530 in chips) 
Seat 4: vitor762 (18920 in chips) 
Seat 5: Scorgiej (64570 in chips) 
Seat 6: goshaleg (21375 in chips) 
Baca4b: posts the ante 500
jklñjklñ: posts the ante 500
@tetaschell: posts the ante 500
vitor762: posts the ante 500
Scorgiej: posts the ante 500
goshaleg: posts the ante 500
vitor762: posts small blind 1000
Scorgiej: posts big blind 2000
*** HOLE CARDS ***
goshaleg: folds 
Baca4b: folds 
jklñjklñ: raises 11630 to 13630 and is all-in
@tetaschell: folds 
vitor762: folds 
Scorgiej: folds 
Uncalled bet (11630) returned to jklñjklñ
jklñjklñ collected 8000 from pot
*** SUMMARY ***
Total pot 8000 | Rake 0 
Seat 1: Baca4b folded before Flop (didn't bet)
Seat 2: jklñjklñ collected (8000)
Seat 3: @tetaschell (button) folded before Flop (didn't bet)
Seat 4: vitor762 (small blind) folded before Flop
Seat 5: Scorgiej (big blind) folded before Flop
Seat 6: goshaleg folded before Flop (didn't bet)

PokerStars Hand #251209842678: Tournament #3769361908, $52.38+$2.62 USD Hold'em No Limit - Level XVII (1000/2000) - 2024/06/26 22:51:17 UTC [2024/06/26 18:51:17 ET]
Table '3769361908 12' 6-max Seat #4 is the button
Seat 1: Baca4b (19352 in chips) 
Seat 2: jklñjklñ (19630 in chips) 
Seat 3: @tetaschell (19030 in chips) 
Seat 4: vitor762 (17420 in chips) 
Seat 5: Scorgiej (62070 in chips) 
Seat 6: goshaleg (20875 in chips) 
Baca4b: posts the ante 500
jklñjklñ: posts the ante 500
@tetaschell: posts the ante 500
vitor762: posts the ante 500
Scorgiej: posts the ante 500
goshaleg: posts the ante 500
Scorgiej: posts small blind 1000
goshaleg: posts big blind 2000
*** HOLE CARDS ***
Baca4b: folds 
jklñjklñ: folds 
@tetaschell: folds 
vitor762: folds 
Scorgiej: raises 59570 to 61570 and is all-in
goshaleg: calls 18375 and is all-in
Uncalled bet (41195) returned to Scorgiej
*** FLOP *** [8d 2s Qh]
*** TURN *** [8d 2s Qh] [2d]
*** RIVER *** [8d 2s Qh 2d] [6s]
*** SHOW DOWN ***
Scorgiej: shows [9d Qc] (two pair, Queens and Deuces)
goshaleg: shows [Ad 4h] (a pair of Deuces)
Scorgiej collected 43750 from pot
goshaleg finished the tournament in 100th place
*** SUMMARY ***
Total pot 43750 | Rake 0 
Board [8d 2s Qh 2d 6s]
Seat 1: Baca4b folded before Flop (didn't bet)
Seat 2: jklñjklñ folded before Flop (didn't bet)
Seat 3: @tetaschell folded before Flop (didn't bet)
Seat 4: vitor762 (button) folded before Flop (didn't bet)
Seat 5: Scorgiej (small blind) showed [9d Qc] and won (43750) with two pair, Queens and Deuces
Seat 6: goshaleg (big blind) showed [Ad 4h] and lost with a pair of Deuces

PokerStars Hand #251209849149: Tournament #3769361908, $52.38+$2.62 USD Hold'em No Limit - Level XVII (1000/2000) - 2024/06/26 22:51:44 UTC [2024/06/26 18:51:44 ET]
Table '3769361908 12' 6-max Seat #5 is the button
Seat 1: Baca4b (18852 in chips) 
Seat 2: jklñjklñ (19130 in chips) 
Seat 3: @tetaschell (18530 in chips) 
Seat 4: vitor762 (16920 in chips) 
Seat 5: Scorgiej (84945 in chips) 
Baca4b: posts the ante 500
jklñjklñ: posts the ante 500
@tetaschell: posts the ante 500
vitor762: posts the ante 500
Scorgiej: posts the ante 500
Baca4b: posts small blind 1000
jklñjklñ: posts big blind 2000
*** HOLE CARDS ***
@tetaschell: folds 
vitor762: raises 14420 to 16420 and is all-in
Scorgiej: folds 
Baca4b: raises 1932 to 18352 and is all-in
jklñjklñ: folds 
Uncalled bet (1932) returned to Baca4b
*** FLOP *** [3s Jc 8s]
*** TURN *** [3s Jc 8s] [7s]
*** RIVER *** [3s Jc 8s 7s] [Js]
G_haeffner is disconnected 
*** SHOW DOWN ***
Baca4b: shows [6d 6c] (two pair, Jacks and Sixes)
vitor762: shows [Qs Qc] (a flush, Queen high)
vitor762 collected 37340 from pot
*** SUMMARY ***
Total pot 37340 | Rake 0 
Board [3s Jc 8s 7s Js]
Seat 1: Baca4b (small blind) showed [6d 6c] and lost with two pair, Jacks and Sixes
Seat 2: jklñjklñ (big blind) folded before Flop
Seat 3: @tetaschell folded before Flop (didn't bet)
Seat 4: vitor762 showed [Qs Qc] and won (37340) with a flush, Queen high
Seat 5: Scorgiej (button) folded before Flop (didn't bet)

PokerStars Hand #251209856163: Tournament #3769361908, $52.38+$2.62 USD Hold'em No Limit - Level XVII (1000/2000) - 2024/06/26 22:52:12 UTC [2024/06/26 18:52:12 ET]
Table '3769361908 12' 6-max Seat #1 is the button
Seat 1: Baca4b (1932 in chips) 
Seat 2: jklñjklñ (16630 in chips) 
Seat 3: @tetaschell (18030 in chips) 
Seat 4: vitor762 (37340 in chips) 
Seat 5: Scorgiej (84445 in chips) 
Seat 6: G_haeffner (9348 in chips) 
Baca4b: posts the ante 500
jklñjklñ: posts the ante 500
@tetaschell: posts the ante 500
vitor762: posts the ante 500
Scorgiej: posts the ante 500
G_haeffner: posts the ante 500
jklñjklñ: posts small blind 1000
@tetaschell: posts big blind 2000
*** HOLE CARDS ***
vitor762: folds 
Scorgiej: raises 81945 to 83945 and is all-in
G_haeffner: folds 
Baca4b: calls 1432 and is all-in
jklñjklñ: folds 
@tetaschell: folds 
Uncalled bet (81945) returned to Scorgiej
*** FLOP *** [Jd 7d 5s]
*** TURN *** [Jd 7d 5s] [Js]
*** RIVER *** [Jd 7d 5s Js] [3h]
*** SHOW DOWN ***
Scorgiej: shows [6h As] (a pair of Jacks)
Scorgiej collected 1136 from side pot
Baca4b: shows [5d 5c] (a full house, Fives full of Jacks)
Baca4b collected 8296 from main pot
*** SUMMARY ***
Total pot 9432 Main pot 8296. Side pot 1136. | Rake 0 
Board [Jd 7d 5s Js 3h]
Seat 1: Baca4b (button) showed [5d 5c] and won (8296) with a full house, Fives full of Jacks
Seat 2: jklñjklñ (small blind) folded before Flop
Seat 3: @tetaschell (big blind) folded before Flop
Seat 4: vitor762 folded before Flop (didn't bet)
Seat 5: Scorgiej showed [6h As] and won (1136) with a pair of Jacks
Seat 6: G_haeffner folded before Flop (didn't bet)

PokerStars Hand #251209863128: Tournament #3769361908, $52.38+$2.62 USD Hold'em No Limit - Level XVII (1000/2000) - 2024/06/26 22:52:40 UTC [2024/06/26 18:52:40 ET]
Table '3769361908 12' 6-max Seat #2 is the button
Seat 1: Baca4b (8296 in chips) 
Seat 2: jklñjklñ (15130 in chips) 
Seat 3: @tetaschell (15530 in chips) 
Seat 4: vitor762 (36840 in chips) 
Seat 5: Scorgiej (83081 in chips) 
Seat 6: G_haeffner (8848 in chips) 
Baca4b: posts the ante 500
jklñjklñ: posts the ante 500
@tetaschell: posts the ante 500
vitor762: posts the ante 500
Scorgiej: posts the ante 500
G_haeffner: posts the ante 500
@tetaschell: posts small blind 1000
vitor762: posts big blind 2000
*** HOLE CARDS ***
Scorgiej: raises 2000 to 4000
G_haeffner: folds 
Baca4b: folds 
jklñjklñ: folds 
@tetaschell: folds 
vitor762: calls 2000
*** FLOP *** [Jd 8d Jh]
vitor762: checks 
Scorgiej: bets 3000
vitor762: folds 
Uncalled bet (3000) returned to Scorgiej
Scorgiej collected 12000 from pot
Scorgiej: doesn't show hand 
*** SUMMARY ***
Total pot 12000 | Rake 0 
Board [Jd 8d Jh]
Seat 1: Baca4b folded before Flop (didn't bet)
Seat 2: jklñjklñ (button) folded before Flop (didn't bet)
Seat 3: @tetaschell (small blind) folded before Flop
Seat 4: vitor762 (big blind) folded on the Flop
Seat 5: Scorgiej collected (12000)
Seat 6: G_haeffner folded before Flop (didn't bet)

PokerStars Hand #251209874511: Tournament #3769361908, $52.38+$2.62 USD Hold'em No Limit - Level XVIII (1200/2400) - 2024/06/26 22:53:28 UTC [2024/06/26 18:53:28 ET]
Table '3769361908 12' 6-max Seat #3 is the button
Seat 1: Baca4b (7796 in chips) 
Seat 2: jklñjklñ (14630 in chips) 
Seat 3: @tetaschell (14030 in chips) 
Seat 4: vitor762 (32340 in chips) 
Seat 5: Scorgiej (90581 in chips) 
Seat 6: G_haeffner (8348 in chips) 
Baca4b: posts the ante 600
jklñjklñ: posts the ante 600
@tetaschell: posts the ante 600
vitor762: posts the ante 600
Scorgiej: posts the ante 600
G_haeffner: posts the ante 600
vitor762: posts small blind 1200
Scorgiej: posts big blind 2400
*** HOLE CARDS ***
G_haeffner: raises 5348 to 7748 and is all-in
Baca4b: calls 7196 and is all-in
jklñjklñ: raises 6282 to 14030 and is all-in
@tetaschell: folds 
vitor762: folds 
Scorgiej: folds 
Uncalled bet (6282) returned to jklñjklñ
*** FLOP *** [8h Ks 9c]
*** TURN *** [8h Ks 9c] [9h]
*** RIVER *** [8h Ks 9c 9h] [6d]
*** SHOW DOWN ***
G_haeffner: shows [Qh Ah] (a pair of Nines)
jklñjklñ: shows [Ac Jc] (a pair of Nines - lower kicker)
G_haeffner collected 1104 from side pot
Baca4b: shows [Ad Tc] (a pair of Nines - lower kicker)
G_haeffner collected 28788 from main pot
Baca4b finished the tournament in 83rd place
*** SUMMARY ***
Total pot 29892 Main pot 28788. Side pot 1104. | Rake 0 
Board [8h Ks 9c 9h 6d]
Seat 1: Baca4b showed [Ad Tc] and lost with a pair of Nines
Seat 2: jklñjklñ showed [Ac Jc] and lost with a pair of Nines
Seat 3: @tetaschell (button) folded before Flop (didn't bet)
Seat 4: vitor762 (small blind) folded before Flop
Seat 5: Scorgiej (big blind) folded before Flop
Seat 6: G_haeffner showed [Qh Ah] and won (29892) with a pair of Nines

PokerStars Hand #251209885604: Tournament #3769361908, $52.38+$2.62 USD Hold'em No Limit - Level XVIII (1200/2400) - 2024/06/26 22:54:13 UTC [2024/06/26 18:54:13 ET]
Table '3769361908 12' 6-max Seat #4 is the button
Seat 2: jklñjklñ (6282 in chips) 
Seat 3: @tetaschell (13430 in chips) 
Seat 4: vitor762 (30540 in chips) 
Seat 5: Scorgiej (87581 in chips) 
Seat 6: G_haeffner (29892 in chips) 
jklñjklñ: posts the ante 600
@tetaschell: posts the ante 600
vitor762: posts the ante 600
Scorgiej: posts the ante 600
G_haeffner: posts the ante 600
Scorgiej: posts small blind 1200
G_haeffner: posts big blind 2400
*** HOLE CARDS ***
jklñjklñ: folds 
@tetaschell: folds 
vitor762: folds 
Scorgiej: raises 84581 to 86981 and is all-in
G_haeffner: folds 
Uncalled bet (84581) returned to Scorgiej
Scorgiej collected 7800 from pot
Scorgiej: doesn't show hand 
*** SUMMARY ***
Total pot 7800 | Rake 0 
Seat 2: jklñjklñ folded before Flop (didn't bet)
Seat 3: @tetaschell folded before Flop (didn't bet)
Seat 4: vitor762 (button) folded before Flop (didn't bet)
Seat 5: Scorgiej (small blind) collected (7800)
Seat 6: G_haeffner (big blind) folded before Flop

PokerStars Hand #251209892168: Tournament #3769361908, $52.38+$2.62 USD Hold'em No Limit - Level XVIII (1200/2400) - 2024/06/26 22:54:40 UTC [2024/06/26 18:54:40 ET]
Table '3769361908 12' 6-max Seat #5 is the button
Seat 2: jklñjklñ (5682 in chips) 
Seat 3: @tetaschell (12830 in chips) 
Seat 4: vitor762 (29940 in chips) 
Seat 5: Scorgiej (92381 in chips) 
Seat 6: G_haeffner (26892 in chips) 
jklñjklñ: posts the ante 600
@tetaschell: posts the ante 600
vitor762: posts the ante 600
Scorgiej: posts the ante 600
G_haeffner: posts the ante 600
G_haeffner: posts small blind 1200
jklñjklñ: posts big blind 2400
*** HOLE CARDS ***
@tetaschell: raises 9830 to 12230 and is all-in
vitor762: folds 
Scorgiej: folds 
G_haeffner: folds 
jklñjklñ: calls 2682 and is all-in
Uncalled bet (7148) returned to @tetaschell
*** FLOP *** [7h 6c 9s]
DR. ELDAR is disconnected 
*** TURN *** [7h 6c 9s] [6s]
*** RIVER *** [7h 6c 9s 6s] [4c]
*** SHOW DOWN ***
jklñjklñ: shows [3s Jd] (a pair of Sixes)
@tetaschell: shows [9h As] (two pair, Nines and Sixes)
@tetaschell collected 14364 from pot
jklñjklñ finished the tournament in 77th place
*** SUMMARY ***
Total pot 14364 | Rake 0 
Board [7h 6c 9s 6s 4c]
Seat 2: jklñjklñ (big blind) showed [3s Jd] and lost with a pair of Sixes
Seat 3: @tetaschell showed [9h As] and won (14364) with two pair, Nines and Sixes
Seat 4: vitor762 folded before Flop (didn't bet)
Seat 5: Scorgiej (button) folded before Flop (didn't bet)
Seat 6: G_haeffner (small blind) folded before Flop

PokerStars Hand #251209964591: Tournament #3769361908, $52.38+$2.62 USD Hold'em No Limit - Level XVIII (1200/2400) - 2024/06/26 23:01:09 UTC [2024/06/26 19:01:09 ET]
Table '3769361908 12' 6-max Seat #6 is the button
Seat 1: DR. ELDAR (36345 in chips) out of hand (moved from another table into small blind)
Seat 2: 4sasss (30176 in chips) out of hand (moved from another table into small blind)
Seat 3: @tetaschell (21512 in chips) 
Seat 4: vitor762 (29340 in chips) 
Seat 5: Scorgiej (91781 in chips) 
Seat 6: G_haeffner (25092 in chips) 
DR. ELDAR will be allowed to play after the button
4sasss will be allowed to play after the button
@tetaschell: posts the ante 600
vitor762: posts the ante 600
Scorgiej: posts the ante 600
G_haeffner: posts the ante 600
@tetaschell: posts small blind 1200
vitor762: posts big blind 2400
*** HOLE CARDS ***
Scorgiej: folds 
G_haeffner: folds 
@tetaschell: raises 18512 to 20912 and is all-in
vitor762: folds 
Uncalled bet (18512) returned to @tetaschell
@tetaschell collected 7200 from pot
@tetaschell: doesn't show hand 
*** SUMMARY ***
Total pot 7200 | Rake 0 
Seat 3: @tetaschell (small blind) collected (7200)
Seat 4: vitor762 (big blind) folded before Flop
Seat 5: Scorgiej folded before Flop (didn't bet)
Seat 6: G_haeffner (button) folded before Flop (didn't bet)

PokerStars Hand #251209968830: Tournament #3769361908, $52.38+$2.62 USD Hold'em No Limit - Level XVIII (1200/2400) - 2024/06/26 23:01:28 UTC [2024/06/26 19:01:28 ET]
Table '3769361908 12' 6-max Seat #3 is the button
Seat 1: DR. ELDAR (36345 in chips) 
Seat 2: 4sasss (30176 in chips) 
Seat 3: @tetaschell (25712 in chips) 
Seat 4: vitor762 (26340 in chips) 
Seat 5: Scorgiej (91181 in chips) 
Seat 6: G_haeffner (24492 in chips) 
DR. ELDAR: posts the ante 600
4sasss: posts the ante 600
@tetaschell: posts the ante 600
vitor762: posts the ante 600
Scorgiej: posts the ante 600
G_haeffner: posts the ante 600
vitor762: posts small blind 1200
Scorgiej: posts big blind 2400
*** HOLE CARDS ***
G_haeffner: folds 
DR. ELDAR: folds 
4sasss: folds 
@tetaschell: folds 
vitor762: folds 
Uncalled bet (1200) returned to Scorgiej
Scorgiej collected 6000 from pot
Scorgiej: doesn't show hand 
*** SUMMARY ***
Total pot 6000 | Rake 0 
Seat 1: DR. ELDAR folded before Flop (didn't bet)
Seat 2: 4sasss folded before Flop (didn't bet)
Seat 3: @tetaschell (button) folded before Flop (didn't bet)
Seat 4: vitor762 (small blind) folded before Flop
Seat 5: Scorgiej (big blind) collected (6000)
Seat 6: G_haeffner folded before Flop (didn't bet)

PokerStars Hand #251209982019: Tournament #3769361908, $52.38+$2.62 USD Hold'em No Limit - Level XIX (1400/2800) - 2024/06/26 23:02:25 UTC [2024/06/26 19:02:25 ET]
Table '3769361908 12' 6-max Seat #4 is the button
Seat 1: DR. ELDAR (35745 in chips) 
Seat 2: 4sasss (29576 in chips) 
Seat 3: @tetaschell (25112 in chips) 
Seat 4: vitor762 (24540 in chips) 
Seat 5: Scorgiej (95381 in chips) 
Seat 6: G_haeffner (23892 in chips) 
DR. ELDAR: posts the ante 700
4sasss: posts the ante 700
@tetaschell: posts the ante 700
vitor762: posts the ante 700
Scorgiej: posts the ante 700
G_haeffner: posts the ante 700
Scorgiej: posts small blind 1400
G_haeffner: posts big blind 2800
*** HOLE CARDS ***
DR. ELDAR: folds 
4sasss: raises 26076 to 28876 and is all-in
@tetaschell: folds 
vitor762: calls 23840 and is all-in
Scorgiej: folds 
G_haeffner: folds 
Uncalled bet (5036) returned to 4sasss
*** FLOP *** [6d 5h 9d]
*** TURN *** [6d 5h 9d] [3c]
*** RIVER *** [6d 5h 9d 3c] [4c]
*** SHOW DOWN ***
4sasss: shows [Qs Ah] (high card Ace)
vitor762: shows [As Ac] (a pair of Aces)
vitor762 collected 56080 from pot
*** SUMMARY ***
Total pot 56080 | Rake 0 
Board [6d 5h 9d 3c 4c]
Seat 1: DR. ELDAR folded before Flop (didn't bet)
Seat 2: 4sasss showed [Qs Ah] and lost with high card Ace
Seat 3: @tetaschell folded before Flop (didn't bet)
Seat 4: vitor762 (button) showed [As Ac] and won (56080) with a pair of Aces
Seat 5: Scorgiej (small blind) folded before Flop
Seat 6: G_haeffner (big blind) folded before Flop

PokerStars Hand #251209994009: Tournament #3769361908, $52.38+$2.62 USD Hold'em No Limit - Level XIX (1400/2800) - 2024/06/26 23:03:17 UTC [2024/06/26 19:03:17 ET]
Table '3769361908 12' 6-max Seat #5 is the button
Seat 1: DR. ELDAR (35045 in chips) 
Seat 2: 4sasss (5036 in chips) 
Seat 3: @tetaschell (24412 in chips) 
Seat 4: vitor762 (56080 in chips) 
Seat 5: Scorgiej (93281 in chips) 
Seat 6: G_haeffner (20392 in chips) 
DR. ELDAR: posts the ante 700
4sasss: posts the ante 700
@tetaschell: posts the ante 700
vitor762: posts the ante 700
Scorgiej: posts the ante 700
G_haeffner: posts the ante 700
G_haeffner: posts small blind 1400
DR. ELDAR: posts big blind 2800
*** HOLE CARDS ***
4sasss: folds 
@tetaschell: folds 
vitor762: folds 
Scorgiej: folds 
G_haeffner: folds 
Uncalled bet (1400) returned to DR. ELDAR
DR. ELDAR collected 7000 from pot
DR. ELDAR: doesn't show hand 
*** SUMMARY ***
Total pot 7000 | Rake 0 
Seat 1: DR. ELDAR (big blind) collected (7000)
Seat 2: 4sasss folded before Flop (didn't bet)
Seat 3: @tetaschell folded before Flop (didn't bet)
Seat 4: vitor762 folded before Flop (didn't bet)
Seat 5: Scorgiej (button) folded before Flop (didn't bet)
Seat 6: G_haeffner (small blind) folded before Flop

PokerStars Hand #251210006784: Tournament #3769361908, $52.38+$2.62 USD Hold'em No Limit - Level XIX (1400/2800) - 2024/06/26 23:04:12 UTC [2024/06/26 19:04:12 ET]
Table '3769361908 12' 6-max Seat #6 is the button
Seat 1: DR. ELDAR (39945 in chips) 
Seat 2: 4sasss (4336 in chips) 
Seat 3: @tetaschell (23712 in chips) 
Seat 4: vitor762 (55380 in chips) 
Seat 5: Scorgiej (92581 in chips) 
Seat 6: G_haeffner (18292 in chips) 
DR. ELDAR: posts the ante 700
4sasss: posts the ante 700
@tetaschell: posts the ante 700
vitor762: posts the ante 700
Scorgiej: posts the ante 700
G_haeffner: posts the ante 700
DR. ELDAR: posts small blind 1400
4sasss: posts big blind 2800
*** HOLE CARDS ***
@tetaschell: folds 
vitor762: raises 2800 to 5600
Scorgiej: folds 
G_haeffner: folds 
DR. ELDAR: folds 
4sasss: calls 836 and is all-in
Uncalled bet (1964) returned to vitor762
*** FLOP *** [4c Kc 9s]
*** TURN *** [4c Kc 9s] [Jc]
*** RIVER *** [4c Kc 9s Jc] [4h]
*** SHOW DOWN ***
4sasss: shows [2c 7d] (a pair of Fours)
vitor762: shows [Ad 8s] (a pair of Fours - Ace kicker)
vitor762 collected 12872 from pot
4sasss finished the tournament in 65th place
*** SUMMARY ***
Total pot 12872 | Rake 0 
Board [4c Kc 9s Jc 4h]
Seat 1: DR. ELDAR (small blind) folded before Flop
Seat 2: 4sasss (big blind) showed [2c 7d] and lost with a pair of Fours
Seat 3: @tetaschell folded before Flop (didn't bet)
Seat 4: vitor762 showed [Ad 8s] and won (12872) with a pair of Fours
Seat 5: Scorgiej folded before Flop (didn't bet)
Seat 6: G_haeffner (button) folded before Flop (didn't bet)

PokerStars Hand #251210018709: Tournament #3769361908, $52.38+$2.62 USD Hold'em No Limit - Level XIX (1400/2800) - 2024/06/26 23:05:03 UTC [2024/06/26 19:05:03 ET]
Table '3769361908 12' 6-max Seat #1 is the button
Seat 1: DR. ELDAR (37845 in chips) 
Seat 3: @tetaschell (23012 in chips) 
Seat 4: vitor762 (63916 in chips) 
Seat 5: Scorgiej (91881 in chips) 
Seat 6: G_haeffner (17592 in chips) 
DR. ELDAR: posts the ante 700
@tetaschell: posts the ante 700
vitor762: posts the ante 700
Scorgiej: posts the ante 700
G_haeffner: posts the ante 700
@tetaschell: posts small blind 1400
vitor762: posts big blind 2800
*** HOLE CARDS ***
Scorgiej: folds 
G_haeffner: folds 
DR. ELDAR: raises 34345 to 37145 and is all-in
@tetaschell: folds 
vitor762: folds 
Uncalled bet (34345) returned to DR. ELDAR
DR. ELDAR collected 10500 from pot
DR. ELDAR: doesn't show hand 
*** SUMMARY ***
Total pot 10500 | Rake 0 
Seat 1: DR. ELDAR (button) collected (10500)
Seat 3: @tetaschell (small blind) folded before Flop
Seat 4: vitor762 (big blind) folded before Flop
Seat 5: Scorgiej folded before Flop (didn't bet)
Seat 6: G_haeffner folded before Flop (didn't bet)

PokerStars Hand #251210036486: Tournament #3769361908, $52.38+$2.62 USD Hold'em No Limit - Level XX (1600/3200) - 2024/06/26 23:06:21 UTC [2024/06/26 19:06:21 ET]
Table '3769361908 12' 6-max Seat #3 is the button
Seat 1: DR. ELDAR (44845 in chips) 
Seat 3: @tetaschell (20912 in chips) 
Seat 4: vitor762 (60416 in chips) 
Seat 5: Scorgiej (91181 in chips) 
Seat 6: G_haeffner (16892 in chips) 
DR. ELDAR: posts the ante 800
@tetaschell: posts the ante 800
vitor762: posts the ante 800
Scorgiej: posts the ante 800
G_haeffner: posts the ante 800
vitor762: posts small blind 1600
Scorgiej: posts big blind 3200
*** HOLE CARDS ***
G_haeffner: folds 
DR. ELDAR: folds 
@tetaschell: folds 
vitor762: calls 1600
Scorgiej: checks 
*** FLOP *** [9d Kd 4h]
vitor762: bets 3200
Scorgiej: folds 
Uncalled bet (3200) returned to vitor762
vitor762 collected 10400 from pot
vitor762: doesn't show hand 
*** SUMMARY ***
Total pot 10400 | Rake 0 
Board [9d Kd 4h]
Seat 1: DR. ELDAR folded before Flop (didn't bet)
Seat 3: @tetaschell (button) folded before Flop (didn't bet)
Seat 4: vitor762 (small blind) collected (10400)
Seat 5: Scorgiej (big blind) folded on the Flop
Seat 6: G_haeffner folded before Flop (didn't bet)

PokerStars Hand #251210050918: Tournament #3769361908, $52.38+$2.62 USD Hold'em No Limit - Level XX (1600/3200) - 2024/06/26 23:07:24 UTC [2024/06/26 19:07:24 ET]
Table '3769361908 12' 6-max Seat #4 is the button
Seat 1: DR. ELDAR (44045 in chips) 
Seat 3: @tetaschell (20112 in chips) 
Seat 4: vitor762 (66816 in chips) 
Seat 5: Scorgiej (87181 in chips) 
Seat 6: G_haeffner (16092 in chips) 
DR. ELDAR: posts the ante 800
@tetaschell: posts the ante 800
vitor762: posts the ante 800
Scorgiej: posts the ante 800
G_haeffner: posts the ante 800
Scorgiej: posts small blind 1600
G_haeffner: posts big blind 3200
*** HOLE CARDS ***
DR. ELDAR: folds 
@tetaschell: raises 16000 to 19200
vitor762: folds 
Scorgiej: folds 
G_haeffner: folds 
Uncalled bet (16000) returned to @tetaschell
@tetaschell collected 12000 from pot
@tetaschell: doesn't show hand 
*** SUMMARY ***
Total pot 12000 | Rake 0 
Seat 1: DR. ELDAR folded before Flop (didn't bet)
Seat 3: @tetaschell collected (12000)
Seat 4: vitor762 (button) folded before Flop (didn't bet)
Seat 5: Scorgiej (small blind) folded before Flop
Seat 6: G_haeffner (big blind) folded before Flop

PokerStars Hand #251210063048: Tournament #3769361908, $52.38+$2.62 USD Hold'em No Limit - Level XXI (1800/3600) - 2024/06/26 23:08:18 UTC [2024/06/26 19:08:18 ET]
Table '3769361908 12' 6-max Seat #5 is the button
Seat 1: DR. ELDAR (43245 in chips) 
Seat 3: @tetaschell (28112 in chips) 
Seat 4: vitor762 (66016 in chips) 
Seat 5: Scorgiej (84781 in chips) 
Seat 6: G_haeffner (12092 in chips) 
DR. ELDAR: posts the ante 900
@tetaschell: posts the ante 900
vitor762: posts the ante 900
Scorgiej: posts the ante 900
G_haeffner: posts the ante 900
G_haeffner: posts small blind 1800
DR. ELDAR: posts big blind 3600
*** HOLE CARDS ***
@tetaschell: folds 
vitor762: folds 
Scorgiej: raises 80281 to 83881 and is all-in
G_haeffner: folds 
DR. ELDAR: folds 
Uncalled bet (80281) returned to Scorgiej
Scorgiej collected 13500 from pot
Scorgiej: doesn't show hand 
*** SUMMARY ***
Total pot 13500 | Rake 0 
Seat 1: DR. ELDAR (big blind) folded before Flop
Seat 3: @tetaschell folded before Flop (didn't bet)
Seat 4: vitor762 folded before Flop (didn't bet)
Seat 5: Scorgiej (button) collected (13500)
Seat 6: G_haeffner (small blind) folded before Flop

PokerStars Hand #251210075601: Tournament #3769361908, $52.38+$2.62 USD Hold'em No Limit - Level XXI (1800/3600) - 2024/06/26 23:09:14 UTC [2024/06/26 19:09:14 ET]
Table '3769361908 12' 6-max Seat #6 is the button
Seat 1: DR. ELDAR (38745 in chips) 
Seat 3: @tetaschell (27212 in chips) 
Seat 4: vitor762 (65116 in chips) 
Seat 5: Scorgiej (93781 in chips) 
Seat 6: G_haeffner (9392 in chips) 
DR. ELDAR: posts the ante 900
@tetaschell: posts the ante 900
vitor762: posts the ante 900
Scorgiej: posts the ante 900
G_haeffner: posts the ante 900
DR. ELDAR: posts small blind 1800
@tetaschell: posts big blind 3600
*** HOLE CARDS ***
vitor762: folds 
Scorgiej: folds 
G_haeffner: folds 
DR. ELDAR: raises 34245 to 37845 and is all-in
@tetaschell: folds 
Uncalled bet (34245) returned to DR. ELDAR
DR. ELDAR collected 11700 from pot
DR. ELDAR: doesn't show hand 
*** SUMMARY ***
Total pot 11700 | Rake 0 
Seat 1: DR. ELDAR (small blind) collected (11700)
Seat 3: @tetaschell (big blind) folded before Flop
Seat 4: vitor762 folded before Flop (didn't bet)
Seat 5: Scorgiej folded before Flop (didn't bet)
Seat 6: G_haeffner (button) folded before Flop (didn't bet)

PokerStars Hand #251210087833: Tournament #3769361908, $52.38+$2.62 USD Hold'em No Limit - Level XXI (1800/3600) - 2024/06/26 23:10:10 UTC [2024/06/26 19:10:10 ET]
Table '3769361908 12' 6-max Seat #1 is the button
Seat 1: DR. ELDAR (45945 in chips) 
Seat 3: @tetaschell (22712 in chips) 
Seat 4: vitor762 (64216 in chips) 
Seat 5: Scorgiej (92881 in chips) 
Seat 6: G_haeffner (8492 in chips) 
DR. ELDAR: posts the ante 900
@tetaschell: posts the ante 900
vitor762: posts the ante 900
Scorgiej: posts the ante 900
G_haeffner: posts the ante 900
@tetaschell: posts small blind 1800
vitor762: posts big blind 3600
*** HOLE CARDS ***
Scorgiej: folds 
G_haeffner: raises 3600 to 7200
DR. ELDAR: folds 
@tetaschell: folds 
vitor762: calls 3600
*** FLOP *** [6h Ad 4d]
vitor762: bets 3600
G_haeffner: calls 392 and is all-in
Uncalled bet (3208) returned to vitor762
*** TURN *** [6h Ad 4d] [7d]
*** RIVER *** [6h Ad 4d 7d] [Js]
*** SHOW DOWN ***
vitor762: shows [2c Ac] (a pair of Aces)
G_haeffner: shows [Kh Qc] (high card Ace)
vitor762 collected 21484 from pot
G_haeffner finished the tournament in 63rd place
*** SUMMARY ***
Total pot 21484 | Rake 0 
Board [6h Ad 4d 7d Js]
Seat 1: DR. ELDAR (button) folded before Flop (didn't bet)
Seat 3: @tetaschell (small blind) folded before Flop
Seat 4: vitor762 (big blind) showed [2c Ac] and won (21484) with a pair of Aces
Seat 5: Scorgiej folded before Flop (didn't bet)
Seat 6: G_haeffner showed [Kh Qc] and lost with high card Ace

PokerStars Hand #251210099753: Tournament #3769361908, $52.38+$2.62 USD Hold'em No Limit - Level XXI (1800/3600) - 2024/06/26 23:11:04 UTC [2024/06/26 19:11:04 ET]
Table '3769361908 12' 6-max Seat #3 is the button
Seat 1: DR. ELDAR (45045 in chips) 
Seat 3: @tetaschell (20012 in chips) 
Seat 4: vitor762 (77208 in chips) 
Seat 5: Scorgiej (91981 in chips) 
DR. ELDAR: posts the ante 900
@tetaschell: posts the ante 900
vitor762: posts the ante 900
Scorgiej: posts the ante 900
vitor762: posts small blind 1800
Scorgiej: posts big blind 3600
*** HOLE CARDS ***
EqualizeSTAR is disconnected 
DR. ELDAR: folds 
@tetaschell: folds 
vitor762: folds 
Uncalled bet (1800) returned to Scorgiej
Scorgiej collected 7200 from pot
Scorgiej: doesn't show hand 
*** SUMMARY ***
Total pot 7200 | Rake 0 
Seat 1: DR. ELDAR folded before Flop (didn't bet)
Seat 3: @tetaschell (button) folded before Flop (didn't bet)
Seat 4: vitor762 (small blind) folded before Flop
Seat 5: Scorgiej (big blind) collected (7200)

PokerStars Hand #251210106072: Tournament #3769361908, $52.38+$2.62 USD Hold'em No Limit - Level XXII (2000/4000) - 2024/06/26 23:11:33 UTC [2024/06/26 19:11:33 ET]
Table '3769361908 12' 6-max Seat #4 is the button
Seat 1: DR. ELDAR (44145 in chips) 
Seat 3: @tetaschell (19112 in chips) 
Seat 4: vitor762 (74508 in chips) 
Seat 5: Scorgiej (96481 in chips) 
Seat 6: EqualizeSTAR (38358 in chips) 
DR. ELDAR: posts the ante 1000
@tetaschell: posts the ante 1000
vitor762: posts the ante 1000
Scorgiej: posts the ante 1000
EqualizeSTAR: posts the ante 1000
Scorgiej: posts small blind 2000
EqualizeSTAR: posts big blind 4000
*** HOLE CARDS ***
DR. ELDAR: folds 
@tetaschell: folds 
vitor762: raises 4000 to 8000
Scorgiej: folds 
EqualizeSTAR: calls 4000
*** FLOP *** [5d 5c 4c]
EqualizeSTAR: checks 
vitor762: bets 6000
pj0901 is disconnected 
EqualizeSTAR: folds 
Uncalled bet (6000) returned to vitor762
vitor762 collected 23000 from pot
vitor762: doesn't show hand 
*** SUMMARY ***
Total pot 23000 | Rake 0 
Board [5d 5c 4c]
Seat 1: DR. ELDAR folded before Flop (didn't bet)
Seat 3: @tetaschell folded before Flop (didn't bet)
Seat 4: vitor762 (button) collected (23000)
Seat 5: Scorgiej (small blind) folded before Flop
Seat 6: EqualizeSTAR (big blind) folded on the Flop

PokerStars Hand #251210129375: Tournament #3769361908, $52.38+$2.62 USD Hold'em No Limit - Level XXII (2000/4000) - 2024/06/26 23:13:22 UTC [2024/06/26 19:13:22 ET]
Table '3769361908 12' 6-max Seat #5 is the button
Seat 1: DR. ELDAR (43145 in chips) 
Seat 2: pj0901 (25996 in chips) 
Seat 3: @tetaschell (18112 in chips) 
Seat 4: vitor762 (88508 in chips) 
Seat 5: Scorgiej (93481 in chips) 
Seat 6: EqualizeSTAR (29358 in chips) 
DR. ELDAR: posts the ante 1000
pj0901: posts the ante 1000
@tetaschell: posts the ante 1000
vitor762: posts the ante 1000
Scorgiej: posts the ante 1000
EqualizeSTAR: posts the ante 1000
EqualizeSTAR: posts small blind 2000
DR. ELDAR: posts big blind 4000
*** HOLE CARDS ***
pj0901: raises 20000 to 24000
@tetaschell: folds 
vitor762: folds 
Scorgiej: folds 
EqualizeSTAR: folds 
DR. ELDAR: folds 
Uncalled bet (20000) returned to pj0901
pj0901 collected 16000 from pot
pj0901: doesn't show hand 
*** SUMMARY ***
Total pot 16000 | Rake 0 
Seat 1: DR. ELDAR (big blind) folded before Flop
Seat 2: pj0901 collected (16000)
Seat 3: @tetaschell folded before Flop (didn't bet)
Seat 4: vitor762 folded before Flop (didn't bet)
Seat 5: Scorgiej (button) folded before Flop (didn't bet)
Seat 6: EqualizeSTAR (small blind) folded before Flop

PokerStars Hand #251210133891: Tournament #3769361908, $52.38+$2.62 USD Hold'em No Limit - Level XXII (2000/4000) - 2024/06/26 23:13:42 UTC [2024/06/26 19:13:42 ET]
Table '3769361908 12' 6-max Seat #6 is the button
Seat 1: DR. ELDAR (38145 in chips) 
Seat 2: pj0901 (36996 in chips) 
Seat 3: @tetaschell (17112 in chips) 
Seat 4: vitor762 (87508 in chips) 
Seat 5: Scorgiej (92481 in chips) 
Seat 6: EqualizeSTAR (26358 in chips) 
DR. ELDAR: posts the ante 1000
pj0901: posts the ante 1000
@tetaschell: posts the ante 1000
vitor762: posts the ante 1000
Scorgiej: posts the ante 1000
EqualizeSTAR: posts the ante 1000
DR. ELDAR: posts small blind 2000
pj0901: posts big blind 4000
*** HOLE CARDS ***
@tetaschell: folds 
vitor762: folds 
Scorgiej: folds 
EqualizeSTAR: folds 
DR. ELDAR: folds 
Uncalled bet (2000) returned to pj0901
pj0901 collected 10000 from pot
pj0901: doesn't show hand 
*** SUMMARY ***
Total pot 10000 | Rake 0 
Seat 1: DR. ELDAR (small blind) folded before Flop
Seat 2: pj0901 (big blind) collected (10000)
Seat 3: @tetaschell folded before Flop (didn't bet)
Seat 4: vitor762 folded before Flop (didn't bet)
Seat 5: Scorgiej folded before Flop (didn't bet)
Seat 6: EqualizeSTAR (button) folded before Flop (didn't bet)

PokerStars Hand #251210141457: Tournament #3769361908, $52.38+$2.62 USD Hold'em No Limit - Level XXIII (2500/5000) - 2024/06/26 23:14:18 UTC [2024/06/26 19:14:18 ET]
Table '3769361908 12' 6-max Seat #1 is the button
Seat 1: DR. ELDAR (35145 in chips) 
Seat 2: pj0901 (43996 in chips) 
Seat 3: @tetaschell (16112 in chips) 
Seat 4: vitor762 (86508 in chips) 
Seat 5: Scorgiej (91481 in chips) 
Seat 6: EqualizeSTAR (25358 in chips) 
DR. ELDAR: posts the ante 1250
pj0901: posts the ante 1250
@tetaschell: posts the ante 1250
vitor762: posts the ante 1250
Scorgiej: posts the ante 1250
EqualizeSTAR: posts the ante 1250
pj0901: posts small blind 2500
@tetaschell: posts big blind 5000
*** HOLE CARDS ***
vitor762: folds 
Scorgiej: folds 
EqualizeSTAR: folds 
DR. ELDAR: folds 
pj0901: raises 8500 to 13500
@tetaschell: raises 1362 to 14862 and is all-in
pj0901: calls 1362
*** FLOP *** [2h 5c 7c]
*** TURN *** [2h 5c 7c] [6s]
*** RIVER *** [2h 5c 7c 6s] [3h]
*** SHOW DOWN ***
pj0901: shows [Th 6d] (a pair of Sixes)
@tetaschell: shows [3s Ks] (a pair of Threes)
pj0901 collected 37224 from pot
@tetaschell finished the tournament in 52nd place and received $91.90.
*** SUMMARY ***
Total pot 37224 | Rake 0 
Board [2h 5c 7c 6s 3h]
Seat 1: DR. ELDAR (button) folded before Flop (didn't bet)
Seat 2: pj0901 (small blind) showed [Th 6d] and won (37224) with a pair of Sixes
Seat 3: @tetaschell (big blind) showed [3s Ks] and lost with a pair of Threes
Seat 4: vitor762 folded before Flop (didn't bet)
Seat 5: Scorgiej folded before Flop (didn't bet)
Seat 6: EqualizeSTAR folded before Flop (didn't bet)

PokerStars Hand #251210152125: Tournament #3769361908, $52.38+$2.62 USD Hold'em No Limit - Level XXIII (2500/5000) - 2024/06/26 23:15:07 UTC [2024/06/26 19:15:07 ET]
Table '3769361908 12' 6-max Seat #2 is the button
Seat 1: DR. ELDAR (33895 in chips) 
Seat 2: pj0901 (65108 in chips) 
Seat 4: vitor762 (85258 in chips) 
Seat 5: Scorgiej (90231 in chips) 
Seat 6: EqualizeSTAR (24108 in chips) 
DR. ELDAR: posts the ante 1250
pj0901: posts the ante 1250
vitor762: posts the ante 1250
Scorgiej: posts the ante 1250
EqualizeSTAR: posts the ante 1250
vitor762: posts small blind 2500
Scorgiej: posts big blind 5000
*** HOLE CARDS ***
EqualizeSTAR: folds 
DR. ELDAR: folds 
pj0901: folds 
vitor762: calls 2500
Scorgiej: raises 8500 to 13500
vitor762: raises 70508 to 84008 and is all-in
Scorgiej: folds 
Uncalled bet (70508) returned to vitor762
vitor762 collected 33250 from pot
vitor762: doesn't show hand 
*** SUMMARY ***
Total pot 33250 | Rake 0 
Seat 1: DR. ELDAR folded before Flop (didn't bet)
Seat 2: pj0901 (button) folded before Flop (didn't bet)
Seat 4: vitor762 (small blind) collected (33250)
Seat 5: Scorgiej (big blind) folded before Flop
Seat 6: EqualizeSTAR folded before Flop (didn't bet)

PokerStars Hand #251210163884: Tournament #3769361908, $52.38+$2.62 USD Hold'em No Limit - Level XXIII (2500/5000) - 2024/06/26 23:16:02 UTC [2024/06/26 19:16:02 ET]
Table '3769361908 12' 6-max Seat #4 is the button
Seat 1: DR. ELDAR (32645 in chips) 
Seat 2: pj0901 (63858 in chips) 
Seat 3: assalbi (87332 in chips) 
Seat 4: vitor762 (103758 in chips) 
Seat 5: Scorgiej (75481 in chips) 
Seat 6: EqualizeSTAR (22858 in chips) 
DR. ELDAR: posts the ante 1250
pj0901: posts the ante 1250
assalbi: posts the ante 1250
vitor762: posts the ante 1250
Scorgiej: posts the ante 1250
EqualizeSTAR: posts the ante 1250
Scorgiej: posts small blind 2500
EqualizeSTAR: posts big blind 5000
*** HOLE CARDS ***
DR. ELDAR: folds 
pj0901: folds 
assalbi: folds 
vitor762: folds 
Scorgiej: folds 
Uncalled bet (2500) returned to EqualizeSTAR
EqualizeSTAR collected 12500 from pot
EqualizeSTAR: doesn't show hand 
*** SUMMARY ***
Total pot 12500 | Rake 0 
Seat 1: DR. ELDAR folded before Flop (didn't bet)
Seat 2: pj0901 folded before Flop (didn't bet)
Seat 3: assalbi folded before Flop (didn't bet)
Seat 4: vitor762 (button) folded before Flop (didn't bet)
Seat 5: Scorgiej (small blind) folded before Flop
Seat 6: EqualizeSTAR (big blind) collected (12500)

PokerStars Hand #251210170856: Tournament #3769361908, $52.38+$2.62 USD Hold'em No Limit - Level XXIII (2500/5000) - 2024/06/26 23:16:34 UTC [2024/06/26 19:16:34 ET]
Table '3769361908 12' 6-max Seat #5 is the button
Seat 1: DR. ELDAR (31395 in chips) 
Seat 2: pj0901 (62608 in chips) 
Seat 3: assalbi (86082 in chips) 
Seat 4: vitor762 (102508 in chips) 
Seat 5: Scorgiej (71731 in chips) 
Seat 6: EqualizeSTAR (31608 in chips) 
DR. ELDAR: posts the ante 1250
pj0901: posts the ante 1250
assalbi: posts the ante 1250
vitor762: posts the ante 1250
Scorgiej: posts the ante 1250
EqualizeSTAR: posts the ante 1250
EqualizeSTAR: posts small blind 2500
DR. ELDAR: posts big blind 5000
*** HOLE CARDS ***
pj0901: folds 
assalbi: folds 
vitor762: folds 
Scorgiej: folds 
EqualizeSTAR: raises 25358 to 30358 and is all-in
DR. ELDAR: folds 
Uncalled bet (25358) returned to EqualizeSTAR
EqualizeSTAR collected 17500 from pot
EqualizeSTAR: doesn't show hand 
*** SUMMARY ***
Total pot 17500 | Rake 0 
Seat 1: DR. ELDAR (big blind) folded before Flop
Seat 2: pj0901 folded before Flop (didn't bet)
Seat 3: assalbi folded before Flop (didn't bet)
Seat 4: vitor762 folded before Flop (didn't bet)
Seat 5: Scorgiej (button) folded before Flop (didn't bet)
Seat 6: EqualizeSTAR (small blind) collected (17500)

PokerStars Hand #251210177558: Tournament #3769361908, $52.38+$2.62 USD Hold'em No Limit - Level XXIII (2500/5000) - 2024/06/26 23:17:06 UTC [2024/06/26 19:17:06 ET]
Table '3769361908 12' 6-max Seat #6 is the button
Seat 1: DR. ELDAR (25145 in chips) 
Seat 2: pj0901 (61358 in chips) 
Seat 3: assalbi (84832 in chips) 
Seat 4: vitor762 (101258 in chips) 
Seat 5: Scorgiej (70481 in chips) 
Seat 6: EqualizeSTAR (42858 in chips) 
DR. ELDAR: posts the ante 1250
pj0901: posts the ante 1250
assalbi: posts the ante 1250
vitor762: posts the ante 1250
Scorgiej: posts the ante 1250
EqualizeSTAR: posts the ante 1250
DR. ELDAR: posts small blind 2500
pj0901: posts big blind 5000
*** HOLE CARDS ***
assalbi: folds 
vitor762: folds 
Scorgiej: folds 
EqualizeSTAR: folds 
DR. ELDAR: raises 18895 to 23895 and is all-in
pj0901: folds 
Uncalled bet (18895) returned to DR. ELDAR
DR. ELDAR collected 17500 from pot
DR. ELDAR: doesn't show hand 
*** SUMMARY ***
Total pot 17500 | Rake 0 
Seat 1: DR. ELDAR (small blind) collected (17500)
Seat 2: pj0901 (big blind) folded before Flop
Seat 3: assalbi folded before Flop (didn't bet)
Seat 4: vitor762 folded before Flop (didn't bet)
Seat 5: Scorgiej folded before Flop (didn't bet)
Seat 6: EqualizeSTAR (button) folded before Flop (didn't bet)

PokerStars Hand #251210185839: Tournament #3769361908, $52.38+$2.62 USD Hold'em No Limit - Level XXIV (3000/6000) - 2024/06/26 23:17:45 UTC [2024/06/26 19:17:45 ET]
Table '3769361908 12' 6-max Seat #1 is the button
Seat 1: DR. ELDAR (36395 in chips) 
Seat 2: pj0901 (55108 in chips) 
Seat 3: assalbi (83582 in chips) 
Seat 4: vitor762 (100008 in chips) 
Seat 5: Scorgiej (69231 in chips) 
Seat 6: EqualizeSTAR (41608 in chips) 
DR. ELDAR: posts the ante 1500
pj0901: posts the ante 1500
assalbi: posts the ante 1500
vitor762: posts the ante 1500
Scorgiej: posts the ante 1500
EqualizeSTAR: posts the ante 1500
pj0901: posts small blind 3000
assalbi: posts big blind 6000
*** HOLE CARDS ***
vitor762: folds 
Scorgiej: folds 
EqualizeSTAR: folds 
DR. ELDAR: raises 28895 to 34895 and is all-in
pj0901: folds 
assalbi: folds 
Uncalled bet (28895) returned to DR. ELDAR
DR. ELDAR collected 24000 from pot
DR. ELDAR: doesn't show hand 
*** SUMMARY ***
Total pot 24000 | Rake 0 
Seat 1: DR. ELDAR (button) collected (24000)
Seat 2: pj0901 (small blind) folded before Flop
Seat 3: assalbi (big blind) folded before Flop
Seat 4: vitor762 folded before Flop (didn't bet)
Seat 5: Scorgiej folded before Flop (didn't bet)
Seat 6: EqualizeSTAR folded before Flop (didn't bet)

PokerStars Hand #251210194137: Tournament #3769361908, $52.38+$2.62 USD Hold'em No Limit - Level XXIV (3000/6000) - 2024/06/26 23:18:24 UTC [2024/06/26 19:18:24 ET]
Table '3769361908 12' 6-max Seat #2 is the button
Seat 1: DR. ELDAR (52895 in chips) 
Seat 2: pj0901 (50608 in chips) 
Seat 3: assalbi (76082 in chips) 
Seat 4: vitor762 (98508 in chips) 
Seat 5: Scorgiej (67731 in chips) 
Seat 6: EqualizeSTAR (40108 in chips) 
DR. ELDAR: posts the ante 1500
pj0901: posts the ante 1500
assalbi: posts the ante 1500
vitor762: posts the ante 1500
Scorgiej: posts the ante 1500
EqualizeSTAR: posts the ante 1500
assalbi: posts small blind 3000
vitor762: posts big blind 6000
*** HOLE CARDS ***
Scorgiej: raises 60231 to 66231 and is all-in
EqualizeSTAR: folds 
DR. ELDAR: folds 
pj0901: folds 
assalbi: folds 
vitor762: folds 
Uncalled bet (60231) returned to Scorgiej
Scorgiej collected 24000 from pot
Scorgiej: doesn't show hand 
*** SUMMARY ***
Total pot 24000 | Rake 0 
Seat 1: DR. ELDAR folded before Flop (didn't bet)
Seat 2: pj0901 (button) folded before Flop (didn't bet)
Seat 3: assalbi (small blind) folded before Flop
Seat 4: vitor762 (big blind) folded before Flop
Seat 5: Scorgiej collected (24000)
Seat 6: EqualizeSTAR folded before Flop (didn't bet)

PokerStars Hand #251210200770: Tournament #3769361908, $52.38+$2.62 USD Hold'em No Limit - Level XXIV (3000/6000) - 2024/06/26 23:18:56 UTC [2024/06/26 19:18:56 ET]
Table '3769361908 12' 6-max Seat #3 is the button
Seat 1: DR. ELDAR (51395 in chips) 
Seat 2: pj0901 (49108 in chips) 
Seat 3: assalbi (71582 in chips) 
Seat 4: vitor762 (91008 in chips) 
Seat 5: Scorgiej (84231 in chips) 
Seat 6: EqualizeSTAR (38608 in chips) 
DR. ELDAR: posts the ante 1500
pj0901: posts the ante 1500
assalbi: posts the ante 1500
vitor762: posts the ante 1500
Scorgiej: posts the ante 1500
EqualizeSTAR: posts the ante 1500
vitor762: posts small blind 3000
Scorgiej: posts big blind 6000
*** HOLE CARDS ***
EqualizeSTAR: folds 
DR. ELDAR: folds 
pj0901: folds 
assalbi: folds 
vitor762: calls 3000
Scorgiej: checks 
*** FLOP *** [9d 7c Qh]
vitor762: bets 6930
Scorgiej: calls 6930
*** TURN *** [9d 7c Qh] [Kd]
vitor762: bets 21600
Scorgiej: folds 
Uncalled bet (21600) returned to vitor762
vitor762 collected 34860 from pot
vitor762: doesn't show hand 
*** SUMMARY ***
Total pot 34860 | Rake 0 
Board [9d 7c Qh Kd]
Seat 1: DR. ELDAR folded before Flop (didn't bet)
Seat 2: pj0901 folded before Flop (didn't bet)
Seat 3: assalbi (button) folded before Flop (didn't bet)
Seat 4: vitor762 (small blind) collected (34860)
Seat 5: Scorgiej (big blind) folded on the Turn
Seat 6: EqualizeSTAR folded before Flop (didn't bet)

PokerStars Hand #251210213337: Tournament #3769361908, $52.38+$2.62 USD Hold'em No Limit - Level XXIV (3000/6000) - 2024/06/26 23:19:56 UTC [2024/06/26 19:19:56 ET]
Table '3769361908 12' 6-max Seat #4 is the button
Seat 1: DR. ELDAR (49895 in chips) 
Seat 2: pj0901 (47608 in chips) 
Seat 3: assalbi (70082 in chips) 
Seat 4: vitor762 (111438 in chips) 
Seat 5: Scorgiej (69801 in chips) 
Seat 6: EqualizeSTAR (37108 in chips) 
DR. ELDAR: posts the ante 1500
pj0901: posts the ante 1500
assalbi: posts the ante 1500
vitor762: posts the ante 1500
Scorgiej: posts the ante 1500
EqualizeSTAR: posts the ante 1500
Scorgiej: posts small blind 3000
EqualizeSTAR: posts big blind 6000
*** HOLE CARDS ***
DR. ELDAR: raises 6600 to 12600
pj0901: folds 
assalbi: folds 
vitor762: folds 
Scorgiej: folds 
EqualizeSTAR: raises 23008 to 35608 and is all-in
DR. ELDAR: calls 23008
*** FLOP *** [6c Jd 5s]
*** TURN *** [6c Jd 5s] [Ks]
*** RIVER *** [6c Jd 5s Ks] [2h]
*** SHOW DOWN ***
EqualizeSTAR: shows [8c Ad] (high card Ace)
DR. ELDAR: shows [Jc Tc] (a pair of Jacks)
DR. ELDAR collected 83216 from pot
EqualizeSTAR finished the tournament in 32nd place and received $111.65.
*** SUMMARY ***
Total pot 83216 | Rake 0 
Board [6c Jd 5s Ks 2h]
Seat 1: DR. ELDAR showed [Jc Tc] and won (83216) with a pair of Jacks
Seat 2: pj0901 folded before Flop (didn't bet)
Seat 3: assalbi folded before Flop (didn't bet)
Seat 4: vitor762 (button) folded before Flop (didn't bet)
Seat 5: Scorgiej (small blind) folded before Flop
Seat 6: EqualizeSTAR (big blind) showed [8c Ad] and lost with high card Ace

PokerStars Hand #251210224391: Tournament #3769361908, $52.38+$2.62 USD Hold'em No Limit - Level XXV (3500/7000) - 2024/06/26 23:20:49 UTC [2024/06/26 19:20:49 ET]
Table '3769361908 12' 6-max Seat #5 is the button
Seat 1: DR. ELDAR (96003 in chips) 
Seat 2: pj0901 (46108 in chips) 
Seat 3: assalbi (68582 in chips) 
Seat 4: vitor762 (109938 in chips) 
Seat 5: Scorgiej (65301 in chips) 
DR. ELDAR: posts the ante 1750
pj0901: posts the ante 1750
assalbi: posts the ante 1750
vitor762: posts the ante 1750
Scorgiej: posts the ante 1750
DR. ELDAR: posts small blind 3500
pj0901: posts big blind 7000
*** HOLE CARDS ***
assalbi: folds 
vitor762: folds 
Scorgiej: folds 
DR. ELDAR: folds 
Uncalled bet (3500) returned to pj0901
pj0901 collected 15750 from pot
pj0901: doesn't show hand 
*** SUMMARY ***
Total pot 15750 | Rake 0 
Seat 1: DR. ELDAR (small blind) folded before Flop
Seat 2: pj0901 (big blind) collected (15750)
Seat 3: assalbi folded before Flop (didn't bet)
Seat 4: vitor762 folded before Flop (didn't bet)
Seat 5: Scorgiej (button) folded before Flop (didn't bet)

PokerStars Hand #251210228730: Tournament #3769361908, $52.38+$2.62 USD Hold'em No Limit - Level XXV (3500/7000) - 2024/06/26 23:21:10 UTC [2024/06/26 19:21:10 ET]
Table '3769361908 12' 6-max Seat #1 is the button
Seat 1: DR. ELDAR (90753 in chips) 
Seat 2: pj0901 (56608 in chips) 
Seat 3: assalbi (66832 in chips) 
Seat 4: vitor762 (108188 in chips) 
Seat 5: Scorgiej (63551 in chips) 
Seat 6: sinister778 (114122 in chips) 
DR. ELDAR: posts the ante 1750
pj0901: posts the ante 1750
assalbi: posts the ante 1750
vitor762: posts the ante 1750
Scorgiej: posts the ante 1750
sinister778: posts the ante 1750
pj0901: posts small blind 3500
assalbi: posts big blind 7000
*** HOLE CARDS ***
vitor762: folds 
Scorgiej: folds 
sinister778: raises 7000 to 14000
DR. ELDAR: folds 
pj0901: folds 
assalbi: folds 
Uncalled bet (7000) returned to sinister778
sinister778 collected 28000 from pot
*** SUMMARY ***
Total pot 28000 | Rake 0 
Seat 1: DR. ELDAR (button) folded before Flop (didn't bet)
Seat 2: pj0901 (small blind) folded before Flop
Seat 3: assalbi (big blind) folded before Flop
Seat 4: vitor762 folded before Flop (didn't bet)
Seat 5: Scorgiej folded before Flop (didn't bet)
Seat 6: sinister778 collected (28000)

PokerStars Hand #251210235643: Tournament #3769361908, $52.38+$2.62 USD Hold'em No Limit - Level XXV (3500/7000) - 2024/06/26 23:21:43 UTC [2024/06/26 19:21:43 ET]
Table '3769361908 12' 6-max Seat #2 is the button
Seat 1: DR. ELDAR (89003 in chips) 
Seat 2: pj0901 (51358 in chips) 
Seat 3: assalbi (58082 in chips) 
Seat 4: vitor762 (106438 in chips) 
Seat 5: Scorgiej (61801 in chips) 
Seat 6: sinister778 (133372 in chips) 
DR. ELDAR: posts the ante 1750
pj0901: posts the ante 1750
assalbi: posts the ante 1750
vitor762: posts the ante 1750
Scorgiej: posts the ante 1750
sinister778: posts the ante 1750
assalbi: posts small blind 3500
vitor762: posts big blind 7000
*** HOLE CARDS ***
Scorgiej: folds 
sinister778: folds 
DR. ELDAR: raises 80253 to 87253 and is all-in
pj0901: folds 
assalbi: folds 
vitor762: calls 80253
*** FLOP *** [Qd Tc Qh]
*** TURN *** [Qd Tc Qh] [6s]
*** RIVER *** [Qd Tc Qh 6s] [Ks]
*** SHOW DOWN ***
vitor762: shows [9s 9h] (two pair, Queens and Nines)
DR. ELDAR: shows [Kd 7c] (two pair, Kings and Queens)
DR. ELDAR collected 188506 from pot
*** SUMMARY ***
Total pot 188506 | Rake 0 
Board [Qd Tc Qh 6s Ks]
Seat 1: DR. ELDAR showed [Kd 7c] and won (188506) with two pair, Kings and Queens
Seat 2: pj0901 (button) folded before Flop (didn't bet)
Seat 3: assalbi (small blind) folded before Flop
Seat 4: vitor762 (big blind) showed [9s 9h] and lost with two pair, Queens and Nines
Seat 5: Scorgiej folded before Flop (didn't bet)
Seat 6: sinister778 folded before Flop (didn't bet)

PokerStars Hand #251210243687: Tournament #3769361908, $52.38+$2.62 USD Hold'em No Limit - Level XXV (3500/7000) - 2024/06/26 23:22:22 UTC [2024/06/26 19:22:22 ET]
Table '3769361908 12' 6-max Seat #3 is the button
Seat 1: DR. ELDAR (188506 in chips) 
Seat 2: pj0901 (49608 in chips) 
Seat 3: assalbi (52832 in chips) 
Seat 4: vitor762 (17435 in chips) 
Seat 5: Scorgiej (60051 in chips) 
DR. ELDAR: posts the ante 1750
pj0901: posts the ante 1750
assalbi: posts the ante 1750
vitor762: posts the ante 1750
Scorgiej: posts the ante 1750
vitor762: posts small blind 3500
Scorgiej: posts big blind 7000
*** HOLE CARDS ***
DR. ELDAR: folds 
pj0901: raises 35000 to 42000
assalbi: folds 
vitor762: folds 
Scorgiej: folds 
Uncalled bet (35000) returned to pj0901
pj0901 collected 26250 from pot
pj0901: doesn't show hand 
*** SUMMARY ***
Total pot 26250 | Rake 0 
Seat 1: DR. ELDAR folded before Flop (didn't bet)
Seat 2: pj0901 collected (26250)
Seat 3: assalbi (button) folded before Flop (didn't bet)
Seat 4: vitor762 (small blind) folded before Flop
Seat 5: Scorgiej (big blind) folded before Flop

PokerStars Hand #251210247972: Tournament #3769361908, $52.38+$2.62 USD Hold'em No Limit - Level XXV (3500/7000) - 2024/06/26 23:22:43 UTC [2024/06/26 19:22:43 ET]
Table '3769361908 12' 6-max Seat #4 is the button
Seat 1: DR. ELDAR (186756 in chips) 
Seat 2: pj0901 (67108 in chips) 
Seat 3: assalbi (51082 in chips) 
Seat 4: vitor762 (12185 in chips) 
Seat 5: Scorgiej (51301 in chips) 
DR. ELDAR: posts the ante 1750
pj0901: posts the ante 1750
assalbi: posts the ante 1750
vitor762: posts the ante 1750
Scorgiej: posts the ante 1750
Scorgiej: posts small blind 3500
DR. ELDAR: posts big blind 7000
*** HOLE CARDS ***
pj0901: folds 
assalbi: folds 
vitor762: folds 
Scorgiej: folds 
Uncalled bet (3500) returned to DR. ELDAR
DR. ELDAR collected 15750 from pot
DR. ELDAR: doesn't show hand 
*** SUMMARY ***
Total pot 15750 | Rake 0 
Seat 1: DR. ELDAR (big blind) collected (15750)
Seat 2: pj0901 folded before Flop (didn't bet)
Seat 3: assalbi folded before Flop (didn't bet)
Seat 4: vitor762 (button) folded before Flop (didn't bet)
Seat 5: Scorgiej (small blind) folded before Flop

PokerStars Hand #251210252890: Tournament #3769361908, $52.38+$2.62 USD Hold'em No Limit - Level XXV (3500/7000) - 2024/06/26 23:23:06 UTC [2024/06/26 19:23:06 ET]
Table '3769361908 12' 6-max Seat #5 is the button
Seat 1: DR. ELDAR (197256 in chips) 
Seat 2: pj0901 (65358 in chips) 
Seat 3: assalbi (49332 in chips) 
Seat 4: vitor762 (10435 in chips) 
Seat 5: Scorgiej (46051 in chips) 
DR. ELDAR: posts the ante 1750
pj0901: posts the ante 1750
assalbi: posts the ante 1750
vitor762: posts the ante 1750
Scorgiej: posts the ante 1750
DR. ELDAR: posts small blind 3500
pj0901: posts big blind 7000
*** HOLE CARDS ***
assalbi: raises 40582 to 47582 and is all-in
vitor762: folds 
Scorgiej: folds 
DR. ELDAR: folds 
pj0901: folds 
Uncalled bet (40582) returned to assalbi
assalbi collected 26250 from pot
assalbi: doesn't show hand 
*** SUMMARY ***
Total pot 26250 | Rake 0 
Seat 1: DR. ELDAR (small blind) folded before Flop
Seat 2: pj0901 (big blind) folded before Flop
Seat 3: assalbi collected (26250)
Seat 4: vitor762 folded before Flop (didn't bet)
Seat 5: Scorgiej (button) folded before Flop (didn't bet)

PokerStars Hand #251210258247: Tournament #3769361908, $52.38+$2.62 USD Hold'em No Limit - Level XXVI (4000/8000) - 2024/06/26 23:23:32 UTC [2024/06/26 19:23:32 ET]
Table '3769361908 12' 6-max Seat #1 is the button
Seat 1: DR. ELDAR (192006 in chips) 
Seat 2: pj0901 (56608 in chips) 
Seat 3: assalbi (66832 in chips) 
Seat 4: vitor762 (8685 in chips) 
Seat 5: Scorgiej (44301 in chips) 
DR. ELDAR: posts the ante 2000
pj0901: posts the ante 2000
assalbi: posts the ante 2000
vitor762: posts the ante 2000
Scorgiej: posts the ante 2000
pj0901: posts small blind 4000
assalbi: posts big blind 8000
*** HOLE CARDS ***
vitor762: calls 6685 and is all-in
Scorgiej: folds 
DR. ELDAR: folds 
pj0901: raises 44000 to 52000
assalbi: folds 
Uncalled bet (44000) returned to pj0901
*** FLOP *** [7s 4h Jc]
*** TURN *** [7s 4h Jc] [2s]
*** RIVER *** [7s 4h Jc 2s] [9h]
*** SHOW DOWN ***
pj0901: shows [Kc 6h] (high card King)
pj0901 collected 2630 from side pot
vitor762: shows [Qs Ac] (high card Ace)
vitor762 collected 30055 from main pot
*** SUMMARY ***
Total pot 32685 Main pot 30055. Side pot 2630. | Rake 0 
Board [7s 4h Jc 2s 9h]
Seat 1: DR. ELDAR (button) folded before Flop (didn't bet)
Seat 2: pj0901 (small blind) showed [Kc 6h] and won (2630) with high card King
Seat 3: assalbi (big blind) folded before Flop
Seat 4: vitor762 showed [Qs Ac] and won (30055) with high card Ace
Seat 5: Scorgiej folded before Flop (didn't bet)

PokerStars Hand #251210266461: Tournament #3769361908, $52.38+$2.62 USD Hold'em No Limit - Level XXVI (4000/8000) - 2024/06/26 23:24:12 UTC [2024/06/26 19:24:12 ET]
Table '3769361908 12' 6-max Seat #2 is the button
Seat 1: DR. ELDAR (190006 in chips) 
Seat 2: pj0901 (49238 in chips) 
Seat 3: assalbi (56832 in chips) 
Seat 4: vitor762 (30055 in chips) 
Seat 5: Scorgiej (42301 in chips) 
DR. ELDAR: posts the ante 2000
pj0901: posts the ante 2000
assalbi: posts the ante 2000
vitor762: posts the ante 2000
Scorgiej: posts the ante 2000
assalbi: posts small blind 4000
vitor762: posts big blind 8000
*** HOLE CARDS ***
Scorgiej: raises 32000 to 40000
DR. ELDAR: folds 
pj0901: folds 
assalbi: raises 14832 to 54832 and is all-in
vitor762: folds 
Scorgiej: calls 301 and is all-in
Uncalled bet (14531) returned to assalbi
*** FLOP *** [8d Qc 7s]
*** TURN *** [8d Qc 7s] [5h]
*** RIVER *** [8d Qc 7s 5h] [7c]
*** SHOW DOWN ***
assalbi: shows [Ac Ks] (a pair of Sevens)
Scorgiej: shows [7h 7d] (four of a kind, Sevens)
Scorgiej collected 98602 from pot
*** SUMMARY ***
Total pot 98602 | Rake 0 
Board [8d Qc 7s 5h 7c]
Seat 1: DR. ELDAR folded before Flop (didn't bet)
Seat 2: pj0901 (button) folded before Flop (didn't bet)
Seat 3: assalbi (small blind) showed [Ac Ks] and lost with a pair of Sevens
Seat 4: vitor762 (big blind) folded before Flop
Seat 5: Scorgiej showed [7h 7d] and won (98602) with four of a kind, Sevens

PokerStars Hand #251210277132: Tournament #3769361908, $52.38+$2.62 USD Hold'em No Limit - Level XXVI (4000/8000) - 2024/06/26 23:25:04 UTC [2024/06/26 19:25:04 ET]
Table '3769361908 12' 6-max Seat #3 is the button
Seat 1: DR. ELDAR (188006 in chips) 
Seat 2: pj0901 (47238 in chips) 
Seat 3: assalbi (14531 in chips) 
Seat 4: vitor762 (20055 in chips) 
Seat 5: Scorgiej (98602 in chips) 
DR. ELDAR: posts the ante 2000
pj0901: posts the ante 2000
assalbi: posts the ante 2000
vitor762: posts the ante 2000
Scorgiej: posts the ante 2000
vitor762: posts small blind 4000
Scorgiej: posts big blind 8000
*** HOLE CARDS ***
DR. ELDAR: folds 
pj0901: folds 
assalbi: raises 4531 to 12531 and is all-in
vitor762: folds 
Scorgiej: calls 4531
*** FLOP *** [8h 6c 3h]
*** TURN *** [8h 6c 3h] [As]
*** RIVER *** [8h 6c 3h As] [Kc]
*** SHOW DOWN ***
Scorgiej: shows [Ah 9c] (a pair of Aces)
assalbi: shows [7h Jd] (high card Ace)
Scorgiej collected 39062 from pot
assalbi finished the tournament in 27th place and received $135.63.
*** SUMMARY ***
Total pot 39062 | Rake 0 
Board [8h 6c 3h As Kc]
Seat 1: DR. ELDAR folded before Flop (didn't bet)
Seat 2: pj0901 folded before Flop (didn't bet)
Seat 3: assalbi (button) showed [7h Jd] and lost with high card Ace
Seat 4: vitor762 (small blind) folded before Flop
Seat 5: Scorgiej (big blind) showed [Ah 9c] and won (39062) with a pair of Aces

PokerStars Hand #251210283587: Tournament #3769361908, $52.38+$2.62 USD Hold'em No Limit - Level XXVI (4000/8000) - 2024/06/26 23:25:35 UTC [2024/06/26 19:25:35 ET]
Table '3769361908 12' 6-max Seat #4 is the button
Seat 1: DR. ELDAR (186006 in chips) 
Seat 2: pj0901 (45238 in chips) 
Seat 4: vitor762 (14055 in chips) 
Seat 5: Scorgiej (123133 in chips) 
DR. ELDAR: posts the ante 2000
pj0901: posts the ante 2000
vitor762: posts the ante 2000
Scorgiej: posts the ante 2000
Scorgiej: posts small blind 4000
DR. ELDAR: posts big blind 8000
*** HOLE CARDS ***
pj0901: folds 
vitor762: raises 4055 to 12055 and is all-in
chrichrac is disconnected 
Scorgiej: calls 8055
DR. ELDAR: calls 4055
*** FLOP *** [8h 2h 7h]
Scorgiej: checks 
DR. ELDAR: checks 
*** TURN *** [8h 2h 7h] [8d]
Scorgiej: checks 
DR. ELDAR: checks 
*** RIVER *** [8h 2h 7h 8d] [2d]
Scorgiej: checks 
DR. ELDAR: checks 
*** SHOW DOWN ***
Scorgiej: shows [Jh 9d] (two pair, Eights and Deuces)
DR. ELDAR: shows [Js Td] (two pair, Eights and Deuces)
vitor762: shows [Ks 8c] (a full house, Eights full of Deuces)
vitor762 collected 44165 from pot
*** SUMMARY ***
Total pot 44165 | Rake 0 
Board [8h 2h 7h 8d 2d]
Seat 1: DR. ELDAR (big blind) showed [Js Td] and lost with two pair, Eights and Deuces
Seat 2: pj0901 folded before Flop (didn't bet)
Seat 4: vitor762 (button) showed [Ks 8c] and won (44165) with a full house, Eights full of Deuces
Seat 5: Scorgiej (small blind) showed [Jh 9d] and lost with two pair, Eights and Deuces

PokerStars Hand #251210290969: Tournament #3769361908, $52.38+$2.62 USD Hold'em No Limit - Level XXVI (4000/8000) - 2024/06/26 23:26:12 UTC [2024/06/26 19:26:12 ET]
Table '3769361908 12' 6-max Seat #5 is the button
Seat 1: DR. ELDAR (171951 in chips) 
Seat 2: pj0901 (43238 in chips) 
Seat 3: chrichrac (83486 in chips) 
Seat 4: vitor762 (44165 in chips) 
Seat 5: Scorgiej (109078 in chips) 
DR. ELDAR: posts the ante 2000
pj0901: posts the ante 2000
chrichrac: posts the ante 2000
vitor762: posts the ante 2000
Scorgiej: posts the ante 2000
DR. ELDAR: posts small blind 4000
pj0901: posts big blind 8000
*** HOLE CARDS ***
chrichrac: folds 
vitor762: folds 
Scorgiej: folds 
DR. ELDAR: folds 
Uncalled bet (4000) returned to pj0901
pj0901 collected 18000 from pot
pj0901: doesn't show hand 
*** SUMMARY ***
Total pot 18000 | Rake 0 
Seat 1: DR. ELDAR (small blind) folded before Flop
Seat 2: pj0901 (big blind) collected (18000)
Seat 3: chrichrac folded before Flop (didn't bet)
Seat 4: vitor762 folded before Flop (didn't bet)
Seat 5: Scorgiej (button) folded before Flop (didn't bet)

PokerStars Hand #251210295720: Tournament #3769361908, $52.38+$2.62 USD Hold'em No Limit - Level XXVII (4500/9000) - 2024/06/26 23:26:35 UTC [2024/06/26 19:26:35 ET]
Table '3769361908 12' 6-max Seat #1 is the button
Seat 1: DR. ELDAR (165951 in chips) 
Seat 2: pj0901 (55238 in chips) 
Seat 3: chrichrac (81486 in chips) 
Seat 4: vitor762 (42165 in chips) 
Seat 5: Scorgiej (107078 in chips) 
DR. ELDAR: posts the ante 2250
pj0901: posts the ante 2250
chrichrac: posts the ante 2250
vitor762: posts the ante 2250
Scorgiej: posts the ante 2250
pj0901: posts small blind 4500
chrichrac: posts big blind 9000
*** HOLE CARDS ***
vitor762: raises 30915 to 39915 and is all-in
Scorgiej: folds 
DR. ELDAR: folds 
pj0901: folds 
chrichrac: folds 
Uncalled bet (30915) returned to vitor762
vitor762 collected 33750 from pot
vitor762: doesn't show hand 
*** SUMMARY ***
Total pot 33750 | Rake 0 
Seat 1: DR. ELDAR (button) folded before Flop (didn't bet)
Seat 2: pj0901 (small blind) folded before Flop
Seat 3: chrichrac (big blind) folded before Flop
Seat 4: vitor762 collected (33750)
Seat 5: Scorgiej folded before Flop (didn't bet)

PokerStars Hand #251210304273: Tournament #3769361908, $52.38+$2.62 USD Hold'em No Limit - Level XXVII (4500/9000) - 2024/06/26 23:27:18 UTC [2024/06/26 19:27:18 ET]
Table '3769361908 12' 6-max Seat #2 is the button
Seat 1: DR. ELDAR (163701 in chips) 
Seat 2: pj0901 (48488 in chips) 
Seat 3: chrichrac (70236 in chips) 
Seat 4: vitor762 (64665 in chips) 
Seat 5: Scorgiej (104828 in chips) 
DR. ELDAR: posts the ante 2250
pj0901: posts the ante 2250
chrichrac: posts the ante 2250
vitor762: posts the ante 2250
Scorgiej: posts the ante 2250
chrichrac: posts small blind 4500
vitor762: posts big blind 9000
*** HOLE CARDS ***
Scorgiej: folds 
DR. ELDAR: raises 152451 to 161451 and is all-in
pj0901: folds 
chrichrac: folds 
vitor762: calls 53415 and is all-in
Uncalled bet (99036) returned to DR. ELDAR
*** FLOP *** [8s 7d 9h]
*** TURN *** [8s 7d 9h] [3d]
*** RIVER *** [8s 7d 9h 3d] [Jc]
*** SHOW DOWN ***
vitor762: shows [Jd Ks] (a pair of Jacks)
DR. ELDAR: shows [Qd Ac] (high card Ace)
vitor762 collected 140580 from pot
*** SUMMARY ***
Total pot 140580 | Rake 0 
Board [8s 7d 9h 3d Jc]
Seat 1: DR. ELDAR showed [Qd Ac] and lost with high card Ace
Seat 2: pj0901 (button) folded before Flop (didn't bet)
Seat 3: chrichrac (small blind) folded before Flop
Seat 4: vitor762 (big blind) showed [Jd Ks] and won (140580) with a pair of Jacks
Seat 5: Scorgiej folded before Flop (didn't bet)

PokerStars Hand #251210316212: Tournament #3769361908, $52.38+$2.62 USD Hold'em No Limit - Level XXVII (4500/9000) - 2024/06/26 23:28:17 UTC [2024/06/26 19:28:17 ET]
Table '3769361908 12' 6-max Seat #3 is the button
Seat 1: DR. ELDAR (99036 in chips) 
Seat 2: pj0901 (46238 in chips) 
Seat 3: chrichrac (63486 in chips) 
Seat 4: vitor762 (140580 in chips) 
Seat 5: Scorgiej (102578 in chips) 
Seat 6: mila is best (110124 in chips) 
DR. ELDAR: posts the ante 2250
pj0901: posts the ante 2250
chrichrac: posts the ante 2250
vitor762: posts the ante 2250
Scorgiej: posts the ante 2250
mila is best: posts the ante 2250
vitor762: posts small blind 4500
Scorgiej: posts big blind 9000
*** HOLE CARDS ***
mila is best: folds 
DR. ELDAR: folds 
pj0901: raises 31500 to 40500
chrichrac has timed out
chrichrac: folds 
chrichrac is sitting out
chrichrac has returned
vitor762: folds 
Scorgiej: folds 
Uncalled bet (31500) returned to pj0901
pj0901 collected 36000 from pot
pj0901: doesn't show hand 
*** SUMMARY ***
Total pot 36000 | Rake 0 
Seat 1: DR. ELDAR folded before Flop (didn't bet)
Seat 2: pj0901 collected (36000)
Seat 3: chrichrac (button) folded before Flop (didn't bet)
Seat 4: vitor762 (small blind) folded before Flop
Seat 5: Scorgiej (big blind) folded before Flop
Seat 6: mila is best folded before Flop (didn't bet)

PokerStars Hand #251210325067: Tournament #3769361908, $52.38+$2.62 USD Hold'em No Limit - Level XXVII (4500/9000) - 2024/06/26 23:29:01 UTC [2024/06/26 19:29:01 ET]
Table '3769361908 12' 6-max Seat #4 is the button
Seat 1: DR. ELDAR (96786 in chips) 
Seat 2: pj0901 (70988 in chips) 
Seat 3: chrichrac (61236 in chips) 
Seat 4: vitor762 (133830 in chips) 
Seat 5: Scorgiej (91328 in chips) 
Seat 6: mila is best (107874 in chips) 
DR. ELDAR: posts the ante 2250
pj0901: posts the ante 2250
chrichrac: posts the ante 2250
vitor762: posts the ante 2250
Scorgiej: posts the ante 2250
mila is best: posts the ante 2250
Scorgiej: posts small blind 4500
mila is best: posts big blind 9000
*** HOLE CARDS ***
DR. ELDAR: raises 19800 to 28800
pj0901: folds 
chrichrac: folds 
vitor762: folds 
Scorgiej: raises 60278 to 89078 and is all-in
mila is best: folds 
DR. ELDAR: calls 60278
*** FLOP *** [2c Jd 5d]
*** TURN *** [2c Jd 5d] [Qd]
*** RIVER *** [2c Jd 5d Qd] [7c]
*** SHOW DOWN ***
Scorgiej: shows [Ks Kc] (a pair of Kings)
DR. ELDAR: shows [Qh Jc] (two pair, Queens and Jacks)
DR. ELDAR collected 200656 from pot
Scorgiej finished the tournament in 22nd place and received $164.76.
*** SUMMARY ***
Total pot 200656 | Rake 0 
Board [2c Jd 5d Qd 7c]
Seat 1: DR. ELDAR showed [Qh Jc] and won (200656) with two pair, Queens and Jacks
Seat 2: pj0901 folded before Flop (didn't bet)
Seat 3: chrichrac folded before Flop (didn't bet)
Seat 4: vitor762 (button) folded before Flop (didn't bet)
Seat 5: Scorgiej (small blind) showed [Ks Kc] and lost with a pair of Kings
Seat 6: mila is best (big blind) folded before Flop

PokerStars Hand #251210336153: Tournament #3769361908, $52.38+$2.62 USD Hold'em No Limit - Level XXVIII (5000/10000) - 2024/06/26 23:29:57 UTC [2024/06/26 19:29:57 ET]
Table '3769361908 12' 6-max Seat #6 is the button
Seat 1: DR. ELDAR (206114 in chips) 
Seat 2: pj0901 (68738 in chips) 
Seat 3: chrichrac (58986 in chips) 
Seat 4: vitor762 (131580 in chips) 
Seat 6: mila is best (96624 in chips) 
DR. ELDAR: posts the ante 2500
pj0901: posts the ante 2500
chrichrac: posts the ante 2500
vitor762: posts the ante 2500
mila is best: posts the ante 2500
DR. ELDAR: posts small blind 5000
pj0901: posts big blind 10000
*** HOLE CARDS ***
chrichrac: raises 46486 to 56486 and is all-in
vitor762: folds 
mila is best: raises 37638 to 94124 and is all-in
DR. ELDAR: folds 
pj0901: folds 
Uncalled bet (37638) returned to mila is best
*** FLOP *** [3s 8s Js]
*** TURN *** [3s 8s Js] [9c]
*** RIVER *** [3s 8s Js 9c] [Qs]
*** SHOW DOWN ***
chrichrac: shows [Kc Th] (a straight, Nine to King)
mila is best: shows [Qc Ac] (a pair of Queens)
chrichrac collected 140472 from pot
*** SUMMARY ***
Total pot 140472 | Rake 0 
Board [3s 8s Js 9c Qs]
Seat 1: DR. ELDAR (small blind) folded before Flop
Seat 2: pj0901 (big blind) folded before Flop
Seat 3: chrichrac showed [Kc Th] and won (140472) with a straight, Nine to King
Seat 4: vitor762 folded before Flop (didn't bet)
Seat 6: mila is best (button) showed [Qc Ac] and lost with a pair of Queens

PokerStars Hand #251210344950: Tournament #3769361908, $52.38+$2.62 USD Hold'em No Limit - Level XXVIII (5000/10000) - 2024/06/26 23:30:41 UTC [2024/06/26 19:30:41 ET]
Table '3769361908 12' 6-max Seat #1 is the button
Seat 1: DR. ELDAR (198614 in chips) 
Seat 2: pj0901 (56238 in chips) 
Seat 3: chrichrac (140472 in chips) 
Seat 4: vitor762 (129080 in chips) 
Seat 6: mila is best (37638 in chips) 
DR. ELDAR: posts the ante 2500
pj0901: posts the ante 2500
chrichrac: posts the ante 2500
vitor762: posts the ante 2500
mila is best: posts the ante 2500
pj0901: posts small blind 5000
chrichrac: posts big blind 10000
*** HOLE CARDS ***
vitor762: folds 
mila is best: folds 
DR. ELDAR: folds 
pj0901: folds 
Uncalled bet (5000) returned to chrichrac
chrichrac collected 22500 from pot
chrichrac: doesn't show hand 
*** SUMMARY ***
Total pot 22500 | Rake 0 
Seat 1: DR. ELDAR (button) folded before Flop (didn't bet)
Seat 2: pj0901 (small blind) folded before Flop
Seat 3: chrichrac (big blind) collected (22500)
Seat 4: vitor762 folded before Flop (didn't bet)
Seat 6: mila is best folded before Flop (didn't bet)

PokerStars Hand #251210350900: Tournament #3769361908, $52.38+$2.62 USD Hold'em No Limit - Level XXVIII (5000/10000) - 2024/06/26 23:31:10 UTC [2024/06/26 19:31:10 ET]
Table '3769361908 12' 6-max Seat #2 is the button
Seat 1: DR. ELDAR (196114 in chips) 
Seat 2: pj0901 (48738 in chips) 
Seat 3: chrichrac (155472 in chips) 
Seat 4: vitor762 (126580 in chips) 
Seat 6: mila is best (35138 in chips) 
DR. ELDAR: posts the ante 2500
pj0901: posts the ante 2500
chrichrac: posts the ante 2500
vitor762: posts the ante 2500
mila is best: posts the ante 2500
chrichrac: posts small blind 5000
vitor762: posts big blind 10000
*** HOLE CARDS ***
mila is best: folds 
DR. ELDAR: folds 
pj0901: raises 35000 to 45000
chrichrac: raises 107972 to 152972 and is all-in
vitor762: folds 
pj0901: calls 1238 and is all-in
Uncalled bet (106734) returned to chrichrac
*** FLOP *** [8c 2c 9c]
*** TURN *** [8c 2c 9c] [7s]
*** RIVER *** [8c 2c 9c 7s] [6s]
*** SHOW DOWN ***
chrichrac: shows [9s 9d] (three of a kind, Nines)
pj0901: shows [Qc Jd] (high card Queen)
chrichrac collected 114976 from pot
pj0901 finished the tournament in 19th place and received $164.76.
*** SUMMARY ***
Total pot 114976 | Rake 0 
Board [8c 2c 9c 7s 6s]
Seat 1: DR. ELDAR folded before Flop (didn't bet)
Seat 2: pj0901 (button) showed [Qc Jd] and lost with high card Queen
Seat 3: chrichrac (small blind) showed [9s 9d] and won (114976) with three of a kind, Nines
Seat 4: vitor762 (big blind) folded before Flop
Seat 6: mila is best folded before Flop (didn't bet)


PokerStars Hand #251209481455: Tournament #3769361908, $52.38+$2.62 USD Hold'em No Limit - Level IX (150/300) - 2024/06/26 22:28:23 UTC [2024/06/26 18:28:23 ET]
Table '3769361908 11' 6-max Seat #5 is the button
Seat 1: Spectral34 (8849 in chips) 
Seat 2: TRAVISROYAL (7415 in chips) 
Seat 3: lucasrojo (10960 in chips) 
Seat 4: UruRey (16633 in chips) 
Seat 5: Pkrscott1992 (2169 in chips) 
Seat 6: lulira10 (14732 in chips) 
Spectral34: posts the ante 75
TRAVISROYAL: posts the ante 75
lucasrojo: posts the ante 75
UruRey: posts the ante 75
Pkrscott1992: posts the ante 75
lulira10: posts the ante 75
lulira10: posts small blind 150
Spectral34: posts big blind 300
*** HOLE CARDS ***
TRAVISROYAL: raises 600 to 900
lucasrojo: folds 
UruRey: raises 2400 to 3300
Pkrscott1992: folds 
lulira10: folds 
Spectral34: folds 
TRAVISROYAL: calls 2400
*** FLOP *** [Qs 9s 8h]
TRAVISROYAL: bets 4040 and is all-in
UruRey: calls 4040
*** TURN *** [Qs 9s 8h] [6h]
*** RIVER *** [Qs 9s 8h 6h] [7d]
*** SHOW DOWN ***
TRAVISROYAL: shows [Qh Kh] (a pair of Queens)
UruRey: shows [Jd Jh] (a pair of Jacks)
TRAVISROYAL collected 15580 from pot
*** SUMMARY ***
Total pot 15580 | Rake 0 
Board [Qs 9s 8h 6h 7d]
Seat 1: Spectral34 (big blind) folded before Flop
Seat 2: TRAVISROYAL showed [Qh Kh] and won (15580) with a pair of Queens
Seat 3: lucasrojo folded before Flop (didn't bet)
Seat 4: UruRey showed [Jd Jh] and lost with a pair of Jacks
Seat 5: Pkrscott1992 (button) folded before Flop (didn't bet)
Seat 6: lulira10 (small blind) folded before Flop

PokerStars Hand #251209492342: Tournament #3769361908, $52.38+$2.62 USD Hold'em No Limit - Level IX (150/300) - 2024/06/26 22:29:02 UTC [2024/06/26 18:29:02 ET]
Table '3769361908 11' 6-max Seat #6 is the button
Seat 1: Spectral34 (8474 in chips) 
Seat 2: TRAVISROYAL (15580 in chips) 
Seat 3: lucasrojo (10885 in chips) 
Seat 4: UruRey (9218 in chips) 
Seat 5: Pkrscott1992 (2094 in chips) 
Seat 6: lulira10 (14507 in chips) 
Spectral34: posts the ante 75
TRAVISROYAL: posts the ante 75
lucasrojo: posts the ante 75
UruRey: posts the ante 75
Pkrscott1992: posts the ante 75
lulira10: posts the ante 75
Spectral34: posts small blind 150
TRAVISROYAL: posts big blind 300
*** HOLE CARDS ***
lucasrojo: folds 
UruRey: folds 
Pkrscott1992: folds 
lulira10: folds 
Spectral34: calls 150
TRAVISROYAL: checks 
*** FLOP *** [2h Kc 3s]
Spectral34: bets 300
TRAVISROYAL: calls 300
*** TURN *** [2h Kc 3s] [Qd]
Spectral34: bets 1200
TRAVISROYAL: calls 1200
*** RIVER *** [2h Kc 3s Qd] [4h]
Spectral34: checks 
TRAVISROYAL: bets 1800
Spectral34: folds 
Uncalled bet (1800) returned to TRAVISROYAL
TRAVISROYAL collected 4050 from pot
*** SUMMARY ***
Total pot 4050 | Rake 0 
Board [2h Kc 3s Qd 4h]
Seat 1: Spectral34 (small blind) folded on the River
Seat 2: TRAVISROYAL (big blind) collected (4050)
Seat 3: lucasrojo folded before Flop (didn't bet)
Seat 4: UruRey folded before Flop (didn't bet)
Seat 5: Pkrscott1992 folded before Flop (didn't bet)
Seat 6: lulira10 (button) folded before Flop (didn't bet)

PokerStars Hand #251209515082: Tournament #3769361908, $52.38+$2.62 USD Hold'em No Limit - Level X (200/400) - 2024/06/26 22:30:24 UTC [2024/06/26 18:30:24 ET]
Table '3769361908 11' 6-max Seat #1 is the button
Seat 1: Spectral34 (6599 in chips) 
Seat 2: TRAVISROYAL (17755 in chips) 
Seat 3: lucasrojo (10810 in chips) 
Seat 4: UruRey (9143 in chips) 
Seat 5: Pkrscott1992 (2019 in chips) 
Seat 6: lulira10 (14432 in chips) 
Spectral34: posts the ante 100
TRAVISROYAL: posts the ante 100
lucasrojo: posts the ante 100
UruRey: posts the ante 100
Pkrscott1992: posts the ante 100
lulira10: posts the ante 100
TRAVISROYAL: posts small blind 200
lucasrojo: posts big blind 400
*** HOLE CARDS ***
UruRey: folds 
Pkrscott1992: raises 1519 to 1919 and is all-in
lulira10: folds 
Spectral34: raises 4580 to 6499 and is all-in
TRAVISROYAL: folds 
lucasrojo: folds 
Uncalled bet (4580) returned to Spectral34
*** FLOP *** [7d 9d 9h]
*** TURN *** [7d 9d 9h] [As]
*** RIVER *** [7d 9d 9h As] [9c]
*** SHOW DOWN ***
Pkrscott1992: shows [Qh 9s] (four of a kind, Nines)
Spectral34: shows [Td Ad] (a full house, Nines full of Aces)
Pkrscott1992 collected 5038 from pot
*** SUMMARY ***
Total pot 5038 | Rake 0 
Board [7d 9d 9h As 9c]
Seat 1: Spectral34 (button) showed [Td Ad] and lost with a full house, Nines full of Aces
Seat 2: TRAVISROYAL (small blind) folded before Flop
Seat 3: lucasrojo (big blind) folded before Flop
Seat 4: UruRey folded before Flop (didn't bet)
Seat 5: Pkrscott1992 showed [Qh 9s] and won (5038) with four of a kind, Nines
Seat 6: lulira10 folded before Flop (didn't bet)

PokerStars Hand #251209522199: Tournament #3769361908, $52.38+$2.62 USD Hold'em No Limit - Level X (200/400) - 2024/06/26 22:30:50 UTC [2024/06/26 18:30:50 ET]
Table '3769361908 11' 6-max Seat #2 is the button
Seat 1: Spectral34 (4580 in chips) 
Seat 2: TRAVISROYAL (17455 in chips) 
Seat 3: lucasrojo (10310 in chips) 
Seat 4: UruRey (9043 in chips) 
Seat 5: Pkrscott1992 (5038 in chips) 
Seat 6: lulira10 (14332 in chips) 
Spectral34: posts the ante 100
TRAVISROYAL: posts the ante 100
lucasrojo: posts the ante 100
UruRey: posts the ante 100
Pkrscott1992: posts the ante 100
lulira10: posts the ante 100
lucasrojo: posts small blind 200
UruRey: posts big blind 400
*** HOLE CARDS ***
Pkrscott1992: folds 
lulira10: raises 400 to 800
Spectral34: folds 
TRAVISROYAL: calls 800
lucasrojo: folds 
UruRey: calls 400
*** FLOP *** [3c 7h Qh]
UruRey: checks 
lulira10: bets 1600
TRAVISROYAL: folds 
UruRey: folds 
Uncalled bet (1600) returned to lulira10
lulira10 collected 3200 from pot
lulira10: doesn't show hand 
*** SUMMARY ***
Total pot 3200 | Rake 0 
Board [3c 7h Qh]
Seat 1: Spectral34 folded before Flop (didn't bet)
Seat 2: TRAVISROYAL (button) folded on the Flop
Seat 3: lucasrojo (small blind) folded before Flop
Seat 4: UruRey (big blind) folded on the Flop
Seat 5: Pkrscott1992 folded before Flop (didn't bet)
Seat 6: lulira10 collected (3200)

PokerStars Hand #251209534179: Tournament #3769361908, $52.38+$2.62 USD Hold'em No Limit - Level X (200/400) - 2024/06/26 22:31:34 UTC [2024/06/26 18:31:34 ET]
Table '3769361908 11' 6-max Seat #3 is the button
Seat 1: Spectral34 (4480 in chips) 
Seat 2: TRAVISROYAL (16555 in chips) 
Seat 3: lucasrojo (10010 in chips) 
Seat 4: UruRey (8143 in chips) 
Seat 5: Pkrscott1992 (4938 in chips) 
Seat 6: lulira10 (16632 in chips) 
Spectral34: posts the ante 100
TRAVISROYAL: posts the ante 100
lucasrojo: posts the ante 100
UruRey: posts the ante 100
Pkrscott1992: posts the ante 100
lulira10: posts the ante 100
UruRey: posts small blind 200
Pkrscott1992: posts big blind 400
*** HOLE CARDS ***
lulira10: folds 
Spectral34: folds 
TRAVISROYAL: calls 400
lucasrojo: folds 
UruRey: folds 
Pkrscott1992: checks 
*** FLOP *** [Ks 3d 8d]
Pkrscott1992: checks 
TRAVISROYAL: checks 
*** TURN *** [Ks 3d 8d] [Ts]
Pkrscott1992: bets 4438 and is all-in
TRAVISROYAL: folds 
Uncalled bet (4438) returned to Pkrscott1992
Pkrscott1992 collected 1600 from pot
Pkrscott1992: doesn't show hand 
*** SUMMARY ***
Total pot 1600 | Rake 0 
Board [Ks 3d 8d Ts]
Seat 1: Spectral34 folded before Flop (didn't bet)
Seat 2: TRAVISROYAL folded on the Turn
Seat 3: lucasrojo (button) folded before Flop (didn't bet)
Seat 4: UruRey (small blind) folded before Flop
Seat 5: Pkrscott1992 (big blind) collected (1600)
Seat 6: lulira10 folded before Flop (didn't bet)

PokerStars Hand #251209545923: Tournament #3769361908, $52.38+$2.62 USD Hold'em No Limit - Level XI (250/500) - 2024/06/26 22:32:16 UTC [2024/06/26 18:32:16 ET]
Table '3769361908 11' 6-max Seat #4 is the button
Seat 1: Spectral34 (4380 in chips) 
Seat 2: TRAVISROYAL (16055 in chips) 
Seat 3: lucasrojo (9910 in chips) 
Seat 4: UruRey (7843 in chips) 
Seat 5: Pkrscott1992 (6038 in chips) 
Seat 6: lulira10 (16532 in chips) 
Spectral34: posts the ante 125
TRAVISROYAL: posts the ante 125
lucasrojo: posts the ante 125
UruRey: posts the ante 125
Pkrscott1992: posts the ante 125
lulira10: posts the ante 125
Pkrscott1992: posts small blind 250
lulira10: posts big blind 500
*** HOLE CARDS ***
Spectral34: folds 
TRAVISROYAL: raises 500 to 1000
lucasrojo: folds 
UruRey: folds 
Pkrscott1992: folds 
lulira10: folds 
Uncalled bet (500) returned to TRAVISROYAL
TRAVISROYAL collected 2000 from pot
*** SUMMARY ***
Total pot 2000 | Rake 0 
Seat 1: Spectral34 folded before Flop (didn't bet)
Seat 2: TRAVISROYAL collected (2000)
Seat 3: lucasrojo folded before Flop (didn't bet)
Seat 4: UruRey (button) folded before Flop (didn't bet)
Seat 5: Pkrscott1992 (small blind) folded before Flop
Seat 6: lulira10 (big blind) folded before Flop

PokerStars Hand #251209554767: Tournament #3769361908, $52.38+$2.62 USD Hold'em No Limit - Level XI (250/500) - 2024/06/26 22:32:49 UTC [2024/06/26 18:32:49 ET]
Table '3769361908 11' 6-max Seat #5 is the button
Seat 1: Spectral34 (4255 in chips) 
Seat 2: TRAVISROYAL (17430 in chips) 
Seat 3: lucasrojo (9785 in chips) 
Seat 4: UruRey (7718 in chips) 
Seat 5: Pkrscott1992 (5663 in chips) 
Seat 6: lulira10 (15907 in chips) 
Spectral34: posts the ante 125
TRAVISROYAL: posts the ante 125
lucasrojo: posts the ante 125
UruRey: posts the ante 125
Pkrscott1992: posts the ante 125
lulira10: posts the ante 125
lulira10: posts small blind 250
Spectral34: posts big blind 500
*** HOLE CARDS ***
TRAVISROYAL: raises 500 to 1000
lucasrojo: folds 
UruRey: raises 6593 to 7593 and is all-in
Pkrscott1992: folds 
lulira10: folds 
Spectral34: folds 
TRAVISROYAL: folds 
Uncalled bet (6593) returned to UruRey
UruRey collected 3500 from pot
UruRey: doesn't show hand 
*** SUMMARY ***
Total pot 3500 | Rake 0 
Seat 1: Spectral34 (big blind) folded before Flop
Seat 2: TRAVISROYAL folded before Flop
Seat 3: lucasrojo folded before Flop (didn't bet)
Seat 4: UruRey collected (3500)
Seat 5: Pkrscott1992 (button) folded before Flop (didn't bet)
Seat 6: lulira10 (small blind) folded before Flop

PokerStars Hand #251209563463: Tournament #3769361908, $52.38+$2.62 USD Hold'em No Limit - Level XI (250/500) - 2024/06/26 22:33:21 UTC [2024/06/26 18:33:21 ET]
Table '3769361908 11' 6-max Seat #6 is the button
Seat 1: Spectral34 (3630 in chips) 
Seat 2: TRAVISROYAL (16305 in chips) 
Seat 3: lucasrojo (9660 in chips) 
Seat 4: UruRey (10093 in chips) 
Seat 5: Pkrscott1992 (5538 in chips) 
Seat 6: lulira10 (15532 in chips) 
Spectral34: posts the ante 125
TRAVISROYAL: posts the ante 125
lucasrojo: posts the ante 125
UruRey: posts the ante 125
Pkrscott1992: posts the ante 125
lulira10: posts the ante 125
Spectral34: posts small blind 250
TRAVISROYAL: posts big blind 500
*** HOLE CARDS ***
lucasrojo: folds 
UruRey: folds 
Pkrscott1992: folds 
lulira10: folds 
Spectral34: raises 3005 to 3505 and is all-in
TRAVISROYAL: folds 
Uncalled bet (3005) returned to Spectral34
Spectral34 collected 1750 from pot
Spectral34: doesn't show hand 
*** SUMMARY ***
Total pot 1750 | Rake 0 
Seat 1: Spectral34 (small blind) collected (1750)
Seat 2: TRAVISROYAL (big blind) folded before Flop
Seat 3: lucasrojo folded before Flop (didn't bet)
Seat 4: UruRey folded before Flop (didn't bet)
Seat 5: Pkrscott1992 folded before Flop (didn't bet)
Seat 6: lulira10 (button) folded before Flop (didn't bet)

PokerStars Hand #251209569239: Tournament #3769361908, $52.38+$2.62 USD Hold'em No Limit - Level XI (250/500) - 2024/06/26 22:33:43 UTC [2024/06/26 18:33:43 ET]
Table '3769361908 11' 6-max Seat #1 is the button
Seat 1: Spectral34 (4755 in chips) 
Seat 2: TRAVISROYAL (15680 in chips) 
Seat 3: lucasrojo (9535 in chips) 
Seat 4: UruRey (9968 in chips) 
Seat 5: Pkrscott1992 (5413 in chips) 
Seat 6: lulira10 (15407 in chips) 
Spectral34: posts the ante 125
TRAVISROYAL: posts the ante 125
lucasrojo: posts the ante 125
UruRey: posts the ante 125
Pkrscott1992: posts the ante 125
lulira10: posts the ante 125
TRAVISROYAL: posts small blind 250
lucasrojo: posts big blind 500
*** HOLE CARDS ***
UruRey: folds 
Pkrscott1992: folds 
lulira10: folds 
Spectral34: raises 500 to 1000
TRAVISROYAL: folds 
lucasrojo: calls 500
*** FLOP *** [Ad Qh Kd]
lucasrojo: checks 
Spectral34: bets 500
lucasrojo: folds 
Uncalled bet (500) returned to Spectral34
Spectral34 collected 3000 from pot
Spectral34: doesn't show hand 
*** SUMMARY ***
Total pot 3000 | Rake 0 
Board [Ad Qh Kd]
Seat 1: Spectral34 (button) collected (3000)
Seat 2: TRAVISROYAL (small blind) folded before Flop
Seat 3: lucasrojo (big blind) folded on the Flop
Seat 4: UruRey folded before Flop (didn't bet)
Seat 5: Pkrscott1992 folded before Flop (didn't bet)
Seat 6: lulira10 folded before Flop (didn't bet)

PokerStars Hand #251209579816: Tournament #3769361908, $52.38+$2.62 USD Hold'em No Limit - Level XI (250/500) - 2024/06/26 22:34:22 UTC [2024/06/26 18:34:22 ET]
Table '3769361908 11' 6-max Seat #2 is the button
Seat 1: Spectral34 (6630 in chips) 
Seat 2: TRAVISROYAL (15305 in chips) 
Seat 3: lucasrojo (8410 in chips) 
Seat 4: UruRey (9843 in chips) 
Seat 5: Pkrscott1992 (5288 in chips) 
Seat 6: lulira10 (15282 in chips) 
Spectral34: posts the ante 125
TRAVISROYAL: posts the ante 125
lucasrojo: posts the ante 125
UruRey: posts the ante 125
Pkrscott1992: posts the ante 125
lulira10: posts the ante 125
lucasrojo: posts small blind 250
UruRey: posts big blind 500
*** HOLE CARDS ***
Pkrscott1992: raises 4663 to 5163 and is all-in
lulira10: folds 
Spectral34: folds 
TRAVISROYAL: folds 
lucasrojo: folds 
UruRey: folds 
Uncalled bet (4663) returned to Pkrscott1992
Pkrscott1992 collected 2000 from pot
Pkrscott1992: doesn't show hand 
*** SUMMARY ***
Total pot 2000 | Rake 0 
Seat 1: Spectral34 folded before Flop (didn't bet)
Seat 2: TRAVISROYAL (button) folded before Flop (didn't bet)
Seat 3: lucasrojo (small blind) folded before Flop
Seat 4: UruRey (big blind) folded before Flop
Seat 5: Pkrscott1992 collected (2000)
Seat 6: lulira10 folded before Flop (didn't bet)

PokerStars Hand #251209583893: Tournament #3769361908, $52.38+$2.62 USD Hold'em No Limit - Level XI (250/500) - 2024/06/26 22:34:37 UTC [2024/06/26 18:34:37 ET]
Table '3769361908 11' 6-max Seat #3 is the button
Seat 1: Spectral34 (6505 in chips) 
Seat 2: TRAVISROYAL (15180 in chips) 
Seat 3: lucasrojo (8035 in chips) 
Seat 4: UruRey (9218 in chips) 
Seat 5: Pkrscott1992 (6663 in chips) 
Seat 6: lulira10 (15157 in chips) 
Spectral34: posts the ante 125
TRAVISROYAL: posts the ante 125
lucasrojo: posts the ante 125
UruRey: posts the ante 125
Pkrscott1992: posts the ante 125
lulira10: posts the ante 125
UruRey: posts small blind 250
Pkrscott1992: posts big blind 500
*** HOLE CARDS ***
lulira10: folds 
Spectral34: folds 
TRAVISROYAL: raises 1000 to 1500
lucasrojo: folds 
UruRey: raises 7593 to 9093 and is all-in
Pkrscott1992: folds 
TRAVISROYAL: folds 
Uncalled bet (7593) returned to UruRey
UruRey collected 4250 from pot
UruRey: doesn't show hand 
*** SUMMARY ***
Total pot 4250 | Rake 0 
Seat 1: Spectral34 folded before Flop (didn't bet)
Seat 2: TRAVISROYAL folded before Flop
Seat 3: lucasrojo (button) folded before Flop (didn't bet)
Seat 4: UruRey (small blind) collected (4250)
Seat 5: Pkrscott1992 (big blind) folded before Flop
Seat 6: lulira10 folded before Flop (didn't bet)

PokerStars Hand #251209594165: Tournament #3769361908, $52.38+$2.62 USD Hold'em No Limit - Level XII (300/600) - 2024/06/26 22:35:15 UTC [2024/06/26 18:35:15 ET]
Table '3769361908 11' 6-max Seat #4 is the button
Seat 1: Spectral34 (6380 in chips) 
Seat 2: TRAVISROYAL (13555 in chips) 
Seat 3: lucasrojo (7910 in chips) 
Seat 4: UruRey (11843 in chips) 
Seat 5: Pkrscott1992 (6038 in chips) 
Seat 6: lulira10 (15032 in chips) 
Spectral34: posts the ante 150
TRAVISROYAL: posts the ante 150
lucasrojo: posts the ante 150
UruRey: posts the ante 150
Pkrscott1992: posts the ante 150
lulira10: posts the ante 150
Pkrscott1992: posts small blind 300
lulira10: posts big blind 600
*** HOLE CARDS ***
Spectral34: raises 5630 to 6230 and is all-in
TRAVISROYAL: folds 
lucasrojo: raises 1530 to 7760 and is all-in
UruRey: folds 
Pkrscott1992: folds 
lulira10: calls 7160
*** FLOP *** [5h 9d Jh]
*** TURN *** [5h 9d Jh] [2h]
*** RIVER *** [5h 9d Jh 2h] [Td]
*** SHOW DOWN ***
lulira10: shows [Ks Kd] (a pair of Kings)
lucasrojo: shows [Kh Kc] (a pair of Kings)
lulira10 collected 1530 from side pot
lucasrojo collected 1530 from side pot
Spectral34: shows [Ah Th] (a flush, Ace high)
Spectral34 collected 19890 from main pot
*** SUMMARY ***
Total pot 22950 Main pot 19890. Side pot 3060. | Rake 0 
Board [5h 9d Jh 2h Td]
Seat 1: Spectral34 showed [Ah Th] and won (19890) with a flush, Ace high
Seat 2: TRAVISROYAL folded before Flop (didn't bet)
Seat 3: lucasrojo showed [Kh Kc] and won (1530) with a pair of Kings
Seat 4: UruRey (button) folded before Flop (didn't bet)
Seat 5: Pkrscott1992 (small blind) folded before Flop
Seat 6: lulira10 (big blind) showed [Ks Kd] and won (1530) with a pair of Kings

PokerStars Hand #251209601163: Tournament #3769361908, $52.38+$2.62 USD Hold'em No Limit - Level XII (300/600) - 2024/06/26 22:35:41 UTC [2024/06/26 18:35:41 ET]
Table '3769361908 11' 6-max Seat #5 is the button
Seat 1: Spectral34 (19890 in chips) 
Seat 2: TRAVISROYAL (13405 in chips) 
Seat 3: lucasrojo (1530 in chips) 
Seat 4: UruRey (11693 in chips) 
Seat 5: Pkrscott1992 (5588 in chips) 
Seat 6: lulira10 (8652 in chips) 
Spectral34: posts the ante 150
TRAVISROYAL: posts the ante 150
lucasrojo: posts the ante 150
UruRey: posts the ante 150
Pkrscott1992: posts the ante 150
lulira10: posts the ante 150
lulira10: posts small blind 300
Spectral34: posts big blind 600
*** HOLE CARDS ***
TRAVISROYAL: folds 
lucasrojo: raises 780 to 1380 and is all-in
UruRey: folds 
Pkrscott1992: folds 
lulira10: calls 1080
Spectral34: raises 18360 to 19740 and is all-in
lulira10: folds 
Uncalled bet (18360) returned to Spectral34
*** FLOP *** [Tc Qd 5d]
*** TURN *** [Tc Qd 5d] [Qh]
*** RIVER *** [Tc Qd 5d Qh] [4s]
*** SHOW DOWN ***
Spectral34: shows [3d As] (a pair of Queens)
lucasrojo: shows [Ad 3h] (a pair of Queens)
Spectral34 collected 2520 from pot
lucasrojo collected 2520 from pot
*** SUMMARY ***
Total pot 5040 | Rake 0 
Board [Tc Qd 5d Qh 4s]
Seat 1: Spectral34 (big blind) showed [3d As] and won (2520) with a pair of Queens
Seat 2: TRAVISROYAL folded before Flop (didn't bet)
Seat 3: lucasrojo showed [Ad 3h] and won (2520) with a pair of Queens
Seat 4: UruRey folded before Flop (didn't bet)
Seat 5: Pkrscott1992 (button) folded before Flop (didn't bet)
Seat 6: lulira10 (small blind) folded before Flop

PokerStars Hand #251209608437: Tournament #3769361908, $52.38+$2.62 USD Hold'em No Limit - Level XII (300/600) - 2024/06/26 22:36:08 UTC [2024/06/26 18:36:08 ET]
Table '3769361908 11' 6-max Seat #6 is the button
Seat 1: Spectral34 (20880 in chips) 
Seat 2: TRAVISROYAL (13255 in chips) 
Seat 3: lucasrojo (2520 in chips) 
Seat 4: UruRey (11543 in chips) 
Seat 5: Pkrscott1992 (5438 in chips) 
Seat 6: lulira10 (7122 in chips) 
Spectral34: posts the ante 150
TRAVISROYAL: posts the ante 150
lucasrojo: posts the ante 150
UruRey: posts the ante 150
Pkrscott1992: posts the ante 150
lulira10: posts the ante 150
Spectral34: posts small blind 300
TRAVISROYAL: posts big blind 600
*** HOLE CARDS ***
lucasrojo: raises 1770 to 2370 and is all-in
UruRey: folds 
Pkrscott1992: folds 
lulira10: raises 4602 to 6972 and is all-in
Spectral34: folds 
TRAVISROYAL: folds 
Uncalled bet (4602) returned to lulira10
*** FLOP *** [5h 4h Qh]
*** TURN *** [5h 4h Qh] [Th]
*** RIVER *** [5h 4h Qh Th] [Qs]
*** SHOW DOWN ***
lucasrojo: shows [Jh 8d] (a flush, Queen high)
lulira10: shows [2h Kh] (a flush, King high)
lulira10 collected 6540 from pot
lucasrojo is sitting out
lucasrojo finished the tournament
*** SUMMARY ***
Total pot 6540 | Rake 0 
Board [5h 4h Qh Th Qs]
Seat 1: Spectral34 (small blind) folded before Flop
Seat 2: TRAVISROYAL (big blind) folded before Flop
Seat 3: lucasrojo showed [Jh 8d] and lost with a flush, Queen high
Seat 4: UruRey folded before Flop (didn't bet)
Seat 5: Pkrscott1992 folded before Flop (didn't bet)
Seat 6: lulira10 (button) showed [2h Kh] and won (6540) with a flush, King high

PokerStars Hand #251209614280: Tournament #3769361908, $52.38+$2.62 USD Hold'em No Limit - Level XII (300/600) - 2024/06/26 22:36:30 UTC [2024/06/26 18:36:30 ET]
Table '3769361908 11' 6-max Seat #1 is the button
Seat 1: Spectral34 (20430 in chips) 
Seat 2: TRAVISROYAL (12505 in chips) 
Seat 4: UruRey (11393 in chips) 
Seat 5: Pkrscott1992 (5288 in chips) 
Seat 6: lulira10 (11142 in chips) 
Spectral34: posts the ante 150
TRAVISROYAL: posts the ante 150
UruRey: posts the ante 150
Pkrscott1992: posts the ante 150
lulira10: posts the ante 150
TRAVISROYAL: posts small blind 300
UruRey: posts big blind 600
*** HOLE CARDS ***
Pkrscott1992: raises 4538 to 5138 and is all-in
lulira10: folds 
Spectral34: folds 
TRAVISROYAL: folds 
UruRey: calls 4538
*** FLOP *** [2s Jd Qc]
*** TURN *** [2s Jd Qc] [Ah]
*** RIVER *** [2s Jd Qc Ah] [7s]
*** SHOW DOWN ***
UruRey: shows [Kc Kh] (a pair of Kings)
Pkrscott1992: shows [As 9h] (a pair of Aces)
Pkrscott1992 collected 11326 from pot
*** SUMMARY ***
Total pot 11326 | Rake 0 
Board [2s Jd Qc Ah 7s]
Seat 1: Spectral34 (button) folded before Flop (didn't bet)
Seat 2: TRAVISROYAL (small blind) folded before Flop
Seat 4: UruRey (big blind) showed [Kc Kh] and lost with a pair of Kings
Seat 5: Pkrscott1992 showed [As 9h] and won (11326) with a pair of Aces
Seat 6: lulira10 folded before Flop (didn't bet)

PokerStars Hand #251209621158: Tournament #3769361908, $52.38+$2.62 USD Hold'em No Limit - Level XII (300/600) - 2024/06/26 22:36:56 UTC [2024/06/26 18:36:56 ET]
Table '3769361908 11' 6-max Seat #2 is the button
Seat 1: Spectral34 (20280 in chips) 
Seat 2: TRAVISROYAL (12055 in chips) 
Seat 4: UruRey (6105 in chips) 
Seat 5: Pkrscott1992 (11326 in chips) 
Seat 6: lulira10 (10992 in chips) 
Spectral34: posts the ante 150
TRAVISROYAL: posts the ante 150
UruRey: posts the ante 150
Pkrscott1992: posts the ante 150
lulira10: posts the ante 150
UruRey: posts small blind 300
Pkrscott1992: posts big blind 600
*** HOLE CARDS ***
lulira10: folds 
Spectral34: folds 
TRAVISROYAL: folds 
Rochinha2011 is disconnected 
UruRey: raises 5355 to 5955 and is all-in
Pkrscott1992: folds 
Uncalled bet (5355) returned to UruRey
UruRey collected 1950 from pot
UruRey: doesn't show hand 
*** SUMMARY ***
Total pot 1950 | Rake 0 
Seat 1: Spectral34 folded before Flop (didn't bet)
Seat 2: TRAVISROYAL (button) folded before Flop (didn't bet)
Seat 4: UruRey (small blind) collected (1950)
Seat 5: Pkrscott1992 (big blind) folded before Flop
Seat 6: lulira10 folded before Flop (didn't bet)

PokerStars Hand #251209624683: Tournament #3769361908, $52.38+$2.62 USD Hold'em No Limit - Level XII (300/600) - 2024/06/26 22:37:09 UTC [2024/06/26 18:37:09 ET]
Table '3769361908 11' 6-max Seat #4 is the button
Seat 1: Spectral34 (20130 in chips) 
Seat 2: TRAVISROYAL (11905 in chips) 
Seat 3: Rochinha2011 (10000 in chips) 
Seat 4: UruRey (7305 in chips) 
Seat 5: Pkrscott1992 (10576 in chips) 
Seat 6: lulira10 (10842 in chips) 
Spectral34: posts the ante 150
TRAVISROYAL: posts the ante 150
Rochinha2011: posts the ante 150
UruRey: posts the ante 150
Pkrscott1992: posts the ante 150
lulira10: posts the ante 150
Pkrscott1992: posts small blind 300
lulira10: posts big blind 600
*** HOLE CARDS ***
Spectral34: raises 600 to 1200
TRAVISROYAL: folds 
Rochinha2011: folds 
UruRey: raises 5955 to 7155 and is all-in
Pkrscott1992: folds 
lulira10: folds 
Spectral34: calls 5955
*** FLOP *** [Kc Jh Qh]
*** TURN *** [Kc Jh Qh] [4s]
*** RIVER *** [Kc Jh Qh 4s] [2c]
*** SHOW DOWN ***
Spectral34: shows [As Ac] (a pair of Aces)
UruRey: shows [Ad Jd] (a pair of Jacks)
Spectral34 collected 16110 from pot
UruRey finished the tournament
*** SUMMARY ***
Total pot 16110 | Rake 0 
Board [Kc Jh Qh 4s 2c]
Seat 1: Spectral34 showed [As Ac] and won (16110) with a pair of Aces
Seat 2: TRAVISROYAL folded before Flop (didn't bet)
Seat 3: Rochinha2011 folded before Flop (didn't bet)
Seat 4: UruRey (button) showed [Ad Jd] and lost with a pair of Jacks
Seat 5: Pkrscott1992 (small blind) folded before Flop
Seat 6: lulira10 (big blind) folded before Flop

PokerStars Hand #251209630523: Tournament #3769361908, $52.38+$2.62 USD Hold'em No Limit - Level XII (300/600) - 2024/06/26 22:37:32 UTC [2024/06/26 18:37:32 ET]
Table '3769361908 11' 6-max Seat #5 is the button
Seat 1: Spectral34 (28935 in chips) 
Seat 2: TRAVISROYAL (11755 in chips) 
Seat 3: Rochinha2011 (9850 in chips) 
Seat 5: Pkrscott1992 (10126 in chips) 
Seat 6: lulira10 (10092 in chips) 
Spectral34: posts the ante 150
TRAVISROYAL: posts the ante 150
Rochinha2011: posts the ante 150
Pkrscott1992: posts the ante 150
lulira10: posts the ante 150
lulira10: posts small blind 300
Spectral34: posts big blind 600
*** HOLE CARDS ***
TRAVISROYAL: folds 
kayamia is disconnected 
Rochinha2011: folds 
Pkrscott1992: folds 
lulira10: raises 9342 to 9942 and is all-in
Spectral34: calls 9342
*** FLOP *** [8h 9s 2d]
*** TURN *** [8h 9s 2d] [4h]
*** RIVER *** [8h 9s 2d 4h] [4c]
*** SHOW DOWN ***
lulira10: shows [6d Ad] (a pair of Fours)
Spectral34: shows [Tc Kd] (a pair of Fours - lower kicker)
lulira10 collected 20634 from pot
*** SUMMARY ***
Total pot 20634 | Rake 0 
Board [8h 9s 2d 4h 4c]
Seat 1: Spectral34 (big blind) showed [Tc Kd] and lost with a pair of Fours
Seat 2: TRAVISROYAL folded before Flop (didn't bet)
Seat 3: Rochinha2011 folded before Flop (didn't bet)
Seat 5: Pkrscott1992 (button) folded before Flop (didn't bet)
Seat 6: lulira10 (small blind) showed [6d Ad] and won (20634) with a pair of Fours

PokerStars Hand #251209637201: Tournament #3769361908, $52.38+$2.62 USD Hold'em No Limit - Level XII (300/600) - 2024/06/26 22:37:57 UTC [2024/06/26 18:37:57 ET]
Table '3769361908 11' 6-max Seat #6 is the button
Seat 1: Spectral34 (18843 in chips) 
Seat 2: TRAVISROYAL (11605 in chips) 
Seat 3: Rochinha2011 (9700 in chips) 
Seat 4: kayamia (10000 in chips) 
Seat 5: Pkrscott1992 (9976 in chips) 
Seat 6: lulira10 (20634 in chips) 
Spectral34: posts the ante 150
TRAVISROYAL: posts the ante 150
Rochinha2011: posts the ante 150
kayamia: posts the ante 150
Pkrscott1992: posts the ante 150
lulira10: posts the ante 150
Spectral34: posts small blind 300
TRAVISROYAL: posts big blind 600
*** HOLE CARDS ***
Rochinha2011: raises 600 to 1200
kayamia: folds 
Pkrscott1992: folds 
lulira10: folds 
Spectral34: folds 
TRAVISROYAL: calls 600
*** FLOP *** [3s 9h 6d]
TRAVISROYAL: bets 1800
Rochinha2011: raises 1800 to 3600
TRAVISROYAL: calls 1800
*** TURN *** [3s 9h 6d] [7d]
TRAVISROYAL: bets 2400
Rochinha2011: raises 2350 to 4750 and is all-in
TRAVISROYAL: calls 2350
*** RIVER *** [3s 9h 6d 7d] [2d]
*** SHOW DOWN ***
TRAVISROYAL: shows [Ts Kc] (high card King)
Rochinha2011: shows [9d As] (a pair of Nines)
Rochinha2011 collected 20300 from pot
*** SUMMARY ***
Total pot 20300 | Rake 0 
Board [3s 9h 6d 7d 2d]
Seat 1: Spectral34 (small blind) folded before Flop
Seat 2: TRAVISROYAL (big blind) showed [Ts Kc] and lost with high card King
Seat 3: Rochinha2011 showed [9d As] and won (20300) with a pair of Nines
Seat 4: kayamia folded before Flop (didn't bet)
Seat 5: Pkrscott1992 folded before Flop (didn't bet)
Seat 6: lulira10 (button) folded before Flop (didn't bet)

PokerStars Hand #251209655531: Tournament #3769361908, $52.38+$2.62 USD Hold'em No Limit - Level XIII (400/800) - 2024/06/26 22:39:05 UTC [2024/06/26 18:39:05 ET]
Table '3769361908 11' 6-max Seat #1 is the button
Seat 1: Spectral34 (18393 in chips) 
Seat 2: TRAVISROYAL (1905 in chips) 
Seat 3: Rochinha2011 (20300 in chips) 
Seat 4: kayamia (9850 in chips) 
Seat 5: Pkrscott1992 (9826 in chips) 
Seat 6: lulira10 (20484 in chips) 
Spectral34: posts the ante 200
TRAVISROYAL: posts the ante 200
Rochinha2011: posts the ante 200
kayamia: posts the ante 200
Pkrscott1992: posts the ante 200
lulira10: posts the ante 200
TRAVISROYAL: posts small blind 400
Rochinha2011: posts big blind 800
*** HOLE CARDS ***
kayamia: folds 
Pkrscott1992: raises 8826 to 9626 and is all-in
lulira10: calls 9626
Spectral34: folds 
TRAVISROYAL: calls 1305 and is all-in
Rochinha2011: folds 
*** FLOP *** [Kd Ks 5s]
*** TURN *** [Kd Ks 5s] [8d]
*** RIVER *** [Kd Ks 5s 8d] [Jh]
*** SHOW DOWN ***
Pkrscott1992: shows [Qs 9s] (a pair of Kings)
lulira10: shows [Js As] (two pair, Kings and Jacks)
lulira10 collected 15842 from side pot
TRAVISROYAL: shows [9h 7h] (a pair of Kings)
lulira10 collected 7115 from main pot
Pkrscott1992 finished the tournament
TRAVISROYAL finished the tournament
LadyLuke2010 is disconnected 
*** SUMMARY ***
Total pot 22957 Main pot 7115. Side pot 15842. | Rake 0 
Board [Kd Ks 5s 8d Jh]
Seat 1: Spectral34 (button) folded before Flop (didn't bet)
Seat 2: TRAVISROYAL (small blind) showed [9h 7h] and lost with a pair of Kings
Seat 3: Rochinha2011 (big blind) folded before Flop
Seat 4: kayamia folded before Flop (didn't bet)
Seat 5: Pkrscott1992 showed [Qs 9s] and lost with a pair of Kings
Seat 6: lulira10 showed [Js As] and won (22957) with two pair, Kings and Jacks

PokerStars Hand #251209661945: Tournament #3769361908, $52.38+$2.62 USD Hold'em No Limit - Level XIII (400/800) - 2024/06/26 22:39:29 UTC [2024/06/26 18:39:29 ET]
Table '3769361908 11' 6-max Seat #3 is the button
Seat 1: Spectral34 (18193 in chips) 
Seat 2: LadyLuke2010 (8100 in chips) 
Seat 3: Rochinha2011 (19300 in chips) 
Seat 4: kayamia (9650 in chips) 
Seat 6: lulira10 (33615 in chips) 
Spectral34: posts the ante 200
LadyLuke2010: posts the ante 200
Rochinha2011: posts the ante 200
kayamia: posts the ante 200
lulira10: posts the ante 200
kayamia: posts small blind 400
lulira10: posts big blind 800
*** HOLE CARDS ***
Spectral34: raises 800 to 1600
LadyLuke2010: calls 1600
Rochinha2011: folds 
kayamia: folds 
lulira10: calls 800
*** FLOP *** [Tc 8c Qd]
lulira10: checks 
Spectral34: bets 2400
LadyLuke2010: raises 3900 to 6300 and is all-in
lulira10: folds 
Spectral34: calls 3900
*** TURN *** [Tc 8c Qd] [2c]
*** RIVER *** [Tc 8c Qd 2c] [9s]
*** SHOW DOWN ***
Spectral34: shows [9c Kc] (a flush, King high)
LadyLuke2010: shows [Td Jh] (a straight, Eight to Queen)
Spectral34 collected 18800 from pot
LadyLuke2010 finished the tournament
*** SUMMARY ***
Total pot 18800 | Rake 0 
Board [Tc 8c Qd 2c 9s]
Seat 1: Spectral34 showed [9c Kc] and won (18800) with a flush, King high
Seat 2: LadyLuke2010 showed [Td Jh] and lost with a straight, Eight to Queen
Seat 3: Rochinha2011 (button) folded before Flop (didn't bet)
Seat 4: kayamia (small blind) folded before Flop
Seat 6: lulira10 (big blind) folded on the Flop

PokerStars Hand #251209670120: Tournament #3769361908, $52.38+$2.62 USD Hold'em No Limit - Level XIII (400/800) - 2024/06/26 22:39:59 UTC [2024/06/26 18:39:59 ET]
Table '3769361908 11' 6-max Seat #4 is the button
Seat 1: Spectral34 (28893 in chips) 
Seat 3: Rochinha2011 (19100 in chips) 
Seat 4: kayamia (9050 in chips) 
Seat 6: lulira10 (31815 in chips) 
Spectral34: posts the ante 200
Rochinha2011: posts the ante 200
kayamia: posts the ante 200
lulira10: posts the ante 200
lulira10: posts small blind 400
Spectral34: posts big blind 800
*** HOLE CARDS ***
biuzinho17 is disconnected 
Rochinha2011: folds 
kayamia: folds 
lulira10: raises 800 to 1600
Spectral34: calls 800
*** FLOP *** [Ad Jd Ac]
lulira10: bets 2000
Spectral34: folds 
Uncalled bet (2000) returned to lulira10
aramio29 is disconnected 
lulira10 collected 4000 from pot
lulira10: doesn't show hand 
*** SUMMARY ***
Total pot 4000 | Rake 0 
Board [Ad Jd Ac]
Seat 1: Spectral34 (big blind) folded on the Flop
Seat 3: Rochinha2011 folded before Flop (didn't bet)
Seat 4: kayamia (button) folded before Flop (didn't bet)
Seat 6: lulira10 (small blind) collected (4000)

PokerStars Hand #251209675141: Tournament #3769361908, $52.38+$2.62 USD Hold'em No Limit - Level XIII (400/800) - 2024/06/26 22:40:19 UTC [2024/06/26 18:40:19 ET]
Table '3769361908 11' 6-max Seat #6 is the button
Seat 1: Spectral34 (27093 in chips) 
Seat 2: biuzinho17 (23100 in chips) 
Seat 3: Rochinha2011 (18900 in chips) 
Seat 4: kayamia (8850 in chips) 
Seat 5: aramio29 (19808 in chips) 
Seat 6: lulira10 (34015 in chips) 
Spectral34: posts the ante 200
biuzinho17: posts the ante 200
Rochinha2011: posts the ante 200
kayamia: posts the ante 200
aramio29: posts the ante 200
lulira10: posts the ante 200
Spectral34: posts small blind 400
biuzinho17: posts big blind 800
*** HOLE CARDS ***
Rochinha2011: folds 
kayamia: raises 800 to 1600
aramio29: folds 
lulira10: folds 
Spectral34: folds 
biuzinho17: folds 
Uncalled bet (800) returned to kayamia
kayamia collected 3200 from pot
kayamia: doesn't show hand 
*** SUMMARY ***
Total pot 3200 | Rake 0 
Seat 1: Spectral34 (small blind) folded before Flop
Seat 2: biuzinho17 (big blind) folded before Flop
Seat 3: Rochinha2011 folded before Flop (didn't bet)
Seat 4: kayamia collected (3200)
Seat 5: aramio29 folded before Flop (didn't bet)
Seat 6: lulira10 (button) folded before Flop (didn't bet)

PokerStars Hand #251209679408: Tournament #3769361908, $52.38+$2.62 USD Hold'em No Limit - Level XIII (400/800) - 2024/06/26 22:40:35 UTC [2024/06/26 18:40:35 ET]
Table '3769361908 11' 6-max Seat #1 is the button
Seat 1: Spectral34 (26493 in chips) 
Seat 2: biuzinho17 (22100 in chips) 
Seat 3: Rochinha2011 (18700 in chips) 
Seat 4: kayamia (11050 in chips) 
Seat 5: aramio29 (19608 in chips) 
Seat 6: lulira10 (33815 in chips) 
Spectral34: posts the ante 200
biuzinho17: posts the ante 200
Rochinha2011: posts the ante 200
kayamia: posts the ante 200
aramio29: posts the ante 200
lulira10: posts the ante 200
biuzinho17: posts small blind 400
Rochinha2011: posts big blind 800
*** HOLE CARDS ***
kayamia: folds 
aramio29: folds 
lulira10: calls 800
Spectral34: folds 
biuzinho17: calls 400
Rochinha2011: raises 2400 to 3200
lulira10: folds 
biuzinho17: folds 
Uncalled bet (2400) returned to Rochinha2011
Rochinha2011 collected 3600 from pot
Rochinha2011: doesn't show hand 
*** SUMMARY ***
Total pot 3600 | Rake 0 
Seat 1: Spectral34 (button) folded before Flop (didn't bet)
Seat 2: biuzinho17 (small blind) folded before Flop
Seat 3: Rochinha2011 (big blind) collected (3600)
Seat 4: kayamia folded before Flop (didn't bet)
Seat 5: aramio29 folded before Flop (didn't bet)
Seat 6: lulira10 folded before Flop

PokerStars Hand #251209689681: Tournament #3769361908, $52.38+$2.62 USD Hold'em No Limit - Level XIV (500/1000) - 2024/06/26 22:41:14 UTC [2024/06/26 18:41:14 ET]
Table '3769361908 11' 6-max Seat #2 is the button
Seat 1: Spectral34 (26293 in chips) 
Seat 2: biuzinho17 (21100 in chips) 
Seat 3: Rochinha2011 (21300 in chips) 
Seat 4: kayamia (10850 in chips) 
Seat 5: aramio29 (19408 in chips) 
Seat 6: lulira10 (32815 in chips) 
Spectral34: posts the ante 250
biuzinho17: posts the ante 250
Rochinha2011: posts the ante 250
kayamia: posts the ante 250
aramio29: posts the ante 250
lulira10: posts the ante 250
Rochinha2011: posts small blind 500
kayamia: posts big blind 1000
*** HOLE CARDS ***
aramio29: folds 
lulira10: folds 
Spectral34: raises 1000 to 2000
biuzinho17: folds 
Rochinha2011: raises 4500 to 6500
kayamia: folds 
Spectral34: folds 
Uncalled bet (4500) returned to Rochinha2011
Rochinha2011 collected 6500 from pot
Rochinha2011: doesn't show hand 
*** SUMMARY ***
Total pot 6500 | Rake 0 
Seat 1: Spectral34 folded before Flop
Seat 2: biuzinho17 (button) folded before Flop (didn't bet)
Seat 3: Rochinha2011 (small blind) collected (6500)
Seat 4: kayamia (big blind) folded before Flop
Seat 5: aramio29 folded before Flop (didn't bet)
Seat 6: lulira10 folded before Flop (didn't bet)

PokerStars Hand #251209701786: Tournament #3769361908, $52.38+$2.62 USD Hold'em No Limit - Level XIV (500/1000) - 2024/06/26 22:42:01 UTC [2024/06/26 18:42:01 ET]
Table '3769361908 11' 6-max Seat #3 is the button
Seat 1: Spectral34 (24043 in chips) 
Seat 2: biuzinho17 (20850 in chips) 
Seat 3: Rochinha2011 (25550 in chips) 
Seat 4: kayamia (9600 in chips) 
Seat 5: aramio29 (19158 in chips) 
Seat 6: lulira10 (32565 in chips) 
Spectral34: posts the ante 250
biuzinho17: posts the ante 250
Rochinha2011: posts the ante 250
kayamia: posts the ante 250
aramio29: posts the ante 250
lulira10: posts the ante 250
kayamia: posts small blind 500
aramio29: posts big blind 1000
*** HOLE CARDS ***
lulira10: folds 
Spectral34: folds 
biuzinho17: raises 1000 to 2000
Rochinha2011: folds 
kayamia: folds 
aramio29: folds 
Uncalled bet (1000) returned to biuzinho17
biuzinho17 collected 4000 from pot
biuzinho17: doesn't show hand 
*** SUMMARY ***
Total pot 4000 | Rake 0 
Seat 1: Spectral34 folded before Flop (didn't bet)
Seat 2: biuzinho17 collected (4000)
Seat 3: Rochinha2011 (button) folded before Flop (didn't bet)
Seat 4: kayamia (small blind) folded before Flop
Seat 5: aramio29 (big blind) folded before Flop
Seat 6: lulira10 folded before Flop (didn't bet)

PokerStars Hand #251209706055: Tournament #3769361908, $52.38+$2.62 USD Hold'em No Limit - Level XIV (500/1000) - 2024/06/26 22:42:18 UTC [2024/06/26 18:42:18 ET]
Table '3769361908 11' 6-max Seat #4 is the button
Seat 1: Spectral34 (23793 in chips) 
Seat 2: biuzinho17 (23600 in chips) 
Seat 3: Rochinha2011 (25300 in chips) 
Seat 4: kayamia (8850 in chips) 
Seat 5: aramio29 (17908 in chips) 
Seat 6: lulira10 (32315 in chips) 
Spectral34: posts the ante 250
biuzinho17: posts the ante 250
Rochinha2011: posts the ante 250
kayamia: posts the ante 250
aramio29: posts the ante 250
lulira10: posts the ante 250
aramio29: posts small blind 500
lulira10: posts big blind 1000
*** HOLE CARDS ***
Spectral34: folds 
biuzinho17: folds 
Rochinha2011: folds 
kayamia: folds 
aramio29: calls 500
lulira10: raises 31065 to 32065 and is all-in
aramio29: folds 
Uncalled bet (31065) returned to lulira10
lulira10 collected 3500 from pot
lulira10: doesn't show hand 
*** SUMMARY ***
Total pot 3500 | Rake 0 
Seat 1: Spectral34 folded before Flop (didn't bet)
Seat 2: biuzinho17 folded before Flop (didn't bet)
Seat 3: Rochinha2011 folded before Flop (didn't bet)
Seat 4: kayamia (button) folded before Flop (didn't bet)
Seat 5: aramio29 (small blind) folded before Flop
Seat 6: lulira10 (big blind) collected (3500)

PokerStars Hand #251209712367: Tournament #3769361908, $52.38+$2.62 USD Hold'em No Limit - Level XIV (500/1000) - 2024/06/26 22:42:42 UTC [2024/06/26 18:42:42 ET]
Table '3769361908 11' 6-max Seat #5 is the button
Seat 1: Spectral34 (23543 in chips) 
Seat 2: biuzinho17 (23350 in chips) 
Seat 3: Rochinha2011 (25050 in chips) 
Seat 4: kayamia (8600 in chips) 
Seat 5: aramio29 (16658 in chips) 
Seat 6: lulira10 (34565 in chips) 
Spectral34: posts the ante 250
biuzinho17: posts the ante 250
Rochinha2011: posts the ante 250
kayamia: posts the ante 250
aramio29: posts the ante 250
lulira10: posts the ante 250
lulira10: posts small blind 500
Spectral34: posts big blind 1000
*** HOLE CARDS ***
biuzinho17: folds 
Rochinha2011: raises 1000 to 2000
kayamia: folds 
aramio29: folds 
lulira10: folds 
Spectral34: calls 1000
*** FLOP *** [8h Jh 2h]
Spectral34: checks 
Rochinha2011: bets 1500
Spectral34: calls 1500
*** TURN *** [8h Jh 2h] [9s]
Spectral34: checks 
Rochinha2011: checks 
*** RIVER *** [8h Jh 2h 9s] [9h]
Spectral34: checks 
Rochinha2011: checks 
*** SHOW DOWN ***
Spectral34: shows [Js Kd] (two pair, Jacks and Nines)
Rochinha2011: shows [9c Ac] (three of a kind, Nines)
Rochinha2011 collected 9000 from pot
*** SUMMARY ***
Total pot 9000 | Rake 0 
Board [8h Jh 2h 9s 9h]
Seat 1: Spectral34 (big blind) showed [Js Kd] and lost with two pair, Jacks and Nines
Seat 2: biuzinho17 folded before Flop (didn't bet)
Seat 3: Rochinha2011 showed [9c Ac] and won (9000) with three of a kind, Nines
Seat 4: kayamia folded before Flop (didn't bet)
Seat 5: aramio29 (button) folded before Flop (didn't bet)
Seat 6: lulira10 (small blind) folded before Flop

PokerStars Hand #251209728790: Tournament #3769361908, $52.38+$2.62 USD Hold'em No Limit - Level XIV (500/1000) - 2024/06/26 22:43:46 UTC [2024/06/26 18:43:46 ET]
Table '3769361908 11' 6-max Seat #6 is the button
Seat 1: Spectral34 (19793 in chips) 
Seat 2: biuzinho17 (23100 in chips) 
Seat 3: Rochinha2011 (30300 in chips) 
Seat 4: kayamia (8350 in chips) 
Seat 5: aramio29 (16408 in chips) 
Seat 6: lulira10 (33815 in chips) 
Spectral34: posts the ante 250
biuzinho17: posts the ante 250
Rochinha2011: posts the ante 250
kayamia: posts the ante 250
aramio29: posts the ante 250
lulira10: posts the ante 250
Spectral34: posts small blind 500
biuzinho17: posts big blind 1000
*** HOLE CARDS ***
Rochinha2011: folds 
kayamia: folds 
aramio29: folds 
lulira10: calls 1000
Spectral34: folds 
biuzinho17: checks 
*** FLOP *** [8c Qc 2h]
biuzinho17: checks 
lulira10: bets 2000
biuzinho17: folds 
Uncalled bet (2000) returned to lulira10
lulira10 collected 4000 from pot
lulira10: doesn't show hand 
*** SUMMARY ***
Total pot 4000 | Rake 0 
Board [8c Qc 2h]
Seat 1: Spectral34 (small blind) folded before Flop
Seat 2: biuzinho17 (big blind) folded on the Flop
Seat 3: Rochinha2011 folded before Flop (didn't bet)
Seat 4: kayamia folded before Flop (didn't bet)
Seat 5: aramio29 folded before Flop (didn't bet)
Seat 6: lulira10 (button) collected (4000)

PokerStars Hand #251209739119: Tournament #3769361908, $52.38+$2.62 USD Hold'em No Limit - Level XV (600/1200) - 2024/06/26 22:44:27 UTC [2024/06/26 18:44:27 ET]
Table '3769361908 11' 6-max Seat #1 is the button
Seat 1: Spectral34 (19043 in chips) 
Seat 2: biuzinho17 (21850 in chips) 
Seat 3: Rochinha2011 (30050 in chips) 
Seat 4: kayamia (8100 in chips) 
Seat 5: aramio29 (16158 in chips) 
Seat 6: lulira10 (36565 in chips) 
Spectral34: posts the ante 300
biuzinho17: posts the ante 300
Rochinha2011: posts the ante 300
kayamia: posts the ante 300
aramio29: posts the ante 300
lulira10: posts the ante 300
biuzinho17: posts small blind 600
Rochinha2011: posts big blind 1200
*** HOLE CARDS ***
kayamia: folds 
aramio29: folds 
lulira10: folds 
Spectral34: folds 
biuzinho17: calls 600
Rochinha2011: raises 2400 to 3600
biuzinho17: calls 2400
*** FLOP *** [Qd Ac 3c]
biuzinho17: checks 
Rochinha2011: bets 2250
biuzinho17: calls 2250
*** TURN *** [Qd Ac 3c] [6h]
biuzinho17: checks 
Rochinha2011: checks 
*** RIVER *** [Qd Ac 3c 6h] [3h]
biuzinho17: bets 15700 and is all-in
Rochinha2011: folds 
Uncalled bet (15700) returned to biuzinho17
biuzinho17 collected 13500 from pot
biuzinho17: doesn't show hand 
*** SUMMARY ***
Total pot 13500 | Rake 0 
Board [Qd Ac 3c 6h 3h]
Seat 1: Spectral34 (button) folded before Flop (didn't bet)
Seat 2: biuzinho17 (small blind) collected (13500)
Seat 3: Rochinha2011 (big blind) folded on the River
Seat 4: kayamia folded before Flop (didn't bet)
Seat 5: aramio29 folded before Flop (didn't bet)
Seat 6: lulira10 folded before Flop (didn't bet)

PokerStars Hand #251209767002: Tournament #3769361908, $52.38+$2.62 USD Hold'em No Limit - Level XV (600/1200) - 2024/06/26 22:46:15 UTC [2024/06/26 18:46:15 ET]
Table '3769361908 11' 6-max Seat #2 is the button
Seat 1: Spectral34 (18743 in chips) 
Seat 2: biuzinho17 (29200 in chips) 
Seat 3: Rochinha2011 (23900 in chips) 
Seat 4: kayamia (7800 in chips) 
Seat 5: aramio29 (15858 in chips) 
Seat 6: lulira10 (36265 in chips) 
Spectral34: posts the ante 300
biuzinho17: posts the ante 300
Rochinha2011: posts the ante 300
kayamia: posts the ante 300
aramio29: posts the ante 300
lulira10: posts the ante 300
Rochinha2011: posts small blind 600
kayamia: posts big blind 1200
*** HOLE CARDS ***
aramio29: folds 
lulira10: folds 
Spectral34: folds 
biuzinho17: folds 
Rochinha2011: raises 22400 to 23600 and is all-in
kayamia: calls 6300 and is all-in
Uncalled bet (16100) returned to Rochinha2011
*** FLOP *** [Qs 4h Ac]
*** TURN *** [Qs 4h Ac] [2h]
*** RIVER *** [Qs 4h Ac 2h] [Ah]
*** SHOW DOWN ***
Rochinha2011: shows [6s Kc] (a pair of Aces)
kayamia: shows [7s 8d] (a pair of Aces - lower kicker)
Rochinha2011 collected 16800 from pot
kayamia finished the tournament
*** SUMMARY ***
Total pot 16800 | Rake 0 
Board [Qs 4h Ac 2h Ah]
Seat 1: Spectral34 folded before Flop (didn't bet)
Seat 2: biuzinho17 (button) folded before Flop (didn't bet)
Seat 3: Rochinha2011 (small blind) showed [6s Kc] and won (16800) with a pair of Aces
Seat 4: kayamia (big blind) showed [7s 8d] and lost with a pair of Aces
Seat 5: aramio29 folded before Flop (didn't bet)
Seat 6: lulira10 folded before Flop (didn't bet)

PokerStars Hand #251209776579: Tournament #3769361908, $52.38+$2.62 USD Hold'em No Limit - Level XV (600/1200) - 2024/06/26 22:46:52 UTC [2024/06/26 18:46:52 ET]
Table '3769361908 11' 6-max Seat #3 is the button
Seat 1: Spectral34 (18443 in chips) 
Seat 2: biuzinho17 (28900 in chips) 
Seat 3: Rochinha2011 (32900 in chips) 
Seat 5: aramio29 (15558 in chips) 
Seat 6: lulira10 (35965 in chips) 
Spectral34: posts the ante 300
biuzinho17: posts the ante 300
Rochinha2011: posts the ante 300
aramio29: posts the ante 300
lulira10: posts the ante 300
aramio29: posts small blind 600
lulira10: posts big blind 1200
*** HOLE CARDS ***
Spectral34: folds 
MjLK MAN is disconnected 
biuzinho17: folds 
Rochinha2011: raises 1200 to 2400
aramio29: raises 12858 to 15258 and is all-in
lulira10: folds 
Rochinha2011: calls 12858
*** FLOP *** [6d Jd 3c]
*** TURN *** [6d Jd 3c] [9d]
*** RIVER *** [6d Jd 3c 9d] [8c]
*** SHOW DOWN ***
aramio29: shows [Jh As] (a pair of Jacks)
Rochinha2011: shows [Qd Qc] (a pair of Queens)
Rochinha2011 collected 33216 from pot
aramio29 finished the tournament
*** SUMMARY ***
Total pot 33216 | Rake 0 
Board [6d Jd 3c 9d 8c]
Seat 1: Spectral34 folded before Flop (didn't bet)
Seat 2: biuzinho17 folded before Flop (didn't bet)
Seat 3: Rochinha2011 (button) showed [Qd Qc] and won (33216) with a pair of Queens
Seat 5: aramio29 (small blind) showed [Jh As] and lost with a pair of Jacks
Seat 6: lulira10 (big blind) folded before Flop

PokerStars Hand #251209785189: Tournament #3769361908, $52.38+$2.62 USD Hold'em No Limit - Level XVI (800/1600) - 2024/06/26 22:47:26 UTC [2024/06/26 18:47:26 ET]
Table '3769361908 11' 6-max Seat #6 is the button
Seat 1: Spectral34 (18143 in chips) 
Seat 2: biuzinho17 (28600 in chips) 
Seat 3: Rochinha2011 (50558 in chips) 
Seat 4: MjLK MAN (10000 in chips) 
Seat 6: lulira10 (34465 in chips) 
Spectral34: posts the ante 400
biuzinho17: posts the ante 400
Rochinha2011: posts the ante 400
MjLK MAN: posts the ante 400
lulira10: posts the ante 400
Spectral34: posts small blind 800
biuzinho17: posts big blind 1600
*** HOLE CARDS ***
Rochinha2011: folds 
MjLK MAN: raises 8000 to 9600 and is all-in
Boogz96 is disconnected 
lulira10: folds 
Spectral34: folds 
biuzinho17: folds 
Uncalled bet (8000) returned to MjLK MAN
MjLK MAN collected 6000 from pot
MjLK MAN: doesn't show hand 
*** SUMMARY ***
Total pot 6000 | Rake 0 
Seat 1: Spectral34 (small blind) folded before Flop
Seat 2: biuzinho17 (big blind) folded before Flop
Seat 3: Rochinha2011 folded before Flop (didn't bet)
Seat 4: MjLK MAN collected (6000)
Seat 6: lulira10 (button) folded before Flop (didn't bet)

PokerStars Hand #251209798470: Tournament #3769361908, $52.38+$2.62 USD Hold'em No Limit - Level XVI (800/1600) - 2024/06/26 22:48:18 UTC [2024/06/26 18:48:18 ET]
Table '3769361908 11' 6-max Seat #1 is the button
Seat 1: Spectral34 (16943 in chips) 
Seat 2: biuzinho17 (26600 in chips) 
Seat 3: Rochinha2011 (50158 in chips) 
Seat 4: MjLK MAN (14000 in chips) 
Seat 5: Boogz96 (13800 in chips) 
Seat 6: lulira10 (34065 in chips) 
Spectral34: posts the ante 400
biuzinho17: posts the ante 400
Rochinha2011: posts the ante 400
MjLK MAN: posts the ante 400
Boogz96: posts the ante 400
lulira10: posts the ante 400
biuzinho17: posts small blind 800
Rochinha2011: posts big blind 1600
*** HOLE CARDS ***
MjLK MAN: folds 
Boogz96: folds 
lulira10: folds 
Spectral34: raises 14943 to 16543 and is all-in
biuzinho17: folds 
Rochinha2011: folds 
Uncalled bet (14943) returned to Spectral34
Spectral34 collected 6400 from pot
Spectral34: doesn't show hand 
*** SUMMARY ***
Total pot 6400 | Rake 0 
Seat 1: Spectral34 (button) collected (6400)
Seat 2: biuzinho17 (small blind) folded before Flop
Seat 3: Rochinha2011 (big blind) folded before Flop
Seat 4: MjLK MAN folded before Flop (didn't bet)
Seat 5: Boogz96 folded before Flop (didn't bet)
Seat 6: lulira10 folded before Flop (didn't bet)

PokerStars Hand #251209804741: Tournament #3769361908, $52.38+$2.62 USD Hold'em No Limit - Level XVI (800/1600) - 2024/06/26 22:48:43 UTC [2024/06/26 18:48:43 ET]
Table '3769361908 11' 6-max Seat #2 is the button
Seat 1: Spectral34 (21343 in chips) 
Seat 2: biuzinho17 (25400 in chips) 
Seat 3: Rochinha2011 (48158 in chips) 
Seat 4: MjLK MAN (13600 in chips) 
Seat 5: Boogz96 (13400 in chips) 
Seat 6: lulira10 (33665 in chips) 
Spectral34: posts the ante 400
biuzinho17: posts the ante 400
Rochinha2011: posts the ante 400
MjLK MAN: posts the ante 400
Boogz96: posts the ante 400
lulira10: posts the ante 400
Rochinha2011: posts small blind 800
MjLK MAN: posts big blind 1600
*** HOLE CARDS ***
Boogz96: folds 
lulira10: folds 
Spectral34: folds 
biuzinho17: raises 1600 to 3200
Rochinha2011: raises 44558 to 47758 and is all-in
MjLK MAN: folds 
biuzinho17: calls 21800 and is all-in
Uncalled bet (22758) returned to Rochinha2011
*** FLOP *** [5c 3h 4c]
*** TURN *** [5c 3h 4c] [Qd]
*** RIVER *** [5c 3h 4c Qd] [Kd]
*** SHOW DOWN ***
Rochinha2011: shows [Qc Kc] (two pair, Kings and Queens)
biuzinho17: shows [9c Ah] (high card Ace)
Rochinha2011 collected 54000 from pot
biuzinho17 finished the tournament in 120th place
*** SUMMARY ***
Total pot 54000 | Rake 0 
Board [5c 3h 4c Qd Kd]
Seat 1: Spectral34 folded before Flop (didn't bet)
Seat 2: biuzinho17 (button) showed [9c Ah] and lost with high card Ace
Seat 3: Rochinha2011 (small blind) showed [Qc Kc] and won (54000) with two pair, Kings and Queens
Seat 4: MjLK MAN (big blind) folded before Flop
Seat 5: Boogz96 folded before Flop (didn't bet)
Seat 6: lulira10 folded before Flop (didn't bet)

PokerStars Hand #251209815816: Tournament #3769361908, $52.38+$2.62 USD Hold'em No Limit - Level XVI (800/1600) - 2024/06/26 22:49:27 UTC [2024/06/26 18:49:27 ET]
Table '3769361908 11' 6-max Seat #3 is the button
Seat 1: Spectral34 (20943 in chips) 
Seat 3: Rochinha2011 (76758 in chips) 
Seat 4: MjLK MAN (11600 in chips) 
Seat 5: Boogz96 (13000 in chips) 
Seat 6: lulira10 (33265 in chips) 
Spectral34: posts the ante 400
Rochinha2011: posts the ante 400
MjLK MAN: posts the ante 400
Boogz96: posts the ante 400
lulira10: posts the ante 400
MjLK MAN: posts small blind 800
Boogz96: posts big blind 1600
*** HOLE CARDS ***
lulira10: folds 
Spectral34: folds 
Rochinha2011: raises 74758 to 76358 and is all-in
jack310759 is disconnected 
MjLK MAN: folds 
Boogz96: folds 
Uncalled bet (74758) returned to Rochinha2011
Rochinha2011 collected 6000 from pot
Rochinha2011: doesn't show hand 
*** SUMMARY ***
Total pot 6000 | Rake 0 
Seat 1: Spectral34 folded before Flop (didn't bet)
Seat 3: Rochinha2011 (button) collected (6000)
Seat 4: MjLK MAN (small blind) folded before Flop
Seat 5: Boogz96 (big blind) folded before Flop
Seat 6: lulira10 folded before Flop (didn't bet)

PokerStars Hand #251209828965: Tournament #3769361908, $52.38+$2.62 USD Hold'em No Limit - Level XVII (1000/2000) - 2024/06/26 22:50:21 UTC [2024/06/26 18:50:21 ET]
Table '3769361908 11' 6-max Seat #4 is the button
Seat 1: Spectral34 (20543 in chips) 
Seat 2: jack310759 (37083 in chips) 
Seat 3: Rochinha2011 (80758 in chips) 
Seat 4: MjLK MAN (10400 in chips) 
Seat 5: Boogz96 (11000 in chips) 
Seat 6: lulira10 (32865 in chips) 
Spectral34: posts the ante 500
jack310759: posts the ante 500
Rochinha2011: posts the ante 500
MjLK MAN: posts the ante 500
Boogz96: posts the ante 500
lulira10: posts the ante 500
Boogz96: posts small blind 1000
lulira10: posts big blind 2000
*** HOLE CARDS ***
Spectral34: folds 
jack310759: raises 4000 to 6000
Rochinha2011: folds 
MjLK MAN: raises 3900 to 9900 and is all-in
Boogz96: folds 
lulira10: folds 
jack310759: calls 3900
*** FLOP *** [6s Kc 2c]
*** TURN *** [6s Kc 2c] [9c]
*** RIVER *** [6s Kc 2c 9c] [2s]
*** SHOW DOWN ***
jack310759: shows [Ah 7h] (a pair of Deuces)
MjLK MAN: shows [Ad Td] (a pair of Deuces - Ace+King+Ten kicker)
MjLK MAN collected 25800 from pot
*** SUMMARY ***
Total pot 25800 | Rake 0 
Board [6s Kc 2c 9c 2s]
Seat 1: Spectral34 folded before Flop (didn't bet)
Seat 2: jack310759 showed [Ah 7h] and lost with a pair of Deuces
Seat 3: Rochinha2011 folded before Flop (didn't bet)
Seat 4: MjLK MAN (button) showed [Ad Td] and won (25800) with a pair of Deuces
Seat 5: Boogz96 (small blind) folded before Flop
Seat 6: lulira10 (big blind) folded before Flop

PokerStars Hand #251209846146: Tournament #3769361908, $52.38+$2.62 USD Hold'em No Limit - Level XVII (1000/2000) - 2024/06/26 22:51:31 UTC [2024/06/26 18:51:31 ET]
Table '3769361908 11' 6-max Seat #5 is the button
Seat 1: Spectral34 (20043 in chips) 
Seat 2: jack310759 (26683 in chips) 
Seat 3: Rochinha2011 (80258 in chips) 
Seat 4: MjLK MAN (25800 in chips) 
Seat 5: Boogz96 (9500 in chips) 
Seat 6: lulira10 (30365 in chips) 
Spectral34: posts the ante 500
jack310759: posts the ante 500
Rochinha2011: posts the ante 500
MjLK MAN: posts the ante 500
Boogz96: posts the ante 500
lulira10: posts the ante 500
lulira10: posts small blind 1000
Spectral34: posts big blind 2000
*** HOLE CARDS ***
jack310759: folds 
Rochinha2011: folds 
MjLK MAN: folds 
Boogz96: folds 
lulira10: raises 27865 to 29865 and is all-in
Spectral34: calls 17543 and is all-in
Uncalled bet (10322) returned to lulira10
*** FLOP *** [3s Ad 3c]
*** TURN *** [3s Ad 3c] [Ts]
*** RIVER *** [3s Ad 3c Ts] [9d]
*** SHOW DOWN ***
lulira10: shows [6h 6d] (two pair, Sixes and Threes)
Spectral34: shows [Ah 3d] (a full house, Threes full of Aces)
Spectral34 collected 42086 from pot
*** SUMMARY ***
Total pot 42086 | Rake 0 
Board [3s Ad 3c Ts 9d]
Seat 1: Spectral34 (big blind) showed [Ah 3d] and won (42086) with a full house, Threes full of Aces
Seat 2: jack310759 folded before Flop (didn't bet)
Seat 3: Rochinha2011 folded before Flop (didn't bet)
Seat 4: MjLK MAN folded before Flop (didn't bet)
Seat 5: Boogz96 (button) folded before Flop (didn't bet)
Seat 6: lulira10 (small blind) showed [6h 6d] and lost with two pair, Sixes and Threes

PokerStars Hand #251209851722: Tournament #3769361908, $52.38+$2.62 USD Hold'em No Limit - Level XVII (1000/2000) - 2024/06/26 22:51:54 UTC [2024/06/26 18:51:54 ET]
Table '3769361908 11' 6-max Seat #6 is the button
Seat 1: Spectral34 (42086 in chips) 
Seat 2: jack310759 (26183 in chips) 
Seat 3: Rochinha2011 (79758 in chips) 
Seat 4: MjLK MAN (25300 in chips) 
Seat 5: Boogz96 (9000 in chips) 
Seat 6: lulira10 (10322 in chips) 
Spectral34: posts the ante 500
jack310759: posts the ante 500
Rochinha2011: posts the ante 500
MjLK MAN: posts the ante 500
Boogz96: posts the ante 500
lulira10: posts the ante 500
Spectral34: posts small blind 1000
jack310759: posts big blind 2000
*** HOLE CARDS ***
Rochinha2011: folds 
MjLK MAN: folds 
Boogz96: folds 
lulira10: folds 
Spectral34: raises 39586 to 41586 and is all-in
jack310759: folds 
Uncalled bet (39586) returned to Spectral34
Spectral34 collected 7000 from pot
Spectral34: doesn't show hand 
*** SUMMARY ***
Total pot 7000 | Rake 0 
Seat 1: Spectral34 (small blind) collected (7000)
Seat 2: jack310759 (big blind) folded before Flop
Seat 3: Rochinha2011 folded before Flop (didn't bet)
Seat 4: MjLK MAN folded before Flop (didn't bet)
Seat 5: Boogz96 folded before Flop (didn't bet)
Seat 6: lulira10 (button) folded before Flop (didn't bet)

PokerStars Hand #251209856855: Tournament #3769361908, $52.38+$2.62 USD Hold'em No Limit - Level XVII (1000/2000) - 2024/06/26 22:52:15 UTC [2024/06/26 18:52:15 ET]
Table '3769361908 11' 6-max Seat #1 is the button
Seat 1: Spectral34 (46586 in chips) 
Seat 2: jack310759 (23683 in chips) 
Seat 3: Rochinha2011 (79258 in chips) 
Seat 4: MjLK MAN (24800 in chips) 
Seat 5: Boogz96 (8500 in chips) 
Seat 6: lulira10 (9822 in chips) 
Spectral34: posts the ante 500
jack310759: posts the ante 500
Rochinha2011: posts the ante 500
MjLK MAN: posts the ante 500
Boogz96: posts the ante 500
lulira10: posts the ante 500
jack310759: posts small blind 1000
Rochinha2011: posts big blind 2000
*** HOLE CARDS ***
MjLK MAN: folds 
Boogz96: folds 
lulira10: folds 
Spectral34: folds 
jack310759: raises 7000 to 9000
Rochinha2011: raises 69758 to 78758 and is all-in
jack310759: calls 14183 and is all-in
Uncalled bet (55575) returned to Rochinha2011
*** FLOP *** [9s 7h 3c]
*** TURN *** [9s 7h 3c] [3s]
*** RIVER *** [9s 7h 3c 3s] [Kh]
*** SHOW DOWN ***
jack310759: shows [Jc Qc] (a pair of Threes)
Rochinha2011: shows [8h Ac] (a pair of Threes - Ace kicker)
Rochinha2011 collected 49366 from pot
jack310759 finished the tournament in 89th place
*** SUMMARY ***
Total pot 49366 | Rake 0 
Board [9s 7h 3c 3s Kh]
Seat 1: Spectral34 (button) folded before Flop (didn't bet)
Seat 2: jack310759 (small blind) showed [Jc Qc] and lost with a pair of Threes
Seat 3: Rochinha2011 (big blind) showed [8h Ac] and won (49366) with a pair of Threes
Seat 4: MjLK MAN folded before Flop (didn't bet)
Seat 5: Boogz96 folded before Flop (didn't bet)
Seat 6: lulira10 folded before Flop (didn't bet)

PokerStars Hand #251209868064: Tournament #3769361908, $52.38+$2.62 USD Hold'em No Limit - Level XVII (1000/2000) - 2024/06/26 22:53:01 UTC [2024/06/26 18:53:01 ET]
Table '3769361908 11' 6-max Seat #3 is the button
Seat 1: Spectral34 (46086 in chips) 
Seat 3: Rochinha2011 (104941 in chips) 
Seat 4: MjLK MAN (24300 in chips) 
Seat 5: Boogz96 (8000 in chips) 
Seat 6: lulira10 (9322 in chips) 
Spectral34: posts the ante 500
Rochinha2011: posts the ante 500
MjLK MAN: posts the ante 500
Boogz96: posts the ante 500
lulira10: posts the ante 500
MjLK MAN: posts small blind 1000
Boogz96: posts big blind 2000
*** HOLE CARDS ***
lulira10: raises 6822 to 8822 and is all-in
Spectral34: folds 
Rochinha2011: raises 95619 to 104441 and is all-in
MjLK MAN: folds 
Boogz96: folds 
Uncalled bet (95619) returned to Rochinha2011
*** FLOP *** [2d 4c 4d]
*** TURN *** [2d 4c 4d] [Qc]
*** RIVER *** [2d 4c 4d Qc] [5h]
*** SHOW DOWN ***
lulira10: shows [Tc Js] (a pair of Fours)
Rochinha2011: shows [6c 6s] (two pair, Sixes and Fours)
Rochinha2011 collected 23144 from pot
lulira10 finished the tournament in 87th place
*** SUMMARY ***
Total pot 23144 | Rake 0 
Board [2d 4c 4d Qc 5h]
Seat 1: Spectral34 folded before Flop (didn't bet)
Seat 3: Rochinha2011 (button) showed [6c 6s] and won (23144) with two pair, Sixes and Fours
Seat 4: MjLK MAN (small blind) folded before Flop
Seat 5: Boogz96 (big blind) folded before Flop
Seat 6: lulira10 showed [Tc Js] and lost with a pair of Fours

PokerStars Hand #251209877847: Tournament #3769361908, $52.38+$2.62 USD Hold'em No Limit - Level XVIII (1200/2400) - 2024/06/26 22:53:41 UTC [2024/06/26 18:53:41 ET]
Table '3769361908 11' 6-max Seat #4 is the button
Seat 1: Spectral34 (45586 in chips) 
Seat 2: DuduLôbo2012 (36990 in chips) 
Seat 3: Rochinha2011 (118763 in chips) 
Seat 4: MjLK MAN (22800 in chips) 
Seat 5: Boogz96 (5500 in chips) 
Spectral34: posts the ante 600
DuduLôbo2012: posts the ante 600
Rochinha2011: posts the ante 600
MjLK MAN: posts the ante 600
Boogz96: posts the ante 600
Boogz96: posts small blind 1200
Spectral34: posts big blind 2400
*** HOLE CARDS ***
DuduLôbo2012: folds 
Rochinha2011: folds 
leocir25 is disconnected 
MjLK MAN: raises 19800 to 22200 and is all-in
Boogz96: folds 
Spectral34: folds 
Uncalled bet (19800) returned to MjLK MAN
MjLK MAN collected 9000 from pot
MjLK MAN: doesn't show hand 
*** SUMMARY ***
Total pot 9000 | Rake 0 
Seat 1: Spectral34 (big blind) folded before Flop
Seat 2: DuduLôbo2012 folded before Flop (didn't bet)
Seat 3: Rochinha2011 folded before Flop (didn't bet)
Seat 4: MjLK MAN (button) collected (9000)
Seat 5: Boogz96 (small blind) folded before Flop

PokerStars Hand #251209883513: Tournament #3769361908, $52.38+$2.62 USD Hold'em No Limit - Level XVIII (1200/2400) - 2024/06/26 22:54:04 UTC [2024/06/26 18:54:04 ET]
Table '3769361908 11' 6-max Seat #5 is the button
Seat 1: Spectral34 (42586 in chips) 
Seat 2: DuduLôbo2012 (36390 in chips) 
Seat 3: Rochinha2011 (118163 in chips) 
Seat 4: MjLK MAN (28800 in chips) 
Seat 5: Boogz96 (3700 in chips) 
Seat 6: leocir25 (104270 in chips) out of hand (moved from another table into small blind)
leocir25 will be allowed to play after the button
Spectral34: posts the ante 600
DuduLôbo2012: posts the ante 600
Rochinha2011: posts the ante 600
MjLK MAN: posts the ante 600
Boogz96: posts the ante 600
Spectral34: posts small blind 1200
DuduLôbo2012: posts big blind 2400
*** HOLE CARDS ***
Rochinha2011: raises 2400 to 4800
MjLK MAN: folds 
Boogz96: folds 
Spectral34: folds 
DuduLôbo2012: folds 
Uncalled bet (2400) returned to Rochinha2011
Rochinha2011 collected 9000 from pot
Rochinha2011: doesn't show hand 
*** SUMMARY ***
Total pot 9000 | Rake 0 
Seat 1: Spectral34 (small blind) folded before Flop
Seat 2: DuduLôbo2012 (big blind) folded before Flop
Seat 3: Rochinha2011 collected (9000)
Seat 4: MjLK MAN folded before Flop (didn't bet)
Seat 5: Boogz96 (button) folded before Flop (didn't bet)

PokerStars Hand #251209891624: Tournament #3769361908, $52.38+$2.62 USD Hold'em No Limit - Level XVIII (1200/2400) - 2024/06/26 22:54:38 UTC [2024/06/26 18:54:38 ET]
Table '3769361908 11' 6-max Seat #1 is the button
Seat 1: Spectral34 (40786 in chips) 
Seat 2: DuduLôbo2012 (33390 in chips) 
Seat 3: Rochinha2011 (124163 in chips) 
Seat 4: MjLK MAN (28200 in chips) 
Seat 5: Boogz96 (3100 in chips) 
Seat 6: leocir25 (104270 in chips) 
Spectral34: posts the ante 600
DuduLôbo2012: posts the ante 600
Rochinha2011: posts the ante 600
MjLK MAN: posts the ante 600
Boogz96: posts the ante 600
leocir25: posts the ante 600
DuduLôbo2012: posts small blind 1200
Rochinha2011: posts big blind 2400
*** HOLE CARDS ***
MjLK MAN: folds 
Boogz96: raises 100 to 2500 and is all-in
leocir25: folds 
Spectral34: folds 
DuduLôbo2012: raises 30290 to 32790 and is all-in
Rochinha2011: folds 
Uncalled bet (30290) returned to DuduLôbo2012
*** FLOP *** [Qd Kh 3h]
*** TURN *** [Qd Kh 3h] [3c]
*** RIVER *** [Qd Kh 3h 3c] [Qh]
*** SHOW DOWN ***
DuduLôbo2012: shows [8h Ah] (a flush, Ace high)
Boogz96: shows [9d Kc] (two pair, Kings and Queens)
DuduLôbo2012 collected 11000 from pot
Boogz96 finished the tournament in 76th place
*** SUMMARY ***
Total pot 11000 | Rake 0 
Board [Qd Kh 3h 3c Qh]
Seat 1: Spectral34 (button) folded before Flop (didn't bet)
Seat 2: DuduLôbo2012 (small blind) showed [8h Ah] and won (11000) with a flush, Ace high
Seat 3: Rochinha2011 (big blind) folded before Flop
Seat 4: MjLK MAN folded before Flop (didn't bet)
Seat 5: Boogz96 showed [9d Kc] and lost with two pair, Kings and Queens
Seat 6: leocir25 folded before Flop (didn't bet)

PokerStars Hand #251209964589: Tournament #3769361908, $52.38+$2.62 USD Hold'em No Limit - Level XVIII (1200/2400) - 2024/06/26 23:01:09 UTC [2024/06/26 19:01:09 ET]
Table '3769361908 11' 6-max Seat #2 is the button
Seat 1: Spectral34 (40186 in chips) 
Seat 2: DuduLôbo2012 (41290 in chips) 
Seat 3: Rochinha2011 (121163 in chips) 
Seat 4: MjLK MAN (27600 in chips) 
Seat 5: mila is best (35374 in chips) 
Seat 6: leocir25 (103670 in chips) 
Spectral34: posts the ante 600
DuduLôbo2012: posts the ante 600
Rochinha2011: posts the ante 600
MjLK MAN: posts the ante 600
mila is best: posts the ante 600
leocir25: posts the ante 600
Rochinha2011: posts small blind 1200
MjLK MAN: posts big blind 2400
*** HOLE CARDS ***
mila is best: folds 
leocir25: folds 
Spectral34: raises 2400 to 4800
DuduLôbo2012: folds 
Rochinha2011: folds 
MjLK MAN: folds 
Uncalled bet (2400) returned to Spectral34
Spectral34 collected 9600 from pot
Spectral34: doesn't show hand 
*** SUMMARY ***
Total pot 9600 | Rake 0 
Seat 1: Spectral34 collected (9600)
Seat 2: DuduLôbo2012 (button) folded before Flop (didn't bet)
Seat 3: Rochinha2011 (small blind) folded before Flop
Seat 4: MjLK MAN (big blind) folded before Flop
Seat 5: mila is best folded before Flop (didn't bet)
Seat 6: leocir25 folded before Flop (didn't bet)

PokerStars Hand #251209976820: Tournament #3769361908, $52.38+$2.62 USD Hold'em No Limit - Level XVIII (1200/2400) - 2024/06/26 23:02:03 UTC [2024/06/26 19:02:03 ET]
Table '3769361908 11' 6-max Seat #3 is the button
Seat 1: Spectral34 (46786 in chips) 
Seat 2: DuduLôbo2012 (40690 in chips) 
Seat 3: Rochinha2011 (119363 in chips) 
Seat 4: MjLK MAN (24600 in chips) 
Seat 5: mila is best (34774 in chips) 
Seat 6: leocir25 (103070 in chips) 
Spectral34: posts the ante 600
DuduLôbo2012: posts the ante 600
Rochinha2011: posts the ante 600
MjLK MAN: posts the ante 600
mila is best: posts the ante 600
leocir25: posts the ante 600
MjLK MAN: posts small blind 1200
mila is best: posts big blind 2400
*** HOLE CARDS ***
leocir25: folds 
Spectral34: folds 
DuduLôbo2012: folds 
Rochinha2011: folds 
MjLK MAN: raises 21600 to 24000 and is all-in
mila is best: folds 
Uncalled bet (21600) returned to MjLK MAN
MjLK MAN collected 8400 from pot
MjLK MAN: doesn't show hand 
*** SUMMARY ***
Total pot 8400 | Rake 0 
Seat 1: Spectral34 folded before Flop (didn't bet)
Seat 2: DuduLôbo2012 folded before Flop (didn't bet)
Seat 3: Rochinha2011 (button) folded before Flop (didn't bet)
Seat 4: MjLK MAN (small blind) collected (8400)
Seat 5: mila is best (big blind) folded before Flop
Seat 6: leocir25 folded before Flop (didn't bet)

PokerStars Hand #251209991711: Tournament #3769361908, $52.38+$2.62 USD Hold'em No Limit - Level XIX (1400/2800) - 2024/06/26 23:03:07 UTC [2024/06/26 19:03:07 ET]
Table '3769361908 11' 6-max Seat #4 is the button
Seat 1: Spectral34 (46186 in chips) 
Seat 2: DuduLôbo2012 (40090 in chips) 
Seat 3: Rochinha2011 (118763 in chips) 
Seat 4: MjLK MAN (30000 in chips) 
Seat 5: mila is best (31774 in chips) 
Seat 6: leocir25 (102470 in chips) 
Spectral34: posts the ante 700
DuduLôbo2012: posts the ante 700
Rochinha2011: posts the ante 700
MjLK MAN: posts the ante 700
mila is best: posts the ante 700
leocir25: posts the ante 700
mila is best: posts small blind 1400
leocir25: posts big blind 2800
*** HOLE CARDS ***
Spectral34: folds 
DuduLôbo2012: folds 
Rochinha2011: raises 2800 to 5600
MjLK MAN: raises 23700 to 29300 and is all-in
mila is best: folds 
leocir25: folds 
Rochinha2011: folds 
Uncalled bet (23700) returned to MjLK MAN
MjLK MAN collected 19600 from pot
MjLK MAN: doesn't show hand 
*** SUMMARY ***
Total pot 19600 | Rake 0 
Seat 1: Spectral34 folded before Flop (didn't bet)
Seat 2: DuduLôbo2012 folded before Flop (didn't bet)
Seat 3: Rochinha2011 folded before Flop
Seat 4: MjLK MAN (button) collected (19600)
Seat 5: mila is best (small blind) folded before Flop
Seat 6: leocir25 (big blind) folded before Flop

PokerStars Hand #251210003671: Tournament #3769361908, $52.38+$2.62 USD Hold'em No Limit - Level XIX (1400/2800) - 2024/06/26 23:03:58 UTC [2024/06/26 19:03:58 ET]
Table '3769361908 11' 6-max Seat #5 is the button
Seat 1: Spectral34 (45486 in chips) 
Seat 2: DuduLôbo2012 (39390 in chips) 
Seat 3: Rochinha2011 (112463 in chips) 
Seat 4: MjLK MAN (43300 in chips) 
Seat 5: mila is best (29674 in chips) 
Seat 6: leocir25 (98970 in chips) 
Spectral34: posts the ante 700
DuduLôbo2012: posts the ante 700
Rochinha2011: posts the ante 700
MjLK MAN: posts the ante 700
mila is best: posts the ante 700
leocir25: posts the ante 700
leocir25: posts small blind 1400
Spectral34: posts big blind 2800
*** HOLE CARDS ***
DuduLôbo2012: folds 
Rochinha2011: folds 
MjLK MAN: folds 
mila is best: folds 
leocir25: raises 95470 to 98270 and is all-in
Spectral34: folds 
Uncalled bet (95470) returned to leocir25
leocir25 collected 9800 from pot
*** SUMMARY ***
Total pot 9800 | Rake 0 
Seat 1: Spectral34 (big blind) folded before Flop
Seat 2: DuduLôbo2012 folded before Flop (didn't bet)
Seat 3: Rochinha2011 folded before Flop (didn't bet)
Seat 4: MjLK MAN folded before Flop (didn't bet)
Seat 5: mila is best (button) folded before Flop (didn't bet)
Seat 6: leocir25 (small blind) collected (9800)

PokerStars Hand #251210016331: Tournament #3769361908, $52.38+$2.62 USD Hold'em No Limit - Level XIX (1400/2800) - 2024/06/26 23:04:53 UTC [2024/06/26 19:04:53 ET]
Table '3769361908 11' 6-max Seat #6 is the button
Seat 1: Spectral34 (41986 in chips) 
Seat 2: DuduLôbo2012 (38690 in chips) 
Seat 3: Rochinha2011 (111763 in chips) 
Seat 4: MjLK MAN (42600 in chips) 
Seat 5: mila is best (28974 in chips) 
Seat 6: leocir25 (105270 in chips) 
Spectral34: posts the ante 700
DuduLôbo2012: posts the ante 700
Rochinha2011: posts the ante 700
MjLK MAN: posts the ante 700
mila is best: posts the ante 700
leocir25: posts the ante 700
Spectral34: posts small blind 1400
DuduLôbo2012: posts big blind 2800
*** HOLE CARDS ***
Rochinha2011: raises 2800 to 5600
MjLK MAN: folds 
mila is best: folds 
leocir25: folds 
Spectral34: folds 
DuduLôbo2012: folds 
Uncalled bet (2800) returned to Rochinha2011
Rochinha2011 collected 11200 from pot
Rochinha2011: doesn't show hand 
*** SUMMARY ***
Total pot 11200 | Rake 0 
Seat 1: Spectral34 (small blind) folded before Flop
Seat 2: DuduLôbo2012 (big blind) folded before Flop
Seat 3: Rochinha2011 collected (11200)
Seat 4: MjLK MAN folded before Flop (didn't bet)
Seat 5: mila is best folded before Flop (didn't bet)
Seat 6: leocir25 (button) folded before Flop (didn't bet)

PokerStars Hand #251210030467: Tournament #3769361908, $52.38+$2.62 USD Hold'em No Limit - Level XX (1600/3200) - 2024/06/26 23:05:54 UTC [2024/06/26 19:05:54 ET]
Table '3769361908 11' 6-max Seat #1 is the button
Seat 1: Spectral34 (39886 in chips) 
Seat 2: DuduLôbo2012 (35190 in chips) 
Seat 3: Rochinha2011 (119463 in chips) 
Seat 4: MjLK MAN (41900 in chips) 
Seat 5: mila is best (28274 in chips) 
Seat 6: leocir25 (104570 in chips) 
Spectral34: posts the ante 800
DuduLôbo2012: posts the ante 800
Rochinha2011: posts the ante 800
MjLK MAN: posts the ante 800
mila is best: posts the ante 800
leocir25: posts the ante 800
DuduLôbo2012: posts small blind 1600
Rochinha2011: posts big blind 3200
*** HOLE CARDS ***
MjLK MAN: raises 37900 to 41100 and is all-in
mila is best: folds 
leocir25: folds 
Spectral34: folds 
DuduLôbo2012: folds 
Rochinha2011: folds 
Uncalled bet (37900) returned to MjLK MAN
MjLK MAN collected 12800 from pot
MjLK MAN: doesn't show hand 
*** SUMMARY ***
Total pot 12800 | Rake 0 
Seat 1: Spectral34 (button) folded before Flop (didn't bet)
Seat 2: DuduLôbo2012 (small blind) folded before Flop
Seat 3: Rochinha2011 (big blind) folded before Flop
Seat 4: MjLK MAN collected (12800)
Seat 5: mila is best folded before Flop (didn't bet)
Seat 6: leocir25 folded before Flop (didn't bet)

PokerStars Hand #251210044318: Tournament #3769361908, $52.38+$2.62 USD Hold'em No Limit - Level XX (1600/3200) - 2024/06/26 23:06:55 UTC [2024/06/26 19:06:55 ET]
Table '3769361908 11' 6-max Seat #2 is the button
Seat 1: Spectral34 (39086 in chips) 
Seat 2: DuduLôbo2012 (32790 in chips) 
Seat 3: Rochinha2011 (115463 in chips) 
Seat 4: MjLK MAN (50700 in chips) 
Seat 5: mila is best (27474 in chips) 
Seat 6: leocir25 (103770 in chips) 
Spectral34: posts the ante 800
DuduLôbo2012: posts the ante 800
Rochinha2011: posts the ante 800
MjLK MAN: posts the ante 800
mila is best: posts the ante 800
leocir25: posts the ante 800
Rochinha2011: posts small blind 1600
MjLK MAN: posts big blind 3200
*** HOLE CARDS ***
mila is best: folds 
leocir25: folds 
Spectral34: folds 
DuduLôbo2012: folds 
Rochinha2011: raises 111463 to 114663 and is all-in
MjLK MAN: folds 
Uncalled bet (111463) returned to Rochinha2011
Rochinha2011 collected 11200 from pot
Rochinha2011: doesn't show hand 
*** SUMMARY ***
Total pot 11200 | Rake 0 
Seat 1: Spectral34 folded before Flop (didn't bet)
Seat 2: DuduLôbo2012 (button) folded before Flop (didn't bet)
Seat 3: Rochinha2011 (small blind) collected (11200)
Seat 4: MjLK MAN (big blind) folded before Flop
Seat 5: mila is best folded before Flop (didn't bet)
Seat 6: leocir25 folded before Flop (didn't bet)

PokerStars Hand #251210056406: Tournament #3769361908, $52.38+$2.62 USD Hold'em No Limit - Level XX (1600/3200) - 2024/06/26 23:07:48 UTC [2024/06/26 19:07:48 ET]
Table '3769361908 11' 6-max Seat #3 is the button
Seat 1: Spectral34 (38286 in chips) 
Seat 2: DuduLôbo2012 (31990 in chips) 
Seat 3: Rochinha2011 (122663 in chips) 
Seat 4: MjLK MAN (46700 in chips) 
Seat 5: mila is best (26674 in chips) 
Seat 6: leocir25 (102970 in chips) 
Spectral34: posts the ante 800
DuduLôbo2012: posts the ante 800
Rochinha2011: posts the ante 800
MjLK MAN: posts the ante 800
mila is best: posts the ante 800
leocir25: posts the ante 800
MjLK MAN: posts small blind 1600
mila is best: posts big blind 3200
*** HOLE CARDS ***
leocir25: folds 
Spectral34: folds 
DuduLôbo2012: folds 
Rochinha2011: raises 118663 to 121863 and is all-in
MjLK MAN: folds 
mila is best: folds 
Uncalled bet (118663) returned to Rochinha2011
Rochinha2011 collected 12800 from pot
Rochinha2011: doesn't show hand 
*** SUMMARY ***
Total pot 12800 | Rake 0 
Seat 1: Spectral34 folded before Flop (didn't bet)
Seat 2: DuduLôbo2012 folded before Flop (didn't bet)
Seat 3: Rochinha2011 (button) collected (12800)
Seat 4: MjLK MAN (small blind) folded before Flop
Seat 5: mila is best (big blind) folded before Flop
Seat 6: leocir25 folded before Flop (didn't bet)

PokerStars Hand #251210070803: Tournament #3769361908, $52.38+$2.62 USD Hold'em No Limit - Level XXI (1800/3600) - 2024/06/26 23:08:53 UTC [2024/06/26 19:08:53 ET]
Table '3769361908 11' 6-max Seat #4 is the button
Seat 1: Spectral34 (37486 in chips) 
Seat 2: DuduLôbo2012 (31190 in chips) 
Seat 3: Rochinha2011 (131463 in chips) 
Seat 4: MjLK MAN (44300 in chips) 
Seat 5: mila is best (22674 in chips) 
Seat 6: leocir25 (102170 in chips) 
Spectral34: posts the ante 900
DuduLôbo2012: posts the ante 900
Rochinha2011: posts the ante 900
MjLK MAN: posts the ante 900
mila is best: posts the ante 900
leocir25: posts the ante 900
mila is best: posts small blind 1800
leocir25: posts big blind 3600
*** HOLE CARDS ***
Spectral34: folds 
DuduLôbo2012: folds 
Rochinha2011: raises 3600 to 7200
MjLK MAN: folds 
mila is best: folds 
leocir25: calls 3600
*** FLOP *** [As 9s Qs]
leocir25: checks 
Rochinha2011: bets 5400
leocir25: folds 
Uncalled bet (5400) returned to Rochinha2011
Rochinha2011 collected 21600 from pot
Rochinha2011: doesn't show hand 
*** SUMMARY ***
Total pot 21600 | Rake 0 
Board [As 9s Qs]
Seat 1: Spectral34 folded before Flop (didn't bet)
Seat 2: DuduLôbo2012 folded before Flop (didn't bet)
Seat 3: Rochinha2011 collected (21600)
Seat 4: MjLK MAN (button) folded before Flop (didn't bet)
Seat 5: mila is best (small blind) folded before Flop
Seat 6: leocir25 (big blind) folded on the Flop

PokerStars Hand #251210096828: Tournament #3769361908, $52.38+$2.62 USD Hold'em No Limit - Level XXI (1800/3600) - 2024/06/26 23:10:50 UTC [2024/06/26 19:10:50 ET]
Table '3769361908 11' 6-max Seat #5 is the button
Seat 1: Spectral34 (36586 in chips) 
Seat 2: DuduLôbo2012 (30290 in chips) 
Seat 3: Rochinha2011 (144963 in chips) 
Seat 4: MjLK MAN (43400 in chips) 
Seat 5: mila is best (19974 in chips) 
Seat 6: leocir25 (94070 in chips) 
Spectral34: posts the ante 900
DuduLôbo2012: posts the ante 900
Rochinha2011: posts the ante 900
MjLK MAN: posts the ante 900
mila is best: posts the ante 900
leocir25: posts the ante 900
leocir25: posts small blind 1800
Spectral34: posts big blind 3600
*** HOLE CARDS ***
DuduLôbo2012 has timed out
DuduLôbo2012: folds 
DuduLôbo2012 is sitting out
DuduLôbo2012 has returned
Rochinha2011: raises 3600 to 7200
MjLK MAN: folds 
mila is best: folds 
leocir25: folds 
Spectral34: folds 
Uncalled bet (3600) returned to Rochinha2011
Rochinha2011 collected 14400 from pot
Rochinha2011: doesn't show hand 
*** SUMMARY ***
Total pot 14400 | Rake 0 
Seat 1: Spectral34 (big blind) folded before Flop
Seat 2: DuduLôbo2012 folded before Flop (didn't bet)
Seat 3: Rochinha2011 collected (14400)
Seat 4: MjLK MAN folded before Flop (didn't bet)
Seat 5: mila is best (button) folded before Flop (didn't bet)
Seat 6: leocir25 (small blind) folded before Flop

PokerStars Hand #251210112311: Tournament #3769361908, $52.38+$2.62 USD Hold'em No Limit - Level XXII (2000/4000) - 2024/06/26 23:12:02 UTC [2024/06/26 19:12:02 ET]
Table '3769361908 11' 6-max Seat #6 is the button
Seat 1: Spectral34 (32086 in chips) 
Seat 2: DuduLôbo2012 (29390 in chips) 
Seat 3: Rochinha2011 (154863 in chips) 
Seat 4: MjLK MAN (42500 in chips) 
Seat 5: mila is best (19074 in chips) 
Seat 6: leocir25 (91370 in chips) 
Spectral34: posts the ante 1000
DuduLôbo2012: posts the ante 1000
Rochinha2011: posts the ante 1000
MjLK MAN: posts the ante 1000
mila is best: posts the ante 1000
leocir25: posts the ante 1000
Spectral34: posts small blind 2000
DuduLôbo2012: posts big blind 4000
*** HOLE CARDS ***
Rochinha2011: raises 149863 to 153863 and is all-in
MjLK MAN has timed out
MjLK MAN: folds 
MjLK MAN is sitting out
MjLK MAN has returned
mila is best: folds 
leocir25: folds 
Spectral34: folds 
DuduLôbo2012: folds 
Uncalled bet (149863) returned to Rochinha2011
Rochinha2011 collected 16000 from pot
Rochinha2011: doesn't show hand 
*** SUMMARY ***
Total pot 16000 | Rake 0 
Seat 1: Spectral34 (small blind) folded before Flop
Seat 2: DuduLôbo2012 (big blind) folded before Flop
Seat 3: Rochinha2011 collected (16000)
Seat 4: MjLK MAN folded before Flop (didn't bet)
Seat 5: mila is best folded before Flop (didn't bet)
Seat 6: leocir25 (button) folded before Flop (didn't bet)

PokerStars Hand #251210129374: Tournament #3769361908, $52.38+$2.62 USD Hold'em No Limit - Level XXII (2000/4000) - 2024/06/26 23:13:21 UTC [2024/06/26 19:13:21 ET]
Table '3769361908 11' 6-max Seat #1 is the button
Seat 1: Spectral34 (29086 in chips) 
Seat 2: DuduLôbo2012 (24390 in chips) 
Seat 3: Rochinha2011 (165863 in chips) 
Seat 4: MjLK MAN (41500 in chips) 
Seat 5: mila is best (18074 in chips) 
Seat 6: leocir25 (90370 in chips) 
Spectral34: posts the ante 1000
DuduLôbo2012: posts the ante 1000
Rochinha2011: posts the ante 1000
MjLK MAN: posts the ante 1000
mila is best: posts the ante 1000
leocir25: posts the ante 1000
DuduLôbo2012: posts small blind 2000
Rochinha2011: posts big blind 4000
*** HOLE CARDS ***
MjLK MAN: folds 
mila is best: folds 
leocir25: raises 4000 to 8000
Spectral34: folds 
DuduLôbo2012: raises 15390 to 23390 and is all-in
Rochinha2011: folds 
leocir25: calls 15390
*** FLOP *** [9d 2c 2s]
*** TURN *** [9d 2c 2s] [2d]
*** RIVER *** [9d 2c 2s 2d] [Td]
*** SHOW DOWN ***
DuduLôbo2012: shows [4s As] (three of a kind, Deuces)
leocir25: shows [Ks 7s] (three of a kind, Deuces - lower kicker)
DuduLôbo2012 collected 56780 from pot
*** SUMMARY ***
Total pot 56780 | Rake 0 
Board [9d 2c 2s 2d Td]
Seat 1: Spectral34 (button) folded before Flop (didn't bet)
Seat 2: DuduLôbo2012 (small blind) showed [4s As] and won (56780) with three of a kind, Deuces
Seat 3: Rochinha2011 (big blind) folded before Flop
Seat 4: MjLK MAN folded before Flop (didn't bet)
Seat 5: mila is best folded before Flop (didn't bet)
Seat 6: leocir25 showed [Ks 7s] and lost with three of a kind, Deuces

PokerStars Hand #251210137105: Tournament #3769361908, $52.38+$2.62 USD Hold'em No Limit - Level XXII (2000/4000) - 2024/06/26 23:13:57 UTC [2024/06/26 19:13:57 ET]
Table '3769361908 11' 6-max Seat #2 is the button
Seat 1: Spectral34 (28086 in chips) 
Seat 2: DuduLôbo2012 (56780 in chips) 
Seat 3: Rochinha2011 (160863 in chips) 
Seat 4: MjLK MAN (40500 in chips) 
Seat 5: mila is best (17074 in chips) 
Seat 6: leocir25 (65980 in chips) 
Spectral34: posts the ante 1000
DuduLôbo2012: posts the ante 1000
Rochinha2011: posts the ante 1000
MjLK MAN: posts the ante 1000
mila is best: posts the ante 1000
leocir25: posts the ante 1000
Rochinha2011: posts small blind 2000
MjLK MAN: posts big blind 4000
*** HOLE CARDS ***
mila is best: folds 
leocir25: raises 60980 to 64980 and is all-in
Spectral34: folds 
DuduLôbo2012: folds 
Rochinha2011: folds 
MjLK MAN has timed out
MjLK MAN: folds 
MjLK MAN is sitting out
Uncalled bet (60980) returned to leocir25
MjLK MAN has returned
leocir25 collected 16000 from pot
*** SUMMARY ***
Total pot 16000 | Rake 0 
Seat 1: Spectral34 folded before Flop (didn't bet)
Seat 2: DuduLôbo2012 (button) folded before Flop (didn't bet)
Seat 3: Rochinha2011 (small blind) folded before Flop
Seat 4: MjLK MAN (big blind) folded before Flop
Seat 5: mila is best folded before Flop (didn't bet)
Seat 6: leocir25 collected (16000)

PokerStars Hand #251210146025: Tournament #3769361908, $52.38+$2.62 USD Hold'em No Limit - Level XXIII (2500/5000) - 2024/06/26 23:14:39 UTC [2024/06/26 19:14:39 ET]
Table '3769361908 11' 6-max Seat #3 is the button
Seat 1: Spectral34 (27086 in chips) 
Seat 2: DuduLôbo2012 (55780 in chips) 
Seat 3: Rochinha2011 (157863 in chips) 
Seat 4: MjLK MAN (35500 in chips) 
Seat 5: mila is best (16074 in chips) 
Seat 6: leocir25 (76980 in chips) 
Spectral34: posts the ante 1250
DuduLôbo2012: posts the ante 1250
Rochinha2011: posts the ante 1250
MjLK MAN: posts the ante 1250
mila is best: posts the ante 1250
leocir25: posts the ante 1250
MjLK MAN: posts small blind 2500
mila is best: posts big blind 5000
*** HOLE CARDS ***
leocir25: folds 
Spectral34: folds 
DuduLôbo2012: folds 
Rochinha2011: raises 151613 to 156613 and is all-in
MjLK MAN: folds 
mila is best: calls 9824 and is all-in
Uncalled bet (141789) returned to Rochinha2011
*** FLOP *** [Ad Ts 5c]
*** TURN *** [Ad Ts 5c] [8d]
*** RIVER *** [Ad Ts 5c 8d] [Kc]
*** SHOW DOWN ***
mila is best: shows [3c Td] (a pair of Tens)
Rochinha2011: shows [Jc 8c] (a pair of Eights)
mila is best collected 39648 from pot
*** SUMMARY ***
Total pot 39648 | Rake 0 
Board [Ad Ts 5c 8d Kc]
Seat 1: Spectral34 folded before Flop (didn't bet)
Seat 2: DuduLôbo2012 folded before Flop (didn't bet)
Seat 3: Rochinha2011 (button) showed [Jc 8c] and lost with a pair of Eights
Seat 4: MjLK MAN (small blind) folded before Flop
Seat 5: mila is best (big blind) showed [3c Td] and won (39648) with a pair of Tens
Seat 6: leocir25 folded before Flop (didn't bet)

PokerStars Hand #251210152634: Tournament #3769361908, $52.38+$2.62 USD Hold'em No Limit - Level XXIII (2500/5000) - 2024/06/26 23:15:10 UTC [2024/06/26 19:15:10 ET]
Table '3769361908 11' 6-max Seat #4 is the button
Seat 1: Spectral34 (25836 in chips) 
Seat 3: Rochinha2011 (141789 in chips) 
Seat 4: MjLK MAN (31750 in chips) 
Seat 5: mila is best (39648 in chips) 
Seat 6: leocir25 (75730 in chips) 
Spectral34: posts the ante 1250
Rochinha2011: posts the ante 1250
MjLK MAN: posts the ante 1250
mila is best: posts the ante 1250
leocir25: posts the ante 1250
mila is best: posts small blind 2500
leocir25: posts big blind 5000
*** HOLE CARDS ***
Spectral34: raises 19586 to 24586 and is all-in
Rochinha2011: folds 
MjLK MAN: raises 5914 to 30500 and is all-in
mila is best: folds 
aapetrone91 is disconnected 
leocir25: folds 
Uncalled bet (5914) returned to MjLK MAN
*** FLOP *** [4h Js Td]
*** TURN *** [4h Js Td] [Ac]
*** RIVER *** [4h Js Td Ac] [2d]
*** SHOW DOWN ***
Spectral34: shows [7c 7s] (a pair of Sevens)
MjLK MAN: shows [4c 4d] (three of a kind, Fours)
MjLK MAN collected 62922 from pot
Spectral34 finished the tournament in 48th place and received $91.90.
*** SUMMARY ***
Total pot 62922 | Rake 0 
Board [4h Js Td Ac 2d]
Seat 1: Spectral34 showed [7c 7s] and lost with a pair of Sevens
Seat 3: Rochinha2011 folded before Flop (didn't bet)
Seat 4: MjLK MAN (button) showed [4c 4d] and won (62922) with three of a kind, Fours
Seat 5: mila is best (small blind) folded before Flop
Seat 6: leocir25 (big blind) folded before Flop

PokerStars Hand #251210159961: Tournament #3769361908, $52.38+$2.62 USD Hold'em No Limit - Level XXIII (2500/5000) - 2024/06/26 23:15:43 UTC [2024/06/26 19:15:43 ET]
Table '3769361908 11' 6-max Seat #5 is the button
Seat 2: aapetrone91 (124118 in chips) 
Seat 3: Rochinha2011 (140539 in chips) 
Seat 4: MjLK MAN (68836 in chips) 
Seat 5: mila is best (35898 in chips) 
Seat 6: leocir25 (69480 in chips) 
aapetrone91: posts the ante 1250
Rochinha2011: posts the ante 1250
MjLK MAN: posts the ante 1250
mila is best: posts the ante 1250
leocir25: posts the ante 1250
leocir25: posts small blind 2500
aapetrone91: posts big blind 5000
*** HOLE CARDS ***
Rochinha2011: raises 5000 to 10000
MjLK MAN: folds 
mila is best: folds 
leocir25: folds 
aapetrone91: calls 5000
*** FLOP *** [Tc 8d 7d]
aapetrone91: checks 
Rochinha2011: bets 19550
aapetrone91: folds 
Uncalled bet (19550) returned to Rochinha2011
Rochinha2011 collected 28750 from pot
Rochinha2011: doesn't show hand 
*** SUMMARY ***
Total pot 28750 | Rake 0 
Board [Tc 8d 7d]
Seat 2: aapetrone91 (big blind) folded on the Flop
Seat 3: Rochinha2011 collected (28750)
Seat 4: MjLK MAN folded before Flop (didn't bet)
Seat 5: mila is best (button) folded before Flop (didn't bet)
Seat 6: leocir25 (small blind) folded before Flop

PokerStars Hand #251210168089: Tournament #3769361908, $52.38+$2.62 USD Hold'em No Limit - Level XXIII (2500/5000) - 2024/06/26 23:16:22 UTC [2024/06/26 19:16:22 ET]
Table '3769361908 11' 6-max Seat #6 is the button
Seat 2: aapetrone91 (112868 in chips) 
Seat 3: Rochinha2011 (158039 in chips) 
Seat 4: MjLK MAN (67586 in chips) 
Seat 5: mila is best (34648 in chips) 
Seat 6: leocir25 (65730 in chips) 
aapetrone91: posts the ante 1250
Rochinha2011: posts the ante 1250
MjLK MAN: posts the ante 1250
mila is best: posts the ante 1250
leocir25: posts the ante 1250
aapetrone91: posts small blind 2500
Rochinha2011: posts big blind 5000
*** HOLE CARDS ***
MjLK MAN: folds 
mila is best: folds 
leocir25: raises 59480 to 64480 and is all-in
aapetrone91: folds 
Rochinha2011: folds 
Uncalled bet (59480) returned to leocir25
leocir25 collected 18750 from pot
*** SUMMARY ***
Total pot 18750 | Rake 0 
Seat 2: aapetrone91 (small blind) folded before Flop
Seat 3: Rochinha2011 (big blind) folded before Flop
Seat 4: MjLK MAN folded before Flop (didn't bet)
Seat 5: mila is best folded before Flop (didn't bet)
Seat 6: leocir25 (button) collected (18750)

PokerStars Hand #251210172388: Tournament #3769361908, $52.38+$2.62 USD Hold'em No Limit - Level XXIII (2500/5000) - 2024/06/26 23:16:42 UTC [2024/06/26 19:16:42 ET]
Table '3769361908 11' 6-max Seat #2 is the button
Seat 2: aapetrone91 (109118 in chips) 
Seat 3: Rochinha2011 (151789 in chips) 
Seat 4: MjLK MAN (66336 in chips) 
Seat 5: mila is best (33398 in chips) 
Seat 6: leocir25 (78230 in chips) 
aapetrone91: posts the ante 1250
Rochinha2011: posts the ante 1250
MjLK MAN: posts the ante 1250
mila is best: posts the ante 1250
leocir25: posts the ante 1250
Rochinha2011: posts small blind 2500
MjLK MAN: posts big blind 5000
*** HOLE CARDS ***
mila is best: folds 
leocir25: raises 5000 to 10000
aapetrone91: folds 
Rochinha2011: folds 
MjLK MAN: folds 
Uncalled bet (5000) returned to leocir25
leocir25 collected 18750 from pot
*** SUMMARY ***
Total pot 18750 | Rake 0 
Seat 2: aapetrone91 (button) folded before Flop (didn't bet)
Seat 3: Rochinha2011 (small blind) folded before Flop
Seat 4: MjLK MAN (big blind) folded before Flop
Seat 5: mila is best folded before Flop (didn't bet)
Seat 6: leocir25 collected (18750)

PokerStars Hand #251210177266: Tournament #3769361908, $52.38+$2.62 USD Hold'em No Limit - Level XXIII (2500/5000) - 2024/06/26 23:17:04 UTC [2024/06/26 19:17:04 ET]
Table '3769361908 11' 6-max Seat #3 is the button
Seat 2: aapetrone91 (107868 in chips) 
Seat 3: Rochinha2011 (148039 in chips) 
Seat 4: MjLK MAN (60086 in chips) 
Seat 5: mila is best (32148 in chips) 
Seat 6: leocir25 (90730 in chips) 
aapetrone91: posts the ante 1250
Rochinha2011: posts the ante 1250
MjLK MAN: posts the ante 1250
mila is best: posts the ante 1250
leocir25: posts the ante 1250
MjLK MAN: posts small blind 2500
mila is best: posts big blind 5000
*** HOLE CARDS ***
leocir25: raises 10000 to 15000
aapetrone91: raises 91618 to 106618 and is all-in
Rochinha2011: folds 
MjLK MAN: folds 
mila is best: folds 
gusanti is disconnected 
leocir25: calls 74480 and is all-in
Uncalled bet (17138) returned to aapetrone91
*** FLOP *** [Qc 2s 7d]
*** TURN *** [Qc 2s 7d] [9h]
*** RIVER *** [Qc 2s 7d 9h] [Jd]
*** SHOW DOWN ***
leocir25: shows [Ad Qs] (a pair of Queens)
aapetrone91: shows [7s 7c] (three of a kind, Sevens)
aapetrone91 collected 192710 from pot
leocir25 finished the tournament in 42nd place and received $91.90.
*** SUMMARY ***
Total pot 192710 | Rake 0 
Board [Qc 2s 7d 9h Jd]
Seat 2: aapetrone91 showed [7s 7c] and won (192710) with three of a kind, Sevens
Seat 3: Rochinha2011 (button) folded before Flop (didn't bet)
Seat 4: MjLK MAN (small blind) folded before Flop
Seat 5: mila is best (big blind) folded before Flop
Seat 6: leocir25 showed [Ad Qs] and lost with a pair of Queens

PokerStars Hand #251210186791: Tournament #3769361908, $52.38+$2.62 USD Hold'em No Limit - Level XXIV (3000/6000) - 2024/06/26 23:17:49 UTC [2024/06/26 19:17:49 ET]
Table '3769361908 11' 6-max Seat #4 is the button
Seat 1: gusanti (50828 in chips) 
Seat 2: aapetrone91 (209848 in chips) 
Seat 3: Rochinha2011 (146789 in chips) 
Seat 4: MjLK MAN (56336 in chips) 
Seat 5: mila is best (25898 in chips) 
gusanti: posts the ante 1500
aapetrone91: posts the ante 1500
Rochinha2011: posts the ante 1500
MjLK MAN: posts the ante 1500
mila is best: posts the ante 1500
mila is best: posts small blind 3000
gusanti: posts big blind 6000
*** HOLE CARDS ***
aapetrone91: folds 
Rochinha2011: raises 139289 to 145289 and is all-in
MjLK MAN: folds 
mila is best: calls 21398 and is all-in
gusanti: folds 
Uncalled bet (120891) returned to Rochinha2011
*** FLOP *** [Qh 2h 2s]
*** TURN *** [Qh 2h 2s] [Ad]
*** RIVER *** [Qh 2h 2s Ad] [Jc]
*** SHOW DOWN ***
mila is best: shows [9d As] (two pair, Aces and Deuces)
Rochinha2011: shows [9s Js] (two pair, Jacks and Deuces)
mila is best collected 62296 from pot
*** SUMMARY ***
Total pot 62296 | Rake 0 
Board [Qh 2h 2s Ad Jc]
Seat 1: gusanti (big blind) folded before Flop
Seat 2: aapetrone91 folded before Flop (didn't bet)
Seat 3: Rochinha2011 showed [9s Js] and lost with two pair, Jacks and Deuces
Seat 4: MjLK MAN (button) folded before Flop (didn't bet)
Seat 5: mila is best (small blind) showed [9d As] and won (62296) with two pair, Aces and Deuces

PokerStars Hand #251210193457: Tournament #3769361908, $52.38+$2.62 USD Hold'em No Limit - Level XXIV (3000/6000) - 2024/06/26 23:18:21 UTC [2024/06/26 19:18:21 ET]
Table '3769361908 11' 6-max Seat #5 is the button
Seat 1: gusanti (43328 in chips) 
Seat 2: aapetrone91 (208348 in chips) 
Seat 3: Rochinha2011 (120891 in chips) 
Seat 4: MjLK MAN (54836 in chips) 
Seat 5: mila is best (62296 in chips) 
gusanti: posts the ante 1500
aapetrone91: posts the ante 1500
Rochinha2011: posts the ante 1500
MjLK MAN: posts the ante 1500
mila is best: posts the ante 1500
gusanti: posts small blind 3000
aapetrone91: posts big blind 6000
*** HOLE CARDS ***
Rochinha2011: raises 6000 to 12000
MjLK MAN: folds 
mila is best: calls 12000
gusanti: folds 
aapetrone91: folds 
*** FLOP *** [Ac 3d Qs]
Rochinha2011: checks 
mila is best: checks 
*** TURN *** [Ac 3d Qs] [Ad]
Rochinha2011: checks 
mila is best: checks 
*** RIVER *** [Ac 3d Qs Ad] [6d]
Rochinha2011: bets 107391 and is all-in
mila is best: folds 
Uncalled bet (107391) returned to Rochinha2011
Rochinha2011 collected 40500 from pot
Rochinha2011: doesn't show hand 
*** SUMMARY ***
Total pot 40500 | Rake 0 
Board [Ac 3d Qs Ad 6d]
Seat 1: gusanti (small blind) folded before Flop
Seat 2: aapetrone91 (big blind) folded before Flop
Seat 3: Rochinha2011 collected (40500)
Seat 4: MjLK MAN folded before Flop (didn't bet)
Seat 5: mila is best (button) folded on the River

PokerStars Hand #251210204866: Tournament #3769361908, $52.38+$2.62 USD Hold'em No Limit - Level XXIV (3000/6000) - 2024/06/26 23:19:15 UTC [2024/06/26 19:19:15 ET]
Table '3769361908 11' 6-max Seat #1 is the button
Seat 1: gusanti (38828 in chips) 
Seat 2: aapetrone91 (200848 in chips) 
Seat 3: Rochinha2011 (147891 in chips) 
Seat 4: MjLK MAN (53336 in chips) 
Seat 5: mila is best (48796 in chips) 
gusanti: posts the ante 1500
aapetrone91: posts the ante 1500
Rochinha2011: posts the ante 1500
MjLK MAN: posts the ante 1500
mila is best: posts the ante 1500
aapetrone91: posts small blind 3000
Rochinha2011: posts big blind 6000
*** HOLE CARDS ***
MjLK MAN: folds 
mila is best: raises 41296 to 47296 and is all-in
DEERV is disconnected 
gusanti: calls 37328 and is all-in
aapetrone91: folds 
Rochinha2011: folds 
Uncalled bet (9968) returned to mila is best
*** FLOP *** [Qc Qh 9c]
*** TURN *** [Qc Qh 9c] [9s]
*** RIVER *** [Qc Qh 9c 9s] [6s]
*** SHOW DOWN ***
mila is best: shows [Jh Jc] (two pair, Queens and Jacks)
gusanti: shows [Tc Ts] (two pair, Queens and Tens)
mila is best collected 91156 from pot
gusanti finished the tournament in 36th place and received $111.65.
*** SUMMARY ***
Total pot 91156 | Rake 0 
Board [Qc Qh 9c 9s 6s]
Seat 1: gusanti (button) showed [Tc Ts] and lost with two pair, Queens and Tens
Seat 2: aapetrone91 (small blind) folded before Flop
Seat 3: Rochinha2011 (big blind) folded before Flop
Seat 4: MjLK MAN folded before Flop (didn't bet)
Seat 5: mila is best showed [Jh Jc] and won (91156) with two pair, Queens and Jacks

PokerStars Hand #251210211347: Tournament #3769361908, $52.38+$2.62 USD Hold'em No Limit - Level XXIV (3000/6000) - 2024/06/26 23:19:46 UTC [2024/06/26 19:19:46 ET]
Table '3769361908 11' 6-max Seat #2 is the button
Seat 2: aapetrone91 (196348 in chips) 
Seat 3: Rochinha2011 (140391 in chips) 
Seat 4: MjLK MAN (51836 in chips) 
Seat 5: mila is best (101124 in chips) 
Seat 6: DEERV (173020 in chips) 
aapetrone91: posts the ante 1500
Rochinha2011: posts the ante 1500
MjLK MAN: posts the ante 1500
mila is best: posts the ante 1500
DEERV: posts the ante 1500
Rochinha2011: posts small blind 3000
MjLK MAN: posts big blind 6000
*** HOLE CARDS ***
mila is best: folds 
DEERV: folds 
aapetrone91: folds 
Rochinha2011: raises 132891 to 138891 and is all-in
MjLK MAN: calls 44336 and is all-in
Uncalled bet (88555) returned to Rochinha2011
*** FLOP *** [4s 8s 5h]
*** TURN *** [4s 8s 5h] [5s]
*** RIVER *** [4s 8s 5h 5s] [Qd]
*** SHOW DOWN ***
Rochinha2011: shows [Td 9d] (a pair of Fives)
MjLK MAN: shows [As Qh] (two pair, Queens and Fives)
MjLK MAN collected 108172 from pot
*** SUMMARY ***
Total pot 108172 | Rake 0 
Board [4s 8s 5h 5s Qd]
Seat 2: aapetrone91 (button) folded before Flop (didn't bet)
Seat 3: Rochinha2011 (small blind) showed [Td 9d] and lost with a pair of Fives
Seat 4: MjLK MAN (big blind) showed [As Qh] and won (108172) with two pair, Queens and Fives
Seat 5: mila is best folded before Flop (didn't bet)
Seat 6: DEERV folded before Flop (didn't bet)

PokerStars Hand #251210217988: Tournament #3769361908, $52.38+$2.62 USD Hold'em No Limit - Level XXV (3500/7000) - 2024/06/26 23:20:18 UTC [2024/06/26 19:20:18 ET]
Table '3769361908 11' 6-max Seat #3 is the button
Seat 2: aapetrone91 (194848 in chips) 
Seat 3: Rochinha2011 (88555 in chips) 
Seat 4: MjLK MAN (108172 in chips) 
Seat 5: mila is best (99624 in chips) 
Seat 6: DEERV (171520 in chips) 
aapetrone91: posts the ante 1750
Rochinha2011: posts the ante 1750
MjLK MAN: posts the ante 1750
mila is best: posts the ante 1750
DEERV: posts the ante 1750
MjLK MAN: posts small blind 3500
mila is best: posts big blind 7000
*** HOLE CARDS ***
DEERV: folds 
aapetrone91: raises 186098 to 193098 and is all-in
Rochinha2011: folds 
MjLK MAN: folds 
mila is best: folds 
Uncalled bet (186098) returned to aapetrone91
aapetrone91 collected 26250 from pot
*** SUMMARY ***
Total pot 26250 | Rake 0 
Seat 2: aapetrone91 collected (26250)
Seat 3: Rochinha2011 (button) folded before Flop (didn't bet)
Seat 4: MjLK MAN (small blind) folded before Flop
Seat 5: mila is best (big blind) folded before Flop
Seat 6: DEERV folded before Flop (didn't bet)

PokerStars Hand #251210222905: Tournament #3769361908, $52.38+$2.62 USD Hold'em No Limit - Level XXV (3500/7000) - 2024/06/26 23:20:42 UTC [2024/06/26 19:20:42 ET]
Table '3769361908 11' 6-max Seat #4 is the button
Seat 2: aapetrone91 (212348 in chips) 
Seat 3: Rochinha2011 (86805 in chips) 
Seat 4: MjLK MAN (102922 in chips) 
Seat 5: mila is best (90874 in chips) 
Seat 6: DEERV (169770 in chips) 
aapetrone91: posts the ante 1750
Rochinha2011: posts the ante 1750
MjLK MAN: posts the ante 1750
mila is best: posts the ante 1750
DEERV: posts the ante 1750
mila is best: posts small blind 3500
DEERV: posts big blind 7000
*** HOLE CARDS ***
aapetrone91: folds 
Rochinha2011: folds 
MjLK MAN: raises 94172 to 101172 and is all-in
mila is best: folds 
DEERV: folds 
Uncalled bet (94172) returned to MjLK MAN
MjLK MAN collected 26250 from pot
MjLK MAN: doesn't show hand 
*** SUMMARY ***
Total pot 26250 | Rake 0 
Seat 2: aapetrone91 folded before Flop (didn't bet)
Seat 3: Rochinha2011 folded before Flop (didn't bet)
Seat 4: MjLK MAN (button) collected (26250)
Seat 5: mila is best (small blind) folded before Flop
Seat 6: DEERV (big blind) folded before Flop

PokerStars Hand #251210226365: Tournament #3769361908, $52.38+$2.62 USD Hold'em No Limit - Level XXV (3500/7000) - 2024/06/26 23:20:58 UTC [2024/06/26 19:20:58 ET]
Table '3769361908 11' 6-max Seat #5 is the button
Seat 2: aapetrone91 (210598 in chips) 
Seat 3: Rochinha2011 (85055 in chips) 
Seat 4: MjLK MAN (120422 in chips) 
Seat 5: mila is best (85624 in chips) 
Seat 6: DEERV (161020 in chips) 
aapetrone91: posts the ante 1750
Rochinha2011: posts the ante 1750
MjLK MAN: posts the ante 1750
mila is best: posts the ante 1750
DEERV: posts the ante 1750
DEERV: posts small blind 3500
aapetrone91: posts big blind 7000
*** HOLE CARDS ***
davideriksso is disconnected 
Rochinha2011: raises 76305 to 83305 and is all-in
MjLK MAN: folds 
mila is best: folds 
DEERV: folds 
aapetrone91: folds 
Uncalled bet (76305) returned to Rochinha2011
Rochinha2011 collected 26250 from pot
Rochinha2011: doesn't show hand 
*** SUMMARY ***
Total pot 26250 | Rake 0 
Seat 2: aapetrone91 (big blind) folded before Flop
Seat 3: Rochinha2011 collected (26250)
Seat 4: MjLK MAN folded before Flop (didn't bet)
Seat 5: mila is best (button) folded before Flop (didn't bet)
Seat 6: DEERV (small blind) folded before Flop

PokerStars Hand #251210231593: Tournament #3769361908, $52.38+$2.62 USD Hold'em No Limit - Level XXV (3500/7000) - 2024/06/26 23:21:23 UTC [2024/06/26 19:21:23 ET]
Table '3769361908 11' 6-max Seat #6 is the button
Seat 1: davideriksso (181627 in chips) out of hand (moved from another table into small blind)
Seat 2: aapetrone91 (201848 in chips) 
Seat 3: Rochinha2011 (102555 in chips) 
Seat 4: MjLK MAN (118672 in chips) 
Seat 5: mila is best (83874 in chips) 
Seat 6: DEERV (155770 in chips) 
davideriksso will be allowed to play after the button
aapetrone91: posts the ante 1750
Rochinha2011: posts the ante 1750
MjLK MAN: posts the ante 1750
mila is best: posts the ante 1750
DEERV: posts the ante 1750
aapetrone91: posts small blind 3500
Rochinha2011: posts big blind 7000
*** HOLE CARDS ***
MjLK MAN: folds 
mila is best: folds 
DEERV: folds 
aapetrone91: raises 193098 to 200098 and is all-in
Rochinha2011: folds 
Uncalled bet (193098) returned to aapetrone91
aapetrone91 collected 22750 from pot
*** SUMMARY ***
Total pot 22750 | Rake 0 
Seat 2: aapetrone91 (small blind) collected (22750)
Seat 3: Rochinha2011 (big blind) folded before Flop
Seat 4: MjLK MAN folded before Flop (didn't bet)
Seat 5: mila is best folded before Flop (didn't bet)
Seat 6: DEERV (button) folded before Flop (didn't bet)

PokerStars Hand #251210235903: Tournament #3769361908, $52.38+$2.62 USD Hold'em No Limit - Level XXV (3500/7000) - 2024/06/26 23:21:44 UTC [2024/06/26 19:21:44 ET]
Table '3769361908 11' 6-max Seat #2 is the button
Seat 1: davideriksso (181627 in chips) 
Seat 2: aapetrone91 (215848 in chips) 
Seat 3: Rochinha2011 (93805 in chips) 
Seat 4: MjLK MAN (116922 in chips) 
Seat 5: mila is best (82124 in chips) 
Seat 6: DEERV (154020 in chips) 
davideriksso: posts the ante 1750
aapetrone91: posts the ante 1750
Rochinha2011: posts the ante 1750
MjLK MAN: posts the ante 1750
mila is best: posts the ante 1750
DEERV: posts the ante 1750
Rochinha2011: posts small blind 3500
MjLK MAN: posts big blind 7000
*** HOLE CARDS ***
mila is best: folds 
DEERV: folds 
davideriksso: folds 
aapetrone91: raises 207098 to 214098 and is all-in
Rochinha2011: folds 
MjLK MAN has timed out
MjLK MAN: folds 
MjLK MAN is sitting out
Uncalled bet (207098) returned to aapetrone91
MjLK MAN has returned
aapetrone91 collected 28000 from pot
*** SUMMARY ***
Total pot 28000 | Rake 0 
Seat 1: davideriksso folded before Flop (didn't bet)
Seat 2: aapetrone91 (button) collected (28000)
Seat 3: Rochinha2011 (small blind) folded before Flop
Seat 4: MjLK MAN (big blind) folded before Flop
Seat 5: mila is best folded before Flop (didn't bet)
Seat 6: DEERV folded before Flop (didn't bet)

PokerStars Hand #251210242062: Tournament #3769361908, $52.38+$2.62 USD Hold'em No Limit - Level XXV (3500/7000) - 2024/06/26 23:22:14 UTC [2024/06/26 19:22:14 ET]
Table '3769361908 11' 6-max Seat #3 is the button
Seat 1: davideriksso (179877 in chips) 
Seat 2: aapetrone91 (235098 in chips) 
Seat 3: Rochinha2011 (88555 in chips) 
Seat 4: MjLK MAN (108172 in chips) 
Seat 5: mila is best (80374 in chips) 
Seat 6: DEERV (152270 in chips) 
davideriksso: posts the ante 1750
aapetrone91: posts the ante 1750
Rochinha2011: posts the ante 1750
MjLK MAN: posts the ante 1750
mila is best: posts the ante 1750
DEERV: posts the ante 1750
MjLK MAN: posts small blind 3500
mila is best: posts big blind 7000
*** HOLE CARDS ***
DEERV: folds 
davideriksso: calls 7000
aapetrone91: folds 
Rochinha2011: folds 
MjLK MAN has timed out
MjLK MAN: folds 
MjLK MAN is sitting out
MjLK MAN has returned
mila is best: checks 
*** FLOP *** [3h 8h 9d]
mila is best: checks 
davideriksso: checks 
*** TURN *** [3h 8h 9d] [Kd]
mila is best: checks 
davideriksso: checks 
*** RIVER *** [3h 8h 9d Kd] [3d]
mila is best: checks 
davideriksso: checks 
*** SHOW DOWN ***
mila is best: shows [6d 8s] (two pair, Eights and Threes)
davideriksso: mucks hand 
mila is best collected 28000 from pot
*** SUMMARY ***
Total pot 28000 | Rake 0 
Board [3h 8h 9d Kd 3d]
Seat 1: davideriksso mucked
Seat 2: aapetrone91 folded before Flop (didn't bet)
Seat 3: Rochinha2011 (button) folded before Flop (didn't bet)
Seat 4: MjLK MAN (small blind) folded before Flop
Seat 5: mila is best (big blind) showed [6d 8s] and won (28000) with two pair, Eights and Threes
Seat 6: DEERV folded before Flop (didn't bet)

PokerStars Hand #251210252478: Tournament #3769361908, $52.38+$2.62 USD Hold'em No Limit - Level XXV (3500/7000) - 2024/06/26 23:23:04 UTC [2024/06/26 19:23:04 ET]
Table '3769361908 11' 6-max Seat #4 is the button
Seat 1: davideriksso (171127 in chips) 
Seat 2: aapetrone91 (233348 in chips) 
Seat 3: Rochinha2011 (86805 in chips) 
Seat 4: MjLK MAN (102922 in chips) 
Seat 5: mila is best (99624 in chips) 
Seat 6: DEERV (150520 in chips) 
davideriksso: posts the ante 1750
aapetrone91: posts the ante 1750
Rochinha2011: posts the ante 1750
MjLK MAN: posts the ante 1750
mila is best: posts the ante 1750
DEERV: posts the ante 1750
mila is best: posts small blind 3500
DEERV: posts big blind 7000
*** HOLE CARDS ***
davideriksso: folds 
aapetrone91: folds 
Rochinha2011: folds 
MjLK MAN: folds 
mila is best: raises 90874 to 97874 and is all-in
DEERV: folds 
Uncalled bet (90874) returned to mila is best
mila is best collected 24500 from pot
*** SUMMARY ***
Total pot 24500 | Rake 0 
Seat 1: davideriksso folded before Flop (didn't bet)
Seat 2: aapetrone91 folded before Flop (didn't bet)
Seat 3: Rochinha2011 folded before Flop (didn't bet)
Seat 4: MjLK MAN (button) folded before Flop (didn't bet)
Seat 5: mila is best (small blind) collected (24500)
Seat 6: DEERV (big blind) folded before Flop

PokerStars Hand #251210258375: Tournament #3769361908, $52.38+$2.62 USD Hold'em No Limit - Level XXVI (4000/8000) - 2024/06/26 23:23:33 UTC [2024/06/26 19:23:33 ET]
Table '3769361908 11' 6-max Seat #5 is the button
Seat 1: davideriksso (169377 in chips) 
Seat 2: aapetrone91 (231598 in chips) 
Seat 3: Rochinha2011 (85055 in chips) 
Seat 4: MjLK MAN (101172 in chips) 
Seat 5: mila is best (115374 in chips) 
Seat 6: DEERV (141770 in chips) 
davideriksso: posts the ante 2000
aapetrone91: posts the ante 2000
Rochinha2011: posts the ante 2000
MjLK MAN: posts the ante 2000
mila is best: posts the ante 2000
DEERV: posts the ante 2000
DEERV: posts small blind 4000
davideriksso: posts big blind 8000
*** HOLE CARDS ***
aapetrone91: folds 
Rochinha2011: folds 
MjLK MAN: raises 91172 to 99172 and is all-in
mila is best: folds 
DEERV: folds 
davideriksso: folds 
Uncalled bet (91172) returned to MjLK MAN
MjLK MAN collected 32000 from pot
MjLK MAN: doesn't show hand 
*** SUMMARY ***
Total pot 32000 | Rake 0 
Seat 1: davideriksso (big blind) folded before Flop
Seat 2: aapetrone91 folded before Flop (didn't bet)
Seat 3: Rochinha2011 folded before Flop (didn't bet)
Seat 4: MjLK MAN collected (32000)
Seat 5: mila is best (button) folded before Flop (didn't bet)
Seat 6: DEERV (small blind) folded before Flop

PokerStars Hand #251210262512: Tournament #3769361908, $52.38+$2.62 USD Hold'em No Limit - Level XXVI (4000/8000) - 2024/06/26 23:23:53 UTC [2024/06/26 19:23:53 ET]
Table '3769361908 11' 6-max Seat #6 is the button
Seat 1: davideriksso (159377 in chips) 
Seat 2: aapetrone91 (229598 in chips) 
Seat 3: Rochinha2011 (83055 in chips) 
Seat 4: MjLK MAN (123172 in chips) 
Seat 5: mila is best (113374 in chips) 
Seat 6: DEERV (135770 in chips) 
davideriksso: posts the ante 2000
aapetrone91: posts the ante 2000
Rochinha2011: posts the ante 2000
MjLK MAN: posts the ante 2000
mila is best: posts the ante 2000
DEERV: posts the ante 2000
davideriksso: posts small blind 4000
aapetrone91: posts big blind 8000
*** HOLE CARDS ***
Rochinha2011: raises 8000 to 16000
MjLK MAN: folds 
mila is best: folds 
DEERV: folds 
davideriksso: folds 
aapetrone91: folds 
Uncalled bet (8000) returned to Rochinha2011
Rochinha2011 collected 32000 from pot
Rochinha2011: doesn't show hand 
*** SUMMARY ***
Total pot 32000 | Rake 0 
Seat 1: davideriksso (small blind) folded before Flop
Seat 2: aapetrone91 (big blind) folded before Flop
Seat 3: Rochinha2011 collected (32000)
Seat 4: MjLK MAN folded before Flop (didn't bet)
Seat 5: mila is best folded before Flop (didn't bet)
Seat 6: DEERV (button) folded before Flop (didn't bet)

PokerStars Hand #251210267539: Tournament #3769361908, $52.38+$2.62 USD Hold'em No Limit - Level XXVI (4000/8000) - 2024/06/26 23:24:18 UTC [2024/06/26 19:24:18 ET]
Table '3769361908 11' 6-max Seat #1 is the button
Seat 1: davideriksso (153377 in chips) 
Seat 2: aapetrone91 (219598 in chips) 
Seat 3: Rochinha2011 (105055 in chips) 
Seat 4: MjLK MAN (121172 in chips) 
Seat 5: mila is best (111374 in chips) 
Seat 6: DEERV (133770 in chips) 
davideriksso: posts the ante 2000
aapetrone91: posts the ante 2000
Rochinha2011: posts the ante 2000
MjLK MAN: posts the ante 2000
mila is best: posts the ante 2000
DEERV: posts the ante 2000
aapetrone91: posts small blind 4000
Rochinha2011: posts big blind 8000
*** HOLE CARDS ***
MjLK MAN: raises 8000 to 16000
mila is best: folds 
DEERV: folds 
davideriksso: folds 
aapetrone91: folds 
Rochinha2011: calls 8000
*** FLOP *** [5d Qh 4c]
Rochinha2011: checks 
MjLK MAN: bets 8000
Rochinha2011: folds 
Uncalled bet (8000) returned to MjLK MAN
MjLK MAN collected 48000 from pot
MjLK MAN: doesn't show hand 
*** SUMMARY ***
Total pot 48000 | Rake 0 
Board [5d Qh 4c]
Seat 1: davideriksso (button) folded before Flop (didn't bet)
Seat 2: aapetrone91 (small blind) folded before Flop
Seat 3: Rochinha2011 (big blind) folded on the Flop
Seat 4: MjLK MAN collected (48000)
Seat 5: mila is best folded before Flop (didn't bet)
Seat 6: DEERV folded before Flop (didn't bet)

PokerStars Hand #251210275363: Tournament #3769361908, $52.38+$2.62 USD Hold'em No Limit - Level XXVI (4000/8000) - 2024/06/26 23:24:56 UTC [2024/06/26 19:24:56 ET]
Table '3769361908 11' 6-max Seat #2 is the button
Seat 1: davideriksso (151377 in chips) 
Seat 2: aapetrone91 (213598 in chips) 
Seat 3: Rochinha2011 (87055 in chips) 
Seat 4: MjLK MAN (151172 in chips) 
Seat 5: mila is best (109374 in chips) 
Seat 6: DEERV (131770 in chips) 
davideriksso: posts the ante 2000
aapetrone91: posts the ante 2000
Rochinha2011: posts the ante 2000
MjLK MAN: posts the ante 2000
mila is best: posts the ante 2000
DEERV: posts the ante 2000
Rochinha2011: posts small blind 4000
MjLK MAN: posts big blind 8000
*** HOLE CARDS ***
mila is best: raises 8000 to 16000
DEERV: folds 
davideriksso: folds 
aapetrone91: folds 
Rochinha2011: folds 
MjLK MAN: calls 8000
*** FLOP *** [Jc Ah Qd]
MjLK MAN: checks 
mila is best: bets 16000
MjLK MAN: folds 
Uncalled bet (16000) returned to mila is best
mila is best collected 48000 from pot
*** SUMMARY ***
Total pot 48000 | Rake 0 
Board [Jc Ah Qd]
Seat 1: davideriksso folded before Flop (didn't bet)
Seat 2: aapetrone91 (button) folded before Flop (didn't bet)
Seat 3: Rochinha2011 (small blind) folded before Flop
Seat 4: MjLK MAN (big blind) folded on the Flop
Seat 5: mila is best collected (48000)
Seat 6: DEERV folded before Flop (didn't bet)

PokerStars Hand #251210292253: Tournament #3769361908, $52.38+$2.62 USD Hold'em No Limit - Level XXVII (4500/9000) - 2024/06/26 23:26:18 UTC [2024/06/26 19:26:18 ET]
Table '3769361908 11' 6-max Seat #3 is the button
Seat 1: davideriksso (149377 in chips) 
Seat 2: aapetrone91 (211598 in chips) 
Seat 3: Rochinha2011 (81055 in chips) 
Seat 4: MjLK MAN (133172 in chips) 
Seat 5: mila is best (139374 in chips) 
Seat 6: DEERV (129770 in chips) 
davideriksso: posts the ante 2250
aapetrone91: posts the ante 2250
Rochinha2011: posts the ante 2250
MjLK MAN: posts the ante 2250
mila is best: posts the ante 2250
DEERV: posts the ante 2250
MjLK MAN: posts small blind 4500
mila is best: posts big blind 9000
*** HOLE CARDS ***
DEERV: folds 
davideriksso: raises 9000 to 18000
aapetrone91: folds 
Rochinha2011: folds 
MjLK MAN: folds 
mila is best: calls 9000
*** FLOP *** [4d 6h 8s]
mila is best: checks 
davideriksso: bets 18000
mila is best: folds 
Uncalled bet (18000) returned to davideriksso
davideriksso collected 54000 from pot
davideriksso: doesn't show hand 
*** SUMMARY ***
Total pot 54000 | Rake 0 
Board [4d 6h 8s]
Seat 1: davideriksso collected (54000)
Seat 2: aapetrone91 folded before Flop (didn't bet)
Seat 3: Rochinha2011 (button) folded before Flop (didn't bet)
Seat 4: MjLK MAN (small blind) folded before Flop
Seat 5: mila is best (big blind) folded on the Flop
Seat 6: DEERV folded before Flop (didn't bet)

PokerStars Hand #251210299898: Tournament #3769361908, $52.38+$2.62 USD Hold'em No Limit - Level XXVII (4500/9000) - 2024/06/26 23:26:56 UTC [2024/06/26 19:26:56 ET]
Table '3769361908 11' 6-max Seat #4 is the button
Seat 1: davideriksso (183127 in chips) 
Seat 2: aapetrone91 (209348 in chips) 
Seat 3: Rochinha2011 (78805 in chips) 
Seat 4: MjLK MAN (126422 in chips) 
Seat 5: mila is best (119124 in chips) 
Seat 6: DEERV (127520 in chips) 
davideriksso: posts the ante 2250
aapetrone91: posts the ante 2250
Rochinha2011: posts the ante 2250
MjLK MAN: posts the ante 2250
mila is best: posts the ante 2250
DEERV: posts the ante 2250
mila is best: posts small blind 4500
DEERV: posts big blind 9000
*** HOLE CARDS ***
davideriksso: folds 
aapetrone91: folds 
Rochinha2011: folds 
MjLK MAN: raises 115172 to 124172 and is all-in
mila is best: folds 
DEERV: folds 
Uncalled bet (115172) returned to MjLK MAN
MjLK MAN collected 36000 from pot
MjLK MAN: doesn't show hand 
*** SUMMARY ***
Total pot 36000 | Rake 0 
Seat 1: davideriksso folded before Flop (didn't bet)
Seat 2: aapetrone91 folded before Flop (didn't bet)
Seat 3: Rochinha2011 folded before Flop (didn't bet)
Seat 4: MjLK MAN (button) collected (36000)
Seat 5: mila is best (small blind) folded before Flop
Seat 6: DEERV (big blind) folded before Flop

PokerStars Hand #251210303982: Tournament #3769361908, $52.38+$2.62 USD Hold'em No Limit - Level XXVII (4500/9000) - 2024/06/26 23:27:16 UTC [2024/06/26 19:27:16 ET]
Table '3769361908 11' 6-max Seat #5 is the button
Seat 1: davideriksso (180877 in chips) 
Seat 2: aapetrone91 (207098 in chips) 
Seat 3: Rochinha2011 (76555 in chips) 
Seat 4: MjLK MAN (151172 in chips) 
Seat 5: mila is best (112374 in chips) 
Seat 6: DEERV (116270 in chips) 
davideriksso: posts the ante 2250
aapetrone91: posts the ante 2250
Rochinha2011: posts the ante 2250
MjLK MAN: posts the ante 2250
mila is best: posts the ante 2250
DEERV: posts the ante 2250
DEERV: posts small blind 4500
davideriksso: posts big blind 9000
*** HOLE CARDS ***
aapetrone91: raises 9000 to 18000
Rochinha2011: raises 56305 to 74305 and is all-in
MjLK MAN: raises 74617 to 148922 and is all-in
mila is best: folds 
DEERV: folds 
davideriksso: folds 
aapetrone91: folds 
Uncalled bet (74617) returned to MjLK MAN
*** FLOP *** [7s 2h 9c]
*** TURN *** [7s 2h 9c] [Ac]
*** RIVER *** [7s 2h 9c Ac] [4h]
*** SHOW DOWN ***
Rochinha2011: shows [Qd Kd] (high card Ace)
MjLK MAN: shows [Jh Jc] (a pair of Jacks)
MjLK MAN collected 193610 from pot
Rochinha2011 finished the tournament in 25th place and received $135.63.
*** SUMMARY ***
Total pot 193610 | Rake 0 
Board [7s 2h 9c Ac 4h]
Seat 1: davideriksso (big blind) folded before Flop
Seat 2: aapetrone91 folded before Flop
Seat 3: Rochinha2011 showed [Qd Kd] and lost with high card Ace
Seat 4: MjLK MAN showed [Jh Jc] and won (193610) with a pair of Jacks
Seat 5: mila is best (button) folded before Flop (didn't bet)
Seat 6: DEERV (small blind) folded before Flop





PokerStars Hand #251209432006: Tournament #3769361908, $52.38+$2.62 USD Hold'em No Limit - Level VIII (125/250) - 2024/06/26 22:25:25 UTC [2024/06/26 18:25:25 ET]
Table '3769361908 5' 6-max Seat #3 is the button
Seat 1: assalbi (26362 in chips) is sitting out
Seat 2: marquinhosss (14590 in chips) 
Seat 3: despair515 (12353 in chips) 
Seat 4: AkwasYT (19836 in chips) 
Seat 5: zioeddy2312 (7240 in chips) 
Seat 6: ricardons8 (9880 in chips) 
assalbi: posts the ante 60
marquinhosss: posts the ante 60
despair515: posts the ante 60
AkwasYT: posts the ante 60
zioeddy2312: posts the ante 60
ricardons8: posts the ante 60
AkwasYT: posts small blind 125
zioeddy2312: posts big blind 250
*** HOLE CARDS ***
ricardons8: folds 
assalbi: folds 
marquinhosss: folds 
despair515: folds 
AkwasYT: calls 125
zioeddy2312: checks 
*** FLOP *** [8h 9s 9h]
AkwasYT: checks 
zioeddy2312: checks 
*** TURN *** [8h 9s 9h] [2d]
AkwasYT: checks 
zioeddy2312: checks 
*** RIVER *** [8h 9s 9h 2d] [2c]
AkwasYT: bets 500
zioeddy2312: folds 
Uncalled bet (500) returned to AkwasYT
AkwasYT collected 860 from pot
AkwasYT: doesn't show hand 
*** SUMMARY ***
Total pot 860 | Rake 0 
Board [8h 9s 9h 2d 2c]
Seat 1: assalbi folded before Flop (didn't bet)
Seat 2: marquinhosss folded before Flop (didn't bet)
Seat 3: despair515 (button) folded before Flop (didn't bet)
Seat 4: AkwasYT (small blind) collected (860)
Seat 5: zioeddy2312 (big blind) folded on the River
Seat 6: ricardons8 folded before Flop (didn't bet)

PokerStars Hand #251209440172: Tournament #3769361908, $52.38+$2.62 USD Hold'em No Limit - Level VIII (125/250) - 2024/06/26 22:25:55 UTC [2024/06/26 18:25:55 ET]
Table '3769361908 5' 6-max Seat #4 is the button
Seat 1: assalbi (26302 in chips) is sitting out
Seat 2: marquinhosss (14530 in chips) 
Seat 3: despair515 (12293 in chips) 
Seat 4: AkwasYT (20386 in chips) 
Seat 5: zioeddy2312 (6930 in chips) 
Seat 6: ricardons8 (9820 in chips) 
assalbi: posts the ante 60
marquinhosss: posts the ante 60
despair515: posts the ante 60
AkwasYT: posts the ante 60
zioeddy2312: posts the ante 60
ricardons8: posts the ante 60
zioeddy2312: posts small blind 125
ricardons8: posts big blind 250
*** HOLE CARDS ***
assalbi: folds 
marquinhosss: folds 
despair515: folds 
AkwasYT: folds 
zioeddy2312: calls 125
ricardons8: raises 625 to 875
zioeddy2312: folds 
Uncalled bet (625) returned to ricardons8
ricardons8 collected 860 from pot
ricardons8: doesn't show hand 
*** SUMMARY ***
Total pot 860 | Rake 0 
Seat 1: assalbi folded before Flop (didn't bet)
Seat 2: marquinhosss folded before Flop (didn't bet)
Seat 3: despair515 folded before Flop (didn't bet)
Seat 4: AkwasYT (button) folded before Flop (didn't bet)
Seat 5: zioeddy2312 (small blind) folded before Flop
Seat 6: ricardons8 (big blind) collected (860)

PokerStars Hand #251209447568: Tournament #3769361908, $52.38+$2.62 USD Hold'em No Limit - Level IX (150/300) - 2024/06/26 22:26:22 UTC [2024/06/26 18:26:22 ET]
Table '3769361908 5' 6-max Seat #5 is the button
Seat 1: assalbi (26242 in chips) is sitting out
Seat 2: marquinhosss (14470 in chips) 
Seat 3: despair515 (12233 in chips) 
Seat 4: AkwasYT (20326 in chips) 
Seat 5: zioeddy2312 (6620 in chips) 
Seat 6: ricardons8 (10370 in chips) 
assalbi: posts the ante 75
marquinhosss: posts the ante 75
despair515: posts the ante 75
AkwasYT: posts the ante 75
zioeddy2312: posts the ante 75
ricardons8: posts the ante 75
ricardons8: posts small blind 150
assalbi: posts big blind 300
*** HOLE CARDS ***
marquinhosss: folds 
despair515: folds 
AkwasYT: folds 
zioeddy2312: raises 600 to 900
ricardons8: raises 9395 to 10295 and is all-in
assalbi: folds 
zioeddy2312: calls 5645 and is all-in
Uncalled bet (3750) returned to ricardons8
*** FLOP *** [8d 4h 8s]
*** TURN *** [8d 4h 8s] [Jh]
*** RIVER *** [8d 4h 8s Jh] [Qs]
*** SHOW DOWN ***
ricardons8: shows [Tc As] (a pair of Eights)
zioeddy2312: shows [Jc Qc] (two pair, Queens and Jacks)
zioeddy2312 collected 13840 from pot
*** SUMMARY ***
Total pot 13840 | Rake 0 
Board [8d 4h 8s Jh Qs]
Seat 1: assalbi (big blind) folded before Flop
Seat 2: marquinhosss folded before Flop (didn't bet)
Seat 3: despair515 folded before Flop (didn't bet)
Seat 4: AkwasYT folded before Flop (didn't bet)
Seat 5: zioeddy2312 (button) showed [Jc Qc] and won (13840) with two pair, Queens and Jacks
Seat 6: ricardons8 (small blind) showed [Tc As] and lost with a pair of Eights

PokerStars Hand #251209457991: Tournament #3769361908, $52.38+$2.62 USD Hold'em No Limit - Level IX (150/300) - 2024/06/26 22:26:59 UTC [2024/06/26 18:26:59 ET]
Table '3769361908 5' 6-max Seat #6 is the button
Seat 1: assalbi (25867 in chips) is sitting out
Seat 2: marquinhosss (14395 in chips) 
Seat 3: despair515 (12158 in chips) 
Seat 4: AkwasYT (20251 in chips) 
Seat 5: zioeddy2312 (13840 in chips) 
Seat 6: ricardons8 (3750 in chips) 
assalbi: posts the ante 75
marquinhosss: posts the ante 75
despair515: posts the ante 75
AkwasYT: posts the ante 75
zioeddy2312: posts the ante 75
ricardons8: posts the ante 75
assalbi: posts small blind 150
marquinhosss: posts big blind 300
*** HOLE CARDS ***
despair515: folds 
AkwasYT: raises 300 to 600
zioeddy2312: folds 
ricardons8: raises 3075 to 3675 and is all-in
assalbi: folds 
marquinhosss: folds 
AkwasYT: calls 3075
*** FLOP *** [2d 8h 4d]
*** TURN *** [2d 8h 4d] [3s]
*** RIVER *** [2d 8h 4d 3s] [6d]
*** SHOW DOWN ***
AkwasYT: shows [Qd Qc] (a pair of Queens)
ricardons8: shows [Ah Ks] (high card Ace)
AkwasYT collected 8250 from pot
ricardons8 finished the tournament
*** SUMMARY ***
Total pot 8250 | Rake 0 
Board [2d 8h 4d 3s 6d]
Seat 1: assalbi (small blind) folded before Flop
Seat 2: marquinhosss (big blind) folded before Flop
Seat 3: despair515 folded before Flop (didn't bet)
Seat 4: AkwasYT showed [Qd Qc] and won (8250) with a pair of Queens
Seat 5: zioeddy2312 folded before Flop (didn't bet)
Seat 6: ricardons8 (button) showed [Ah Ks] and lost with high card Ace

PokerStars Hand #251209466510: Tournament #3769361908, $52.38+$2.62 USD Hold'em No Limit - Level IX (150/300) - 2024/06/26 22:27:30 UTC [2024/06/26 18:27:30 ET]
Table '3769361908 5' 6-max Seat #1 is the button
Seat 1: assalbi (25642 in chips) is sitting out
Seat 2: marquinhosss (14020 in chips) 
Seat 4: AkwasYT (24751 in chips) 
Seat 5: zioeddy2312 (13765 in chips) 
assalbi: posts the ante 75
marquinhosss: posts the ante 75
AkwasYT: posts the ante 75
zioeddy2312: posts the ante 75
marquinhosss: posts small blind 150
AkwasYT: posts big blind 300
*** HOLE CARDS ***
zioeddy2312: folds 
assalbi: folds 
burianjpb is disconnected 
marquinhosss: calls 150
AkwasYT: raises 300 to 600
marquinhosss: calls 300
*** FLOP *** [8c 4s 2c]
marquinhosss: checks 
AkwasYT: checks 
*** TURN *** [8c 4s 2c] [Tc]
marquinhosss: bets 495
AkwasYT: calls 495
*** RIVER *** [8c 4s 2c Tc] [Kd]
marquinhosss: bets 822
AkwasYT: folds 
Uncalled bet (822) returned to marquinhosss
marquinhosss collected 2490 from pot
marquinhosss: doesn't show hand 
*** SUMMARY ***
Total pot 2490 | Rake 0 
Board [8c 4s 2c Tc Kd]
Seat 1: assalbi (button) folded before Flop (didn't bet)
Seat 2: marquinhosss (small blind) collected (2490)
Seat 4: AkwasYT (big blind) folded on the River
Seat 5: zioeddy2312 folded before Flop (didn't bet)

PokerStars Hand #251209480145: Tournament #3769361908, $52.38+$2.62 USD Hold'em No Limit - Level IX (150/300) - 2024/06/26 22:28:19 UTC [2024/06/26 18:28:19 ET]
Table '3769361908 5' 6-max Seat #2 is the button
Seat 1: assalbi (25567 in chips) is sitting out
Seat 2: marquinhosss (15340 in chips) 
Seat 3: burianjpb (13090 in chips) out of hand (moved from another table into small blind)
Seat 4: AkwasYT (23581 in chips) 
Seat 5: zioeddy2312 (13690 in chips) 
burianjpb will be allowed to play after the button
assalbi: posts the ante 75
marquinhosss: posts the ante 75
AkwasYT: posts the ante 75
zioeddy2312: posts the ante 75
AkwasYT: posts small blind 150
zioeddy2312: posts big blind 300
*** HOLE CARDS ***
assalbi: folds 
marquinhosss: raises 300 to 600
AkwasYT: calls 450
zioeddy2312: folds 
*** FLOP *** [9s 2d Kd]
AkwasYT: checks 
marquinhosss: bets 594
AkwasYT: calls 594
*** TURN *** [9s 2d Kd] [7h]
AkwasYT: bets 900
marquinhosss: calls 900
*** RIVER *** [9s 2d Kd 7h] [4c]
AkwasYT: checks 
marquinhosss: checks 
*** SHOW DOWN ***
AkwasYT: shows [Kc Th] (a pair of Kings)
marquinhosss: mucks hand 
AkwasYT collected 4788 from pot
*** SUMMARY ***
Total pot 4788 | Rake 0 
Board [9s 2d Kd 7h 4c]
Seat 1: assalbi folded before Flop (didn't bet)
Seat 2: marquinhosss (button) mucked
Seat 4: AkwasYT (small blind) showed [Kc Th] and won (4788) with a pair of Kings
Seat 5: zioeddy2312 (big blind) folded before Flop

PokerStars Hand #251209491052: Tournament #3769361908, $52.38+$2.62 USD Hold'em No Limit - Level IX (150/300) - 2024/06/26 22:28:58 UTC [2024/06/26 18:28:58 ET]
Table '3769361908 5' 6-max Seat #4 is the button
Seat 1: assalbi (25492 in chips) is sitting out
Seat 2: marquinhosss (13171 in chips) 
Seat 3: burianjpb (13090 in chips) 
Seat 4: AkwasYT (26200 in chips) 
Seat 5: zioeddy2312 (13315 in chips) 
assalbi: posts the ante 75
marquinhosss: posts the ante 75
burianjpb: posts the ante 75
AkwasYT: posts the ante 75
zioeddy2312: posts the ante 75
zioeddy2312: posts small blind 150
assalbi: posts big blind 300
*** HOLE CARDS ***
marquinhosss: folds 
burianjpb: folds 
AkwasYT: folds 
zioeddy2312: raises 300 to 600
assalbi: folds 
Uncalled bet (300) returned to zioeddy2312
zioeddy2312 collected 975 from pot
*** SUMMARY ***
Total pot 975 | Rake 0 
Seat 1: assalbi (big blind) folded before Flop
Seat 2: marquinhosss folded before Flop (didn't bet)
Seat 3: burianjpb folded before Flop (didn't bet)
Seat 4: AkwasYT (button) folded before Flop (didn't bet)
Seat 5: zioeddy2312 (small blind) collected (975)

PokerStars Hand #251209497894: Tournament #3769361908, $52.38+$2.62 USD Hold'em No Limit - Level X (200/400) - 2024/06/26 22:29:23 UTC [2024/06/26 18:29:23 ET]
Table '3769361908 5' 6-max Seat #5 is the button
Seat 1: assalbi (25117 in chips) is sitting out
Seat 2: marquinhosss (13096 in chips) 
Seat 3: burianjpb (13015 in chips) 
Seat 4: AkwasYT (26125 in chips) 
Seat 5: zioeddy2312 (13915 in chips) 
assalbi: posts the ante 100
marquinhosss: posts the ante 100
burianjpb: posts the ante 100
AkwasYT: posts the ante 100
zioeddy2312: posts the ante 100
assalbi: posts small blind 200
marquinhosss: posts big blind 400
*** HOLE CARDS ***
burianjpb: folds 
AkwasYT: raises 400 to 800
zioeddy2312: folds 
assalbi: folds 
marquinhosss: calls 400
*** FLOP *** [3h 8c 7s]
marquinhosss: checks 
AkwasYT: checks 
*** TURN *** [3h 8c 7s] [5c]
marquinhosss: checks 
assalbi has returned
AkwasYT: bets 800
marquinhosss: calls 800
*** RIVER *** [3h 8c 7s 5c] [Qs]
marquinhosss: checks 
AkwasYT: bets 1200
marquinhosss: calls 1200
*** SHOW DOWN ***
AkwasYT: shows [Tc Ah] (high card Ace)
marquinhosss: mucks hand 
AkwasYT collected 6300 from pot
*** SUMMARY ***
Total pot 6300 | Rake 0 
Board [3h 8c 7s 5c Qs]
Seat 1: assalbi (small blind) folded before Flop
Seat 2: marquinhosss (big blind) mucked
Seat 3: burianjpb folded before Flop (didn't bet)
Seat 4: AkwasYT showed [Tc Ah] and won (6300) with high card Ace
Seat 5: zioeddy2312 (button) folded before Flop (didn't bet)

PokerStars Hand #251209511634: Tournament #3769361908, $52.38+$2.62 USD Hold'em No Limit - Level X (200/400) - 2024/06/26 22:30:11 UTC [2024/06/26 18:30:11 ET]
Table '3769361908 5' 6-max Seat #1 is the button
Seat 1: assalbi (24817 in chips) 
Seat 2: marquinhosss (10196 in chips) 
Seat 3: burianjpb (12915 in chips) 
Seat 4: AkwasYT (29525 in chips) 
Seat 5: zioeddy2312 (13815 in chips) 
Seat 6: antonisar (10000 in chips) 
assalbi: posts the ante 100
marquinhosss: posts the ante 100
burianjpb: posts the ante 100
AkwasYT: posts the ante 100
zioeddy2312: posts the ante 100
antonisar: posts the ante 100
marquinhosss: posts small blind 200
burianjpb: posts big blind 400
*** HOLE CARDS ***
AkwasYT: folds 
zioeddy2312: folds 
antonisar: folds 
assalbi has timed out
assalbi: folds 
assalbi is sitting out
marquinhosss: calls 200
burianjpb: raises 800 to 1200
marquinhosss: calls 800
*** FLOP *** [7s 5s 3d]
marquinhosss: checks 
burianjpb: checks 
*** TURN *** [7s 5s 3d] [9d]
marquinhosss: checks 
burianjpb: checks 
*** RIVER *** [7s 5s 3d 9d] [2h]
marquinhosss: checks 
burianjpb: checks 
*** SHOW DOWN ***
marquinhosss: shows [3c Ad] (a pair of Threes)
burianjpb: mucks hand 
marquinhosss collected 3000 from pot
*** SUMMARY ***
Total pot 3000 | Rake 0 
Board [7s 5s 3d 9d 2h]
Seat 1: assalbi (button) folded before Flop (didn't bet)
Seat 2: marquinhosss (small blind) showed [3c Ad] and won (3000) with a pair of Threes
Seat 3: burianjpb (big blind) mucked
Seat 4: AkwasYT folded before Flop (didn't bet)
Seat 5: zioeddy2312 folded before Flop (didn't bet)
Seat 6: antonisar folded before Flop (didn't bet)

PokerStars Hand #251209535093: Tournament #3769361908, $52.38+$2.62 USD Hold'em No Limit - Level X (200/400) - 2024/06/26 22:31:37 UTC [2024/06/26 18:31:37 ET]
Table '3769361908 5' 6-max Seat #2 is the button
Seat 1: assalbi (24717 in chips) is sitting out
Seat 2: marquinhosss (11896 in chips) 
Seat 3: burianjpb (11615 in chips) 
Seat 4: AkwasYT (29425 in chips) 
Seat 5: zioeddy2312 (13715 in chips) 
Seat 6: antonisar (9900 in chips) 
assalbi: posts the ante 100
marquinhosss: posts the ante 100
burianjpb: posts the ante 100
AkwasYT: posts the ante 100
zioeddy2312: posts the ante 100
antonisar: posts the ante 100
burianjpb: posts small blind 200
AkwasYT: posts big blind 400
*** HOLE CARDS ***
zioeddy2312: raises 800 to 1200
antonisar: calls 1200
assalbi: folds 
marquinhosss: raises 10596 to 11796 and is all-in
burianjpb: folds 
AkwasYT: folds 
zioeddy2312: folds 
antonisar: calls 8600 and is all-in
Uncalled bet (1996) returned to marquinhosss
*** FLOP *** [Ts Kd Kh]
*** TURN *** [Ts Kd Kh] [5c]
*** RIVER *** [Ts Kd Kh 5c] [9c]
*** SHOW DOWN ***
antonisar: shows [Js Ac] (a pair of Kings)
marquinhosss: shows [Kc As] (three of a kind, Kings)
marquinhosss collected 22000 from pot
antonisar finished the tournament
*** SUMMARY ***
Total pot 22000 | Rake 0 
Board [Ts Kd Kh 5c 9c]
Seat 1: assalbi folded before Flop (didn't bet)
Seat 2: marquinhosss (button) showed [Kc As] and won (22000) with three of a kind, Kings
Seat 3: burianjpb (small blind) folded before Flop
Seat 4: AkwasYT (big blind) folded before Flop
Seat 5: zioeddy2312 folded before Flop
Seat 6: antonisar showed [Js Ac] and lost with a pair of Kings

PokerStars Hand #251209551859: Tournament #3769361908, $52.38+$2.62 USD Hold'em No Limit - Level XI (250/500) - 2024/06/26 22:32:38 UTC [2024/06/26 18:32:38 ET]
Table '3769361908 5' 6-max Seat #3 is the button
Seat 1: assalbi (24617 in chips) is sitting out
Seat 2: marquinhosss (23996 in chips) 
Seat 3: burianjpb (11315 in chips) 
Seat 4: AkwasYT (28925 in chips) 
Seat 5: zioeddy2312 (12415 in chips) 
assalbi: posts the ante 125
marquinhosss: posts the ante 125
burianjpb: posts the ante 125
AkwasYT: posts the ante 125
zioeddy2312: posts the ante 125
AkwasYT: posts small blind 250
zioeddy2312: posts big blind 500
*** HOLE CARDS ***
assalbi: folds 
marquinhosss: folds 
burianjpb: folds 
AkwasYT: calls 250
zioeddy2312: checks 
*** FLOP *** [4d Ah 7c]
AkwasYT: checks 
zioeddy2312: checks 
*** TURN *** [4d Ah 7c] [8h]
AkwasYT: bets 1000
zioeddy2312: calls 1000
*** RIVER *** [4d Ah 7c 8h] [5h]
AkwasYT: checks 
zioeddy2312: bets 2500
AkwasYT: folds 
Uncalled bet (2500) returned to zioeddy2312
zioeddy2312 collected 3625 from pot
*** SUMMARY ***
Total pot 3625 | Rake 0 
Board [4d Ah 7c 8h 5h]
Seat 1: assalbi folded before Flop (didn't bet)
Seat 2: marquinhosss folded before Flop (didn't bet)
Seat 3: burianjpb (button) folded before Flop (didn't bet)
Seat 4: AkwasYT (small blind) folded on the River
Seat 5: zioeddy2312 (big blind) collected (3625)

PokerStars Hand #251209569606: Tournament #3769361908, $52.38+$2.62 USD Hold'em No Limit - Level XI (250/500) - 2024/06/26 22:33:45 UTC [2024/06/26 18:33:45 ET]
Table '3769361908 5' 6-max Seat #4 is the button
Seat 1: assalbi (24492 in chips) is sitting out
Seat 2: marquinhosss (23871 in chips) 
Seat 3: burianjpb (11190 in chips) 
Seat 4: AkwasYT (27300 in chips) 
Seat 5: zioeddy2312 (14415 in chips) 
assalbi: posts the ante 125
marquinhosss: posts the ante 125
burianjpb: posts the ante 125
AkwasYT: posts the ante 125
zioeddy2312: posts the ante 125
zioeddy2312: posts small blind 250
assalbi: posts big blind 500
*** HOLE CARDS ***
marquinhosss: folds 
burianjpb: folds 
AkwasYT: folds 
zioeddy2312: folds 
Uncalled bet (250) returned to assalbi
assalbi collected 1125 from pot
assalbi: doesn't show hand 
*** SUMMARY ***
Total pot 1125 | Rake 0 
Seat 1: assalbi (big blind) collected (1125)
Seat 2: marquinhosss folded before Flop (didn't bet)
Seat 3: burianjpb folded before Flop (didn't bet)
Seat 4: AkwasYT (button) folded before Flop (didn't bet)
Seat 5: zioeddy2312 (small blind) folded before Flop

PokerStars Hand #251209571950: Tournament #3769361908, $52.38+$2.62 USD Hold'em No Limit - Level XI (250/500) - 2024/06/26 22:33:53 UTC [2024/06/26 18:33:53 ET]
Table '3769361908 5' 6-max Seat #5 is the button
Seat 1: assalbi (25242 in chips) is sitting out
Seat 2: marquinhosss (23746 in chips) 
Seat 3: burianjpb (11065 in chips) 
Seat 4: AkwasYT (27175 in chips) 
Seat 5: zioeddy2312 (14040 in chips) 
assalbi: posts the ante 125
marquinhosss: posts the ante 125
burianjpb: posts the ante 125
AkwasYT: posts the ante 125
zioeddy2312: posts the ante 125
assalbi: posts small blind 250
marquinhosss: posts big blind 500
*** HOLE CARDS ***
burianjpb: folds 
AkwasYT: folds 
zioeddy2312: folds 
assalbi: folds 
Uncalled bet (250) returned to marquinhosss
marquinhosss collected 1125 from pot
marquinhosss: doesn't show hand 
*** SUMMARY ***
Total pot 1125 | Rake 0 
Seat 1: assalbi (small blind) folded before Flop
Seat 2: marquinhosss (big blind) collected (1125)
Seat 3: burianjpb folded before Flop (didn't bet)
Seat 4: AkwasYT folded before Flop (didn't bet)
Seat 5: zioeddy2312 (button) folded before Flop (didn't bet)

PokerStars Hand #251209574863: Tournament #3769361908, $52.38+$2.62 USD Hold'em No Limit - Level XI (250/500) - 2024/06/26 22:34:04 UTC [2024/06/26 18:34:04 ET]
Table '3769361908 5' 6-max Seat #1 is the button
Seat 1: assalbi (24867 in chips) is sitting out
Seat 2: marquinhosss (24496 in chips) 
Seat 3: burianjpb (10940 in chips) 
Seat 4: AkwasYT (27050 in chips) 
Seat 5: zioeddy2312 (13915 in chips) 
assalbi: posts the ante 125
marquinhosss: posts the ante 125
burianjpb: posts the ante 125
AkwasYT: posts the ante 125
zioeddy2312: posts the ante 125
marquinhosss: posts small blind 250
burianjpb: posts big blind 500
*** HOLE CARDS ***
AkwasYT: folds 
zioeddy2312: folds 
assalbi: folds 
marquinhosss: calls 250
burianjpb: checks 
*** FLOP *** [Tc 7s Kh]
marquinhosss: bets 500
burianjpb: calls 500
*** TURN *** [Tc 7s Kh] [Td]
marquinhosss: checks 
burianjpb: bets 865
marquinhosss: calls 865
*** RIVER *** [Tc 7s Kh Td] [6h]
marquinhosss: bets 3702
burianjpb: folds 
Uncalled bet (3702) returned to marquinhosss
marquinhosss collected 4355 from pot
marquinhosss: doesn't show hand 
*** SUMMARY ***
Total pot 4355 | Rake 0 
Board [Tc 7s Kh Td 6h]
Seat 1: assalbi (button) folded before Flop (didn't bet)
Seat 2: marquinhosss (small blind) collected (4355)
Seat 3: burianjpb (big blind) folded on the River
Seat 4: AkwasYT folded before Flop (didn't bet)
Seat 5: zioeddy2312 folded before Flop (didn't bet)

PokerStars Hand #251209588156: Tournament #3769361908, $52.38+$2.62 USD Hold'em No Limit - Level XI (250/500) - 2024/06/26 22:34:53 UTC [2024/06/26 18:34:53 ET]
Table '3769361908 5' 6-max Seat #2 is the button
Seat 1: assalbi (24742 in chips) is sitting out
Seat 2: marquinhosss (26861 in chips) 
Seat 3: burianjpb (8950 in chips) 
Seat 4: AkwasYT (26925 in chips) 
Seat 5: zioeddy2312 (13790 in chips) 
Seat 6: adrf1999 (10000 in chips) 
assalbi: posts the ante 125
marquinhosss: posts the ante 125
burianjpb: posts the ante 125
AkwasYT: posts the ante 125
zioeddy2312: posts the ante 125
adrf1999: posts the ante 125
burianjpb: posts small blind 250
AkwasYT: posts big blind 500
*** HOLE CARDS ***
zioeddy2312: folds 
adrf1999: raises 500 to 1000
assalbi: folds 
marquinhosss: folds 
burianjpb: calls 750
AkwasYT: calls 500
*** FLOP *** [4c Td Qc]
burianjpb: checks 
AkwasYT: checks 
adrf1999: bets 1000
burianjpb: calls 1000
AkwasYT: folds 
*** TURN *** [4c Td Qc] [Ks]
burianjpb: checks 
adrf1999: bets 2000
burianjpb: raises 4825 to 6825 and is all-in
adrf1999: calls 4825
*** RIVER *** [4c Td Qc Ks] [Qd]
*** SHOW DOWN ***
burianjpb: shows [Kd 9d] (two pair, Kings and Queens)
adrf1999: shows [4s 4d] (a full house, Fours full of Queens)
adrf1999 collected 19400 from pot
burianjpb finished the tournament
*** SUMMARY ***
Total pot 19400 | Rake 0 
Board [4c Td Qc Ks Qd]
Seat 1: assalbi folded before Flop (didn't bet)
Seat 2: marquinhosss (button) folded before Flop (didn't bet)
Seat 3: burianjpb (small blind) showed [Kd 9d] and lost with two pair, Kings and Queens
Seat 4: AkwasYT (big blind) folded on the Flop
Seat 5: zioeddy2312 folded before Flop (didn't bet)
Seat 6: adrf1999 showed [4s 4d] and won (19400) with a full house, Fours full of Queens

PokerStars Hand #251209607364: Tournament #3769361908, $52.38+$2.62 USD Hold'em No Limit - Level XII (300/600) - 2024/06/26 22:36:04 UTC [2024/06/26 18:36:04 ET]
Table '3769361908 5' 6-max Seat #4 is the button
Seat 1: assalbi (24617 in chips) is sitting out
Seat 2: marquinhosss (26736 in chips) 
Seat 4: AkwasYT (25800 in chips) 
Seat 5: zioeddy2312 (13665 in chips) 
Seat 6: adrf1999 (20450 in chips) 
assalbi: posts the ante 150
marquinhosss: posts the ante 150
AkwasYT: posts the ante 150
zioeddy2312: posts the ante 150
adrf1999: posts the ante 150
zioeddy2312: posts small blind 300
adrf1999: posts big blind 600
*** HOLE CARDS ***
assalbi: folds 
marquinhosss: folds 
AkwasYT: folds 
zioeddy2312: raises 1800 to 2400
adrf1999: raises 17900 to 20300 and is all-in
zioeddy2312: calls 11115 and is all-in
Uncalled bet (6785) returned to adrf1999
assalbi has returned
*** FLOP *** [As 7s Qh]
*** TURN *** [As 7s Qh] [Kd]
*** RIVER *** [As 7s Qh Kd] [6s]
*** SHOW DOWN ***
zioeddy2312: shows [Qd Ah] (two pair, Aces and Queens)
adrf1999: shows [Kh Jc] (a pair of Kings)
zioeddy2312 collected 27780 from pot
*** SUMMARY ***
Total pot 27780 | Rake 0 
Board [As 7s Qh Kd 6s]
Seat 1: assalbi folded before Flop (didn't bet)
Seat 2: marquinhosss folded before Flop (didn't bet)
Seat 4: AkwasYT (button) folded before Flop (didn't bet)
Seat 5: zioeddy2312 (small blind) showed [Qd Ah] and won (27780) with two pair, Aces and Queens
Seat 6: adrf1999 (big blind) showed [Kh Jc] and lost with a pair of Kings

PokerStars Hand #251209616827: Tournament #3769361908, $52.38+$2.62 USD Hold'em No Limit - Level XII (300/600) - 2024/06/26 22:36:40 UTC [2024/06/26 18:36:40 ET]
Table '3769361908 5' 6-max Seat #5 is the button
Seat 1: assalbi (24467 in chips) 
Seat 2: marquinhosss (26586 in chips) 
Seat 4: AkwasYT (25650 in chips) 
Seat 5: zioeddy2312 (27780 in chips) 
Seat 6: adrf1999 (6785 in chips) 
assalbi: posts the ante 150
marquinhosss: posts the ante 150
AkwasYT: posts the ante 150
zioeddy2312: posts the ante 150
adrf1999: posts the ante 150
adrf1999: posts small blind 300
assalbi: posts big blind 600
*** HOLE CARDS ***
marquinhosss: raises 600 to 1200
AkwasYT: folds 
zioeddy2312: folds 
adrf1999: folds 
assalbi: calls 600
*** FLOP *** [Jc 4d 9h]
assalbi: checks 
marquinhosss: bets 1139
assalbi: calls 1139
*** TURN *** [Jc 4d 9h] [8h]
assalbi: checks 
marquinhosss: bets 3780
assalbi: calls 3780
*** RIVER *** [Jc 4d 9h 8h] [6c]
assalbi: checks 
marquinhosss: checks 
*** SHOW DOWN ***
assalbi: shows [Td Kd] (high card King)
marquinhosss: shows [9d 8d] (two pair, Nines and Eights)
marquinhosss collected 13288 from pot
*** SUMMARY ***
Total pot 13288 | Rake 0 
Board [Jc 4d 9h 8h 6c]
Seat 1: assalbi (big blind) showed [Td Kd] and lost with high card King
Seat 2: marquinhosss showed [9d 8d] and won (13288) with two pair, Nines and Eights
Seat 4: AkwasYT folded before Flop (didn't bet)
Seat 5: zioeddy2312 (button) folded before Flop (didn't bet)
Seat 6: adrf1999 (small blind) folded before Flop

PokerStars Hand #251209629572: Tournament #3769361908, $52.38+$2.62 USD Hold'em No Limit - Level XII (300/600) - 2024/06/26 22:37:28 UTC [2024/06/26 18:37:28 ET]
Table '3769361908 5' 6-max Seat #6 is the button
Seat 1: assalbi (18198 in chips) 
Seat 2: marquinhosss (33605 in chips) 
Seat 3: Chuckster388 (10000 in chips) 
Seat 4: AkwasYT (25500 in chips) 
Seat 5: zioeddy2312 (27630 in chips) 
Seat 6: adrf1999 (6335 in chips) 
assalbi: posts the ante 150
marquinhosss: posts the ante 150
Chuckster388: posts the ante 150
AkwasYT: posts the ante 150
zioeddy2312: posts the ante 150
adrf1999: posts the ante 150
assalbi: posts small blind 300
marquinhosss: posts big blind 600
*** HOLE CARDS ***
Chuckster388: folds 
AkwasYT: raises 600 to 1200
zioeddy2312: folds 
adrf1999: folds 
assalbi: folds 
marquinhosss: calls 600
*** FLOP *** [As 7s 5s]
marquinhosss: checks 
AkwasYT: bets 1800
marquinhosss: raises 4500 to 6300
AkwasYT: folds [Kd Kc]
Uncalled bet (4500) returned to marquinhosss
marquinhosss collected 7200 from pot
marquinhosss: doesn't show hand 
*** SUMMARY ***
Total pot 7200 | Rake 0 
Board [As 7s 5s]
Seat 1: assalbi (small blind) folded before Flop
Seat 2: marquinhosss (big blind) collected (7200)
Seat 3: Chuckster388 folded before Flop (didn't bet)
Seat 4: AkwasYT folded on the Flop
Seat 5: zioeddy2312 folded before Flop (didn't bet)
Seat 6: adrf1999 (button) folded before Flop (didn't bet)

PokerStars Hand #251209646196: Tournament #3769361908, $52.38+$2.62 USD Hold'em No Limit - Level XIII (400/800) - 2024/06/26 22:38:30 UTC [2024/06/26 18:38:30 ET]
Table '3769361908 5' 6-max Seat #1 is the button
Seat 1: assalbi (17748 in chips) 
Seat 2: marquinhosss (37655 in chips) 
Seat 3: Chuckster388 (9850 in chips) 
Seat 4: AkwasYT (22350 in chips) 
Seat 5: zioeddy2312 (27480 in chips) 
Seat 6: adrf1999 (6185 in chips) 
assalbi: posts the ante 200
marquinhosss: posts the ante 200
Chuckster388: posts the ante 200
AkwasYT: posts the ante 200
zioeddy2312: posts the ante 200
adrf1999: posts the ante 200
marquinhosss: posts small blind 400
Chuckster388: posts big blind 800
*** HOLE CARDS ***
AkwasYT: folds 
zioeddy2312: raises 1600 to 2400
adrf1999: raises 3585 to 5985 and is all-in
assalbi: folds 
marquinhosss: calls 5585
Chuckster388: folds 
zioeddy2312: folds 
*** FLOP *** [Tc Kh Kc]
*** TURN *** [Tc Kh Kc] [Qc]
*** RIVER *** [Tc Kh Kc Qc] [8d]
*** SHOW DOWN ***
marquinhosss: shows [Ah Jd] (a straight, Ten to Ace)
adrf1999: shows [6c 6h] (two pair, Kings and Sixes)
marquinhosss collected 16370 from pot
adrf1999 finished the tournament
*** SUMMARY ***
Total pot 16370 | Rake 0 
Board [Tc Kh Kc Qc 8d]
Seat 1: assalbi (button) folded before Flop (didn't bet)
Seat 2: marquinhosss (small blind) showed [Ah Jd] and won (16370) with a straight, Ten to Ace
Seat 3: Chuckster388 (big blind) folded before Flop
Seat 4: AkwasYT folded before Flop (didn't bet)
Seat 5: zioeddy2312 folded before Flop
Seat 6: adrf1999 showed [6c 6h] and lost with two pair, Kings and Sixes

PokerStars Hand #251209655542: Tournament #3769361908, $52.38+$2.62 USD Hold'em No Limit - Level XIII (400/800) - 2024/06/26 22:39:05 UTC [2024/06/26 18:39:05 ET]
Table '3769361908 5' 6-max Seat #2 is the button
Seat 1: assalbi (17548 in chips) 
Seat 2: marquinhosss (47840 in chips) 
Seat 3: Chuckster388 (8850 in chips) 
Seat 4: AkwasYT (22150 in chips) 
Seat 5: zioeddy2312 (24880 in chips) 
assalbi: posts the ante 200
marquinhosss: posts the ante 200
Chuckster388: posts the ante 200
AkwasYT: posts the ante 200
zioeddy2312: posts the ante 200
Chuckster388: posts small blind 400
AkwasYT: posts big blind 800
*** HOLE CARDS ***
zioeddy2312: folds 
assalbi: raises 800 to 1600
marquinhosss: folds 
Chuckster388: folds 
AkwasYT: calls 800
*** FLOP *** [Qs Tc Kc]
AkwasYT: bets 2400
assalbi: calls 2400
*** TURN *** [Qs Tc Kc] [8s]
AkwasYT: checks 
assalbi: checks 
*** RIVER *** [Qs Tc Kc 8s] [4h]
AkwasYT: checks 
assalbi: checks 
*** SHOW DOWN ***
AkwasYT: shows [Ts 7c] (a pair of Tens)
assalbi: mucks hand 
AkwasYT collected 9400 from pot
*** SUMMARY ***
Total pot 9400 | Rake 0 
Board [Qs Tc Kc 8s 4h]
Seat 1: assalbi mucked
Seat 2: marquinhosss (button) folded before Flop (didn't bet)
Seat 3: Chuckster388 (small blind) folded before Flop
Seat 4: AkwasYT (big blind) showed [Ts 7c] and won (9400) with a pair of Tens
Seat 5: zioeddy2312 folded before Flop (didn't bet)

PokerStars Hand #251209668666: Tournament #3769361908, $52.38+$2.62 USD Hold'em No Limit - Level XIII (400/800) - 2024/06/26 22:39:54 UTC [2024/06/26 18:39:54 ET]
Table '3769361908 5' 6-max Seat #3 is the button
Seat 1: assalbi (13348 in chips) 
Seat 2: marquinhosss (47640 in chips) 
Seat 3: Chuckster388 (8250 in chips) 
Seat 4: AkwasYT (27350 in chips) 
Seat 5: zioeddy2312 (24680 in chips) 
Seat 6: sinister778 (34396 in chips) 
assalbi: posts the ante 200
marquinhosss: posts the ante 200
Chuckster388: posts the ante 200
AkwasYT: posts the ante 200
zioeddy2312: posts the ante 200
sinister778: posts the ante 200
AkwasYT: posts small blind 400
zioeddy2312: posts big blind 800
*** HOLE CARDS ***
sinister778: raises 800 to 1600
assalbi: folds 
marquinhosss: folds 
Chuckster388: folds 
AkwasYT: folds 
zioeddy2312: calls 800
*** FLOP *** [2c Ad Td]
zioeddy2312: checks 
sinister778: bets 2400
zioeddy2312: calls 2400
*** TURN *** [2c Ad Td] [Ks]
zioeddy2312: checks 
sinister778: bets 5600
zioeddy2312: calls 5600
*** RIVER *** [2c Ad Td Ks] [9c]
zioeddy2312: checks 
sinister778: bets 24596 and is all-in
zioeddy2312: folds 
Uncalled bet (24596) returned to sinister778
sinister778 collected 20800 from pot
*** SUMMARY ***
Total pot 20800 | Rake 0 
Board [2c Ad Td Ks 9c]
Seat 1: assalbi folded before Flop (didn't bet)
Seat 2: marquinhosss folded before Flop (didn't bet)
Seat 3: Chuckster388 (button) folded before Flop (didn't bet)
Seat 4: AkwasYT (small blind) folded before Flop
Seat 5: zioeddy2312 (big blind) folded on the River
Seat 6: sinister778 collected (20800)

PokerStars Hand #251209698479: Tournament #3769361908, $52.38+$2.62 USD Hold'em No Limit - Level XIV (500/1000) - 2024/06/26 22:41:48 UTC [2024/06/26 18:41:48 ET]
Table '3769361908 5' 6-max Seat #4 is the button
Seat 1: assalbi (13148 in chips) 
Seat 2: marquinhosss (47440 in chips) 
Seat 3: Chuckster388 (8050 in chips) 
Seat 4: AkwasYT (26750 in chips) 
Seat 5: zioeddy2312 (14880 in chips) 
Seat 6: sinister778 (45396 in chips) 
assalbi: posts the ante 250
marquinhosss: posts the ante 250
Chuckster388: posts the ante 250
AkwasYT: posts the ante 250
zioeddy2312: posts the ante 250
sinister778: posts the ante 250
zioeddy2312: posts small blind 500
sinister778: posts big blind 1000
*** HOLE CARDS ***
assalbi: folds 
marquinhosss: raises 1000 to 2000
Chuckster388: folds 
AkwasYT: folds 
zioeddy2312: folds 
sinister778: calls 1000
*** FLOP *** [Ad As 2c]
sinister778: checks 
marquinhosss: bets 1500
sinister778: folds 
Uncalled bet (1500) returned to marquinhosss
marquinhosss collected 6000 from pot
marquinhosss: doesn't show hand 
*** SUMMARY ***
Total pot 6000 | Rake 0 
Board [Ad As 2c]
Seat 1: assalbi folded before Flop (didn't bet)
Seat 2: marquinhosss collected (6000)
Seat 3: Chuckster388 folded before Flop (didn't bet)
Seat 4: AkwasYT (button) folded before Flop (didn't bet)
Seat 5: zioeddy2312 (small blind) folded before Flop
Seat 6: sinister778 (big blind) folded on the Flop

PokerStars Hand #251209712105: Tournament #3769361908, $52.38+$2.62 USD Hold'em No Limit - Level XIV (500/1000) - 2024/06/26 22:42:41 UTC [2024/06/26 18:42:41 ET]
Table '3769361908 5' 6-max Seat #5 is the button
Seat 1: assalbi (12898 in chips) 
Seat 2: marquinhosss (51190 in chips) 
Seat 3: Chuckster388 (7800 in chips) 
Seat 4: AkwasYT (26500 in chips) 
Seat 5: zioeddy2312 (14130 in chips) 
Seat 6: sinister778 (43146 in chips) 
assalbi: posts the ante 250
marquinhosss: posts the ante 250
Chuckster388: posts the ante 250
AkwasYT: posts the ante 250
zioeddy2312: posts the ante 250
sinister778: posts the ante 250
sinister778: posts small blind 500
assalbi: posts big blind 1000
*** HOLE CARDS ***
marquinhosss: folds 
Chuckster388: folds 
AkwasYT: raises 1000 to 2000
zioeddy2312: folds 
sinister778: folds 
assalbi: calls 1000
*** FLOP *** [4d 9c As]
assalbi: checks 
AkwasYT: bets 2000
assalbi: folds 
Uncalled bet (2000) returned to AkwasYT
AkwasYT collected 6000 from pot
AkwasYT: doesn't show hand 
*** SUMMARY ***
Total pot 6000 | Rake 0 
Board [4d 9c As]
Seat 1: assalbi (big blind) folded on the Flop
Seat 2: marquinhosss folded before Flop (didn't bet)
Seat 3: Chuckster388 folded before Flop (didn't bet)
Seat 4: AkwasYT collected (6000)
Seat 5: zioeddy2312 (button) folded before Flop (didn't bet)
Seat 6: sinister778 (small blind) folded before Flop

PokerStars Hand #251209721496: Tournament #3769361908, $52.38+$2.62 USD Hold'em No Limit - Level XIV (500/1000) - 2024/06/26 22:43:18 UTC [2024/06/26 18:43:18 ET]
Table '3769361908 5' 6-max Seat #6 is the button
Seat 1: assalbi (10648 in chips) 
Seat 2: marquinhosss (50940 in chips) 
Seat 3: Chuckster388 (7550 in chips) 
Seat 4: AkwasYT (30250 in chips) 
Seat 5: zioeddy2312 (13880 in chips) 
Seat 6: sinister778 (42396 in chips) 
assalbi: posts the ante 250
marquinhosss: posts the ante 250
Chuckster388: posts the ante 250
AkwasYT: posts the ante 250
zioeddy2312: posts the ante 250
sinister778: posts the ante 250
assalbi: posts small blind 500
marquinhosss: posts big blind 1000
*** HOLE CARDS ***
Chuckster388: folds 
AkwasYT: folds 
zioeddy2312: folds 
sinister778: raises 1000 to 2000
assalbi: folds 
marquinhosss: calls 1000
*** FLOP *** [6s Kh 8d]
marquinhosss: checks 
sinister778: bets 2500
marquinhosss: folds 
Uncalled bet (2500) returned to sinister778
sinister778 collected 6000 from pot
*** SUMMARY ***
Total pot 6000 | Rake 0 
Board [6s Kh 8d]
Seat 1: assalbi (small blind) folded before Flop
Seat 2: marquinhosss (big blind) folded on the Flop
Seat 3: Chuckster388 folded before Flop (didn't bet)
Seat 4: AkwasYT folded before Flop (didn't bet)
Seat 5: zioeddy2312 folded before Flop (didn't bet)
Seat 6: sinister778 (button) collected (6000)

PokerStars Hand #251209736206: Tournament #3769361908, $52.38+$2.62 USD Hold'em No Limit - Level XV (600/1200) - 2024/06/26 22:44:15 UTC [2024/06/26 18:44:15 ET]
Table '3769361908 5' 6-max Seat #1 is the button
Seat 1: assalbi (9898 in chips) 
Seat 2: marquinhosss (48690 in chips) 
Seat 3: Chuckster388 (7300 in chips) 
Seat 4: AkwasYT (30000 in chips) 
Seat 5: zioeddy2312 (13630 in chips) 
Seat 6: sinister778 (46146 in chips) 
assalbi: posts the ante 300
marquinhosss: posts the ante 300
Chuckster388: posts the ante 300
AkwasYT: posts the ante 300
zioeddy2312: posts the ante 300
sinister778: posts the ante 300
marquinhosss: posts small blind 600
Chuckster388: posts big blind 1200
*** HOLE CARDS ***
AkwasYT: raises 2400 to 3600
zioeddy2312: folds 
sinister778: folds 
assalbi: folds 
marquinhosss: folds 
Chuckster388: calls 2400
*** FLOP *** [Kh 9s 6c]
Chuckster388: bets 3400 and is all-in
AkwasYT: calls 3400
*** TURN *** [Kh 9s 6c] [5s]
*** RIVER *** [Kh 9s 6c 5s] [2s]
*** SHOW DOWN ***
Chuckster388: shows [6h Ah] (a pair of Sixes)
AkwasYT: shows [Qc As] (high card Ace)
Chuckster388 collected 16400 from pot
*** SUMMARY ***
Total pot 16400 | Rake 0 
Board [Kh 9s 6c 5s 2s]
Seat 1: assalbi (button) folded before Flop (didn't bet)
Seat 2: marquinhosss (small blind) folded before Flop
Seat 3: Chuckster388 (big blind) showed [6h Ah] and won (16400) with a pair of Sixes
Seat 4: AkwasYT showed [Qc As] and lost with high card Ace
Seat 5: zioeddy2312 folded before Flop (didn't bet)
Seat 6: sinister778 folded before Flop (didn't bet)

PokerStars Hand #251209747343: Tournament #3769361908, $52.38+$2.62 USD Hold'em No Limit - Level XV (600/1200) - 2024/06/26 22:44:58 UTC [2024/06/26 18:44:58 ET]
Table '3769361908 5' 6-max Seat #2 is the button
Seat 1: assalbi (9598 in chips) 
Seat 2: marquinhosss (47790 in chips) 
Seat 3: Chuckster388 (16400 in chips) 
Seat 4: AkwasYT (22700 in chips) 
Seat 5: zioeddy2312 (13330 in chips) 
Seat 6: sinister778 (45846 in chips) 
assalbi: posts the ante 300
marquinhosss: posts the ante 300
Chuckster388: posts the ante 300
AkwasYT: posts the ante 300
zioeddy2312: posts the ante 300
sinister778: posts the ante 300
Chuckster388: posts small blind 600
AkwasYT: posts big blind 1200
*** HOLE CARDS ***
zioeddy2312: raises 11830 to 13030 and is all-in
sinister778: folds 
assalbi: folds 
marquinhosss: folds 
Chuckster388: folds 
AkwasYT: folds 
Uncalled bet (11830) returned to zioeddy2312
zioeddy2312 collected 4800 from pot
*** SUMMARY ***
Total pot 4800 | Rake 0 
Seat 1: assalbi folded before Flop (didn't bet)
Seat 2: marquinhosss (button) folded before Flop (didn't bet)
Seat 3: Chuckster388 (small blind) folded before Flop
Seat 4: AkwasYT (big blind) folded before Flop
Seat 5: zioeddy2312 collected (4800)
Seat 6: sinister778 folded before Flop (didn't bet)

PokerStars Hand #251209751443: Tournament #3769361908, $52.38+$2.62 USD Hold'em No Limit - Level XV (600/1200) - 2024/06/26 22:45:14 UTC [2024/06/26 18:45:14 ET]
Table '3769361908 5' 6-max Seat #3 is the button
Seat 1: assalbi (9298 in chips) 
Seat 2: marquinhosss (47490 in chips) 
Seat 3: Chuckster388 (15500 in chips) 
Seat 4: AkwasYT (21200 in chips) 
Seat 5: zioeddy2312 (16630 in chips) 
Seat 6: sinister778 (45546 in chips) 
assalbi: posts the ante 300
marquinhosss: posts the ante 300
Chuckster388: posts the ante 300
AkwasYT: posts the ante 300
zioeddy2312: posts the ante 300
sinister778: posts the ante 300
AkwasYT: posts small blind 600
zioeddy2312: posts big blind 1200
*** HOLE CARDS ***
sinister778: raises 1200 to 2400
assalbi: raises 6598 to 8998 and is all-in
marquinhosss: folds 
Chuckster388: folds 
AkwasYT: raises 11902 to 20900 and is all-in
zioeddy2312: folds 
sinister778: calls 18500
*** FLOP *** [Js 2c Jh]
*** TURN *** [Js 2c Jh] [8h]
*** RIVER *** [Js 2c Jh 8h] [7d]
*** SHOW DOWN ***
AkwasYT: shows [Qd Td] (a pair of Jacks)
sinister778: shows [Ah Kh] (a pair of Jacks - Ace kicker)
sinister778 collected 23804 from side pot
assalbi: shows [Ts Ac] (a pair of Jacks - lower kicker)
sinister778 collected 29994 from main pot
AkwasYT finished the tournament
assalbi finished the tournament
IgorHKR is disconnected 
*** SUMMARY ***
Total pot 53798 Main pot 29994. Side pot 23804. | Rake 0 
Board [Js 2c Jh 8h 7d]
Seat 1: assalbi showed [Ts Ac] and lost with a pair of Jacks
Seat 2: marquinhosss folded before Flop (didn't bet)
Seat 3: Chuckster388 (button) folded before Flop (didn't bet)
Seat 4: AkwasYT (small blind) showed [Qd Td] and lost with a pair of Jacks
Seat 5: zioeddy2312 (big blind) folded before Flop
Seat 6: sinister778 showed [Ah Kh] and won (53798) with a pair of Jacks

PokerStars Hand #251209760768: Tournament #3769361908, $52.38+$2.62 USD Hold'em No Limit - Level XV (600/1200) - 2024/06/26 22:45:50 UTC [2024/06/26 18:45:50 ET]
Table '3769361908 5' 6-max Seat #5 is the button
Seat 1: IgorHKR (10000 in chips) 
Seat 2: marquinhosss (47190 in chips) 
Seat 3: Chuckster388 (15200 in chips) 
Seat 5: zioeddy2312 (15130 in chips) 
Seat 6: sinister778 (78144 in chips) 
IgorHKR: posts the ante 300
marquinhosss: posts the ante 300
Chuckster388: posts the ante 300
zioeddy2312: posts the ante 300
sinister778: posts the ante 300
sinister778: posts small blind 600
IgorHKR: posts big blind 1200
*** HOLE CARDS ***
marquinhosss: folds 
Chuckster388: raises 13700 to 14900 and is all-in
zioeddy2312: folds 
sinister778: folds 
IgorHKR: folds 
Uncalled bet (13700) returned to Chuckster388
Chuckster388 collected 4500 from pot
Chuckster388: doesn't show hand 
*** SUMMARY ***
Total pot 4500 | Rake 0 
Seat 1: IgorHKR (big blind) folded before Flop
Seat 2: marquinhosss folded before Flop (didn't bet)
Seat 3: Chuckster388 collected (4500)
Seat 5: zioeddy2312 (button) folded before Flop (didn't bet)
Seat 6: sinister778 (small blind) folded before Flop

PokerStars Hand #251209764897: Tournament #3769361908, $52.38+$2.62 USD Hold'em No Limit - Level XV (600/1200) - 2024/06/26 22:46:06 UTC [2024/06/26 18:46:06 ET]
Table '3769361908 5' 6-max Seat #6 is the button
Seat 1: IgorHKR (8500 in chips) 
Seat 2: marquinhosss (46890 in chips) 
Seat 3: Chuckster388 (18200 in chips) 
Seat 5: zioeddy2312 (14830 in chips) 
Seat 6: sinister778 (77244 in chips) 
IgorHKR: posts the ante 300
marquinhosss: posts the ante 300
Chuckster388: posts the ante 300
zioeddy2312: posts the ante 300
sinister778: posts the ante 300
IgorHKR: posts small blind 600
marquinhosss: posts big blind 1200
*** HOLE CARDS ***
Theo7171 is disconnected 
Chuckster388: raises 1320 to 2520
zioeddy2312: folds 
sinister778: folds 
IgorHKR: folds 
marquinhosss: folds 
Uncalled bet (1320) returned to Chuckster388
Chuckster388 collected 4500 from pot
Chuckster388: doesn't show hand 
*** SUMMARY ***
Total pot 4500 | Rake 0 
Seat 1: IgorHKR (small blind) folded before Flop
Seat 2: marquinhosss (big blind) folded before Flop
Seat 3: Chuckster388 collected (4500)
Seat 5: zioeddy2312 folded before Flop (didn't bet)
Seat 6: sinister778 (button) folded before Flop (didn't bet)

PokerStars Hand #251209770205: Tournament #3769361908, $52.38+$2.62 USD Hold'em No Limit - Level XV (600/1200) - 2024/06/26 22:46:27 UTC [2024/06/26 18:46:27 ET]
Table '3769361908 5' 6-max Seat #1 is the button
Seat 1: IgorHKR (7600 in chips) 
Seat 2: marquinhosss (45390 in chips) 
Seat 3: Chuckster388 (21200 in chips) 
Seat 4: Theo7171 (10000 in chips) 
Seat 5: zioeddy2312 (14530 in chips) 
Seat 6: sinister778 (76944 in chips) 
IgorHKR: posts the ante 300
marquinhosss: posts the ante 300
Chuckster388: posts the ante 300
Theo7171: posts the ante 300
zioeddy2312: posts the ante 300
sinister778: posts the ante 300
marquinhosss: posts small blind 600
Chuckster388: posts big blind 1200
*** HOLE CARDS ***
Theo7171: folds 
zioeddy2312: folds 
sinister778: folds 
IgorHKR: folds 
marquinhosss: raises 43890 to 45090 and is all-in
Chuckster388: folds 
Uncalled bet (43890) returned to marquinhosss
marquinhosss collected 4200 from pot
marquinhosss: doesn't show hand 
*** SUMMARY ***
Total pot 4200 | Rake 0 
Seat 1: IgorHKR (button) folded before Flop (didn't bet)
Seat 2: marquinhosss (small blind) collected (4200)
Seat 3: Chuckster388 (big blind) folded before Flop
Seat 4: Theo7171 folded before Flop (didn't bet)
Seat 5: zioeddy2312 folded before Flop (didn't bet)
Seat 6: sinister778 folded before Flop (didn't bet)

PokerStars Hand #251209775738: Tournament #3769361908, $52.38+$2.62 USD Hold'em No Limit - Level XV (600/1200) - 2024/06/26 22:46:49 UTC [2024/06/26 18:46:49 ET]
Table '3769361908 5' 6-max Seat #2 is the button
Seat 1: IgorHKR (7300 in chips) 
Seat 2: marquinhosss (48090 in chips) 
Seat 3: Chuckster388 (19700 in chips) 
Seat 4: Theo7171 (9700 in chips) 
Seat 5: zioeddy2312 (14230 in chips) 
Seat 6: sinister778 (76644 in chips) 
IgorHKR: posts the ante 300
marquinhosss: posts the ante 300
Chuckster388: posts the ante 300
Theo7171: posts the ante 300
zioeddy2312: posts the ante 300
sinister778: posts the ante 300
Chuckster388: posts small blind 600
Theo7171: posts big blind 1200
*** HOLE CARDS ***
zioeddy2312: folds 
sinister778: raises 1800 to 3000
IgorHKR: folds 
marquinhosss: folds 
Chuckster388: folds 
Theo7171: calls 1800
*** FLOP *** [9d 8s Ks]
Theo7171: bets 6400 and is all-in
sinister778: calls 6400
*** TURN *** [9d 8s Ks] [5s]
*** RIVER *** [9d 8s Ks 5s] [Tc]
*** SHOW DOWN ***
Theo7171: shows [Th Jd] (a pair of Tens)
sinister778: shows [Ts As] (a flush, Ace high)
sinister778 collected 21200 from pot
Theo7171 finished the tournament
*** SUMMARY ***
Total pot 21200 | Rake 0 
Board [9d 8s Ks 5s Tc]
Seat 1: IgorHKR folded before Flop (didn't bet)
Seat 2: marquinhosss (button) folded before Flop (didn't bet)
Seat 3: Chuckster388 (small blind) folded before Flop
Seat 4: Theo7171 (big blind) showed [Th Jd] and lost with a pair of Tens
Seat 5: zioeddy2312 folded before Flop (didn't bet)
Seat 6: sinister778 showed [Ts As] and won (21200) with a flush, Ace high

PokerStars Hand #251209784941: Tournament #3769361908, $52.38+$2.62 USD Hold'em No Limit - Level XVI (800/1600) - 2024/06/26 22:47:25 UTC [2024/06/26 18:47:25 ET]
Table '3769361908 5' 6-max Seat #3 is the button
Seat 1: IgorHKR (7000 in chips) 
Seat 2: marquinhosss (47790 in chips) 
Seat 3: Chuckster388 (18800 in chips) 
Seat 5: zioeddy2312 (13930 in chips) 
Seat 6: sinister778 (88144 in chips) 
IgorHKR: posts the ante 400
marquinhosss: posts the ante 400
Chuckster388: posts the ante 400
zioeddy2312: posts the ante 400
sinister778: posts the ante 400
zioeddy2312: posts small blind 800
sinister778: posts big blind 1600
*** HOLE CARDS ***
IgorHKR: raises 5000 to 6600 and is all-in
marquinhosss: folds 
Chuckster388: raises 11800 to 18400 and is all-in
zioeddy2312: folds 
sinister778: folds 
Uncalled bet (11800) returned to Chuckster388
*** FLOP *** [9s Jh 6d]
*** TURN *** [9s Jh 6d] [2s]
*** RIVER *** [9s Jh 6d 2s] [3d]
*** SHOW DOWN ***
IgorHKR: shows [8h 8d] (a pair of Eights)
Chuckster388: shows [Kc 9d] (a pair of Nines)
Chuckster388 collected 17600 from pot
IgorHKR finished the tournament
$ubuta1 is disconnected 
*** SUMMARY ***
Total pot 17600 | Rake 0 
Board [9s Jh 6d 2s 3d]
Seat 1: IgorHKR showed [8h 8d] and lost with a pair of Eights
Seat 2: marquinhosss folded before Flop (didn't bet)
Seat 3: Chuckster388 (button) showed [Kc 9d] and won (17600) with a pair of Nines
Seat 5: zioeddy2312 (small blind) folded before Flop
Seat 6: sinister778 (big blind) folded before Flop

PokerStars Hand #251209794496: Tournament #3769361908, $52.38+$2.62 USD Hold'em No Limit - Level XVI (800/1600) - 2024/06/26 22:48:03 UTC [2024/06/26 18:48:03 ET]
Table '3769361908 5' 6-max Seat #5 is the button
Seat 2: marquinhosss (47390 in chips) 
Seat 3: Chuckster388 (29400 in chips) 
Seat 4: $ubuta1 (19448 in chips) 
Seat 5: zioeddy2312 (12730 in chips) 
Seat 6: sinister778 (86144 in chips) 
marquinhosss: posts the ante 400
Chuckster388: posts the ante 400
$ubuta1: posts the ante 400
zioeddy2312: posts the ante 400
sinister778: posts the ante 400
sinister778: posts small blind 800
marquinhosss: posts big blind 1600
*** HOLE CARDS ***
Chuckster388: folds 
$ubuta1: folds 
zioeddy2312: folds 
DeathBrain09 is disconnected 
sinister778: calls 800
marquinhosss: checks 
*** FLOP *** [2d 7h 3s]
sinister778: bets 3200
marquinhosss: raises 8000 to 11200
sinister778: folds 
Uncalled bet (8000) returned to marquinhosss
marquinhosss collected 11600 from pot
marquinhosss: doesn't show hand 
*** SUMMARY ***
Total pot 11600 | Rake 0 
Board [2d 7h 3s]
Seat 2: marquinhosss (big blind) collected (11600)
Seat 3: Chuckster388 folded before Flop (didn't bet)
Seat 4: $ubuta1 folded before Flop (didn't bet)
Seat 5: zioeddy2312 (button) folded before Flop (didn't bet)
Seat 6: sinister778 (small blind) folded on the Flop

PokerStars Hand #251209805603: Tournament #3769361908, $52.38+$2.62 USD Hold'em No Limit - Level XVI (800/1600) - 2024/06/26 22:48:46 UTC [2024/06/26 18:48:46 ET]
Table '3769361908 5' 6-max Seat #6 is the button
Seat 1: DeathBrain09 (28700 in chips) out of hand (moved from another table into small blind)
Seat 2: marquinhosss (53790 in chips) 
Seat 3: Chuckster388 (29000 in chips) 
Seat 4: $ubuta1 (19048 in chips) 
Seat 5: zioeddy2312 (12330 in chips) 
Seat 6: sinister778 (80944 in chips) 
DeathBrain09 will be allowed to play after the button
marquinhosss: posts the ante 400
Chuckster388: posts the ante 400
$ubuta1: posts the ante 400
zioeddy2312: posts the ante 400
sinister778: posts the ante 400
marquinhosss: posts small blind 800
Chuckster388: posts big blind 1600
*** HOLE CARDS ***
$ubuta1: folds 
zioeddy2312: raises 10330 to 11930 and is all-in
sinister778: folds 
marquinhosss: folds 
Chuckster388: calls 10330
*** FLOP *** [As 7d 7h]
*** TURN *** [As 7d 7h] [4h]
*** RIVER *** [As 7d 7h 4h] [Qh]
*** SHOW DOWN ***
Chuckster388: shows [2s Ac] (two pair, Aces and Sevens)
zioeddy2312: shows [6d Ad] (two pair, Aces and Sevens)
Chuckster388 collected 13330 from pot
zioeddy2312 collected 13330 from pot
*** SUMMARY ***
Total pot 26660 | Rake 0 
Board [As 7d 7h 4h Qh]
Seat 2: marquinhosss (small blind) folded before Flop
Seat 3: Chuckster388 (big blind) showed [2s Ac] and won (13330) with two pair, Aces and Sevens
Seat 4: $ubuta1 folded before Flop (didn't bet)
Seat 5: zioeddy2312 showed [6d Ad] and won (13330) with two pair, Aces and Sevens
Seat 6: sinister778 (button) folded before Flop (didn't bet)

PokerStars Hand #251209813181: Tournament #3769361908, $52.38+$2.62 USD Hold'em No Limit - Level XVI (800/1600) - 2024/06/26 22:49:17 UTC [2024/06/26 18:49:17 ET]
Table '3769361908 5' 6-max Seat #2 is the button
Seat 1: DeathBrain09 (28700 in chips) 
Seat 2: marquinhosss (52590 in chips) 
Seat 3: Chuckster388 (30000 in chips) 
Seat 4: $ubuta1 (18648 in chips) 
Seat 5: zioeddy2312 (13330 in chips) 
Seat 6: sinister778 (80544 in chips) 
DeathBrain09: posts the ante 400
marquinhosss: posts the ante 400
Chuckster388: posts the ante 400
$ubuta1: posts the ante 400
zioeddy2312: posts the ante 400
sinister778: posts the ante 400
Chuckster388: posts small blind 800
$ubuta1: posts big blind 1600
*** HOLE CARDS ***
zioeddy2312: raises 11330 to 12930 and is all-in
sinister778: calls 12930
DeathBrain09: folds 
marquinhosss: folds 
Chuckster388: folds 
$ubuta1: folds 
*** FLOP *** [4d 6s Jd]
*** TURN *** [4d 6s Jd] [7s]
*** RIVER *** [4d 6s Jd 7s] [7c]
*** SHOW DOWN ***
zioeddy2312: shows [9d Ah] (a pair of Sevens)
sinister778: shows [Kd Jh] (two pair, Jacks and Sevens)
sinister778 collected 30660 from pot
zioeddy2312 finished the tournament in 116th place
*** SUMMARY ***
Total pot 30660 | Rake 0 
Board [4d 6s Jd 7s 7c]
Seat 1: DeathBrain09 folded before Flop (didn't bet)
Seat 2: marquinhosss (button) folded before Flop (didn't bet)
Seat 3: Chuckster388 (small blind) folded before Flop
Seat 4: $ubuta1 (big blind) folded before Flop
Seat 5: zioeddy2312 showed [9d Ah] and lost with a pair of Sevens
Seat 6: sinister778 showed [Kd Jh] and won (30660) with two pair, Jacks and Sevens

PokerStars Hand #251209820827: Tournament #3769361908, $52.38+$2.62 USD Hold'em No Limit - Level XVI (800/1600) - 2024/06/26 22:49:48 UTC [2024/06/26 18:49:48 ET]
Table '3769361908 5' 6-max Seat #3 is the button
Seat 1: DeathBrain09 (28300 in chips) 
Seat 2: marquinhosss (52190 in chips) 
Seat 3: Chuckster388 (28800 in chips) 
Seat 4: $ubuta1 (16648 in chips) 
Seat 6: sinister778 (97874 in chips) 
DeathBrain09: posts the ante 400
marquinhosss: posts the ante 400
Chuckster388: posts the ante 400
$ubuta1: posts the ante 400
sinister778: posts the ante 400
$ubuta1: posts small blind 800
sinister778: posts big blind 1600
*** HOLE CARDS ***
DeathBrain09: folds 
marquinhosss: folds 
Chuckster388: folds 
$ubuta1: raises 14648 to 16248 and is all-in
sinister778: calls 14648
*** FLOP *** [9h 6c 2h]
*** TURN *** [9h 6c 2h] [9s]
*** RIVER *** [9h 6c 2h 9s] [Kh]
*** SHOW DOWN ***
$ubuta1: shows [6s Ad] (two pair, Nines and Sixes)
sinister778: shows [4c Kd] (two pair, Kings and Nines)
sinister778 collected 34496 from pot
$ubuta1 finished the tournament in 110th place
*** SUMMARY ***
Total pot 34496 | Rake 0 
Board [9h 6c 2h 9s Kh]
Seat 1: DeathBrain09 folded before Flop (didn't bet)
Seat 2: marquinhosss folded before Flop (didn't bet)
Seat 3: Chuckster388 (button) folded before Flop (didn't bet)
Seat 4: $ubuta1 (small blind) showed [6s Ad] and lost with two pair, Nines and Sixes
Seat 6: sinister778 (big blind) showed [4c Kd] and won (34496) with two pair, Kings and Nines

PokerStars Hand #251209830105: Tournament #3769361908, $52.38+$2.62 USD Hold'em No Limit - Level XVII (1000/2000) - 2024/06/26 22:50:25 UTC [2024/06/26 18:50:25 ET]
Table '3769361908 5' 6-max Seat #6 is the button
Seat 1: DeathBrain09 (27900 in chips) 
Seat 2: marquinhosss (51790 in chips) 
Seat 3: Chuckster388 (28400 in chips) 
Seat 4: xxxppp (33800 in chips) 
Seat 5: SicKTHPS (62577 in chips) 
Seat 6: sinister778 (115722 in chips) 
DeathBrain09: posts the ante 500
marquinhosss: posts the ante 500
Chuckster388: posts the ante 500
xxxppp: posts the ante 500
SicKTHPS: posts the ante 500
sinister778: posts the ante 500
DeathBrain09: posts small blind 1000
marquinhosss: posts big blind 2000
*** HOLE CARDS ***
Chuckster388: folds 
xxxppp: folds 
SicKTHPS: raises 2000 to 4000
sinister778: calls 4000
DeathBrain09: folds 
marquinhosss: raises 47290 to 51290 and is all-in
SicKTHPS: folds 
sinister778: folds 
Uncalled bet (47290) returned to marquinhosss
marquinhosss collected 16000 from pot
marquinhosss: doesn't show hand 
*** SUMMARY ***
Total pot 16000 | Rake 0 
Seat 1: DeathBrain09 (small blind) folded before Flop
Seat 2: marquinhosss (big blind) collected (16000)
Seat 3: Chuckster388 folded before Flop (didn't bet)
Seat 4: xxxppp folded before Flop (didn't bet)
Seat 5: SicKTHPS folded before Flop
Seat 6: sinister778 (button) folded before Flop

PokerStars Hand #251209840285: Tournament #3769361908, $52.38+$2.62 USD Hold'em No Limit - Level XVII (1000/2000) - 2024/06/26 22:51:08 UTC [2024/06/26 18:51:08 ET]
Table '3769361908 5' 6-max Seat #1 is the button
Seat 1: DeathBrain09 (26400 in chips) 
Seat 2: marquinhosss (63290 in chips) 
Seat 3: Chuckster388 (27900 in chips) 
Seat 4: xxxppp (33300 in chips) 
Seat 5: SicKTHPS (58077 in chips) 
Seat 6: sinister778 (111222 in chips) 
DeathBrain09: posts the ante 500
marquinhosss: posts the ante 500
Chuckster388: posts the ante 500
xxxppp: posts the ante 500
SicKTHPS: posts the ante 500
sinister778: posts the ante 500
marquinhosss: posts small blind 1000
Chuckster388: posts big blind 2000
*** HOLE CARDS ***
xxxppp: raises 2000 to 4000
SicKTHPS: folds 
sinister778: folds 
DeathBrain09: folds 
marquinhosss: folds 
Chuckster388: calls 2000
*** FLOP *** [5d 7d Qh]
Chuckster388: checks 
xxxppp: bets 4000
Chuckster388: calls 4000
*** TURN *** [5d 7d Qh] [9c]
Chuckster388: checks 
xxxppp: checks 
*** RIVER *** [5d 7d Qh 9c] [5s]
Chuckster388: bets 6000
xxxppp: calls 6000
*** SHOW DOWN ***
Chuckster388: shows [3c Qc] (two pair, Queens and Fives)
xxxppp: mucks hand 
Chuckster388 collected 32000 from pot
*** SUMMARY ***
Total pot 32000 | Rake 0 
Board [5d 7d Qh 9c 5s]
Seat 1: DeathBrain09 (button) folded before Flop (didn't bet)
Seat 2: marquinhosss (small blind) folded before Flop
Seat 3: Chuckster388 (big blind) showed [3c Qc] and won (32000) with two pair, Queens and Fives
Seat 4: xxxppp mucked
Seat 5: SicKTHPS folded before Flop (didn't bet)
Seat 6: sinister778 folded before Flop (didn't bet)

PokerStars Hand #251209848835: Tournament #3769361908, $52.38+$2.62 USD Hold'em No Limit - Level XVII (1000/2000) - 2024/06/26 22:51:42 UTC [2024/06/26 18:51:42 ET]
Table '3769361908 5' 6-max Seat #2 is the button
Seat 1: DeathBrain09 (25900 in chips) 
Seat 2: marquinhosss (61790 in chips) 
Seat 3: Chuckster388 (45400 in chips) 
Seat 4: xxxppp (18800 in chips) 
Seat 5: SicKTHPS (57577 in chips) 
Seat 6: sinister778 (110722 in chips) 
DeathBrain09: posts the ante 500
marquinhosss: posts the ante 500
Chuckster388: posts the ante 500
xxxppp: posts the ante 500
SicKTHPS: posts the ante 500
sinister778: posts the ante 500
Chuckster388: posts small blind 1000
xxxppp: posts big blind 2000
*** HOLE CARDS ***
SicKTHPS: folds 
sinister778: folds 
DeathBrain09: folds 
marquinhosss: raises 2000 to 4000
Chuckster388: folds 
xxxppp: calls 2000
*** FLOP *** [8d 5h Kc]
xxxppp: checks 
marquinhosss: bets 2000
xxxppp: folds 
Uncalled bet (2000) returned to marquinhosss
marquinhosss collected 12000 from pot
marquinhosss: doesn't show hand 
*** SUMMARY ***
Total pot 12000 | Rake 0 
Board [8d 5h Kc]
Seat 1: DeathBrain09 folded before Flop (didn't bet)
Seat 2: marquinhosss (button) collected (12000)
Seat 3: Chuckster388 (small blind) folded before Flop
Seat 4: xxxppp (big blind) folded on the Flop
Seat 5: SicKTHPS folded before Flop (didn't bet)
Seat 6: sinister778 folded before Flop (didn't bet)

PokerStars Hand #251209854597: Tournament #3769361908, $52.38+$2.62 USD Hold'em No Limit - Level XVII (1000/2000) - 2024/06/26 22:52:06 UTC [2024/06/26 18:52:06 ET]
Table '3769361908 5' 6-max Seat #3 is the button
Seat 1: DeathBrain09 (25400 in chips) 
Seat 2: marquinhosss (69290 in chips) 
Seat 3: Chuckster388 (43900 in chips) 
Seat 4: xxxppp (14300 in chips) 
Seat 5: SicKTHPS (57077 in chips) 
Seat 6: sinister778 (110222 in chips) 
DeathBrain09: posts the ante 500
marquinhosss: posts the ante 500
Chuckster388: posts the ante 500
xxxppp: posts the ante 500
SicKTHPS: posts the ante 500
sinister778: posts the ante 500
xxxppp: posts small blind 1000
SicKTHPS: posts big blind 2000
*** HOLE CARDS ***
sinister778: folds 
DeathBrain09: folds 
marquinhosss: raises 2000 to 4000
Chuckster388: folds 
xxxppp: calls 3000
SicKTHPS: folds 
*** FLOP *** [Js 8d 2h]
xxxppp: bets 9800 and is all-in
marquinhosss: calls 9800
*** TURN *** [Js 8d 2h] [Th]
*** RIVER *** [Js 8d 2h Th] [6s]
*** SHOW DOWN ***
xxxppp: shows [Ks 4s] (high card King)
marquinhosss: shows [Tc Kh] (a pair of Tens)
marquinhosss collected 32600 from pot
xxxppp finished the tournament in 93rd place
*** SUMMARY ***
Total pot 32600 | Rake 0 
Board [Js 8d 2h Th 6s]
Seat 1: DeathBrain09 folded before Flop (didn't bet)
Seat 2: marquinhosss showed [Tc Kh] and won (32600) with a pair of Tens
Seat 3: Chuckster388 (button) folded before Flop (didn't bet)
Seat 4: xxxppp (small blind) showed [Ks 4s] and lost with high card King
Seat 5: SicKTHPS (big blind) folded before Flop
Seat 6: sinister778 folded before Flop (didn't bet)

PokerStars Hand #251209862488: Tournament #3769361908, $52.38+$2.62 USD Hold'em No Limit - Level XVII (1000/2000) - 2024/06/26 22:52:38 UTC [2024/06/26 18:52:38 ET]
Table '3769361908 5' 6-max Seat #5 is the button
Seat 1: DeathBrain09 (24900 in chips) 
Seat 2: marquinhosss (87590 in chips) 
Seat 3: Chuckster388 (43400 in chips) 
Seat 5: SicKTHPS (54577 in chips) 
Seat 6: sinister778 (109722 in chips) 
DeathBrain09: posts the ante 500
marquinhosss: posts the ante 500
Chuckster388: posts the ante 500
SicKTHPS: posts the ante 500
sinister778: posts the ante 500
sinister778: posts small blind 1000
DeathBrain09: posts big blind 2000
*** HOLE CARDS ***
marquinhosss: folds 
Chuckster388: raises 2000 to 4000
SicKTHPS: folds 
sinister778: folds 
DeathBrain09: calls 2000
*** FLOP *** [8d 2h 9d]
DeathBrain09: checks 
Chuckster388: checks 
*** TURN *** [8d 2h 9d] [5h]
DeathBrain09: bets 3680
Chuckster388: calls 3680
*** RIVER *** [8d 2h 9d 5h] [4c]
DeathBrain09: bets 16720 and is all-in
Chuckster388: folds 
Uncalled bet (16720) returned to DeathBrain09
DeathBrain09 collected 18860 from pot
*** SUMMARY ***
Total pot 18860 | Rake 0 
Board [8d 2h 9d 5h 4c]
Seat 1: DeathBrain09 (big blind) collected (18860)
Seat 2: marquinhosss folded before Flop (didn't bet)
Seat 3: Chuckster388 folded on the River
Seat 5: SicKTHPS (button) folded before Flop (didn't bet)
Seat 6: sinister778 (small blind) folded before Flop

PokerStars Hand #251209873218: Tournament #3769361908, $52.38+$2.62 USD Hold'em No Limit - Level XVIII (1200/2400) - 2024/06/26 22:53:22 UTC [2024/06/26 18:53:22 ET]
Table '3769361908 5' 6-max Seat #6 is the button
Seat 1: DeathBrain09 (35580 in chips) 
Seat 2: marquinhosss (87090 in chips) 
Seat 3: Chuckster388 (35220 in chips) 
Seat 4: jvieiradias8 (13900 in chips) 
Seat 5: SicKTHPS (54077 in chips) 
Seat 6: sinister778 (108222 in chips) 
DeathBrain09: posts the ante 600
marquinhosss: posts the ante 600
Chuckster388: posts the ante 600
jvieiradias8: posts the ante 600
SicKTHPS: posts the ante 600
sinister778: posts the ante 600
DeathBrain09: posts small blind 1200
marquinhosss: posts big blind 2400
*** HOLE CARDS ***
Chuckster388: folds 
jvieiradias8: raises 10900 to 13300 and is all-in
SicKTHPS: folds 
sinister778: folds 
DeathBrain09: folds 
marquinhosss: folds 
Uncalled bet (10900) returned to jvieiradias8
jvieiradias8 collected 9600 from pot
jvieiradias8: doesn't show hand 
*** SUMMARY ***
Total pot 9600 | Rake 0 
Seat 1: DeathBrain09 (small blind) folded before Flop
Seat 2: marquinhosss (big blind) folded before Flop
Seat 3: Chuckster388 folded before Flop (didn't bet)
Seat 4: jvieiradias8 collected (9600)
Seat 5: SicKTHPS folded before Flop (didn't bet)
Seat 6: sinister778 (button) folded before Flop (didn't bet)

PokerStars Hand #251209879638: Tournament #3769361908, $52.38+$2.62 USD Hold'em No Limit - Level XVIII (1200/2400) - 2024/06/26 22:53:48 UTC [2024/06/26 18:53:48 ET]
Table '3769361908 5' 6-max Seat #1 is the button
Seat 1: DeathBrain09 (33780 in chips) 
Seat 2: marquinhosss (84090 in chips) 
Seat 3: Chuckster388 (34620 in chips) 
Seat 4: jvieiradias8 (20500 in chips) 
Seat 5: SicKTHPS (53477 in chips) 
Seat 6: sinister778 (107622 in chips) 
DeathBrain09: posts the ante 600
marquinhosss: posts the ante 600
Chuckster388: posts the ante 600
jvieiradias8: posts the ante 600
SicKTHPS: posts the ante 600
sinister778: posts the ante 600
marquinhosss: posts small blind 1200
Chuckster388: posts big blind 2400
*** HOLE CARDS ***
jvieiradias8: folds 
SicKTHPS: folds 
sinister778: raises 2400 to 4800
DeathBrain09: folds 
marquinhosss: folds 
Chuckster388: folds 
Uncalled bet (2400) returned to sinister778
sinister778 collected 9600 from pot
*** SUMMARY ***
Total pot 9600 | Rake 0 
Seat 1: DeathBrain09 (button) folded before Flop (didn't bet)
Seat 2: marquinhosss (small blind) folded before Flop
Seat 3: Chuckster388 (big blind) folded before Flop
Seat 4: jvieiradias8 folded before Flop (didn't bet)
Seat 5: SicKTHPS folded before Flop (didn't bet)
Seat 6: sinister778 collected (9600)

PokerStars Hand #251209888555: Tournament #3769361908, $52.38+$2.62 USD Hold'em No Limit - Level XVIII (1200/2400) - 2024/06/26 22:54:25 UTC [2024/06/26 18:54:25 ET]
Table '3769361908 5' 6-max Seat #2 is the button
Seat 1: DeathBrain09 (33180 in chips) 
Seat 2: marquinhosss (82290 in chips) 
Seat 3: Chuckster388 (31620 in chips) 
Seat 4: jvieiradias8 (19900 in chips) 
Seat 5: SicKTHPS (52877 in chips) 
Seat 6: sinister778 (114222 in chips) 
DeathBrain09: posts the ante 600
marquinhosss: posts the ante 600
Chuckster388: posts the ante 600
jvieiradias8: posts the ante 600
SicKTHPS: posts the ante 600
sinister778: posts the ante 600
Chuckster388: posts small blind 1200
jvieiradias8: posts big blind 2400
*** HOLE CARDS ***
SicKTHPS: folds 
sinister778: folds 
DeathBrain09: folds 
marquinhosss: folds 
Chuckster388: raises 28620 to 31020 and is all-in
jvieiradias8: calls 16900 and is all-in
Uncalled bet (11720) returned to Chuckster388
*** FLOP *** [4c Ac 7d]
*** TURN *** [4c Ac 7d] [Tc]
*** RIVER *** [4c Ac 7d Tc] [Qs]
*** SHOW DOWN ***
Chuckster388: shows [2c Jc] (a flush, Ace high)
jvieiradias8: shows [Ah Qd] (two pair, Aces and Queens)
Chuckster388 collected 42200 from pot
jvieiradias8 finished the tournament in 78th place
*** SUMMARY ***
Total pot 42200 | Rake 0 
Board [4c Ac 7d Tc Qs]
Seat 1: DeathBrain09 folded before Flop (didn't bet)
Seat 2: marquinhosss (button) folded before Flop (didn't bet)
Seat 3: Chuckster388 (small blind) showed [2c Jc] and won (42200) with a flush, Ace high
Seat 4: jvieiradias8 (big blind) showed [Ah Qd] and lost with two pair, Aces and Queens
Seat 5: SicKTHPS folded before Flop (didn't bet)
Seat 6: sinister778 folded before Flop (didn't bet)

PokerStars Hand #251209964596: Tournament #3769361908, $52.38+$2.62 USD Hold'em No Limit - Level XVIII (1200/2400) - 2024/06/26 23:01:09 UTC [2024/06/26 19:01:09 ET]
Table '3769361908 5' 6-max Seat #3 is the button
Seat 1: DeathBrain09 (32580 in chips) 
Seat 2: marquinhosss (81690 in chips) 
Seat 3: Chuckster388 (53920 in chips) 
Seat 4: Earl of Poker V (31812 in chips) out of hand (moved from another table into small blind)
Seat 5: SicKTHPS (52277 in chips) 
Seat 6: sinister778 (113622 in chips) 
Earl of Poker V will be allowed to play after the button
DeathBrain09: posts the ante 600
marquinhosss: posts the ante 600
Chuckster388: posts the ante 600
SicKTHPS: posts the ante 600
sinister778: posts the ante 600
SicKTHPS: posts small blind 1200
sinister778: posts big blind 2400
*** HOLE CARDS ***
DeathBrain09: folds 
marquinhosss: raises 2400 to 4800
Chuckster388: folds 
SicKTHPS: folds 
sinister778: folds 
Uncalled bet (2400) returned to marquinhosss
marquinhosss collected 9000 from pot
marquinhosss: doesn't show hand 
*** SUMMARY ***
Total pot 9000 | Rake 0 
Seat 1: DeathBrain09 folded before Flop (didn't bet)
Seat 2: marquinhosss collected (9000)
Seat 3: Chuckster388 (button) folded before Flop (didn't bet)
Seat 5: SicKTHPS (small blind) folded before Flop
Seat 6: sinister778 (big blind) folded before Flop

PokerStars Hand #251209977028: Tournament #3769361908, $52.38+$2.62 USD Hold'em No Limit - Level XVIII (1200/2400) - 2024/06/26 23:02:04 UTC [2024/06/26 19:02:04 ET]
Table '3769361908 5' 6-max Seat #5 is the button
Seat 1: DeathBrain09 (31980 in chips) 
Seat 2: marquinhosss (87690 in chips) 
Seat 3: Chuckster388 (53320 in chips) 
Seat 4: Earl of Poker V (31812 in chips) 
Seat 5: SicKTHPS (50477 in chips) 
Seat 6: sinister778 (110622 in chips) 
DeathBrain09: posts the ante 600
marquinhosss: posts the ante 600
Chuckster388: posts the ante 600
Earl of Poker V: posts the ante 600
SicKTHPS: posts the ante 600
sinister778: posts the ante 600
sinister778: posts small blind 1200
DeathBrain09: posts big blind 2400
*** HOLE CARDS ***
marquinhosss: folds 
Chuckster388: folds 
Earl of Poker V: folds 
SicKTHPS: raises 2400 to 4800
sinister778: folds 
DeathBrain09: calls 2400
*** FLOP *** [Ac 8d 9h]
DeathBrain09: checks 
SicKTHPS: bets 4896
DeathBrain09: raises 4896 to 9792
SicKTHPS: raises 35285 to 45077 and is all-in
DeathBrain09: folds 
Uncalled bet (35285) returned to SicKTHPS
SicKTHPS collected 33984 from pot
SicKTHPS: doesn't show hand 
*** SUMMARY ***
Total pot 33984 | Rake 0 
Board [Ac 8d 9h]
Seat 1: DeathBrain09 (big blind) folded on the Flop
Seat 2: marquinhosss folded before Flop (didn't bet)
Seat 3: Chuckster388 folded before Flop (didn't bet)
Seat 4: Earl of Poker V folded before Flop (didn't bet)
Seat 5: SicKTHPS (button) collected (33984)
Seat 6: sinister778 (small blind) folded before Flop

PokerStars Hand #251209986131: Tournament #3769361908, $52.38+$2.62 USD Hold'em No Limit - Level XIX (1400/2800) - 2024/06/26 23:02:43 UTC [2024/06/26 19:02:43 ET]
Table '3769361908 5' 6-max Seat #6 is the button
Seat 1: DeathBrain09 (16788 in chips) 
Seat 2: marquinhosss (87090 in chips) 
Seat 3: Chuckster388 (52720 in chips) 
Seat 4: Earl of Poker V (31212 in chips) 
Seat 5: SicKTHPS (69269 in chips) 
Seat 6: sinister778 (108822 in chips) 
DeathBrain09: posts the ante 700
marquinhosss: posts the ante 700
Chuckster388: posts the ante 700
Earl of Poker V: posts the ante 700
SicKTHPS: posts the ante 700
sinister778: posts the ante 700
DeathBrain09: posts small blind 1400
marquinhosss: posts big blind 2800
*** HOLE CARDS ***
Chuckster388: raises 4060 to 6860
Earl of Poker V: folds 
SicKTHPS: folds 
sinister778: folds 
DeathBrain09: folds 
marquinhosss: calls 4060
*** FLOP *** [Jc Qs 2c]
marquinhosss: checks 
Chuckster388: bets 6376
marquinhosss: folds 
Uncalled bet (6376) returned to Chuckster388
Chuckster388 collected 19320 from pot
Chuckster388: doesn't show hand 
*** SUMMARY ***
Total pot 19320 | Rake 0 
Board [Jc Qs 2c]
Seat 1: DeathBrain09 (small blind) folded before Flop
Seat 2: marquinhosss (big blind) folded on the Flop
Seat 3: Chuckster388 collected (19320)
Seat 4: Earl of Poker V folded before Flop (didn't bet)
Seat 5: SicKTHPS folded before Flop (didn't bet)
Seat 6: sinister778 (button) folded before Flop (didn't bet)

PokerStars Hand #251209996362: Tournament #3769361908, $52.38+$2.62 USD Hold'em No Limit - Level XIX (1400/2800) - 2024/06/26 23:03:27 UTC [2024/06/26 19:03:27 ET]
Table '3769361908 5' 6-max Seat #1 is the button
Seat 1: DeathBrain09 (14688 in chips) 
Seat 2: marquinhosss (79530 in chips) 
Seat 3: Chuckster388 (64480 in chips) 
Seat 4: Earl of Poker V (30512 in chips) 
Seat 5: SicKTHPS (68569 in chips) 
Seat 6: sinister778 (108122 in chips) 
DeathBrain09: posts the ante 700
marquinhosss: posts the ante 700
Chuckster388: posts the ante 700
Earl of Poker V: posts the ante 700
SicKTHPS: posts the ante 700
sinister778: posts the ante 700
marquinhosss: posts small blind 1400
Chuckster388: posts big blind 2800
*** HOLE CARDS ***
Earl of Poker V: folds 
SicKTHPS: folds 
sinister778: folds 
DeathBrain09: raises 11188 to 13988 and is all-in
marquinhosss: folds 
Chuckster388: folds 
Uncalled bet (11188) returned to DeathBrain09
DeathBrain09 collected 11200 from pot
*** SUMMARY ***
Total pot 11200 | Rake 0 
Seat 1: DeathBrain09 (button) collected (11200)
Seat 2: marquinhosss (small blind) folded before Flop
Seat 3: Chuckster388 (big blind) folded before Flop
Seat 4: Earl of Poker V folded before Flop (didn't bet)
Seat 5: SicKTHPS folded before Flop (didn't bet)
Seat 6: sinister778 folded before Flop (didn't bet)

PokerStars Hand #251210001660: Tournament #3769361908, $52.38+$2.62 USD Hold'em No Limit - Level XIX (1400/2800) - 2024/06/26 23:03:50 UTC [2024/06/26 19:03:50 ET]
Table '3769361908 5' 6-max Seat #2 is the button
Seat 1: DeathBrain09 (22388 in chips) 
Seat 2: marquinhosss (77430 in chips) 
Seat 3: Chuckster388 (60980 in chips) 
Seat 4: Earl of Poker V (29812 in chips) 
Seat 5: SicKTHPS (67869 in chips) 
Seat 6: sinister778 (107422 in chips) 
DeathBrain09: posts the ante 700
marquinhosss: posts the ante 700
Chuckster388: posts the ante 700
Earl of Poker V: posts the ante 700
SicKTHPS: posts the ante 700
sinister778: posts the ante 700
Chuckster388: posts small blind 1400
Earl of Poker V: posts big blind 2800
*** HOLE CARDS ***
SicKTHPS: folds 
sinister778: folds 
DeathBrain09: raises 18888 to 21688 and is all-in
marquinhosss: folds 
Chuckster388: folds 
Earl of Poker V: calls 18888
*** FLOP *** [9c 7h 4d]
*** TURN *** [9c 7h 4d] [5d]
*** RIVER *** [9c 7h 4d 5d] [7d]
*** SHOW DOWN ***
Earl of Poker V: shows [Ac Ts] (a pair of Sevens)
DeathBrain09: shows [Jd Qs] (a pair of Sevens - lower kicker)
Earl of Poker V collected 48976 from pot
DeathBrain09 finished the tournament in 67th place
*** SUMMARY ***
Total pot 48976 | Rake 0 
Board [9c 7h 4d 5d 7d]
Seat 1: DeathBrain09 showed [Jd Qs] and lost with a pair of Sevens
Seat 2: marquinhosss (button) folded before Flop (didn't bet)
Seat 3: Chuckster388 (small blind) folded before Flop
Seat 4: Earl of Poker V (big blind) showed [Ac Ts] and won (48976) with a pair of Sevens
Seat 5: SicKTHPS folded before Flop (didn't bet)
Seat 6: sinister778 folded before Flop (didn't bet)


PokerStars Hand #251209533852: Tournament #3769361908, $52.38+$2.62 USD Hold'em No Limit - Level X (200/400) - 2024/06/26 22:31:32 UTC [2024/06/26 18:31:32 ET]
Table '3769361908 4' 6-max Seat #5 is the button
Seat 1: JamPanamJam (16410 in chips) 
Seat 2: maderinha22 (9060 in chips) 
Seat 3: @tetaschell (10000 in chips) 
Seat 4: muriLLoo.mrL (11077 in chips) 
Seat 5: Everbrun11 (7416 in chips) 
Seat 6: Rochinha2011 (7520 in chips) 
JamPanamJam: posts the ante 100
maderinha22: posts the ante 100
@tetaschell: posts the ante 100
muriLLoo.mrL: posts the ante 100
Everbrun11: posts the ante 100
Rochinha2011: posts the ante 100
Rochinha2011: posts small blind 200
JamPanamJam: posts big blind 400
*** HOLE CARDS ***
maderinha22: folds 
@tetaschell: folds 
muriLLoo.mrL: raises 400 to 800
Everbrun11: raises 6516 to 7316 and is all-in
Rochinha2011: folds 
JamPanamJam: folds 
muriLLoo.mrL: folds 
Uncalled bet (6516) returned to Everbrun11
Everbrun11 collected 2800 from pot
Everbrun11: doesn't show hand 
*** SUMMARY ***
Total pot 2800 | Rake 0 
Seat 1: JamPanamJam (big blind) folded before Flop
Seat 2: maderinha22 folded before Flop (didn't bet)
Seat 3: @tetaschell folded before Flop (didn't bet)
Seat 4: muriLLoo.mrL folded before Flop
Seat 5: Everbrun11 (button) collected (2800)
Seat 6: Rochinha2011 (small blind) folded before Flop

PokerStars Hand #251209541565: Tournament #3769361908, $52.38+$2.62 USD Hold'em No Limit - Level X (200/400) - 2024/06/26 22:32:01 UTC [2024/06/26 18:32:01 ET]
Table '3769361908 4' 6-max Seat #6 is the button
Seat 1: JamPanamJam (15910 in chips) 
Seat 2: maderinha22 (8960 in chips) 
Seat 3: @tetaschell (9900 in chips) 
Seat 4: muriLLoo.mrL (10177 in chips) 
Seat 5: Everbrun11 (9316 in chips) 
Seat 6: Rochinha2011 (7220 in chips) 
JamPanamJam: posts the ante 100
maderinha22: posts the ante 100
@tetaschell: posts the ante 100
muriLLoo.mrL: posts the ante 100
Everbrun11: posts the ante 100
Rochinha2011: posts the ante 100
JamPanamJam: posts small blind 200
maderinha22: posts big blind 400
*** HOLE CARDS ***
@tetaschell: folds 
muriLLoo.mrL: raises 400 to 800
Everbrun11: folds 
Rochinha2011: folds 
JamPanamJam: folds 
maderinha22: calls 400
*** FLOP *** [As 4d 6c]
maderinha22: checks 
muriLLoo.mrL: bets 792
maderinha22: folds 
Uncalled bet (792) returned to muriLLoo.mrL
muriLLoo.mrL collected 2400 from pot
muriLLoo.mrL: doesn't show hand 
*** SUMMARY ***
Total pot 2400 | Rake 0 
Board [As 4d 6c]
Seat 1: JamPanamJam (small blind) folded before Flop
Seat 2: maderinha22 (big blind) folded on the Flop
Seat 3: @tetaschell folded before Flop (didn't bet)
Seat 4: muriLLoo.mrL collected (2400)
Seat 5: Everbrun11 folded before Flop (didn't bet)
Seat 6: Rochinha2011 (button) folded before Flop (didn't bet)

PokerStars Hand #251209559639: Tournament #3769361908, $52.38+$2.62 USD Hold'em No Limit - Level XI (250/500) - 2024/06/26 22:33:07 UTC [2024/06/26 18:33:07 ET]
Table '3769361908 4' 6-max Seat #1 is the button
Seat 1: JamPanamJam (15610 in chips) 
Seat 2: maderinha22 (8060 in chips) 
Seat 3: @tetaschell (9800 in chips) 
Seat 4: muriLLoo.mrL (11677 in chips) 
Seat 5: Everbrun11 (9216 in chips) 
Seat 6: Rochinha2011 (7120 in chips) 
JamPanamJam: posts the ante 125
maderinha22: posts the ante 125
@tetaschell: posts the ante 125
muriLLoo.mrL: posts the ante 125
Everbrun11: posts the ante 125
Rochinha2011: posts the ante 125
maderinha22: posts small blind 250
@tetaschell: posts big blind 500
*** HOLE CARDS ***
muriLLoo.mrL: raises 500 to 1000
Everbrun11: raises 8091 to 9091 and is all-in
Rochinha2011: folds 
JamPanamJam: folds 
maderinha22: folds 
@tetaschell: folds 
muriLLoo.mrL: folds 
Uncalled bet (8091) returned to Everbrun11
Everbrun11 collected 3500 from pot
Everbrun11: doesn't show hand 
*** SUMMARY ***
Total pot 3500 | Rake 0 
Seat 1: JamPanamJam (button) folded before Flop (didn't bet)
Seat 2: maderinha22 (small blind) folded before Flop
Seat 3: @tetaschell (big blind) folded before Flop
Seat 4: muriLLoo.mrL folded before Flop
Seat 5: Everbrun11 collected (3500)
Seat 6: Rochinha2011 folded before Flop (didn't bet)

PokerStars Hand #251209568893: Tournament #3769361908, $52.38+$2.62 USD Hold'em No Limit - Level XI (250/500) - 2024/06/26 22:33:42 UTC [2024/06/26 18:33:42 ET]
Table '3769361908 4' 6-max Seat #2 is the button
Seat 1: JamPanamJam (15485 in chips) 
Seat 2: maderinha22 (7685 in chips) 
Seat 3: @tetaschell (9175 in chips) 
Seat 4: muriLLoo.mrL (10552 in chips) 
Seat 5: Everbrun11 (11591 in chips) 
Seat 6: Rochinha2011 (6995 in chips) 
JamPanamJam: posts the ante 125
maderinha22: posts the ante 125
@tetaschell: posts the ante 125
muriLLoo.mrL: posts the ante 125
Everbrun11: posts the ante 125
Rochinha2011: posts the ante 125
@tetaschell: posts small blind 250
muriLLoo.mrL: posts big blind 500
*** HOLE CARDS ***
Everbrun11: folds 
Rochinha2011: folds 
JamPanamJam: raises 500 to 1000
maderinha22: folds 
@tetaschell: folds 
muriLLoo.mrL: calls 500
*** FLOP *** [Qd Js Th]
muriLLoo.mrL: checks 
JamPanamJam: checks 
*** TURN *** [Qd Js Th] [Kh]
muriLLoo.mrL: checks 
JamPanamJam: bets 2310
muriLLoo.mrL: folds 
Uncalled bet (2310) returned to JamPanamJam
JamPanamJam collected 3000 from pot
JamPanamJam: doesn't show hand 
*** SUMMARY ***
Total pot 3000 | Rake 0 
Board [Qd Js Th Kh]
Seat 1: JamPanamJam collected (3000)
Seat 2: maderinha22 (button) folded before Flop (didn't bet)
Seat 3: @tetaschell (small blind) folded before Flop
Seat 4: muriLLoo.mrL (big blind) folded on the Turn
Seat 5: Everbrun11 folded before Flop (didn't bet)
Seat 6: Rochinha2011 folded before Flop (didn't bet)

PokerStars Hand #251209579019: Tournament #3769361908, $52.38+$2.62 USD Hold'em No Limit - Level XI (250/500) - 2024/06/26 22:34:19 UTC [2024/06/26 18:34:19 ET]
Table '3769361908 4' 6-max Seat #3 is the button
Seat 1: JamPanamJam (17360 in chips) 
Seat 2: maderinha22 (7560 in chips) 
Seat 3: @tetaschell (8800 in chips) 
Seat 4: muriLLoo.mrL (9427 in chips) 
Seat 5: Everbrun11 (11466 in chips) 
Seat 6: Rochinha2011 (6870 in chips) 
JamPanamJam: posts the ante 125
maderinha22: posts the ante 125
@tetaschell: posts the ante 125
muriLLoo.mrL: posts the ante 125
Everbrun11: posts the ante 125
Rochinha2011: posts the ante 125
muriLLoo.mrL: posts small blind 250
Everbrun11: posts big blind 500
*** HOLE CARDS ***
Rochinha2011: folds 
JamPanamJam: folds 
maderinha22: raises 6935 to 7435 and is all-in
@tetaschell: folds 
muriLLoo.mrL: folds 
Everbrun11: calls 6935
*** FLOP *** [2h Td Js]
*** TURN *** [2h Td Js] [6s]
*** RIVER *** [2h Td Js 6s] [9h]
*** SHOW DOWN ***
Everbrun11: shows [As Jd] (a pair of Jacks)
maderinha22: shows [3c 3s] (a pair of Threes)
Everbrun11 collected 15870 from pot
maderinha22 finished the tournament
*** SUMMARY ***
Total pot 15870 | Rake 0 
Board [2h Td Js 6s 9h]
Seat 1: JamPanamJam folded before Flop (didn't bet)
Seat 2: maderinha22 showed [3c 3s] and lost with a pair of Threes
Seat 3: @tetaschell (button) folded before Flop (didn't bet)
Seat 4: muriLLoo.mrL (small blind) folded before Flop
Seat 5: Everbrun11 (big blind) showed [As Jd] and won (15870) with a pair of Jacks
Seat 6: Rochinha2011 folded before Flop (didn't bet)

PokerStars Hand #251209587007: Tournament #3769361908, $52.38+$2.62 USD Hold'em No Limit - Level XI (250/500) - 2024/06/26 22:34:49 UTC [2024/06/26 18:34:49 ET]
Table '3769361908 4' 6-max Seat #4 is the button
Seat 1: JamPanamJam (17235 in chips) 
Seat 3: @tetaschell (8675 in chips) 
Seat 4: muriLLoo.mrL (9052 in chips) 
Seat 5: Everbrun11 (19776 in chips) 
Seat 6: Rochinha2011 (6745 in chips) 
JamPanamJam: posts the ante 125
@tetaschell: posts the ante 125
muriLLoo.mrL: posts the ante 125
Everbrun11: posts the ante 125
Rochinha2011: posts the ante 125
Everbrun11: posts small blind 250
Rochinha2011: posts big blind 500
*** HOLE CARDS ***
JamPanamJam: raises 500 to 1000
@tetaschell: folds 
muriLLoo.mrL: folds 
Everbrun11: folds 
Rochinha2011: folds 
Uncalled bet (500) returned to JamPanamJam
JamPanamJam collected 1875 from pot
JamPanamJam: doesn't show hand 
*** SUMMARY ***
Total pot 1875 | Rake 0 
Seat 1: JamPanamJam collected (1875)
Seat 3: @tetaschell folded before Flop (didn't bet)
Seat 4: muriLLoo.mrL (button) folded before Flop (didn't bet)
Seat 5: Everbrun11 (small blind) folded before Flop
Seat 6: Rochinha2011 (big blind) folded before Flop

PokerStars Hand #251209594770: Tournament #3769361908, $52.38+$2.62 USD Hold'em No Limit - Level XII (300/600) - 2024/06/26 22:35:18 UTC [2024/06/26 18:35:18 ET]
Table '3769361908 4' 6-max Seat #5 is the button
Seat 1: JamPanamJam (18485 in chips) 
Seat 3: @tetaschell (8550 in chips) 
Seat 4: muriLLoo.mrL (8927 in chips) 
Seat 5: Everbrun11 (19401 in chips) 
Seat 6: Rochinha2011 (6120 in chips) 
JamPanamJam: posts the ante 150
@tetaschell: posts the ante 150
muriLLoo.mrL: posts the ante 150
Everbrun11: posts the ante 150
Rochinha2011: posts the ante 150
Rochinha2011: posts small blind 300
JamPanamJam: posts big blind 600
*** HOLE CARDS ***
@tetaschell: folds 
muriLLoo.mrL: folds 
Everbrun11: folds 
Rochinha2011: folds 
Uncalled bet (300) returned to JamPanamJam
JamPanamJam collected 1350 from pot
JamPanamJam: doesn't show hand 
*** SUMMARY ***
Total pot 1350 | Rake 0 
Seat 1: JamPanamJam (big blind) collected (1350)
Seat 3: @tetaschell folded before Flop (didn't bet)
Seat 4: muriLLoo.mrL folded before Flop (didn't bet)
Seat 5: Everbrun11 (button) folded before Flop (didn't bet)
Seat 6: Rochinha2011 (small blind) folded before Flop

PokerStars Hand #251209599762: Tournament #3769361908, $52.38+$2.62 USD Hold'em No Limit - Level XII (300/600) - 2024/06/26 22:35:36 UTC [2024/06/26 18:35:36 ET]
Table '3769361908 4' 6-max Seat #6 is the button
Seat 1: JamPanamJam (19385 in chips) 
Seat 2: alexsarakini (10000 in chips) 
Seat 3: @tetaschell (8400 in chips) 
Seat 4: muriLLoo.mrL (8777 in chips) 
Seat 5: Everbrun11 (19251 in chips) 
Seat 6: Rochinha2011 (5670 in chips) 
JamPanamJam: posts the ante 150
alexsarakini: posts the ante 150
@tetaschell: posts the ante 150
muriLLoo.mrL: posts the ante 150
Everbrun11: posts the ante 150
Rochinha2011: posts the ante 150
JamPanamJam: posts small blind 300
alexsarakini: posts big blind 600
*** HOLE CARDS ***
@tetaschell: folds 
muriLLoo.mrL: folds 
Everbrun11: raises 600 to 1200
Rochinha2011: folds 
JamPanamJam: raises 18035 to 19235 and is all-in
alexsarakini: folds 
Everbrun11: calls 17901 and is all-in
Uncalled bet (134) returned to JamPanamJam
*** FLOP *** [7c 5s 7h]
*** TURN *** [7c 5s 7h] [Jd]
*** RIVER *** [7c 5s 7h Jd] [6h]
*** SHOW DOWN ***
JamPanamJam: shows [8h 8s] (two pair, Eights and Sevens)
Everbrun11: shows [Ts Th] (two pair, Tens and Sevens)
Everbrun11 collected 39702 from pot
*** SUMMARY ***
Total pot 39702 | Rake 0 
Board [7c 5s 7h Jd 6h]
Seat 1: JamPanamJam (small blind) showed [8h 8s] and lost with two pair, Eights and Sevens
Seat 2: alexsarakini (big blind) folded before Flop
Seat 3: @tetaschell folded before Flop (didn't bet)
Seat 4: muriLLoo.mrL folded before Flop (didn't bet)
Seat 5: Everbrun11 showed [Ts Th] and won (39702) with two pair, Tens and Sevens
Seat 6: Rochinha2011 (button) folded before Flop (didn't bet)

PokerStars Hand #251209611279: Tournament #3769361908, $52.38+$2.62 USD Hold'em No Limit - Level XII (300/600) - 2024/06/26 22:36:19 UTC [2024/06/26 18:36:19 ET]
Table '3769361908 4' 6-max Seat #1 is the button
Seat 1: JamPanamJam (134 in chips) 
Seat 2: alexsarakini (9250 in chips) 
Seat 3: @tetaschell (8250 in chips) 
Seat 4: muriLLoo.mrL (8627 in chips) 
Seat 5: Everbrun11 (39702 in chips) 
Seat 6: Rochinha2011 (5520 in chips) 
JamPanamJam: posts the ante 134 and is all-in
alexsarakini: posts the ante 150
@tetaschell: posts the ante 150
muriLLoo.mrL: posts the ante 150
Everbrun11: posts the ante 150
Rochinha2011: posts the ante 150
alexsarakini: posts small blind 300
@tetaschell: posts big blind 600
*** HOLE CARDS ***
muriLLoo.mrL: folds 
Everbrun11: folds 
Rochinha2011: raises 4770 to 5370 and is all-in
alexsarakini: folds 
@tetaschell: calls 4770
*** FLOP *** [2d 7s 5d]
*** TURN *** [2d 7s 5d] [Ks]
*** RIVER *** [2d 7s 5d Ks] [6h]
*** SHOW DOWN ***
@tetaschell: shows [Qc As] (high card Ace)
Rochinha2011: shows [8d Ah] (high card Ace - lower kicker)
@tetaschell collected 11120 from side pot
JamPanamJam: shows [6d 4h] (a pair of Sixes)
JamPanamJam collected 804 from main pot
Rochinha2011 finished the tournament
*** SUMMARY ***
Total pot 11924 Main pot 804. Side pot 11120. | Rake 0 
Board [2d 7s 5d Ks 6h]
Seat 1: JamPanamJam (button) showed [6d 4h] and won (804) with a pair of Sixes
Seat 2: alexsarakini (small blind) folded before Flop
Seat 3: @tetaschell (big blind) showed [Qc As] and won (11120) with high card Ace
Seat 4: muriLLoo.mrL folded before Flop (didn't bet)
Seat 5: Everbrun11 folded before Flop (didn't bet)
Seat 6: Rochinha2011 showed [8d Ah] and lost with high card Ace

PokerStars Hand #251209619225: Tournament #3769361908, $52.38+$2.62 USD Hold'em No Limit - Level XII (300/600) - 2024/06/26 22:36:49 UTC [2024/06/26 18:36:49 ET]
Table '3769361908 4' 6-max Seat #2 is the button
Seat 1: JamPanamJam (804 in chips) 
Seat 2: alexsarakini (8800 in chips) 
Seat 3: @tetaschell (13850 in chips) 
Seat 4: muriLLoo.mrL (8477 in chips) 
Seat 5: Everbrun11 (39552 in chips) 
JamPanamJam: posts the ante 150
alexsarakini: posts the ante 150
@tetaschell: posts the ante 150
muriLLoo.mrL: posts the ante 150
Everbrun11: posts the ante 150
@tetaschell: posts small blind 300
muriLLoo.mrL: posts big blind 600
*** HOLE CARDS ***
Everbrun11: raises 600 to 1200
JamPanamJam: folds 
alexsarakini: calls 1200
@tetaschell: folds 
muriLLoo.mrL: raises 7127 to 8327 and is all-in
Everbrun11: folds 
alexsarakini: folds 
Uncalled bet (7127) returned to muriLLoo.mrL
muriLLoo.mrL collected 4650 from pot
muriLLoo.mrL: doesn't show hand 
*** SUMMARY ***
Total pot 4650 | Rake 0 
Seat 1: JamPanamJam folded before Flop (didn't bet)
Seat 2: alexsarakini (button) folded before Flop
Seat 3: @tetaschell (small blind) folded before Flop
Seat 4: muriLLoo.mrL (big blind) collected (4650)
Seat 5: Everbrun11 folded before Flop

PokerStars Hand #251209624583: Tournament #3769361908, $52.38+$2.62 USD Hold'em No Limit - Level XII (300/600) - 2024/06/26 22:37:09 UTC [2024/06/26 18:37:09 ET]
Table '3769361908 4' 6-max Seat #3 is the button
Seat 1: JamPanamJam (654 in chips) 
Seat 2: alexsarakini (7450 in chips) 
Seat 3: @tetaschell (13400 in chips) 
Seat 4: muriLLoo.mrL (11777 in chips) 
Seat 5: Everbrun11 (38202 in chips) 
JamPanamJam: posts the ante 150
alexsarakini: posts the ante 150
@tetaschell: posts the ante 150
muriLLoo.mrL: posts the ante 150
Everbrun11: posts the ante 150
muriLLoo.mrL: posts small blind 300
Everbrun11: posts big blind 600
*** HOLE CARDS ***
JamPanamJam: calls 504 and is all-in
alexsarakini: folds 
@tetaschell: folds 
muriLLoo.mrL: calls 300
Everbrun11: raises 1200 to 1800
muriLLoo.mrL: folds 
Uncalled bet (1200) returned to Everbrun11
*** FLOP *** [Jc 3s Qc]
*** TURN *** [Jc 3s Qc] [6c]
*** RIVER *** [Jc 3s Qc 6c] [8s]
*** SHOW DOWN ***
Everbrun11: shows [Kc Kd] (a pair of Kings)
Everbrun11 collected 192 from side pot
JamPanamJam: shows [2s 8d] (a pair of Eights)
Everbrun11 collected 2262 from main pot
JamPanamJam finished the tournament
somnamna555 is disconnected 
*** SUMMARY ***
Total pot 2454 Main pot 2262. Side pot 192. | Rake 0 
Board [Jc 3s Qc 6c 8s]
Seat 1: JamPanamJam showed [2s 8d] and lost with a pair of Eights
Seat 2: alexsarakini folded before Flop (didn't bet)
Seat 3: @tetaschell (button) folded before Flop (didn't bet)
Seat 4: muriLLoo.mrL (small blind) folded before Flop
Seat 5: Everbrun11 (big blind) showed [Kc Kd] and won (2454) with a pair of Kings

PokerStars Hand #251209636110: Tournament #3769361908, $52.38+$2.62 USD Hold'em No Limit - Level XII (300/600) - 2024/06/26 22:37:52 UTC [2024/06/26 18:37:52 ET]
Table '3769361908 4' 6-max Seat #4 is the button
Seat 1: somnamna555 (13734 in chips) 
Seat 2: alexsarakini (7300 in chips) 
Seat 3: @tetaschell (13250 in chips) 
Seat 4: muriLLoo.mrL (11027 in chips) 
Seat 5: Everbrun11 (39906 in chips) 
somnamna555: posts the ante 150
alexsarakini: posts the ante 150
@tetaschell: posts the ante 150
muriLLoo.mrL: posts the ante 150
Everbrun11: posts the ante 150
Everbrun11: posts small blind 300
somnamna555: posts big blind 600
*** HOLE CARDS ***
alexsarakini: raises 1200 to 1800
@tetaschell: folds 
muriLLoo.mrL: folds 
Everbrun11: folds 
somnamna555: folds 
Uncalled bet (1200) returned to alexsarakini
alexsarakini collected 2250 from pot
*** SUMMARY ***
Total pot 2250 | Rake 0 
Seat 1: somnamna555 (big blind) folded before Flop
Seat 2: alexsarakini collected (2250)
Seat 3: @tetaschell folded before Flop (didn't bet)
Seat 4: muriLLoo.mrL (button) folded before Flop (didn't bet)
Seat 5: Everbrun11 (small blind) folded before Flop

PokerStars Hand #251209642433: Tournament #3769361908, $52.38+$2.62 USD Hold'em No Limit - Level XIII (400/800) - 2024/06/26 22:38:16 UTC [2024/06/26 18:38:16 ET]
Table '3769361908 4' 6-max Seat #5 is the button
Seat 1: somnamna555 (12984 in chips) 
Seat 2: alexsarakini (8800 in chips) 
Seat 3: @tetaschell (13100 in chips) 
Seat 4: muriLLoo.mrL (10877 in chips) 
Seat 5: Everbrun11 (39456 in chips) 
somnamna555: posts the ante 200
alexsarakini: posts the ante 200
@tetaschell: posts the ante 200
muriLLoo.mrL: posts the ante 200
Everbrun11: posts the ante 200
somnamna555: posts small blind 400
alexsarakini: posts big blind 800
*** HOLE CARDS ***
@tetaschell: folds 
muriLLoo.mrL: folds 
Everbrun11: folds 
somnamna555: folds 
Uncalled bet (400) returned to alexsarakini
alexsarakini collected 1800 from pot
*** SUMMARY ***
Total pot 1800 | Rake 0 
Seat 1: somnamna555 (small blind) folded before Flop
Seat 2: alexsarakini (big blind) collected (1800)
Seat 3: @tetaschell folded before Flop (didn't bet)
Seat 4: muriLLoo.mrL folded before Flop (didn't bet)
Seat 5: Everbrun11 (button) folded before Flop (didn't bet)

PokerStars Hand #251209645550: Tournament #3769361908, $52.38+$2.62 USD Hold'em No Limit - Level XIII (400/800) - 2024/06/26 22:38:28 UTC [2024/06/26 18:38:28 ET]
Table '3769361908 4' 6-max Seat #1 is the button
Seat 1: somnamna555 (12384 in chips) 
Seat 2: alexsarakini (10000 in chips) 
Seat 3: @tetaschell (12900 in chips) 
Seat 4: muriLLoo.mrL (10677 in chips) 
Seat 5: Everbrun11 (39256 in chips) 
somnamna555: posts the ante 200
alexsarakini: posts the ante 200
@tetaschell: posts the ante 200
muriLLoo.mrL: posts the ante 200
Everbrun11: posts the ante 200
alexsarakini: posts small blind 400
@tetaschell: posts big blind 800
*** HOLE CARDS ***
muriLLoo.mrL: folds 
Everbrun11: folds 
somnamna555: folds 
alexsarakini: folds 
Uncalled bet (400) returned to @tetaschell
@tetaschell collected 1800 from pot
@tetaschell: doesn't show hand 
*** SUMMARY ***
Total pot 1800 | Rake 0 
Seat 1: somnamna555 (button) folded before Flop (didn't bet)
Seat 2: alexsarakini (small blind) folded before Flop
Seat 3: @tetaschell (big blind) collected (1800)
Seat 4: muriLLoo.mrL folded before Flop (didn't bet)
Seat 5: Everbrun11 folded before Flop (didn't bet)

PokerStars Hand #251209647964: Tournament #3769361908, $52.38+$2.62 USD Hold'em No Limit - Level XIII (400/800) - 2024/06/26 22:38:37 UTC [2024/06/26 18:38:37 ET]
Table '3769361908 4' 6-max Seat #2 is the button
Seat 1: somnamna555 (12184 in chips) 
Seat 2: alexsarakini (9400 in chips) 
Seat 3: @tetaschell (14100 in chips) 
Seat 4: muriLLoo.mrL (10477 in chips) 
Seat 5: Everbrun11 (39056 in chips) 
somnamna555: posts the ante 200
alexsarakini: posts the ante 200
@tetaschell: posts the ante 200
muriLLoo.mrL: posts the ante 200
Everbrun11: posts the ante 200
@tetaschell: posts small blind 400
muriLLoo.mrL: posts big blind 800
*** HOLE CARDS ***
Everbrun11: folds 
somnamna555: folds 
alexsarakini: raises 800 to 1600
@tetaschell: folds 
muriLLoo.mrL: calls 800
*** FLOP *** [Td 6c 8s]
muriLLoo.mrL: checks 
alexsarakini: bets 1500
muriLLoo.mrL: folds 
Uncalled bet (1500) returned to alexsarakini
alexsarakini collected 4600 from pot
*** SUMMARY ***
Total pot 4600 | Rake 0 
Board [Td 6c 8s]
Seat 1: somnamna555 folded before Flop (didn't bet)
Seat 2: alexsarakini (button) collected (4600)
Seat 3: @tetaschell (small blind) folded before Flop
Seat 4: muriLLoo.mrL (big blind) folded on the Flop
Seat 5: Everbrun11 folded before Flop (didn't bet)

PokerStars Hand #251209658154: Tournament #3769361908, $52.38+$2.62 USD Hold'em No Limit - Level XIII (400/800) - 2024/06/26 22:39:15 UTC [2024/06/26 18:39:15 ET]
Table '3769361908 4' 6-max Seat #3 is the button
Seat 1: somnamna555 (11984 in chips) 
Seat 2: alexsarakini (12200 in chips) 
Seat 3: @tetaschell (13500 in chips) 
Seat 4: muriLLoo.mrL (8677 in chips) 
Seat 5: Everbrun11 (38856 in chips) 
somnamna555: posts the ante 200
alexsarakini: posts the ante 200
@tetaschell: posts the ante 200
muriLLoo.mrL: posts the ante 200
Everbrun11: posts the ante 200
muriLLoo.mrL: posts small blind 400
Everbrun11: posts big blind 800
*** HOLE CARDS ***
somnamna555: folds 
alexsarakini: folds 
@tetaschell: folds 
muriLLoo.mrL: calls 400
Everbrun11: raises 37856 to 38656 and is all-in
muriLLoo.mrL: calls 7677 and is all-in
Uncalled bet (30179) returned to Everbrun11
*** FLOP *** [4c 5h Qd]
*** TURN *** [4c 5h Qd] [9c]
*** RIVER *** [4c 5h Qd 9c] [Jc]
*** SHOW DOWN ***
muriLLoo.mrL: shows [Qc Qh] (three of a kind, Queens)
Everbrun11: shows [Ac 3s] (high card Ace)
muriLLoo.mrL collected 17954 from pot
*** SUMMARY ***
Total pot 17954 | Rake 0 
Board [4c 5h Qd 9c Jc]
Seat 1: somnamna555 folded before Flop (didn't bet)
Seat 2: alexsarakini folded before Flop (didn't bet)
Seat 3: @tetaschell (button) folded before Flop (didn't bet)
Seat 4: muriLLoo.mrL (small blind) showed [Qc Qh] and won (17954) with three of a kind, Queens
Seat 5: Everbrun11 (big blind) showed [Ac 3s] and lost with high card Ace

PokerStars Hand #251209665019: Tournament #3769361908, $52.38+$2.62 USD Hold'em No Limit - Level XIII (400/800) - 2024/06/26 22:39:40 UTC [2024/06/26 18:39:40 ET]
Table '3769361908 4' 6-max Seat #4 is the button
Seat 1: somnamna555 (11784 in chips) 
Seat 2: alexsarakini (12000 in chips) 
Seat 3: @tetaschell (13300 in chips) 
Seat 4: muriLLoo.mrL (17954 in chips) 
Seat 5: Everbrun11 (30179 in chips) 
Seat 6: anth0nypappa (2142 in chips) is sitting out
somnamna555: posts the ante 200
alexsarakini: posts the ante 200
@tetaschell: posts the ante 200
muriLLoo.mrL: posts the ante 200
Everbrun11: posts the ante 200
anth0nypappa: posts the ante 200
Everbrun11: posts small blind 400
anth0nypappa: posts big blind 800
*** HOLE CARDS ***
somnamna555: raises 10784 to 11584 and is all-in
alexsarakini: folds 
@tetaschell: folds 
muriLLoo.mrL: folds 
Everbrun11: folds 
anth0nypappa: folds 
Uncalled bet (10784) returned to somnamna555
somnamna555 collected 3200 from pot
somnamna555: doesn't show hand 
*** SUMMARY ***
Total pot 3200 | Rake 0 
Seat 1: somnamna555 collected (3200)
Seat 2: alexsarakini folded before Flop (didn't bet)
Seat 3: @tetaschell folded before Flop (didn't bet)
Seat 4: muriLLoo.mrL (button) folded before Flop (didn't bet)
Seat 5: Everbrun11 (small blind) folded before Flop
Seat 6: anth0nypappa (big blind) folded before Flop

PokerStars Hand #251209670103: Tournament #3769361908, $52.38+$2.62 USD Hold'em No Limit - Level XIII (400/800) - 2024/06/26 22:39:59 UTC [2024/06/26 18:39:59 ET]
Table '3769361908 4' 6-max Seat #5 is the button
Seat 1: somnamna555 (13984 in chips) 
Seat 2: alexsarakini (11800 in chips) 
Seat 3: @tetaschell (13100 in chips) 
Seat 4: muriLLoo.mrL (17754 in chips) 
Seat 5: Everbrun11 (29579 in chips) 
Seat 6: anth0nypappa (1142 in chips) is sitting out
somnamna555: posts the ante 200
alexsarakini: posts the ante 200
@tetaschell: posts the ante 200
muriLLoo.mrL: posts the ante 200
Everbrun11: posts the ante 200
anth0nypappa: posts the ante 200
anth0nypappa: posts small blind 400
somnamna555: posts big blind 800
*** HOLE CARDS ***
alexsarakini: folds 
@tetaschell: raises 800 to 1600
muriLLoo.mrL: folds 
Everbrun11: folds 
anth0nypappa: folds 
somnamna555: raises 12184 to 13784 and is all-in
@tetaschell: calls 11300 and is all-in
Uncalled bet (884) returned to somnamna555
*** FLOP *** [4h 6c 3h]
*** TURN *** [4h 6c 3h] [7c]
*** RIVER *** [4h 6c 3h 7c] [5d]
*** SHOW DOWN ***
somnamna555: shows [As 9s] (a straight, Three to Seven)
@tetaschell: shows [Qc Ah] (a straight, Three to Seven)
somnamna555 collected 13700 from pot
@tetaschell collected 13700 from pot
*** SUMMARY ***
Total pot 27400 | Rake 0 
Board [4h 6c 3h 7c 5d]
Seat 1: somnamna555 (big blind) showed [As 9s] and won (13700) with a straight, Three to Seven
Seat 2: alexsarakini folded before Flop (didn't bet)
Seat 3: @tetaschell showed [Qc Ah] and won (13700) with a straight, Three to Seven
Seat 4: muriLLoo.mrL folded before Flop (didn't bet)
Seat 5: Everbrun11 (button) folded before Flop (didn't bet)
Seat 6: anth0nypappa (small blind) folded before Flop

PokerStars Hand #251209676974: Tournament #3769361908, $52.38+$2.62 USD Hold'em No Limit - Level XIII (400/800) - 2024/06/26 22:40:25 UTC [2024/06/26 18:40:25 ET]
Table '3769361908 4' 6-max Seat #6 is the button
Seat 1: somnamna555 (14584 in chips) 
Seat 2: alexsarakini (11600 in chips) 
Seat 3: @tetaschell (13700 in chips) 
Seat 4: muriLLoo.mrL (17554 in chips) 
Seat 5: Everbrun11 (29379 in chips) 
Seat 6: anth0nypappa (542 in chips) is sitting out
somnamna555: posts the ante 200
alexsarakini: posts the ante 200
@tetaschell: posts the ante 200
muriLLoo.mrL: posts the ante 200
Everbrun11: posts the ante 200
anth0nypappa: posts the ante 200
somnamna555: posts small blind 400
alexsarakini: posts big blind 800
*** HOLE CARDS ***
@tetaschell: folds 
muriLLoo.mrL: folds 
Everbrun11: folds 
anth0nypappa: folds 
somnamna555: raises 13584 to 14384 and is all-in
alexsarakini: folds 
Uncalled bet (13584) returned to somnamna555
somnamna555 collected 2800 from pot
somnamna555: doesn't show hand 
*** SUMMARY ***
Total pot 2800 | Rake 0 
Seat 1: somnamna555 (small blind) collected (2800)
Seat 2: alexsarakini (big blind) folded before Flop
Seat 3: @tetaschell folded before Flop (didn't bet)
Seat 4: muriLLoo.mrL folded before Flop (didn't bet)
Seat 5: Everbrun11 folded before Flop (didn't bet)
Seat 6: anth0nypappa (button) folded before Flop (didn't bet)

PokerStars Hand #251209681960: Tournament #3769361908, $52.38+$2.62 USD Hold'em No Limit - Level XIII (400/800) - 2024/06/26 22:40:45 UTC [2024/06/26 18:40:45 ET]
Table '3769361908 4' 6-max Seat #1 is the button
Seat 1: somnamna555 (16384 in chips) 
Seat 2: alexsarakini (10600 in chips) 
Seat 3: @tetaschell (13500 in chips) 
Seat 4: muriLLoo.mrL (17354 in chips) 
Seat 5: Everbrun11 (29179 in chips) 
Seat 6: anth0nypappa (342 in chips) is sitting out
somnamna555: posts the ante 200
alexsarakini: posts the ante 200
@tetaschell: posts the ante 200
muriLLoo.mrL: posts the ante 200
Everbrun11: posts the ante 200
anth0nypappa: posts the ante 200
alexsarakini: posts small blind 400
@tetaschell: posts big blind 800
*** HOLE CARDS ***
muriLLoo.mrL: folds 
Everbrun11: raises 800 to 1600
anth0nypappa: folds 
somnamna555: folds 
alexsarakini: folds 
@tetaschell: calls 800
*** FLOP *** [As 8c 6d]
@tetaschell: checks 
Everbrun11: bets 1200
@tetaschell: folds 
Uncalled bet (1200) returned to Everbrun11
Everbrun11 collected 4800 from pot
Everbrun11: doesn't show hand 
*** SUMMARY ***
Total pot 4800 | Rake 0 
Board [As 8c 6d]
Seat 1: somnamna555 (button) folded before Flop (didn't bet)
Seat 2: alexsarakini (small blind) folded before Flop
Seat 3: @tetaschell (big blind) folded on the Flop
Seat 4: muriLLoo.mrL folded before Flop (didn't bet)
Seat 5: Everbrun11 collected (4800)
Seat 6: anth0nypappa folded before Flop (didn't bet)

PokerStars Hand #251209694908: Tournament #3769361908, $52.38+$2.62 USD Hold'em No Limit - Level XIV (500/1000) - 2024/06/26 22:41:34 UTC [2024/06/26 18:41:34 ET]
Table '3769361908 4' 6-max Seat #2 is the button
Seat 1: somnamna555 (16184 in chips) 
Seat 2: alexsarakini (10000 in chips) 
Seat 3: @tetaschell (11700 in chips) 
Seat 4: muriLLoo.mrL (17154 in chips) 
Seat 5: Everbrun11 (32179 in chips) 
Seat 6: anth0nypappa (142 in chips) is sitting out
somnamna555: posts the ante 250
alexsarakini: posts the ante 250
@tetaschell: posts the ante 250
muriLLoo.mrL: posts the ante 250
Everbrun11: posts the ante 250
anth0nypappa: posts the ante 142 and is all-in
@tetaschell: posts small blind 500
muriLLoo.mrL: posts big blind 1000
*** HOLE CARDS ***
Everbrun11: raises 1000 to 2000
anth0nypappa: folds 
somnamna555: folds 
alexsarakini: folds 
@tetaschell: folds 
muriLLoo.mrL: calls 1000
*** FLOP *** [Ad 8h 4h]
muriLLoo.mrL: checks 
Everbrun11: bets 1500
muriLLoo.mrL: raises 13404 to 14904 and is all-in
Everbrun11: folds 
Uncalled bet (13404) returned to muriLLoo.mrL
muriLLoo.mrL collected 8892 from pot
anth0nypappa finished the tournament
muriLLoo.mrL: doesn't show hand 
*** SUMMARY ***
Total pot 8892 | Rake 0 
Board [Ad 8h 4h]
Seat 1: somnamna555 folded before Flop (didn't bet)
Seat 2: alexsarakini (button) folded before Flop (didn't bet)
Seat 3: @tetaschell (small blind) folded before Flop
Seat 4: muriLLoo.mrL (big blind) collected (8892)
Seat 5: Everbrun11 folded on the Flop
Seat 6: anth0nypappa folded before Flop (didn't bet)

PokerStars Hand #251209706683: Tournament #3769361908, $52.38+$2.62 USD Hold'em No Limit - Level XIV (500/1000) - 2024/06/26 22:42:20 UTC [2024/06/26 18:42:20 ET]
Table '3769361908 4' 6-max Seat #3 is the button
Seat 1: somnamna555 (15934 in chips) 
Seat 2: alexsarakini (9750 in chips) 
Seat 3: @tetaschell (10950 in chips) 
Seat 4: muriLLoo.mrL (22296 in chips) 
Seat 5: Everbrun11 (28429 in chips) 
somnamna555: posts the ante 250
alexsarakini: posts the ante 250
@tetaschell: posts the ante 250
muriLLoo.mrL: posts the ante 250
Everbrun11: posts the ante 250
muriLLoo.mrL: posts small blind 500
Everbrun11: posts big blind 1000
*** HOLE CARDS ***
somnamna555: folds 
alexsarakini: folds 
@tetaschell: raises 9700 to 10700 and is all-in
muriLLoo.mrL: folds 
Everbrun11: folds 
Uncalled bet (9700) returned to @tetaschell
@tetaschell collected 3750 from pot
@tetaschell: doesn't show hand 
*** SUMMARY ***
Total pot 3750 | Rake 0 
Seat 1: somnamna555 folded before Flop (didn't bet)
Seat 2: alexsarakini folded before Flop (didn't bet)
Seat 3: @tetaschell (button) collected (3750)
Seat 4: muriLLoo.mrL (small blind) folded before Flop
Seat 5: Everbrun11 (big blind) folded before Flop

PokerStars Hand #251209711927: Tournament #3769361908, $52.38+$2.62 USD Hold'em No Limit - Level XIV (500/1000) - 2024/06/26 22:42:40 UTC [2024/06/26 18:42:40 ET]
Table '3769361908 4' 6-max Seat #4 is the button
Seat 1: somnamna555 (15684 in chips) 
Seat 2: alexsarakini (9500 in chips) 
Seat 3: @tetaschell (13450 in chips) 
Seat 4: muriLLoo.mrL (21546 in chips) 
Seat 5: Everbrun11 (27179 in chips) 
somnamna555: posts the ante 250
alexsarakini: posts the ante 250
@tetaschell: posts the ante 250
muriLLoo.mrL: posts the ante 250
Everbrun11: posts the ante 250
Everbrun11: posts small blind 500
somnamna555: posts big blind 1000
*** HOLE CARDS ***
alexsarakini: folds 
@tetaschell: folds 
muriLLoo.mrL: raises 1000 to 2000
Everbrun11: folds 
somnamna555: folds 
Uncalled bet (1000) returned to muriLLoo.mrL
muriLLoo.mrL collected 3750 from pot
muriLLoo.mrL: doesn't show hand 
*** SUMMARY ***
Total pot 3750 | Rake 0 
Seat 1: somnamna555 (big blind) folded before Flop
Seat 2: alexsarakini folded before Flop (didn't bet)
Seat 3: @tetaschell folded before Flop (didn't bet)
Seat 4: muriLLoo.mrL (button) collected (3750)
Seat 5: Everbrun11 (small blind) folded before Flop

PokerStars Hand #251209717782: Tournament #3769361908, $52.38+$2.62 USD Hold'em No Limit - Level XIV (500/1000) - 2024/06/26 22:43:03 UTC [2024/06/26 18:43:03 ET]
Table '3769361908 4' 6-max Seat #5 is the button
Seat 1: somnamna555 (14434 in chips) 
Seat 2: alexsarakini (9250 in chips) 
Seat 3: @tetaschell (13200 in chips) 
Seat 4: muriLLoo.mrL (24046 in chips) 
Seat 5: Everbrun11 (26429 in chips) 
somnamna555: posts the ante 250
alexsarakini: posts the ante 250
@tetaschell: posts the ante 250
muriLLoo.mrL: posts the ante 250
Everbrun11: posts the ante 250
somnamna555: posts small blind 500
alexsarakini: posts big blind 1000
*** HOLE CARDS ***
@tetaschell: raises 11950 to 12950 and is all-in
muriLLoo.mrL: raises 10846 to 23796 and is all-in
Everbrun11: folds 
somnamna555: folds 
alexsarakini: folds 
Uncalled bet (10846) returned to muriLLoo.mrL
*** FLOP *** [Js Ah 4c]
*** TURN *** [Js Ah 4c] [3c]
*** RIVER *** [Js Ah 4c 3c] [4d]
*** SHOW DOWN ***
@tetaschell: shows [Ks Qd] (a pair of Fours)
muriLLoo.mrL: shows [Ac 7c] (two pair, Aces and Fours)
muriLLoo.mrL collected 28650 from pot
@tetaschell finished the tournament
*** SUMMARY ***
Total pot 28650 | Rake 0 
Board [Js Ah 4c 3c 4d]
Seat 1: somnamna555 (small blind) folded before Flop
Seat 2: alexsarakini (big blind) folded before Flop
Seat 3: @tetaschell showed [Ks Qd] and lost with a pair of Fours
Seat 4: muriLLoo.mrL showed [Ac 7c] and won (28650) with two pair, Aces and Fours
Seat 5: Everbrun11 (button) folded before Flop (didn't bet)

PokerStars Hand #251209725506: Tournament #3769361908, $52.38+$2.62 USD Hold'em No Limit - Level XIV (500/1000) - 2024/06/26 22:43:33 UTC [2024/06/26 18:43:33 ET]
Table '3769361908 4' 6-max Seat #1 is the button
Seat 1: somnamna555 (13684 in chips) 
Seat 2: alexsarakini (8000 in chips) 
Seat 4: muriLLoo.mrL (39496 in chips) 
Seat 5: Everbrun11 (26179 in chips) 
somnamna555: posts the ante 250
alexsarakini: posts the ante 250
muriLLoo.mrL: posts the ante 250
Everbrun11: posts the ante 250
alexsarakini: posts small blind 500
muriLLoo.mrL: posts big blind 1000
*** HOLE CARDS ***
gwallgofddyn is disconnected 
Everbrun11: raises 1000 to 2000
somnamna555: folds 
alexsarakini: folds 
muriLLoo.mrL: calls 1000
*** FLOP *** [9d Qc Td]
muriLLoo.mrL: checks 
Everbrun11: bets 2000
muriLLoo.mrL: calls 2000
*** TURN *** [9d Qc Td] [Ah]
muriLLoo.mrL: checks 
Everbrun11: bets 6000
muriLLoo.mrL: raises 29246 to 35246 and is all-in
Everbrun11: calls 15929 and is all-in
Uncalled bet (13317) returned to muriLLoo.mrL
*** RIVER *** [9d Qc Td Ah] [6d]
*** SHOW DOWN ***
muriLLoo.mrL: shows [Ac 9h] (two pair, Aces and Nines)
Everbrun11: shows [Qs Ad] (two pair, Aces and Queens)
Everbrun11 collected 53358 from pot
*** SUMMARY ***
Total pot 53358 | Rake 0 
Board [9d Qc Td Ah 6d]
Seat 1: somnamna555 (button) folded before Flop (didn't bet)
Seat 2: alexsarakini (small blind) folded before Flop
Seat 4: muriLLoo.mrL (big blind) showed [Ac 9h] and lost with two pair, Aces and Nines
Seat 5: Everbrun11 showed [Qs Ad] and won (53358) with two pair, Aces and Queens

PokerStars Hand #251209736516: Tournament #3769361908, $52.38+$2.62 USD Hold'em No Limit - Level XV (600/1200) - 2024/06/26 22:44:16 UTC [2024/06/26 18:44:16 ET]
Table '3769361908 4' 6-max Seat #2 is the button
Seat 1: somnamna555 (13434 in chips) 
Seat 2: alexsarakini (7250 in chips) 
Seat 3: gwallgofddyn (12876 in chips) out of hand (moved from another table into small blind)
Seat 4: muriLLoo.mrL (13317 in chips) 
Seat 5: Everbrun11 (53358 in chips) 
gwallgofddyn will be allowed to play after the button
somnamna555: posts the ante 300
alexsarakini: posts the ante 300
muriLLoo.mrL: posts the ante 300
Everbrun11: posts the ante 300
muriLLoo.mrL: posts small blind 600
Everbrun11: posts big blind 1200
*** HOLE CARDS ***
somnamna555: folds 
alexsarakini: folds 
muriLLoo.mrL: raises 11817 to 13017 and is all-in
Everbrun11: folds 
Uncalled bet (11817) returned to muriLLoo.mrL
muriLLoo.mrL collected 3600 from pot
muriLLoo.mrL: doesn't show hand 
*** SUMMARY ***
Total pot 3600 | Rake 0 
Seat 1: somnamna555 folded before Flop (didn't bet)
Seat 2: alexsarakini (button) folded before Flop (didn't bet)
Seat 4: muriLLoo.mrL (small blind) collected (3600)
Seat 5: Everbrun11 (big blind) folded before Flop

PokerStars Hand #251209740100: Tournament #3769361908, $52.38+$2.62 USD Hold'em No Limit - Level XV (600/1200) - 2024/06/26 22:44:30 UTC [2024/06/26 18:44:30 ET]
Table '3769361908 4' 6-max Seat #4 is the button
Seat 1: somnamna555 (13134 in chips) 
Seat 2: alexsarakini (6950 in chips) 
Seat 3: gwallgofddyn (12876 in chips) 
Seat 4: muriLLoo.mrL (15417 in chips) 
Seat 5: Everbrun11 (51858 in chips) 
somnamna555: posts the ante 300
alexsarakini: posts the ante 300
gwallgofddyn: posts the ante 300
muriLLoo.mrL: posts the ante 300
Everbrun11: posts the ante 300
Everbrun11: posts small blind 600
somnamna555: posts big blind 1200
*** HOLE CARDS ***
alexsarakini: folds 
gwallgofddyn: raises 1200 to 2400
muriLLoo.mrL: folds 
BernardoDG is disconnected 
Everbrun11: folds 
somnamna555: folds 
Uncalled bet (1200) returned to gwallgofddyn
gwallgofddyn collected 4500 from pot
gwallgofddyn: doesn't show hand 
*** SUMMARY ***
Total pot 4500 | Rake 0 
Seat 1: somnamna555 (big blind) folded before Flop
Seat 2: alexsarakini folded before Flop (didn't bet)
Seat 3: gwallgofddyn collected (4500)
Seat 4: muriLLoo.mrL (button) folded before Flop (didn't bet)
Seat 5: Everbrun11 (small blind) folded before Flop

PokerStars Hand #251209746455: Tournament #3769361908, $52.38+$2.62 USD Hold'em No Limit - Level XV (600/1200) - 2024/06/26 22:44:55 UTC [2024/06/26 18:44:55 ET]
Table '3769361908 4' 6-max Seat #5 is the button
Seat 1: somnamna555 (11634 in chips) 
Seat 2: alexsarakini (6650 in chips) 
Seat 3: gwallgofddyn (15876 in chips) 
Seat 4: muriLLoo.mrL (15117 in chips) 
Seat 5: Everbrun11 (50958 in chips) 
Seat 6: BernardoDG (18951 in chips) out of hand (moved from another table into small blind)
BernardoDG will be allowed to play after the button
somnamna555: posts the ante 300
alexsarakini: posts the ante 300
gwallgofddyn: posts the ante 300
muriLLoo.mrL: posts the ante 300
Everbrun11: posts the ante 300
somnamna555: posts small blind 600
alexsarakini: posts big blind 1200
*** HOLE CARDS ***
gwallgofddyn: folds 
muriLLoo.mrL: raises 1200 to 2400
Everbrun11: folds 
somnamna555: folds 
alexsarakini: folds 
Uncalled bet (1200) returned to muriLLoo.mrL
muriLLoo.mrL collected 4500 from pot
muriLLoo.mrL: doesn't show hand 
*** SUMMARY ***
Total pot 4500 | Rake 0 
Seat 1: somnamna555 (small blind) folded before Flop
Seat 2: alexsarakini (big blind) folded before Flop
Seat 3: gwallgofddyn folded before Flop (didn't bet)
Seat 4: muriLLoo.mrL collected (4500)
Seat 5: Everbrun11 (button) folded before Flop (didn't bet)

PokerStars Hand #251209753640: Tournament #3769361908, $52.38+$2.62 USD Hold'em No Limit - Level XV (600/1200) - 2024/06/26 22:45:23 UTC [2024/06/26 18:45:23 ET]
Table '3769361908 4' 6-max Seat #1 is the button
Seat 1: somnamna555 (10734 in chips) 
Seat 2: alexsarakini (5150 in chips) 
Seat 3: gwallgofddyn (15576 in chips) 
Seat 4: muriLLoo.mrL (18117 in chips) 
Seat 5: Everbrun11 (50658 in chips) 
Seat 6: BernardoDG (18951 in chips) 
somnamna555: posts the ante 300
alexsarakini: posts the ante 300
gwallgofddyn: posts the ante 300
muriLLoo.mrL: posts the ante 300
Everbrun11: posts the ante 300
BernardoDG: posts the ante 300
alexsarakini: posts small blind 600
gwallgofddyn: posts big blind 1200
*** HOLE CARDS ***
muriLLoo.mrL: raises 16617 to 17817 and is all-in
Everbrun11: raises 16617 to 34434
BernardoDG: folds 
somnamna555: folds 
alexsarakini: calls 4250 and is all-in
gwallgofddyn: folds 
Uncalled bet (16617) returned to Everbrun11
*** FLOP *** [As 3s 9h]
*** TURN *** [As 3s 9h] [8h]
*** RIVER *** [As 3s 9h 8h] [4d]
*** SHOW DOWN ***
muriLLoo.mrL: shows [Kh Qs] (high card Ace)
Everbrun11: shows [Ad Jc] (a pair of Aces)
Everbrun11 collected 25934 from side pot
alexsarakini: shows [Ac 6h] (a pair of Aces - lower kicker)
Everbrun11 collected 17550 from main pot
muriLLoo.mrL finished the tournament
alexsarakini finished the tournament
*** SUMMARY ***
Total pot 43484 Main pot 17550. Side pot 25934. | Rake 0 
Board [As 3s 9h 8h 4d]
Seat 1: somnamna555 (button) folded before Flop (didn't bet)
Seat 2: alexsarakini (small blind) showed [Ac 6h] and lost with a pair of Aces
Seat 3: gwallgofddyn (big blind) folded before Flop
Seat 4: muriLLoo.mrL showed [Kh Qs] and lost with high card Ace
Seat 5: Everbrun11 showed [Ad Jc] and won (43484) with a pair of Aces
Seat 6: BernardoDG folded before Flop (didn't bet)

PokerStars Hand #251209759426: Tournament #3769361908, $52.38+$2.62 USD Hold'em No Limit - Level XV (600/1200) - 2024/06/26 22:45:45 UTC [2024/06/26 18:45:45 ET]
Table '3769361908 4' 6-max Seat #3 is the button
Seat 1: somnamna555 (10434 in chips) 
Seat 2: Biguethi339 (7600 in chips) 
Seat 3: gwallgofddyn (14076 in chips) 
Seat 5: Everbrun11 (76025 in chips) 
Seat 6: BernardoDG (18651 in chips) 
somnamna555: posts the ante 300
Biguethi339: posts the ante 300
gwallgofddyn: posts the ante 300
Everbrun11: posts the ante 300
BernardoDG: posts the ante 300
Everbrun11: posts small blind 600
BernardoDG: posts big blind 1200
*** HOLE CARDS ***
Biguethi339 is disconnected 
somnamna555: folds 
Biguethi339: folds 
gwallgofddyn: raises 12576 to 13776 and is all-in
Everbrun11: folds 
BernardoDG: folds 
Uncalled bet (12576) returned to gwallgofddyn
gwallgofddyn collected 4500 from pot
gwallgofddyn: doesn't show hand 
*** SUMMARY ***
Total pot 4500 | Rake 0 
Seat 1: somnamna555 folded before Flop (didn't bet)
Seat 2: Biguethi339 folded before Flop (didn't bet)
Seat 3: gwallgofddyn (button) collected (4500)
Seat 5: Everbrun11 (small blind) folded before Flop
Seat 6: BernardoDG (big blind) folded before Flop

PokerStars Hand #251209764347: Tournament #3769361908, $52.38+$2.62 USD Hold'em No Limit - Level XV (600/1200) - 2024/06/26 22:46:04 UTC [2024/06/26 18:46:04 ET]
Table '3769361908 4' 6-max Seat #5 is the button
Seat 1: somnamna555 (10134 in chips) 
Seat 2: Biguethi339 (7300 in chips) 
Seat 3: gwallgofddyn (17076 in chips) 
Seat 5: Everbrun11 (75125 in chips) 
Seat 6: BernardoDG (17151 in chips) 
somnamna555: posts the ante 300
Biguethi339: posts the ante 300
gwallgofddyn: posts the ante 300
Everbrun11: posts the ante 300
BernardoDG: posts the ante 300
BernardoDG: posts small blind 600
somnamna555: posts big blind 1200
*** HOLE CARDS ***
Biguethi339: folds 
gwallgofddyn: folds 
Everbrun11: folds 
hed777 is disconnected 
BernardoDG: raises 15651 to 16851 and is all-in
somnamna555: folds 
Uncalled bet (15651) returned to BernardoDG
BernardoDG collected 3900 from pot
BernardoDG: doesn't show hand 
*** SUMMARY ***
Total pot 3900 | Rake 0 
Seat 1: somnamna555 (big blind) folded before Flop
Seat 2: Biguethi339 folded before Flop (didn't bet)
Seat 3: gwallgofddyn folded before Flop (didn't bet)
Seat 5: Everbrun11 (button) folded before Flop (didn't bet)
Seat 6: BernardoDG (small blind) collected (3900)

PokerStars Hand #251209769569: Tournament #3769361908, $52.38+$2.62 USD Hold'em No Limit - Level XV (600/1200) - 2024/06/26 22:46:24 UTC [2024/06/26 18:46:24 ET]
Table '3769361908 4' 6-max Seat #6 is the button
Seat 1: somnamna555 (8634 in chips) 
Seat 2: Biguethi339 (7000 in chips) 
Seat 3: gwallgofddyn (16776 in chips) 
Seat 4: hed777 (10000 in chips) 
Seat 5: Everbrun11 (74825 in chips) 
Seat 6: BernardoDG (19551 in chips) 
somnamna555: posts the ante 300
Biguethi339: posts the ante 300
gwallgofddyn: posts the ante 300
hed777: posts the ante 300
Everbrun11: posts the ante 300
BernardoDG: posts the ante 300
somnamna555: posts small blind 600
Biguethi339: posts big blind 1200
*** HOLE CARDS ***
gwallgofddyn: folds 
hed777: folds 
Everbrun11: folds 
BernardoDG: raises 18051 to 19251 and is all-in
somnamna555: folds 
Biguethi339: calls 5500 and is all-in
Uncalled bet (12551) returned to BernardoDG
*** FLOP *** [Qd 3d Qh]
*** TURN *** [Qd 3d Qh] [Kc]
*** RIVER *** [Qd 3d Qh Kc] [2s]
*** SHOW DOWN ***
Biguethi339: shows [Kh 9s] (two pair, Kings and Queens)
BernardoDG: shows [8h 8s] (two pair, Queens and Eights)
Biguethi339 collected 15800 from pot
*** SUMMARY ***
Total pot 15800 | Rake 0 
Board [Qd 3d Qh Kc 2s]
Seat 1: somnamna555 (small blind) folded before Flop
Seat 2: Biguethi339 (big blind) showed [Kh 9s] and won (15800) with two pair, Kings and Queens
Seat 3: gwallgofddyn folded before Flop (didn't bet)
Seat 4: hed777 folded before Flop (didn't bet)
Seat 5: Everbrun11 folded before Flop (didn't bet)
Seat 6: BernardoDG (button) showed [8h 8s] and lost with two pair, Queens and Eights

PokerStars Hand #251209776500: Tournament #3769361908, $52.38+$2.62 USD Hold'em No Limit - Level XV (600/1200) - 2024/06/26 22:46:52 UTC [2024/06/26 18:46:52 ET]
Table '3769361908 4' 6-max Seat #1 is the button
Seat 1: somnamna555 (7734 in chips) 
Seat 2: Biguethi339 (15800 in chips) 
Seat 3: gwallgofddyn (16476 in chips) 
Seat 4: hed777 (9700 in chips) 
Seat 5: Everbrun11 (74525 in chips) 
Seat 6: BernardoDG (12551 in chips) 
somnamna555: posts the ante 300
Biguethi339: posts the ante 300
gwallgofddyn: posts the ante 300
hed777: posts the ante 300
Everbrun11: posts the ante 300
BernardoDG: posts the ante 300
Biguethi339: posts small blind 600
gwallgofddyn: posts big blind 1200
*** HOLE CARDS ***
hed777: folds 
Everbrun11: folds 
BernardoDG: raises 11051 to 12251 and is all-in
somnamna555: folds 
Biguethi339: folds 
gwallgofddyn: folds 
Uncalled bet (11051) returned to BernardoDG
BernardoDG collected 4800 from pot
BernardoDG: doesn't show hand 
*** SUMMARY ***
Total pot 4800 | Rake 0 
Seat 1: somnamna555 (button) folded before Flop (didn't bet)
Seat 2: Biguethi339 (small blind) folded before Flop
Seat 3: gwallgofddyn (big blind) folded before Flop
Seat 4: hed777 folded before Flop (didn't bet)
Seat 5: Everbrun11 folded before Flop (didn't bet)
Seat 6: BernardoDG collected (4800)

PokerStars Hand #251209782529: Tournament #3769361908, $52.38+$2.62 USD Hold'em No Limit - Level XVI (800/1600) - 2024/06/26 22:47:15 UTC [2024/06/26 18:47:15 ET]
Table '3769361908 4' 6-max Seat #2 is the button
Seat 1: somnamna555 (7434 in chips) 
Seat 2: Biguethi339 (14900 in chips) 
Seat 3: gwallgofddyn (14976 in chips) 
Seat 4: hed777 (9400 in chips) 
Seat 5: Everbrun11 (74225 in chips) 
Seat 6: BernardoDG (15851 in chips) 
somnamna555: posts the ante 400
Biguethi339: posts the ante 400
gwallgofddyn: posts the ante 400
hed777: posts the ante 400
Everbrun11: posts the ante 400
BernardoDG: posts the ante 400
gwallgofddyn: posts small blind 800
hed777: posts big blind 1600
*** HOLE CARDS ***
Everbrun11: raises 1600 to 3200
BernardoDG: raises 12251 to 15451 and is all-in
somnamna555: folds 
Biguethi339: folds 
gwallgofddyn: folds 
hed777: folds 
Everbrun11: calls 12251
*** FLOP *** [7c Ks 3c]
*** TURN *** [7c Ks 3c] [2h]
*** RIVER *** [7c Ks 3c 2h] [4s]
*** SHOW DOWN ***
Everbrun11: shows [Ad Ac] (a pair of Aces)
BernardoDG: shows [5c 5h] (a pair of Fives)
Everbrun11 collected 35702 from pot
BernardoDG finished the tournament
*** SUMMARY ***
Total pot 35702 | Rake 0 
Board [7c Ks 3c 2h 4s]
Seat 1: somnamna555 folded before Flop (didn't bet)
Seat 2: Biguethi339 (button) folded before Flop (didn't bet)
Seat 3: gwallgofddyn (small blind) folded before Flop
Seat 4: hed777 (big blind) folded before Flop
Seat 5: Everbrun11 showed [Ad Ac] and won (35702) with a pair of Aces
Seat 6: BernardoDG showed [5c 5h] and lost with a pair of Fives

PokerStars Hand #251209794896: Tournament #3769361908, $52.38+$2.62 USD Hold'em No Limit - Level XVI (800/1600) - 2024/06/26 22:48:04 UTC [2024/06/26 18:48:04 ET]
Table '3769361908 4' 6-max Seat #3 is the button
Seat 1: somnamna555 (7034 in chips) 
Seat 2: Biguethi339 (14500 in chips) 
Seat 3: gwallgofddyn (13776 in chips) 
Seat 4: hed777 (7400 in chips) 
Seat 5: Everbrun11 (94076 in chips) 
somnamna555: posts the ante 400
Biguethi339: posts the ante 400
gwallgofddyn: posts the ante 400
hed777: posts the ante 400
Everbrun11: posts the ante 400
hed777: posts small blind 800
Everbrun11: posts big blind 1600
*** HOLE CARDS ***
Berkowitz33 is disconnected 
somnamna555: raises 5034 to 6634 and is all-in
Biguethi339: folds 
gwallgofddyn: folds 
hed777: folds 
Everbrun11: calls 5034
*** FLOP *** [Qc 7c 2s]
*** TURN *** [Qc 7c 2s] [Jd]
*** RIVER *** [Qc 7c 2s Jd] [Td]
*** SHOW DOWN ***
Everbrun11: shows [6s 9h] (high card Queen)
somnamna555: shows [7h Ah] (a pair of Sevens)
somnamna555 collected 16068 from pot
*** SUMMARY ***
Total pot 16068 | Rake 0 
Board [Qc 7c 2s Jd Td]
Seat 1: somnamna555 showed [7h Ah] and won (16068) with a pair of Sevens
Seat 2: Biguethi339 folded before Flop (didn't bet)
Seat 3: gwallgofddyn (button) folded before Flop (didn't bet)
Seat 4: hed777 (small blind) folded before Flop
Seat 5: Everbrun11 (big blind) showed [6s 9h] and lost with high card Queen

PokerStars Hand #251209803710: Tournament #3769361908, $52.38+$2.62 USD Hold'em No Limit - Level XVI (800/1600) - 2024/06/26 22:48:39 UTC [2024/06/26 18:48:39 ET]
Table '3769361908 4' 6-max Seat #4 is the button
Seat 1: somnamna555 (16068 in chips) 
Seat 2: Biguethi339 (14100 in chips) 
Seat 3: gwallgofddyn (13376 in chips) 
Seat 4: hed777 (6200 in chips) 
Seat 5: Everbrun11 (87042 in chips) 
Seat 6: Berkowitz33 (13666 in chips) 
somnamna555: posts the ante 400
Biguethi339: posts the ante 400
gwallgofddyn: posts the ante 400
hed777: posts the ante 400
Everbrun11: posts the ante 400
Berkowitz33: posts the ante 400
Everbrun11: posts small blind 800
Berkowitz33: posts big blind 1600
*** HOLE CARDS ***
somnamna555: raises 14068 to 15668 and is all-in
Biguethi339: folds 
gwallgofddyn: folds 
hed777: folds 
Everbrun11: folds 
Berkowitz33: folds 
Uncalled bet (14068) returned to somnamna555
somnamna555 collected 6400 from pot
somnamna555: doesn't show hand 
*** SUMMARY ***
Total pot 6400 | Rake 0 
Seat 1: somnamna555 collected (6400)
Seat 2: Biguethi339 folded before Flop (didn't bet)
Seat 3: gwallgofddyn folded before Flop (didn't bet)
Seat 4: hed777 (button) folded before Flop (didn't bet)
Seat 5: Everbrun11 (small blind) folded before Flop
Seat 6: Berkowitz33 (big blind) folded before Flop

PokerStars Hand #251209808170: Tournament #3769361908, $52.38+$2.62 USD Hold'em No Limit - Level XVI (800/1600) - 2024/06/26 22:48:56 UTC [2024/06/26 18:48:56 ET]
Table '3769361908 4' 6-max Seat #5 is the button
Seat 2: Biguethi339 (13700 in chips) 
Seat 3: gwallgofddyn (12976 in chips) 
Seat 4: hed777 (5800 in chips) 
Seat 5: Everbrun11 (85842 in chips) 
Seat 6: Berkowitz33 (11666 in chips) 
Biguethi339: posts the ante 400
gwallgofddyn: posts the ante 400
hed777: posts the ante 400
Everbrun11: posts the ante 400
Berkowitz33: posts the ante 400
Berkowitz33: posts small blind 800
Biguethi339: posts big blind 1600
*** HOLE CARDS ***
gwallgofddyn: folds 
hed777: raises 3800 to 5400 and is all-in
C0rpsbal is disconnected 
Everbrun11: folds 
Berkowitz33: folds 
Biguethi339: calls 3800
*** FLOP *** [Kc 4h 8c]
*** TURN *** [Kc 4h 8c] [9d]
*** RIVER *** [Kc 4h 8c 9d] [3s]
*** SHOW DOWN ***
Biguethi339: shows [Th 7d] (high card King)
hed777: shows [4d As] (a pair of Fours)
hed777 collected 13600 from pot
*** SUMMARY ***
Total pot 13600 | Rake 0 
Board [Kc 4h 8c 9d 3s]
Seat 2: Biguethi339 (big blind) showed [Th 7d] and lost with high card King
Seat 3: gwallgofddyn folded before Flop (didn't bet)
Seat 4: hed777 showed [4d As] and won (13600) with a pair of Fours
Seat 5: Everbrun11 (button) folded before Flop (didn't bet)
Seat 6: Berkowitz33 (small blind) folded before Flop

PokerStars Hand #251209818951: Tournament #3769361908, $52.38+$2.62 USD Hold'em No Limit - Level XVI (800/1600) - 2024/06/26 22:49:40 UTC [2024/06/26 18:49:40 ET]
Table '3769361908 4' 6-max Seat #6 is the button
Seat 1: C0rpsbal (21826 in chips) out of hand (moved from another table into small blind)
Seat 2: Biguethi339 (7900 in chips) 
Seat 3: gwallgofddyn (12576 in chips) 
Seat 4: hed777 (13600 in chips) 
Seat 5: Everbrun11 (85442 in chips) 
Seat 6: Berkowitz33 (10466 in chips) 
C0rpsbal will be allowed to play after the button
Biguethi339: posts the ante 400
gwallgofddyn: posts the ante 400
hed777: posts the ante 400
Everbrun11: posts the ante 400
Berkowitz33: posts the ante 400
Biguethi339: posts small blind 800
gwallgofddyn: posts big blind 1600
*** HOLE CARDS ***
hed777: folds 
Everbrun11: folds 
Berkowitz33: folds 
Biguethi339: folds 
Uncalled bet (800) returned to gwallgofddyn
gwallgofddyn collected 3600 from pot
gwallgofddyn: doesn't show hand 
*** SUMMARY ***
Total pot 3600 | Rake 0 
Seat 2: Biguethi339 (small blind) folded before Flop
Seat 3: gwallgofddyn (big blind) collected (3600)
Seat 4: hed777 folded before Flop (didn't bet)
Seat 5: Everbrun11 folded before Flop (didn't bet)
Seat 6: Berkowitz33 (button) folded before Flop (didn't bet)

PokerStars Hand #251209821256: Tournament #3769361908, $52.38+$2.62 USD Hold'em No Limit - Level XVI (800/1600) - 2024/06/26 22:49:49 UTC [2024/06/26 18:49:49 ET]
Table '3769361908 4' 6-max Seat #2 is the button
Seat 1: C0rpsbal (21826 in chips) 
Seat 2: Biguethi339 (6700 in chips) 
Seat 3: gwallgofddyn (14976 in chips) 
Seat 4: hed777 (13200 in chips) 
Seat 5: Everbrun11 (85042 in chips) 
Seat 6: Berkowitz33 (10066 in chips) 
C0rpsbal: posts the ante 400
Biguethi339: posts the ante 400
gwallgofddyn: posts the ante 400
hed777: posts the ante 400
Everbrun11: posts the ante 400
Berkowitz33: posts the ante 400
gwallgofddyn: posts small blind 800
hed777: posts big blind 1600
*** HOLE CARDS ***
Everbrun11: folds 
Berkowitz33: raises 8066 to 9666 and is all-in
C0rpsbal: folds 
Biguethi339: calls 6300 and is all-in
gwallgofddyn: folds 
hed777: folds 
Uncalled bet (3366) returned to Berkowitz33
*** FLOP *** [6c 7c 9s]
*** TURN *** [6c 7c 9s] [Qs]
*** RIVER *** [6c 7c 9s Qs] [Jc]
*** SHOW DOWN ***
Berkowitz33: shows [Qd Ad] (a pair of Queens)
Biguethi339: shows [Qh Jh] (two pair, Queens and Jacks)
Biguethi339 collected 17400 from pot
*** SUMMARY ***
Total pot 17400 | Rake 0 
Board [6c 7c 9s Qs Jc]
Seat 1: C0rpsbal folded before Flop (didn't bet)
Seat 2: Biguethi339 (button) showed [Qh Jh] and won (17400) with two pair, Queens and Jacks
Seat 3: gwallgofddyn (small blind) folded before Flop
Seat 4: hed777 (big blind) folded before Flop
Seat 5: Everbrun11 folded before Flop (didn't bet)
Seat 6: Berkowitz33 showed [Qd Ad] and lost with a pair of Queens

PokerStars Hand #251209834253: Tournament #3769361908, $52.38+$2.62 USD Hold'em No Limit - Level XVII (1000/2000) - 2024/06/26 22:50:42 UTC [2024/06/26 18:50:42 ET]
Table '3769361908 4' 6-max Seat #3 is the button
Seat 1: C0rpsbal (21426 in chips) 
Seat 2: Biguethi339 (17400 in chips) 
Seat 3: gwallgofddyn (13776 in chips) 
Seat 4: hed777 (11200 in chips) 
Seat 5: Everbrun11 (84642 in chips) 
Seat 6: Berkowitz33 (3366 in chips) 
C0rpsbal: posts the ante 500
Biguethi339: posts the ante 500
gwallgofddyn: posts the ante 500
hed777: posts the ante 500
Everbrun11: posts the ante 500
Berkowitz33: posts the ante 500
hed777: posts small blind 1000
Everbrun11: posts big blind 2000
*** HOLE CARDS ***
Berkowitz33: folds 
C0rpsbal: folds 
Biguethi339: folds 
gwallgofddyn: folds 
hed777: raises 8700 to 10700 and is all-in
Everbrun11: calls 8700
*** FLOP *** [9c 4h Qs]
*** TURN *** [9c 4h Qs] [As]
*** RIVER *** [9c 4h Qs As] [Ac]
*** SHOW DOWN ***
hed777: shows [Jc Ks] (a pair of Aces)
Everbrun11: shows [Th Qc] (two pair, Aces and Queens)
Everbrun11 collected 24400 from pot
hed777 finished the tournament in 105th place
*** SUMMARY ***
Total pot 24400 | Rake 0 
Board [9c 4h Qs As Ac]
Seat 1: C0rpsbal folded before Flop (didn't bet)
Seat 2: Biguethi339 folded before Flop (didn't bet)
Seat 3: gwallgofddyn (button) folded before Flop (didn't bet)
Seat 4: hed777 (small blind) showed [Jc Ks] and lost with a pair of Aces
Seat 5: Everbrun11 (big blind) showed [Th Qc] and won (24400) with two pair, Aces and Queens
Seat 6: Berkowitz33 folded before Flop (didn't bet)

PokerStars Hand #251209841343: Tournament #3769361908, $52.38+$2.62 USD Hold'em No Limit - Level XVII (1000/2000) - 2024/06/26 22:51:12 UTC [2024/06/26 18:51:12 ET]
Table '3769361908 4' 6-max Seat #5 is the button
Seat 1: C0rpsbal (20926 in chips) 
Seat 2: Biguethi339 (16900 in chips) 
Seat 3: gwallgofddyn (13276 in chips) 
Seat 5: Everbrun11 (97842 in chips) 
Seat 6: Berkowitz33 (2866 in chips) 
C0rpsbal: posts the ante 500
Biguethi339: posts the ante 500
gwallgofddyn: posts the ante 500
Everbrun11: posts the ante 500
Berkowitz33: posts the ante 500
Berkowitz33: posts small blind 1000
C0rpsbal: posts big blind 2000
*** HOLE CARDS ***
Biguethi339: folds 
gwallgofddyn: folds 
Everbrun11: folds 
DR. ELDAR is disconnected 
Berkowitz33: raises 366 to 2366 and is all-in
C0rpsbal: calls 366
*** FLOP *** [Qh 9h 4s]
*** TURN *** [Qh 9h 4s] [Ts]
*** RIVER *** [Qh 9h 4s Ts] [Qs]
*** SHOW DOWN ***
Berkowitz33: shows [3s 5d] (a pair of Queens)
C0rpsbal: shows [Qd Jh] (three of a kind, Queens)
C0rpsbal collected 7232 from pot
Berkowitz33 finished the tournament in 102nd place
*** SUMMARY ***
Total pot 7232 | Rake 0 
Board [Qh 9h 4s Ts Qs]
Seat 1: C0rpsbal (big blind) showed [Qd Jh] and won (7232) with three of a kind, Queens
Seat 2: Biguethi339 folded before Flop (didn't bet)
Seat 3: gwallgofddyn folded before Flop (didn't bet)
Seat 5: Everbrun11 (button) folded before Flop (didn't bet)
Seat 6: Berkowitz33 (small blind) showed [3s 5d] and lost with a pair of Queens

PokerStars Hand #251209847215: Tournament #3769361908, $52.38+$2.62 USD Hold'em No Limit - Level XVII (1000/2000) - 2024/06/26 22:51:36 UTC [2024/06/26 18:51:36 ET]
Table '3769361908 4' 6-max Seat #1 is the button
Seat 1: C0rpsbal (25292 in chips) 
Seat 2: Biguethi339 (16400 in chips) 
Seat 3: gwallgofddyn (12776 in chips) 
Seat 4: DR. ELDAR (33745 in chips) 
Seat 5: Everbrun11 (97342 in chips) 
C0rpsbal: posts the ante 500
Biguethi339: posts the ante 500
gwallgofddyn: posts the ante 500
DR. ELDAR: posts the ante 500
Everbrun11: posts the ante 500
Biguethi339: posts small blind 1000
gwallgofddyn: posts big blind 2000
*** HOLE CARDS ***
DR. ELDAR: folds 
Everbrun11: folds 
C0rpsbal: folds 
Biguethi339: raises 13900 to 15900 and is all-in
gwallgofddyn: folds 
Uncalled bet (13900) returned to Biguethi339
Biguethi339 collected 6500 from pot
Biguethi339: doesn't show hand 
*** SUMMARY ***
Total pot 6500 | Rake 0 
Seat 1: C0rpsbal (button) folded before Flop (didn't bet)
Seat 2: Biguethi339 (small blind) collected (6500)
Seat 3: gwallgofddyn (big blind) folded before Flop
Seat 4: DR. ELDAR folded before Flop (didn't bet)
Seat 5: Everbrun11 folded before Flop (didn't bet)

PokerStars Hand #251209851160: Tournament #3769361908, $52.38+$2.62 USD Hold'em No Limit - Level XVII (1000/2000) - 2024/06/26 22:51:52 UTC [2024/06/26 18:51:52 ET]
Table '3769361908 4' 6-max Seat #2 is the button
Seat 1: C0rpsbal (24792 in chips) 
Seat 2: Biguethi339 (20400 in chips) 
Seat 3: gwallgofddyn (10276 in chips) 
Seat 4: DR. ELDAR (33245 in chips) 
Seat 5: Everbrun11 (96842 in chips) 
C0rpsbal: posts the ante 500
Biguethi339: posts the ante 500
gwallgofddyn: posts the ante 500
DR. ELDAR: posts the ante 500
Everbrun11: posts the ante 500
gwallgofddyn: posts small blind 1000
DR. ELDAR: posts big blind 2000
*** HOLE CARDS ***
Everbrun11: folds 
C0rpsbal: raises 2000 to 4000
viniperri is disconnected 
Biguethi339: folds 
gwallgofddyn: raises 5776 to 9776 and is all-in
DR. ELDAR: folds 
C0rpsbal: calls 5776
*** FLOP *** [Jd 2h Ks]
*** TURN *** [Jd 2h Ks] [5d]
*** RIVER *** [Jd 2h Ks 5d] [5s]
*** SHOW DOWN ***
gwallgofddyn: shows [3d Ac] (a pair of Fives)
C0rpsbal: shows [4c Kc] (two pair, Kings and Fives)
C0rpsbal collected 24052 from pot
gwallgofddyn finished the tournament in 94th place
*** SUMMARY ***
Total pot 24052 | Rake 0 
Board [Jd 2h Ks 5d 5s]
Seat 1: C0rpsbal showed [4c Kc] and won (24052) with two pair, Kings and Fives
Seat 2: Biguethi339 (button) folded before Flop (didn't bet)
Seat 3: gwallgofddyn (small blind) showed [3d Ac] and lost with a pair of Fives
Seat 4: DR. ELDAR (big blind) folded before Flop
Seat 5: Everbrun11 folded before Flop (didn't bet)

PokerStars Hand #251209860579: Tournament #3769361908, $52.38+$2.62 USD Hold'em No Limit - Level XVII (1000/2000) - 2024/06/26 22:52:30 UTC [2024/06/26 18:52:30 ET]
Table '3769361908 4' 6-max Seat #4 is the button
Seat 1: C0rpsbal (38568 in chips) 
Seat 2: Biguethi339 (19900 in chips) 
Seat 4: DR. ELDAR (30745 in chips) 
Seat 5: Everbrun11 (96342 in chips) 
Seat 6: viniperri (81901 in chips) 
C0rpsbal: posts the ante 500
Biguethi339: posts the ante 500
DR. ELDAR: posts the ante 500
Everbrun11: posts the ante 500
viniperri: posts the ante 500
Everbrun11: posts small blind 1000
viniperri: posts big blind 2000
*** HOLE CARDS ***
C0rpsbal: folds 
Biguethi339: raises 17400 to 19400 and is all-in
DR. ELDAR: folds 
Everbrun11: folds 
viniperri: folds 
Uncalled bet (17400) returned to Biguethi339
Biguethi339 collected 7500 from pot
Biguethi339: doesn't show hand 
*** SUMMARY ***
Total pot 7500 | Rake 0 
Seat 1: C0rpsbal folded before Flop (didn't bet)
Seat 2: Biguethi339 collected (7500)
Seat 4: DR. ELDAR (button) folded before Flop (didn't bet)
Seat 5: Everbrun11 (small blind) folded before Flop
Seat 6: viniperri (big blind) folded before Flop

PokerStars Hand #251209865684: Tournament #3769361908, $52.38+$2.62 USD Hold'em No Limit - Level XVII (1000/2000) - 2024/06/26 22:52:51 UTC [2024/06/26 18:52:51 ET]
Table '3769361908 4' 6-max Seat #5 is the button
Seat 1: C0rpsbal (38068 in chips) 
Seat 2: Biguethi339 (24900 in chips) 
Seat 3: jerdno0 (19434 in chips) 
Seat 4: DR. ELDAR (30245 in chips) 
Seat 5: Everbrun11 (94842 in chips) 
Seat 6: viniperri (79401 in chips) 
C0rpsbal: posts the ante 500
Biguethi339: posts the ante 500
jerdno0: posts the ante 500
DR. ELDAR: posts the ante 500
Everbrun11: posts the ante 500
viniperri: posts the ante 500
viniperri: posts small blind 1000
C0rpsbal: posts big blind 2000
*** HOLE CARDS ***
Biguethi339: raises 2000 to 4000
jerdno0: folds 
DR. ELDAR: folds 
Everbrun11: folds 
viniperri: folds 
C0rpsbal: calls 2000
*** FLOP *** [Jh Jd 9s]
C0rpsbal: checks 
Biguethi339: bets 2000
C0rpsbal: calls 2000
*** TURN *** [Jh Jd 9s] [Jc]
C0rpsbal: checks 
Biguethi339: bets 3200
C0rpsbal: raises 22400 to 25600
Biguethi339: folds 
Uncalled bet (22400) returned to C0rpsbal
C0rpsbal collected 22400 from pot
C0rpsbal: doesn't show hand 
*** SUMMARY ***
Total pot 22400 | Rake 0 
Board [Jh Jd 9s Jc]
Seat 1: C0rpsbal (big blind) collected (22400)
Seat 2: Biguethi339 folded on the Turn
Seat 3: jerdno0 folded before Flop (didn't bet)
Seat 4: DR. ELDAR folded before Flop (didn't bet)
Seat 5: Everbrun11 (button) folded before Flop (didn't bet)
Seat 6: viniperri (small blind) folded before Flop

PokerStars Hand #251209881021: Tournament #3769361908, $52.38+$2.62 USD Hold'em No Limit - Level XVIII (1200/2400) - 2024/06/26 22:53:54 UTC [2024/06/26 18:53:54 ET]
Table '3769361908 4' 6-max Seat #6 is the button
Seat 1: C0rpsbal (50768 in chips) 
Seat 2: Biguethi339 (15200 in chips) 
Seat 3: jerdno0 (18934 in chips) 
Seat 4: DR. ELDAR (29745 in chips) 
Seat 5: Everbrun11 (94342 in chips) 
Seat 6: viniperri (77901 in chips) 
C0rpsbal: posts the ante 600
Biguethi339: posts the ante 600
jerdno0: posts the ante 600
DR. ELDAR: posts the ante 600
Everbrun11: posts the ante 600
viniperri: posts the ante 600
C0rpsbal: posts small blind 1200
Biguethi339: posts big blind 2400
*** HOLE CARDS ***
jerdno0: folds 
DR. ELDAR: raises 2640 to 5040
Everbrun11: folds 
viniperri: folds 
C0rpsbal: folds 
Biguethi339: folds 
Uncalled bet (2640) returned to DR. ELDAR
DR. ELDAR collected 9600 from pot
DR. ELDAR: doesn't show hand 
*** SUMMARY ***
Total pot 9600 | Rake 0 
Seat 1: C0rpsbal (small blind) folded before Flop
Seat 2: Biguethi339 (big blind) folded before Flop
Seat 3: jerdno0 folded before Flop (didn't bet)
Seat 4: DR. ELDAR collected (9600)
Seat 5: Everbrun11 folded before Flop (didn't bet)
Seat 6: viniperri (button) folded before Flop (didn't bet)

PokerStars Hand #251209888262: Tournament #3769361908, $52.38+$2.62 USD Hold'em No Limit - Level XVIII (1200/2400) - 2024/06/26 22:54:24 UTC [2024/06/26 18:54:24 ET]
Table '3769361908 4' 6-max Seat #1 is the button
Seat 1: C0rpsbal (48968 in chips) 
Seat 2: Biguethi339 (12200 in chips) 
Seat 3: jerdno0 (18334 in chips) 
Seat 5: Everbrun11 (93742 in chips) 
Seat 6: viniperri (77301 in chips) 
C0rpsbal: posts the ante 600
Biguethi339: posts the ante 600
jerdno0: posts the ante 600
Everbrun11: posts the ante 600
viniperri: posts the ante 600
Biguethi339: posts small blind 1200
jerdno0: posts big blind 2400
*** HOLE CARDS ***
Everbrun11: raises 3600 to 6000
viniperri: folds 
C0rpsbal: folds 
Biguethi339: folds 
jerdno0: folds 
Uncalled bet (3600) returned to Everbrun11
Everbrun11 collected 9000 from pot
Everbrun11: doesn't show hand 
*** SUMMARY ***
Total pot 9000 | Rake 0 
Seat 1: C0rpsbal (button) folded before Flop (didn't bet)
Seat 2: Biguethi339 (small blind) folded before Flop
Seat 3: jerdno0 (big blind) folded before Flop
Seat 5: Everbrun11 collected (9000)
Seat 6: viniperri folded before Flop (didn't bet)

PokerStars Hand #251209894287: Tournament #3769361908, $52.38+$2.62 USD Hold'em No Limit - Level XVIII (1200/2400) - 2024/06/26 22:54:49 UTC [2024/06/26 18:54:49 ET]
Table '3769361908 4' 6-max Seat #2 is the button
Seat 1: C0rpsbal (48368 in chips) 
Seat 2: Biguethi339 (10400 in chips) 
Seat 3: jerdno0 (15334 in chips) 
Seat 5: Everbrun11 (99742 in chips) 
Seat 6: viniperri (76701 in chips) 
C0rpsbal: posts the ante 600
Biguethi339: posts the ante 600
jerdno0: posts the ante 600
Everbrun11: posts the ante 600
viniperri: posts the ante 600
jerdno0: posts small blind 1200
Everbrun11: posts big blind 2400
*** HOLE CARDS ***
viniperri: folds 
C0rpsbal: folds 
Biguethi339: folds 
jerdno0: raises 4800 to 7200
Lecher1991 is disconnected 
Everbrun11: raises 9600 to 16800
jerdno0: calls 7534 and is all-in
Uncalled bet (2066) returned to Everbrun11
*** FLOP *** [9s Ks Qh]
*** TURN *** [9s Ks Qh] [9h]
*** RIVER *** [9s Ks Qh 9h] [4d]
*** SHOW DOWN ***
jerdno0: shows [As Ac] (two pair, Aces and Nines)
Everbrun11: shows [Ad Th] (a pair of Nines)
jerdno0 collected 32468 from pot
*** SUMMARY ***
Total pot 32468 | Rake 0 
Board [9s Ks Qh 9h 4d]
Seat 1: C0rpsbal folded before Flop (didn't bet)
Seat 2: Biguethi339 (button) folded before Flop (didn't bet)
Seat 3: jerdno0 (small blind) showed [As Ac] and won (32468) with two pair, Aces and Nines
Seat 5: Everbrun11 (big blind) showed [Ad Th] and lost with a pair of Nines
Seat 6: viniperri folded before Flop (didn't bet)

PokerStars Hand #251209964595: Tournament #3769361908, $52.38+$2.62 USD Hold'em No Limit - Level XVIII (1200/2400) - 2024/06/26 23:01:09 UTC [2024/06/26 19:01:09 ET]
Table '3769361908 4' 6-max Seat #3 is the button
Seat 1: C0rpsbal (47768 in chips) 
Seat 2: Biguethi339 (9800 in chips) 
Seat 3: jerdno0 (32468 in chips) 
Seat 4: Lecher1991 (61456 in chips) out of hand (moved from another table into small blind)
Seat 5: Everbrun11 (84408 in chips) 
Seat 6: viniperri (76101 in chips) 
Lecher1991 will be allowed to play after the button
C0rpsbal: posts the ante 600
Biguethi339: posts the ante 600
jerdno0: posts the ante 600
Everbrun11: posts the ante 600
viniperri: posts the ante 600
Everbrun11: posts small blind 1200
viniperri: posts big blind 2400
*** HOLE CARDS ***
C0rpsbal: folds 
Biguethi339: folds 
jerdno0: folds 
Everbrun11: calls 1200
viniperri: checks 
*** FLOP *** [Qs 2h Td]
Everbrun11: checks 
viniperri: checks 
*** TURN *** [Qs 2h Td] [Kc]
Everbrun11: bets 2400
viniperri: calls 2400
*** RIVER *** [Qs 2h Td Kc] [7s]
Everbrun11: bets 8400
viniperri: folds 
Uncalled bet (8400) returned to Everbrun11
Everbrun11 collected 12600 from pot
Everbrun11: doesn't show hand 
*** SUMMARY ***
Total pot 12600 | Rake 0 
Board [Qs 2h Td Kc 7s]
Seat 1: C0rpsbal folded before Flop (didn't bet)
Seat 2: Biguethi339 folded before Flop (didn't bet)
Seat 3: jerdno0 (button) folded before Flop (didn't bet)
Seat 5: Everbrun11 (small blind) collected (12600)
Seat 6: viniperri (big blind) folded on the River

PokerStars Hand #251209981054: Tournament #3769361908, $52.38+$2.62 USD Hold'em No Limit - Level XIX (1400/2800) - 2024/06/26 23:02:21 UTC [2024/06/26 19:02:21 ET]
Table '3769361908 4' 6-max Seat #5 is the button
Seat 1: C0rpsbal (47168 in chips) 
Seat 2: Biguethi339 (9200 in chips) 
Seat 3: jerdno0 (31868 in chips) 
Seat 4: Lecher1991 (61456 in chips) 
Seat 5: Everbrun11 (91608 in chips) 
Seat 6: viniperri (70701 in chips) 
C0rpsbal: posts the ante 700
Biguethi339: posts the ante 700
jerdno0: posts the ante 700
Lecher1991: posts the ante 700
Everbrun11: posts the ante 700
viniperri: posts the ante 700
viniperri: posts small blind 1400
C0rpsbal: posts big blind 2800
*** HOLE CARDS ***
Biguethi339: raises 5700 to 8500 and is all-in
jerdno0: calls 8500
Lecher1991: folds 
Everbrun11: folds 
viniperri: folds 
C0rpsbal: folds 
*** FLOP *** [Ad Jc Ts]
*** TURN *** [Ad Jc Ts] [8d]
*** RIVER *** [Ad Jc Ts 8d] [3d]
*** SHOW DOWN ***
Biguethi339: shows [Kc Td] (a pair of Tens)
jerdno0: shows [5h Ah] (a pair of Aces)
jerdno0 collected 25400 from pot
Biguethi339 finished the tournament in 70th place
*** SUMMARY ***
Total pot 25400 | Rake 0 
Board [Ad Jc Ts 8d 3d]
Seat 1: C0rpsbal (big blind) folded before Flop
Seat 2: Biguethi339 showed [Kc Td] and lost with a pair of Tens
Seat 3: jerdno0 showed [5h Ah] and won (25400) with a pair of Aces
Seat 4: Lecher1991 folded before Flop (didn't bet)
Seat 5: Everbrun11 (button) folded before Flop (didn't bet)
Seat 6: viniperri (small blind) folded before Flop

PokerStars Hand #251209989190: Tournament #3769361908, $52.38+$2.62 USD Hold'em No Limit - Level XIX (1400/2800) - 2024/06/26 23:02:56 UTC [2024/06/26 19:02:56 ET]
Table '3769361908 4' 6-max Seat #6 is the button
Seat 1: C0rpsbal (43668 in chips) 
Seat 3: jerdno0 (48068 in chips) 
Seat 4: Lecher1991 (60756 in chips) 
Seat 5: Everbrun11 (90908 in chips) 
Seat 6: viniperri (68601 in chips) 
C0rpsbal: posts the ante 700
jerdno0: posts the ante 700
Lecher1991: posts the ante 700
Everbrun11: posts the ante 700
viniperri: posts the ante 700
C0rpsbal: posts small blind 1400
jerdno0: posts big blind 2800
*** HOLE CARDS ***
Lecher1991: folds 
Everbrun11: folds 
viniperri: folds 
C0rpsbal: raises 40168 to 42968 and is all-in
jerdno0: folds 
Uncalled bet (40168) returned to C0rpsbal
C0rpsbal collected 9100 from pot
C0rpsbal: doesn't show hand 
*** SUMMARY ***
Total pot 9100 | Rake 0 
Seat 1: C0rpsbal (small blind) collected (9100)
Seat 3: jerdno0 (big blind) folded before Flop
Seat 4: Lecher1991 folded before Flop (didn't bet)
Seat 5: Everbrun11 folded before Flop (didn't bet)
Seat 6: viniperri (button) folded before Flop (didn't bet)

PokerStars Hand #251209997527: Tournament #3769361908, $52.38+$2.62 USD Hold'em No Limit - Level XIX (1400/2800) - 2024/06/26 23:03:32 UTC [2024/06/26 19:03:32 ET]
Table '3769361908 4' 6-max Seat #1 is the button
Seat 1: C0rpsbal (49268 in chips) 
Seat 3: jerdno0 (44568 in chips) 
Seat 4: Lecher1991 (60056 in chips) 
Seat 5: Everbrun11 (90208 in chips) 
Seat 6: viniperri (67901 in chips) 
C0rpsbal: posts the ante 700
jerdno0: posts the ante 700
Lecher1991: posts the ante 700
Everbrun11: posts the ante 700
viniperri: posts the ante 700
jerdno0: posts small blind 1400
Lecher1991: posts big blind 2800
*** HOLE CARDS ***
Everbrun11: folds 
viniperri: folds 
C0rpsbal: folds 
jerdno0: folds 
Uncalled bet (1400) returned to Lecher1991
Lecher1991 collected 6300 from pot
*** SUMMARY ***
Total pot 6300 | Rake 0 
Seat 1: C0rpsbal (button) folded before Flop (didn't bet)
Seat 3: jerdno0 (small blind) folded before Flop
Seat 4: Lecher1991 (big blind) collected (6300)
Seat 5: Everbrun11 folded before Flop (didn't bet)
Seat 6: viniperri folded before Flop (didn't bet)

PokerStars Hand #251210005825: Tournament #3769361908, $52.38+$2.62 USD Hold'em No Limit - Level XIX (1400/2800) - 2024/06/26 23:04:08 UTC [2024/06/26 19:04:08 ET]
Table '3769361908 4' 6-max Seat #3 is the button
Seat 1: C0rpsbal (48568 in chips) 
Seat 3: jerdno0 (42468 in chips) 
Seat 4: Lecher1991 (64256 in chips) 
Seat 5: Everbrun11 (89508 in chips) 
Seat 6: viniperri (67201 in chips) 
C0rpsbal: posts the ante 700
jerdno0: posts the ante 700
Lecher1991: posts the ante 700
Everbrun11: posts the ante 700
viniperri: posts the ante 700
Lecher1991: posts small blind 1400
Everbrun11: posts big blind 2800
*** HOLE CARDS ***
viniperri: folds 
C0rpsbal: folds 
jerdno0: folds 
Chuckster388 is disconnected 
Lecher1991: folds 
Uncalled bet (1400) returned to Everbrun11
Everbrun11 collected 6300 from pot
Everbrun11: doesn't show hand 
*** SUMMARY ***
Total pot 6300 | Rake 0 
Seat 1: C0rpsbal folded before Flop (didn't bet)
Seat 3: jerdno0 (button) folded before Flop (didn't bet)
Seat 4: Lecher1991 (small blind) folded before Flop
Seat 5: Everbrun11 (big blind) collected (6300)
Seat 6: viniperri folded before Flop (didn't bet)

PokerStars Hand #251210010407: Tournament #3769361908, $52.38+$2.62 USD Hold'em No Limit - Level XIX (1400/2800) - 2024/06/26 23:04:27 UTC [2024/06/26 19:04:27 ET]
Table '3769361908 4' 6-max Seat #4 is the button
Seat 1: C0rpsbal (47868 in chips) 
Seat 2: Chuckster388 (58880 in chips) 
Seat 3: jerdno0 (41768 in chips) 
Seat 4: Lecher1991 (62156 in chips) 
Seat 5: Everbrun11 (93708 in chips) 
Seat 6: viniperri (66501 in chips) 
C0rpsbal: posts the ante 700
Chuckster388: posts the ante 700
jerdno0: posts the ante 700
Lecher1991: posts the ante 700
Everbrun11: posts the ante 700
viniperri: posts the ante 700
Everbrun11: posts small blind 1400
viniperri: posts big blind 2800
*** HOLE CARDS ***
C0rpsbal: folds 
Chuckster388: folds 
jerdno0: folds 
Lecher1991: folds 
Everbrun11: calls 1400
viniperri: checks 
*** FLOP *** [4h Jh 3s]
Everbrun11: bets 2800
viniperri: calls 2800
*** TURN *** [4h Jh 3s] [4d]
Everbrun11: checks 
viniperri: bets 9800
Everbrun11: calls 9800
*** RIVER *** [4h Jh 3s 4d] [9d]
Everbrun11: checks 
viniperri: bets 42000
Everbrun11: folds 
Uncalled bet (42000) returned to viniperri
viniperri collected 35000 from pot
viniperri: doesn't show hand 
*** SUMMARY ***
Total pot 35000 | Rake 0 
Board [4h Jh 3s 4d 9d]
Seat 1: C0rpsbal folded before Flop (didn't bet)
Seat 2: Chuckster388 folded before Flop (didn't bet)
Seat 3: jerdno0 folded before Flop (didn't bet)
Seat 4: Lecher1991 (button) folded before Flop (didn't bet)
Seat 5: Everbrun11 (small blind) folded on the River
Seat 6: viniperri (big blind) collected (35000)

PokerStars Hand #251210037661: Tournament #3769361908, $52.38+$2.62 USD Hold'em No Limit - Level XX (1600/3200) - 2024/06/26 23:06:26 UTC [2024/06/26 19:06:26 ET]
Table '3769361908 4' 6-max Seat #5 is the button
Seat 1: C0rpsbal (47168 in chips) 
Seat 2: Chuckster388 (58180 in chips) 
Seat 3: jerdno0 (41068 in chips) 
Seat 4: Lecher1991 (61456 in chips) 
Seat 5: Everbrun11 (77608 in chips) 
Seat 6: viniperri (85401 in chips) 
C0rpsbal: posts the ante 800
Chuckster388: posts the ante 800
jerdno0: posts the ante 800
Lecher1991: posts the ante 800
Everbrun11: posts the ante 800
viniperri: posts the ante 800
viniperri: posts small blind 1600
C0rpsbal: posts big blind 3200
*** HOLE CARDS ***
Chuckster388: folds 
jerdno0: calls 3200
Lecher1991: folds 
Everbrun11: folds 
viniperri: calls 1600
C0rpsbal: checks 
*** FLOP *** [2s 7h 3h]
viniperri: checks 
C0rpsbal: checks 
jerdno0: bets 4000
viniperri: calls 4000
C0rpsbal: folds 
*** TURN *** [2s 7h 3h] [2d]
viniperri: checks 
jerdno0: bets 8000
viniperri: folds 
Uncalled bet (8000) returned to jerdno0
jerdno0 collected 22400 from pot
*** SUMMARY ***
Total pot 22400 | Rake 0 
Board [2s 7h 3h 2d]
Seat 1: C0rpsbal (big blind) folded on the Flop
Seat 2: Chuckster388 folded before Flop (didn't bet)
Seat 3: jerdno0 collected (22400)
Seat 4: Lecher1991 folded before Flop (didn't bet)
Seat 5: Everbrun11 (button) folded before Flop (didn't bet)
Seat 6: viniperri (small blind) folded on the Turn

PokerStars Hand #251210059333: Tournament #3769361908, $52.38+$2.62 USD Hold'em No Limit - Level XX (1600/3200) - 2024/06/26 23:08:01 UTC [2024/06/26 19:08:01 ET]
Table '3769361908 4' 6-max Seat #6 is the button
Seat 1: C0rpsbal (43168 in chips) 
Seat 2: Chuckster388 (57380 in chips) 
Seat 3: jerdno0 (55468 in chips) 
Seat 4: Lecher1991 (60656 in chips) 
Seat 5: Everbrun11 (76808 in chips) 
Seat 6: viniperri (77401 in chips) 
C0rpsbal: posts the ante 800
Chuckster388: posts the ante 800
jerdno0: posts the ante 800
Lecher1991: posts the ante 800
Everbrun11: posts the ante 800
viniperri: posts the ante 800
C0rpsbal: posts small blind 1600
Chuckster388: posts big blind 3200
*** HOLE CARDS ***
jerdno0: folds 
Lecher1991: folds 
Everbrun11: folds 
viniperri: raises 3200 to 6400
C0rpsbal: folds 
Chuckster388: folds 
Uncalled bet (3200) returned to viniperri
viniperri collected 12800 from pot
viniperri: doesn't show hand 
*** SUMMARY ***
Total pot 12800 | Rake 0 
Seat 1: C0rpsbal (small blind) folded before Flop
Seat 2: Chuckster388 (big blind) folded before Flop
Seat 3: jerdno0 folded before Flop (didn't bet)
Seat 4: Lecher1991 folded before Flop (didn't bet)
Seat 5: Everbrun11 folded before Flop (didn't bet)
Seat 6: viniperri (button) collected (12800)

PokerStars Hand #251210065769: Tournament #3769361908, $52.38+$2.62 USD Hold'em No Limit - Level XXI (1800/3600) - 2024/06/26 23:08:30 UTC [2024/06/26 19:08:30 ET]
Table '3769361908 4' 6-max Seat #1 is the button
Seat 1: C0rpsbal (40768 in chips) 
Seat 2: Chuckster388 (53380 in chips) 
Seat 3: jerdno0 (54668 in chips) 
Seat 4: Lecher1991 (59856 in chips) 
Seat 5: Everbrun11 (76008 in chips) 
Seat 6: viniperri (86201 in chips) 
C0rpsbal: posts the ante 900
Chuckster388: posts the ante 900
jerdno0: posts the ante 900
Lecher1991: posts the ante 900
Everbrun11: posts the ante 900
viniperri: posts the ante 900
Chuckster388: posts small blind 1800
jerdno0: posts big blind 3600
*** HOLE CARDS ***
Lecher1991: folds 
Everbrun11: folds 
viniperri: folds 
C0rpsbal: folds 
Chuckster388: folds 
Uncalled bet (1800) returned to jerdno0
jerdno0 collected 9000 from pot
*** SUMMARY ***
Total pot 9000 | Rake 0 
Seat 1: C0rpsbal (button) folded before Flop (didn't bet)
Seat 2: Chuckster388 (small blind) folded before Flop
Seat 3: jerdno0 (big blind) collected (9000)
Seat 4: Lecher1991 folded before Flop (didn't bet)
Seat 5: Everbrun11 folded before Flop (didn't bet)
Seat 6: viniperri folded before Flop (didn't bet)

PokerStars Hand #251210070463: Tournament #3769361908, $52.38+$2.62 USD Hold'em No Limit - Level XXI (1800/3600) - 2024/06/26 23:08:52 UTC [2024/06/26 19:08:52 ET]
Table '3769361908 4' 6-max Seat #2 is the button
Seat 1: C0rpsbal (39868 in chips) 
Seat 2: Chuckster388 (50680 in chips) 
Seat 3: jerdno0 (60968 in chips) 
Seat 4: Lecher1991 (58956 in chips) 
Seat 5: Everbrun11 (75108 in chips) 
Seat 6: viniperri (85301 in chips) 
C0rpsbal: posts the ante 900
Chuckster388: posts the ante 900
jerdno0: posts the ante 900
Lecher1991: posts the ante 900
Everbrun11: posts the ante 900
viniperri: posts the ante 900
jerdno0: posts small blind 1800
Lecher1991: posts big blind 3600
*** HOLE CARDS ***
Everbrun11: folds 
viniperri: raises 3600 to 7200
C0rpsbal: folds 
Chuckster388: folds 
jerdno0: folds 
Lecher1991: folds 
Uncalled bet (3600) returned to viniperri
viniperri collected 14400 from pot
viniperri: doesn't show hand 
*** SUMMARY ***
Total pot 14400 | Rake 0 
Seat 1: C0rpsbal folded before Flop (didn't bet)
Seat 2: Chuckster388 (button) folded before Flop (didn't bet)
Seat 3: jerdno0 (small blind) folded before Flop
Seat 4: Lecher1991 (big blind) folded before Flop
Seat 5: Everbrun11 folded before Flop (didn't bet)
Seat 6: viniperri collected (14400)

PokerStars Hand #251210077169: Tournament #3769361908, $52.38+$2.62 USD Hold'em No Limit - Level XXI (1800/3600) - 2024/06/26 23:09:22 UTC [2024/06/26 19:09:22 ET]
Table '3769361908 4' 6-max Seat #3 is the button
Seat 1: C0rpsbal (38968 in chips) 
Seat 2: Chuckster388 (49780 in chips) 
Seat 3: jerdno0 (58268 in chips) 
Seat 4: Lecher1991 (54456 in chips) 
Seat 5: Everbrun11 (74208 in chips) 
Seat 6: viniperri (95201 in chips) 
C0rpsbal: posts the ante 900
Chuckster388: posts the ante 900
jerdno0: posts the ante 900
Lecher1991: posts the ante 900
Everbrun11: posts the ante 900
viniperri: posts the ante 900
Lecher1991: posts small blind 1800
Everbrun11: posts big blind 3600
*** HOLE CARDS ***
viniperri: folds 
C0rpsbal: folds 
Chuckster388: folds 
jerdno0: calls 3600
Lecher1991: calls 1800
Everbrun11: checks 
*** FLOP *** [2h 6d 3c]
Lecher1991: checks 
Everbrun11: bets 5346
jerdno0: folds 
Lecher1991: folds 
Uncalled bet (5346) returned to Everbrun11
Everbrun11 collected 16200 from pot
Everbrun11: doesn't show hand 
*** SUMMARY ***
Total pot 16200 | Rake 0 
Board [2h 6d 3c]
Seat 1: C0rpsbal folded before Flop (didn't bet)
Seat 2: Chuckster388 folded before Flop (didn't bet)
Seat 3: jerdno0 (button) folded on the Flop
Seat 4: Lecher1991 (small blind) folded on the Flop
Seat 5: Everbrun11 (big blind) collected (16200)
Seat 6: viniperri folded before Flop (didn't bet)

PokerStars Hand #251210090872: Tournament #3769361908, $52.38+$2.62 USD Hold'em No Limit - Level XXI (1800/3600) - 2024/06/26 23:10:24 UTC [2024/06/26 19:10:24 ET]
Table '3769361908 4' 6-max Seat #4 is the button
Seat 1: C0rpsbal (38068 in chips) 
Seat 2: Chuckster388 (48880 in chips) 
Seat 3: jerdno0 (53768 in chips) 
Seat 4: Lecher1991 (49956 in chips) 
Seat 5: Everbrun11 (85908 in chips) 
Seat 6: viniperri (94301 in chips) 
C0rpsbal: posts the ante 900
Chuckster388: posts the ante 900
jerdno0: posts the ante 900
Lecher1991: posts the ante 900
Everbrun11: posts the ante 900
viniperri: posts the ante 900
Everbrun11: posts small blind 1800
viniperri: posts big blind 3600
*** HOLE CARDS ***
C0rpsbal: folds 
Chuckster388: folds 
jerdno0: calls 3600
Lecher1991: folds 
Everbrun11: calls 1800
viniperri: checks 
*** FLOP *** [Qs 2h 6s]
Everbrun11: checks 
viniperri: checks 
jerdno0: bets 8100
Everbrun11: folds 
viniperri: folds 
Uncalled bet (8100) returned to jerdno0
jerdno0 collected 16200 from pot
*** SUMMARY ***
Total pot 16200 | Rake 0 
Board [Qs 2h 6s]
Seat 1: C0rpsbal folded before Flop (didn't bet)
Seat 2: Chuckster388 folded before Flop (didn't bet)
Seat 3: jerdno0 collected (16200)
Seat 4: Lecher1991 (button) folded before Flop (didn't bet)
Seat 5: Everbrun11 (small blind) folded on the Flop
Seat 6: viniperri (big blind) folded on the Flop

PokerStars Hand #251210105836: Tournament #3769361908, $52.38+$2.62 USD Hold'em No Limit - Level XXII (2000/4000) - 2024/06/26 23:11:32 UTC [2024/06/26 19:11:32 ET]
Table '3769361908 4' 6-max Seat #5 is the button
Seat 1: C0rpsbal (37168 in chips) 
Seat 2: Chuckster388 (47980 in chips) 
Seat 3: jerdno0 (65468 in chips) 
Seat 4: Lecher1991 (49056 in chips) 
Seat 5: Everbrun11 (81408 in chips) 
Seat 6: viniperri (89801 in chips) 
C0rpsbal: posts the ante 1000
Chuckster388: posts the ante 1000
jerdno0: posts the ante 1000
Lecher1991: posts the ante 1000
Everbrun11: posts the ante 1000
viniperri: posts the ante 1000
viniperri: posts small blind 2000
C0rpsbal: posts big blind 4000
*** HOLE CARDS ***
Chuckster388: folds 
jerdno0: folds 
Lecher1991: folds 
Everbrun11: folds 
viniperri: raises 84801 to 88801 and is all-in
C0rpsbal: folds 
Uncalled bet (84801) returned to viniperri
viniperri collected 14000 from pot
viniperri: doesn't show hand 
*** SUMMARY ***
Total pot 14000 | Rake 0 
Seat 1: C0rpsbal (big blind) folded before Flop
Seat 2: Chuckster388 folded before Flop (didn't bet)
Seat 3: jerdno0 folded before Flop (didn't bet)
Seat 4: Lecher1991 folded before Flop (didn't bet)
Seat 5: Everbrun11 (button) folded before Flop (didn't bet)
Seat 6: viniperri (small blind) collected (14000)

PokerStars Hand #251210113056: Tournament #3769361908, $52.38+$2.62 USD Hold'em No Limit - Level XXII (2000/4000) - 2024/06/26 23:12:06 UTC [2024/06/26 19:12:06 ET]
Table '3769361908 4' 6-max Seat #6 is the button
Seat 1: C0rpsbal (32168 in chips) 
Seat 2: Chuckster388 (46980 in chips) 
Seat 3: jerdno0 (64468 in chips) 
Seat 4: Lecher1991 (48056 in chips) 
Seat 5: Everbrun11 (80408 in chips) 
Seat 6: viniperri (98801 in chips) 
C0rpsbal: posts the ante 1000
Chuckster388: posts the ante 1000
jerdno0: posts the ante 1000
Lecher1991: posts the ante 1000
Everbrun11: posts the ante 1000
viniperri: posts the ante 1000
C0rpsbal: posts small blind 2000
Chuckster388: posts big blind 4000
*** HOLE CARDS ***
jerdno0: folds 
Lecher1991: folds 
Everbrun11: raises 4000 to 8000
viniperri: folds 
C0rpsbal: folds 
Chuckster388: calls 4000
*** FLOP *** [2c Kd 9s]
Chuckster388: checks 
Everbrun11: bets 6000
Chuckster388: calls 6000
*** TURN *** [2c Kd 9s] [5s]
Chuckster388: checks 
Everbrun11: bets 12000
Chuckster388: folds 
Uncalled bet (12000) returned to Everbrun11
Everbrun11 collected 36000 from pot
Everbrun11: doesn't show hand 
*** SUMMARY ***
Total pot 36000 | Rake 0 
Board [2c Kd 9s 5s]
Seat 1: C0rpsbal (small blind) folded before Flop
Seat 2: Chuckster388 (big blind) folded on the Turn
Seat 3: jerdno0 folded before Flop (didn't bet)
Seat 4: Lecher1991 folded before Flop (didn't bet)
Seat 5: Everbrun11 collected (36000)
Seat 6: viniperri (button) folded before Flop (didn't bet)

PokerStars Hand #251210129602: Tournament #3769361908, $52.38+$2.62 USD Hold'em No Limit - Level XXII (2000/4000) - 2024/06/26 23:13:22 UTC [2024/06/26 19:13:22 ET]
Table '3769361908 4' 6-max Seat #1 is the button
Seat 1: C0rpsbal (29168 in chips) 
Seat 2: Chuckster388 (31980 in chips) 
Seat 3: jerdno0 (63468 in chips) 
Seat 4: Lecher1991 (47056 in chips) 
Seat 5: Everbrun11 (101408 in chips) 
Seat 6: viniperri (97801 in chips) 
C0rpsbal: posts the ante 1000
Chuckster388: posts the ante 1000
jerdno0: posts the ante 1000
Lecher1991: posts the ante 1000
Everbrun11: posts the ante 1000
viniperri: posts the ante 1000
Chuckster388: posts small blind 2000
jerdno0: posts big blind 4000
*** HOLE CARDS ***
Lecher1991: folds 
Everbrun11: folds 
viniperri: raises 4000 to 8000
C0rpsbal: folds 
Chuckster388: raises 22980 to 30980 and is all-in
jerdno0: folds 
viniperri: calls 22980
*** FLOP *** [Jc 3h 8d]
*** TURN *** [Jc 3h 8d] [Tc]
*** RIVER *** [Jc 3h 8d Tc] [Ks]
*** SHOW DOWN ***
Chuckster388: shows [5c Ac] (high card Ace)
viniperri: shows [6h Ad] (high card Ace)
Chuckster388 collected 35980 from pot
viniperri collected 35980 from pot
*** SUMMARY ***
Total pot 71960 | Rake 0 
Board [Jc 3h 8d Tc Ks]
Seat 1: C0rpsbal (button) folded before Flop (didn't bet)
Seat 2: Chuckster388 (small blind) showed [5c Ac] and won (35980) with high card Ace
Seat 3: jerdno0 (big blind) folded before Flop
Seat 4: Lecher1991 folded before Flop (didn't bet)
Seat 5: Everbrun11 folded before Flop (didn't bet)
Seat 6: viniperri showed [6h Ad] and won (35980) with high card Ace

PokerStars Hand #251210139144: Tournament #3769361908, $52.38+$2.62 USD Hold'em No Limit - Level XXII (2000/4000) - 2024/06/26 23:14:07 UTC [2024/06/26 19:14:07 ET]
Table '3769361908 4' 6-max Seat #2 is the button
Seat 1: C0rpsbal (28168 in chips) 
Seat 2: Chuckster388 (35980 in chips) 
Seat 3: jerdno0 (58468 in chips) 
Seat 4: Lecher1991 (46056 in chips) 
Seat 5: Everbrun11 (100408 in chips) 
Seat 6: viniperri (101801 in chips) 
C0rpsbal: posts the ante 1000
Chuckster388: posts the ante 1000
jerdno0: posts the ante 1000
Lecher1991: posts the ante 1000
Everbrun11: posts the ante 1000
viniperri: posts the ante 1000
jerdno0: posts small blind 2000
Lecher1991: posts big blind 4000
*** HOLE CARDS ***
Everbrun11: folds 
viniperri: folds 
C0rpsbal: folds 
Chuckster388: folds 
jerdno0: folds 
Uncalled bet (2000) returned to Lecher1991
Lecher1991 collected 10000 from pot
*** SUMMARY ***
Total pot 10000 | Rake 0 
Seat 1: C0rpsbal folded before Flop (didn't bet)
Seat 2: Chuckster388 (button) folded before Flop (didn't bet)
Seat 3: jerdno0 (small blind) folded before Flop
Seat 4: Lecher1991 (big blind) collected (10000)
Seat 5: Everbrun11 folded before Flop (didn't bet)
Seat 6: viniperri folded before Flop (didn't bet)

PokerStars Hand #251210143376: Tournament #3769361908, $52.38+$2.62 USD Hold'em No Limit - Level XXIII (2500/5000) - 2024/06/26 23:14:26 UTC [2024/06/26 19:14:26 ET]
Table '3769361908 4' 6-max Seat #3 is the button
Seat 1: C0rpsbal (27168 in chips) 
Seat 2: Chuckster388 (34980 in chips) 
Seat 3: jerdno0 (55468 in chips) 
Seat 4: Lecher1991 (53056 in chips) 
Seat 5: Everbrun11 (99408 in chips) 
Seat 6: viniperri (100801 in chips) 
C0rpsbal: posts the ante 1250
Chuckster388: posts the ante 1250
jerdno0: posts the ante 1250
Lecher1991: posts the ante 1250
Everbrun11: posts the ante 1250
viniperri: posts the ante 1250
Lecher1991: posts small blind 2500
Everbrun11: posts big blind 5000
*** HOLE CARDS ***
viniperri: raises 5000 to 10000
C0rpsbal: folds 
Chuckster388: folds 
jerdno0: folds 
Lecher1991: folds 
Everbrun11: calls 5000
*** FLOP *** [Qs Jh Ks]
Everbrun11: checks 
viniperri: bets 7500
Everbrun11: calls 7500
*** TURN *** [Qs Jh Ks] [7d]
Everbrun11: checks 
viniperri: checks 
*** RIVER *** [Qs Jh Ks 7d] [4d]
Everbrun11: bets 15000
viniperri: calls 15000
*** SHOW DOWN ***
Everbrun11: shows [Ts Ah] (a straight, Ten to Ace)
viniperri: mucks hand 
Everbrun11 collected 75000 from pot
*** SUMMARY ***
Total pot 75000 | Rake 0 
Board [Qs Jh Ks 7d 4d]
Seat 1: C0rpsbal folded before Flop (didn't bet)
Seat 2: Chuckster388 folded before Flop (didn't bet)
Seat 3: jerdno0 (button) folded before Flop (didn't bet)
Seat 4: Lecher1991 (small blind) folded before Flop
Seat 5: Everbrun11 (big blind) showed [Ts Ah] and won (75000) with a straight, Ten to Ace
Seat 6: viniperri mucked

PokerStars Hand #251210158020: Tournament #3769361908, $52.38+$2.62 USD Hold'em No Limit - Level XXIII (2500/5000) - 2024/06/26 23:15:35 UTC [2024/06/26 19:15:35 ET]
Table '3769361908 4' 6-max Seat #4 is the button
Seat 1: C0rpsbal (25918 in chips) 
Seat 2: Chuckster388 (33730 in chips) 
Seat 3: jerdno0 (54218 in chips) 
Seat 4: Lecher1991 (49306 in chips) 
Seat 5: Everbrun11 (140658 in chips) 
Seat 6: viniperri (67051 in chips) 
C0rpsbal: posts the ante 1250
Chuckster388: posts the ante 1250
jerdno0: posts the ante 1250
Lecher1991: posts the ante 1250
Everbrun11: posts the ante 1250
viniperri: posts the ante 1250
Everbrun11: posts small blind 2500
viniperri: posts big blind 5000
*** HOLE CARDS ***
C0rpsbal: folds 
Chuckster388: raises 27480 to 32480 and is all-in
jerdno0: folds 
Lecher1991: folds 
Everbrun11: folds 
viniperri: calls 27480
*** FLOP *** [Qc 3c 3s]
*** TURN *** [Qc 3c 3s] [7s]
*** RIVER *** [Qc 3c 3s 7s] [9h]
*** SHOW DOWN ***
viniperri: shows [Ad 4h] (a pair of Threes)
Chuckster388: shows [2c 2s] (two pair, Threes and Deuces)
Chuckster388 collected 74960 from pot
*** SUMMARY ***
Total pot 74960 | Rake 0 
Board [Qc 3c 3s 7s 9h]
Seat 1: C0rpsbal folded before Flop (didn't bet)
Seat 2: Chuckster388 showed [2c 2s] and won (74960) with two pair, Threes and Deuces
Seat 3: jerdno0 folded before Flop (didn't bet)
Seat 4: Lecher1991 (button) folded before Flop (didn't bet)
Seat 5: Everbrun11 (small blind) folded before Flop
Seat 6: viniperri (big blind) showed [Ad 4h] and lost with a pair of Threes

PokerStars Hand #251210166273: Tournament #3769361908, $52.38+$2.62 USD Hold'em No Limit - Level XXIII (2500/5000) - 2024/06/26 23:16:13 UTC [2024/06/26 19:16:13 ET]
Table '3769361908 4' 6-max Seat #5 is the button
Seat 1: C0rpsbal (24668 in chips) 
Seat 2: Chuckster388 (74960 in chips) 
Seat 3: jerdno0 (52968 in chips) 
Seat 4: Lecher1991 (48056 in chips) 
Seat 5: Everbrun11 (136908 in chips) 
Seat 6: viniperri (33321 in chips) 
C0rpsbal: posts the ante 1250
Chuckster388: posts the ante 1250
jerdno0: posts the ante 1250
Lecher1991: posts the ante 1250
Everbrun11: posts the ante 1250
viniperri: posts the ante 1250
viniperri: posts small blind 2500
C0rpsbal: posts big blind 5000
*** HOLE CARDS ***
Chuckster388: folds 
jerdno0: folds 
Lecher1991: folds 
Everbrun11: raises 130658 to 135658 and is all-in
viniperri: folds 
C0rpsbal: folds 
Uncalled bet (130658) returned to Everbrun11
Everbrun11 collected 20000 from pot
Everbrun11: doesn't show hand 
*** SUMMARY ***
Total pot 20000 | Rake 0 
Seat 1: C0rpsbal (big blind) folded before Flop
Seat 2: Chuckster388 folded before Flop (didn't bet)
Seat 3: jerdno0 folded before Flop (didn't bet)
Seat 4: Lecher1991 folded before Flop (didn't bet)
Seat 5: Everbrun11 (button) collected (20000)
Seat 6: viniperri (small blind) folded before Flop

PokerStars Hand #251210173976: Tournament #3769361908, $52.38+$2.62 USD Hold'em No Limit - Level XXIII (2500/5000) - 2024/06/26 23:16:49 UTC [2024/06/26 19:16:49 ET]
Table '3769361908 4' 6-max Seat #6 is the button
Seat 1: C0rpsbal (18418 in chips) 
Seat 2: Chuckster388 (73710 in chips) 
Seat 3: jerdno0 (51718 in chips) 
Seat 4: Lecher1991 (46806 in chips) 
Seat 5: Everbrun11 (150658 in chips) 
Seat 6: viniperri (29571 in chips) 
C0rpsbal: posts the ante 1250
Chuckster388: posts the ante 1250
jerdno0: posts the ante 1250
Lecher1991: posts the ante 1250
Everbrun11: posts the ante 1250
viniperri: posts the ante 1250
C0rpsbal: posts small blind 2500
Chuckster388: posts big blind 5000
*** HOLE CARDS ***
jerdno0: folds 
Lecher1991: folds 
Everbrun11: folds 
viniperri: raises 23321 to 28321 and is all-in
C0rpsbal: calls 14668 and is all-in
Chuckster388: folds 
Uncalled bet (11153) returned to viniperri
*** FLOP *** [Ad Jd 2h]
*** TURN *** [Ad Jd 2h] [8h]
*** RIVER *** [Ad Jd 2h 8h] [3d]
*** SHOW DOWN ***
C0rpsbal: shows [Kc 9s] (high card Ace)
viniperri: shows [Qs 6d] (high card Ace - lower kicker)
C0rpsbal collected 46836 from pot
*** SUMMARY ***
Total pot 46836 | Rake 0 
Board [Ad Jd 2h 8h 3d]
Seat 1: C0rpsbal (small blind) showed [Kc 9s] and won (46836) with high card Ace
Seat 2: Chuckster388 (big blind) folded before Flop
Seat 3: jerdno0 folded before Flop (didn't bet)
Seat 4: Lecher1991 folded before Flop (didn't bet)
Seat 5: Everbrun11 folded before Flop (didn't bet)
Seat 6: viniperri (button) showed [Qs 6d] and lost with high card Ace

PokerStars Hand #251210181535: Tournament #3769361908, $52.38+$2.62 USD Hold'em No Limit - Level XXIV (3000/6000) - 2024/06/26 23:17:24 UTC [2024/06/26 19:17:24 ET]
Table '3769361908 4' 6-max Seat #1 is the button
Seat 1: C0rpsbal (46836 in chips) 
Seat 2: Chuckster388 (67460 in chips) 
Seat 3: jerdno0 (50468 in chips) 
Seat 4: Lecher1991 (45556 in chips) 
Seat 5: Everbrun11 (149408 in chips) 
Seat 6: viniperri (11153 in chips) 
C0rpsbal: posts the ante 1500
Chuckster388: posts the ante 1500
jerdno0: posts the ante 1500
Lecher1991: posts the ante 1500
Everbrun11: posts the ante 1500
viniperri: posts the ante 1500
Chuckster388: posts small blind 3000
jerdno0: posts big blind 6000
*** HOLE CARDS ***
Lecher1991: folds 
Everbrun11: folds 
viniperri: folds 
C0rpsbal: folds 
Chuckster388: calls 3000
jerdno0: checks 
*** FLOP *** [3d 4c 8c]
Chuckster388: bets 59960 and is all-in
jerdno0: folds 
Uncalled bet (59960) returned to Chuckster388
Chuckster388 collected 21000 from pot
Chuckster388: doesn't show hand 
*** SUMMARY ***
Total pot 21000 | Rake 0 
Board [3d 4c 8c]
Seat 1: C0rpsbal (button) folded before Flop (didn't bet)
Seat 2: Chuckster388 (small blind) collected (21000)
Seat 3: jerdno0 (big blind) folded on the Flop
Seat 4: Lecher1991 folded before Flop (didn't bet)
Seat 5: Everbrun11 folded before Flop (didn't bet)
Seat 6: viniperri folded before Flop (didn't bet)

PokerStars Hand #251210189440: Tournament #3769361908, $52.38+$2.62 USD Hold'em No Limit - Level XXIV (3000/6000) - 2024/06/26 23:18:02 UTC [2024/06/26 19:18:02 ET]
Table '3769361908 4' 6-max Seat #2 is the button
Seat 1: C0rpsbal (45336 in chips) 
Seat 2: Chuckster388 (80960 in chips) 
Seat 3: jerdno0 (42968 in chips) 
Seat 4: Lecher1991 (44056 in chips) 
Seat 5: Everbrun11 (147908 in chips) 
Seat 6: viniperri (9653 in chips) 
C0rpsbal: posts the ante 1500
Chuckster388: posts the ante 1500
jerdno0: posts the ante 1500
Lecher1991: posts the ante 1500
Everbrun11: posts the ante 1500
viniperri: posts the ante 1500
jerdno0: posts small blind 3000
Lecher1991: posts big blind 6000
*** HOLE CARDS ***
Everbrun11: folds 
viniperri: folds 
C0rpsbal: folds 
Chuckster388: folds 
jerdno0: calls 3000
Lecher1991: raises 36556 to 42556 and is all-in
jerdno0: calls 35468 and is all-in
Uncalled bet (1088) returned to Lecher1991
*** FLOP *** [5d Jd 9h]
*** TURN *** [5d Jd 9h] [4c]
*** RIVER *** [5d Jd 9h 4c] [Qh]
*** SHOW DOWN ***
jerdno0: shows [Kc Js] (a pair of Jacks)
Lecher1991: shows [7d 8c] (high card Queen)
jerdno0 collected 91936 from pot
*** SUMMARY ***
Total pot 91936 | Rake 0 
Board [5d Jd 9h 4c Qh]
Seat 1: C0rpsbal folded before Flop (didn't bet)
Seat 2: Chuckster388 (button) folded before Flop (didn't bet)
Seat 3: jerdno0 (small blind) showed [Kc Js] and won (91936) with a pair of Jacks
Seat 4: Lecher1991 (big blind) showed [7d 8c] and lost with high card Queen
Seat 5: Everbrun11 folded before Flop (didn't bet)
Seat 6: viniperri folded before Flop (didn't bet)

PokerStars Hand #251210198526: Tournament #3769361908, $52.38+$2.62 USD Hold'em No Limit - Level XXIV (3000/6000) - 2024/06/26 23:18:45 UTC [2024/06/26 19:18:45 ET]
Table '3769361908 4' 6-max Seat #3 is the button
Seat 1: C0rpsbal (43836 in chips) 
Seat 2: Chuckster388 (79460 in chips) 
Seat 3: jerdno0 (91936 in chips) 
Seat 4: Lecher1991 (1088 in chips) 
Seat 5: Everbrun11 (146408 in chips) 
Seat 6: viniperri (8153 in chips) 
C0rpsbal: posts the ante 1500
Chuckster388: posts the ante 1500
jerdno0: posts the ante 1500
Lecher1991: posts the ante 1088 and is all-in
Everbrun11: posts the ante 1500
viniperri: posts the ante 1500
Everbrun11: posts big blind 6000
*** HOLE CARDS ***
viniperri: raises 653 to 6653 and is all-in
C0rpsbal: folds 
Chuckster388: folds 
jerdno0: folds 
Everbrun11: calls 653
*** FLOP *** [Kc 8d Jh]
*** TURN *** [Kc 8d Jh] [Qd]
*** RIVER *** [Kc 8d Jh Qd] [Ac]
*** SHOW DOWN ***
Everbrun11: shows [7s Th] (a straight, Ten to Ace)
viniperri: shows [5s Kh] (a pair of Kings)
Everbrun11 collected 15366 from side pot
Lecher1991: shows [9h 3s] (high card Ace)
Everbrun11 collected 6528 from main pot
viniperri finished the tournament in 38th place and received $111.65.
Lecher1991 finished the tournament in 39th place and received $111.65.
*** SUMMARY ***
Total pot 21894 Main pot 6528. Side pot 15366. | Rake 0 
Board [Kc 8d Jh Qd Ac]
Seat 1: C0rpsbal folded before Flop (didn't bet)
Seat 2: Chuckster388 folded before Flop (didn't bet)
Seat 3: jerdno0 (button) folded before Flop (didn't bet)
Seat 4: Lecher1991 showed [9h 3s] and lost with high card Ace
Seat 5: Everbrun11 (big blind) showed [7s Th] and won (21894) with a straight, Ten to Ace
Seat 6: viniperri showed [5s Kh] and lost with a pair of Kings

PokerStars Hand #251210203595: Tournament #3769361908, $52.38+$2.62 USD Hold'em No Limit - Level XXIV (3000/6000) - 2024/06/26 23:19:09 UTC [2024/06/26 19:19:09 ET]
Table '3769361908 4' 6-max Seat #5 is the button
Seat 1: C0rpsbal (42336 in chips) 
Seat 2: Chuckster388 (77960 in chips) 
Seat 3: jerdno0 (90436 in chips) 
Seat 5: Everbrun11 (160149 in chips) 
C0rpsbal: posts the ante 1500
Chuckster388: posts the ante 1500
jerdno0: posts the ante 1500
Everbrun11: posts the ante 1500
C0rpsbal: posts small blind 3000
Chuckster388: posts big blind 6000
*** HOLE CARDS ***
jerdno0: calls 6000
Everbrun11: folds 
C0rpsbal: folds 
Chuckster388: checks 
*** FLOP *** [3d 7s Ah]
Pseudo Fruto is disconnected 
Acai Brend is disconnected 
Chuckster388: checks 
jerdno0: bets 10500
Chuckster388: folds 
Uncalled bet (10500) returned to jerdno0
jerdno0 collected 21000 from pot
*** SUMMARY ***
Total pot 21000 | Rake 0 
Board [3d 7s Ah]
Seat 1: C0rpsbal (small blind) folded before Flop
Seat 2: Chuckster388 (big blind) folded on the Flop
Seat 3: jerdno0 collected (21000)
Seat 5: Everbrun11 (button) folded before Flop (didn't bet)

PokerStars Hand #251210210677: Tournament #3769361908, $52.38+$2.62 USD Hold'em No Limit - Level XXIV (3000/6000) - 2024/06/26 23:19:43 UTC [2024/06/26 19:19:43 ET]
Table '3769361908 4' 6-max Seat #1 is the button
Seat 1: C0rpsbal (37836 in chips) 
Seat 2: Chuckster388 (70460 in chips) 
Seat 3: jerdno0 (103936 in chips) 
Seat 4: Pseudo Fruto (106930 in chips) 
Seat 5: Everbrun11 (158649 in chips) 
Seat 6: Acai Brend (29566 in chips) 
C0rpsbal: posts the ante 1500
Chuckster388: posts the ante 1500
jerdno0: posts the ante 1500
Pseudo Fruto: posts the ante 1500
Everbrun11: posts the ante 1500
Acai Brend: posts the ante 1500
Chuckster388: posts small blind 3000
jerdno0: posts big blind 6000
*** HOLE CARDS ***
Pseudo Fruto: folds 
Everbrun11: folds 
Acai Brend: raises 22066 to 28066 and is all-in
C0rpsbal: raises 8270 to 36336 and is all-in
Chuckster388: folds 
jerdno0: folds 
Uncalled bet (8270) returned to C0rpsbal
*** FLOP *** [5h 6s 3h]
*** TURN *** [5h 6s 3h] [Jd]
*** RIVER *** [5h 6s 3h Jd] [6c]
*** SHOW DOWN ***
Acai Brend: shows [Th Kh] (a pair of Sixes)
C0rpsbal: shows [7d As] (a pair of Sixes - Ace kicker)
C0rpsbal collected 74132 from pot
Acai Brend finished the tournament in 34th place and received $111.65.
*** SUMMARY ***
Total pot 74132 | Rake 0 
Board [5h 6s 3h Jd 6c]
Seat 1: C0rpsbal (button) showed [7d As] and won (74132) with a pair of Sixes
Seat 2: Chuckster388 (small blind) folded before Flop
Seat 3: jerdno0 (big blind) folded before Flop
Seat 4: Pseudo Fruto folded before Flop (didn't bet)
Seat 5: Everbrun11 folded before Flop (didn't bet)
Seat 6: Acai Brend showed [Th Kh] and lost with a pair of Sixes

PokerStars Hand #251210220025: Tournament #3769361908, $52.38+$2.62 USD Hold'em No Limit - Level XXV (3500/7000) - 2024/06/26 23:20:28 UTC [2024/06/26 19:20:28 ET]
Table '3769361908 4' 6-max Seat #2 is the button
Seat 1: C0rpsbal (82402 in chips) 
Seat 2: Chuckster388 (65960 in chips) 
Seat 3: jerdno0 (96436 in chips) 
Seat 4: Pseudo Fruto (105430 in chips) 
Seat 5: Everbrun11 (157149 in chips) 
C0rpsbal: posts the ante 1750
Chuckster388: posts the ante 1750
jerdno0: posts the ante 1750
Pseudo Fruto: posts the ante 1750
Everbrun11: posts the ante 1750
jerdno0: posts small blind 3500
Pseudo Fruto: posts big blind 7000
*** HOLE CARDS ***
Everbrun11: folds 
C0rpsbal: folds 
Chuckster388: folds 
jerdno0: calls 3500
Pseudo Fruto: checks 
*** FLOP *** [Ah Ad 9h]
jerdno0: bets 7000
Pseudo Fruto: folds 
Uncalled bet (7000) returned to jerdno0
jerdno0 collected 22750 from pot
*** SUMMARY ***
Total pot 22750 | Rake 0 
Board [Ah Ad 9h]
Seat 1: C0rpsbal folded before Flop (didn't bet)
Seat 2: Chuckster388 (button) folded before Flop (didn't bet)
Seat 3: jerdno0 (small blind) collected (22750)
Seat 4: Pseudo Fruto (big blind) folded on the Flop
Seat 5: Everbrun11 folded before Flop (didn't bet)

PokerStars Hand #251210231895: Tournament #3769361908, $52.38+$2.62 USD Hold'em No Limit - Level XXV (3500/7000) - 2024/06/26 23:21:25 UTC [2024/06/26 19:21:25 ET]
Table '3769361908 4' 6-max Seat #3 is the button
Seat 1: C0rpsbal (80652 in chips) 
Seat 2: Chuckster388 (64210 in chips) 
Seat 3: jerdno0 (110436 in chips) 
Seat 4: Pseudo Fruto (96680 in chips) 
Seat 5: Everbrun11 (155399 in chips) 
Seat 6: VxVendetta00 (146970 in chips) 
C0rpsbal: posts the ante 1750
Chuckster388: posts the ante 1750
jerdno0: posts the ante 1750
Pseudo Fruto: posts the ante 1750
Everbrun11: posts the ante 1750
VxVendetta00: posts the ante 1750
Pseudo Fruto: posts small blind 3500
Everbrun11: posts big blind 7000
*** HOLE CARDS ***
VxVendetta00: folds 
C0rpsbal: folds 
Chuckster388: folds 
jerdno0: calls 7000
Pseudo Fruto: folds 
Everbrun11: checks 
*** FLOP *** [9s 5d 6c]
Everbrun11: checks 
jerdno0: bets 7000
Everbrun11: calls 7000
*** TURN *** [9s 5d 6c] [Kc]
Everbrun11: checks 
jerdno0: checks 
*** RIVER *** [9s 5d 6c Kc] [Qd]
Everbrun11: bets 13860
jerdno0: folds 
Uncalled bet (13860) returned to Everbrun11
Everbrun11 collected 42000 from pot
Everbrun11: doesn't show hand 
*** SUMMARY ***
Total pot 42000 | Rake 0 
Board [9s 5d 6c Kc Qd]
Seat 1: C0rpsbal folded before Flop (didn't bet)
Seat 2: Chuckster388 folded before Flop (didn't bet)
Seat 3: jerdno0 (button) folded on the River
Seat 4: Pseudo Fruto (small blind) folded before Flop
Seat 5: Everbrun11 (big blind) collected (42000)
Seat 6: VxVendetta00 folded before Flop (didn't bet)

PokerStars Hand #251210244527: Tournament #3769361908, $52.38+$2.62 USD Hold'em No Limit - Level XXV (3500/7000) - 2024/06/26 23:22:26 UTC [2024/06/26 19:22:26 ET]
Table '3769361908 4' 6-max Seat #4 is the button
Seat 1: C0rpsbal (78902 in chips) 
Seat 2: Chuckster388 (62460 in chips) 
Seat 3: jerdno0 (94686 in chips) 
Seat 4: Pseudo Fruto (91430 in chips) 
Seat 5: Everbrun11 (181649 in chips) 
Seat 6: VxVendetta00 (145220 in chips) 
C0rpsbal: posts the ante 1750
Chuckster388: posts the ante 1750
jerdno0: posts the ante 1750
Pseudo Fruto: posts the ante 1750
Everbrun11: posts the ante 1750
VxVendetta00: posts the ante 1750
Everbrun11: posts small blind 3500
VxVendetta00: posts big blind 7000
*** HOLE CARDS ***
C0rpsbal: folds 
Chuckster388: folds 
jerdno0: folds 
Pseudo Fruto: folds 
Everbrun11: raises 17500 to 24500
VxVendetta00: folds 
Uncalled bet (17500) returned to Everbrun11
Everbrun11 collected 24500 from pot
Everbrun11: doesn't show hand 
*** SUMMARY ***
Total pot 24500 | Rake 0 
Seat 1: C0rpsbal folded before Flop (didn't bet)
Seat 2: Chuckster388 folded before Flop (didn't bet)
Seat 3: jerdno0 folded before Flop (didn't bet)
Seat 4: Pseudo Fruto (button) folded before Flop (didn't bet)
Seat 5: Everbrun11 (small blind) collected (24500)
Seat 6: VxVendetta00 (big blind) folded before Flop

PokerStars Hand #251210250600: Tournament #3769361908, $52.38+$2.62 USD Hold'em No Limit - Level XXV (3500/7000) - 2024/06/26 23:22:55 UTC [2024/06/26 19:22:55 ET]
Table '3769361908 4' 6-max Seat #5 is the button
Seat 1: C0rpsbal (77152 in chips) 
Seat 2: Chuckster388 (60710 in chips) 
Seat 4: Pseudo Fruto (89680 in chips) 
Seat 5: Everbrun11 (197399 in chips) 
Seat 6: VxVendetta00 (136470 in chips) 
C0rpsbal: posts the ante 1750
Chuckster388: posts the ante 1750
Pseudo Fruto: posts the ante 1750
Everbrun11: posts the ante 1750
VxVendetta00: posts the ante 1750
VxVendetta00: posts small blind 3500
C0rpsbal: posts big blind 7000
*** HOLE CARDS ***
Chuckster388: folds 
Pseudo Fruto: raises 80930 to 87930 and is all-in
Everbrun11: folds 
VxVendetta00: folds 
C0rpsbal: folds 
Uncalled bet (80930) returned to Pseudo Fruto
Pseudo Fruto collected 26250 from pot
Pseudo Fruto: doesn't show hand 
*** SUMMARY ***
Total pot 26250 | Rake 0 
Seat 1: C0rpsbal (big blind) folded before Flop
Seat 2: Chuckster388 folded before Flop (didn't bet)
Seat 4: Pseudo Fruto collected (26250)
Seat 5: Everbrun11 (button) folded before Flop (didn't bet)
Seat 6: VxVendetta00 (small blind) folded before Flop

PokerStars Hand #251210254434: Tournament #3769361908, $52.38+$2.62 USD Hold'em No Limit - Level XXV (3500/7000) - 2024/06/26 23:23:14 UTC [2024/06/26 19:23:14 ET]
Table '3769361908 4' 6-max Seat #6 is the button
Seat 1: C0rpsbal (68402 in chips) 
Seat 2: Chuckster388 (58960 in chips) 
Seat 4: Pseudo Fruto (107180 in chips) 
Seat 5: Everbrun11 (195649 in chips) 
Seat 6: VxVendetta00 (131220 in chips) 
C0rpsbal: posts the ante 1750
Chuckster388: posts the ante 1750
Pseudo Fruto: posts the ante 1750
Everbrun11: posts the ante 1750
VxVendetta00: posts the ante 1750
C0rpsbal: posts small blind 3500
Chuckster388: posts big blind 7000
*** HOLE CARDS ***
Pseudo Fruto: folds 
Everbrun11: raises 7000 to 14000
VxVendetta00: folds 
C0rpsbal: folds 
Chuckster388: folds 
Uncalled bet (7000) returned to Everbrun11
Everbrun11 collected 26250 from pot
Everbrun11: doesn't show hand 
*** SUMMARY ***
Total pot 26250 | Rake 0 
Seat 1: C0rpsbal (small blind) folded before Flop
Seat 2: Chuckster388 (big blind) folded before Flop
Seat 4: Pseudo Fruto folded before Flop (didn't bet)
Seat 5: Everbrun11 collected (26250)
Seat 6: VxVendetta00 (button) folded before Flop (didn't bet)

PokerStars Hand #251210261229: Tournament #3769361908, $52.38+$2.62 USD Hold'em No Limit - Level XXVI (4000/8000) - 2024/06/26 23:23:47 UTC [2024/06/26 19:23:47 ET]
Table '3769361908 4' 6-max Seat #1 is the button
Seat 1: C0rpsbal (63152 in chips) 
Seat 2: Chuckster388 (50210 in chips) 
Seat 4: Pseudo Fruto (105430 in chips) 
Seat 5: Everbrun11 (213149 in chips) 
Seat 6: VxVendetta00 (129470 in chips) 
C0rpsbal: posts the ante 2000
Chuckster388: posts the ante 2000
Pseudo Fruto: posts the ante 2000
Everbrun11: posts the ante 2000
VxVendetta00: posts the ante 2000
Chuckster388: posts small blind 4000
Pseudo Fruto: posts big blind 8000
*** HOLE CARDS ***
Everbrun11: raises 8000 to 16000
VxVendetta00: folds 
C0rpsbal: folds 
Chuckster388: folds 
Pseudo Fruto: folds 
Uncalled bet (8000) returned to Everbrun11
Everbrun11 collected 30000 from pot
Everbrun11: doesn't show hand 
*** SUMMARY ***
Total pot 30000 | Rake 0 
Seat 1: C0rpsbal (button) folded before Flop (didn't bet)
Seat 2: Chuckster388 (small blind) folded before Flop
Seat 4: Pseudo Fruto (big blind) folded before Flop
Seat 5: Everbrun11 collected (30000)
Seat 6: VxVendetta00 folded before Flop (didn't bet)

PokerStars Hand #251210265582: Tournament #3769361908, $52.38+$2.62 USD Hold'em No Limit - Level XXVI (4000/8000) - 2024/06/26 23:24:08 UTC [2024/06/26 19:24:08 ET]
Table '3769361908 4' 6-max Seat #2 is the button
Seat 1: C0rpsbal (61152 in chips) 
Seat 2: Chuckster388 (44210 in chips) 
Seat 4: Pseudo Fruto (95430 in chips) 
Seat 5: Everbrun11 (233149 in chips) 
Seat 6: VxVendetta00 (127470 in chips) 
C0rpsbal: posts the ante 2000
Chuckster388: posts the ante 2000
Pseudo Fruto: posts the ante 2000
Everbrun11: posts the ante 2000
VxVendetta00: posts the ante 2000
Pseudo Fruto: posts small blind 4000
Everbrun11: posts big blind 8000
*** HOLE CARDS ***
VxVendetta00: folds 
C0rpsbal: folds 
Chuckster388: folds 
Pseudo Fruto: calls 4000
Everbrun11: checks 
*** FLOP *** [Kh 9s 4h]
Pseudo Fruto: bets 8000
Everbrun11: folds 
Uncalled bet (8000) returned to Pseudo Fruto
Pseudo Fruto collected 26000 from pot
Pseudo Fruto: doesn't show hand 
*** SUMMARY ***
Total pot 26000 | Rake 0 
Board [Kh 9s 4h]
Seat 1: C0rpsbal folded before Flop (didn't bet)
Seat 2: Chuckster388 (button) folded before Flop (didn't bet)
Seat 4: Pseudo Fruto (small blind) collected (26000)
Seat 5: Everbrun11 (big blind) folded on the Flop
Seat 6: VxVendetta00 folded before Flop (didn't bet)

PokerStars Hand #251210269356: Tournament #3769361908, $52.38+$2.62 USD Hold'em No Limit - Level XXVI (4000/8000) - 2024/06/26 23:24:26 UTC [2024/06/26 19:24:26 ET]
Table '3769361908 4' 6-max Seat #4 is the button
Seat 1: C0rpsbal (59152 in chips) 
Seat 2: Chuckster388 (42210 in chips) 
Seat 4: Pseudo Fruto (111430 in chips) 
Seat 5: Everbrun11 (223149 in chips) 
Seat 6: VxVendetta00 (125470 in chips) 
C0rpsbal: posts the ante 2000
Chuckster388: posts the ante 2000
Pseudo Fruto: posts the ante 2000
Everbrun11: posts the ante 2000
VxVendetta00: posts the ante 2000
Everbrun11: posts small blind 4000
VxVendetta00: posts big blind 8000
*** HOLE CARDS ***
C0rpsbal: folds 
Chuckster388: folds 
Pseudo Fruto: folds 
Everbrun11: raises 16000 to 24000
VxVendetta00: folds 
Uncalled bet (16000) returned to Everbrun11
Everbrun11 collected 26000 from pot
Everbrun11: doesn't show hand 
*** SUMMARY ***
Total pot 26000 | Rake 0 
Seat 1: C0rpsbal folded before Flop (didn't bet)
Seat 2: Chuckster388 folded before Flop (didn't bet)
Seat 4: Pseudo Fruto (button) folded before Flop (didn't bet)
Seat 5: Everbrun11 (small blind) collected (26000)
Seat 6: VxVendetta00 (big blind) folded before Flop

PokerStars Hand #251210275101: Tournament #3769361908, $52.38+$2.62 USD Hold'em No Limit - Level XXVI (4000/8000) - 2024/06/26 23:24:54 UTC [2024/06/26 19:24:54 ET]
Table '3769361908 4' 6-max Seat #5 is the button
Seat 1: C0rpsbal (57152 in chips) 
Seat 2: Chuckster388 (40210 in chips) 
Seat 4: Pseudo Fruto (109430 in chips) 
Seat 5: Everbrun11 (239149 in chips) 
Seat 6: VxVendetta00 (115470 in chips) 
C0rpsbal: posts the ante 2000
Chuckster388: posts the ante 2000
Pseudo Fruto: posts the ante 2000
Everbrun11: posts the ante 2000
VxVendetta00: posts the ante 2000
VxVendetta00: posts small blind 4000
C0rpsbal: posts big blind 8000
*** HOLE CARDS ***
Chuckster388: folds 
Pseudo Fruto: folds 
Everbrun11: folds 
VxVendetta00: folds 
Uncalled bet (4000) returned to C0rpsbal
C0rpsbal collected 18000 from pot
C0rpsbal: doesn't show hand 
*** SUMMARY ***
Total pot 18000 | Rake 0 
Seat 1: C0rpsbal (big blind) collected (18000)
Seat 2: Chuckster388 folded before Flop (didn't bet)
Seat 4: Pseudo Fruto folded before Flop (didn't bet)
Seat 5: Everbrun11 (button) folded before Flop (didn't bet)
Seat 6: VxVendetta00 (small blind) folded before Flop

PokerStars Hand #251210278059: Tournament #3769361908, $52.38+$2.62 USD Hold'em No Limit - Level XXVI (4000/8000) - 2024/06/26 23:25:09 UTC [2024/06/26 19:25:09 ET]
Table '3769361908 4' 6-max Seat #6 is the button
Seat 1: C0rpsbal (69152 in chips) 
Seat 2: Chuckster388 (38210 in chips) 
Seat 4: Pseudo Fruto (107430 in chips) 
Seat 5: Everbrun11 (237149 in chips) 
Seat 6: VxVendetta00 (109470 in chips) 
C0rpsbal: posts the ante 2000
Chuckster388: posts the ante 2000
Pseudo Fruto: posts the ante 2000
Everbrun11: posts the ante 2000
VxVendetta00: posts the ante 2000
C0rpsbal: posts small blind 4000
Chuckster388: posts big blind 8000
*** HOLE CARDS ***
Pseudo Fruto: folds 
Everbrun11: folds 
VxVendetta00: folds 
C0rpsbal: folds 
Uncalled bet (4000) returned to Chuckster388
Chuckster388 collected 18000 from pot
Chuckster388: doesn't show hand 
*** SUMMARY ***
Total pot 18000 | Rake 0 
Seat 1: C0rpsbal (small blind) folded before Flop
Seat 2: Chuckster388 (big blind) collected (18000)
Seat 4: Pseudo Fruto folded before Flop (didn't bet)
Seat 5: Everbrun11 folded before Flop (didn't bet)
Seat 6: VxVendetta00 (button) folded before Flop (didn't bet)

PokerStars Hand #251210281026: Tournament #3769361908, $52.38+$2.62 USD Hold'em No Limit - Level XXVI (4000/8000) - 2024/06/26 23:25:23 UTC [2024/06/26 19:25:23 ET]
Table '3769361908 4' 6-max Seat #1 is the button
Seat 1: C0rpsbal (63152 in chips) 
Seat 2: Chuckster388 (50210 in chips) 
Seat 4: Pseudo Fruto (105430 in chips) 
Seat 5: Everbrun11 (235149 in chips) 
Seat 6: VxVendetta00 (107470 in chips) 
C0rpsbal: posts the ante 2000
Chuckster388: posts the ante 2000
Pseudo Fruto: posts the ante 2000
Everbrun11: posts the ante 2000
VxVendetta00: posts the ante 2000
Chuckster388: posts small blind 4000
Pseudo Fruto: posts big blind 8000
*** HOLE CARDS ***
Everbrun11: folds 
VxVendetta00: folds 
C0rpsbal: folds 
Chuckster388: raises 40210 to 48210 and is all-in
Pseudo Fruto: calls 40210
*** FLOP *** [8s 7c Js]
*** TURN *** [8s 7c Js] [Qc]
*** RIVER *** [8s 7c Js Qc] [9s]
*** SHOW DOWN ***
Chuckster388: shows [5d Th] (a straight, Eight to Queen)
Pseudo Fruto: shows [Ks 3h] (high card King)
Chuckster388 collected 106420 from pot
*** SUMMARY ***
Total pot 106420 | Rake 0 
Board [8s 7c Js Qc 9s]
Seat 1: C0rpsbal (button) folded before Flop (didn't bet)
Seat 2: Chuckster388 (small blind) showed [5d Th] and won (106420) with a straight, Eight to Queen
Seat 4: Pseudo Fruto (big blind) showed [Ks 3h] and lost with high card King
Seat 5: Everbrun11 folded before Flop (didn't bet)
Seat 6: VxVendetta00 folded before Flop (didn't bet)

PokerStars Hand #251210285946: Tournament #3769361908, $52.38+$2.62 USD Hold'em No Limit - Level XXVI (4000/8000) - 2024/06/26 23:25:47 UTC [2024/06/26 19:25:47 ET]
Table '3769361908 4' 6-max Seat #2 is the button
Seat 1: C0rpsbal (61152 in chips) 
Seat 2: Chuckster388 (106420 in chips) 
Seat 4: Pseudo Fruto (55220 in chips) 
Seat 5: Everbrun11 (233149 in chips) 
Seat 6: VxVendetta00 (105470 in chips) 
C0rpsbal: posts the ante 2000
Chuckster388: posts the ante 2000
Pseudo Fruto: posts the ante 2000
Everbrun11: posts the ante 2000
VxVendetta00: posts the ante 2000
Pseudo Fruto: posts small blind 4000
Everbrun11: posts big blind 8000
*** HOLE CARDS ***
VxVendetta00: folds 
C0rpsbal: raises 8000 to 16000
Chuckster388: folds 
Pseudo Fruto: folds 
Everbrun11: calls 8000
*** FLOP *** [3h Qc 5h]
Everbrun11: checks 
C0rpsbal: bets 8000
Everbrun11: folds 
Uncalled bet (8000) returned to C0rpsbal
C0rpsbal collected 46000 from pot
C0rpsbal: doesn't show hand 
*** SUMMARY ***
Total pot 46000 | Rake 0 
Board [3h Qc 5h]
Seat 1: C0rpsbal collected (46000)
Seat 2: Chuckster388 (button) folded before Flop (didn't bet)
Seat 4: Pseudo Fruto (small blind) folded before Flop
Seat 5: Everbrun11 (big blind) folded on the Flop
Seat 6: VxVendetta00 folded before Flop (didn't bet)

PokerStars Hand #251210294016: Tournament #3769361908, $52.38+$2.62 USD Hold'em No Limit - Level XXVII (4500/9000) - 2024/06/26 23:26:27 UTC [2024/06/26 19:26:27 ET]
Table '3769361908 4' 6-max Seat #4 is the button
Seat 1: C0rpsbal (89152 in chips) 
Seat 2: Chuckster388 (104420 in chips) 
Seat 4: Pseudo Fruto (49220 in chips) 
Seat 5: Everbrun11 (215149 in chips) 
Seat 6: VxVendetta00 (103470 in chips) 
C0rpsbal: posts the ante 2250
Chuckster388: posts the ante 2250
Pseudo Fruto: posts the ante 2250
Everbrun11: posts the ante 2250
VxVendetta00: posts the ante 2250
Everbrun11: posts small blind 4500
VxVendetta00: posts big blind 9000
*** HOLE CARDS ***
C0rpsbal: raises 77902 to 86902 and is all-in
Chuckster388: folds 
Pseudo Fruto: folds 
Everbrun11: folds 
VxVendetta00: folds 
Uncalled bet (77902) returned to C0rpsbal
C0rpsbal collected 33750 from pot
C0rpsbal: doesn't show hand 
*** SUMMARY ***
Total pot 33750 | Rake 0 
Seat 1: C0rpsbal collected (33750)
Seat 2: Chuckster388 folded before Flop (didn't bet)
Seat 4: Pseudo Fruto (button) folded before Flop (didn't bet)
Seat 5: Everbrun11 (small blind) folded before Flop
Seat 6: VxVendetta00 (big blind) folded before Flop

PokerStars Hand #251210298383: Tournament #3769361908, $52.38+$2.62 USD Hold'em No Limit - Level XXVII (4500/9000) - 2024/06/26 23:26:48 UTC [2024/06/26 19:26:48 ET]
Table '3769361908 4' 6-max Seat #5 is the button
Seat 1: C0rpsbal (111652 in chips) 
Seat 2: Chuckster388 (102170 in chips) 
Seat 4: Pseudo Fruto (46970 in chips) 
Seat 5: Everbrun11 (208399 in chips) 
Seat 6: VxVendetta00 (92220 in chips) 
C0rpsbal: posts the ante 2250
Chuckster388: posts the ante 2250
Pseudo Fruto: posts the ante 2250
Everbrun11: posts the ante 2250
VxVendetta00: posts the ante 2250
VxVendetta00: posts small blind 4500
C0rpsbal: posts big blind 9000
*** HOLE CARDS ***
Chuckster388: folds 
Pseudo Fruto: folds 
Everbrun11: raises 197149 to 206149 and is all-in
VxVendetta00: folds 
C0rpsbal: folds 
Uncalled bet (197149) returned to Everbrun11
Everbrun11 collected 33750 from pot
Everbrun11: doesn't show hand 
*** SUMMARY ***
Total pot 33750 | Rake 0 
Seat 1: C0rpsbal (big blind) folded before Flop
Seat 2: Chuckster388 folded before Flop (didn't bet)
Seat 4: Pseudo Fruto folded before Flop (didn't bet)
Seat 5: Everbrun11 (button) collected (33750)
Seat 6: VxVendetta00 (small blind) folded before Flop

PokerStars Hand #251210302507: Tournament #3769361908, $52.38+$2.62 USD Hold'em No Limit - Level XXVII (4500/9000) - 2024/06/26 23:27:09 UTC [2024/06/26 19:27:09 ET]
Table '3769361908 4' 6-max Seat #6 is the button
Seat 1: C0rpsbal (100402 in chips) 
Seat 2: Chuckster388 (99920 in chips) 
Seat 4: Pseudo Fruto (44720 in chips) 
Seat 5: Everbrun11 (230899 in chips) 
Seat 6: VxVendetta00 (85470 in chips) 
C0rpsbal: posts the ante 2250
Chuckster388: posts the ante 2250
Pseudo Fruto: posts the ante 2250
Everbrun11: posts the ante 2250
VxVendetta00: posts the ante 2250
C0rpsbal: posts small blind 4500
Chuckster388: posts big blind 9000
*** HOLE CARDS ***
Pseudo Fruto: raises 33470 to 42470 and is all-in
Everbrun11: folds 
VxVendetta00: folds 
C0rpsbal: raises 55682 to 98152 and is all-in
Chuckster388: folds 
Uncalled bet (55682) returned to C0rpsbal
*** FLOP *** [9c 5s Td]
*** TURN *** [9c 5s Td] [3h]
*** RIVER *** [9c 5s Td 3h] [4h]
*** SHOW DOWN ***
C0rpsbal: shows [Ah Ad] (a pair of Aces)
Pseudo Fruto: shows [Kc 7c] (high card King)
C0rpsbal collected 105190 from pot
Pseudo Fruto finished the tournament in 26th place and received $135.63.
MjLK MAN is disconnected 
aapetrone91 is disconnected 
*** SUMMARY ***
Total pot 105190 | Rake 0 
Board [9c 5s Td 3h 4h]
Seat 1: C0rpsbal (small blind) showed [Ah Ad] and won (105190) with a pair of Aces
Seat 2: Chuckster388 (big blind) folded before Flop
Seat 4: Pseudo Fruto showed [Kc 7c] and lost with high card King
Seat 5: Everbrun11 folded before Flop (didn't bet)
Seat 6: VxVendetta00 (button) folded before Flop (didn't bet)

PokerStars Hand #251210311580: Tournament #3769361908, $52.38+$2.62 USD Hold'em No Limit - Level XXVII (4500/9000) - 2024/06/26 23:27:54 UTC [2024/06/26 19:27:54 ET]
Table '3769361908 4' 6-max Seat #1 is the button
Seat 1: C0rpsbal (160872 in chips) 
Seat 2: Chuckster388 (88670 in chips) 
Seat 3: MjLK MAN (268227 in chips) 
Seat 4: aapetrone91 (186848 in chips) 
Seat 5: Everbrun11 (228649 in chips) 
Seat 6: VxVendetta00 (83220 in chips) 
C0rpsbal: posts the ante 2250
Chuckster388: posts the ante 2250
MjLK MAN: posts the ante 2250
aapetrone91: posts the ante 2250
Everbrun11: posts the ante 2250
VxVendetta00: posts the ante 2250
Chuckster388: posts small blind 4500
MjLK MAN: posts big blind 9000
*** HOLE CARDS ***
aapetrone91: folds 
Everbrun11: folds 
VxVendetta00: raises 71970 to 80970 and is all-in
C0rpsbal: folds 
Chuckster388: folds 
MjLK MAN has timed out
MjLK MAN: folds 
MjLK MAN is sitting out
Uncalled bet (71970) returned to VxVendetta00
VxVendetta00 collected 36000 from pot
MjLK MAN has returned
*** SUMMARY ***
Total pot 36000 | Rake 0 
Seat 1: C0rpsbal (button) folded before Flop (didn't bet)
Seat 2: Chuckster388 (small blind) folded before Flop
Seat 3: MjLK MAN (big blind) folded before Flop
Seat 4: aapetrone91 folded before Flop (didn't bet)
Seat 5: Everbrun11 folded before Flop (didn't bet)
Seat 6: VxVendetta00 collected (36000)

PokerStars Hand #251210317409: Tournament #3769361908, $52.38+$2.62 USD Hold'em No Limit - Level XXVII (4500/9000) - 2024/06/26 23:28:23 UTC [2024/06/26 19:28:23 ET]
Table '3769361908 4' 6-max Seat #2 is the button
Seat 1: C0rpsbal (158622 in chips) 
Seat 2: Chuckster388 (81920 in chips) 
Seat 3: MjLK MAN (256977 in chips) 
Seat 4: aapetrone91 (184598 in chips) 
Seat 5: Everbrun11 (226399 in chips) 
Seat 6: VxVendetta00 (107970 in chips) 
C0rpsbal: posts the ante 2250
Chuckster388: posts the ante 2250
MjLK MAN: posts the ante 2250
aapetrone91: posts the ante 2250
Everbrun11: posts the ante 2250
VxVendetta00: posts the ante 2250
MjLK MAN: posts small blind 4500
aapetrone91: posts big blind 9000
*** HOLE CARDS ***
Everbrun11: folds 
VxVendetta00: folds 
C0rpsbal: folds 
Chuckster388: folds 
MjLK MAN has timed out
MjLK MAN: folds 
MjLK MAN is sitting out
Uncalled bet (4500) returned to aapetrone91
aapetrone91 collected 22500 from pot
MjLK MAN has returned
*** SUMMARY ***
Total pot 22500 | Rake 0 
Seat 1: C0rpsbal folded before Flop (didn't bet)
Seat 2: Chuckster388 (button) folded before Flop (didn't bet)
Seat 3: MjLK MAN (small blind) folded before Flop
Seat 4: aapetrone91 (big blind) collected (22500)
Seat 5: Everbrun11 folded before Flop (didn't bet)
Seat 6: VxVendetta00 folded before Flop (didn't bet)

PokerStars Hand #251210323162: Tournament #3769361908, $52.38+$2.62 USD Hold'em No Limit - Level XXVII (4500/9000) - 2024/06/26 23:28:52 UTC [2024/06/26 19:28:52 ET]
Table '3769361908 4' 6-max Seat #3 is the button
Seat 1: C0rpsbal (156372 in chips) 
Seat 2: Chuckster388 (79670 in chips) 
Seat 3: MjLK MAN (250227 in chips) 
Seat 4: aapetrone91 (200348 in chips) 
Seat 5: Everbrun11 (224149 in chips) 
Seat 6: VxVendetta00 (105720 in chips) 
C0rpsbal: posts the ante 2250
Chuckster388: posts the ante 2250
MjLK MAN: posts the ante 2250
aapetrone91: posts the ante 2250
Everbrun11: posts the ante 2250
VxVendetta00: posts the ante 2250
aapetrone91: posts small blind 4500
Everbrun11: posts big blind 9000
*** HOLE CARDS ***
VxVendetta00: folds 
C0rpsbal: raises 9000 to 18000
Chuckster388: folds 
MjLK MAN has timed out
MjLK MAN: folds 
MjLK MAN is sitting out
MjLK MAN has returned
aapetrone91: folds 
Everbrun11: calls 9000
*** FLOP *** [3s 5c Ad]
Everbrun11: checks 
C0rpsbal: bets 16200
Everbrun11: raises 19800 to 36000
C0rpsbal: calls 19800
*** TURN *** [3s 5c Ad] [4d]
Everbrun11: bets 40500
C0rpsbal: folds 
Uncalled bet (40500) returned to Everbrun11
Everbrun11 collected 126000 from pot
Everbrun11: doesn't show hand 
*** SUMMARY ***
Total pot 126000 | Rake 0 
Board [3s 5c Ad 4d]
Seat 1: C0rpsbal folded on the Turn
Seat 2: Chuckster388 folded before Flop (didn't bet)
Seat 3: MjLK MAN (button) folded before Flop (didn't bet)
Seat 4: aapetrone91 (small blind) folded before Flop
Seat 5: Everbrun11 (big blind) collected (126000)
Seat 6: VxVendetta00 folded before Flop (didn't bet)

PokerStars Hand #251210340729: Tournament #3769361908, $52.38+$2.62 USD Hold'em No Limit - Level XXVIII (5000/10000) - 2024/06/26 23:30:20 UTC [2024/06/26 19:30:20 ET]
Table '3769361908 4' 6-max Seat #4 is the button
Seat 1: C0rpsbal (100122 in chips) 
Seat 2: Chuckster388 (77420 in chips) 
Seat 3: MjLK MAN (247977 in chips) 
Seat 4: aapetrone91 (193598 in chips) 
Seat 5: Everbrun11 (293899 in chips) 
Seat 6: VxVendetta00 (103470 in chips) 
C0rpsbal: posts the ante 2500
Chuckster388: posts the ante 2500
MjLK MAN: posts the ante 2500
aapetrone91: posts the ante 2500
Everbrun11: posts the ante 2500
VxVendetta00: posts the ante 2500
Everbrun11: posts small blind 5000
VxVendetta00: posts big blind 10000
*** HOLE CARDS ***
C0rpsbal: raises 87622 to 97622 and is all-in
Chuckster388: folds 
MjLK MAN: folds 
aapetrone91: folds 
Everbrun11: folds 
VxVendetta00: folds 
Uncalled bet (87622) returned to C0rpsbal
C0rpsbal collected 40000 from pot
C0rpsbal: doesn't show hand 
*** SUMMARY ***
Total pot 40000 | Rake 0 
Seat 1: C0rpsbal collected (40000)
Seat 2: Chuckster388 folded before Flop (didn't bet)
Seat 3: MjLK MAN folded before Flop (didn't bet)
Seat 4: aapetrone91 (button) folded before Flop (didn't bet)
Seat 5: Everbrun11 (small blind) folded before Flop
Seat 6: VxVendetta00 (big blind) folded before Flop

PokerStars Hand #251210346489: Tournament #3769361908, $52.38+$2.62 USD Hold'em No Limit - Level XXVIII (5000/10000) - 2024/06/26 23:30:48 UTC [2024/06/26 19:30:48 ET]
Table '3769361908 4' 6-max Seat #5 is the button
Seat 1: C0rpsbal (127622 in chips) 
Seat 3: MjLK MAN (245477 in chips) 
Seat 4: aapetrone91 (191098 in chips) 
Seat 5: Everbrun11 (286399 in chips) 
Seat 6: VxVendetta00 (90970 in chips) 
C0rpsbal: posts the ante 2500
MjLK MAN: posts the ante 2500
aapetrone91: posts the ante 2500
Everbrun11: posts the ante 2500
VxVendetta00: posts the ante 2500
VxVendetta00: posts small blind 5000
C0rpsbal: posts big blind 10000
*** HOLE CARDS ***
MjLK MAN: folds 
aapetrone91: folds 
Everbrun11: folds 
VxVendetta00: raises 78470 to 88470 and is all-in
C0rpsbal: folds 
Uncalled bet (78470) returned to VxVendetta00
VxVendetta00 collected 32500 from pot
*** SUMMARY ***
Total pot 32500 | Rake 0 
Seat 1: C0rpsbal (big blind) folded before Flop
Seat 3: MjLK MAN folded before Flop (didn't bet)
Seat 4: aapetrone91 folded before Flop (didn't bet)
Seat 5: Everbrun11 (button) folded before Flop (didn't bet)
Seat 6: VxVendetta00 (small blind) collected (32500)

PokerStars Hand #251210349519: Tournament #3769361908, $52.38+$2.62 USD Hold'em No Limit - Level XXVIII (5000/10000) - 2024/06/26 23:31:04 UTC [2024/06/26 19:31:04 ET]
Table '3769361908 4' 6-max Seat #6 is the button
Seat 1: C0rpsbal (115122 in chips) 
Seat 3: MjLK MAN (242977 in chips) 
Seat 4: aapetrone91 (188598 in chips) 
Seat 5: Everbrun11 (283899 in chips) 
Seat 6: VxVendetta00 (110970 in chips) 
C0rpsbal: posts the ante 2500
MjLK MAN: posts the ante 2500
aapetrone91: posts the ante 2500
Everbrun11: posts the ante 2500
VxVendetta00: posts the ante 2500
C0rpsbal: posts small blind 5000
MjLK MAN: posts big blind 10000
*** HOLE CARDS ***
aapetrone91: folds 
Everbrun11: folds 
VxVendetta00: folds 
C0rpsbal: raises 102622 to 112622 and is all-in
MjLK MAN: calls 102622
*** FLOP *** [Td 3c 9s]
*** TURN *** [Td 3c 9s] [8d]
*** RIVER *** [Td 3c 9s 8d] [4d]
*** SHOW DOWN ***
C0rpsbal: shows [5h Kh] (high card King)
MjLK MAN: shows [7c Ad] (high card Ace)
MjLK MAN collected 237744 from pot
C0rpsbal finished the tournament in 20th place and received $164.76.
*** SUMMARY ***
Total pot 237744 | Rake 0 
Board [Td 3c 9s 8d 4d]
Seat 1: C0rpsbal (small blind) showed [5h Kh] and lost with high card King
Seat 3: MjLK MAN (big blind) showed [7c Ad] and won (237744) with high card Ace
Seat 4: aapetrone91 folded before Flop (didn't bet)
Seat 5: Everbrun11 folded before Flop (didn't bet)
Seat 6: VxVendetta00 (button) folded before Flop (didn't bet)

PokerStars Hand #251210353655: Tournament #3769361908, $52.38+$2.62 USD Hold'em No Limit - Level XXVIII (5000/10000) - 2024/06/26 23:31:24 UTC [2024/06/26 19:31:24 ET]
Table '3769361908 4' 6-max Seat #3 is the button
Seat 3: MjLK MAN (365599 in chips) 
Seat 4: aapetrone91 (186098 in chips) 
Seat 5: Everbrun11 (281399 in chips) 
Seat 6: VxVendetta00 (108470 in chips) 
MjLK MAN: posts the ante 2500
aapetrone91: posts the ante 2500
Everbrun11: posts the ante 2500
VxVendetta00: posts the ante 2500
aapetrone91: posts small blind 5000
Everbrun11: posts big blind 10000
*** HOLE CARDS ***
VxVendetta00: raises 95970 to 105970 and is all-in
MjLK MAN: folds 
aapetrone91: folds 
Everbrun11: folds 
Uncalled bet (95970) returned to VxVendetta00
VxVendetta00 collected 35000 from pot
*** SUMMARY ***
Total pot 35000 | Rake 0 
Seat 3: MjLK MAN (button) folded before Flop (didn't bet)
Seat 4: aapetrone91 (small blind) folded before Flop
Seat 5: Everbrun11 (big blind) folded before Flop
Seat 6: VxVendetta00 collected (35000)

PokerStars Hand #251210355938: Tournament #3769361908, $52.38+$2.62 USD Hold'em No Limit - Level XXVIII (5000/10000) - 2024/06/26 23:31:36 UTC [2024/06/26 19:31:36 ET]
Table '3769361908 4' 6-max Seat #4 is the button
Seat 3: MjLK MAN (363099 in chips) 
Seat 4: aapetrone91 (178598 in chips) 
Seat 5: Everbrun11 (268899 in chips) 
Seat 6: VxVendetta00 (130970 in chips) 
MjLK MAN: posts the ante 2500
aapetrone91: posts the ante 2500
Everbrun11: posts the ante 2500
VxVendetta00: posts the ante 2500
Everbrun11: posts small blind 5000
VxVendetta00: posts big blind 10000
*** HOLE CARDS ***
MjLK MAN: raises 10000 to 20000
aapetrone91: raises 30000 to 50000
Everbrun11: folds 
VxVendetta00: folds 
MjLK MAN: calls 30000
*** FLOP *** [Qc 8s 2d]
MjLK MAN: checks 
aapetrone91: bets 27500
MjLK MAN: calls 27500
*** TURN *** [Qc 8s 2d] [3s]
MjLK MAN: checks 
aapetrone91: bets 98598 and is all-in
MjLK MAN: calls 98598
*** RIVER *** [Qc 8s 2d 3s] [9d]
*** SHOW DOWN ***
MjLK MAN: shows [Ah Ad] (a pair of Aces)
aapetrone91: shows [Jh Jc] (a pair of Jacks)
MjLK MAN collected 377196 from pot
aapetrone91 finished the tournament in 18th place and received $164.76.
*** SUMMARY ***
Total pot 377196 | Rake 0 
Board [Qc 8s 2d 3s 9d]
Seat 3: MjLK MAN showed [Ah Ad] and won (377196) with a pair of Aces
Seat 4: aapetrone91 (button) showed [Jh Jc] and lost with a pair of Jacks
Seat 5: Everbrun11 (small blind) folded before Flop
Seat 6: VxVendetta00 (big blind) folded before Flop

PokerStars Hand #251210372977: Tournament #3769361908, $52.38+$2.62 USD Hold'em No Limit - Level XXIX (6000/12000) - 2024/06/26 23:33:03 UTC [2024/06/26 19:33:03 ET]
Table '3769361908 4' 6-max Seat #5 is the button
Seat 1: DR. ELDAR (193614 in chips) 
Seat 2: mila is best (32638 in chips) 
Seat 3: MjLK MAN (561697 in chips) 
Seat 5: Everbrun11 (261399 in chips) 
Seat 6: VxVendetta00 (118470 in chips) 
DR. ELDAR: posts the ante 3000
mila is best: posts the ante 3000
MjLK MAN: posts the ante 3000
Everbrun11: posts the ante 3000
VxVendetta00: posts the ante 3000
VxVendetta00: posts small blind 6000
DR. ELDAR: posts big blind 12000
*** HOLE CARDS ***
mila is best: folds 
MjLK MAN: raises 12000 to 24000
Everbrun11: folds 
VxVendetta00: folds 
DR. ELDAR: raises 166614 to 190614 and is all-in
MjLK MAN: folds 
Uncalled bet (166614) returned to DR. ELDAR
DR. ELDAR collected 69000 from pot
DR. ELDAR: doesn't show hand 
*** SUMMARY ***
Total pot 69000 | Rake 0 
Seat 1: DR. ELDAR (big blind) collected (69000)
Seat 2: mila is best folded before Flop (didn't bet)
Seat 3: MjLK MAN folded before Flop
Seat 5: Everbrun11 (button) folded before Flop (didn't bet)
Seat 6: VxVendetta00 (small blind) folded before Flop

PokerStars Hand #251210378494: Tournament #3769361908, $52.38+$2.62 USD Hold'em No Limit - Level XXIX (6000/12000) - 2024/06/26 23:33:31 UTC [2024/06/26 19:33:31 ET]
Table '3769361908 4' 6-max Seat #6 is the button
Seat 1: DR. ELDAR (235614 in chips) 
Seat 2: mila is best (29638 in chips) 
Seat 3: MjLK MAN (534697 in chips) 
Seat 5: Everbrun11 (258399 in chips) 
Seat 6: VxVendetta00 (109470 in chips) 
DR. ELDAR: posts the ante 3000
mila is best: posts the ante 3000
MjLK MAN: posts the ante 3000
Everbrun11: posts the ante 3000
VxVendetta00: posts the ante 3000
DR. ELDAR: posts small blind 6000
mila is best: posts big blind 12000
*** HOLE CARDS ***
MjLK MAN: folds 
Everbrun11: raises 12000 to 24000
VxVendetta00: folds 
DR. ELDAR: folds 
mila is best: raises 2638 to 26638 and is all-in
Everbrun11: calls 2638
*** FLOP *** [5d Qd Ks]
*** TURN *** [5d Qd Ks] [3d]
*** RIVER *** [5d Qd Ks 3d] [Js]
*** SHOW DOWN ***
mila is best: shows [Ts Td] (a pair of Tens)
Everbrun11: shows [Qh As] (a pair of Queens)
Everbrun11 collected 74276 from pot
mila is best finished the tournament in 17th place and received $200.15.
*** SUMMARY ***
Total pot 74276 | Rake 0 
Board [5d Qd Ks 3d Js]
Seat 1: DR. ELDAR (small blind) folded before Flop
Seat 2: mila is best (big blind) showed [Ts Td] and lost with a pair of Tens
Seat 3: MjLK MAN folded before Flop (didn't bet)
Seat 5: Everbrun11 showed [Qh As] and won (74276) with a pair of Queens
Seat 6: VxVendetta00 (button) folded before Flop (didn't bet)

PokerStars Hand #251210383372: Tournament #3769361908, $52.38+$2.62 USD Hold'em No Limit - Level XXIX (6000/12000) - 2024/06/26 23:33:55 UTC [2024/06/26 19:33:55 ET]
Table '3769361908 4' 6-max Seat #1 is the button
Seat 1: DR. ELDAR (226614 in chips) 
Seat 3: MjLK MAN (531697 in chips) 
Seat 5: Everbrun11 (303037 in chips) 
Seat 6: VxVendetta00 (106470 in chips) 
DR. ELDAR: posts the ante 3000
MjLK MAN: posts the ante 3000
Everbrun11: posts the ante 3000
VxVendetta00: posts the ante 3000
MjLK MAN: posts small blind 6000
Everbrun11: posts big blind 12000
*** HOLE CARDS ***
Muril0souza is disconnected 
VxVendetta00: folds 
DR. ELDAR: folds 
MjLK MAN: raises 24000 to 36000
Everbrun11: folds 
Uncalled bet (24000) returned to MjLK MAN
MjLK MAN collected 36000 from pot
MjLK MAN: doesn't show hand 
*** SUMMARY ***
Total pot 36000 | Rake 0 
Seat 1: DR. ELDAR (button) folded before Flop (didn't bet)
Seat 3: MjLK MAN (small blind) collected (36000)
Seat 5: Everbrun11 (big blind) folded before Flop
Seat 6: VxVendetta00 folded before Flop (didn't bet)

PokerStars Hand #251210387413: Tournament #3769361908, $52.38+$2.62 USD Hold'em No Limit - Level XXIX (6000/12000) - 2024/06/26 23:34:15 UTC [2024/06/26 19:34:15 ET]
Table '3769361908 4' 6-max Seat #3 is the button
Seat 1: DR. ELDAR (223614 in chips) 
Seat 3: MjLK MAN (552697 in chips) 
Seat 4: Muril0souza (90798 in chips) out of hand (moved from another table into small blind)
Seat 5: Everbrun11 (288037 in chips) 
Seat 6: VxVendetta00 (103470 in chips) 
Muril0souza will be allowed to play after the button
DR. ELDAR: posts the ante 3000
MjLK MAN: posts the ante 3000
Everbrun11: posts the ante 3000
VxVendetta00: posts the ante 3000
Everbrun11: posts small blind 6000
VxVendetta00: posts big blind 12000
*** HOLE CARDS ***
DR. ELDAR: folds 
MjLK MAN: raises 537697 to 549697 and is all-in
Everbrun11: folds 
VxVendetta00: folds 
Uncalled bet (537697) returned to MjLK MAN
MjLK MAN collected 42000 from pot
MjLK MAN: doesn't show hand 
*** SUMMARY ***
Total pot 42000 | Rake 0 
Seat 1: DR. ELDAR folded before Flop (didn't bet)
Seat 3: MjLK MAN (button) collected (42000)
Seat 5: Everbrun11 (small blind) folded before Flop
Seat 6: VxVendetta00 (big blind) folded before Flop

PokerStars Hand #251210389844: Tournament #3769361908, $52.38+$2.62 USD Hold'em No Limit - Level XXIX (6000/12000) - 2024/06/26 23:34:27 UTC [2024/06/26 19:34:27 ET]
Table '3769361908 4' 6-max Seat #5 is the button
Seat 1: DR. ELDAR (220614 in chips) 
Seat 3: MjLK MAN (579697 in chips) 
Seat 4: Muril0souza (90798 in chips) 
Seat 5: Everbrun11 (279037 in chips) 
Seat 6: VxVendetta00 (88470 in chips) 
DR. ELDAR: posts the ante 3000
MjLK MAN: posts the ante 3000
Muril0souza: posts the ante 3000
Everbrun11: posts the ante 3000
VxVendetta00: posts the ante 3000
VxVendetta00: posts small blind 6000
DR. ELDAR: posts big blind 12000
*** HOLE CARDS ***
MjLK MAN: folds 
Muril0souza: raises 75798 to 87798 and is all-in
Everbrun11: folds 
VxVendetta00: folds 
DR. ELDAR: folds 
Uncalled bet (75798) returned to Muril0souza
Muril0souza collected 45000 from pot
*** SUMMARY ***
Total pot 45000 | Rake 0 
Seat 1: DR. ELDAR (big blind) folded before Flop
Seat 3: MjLK MAN folded before Flop (didn't bet)
Seat 4: Muril0souza collected (45000)
Seat 5: Everbrun11 (button) folded before Flop (didn't bet)
Seat 6: VxVendetta00 (small blind) folded before Flop

PokerStars Hand #251210392858: Tournament #3769361908, $52.38+$2.62 USD Hold'em No Limit - Level XXIX (6000/12000) - 2024/06/26 23:34:42 UTC [2024/06/26 19:34:42 ET]
Table '3769361908 4' 6-max Seat #6 is the button
Seat 1: DR. ELDAR (205614 in chips) 
Seat 3: MjLK MAN (576697 in chips) 
Seat 4: Muril0souza (120798 in chips) 
Seat 5: Everbrun11 (276037 in chips) 
Seat 6: VxVendetta00 (79470 in chips) 
DR. ELDAR: posts the ante 3000
MjLK MAN: posts the ante 3000
Muril0souza: posts the ante 3000
Everbrun11: posts the ante 3000
VxVendetta00: posts the ante 3000
DR. ELDAR: posts small blind 6000
MjLK MAN: posts big blind 12000
*** HOLE CARDS ***
Muril0souza: raises 105798 to 117798 and is all-in
Everbrun11: folds 
VxVendetta00: folds 
DR. ELDAR: folds 
MjLK MAN: folds 
Uncalled bet (105798) returned to Muril0souza
Muril0souza collected 45000 from pot
*** SUMMARY ***
Total pot 45000 | Rake 0 
Seat 1: DR. ELDAR (small blind) folded before Flop
Seat 3: MjLK MAN (big blind) folded before Flop
Seat 4: Muril0souza collected (45000)
Seat 5: Everbrun11 folded before Flop (didn't bet)
Seat 6: VxVendetta00 (button) folded before Flop (didn't bet)

PokerStars Hand #251210397751: Tournament #3769361908, $52.38+$2.62 USD Hold'em No Limit - Level XXIX (6000/12000) - 2024/06/26 23:35:07 UTC [2024/06/26 19:35:07 ET]
Table '3769361908 4' 6-max Seat #1 is the button
Seat 1: DR. ELDAR (196614 in chips) 
Seat 3: MjLK MAN (561697 in chips) 
Seat 4: Muril0souza (150798 in chips) 
Seat 5: Everbrun11 (273037 in chips) 
Seat 6: VxVendetta00 (76470 in chips) 
DR. ELDAR: posts the ante 3000
MjLK MAN: posts the ante 3000
Muril0souza: posts the ante 3000
Everbrun11: posts the ante 3000
VxVendetta00: posts the ante 3000
MjLK MAN: posts small blind 6000
Muril0souza: posts big blind 12000
*** HOLE CARDS ***
Everbrun11: folds 
VxVendetta00: folds 
DR. ELDAR: folds 
MjLK MAN: folds 
Uncalled bet (6000) returned to Muril0souza
Muril0souza collected 27000 from pot
*** SUMMARY ***
Total pot 27000 | Rake 0 
Seat 1: DR. ELDAR (button) folded before Flop (didn't bet)
Seat 3: MjLK MAN (small blind) folded before Flop
Seat 4: Muril0souza (big blind) collected (27000)
Seat 5: Everbrun11 folded before Flop (didn't bet)
Seat 6: VxVendetta00 folded before Flop (didn't bet)

PokerStars Hand #251210402684: Tournament #3769361908, $52.38+$2.62 USD Hold'em No Limit - Level XXX (8000/16000) - 2024/06/26 23:35:32 UTC [2024/06/26 19:35:32 ET]
Table '3769361908 4' 6-max Seat #3 is the button
Seat 1: DR. ELDAR (193614 in chips) 
Seat 3: MjLK MAN (552697 in chips) 
Seat 4: Muril0souza (168798 in chips) 
Seat 5: Everbrun11 (270037 in chips) 
Seat 6: VxVendetta00 (73470 in chips) 
DR. ELDAR: posts the ante 4000
MjLK MAN: posts the ante 4000
Muril0souza: posts the ante 4000
Everbrun11: posts the ante 4000
VxVendetta00: posts the ante 4000
Muril0souza: posts small blind 8000
Everbrun11: posts big blind 16000
*** HOLE CARDS ***
VxVendetta00: folds 
DR. ELDAR: raises 173614 to 189614 and is all-in
MjLK MAN: folds 
Muril0souza: folds 
Everbrun11: folds 
Uncalled bet (173614) returned to DR. ELDAR
DR. ELDAR collected 60000 from pot
DR. ELDAR: doesn't show hand 
*** SUMMARY ***
Total pot 60000 | Rake 0 
Seat 1: DR. ELDAR collected (60000)
Seat 3: MjLK MAN (button) folded before Flop (didn't bet)
Seat 4: Muril0souza (small blind) folded before Flop
Seat 5: Everbrun11 (big blind) folded before Flop
Seat 6: VxVendetta00 folded before Flop (didn't bet)

PokerStars Hand #251210408160: Tournament #3769361908, $52.38+$2.62 USD Hold'em No Limit - Level XXX (8000/16000) - 2024/06/26 23:36:00 UTC [2024/06/26 19:36:00 ET]
Table '3769361908 4' 6-max Seat #4 is the button
Seat 1: DR. ELDAR (233614 in chips) 
Seat 3: MjLK MAN (548697 in chips) 
Seat 4: Muril0souza (156798 in chips) 
Seat 5: Everbrun11 (250037 in chips) 
Seat 6: VxVendetta00 (69470 in chips) 
DR. ELDAR: posts the ante 4000
MjLK MAN: posts the ante 4000
Muril0souza: posts the ante 4000
Everbrun11: posts the ante 4000
VxVendetta00: posts the ante 4000
Everbrun11: posts small blind 8000
VxVendetta00: posts big blind 16000
*** HOLE CARDS ***
DR. ELDAR: folds 
MjLK MAN: folds 
Muril0souza: raises 136798 to 152798 and is all-in
Everbrun11: folds 
VxVendetta00: folds 
Uncalled bet (136798) returned to Muril0souza
Muril0souza collected 60000 from pot
*** SUMMARY ***
Total pot 60000 | Rake 0 
Seat 1: DR. ELDAR folded before Flop (didn't bet)
Seat 3: MjLK MAN folded before Flop (didn't bet)
Seat 4: Muril0souza (button) collected (60000)
Seat 5: Everbrun11 (small blind) folded before Flop
Seat 6: VxVendetta00 (big blind) folded before Flop

PokerStars Hand #251210411163: Tournament #3769361908, $52.38+$2.62 USD Hold'em No Limit - Level XXX (8000/16000) - 2024/06/26 23:36:14 UTC [2024/06/26 19:36:14 ET]
Table '3769361908 4' 6-max Seat #5 is the button
Seat 1: DR. ELDAR (229614 in chips) 
Seat 3: MjLK MAN (544697 in chips) 
Seat 4: Muril0souza (196798 in chips) 
Seat 5: Everbrun11 (238037 in chips) 
Seat 6: VxVendetta00 (49470 in chips) 
DR. ELDAR: posts the ante 4000
MjLK MAN: posts the ante 4000
Muril0souza: posts the ante 4000
Everbrun11: posts the ante 4000
VxVendetta00: posts the ante 4000
VxVendetta00: posts small blind 8000
DR. ELDAR: posts big blind 16000
*** HOLE CARDS ***
MjLK MAN: folds 
Muril0souza: folds 
Everbrun11: folds 
VxVendetta00: raises 29470 to 45470 and is all-in
DR. ELDAR: calls 29470
*** FLOP *** [6d 8s Ah]
*** TURN *** [6d 8s Ah] [5h]
*** RIVER *** [6d 8s Ah 5h] [Ac]
*** SHOW DOWN ***
VxVendetta00: shows [8h Qc] (two pair, Aces and Eights)
DR. ELDAR: shows [As 3h] (three of a kind, Aces)
DR. ELDAR collected 110940 from pot
VxVendetta00 finished the tournament in 13th place and received $243.14.
*** SUMMARY ***
Total pot 110940 | Rake 0 
Board [6d 8s Ah 5h Ac]
Seat 1: DR. ELDAR (big blind) showed [As 3h] and won (110940) with three of a kind, Aces
Seat 3: MjLK MAN folded before Flop (didn't bet)
Seat 4: Muril0souza folded before Flop (didn't bet)
Seat 5: Everbrun11 (button) folded before Flop (didn't bet)
Seat 6: VxVendetta00 (small blind) showed [8h Qc] and lost with two pair, Aces and Eights






PokerStars Hand #251209099115: Tournament #3769361908, $52.38+$2.62 USD Hold'em No Limit - Level II (30/60) - 2024/06/26 22:05:55 UTC [2024/06/26 18:05:55 ET]
Table '3769361908 1' 6-max Seat #5 is the button
Seat 1: 67KOSTAS (10108 in chips) 
Seat 2: jessecesar (8748 in chips) 
Seat 3: sinister778 (9985 in chips) 
Seat 4: mehditheboss (10144 in chips) 
Seat 5: lidi77777 (11373 in chips) 
Seat 6: Link_fNK (9913 in chips) 
67KOSTAS: posts the ante 15
jessecesar: posts the ante 15
sinister778: posts the ante 15
mehditheboss: posts the ante 15
lidi77777: posts the ante 15
Link_fNK: posts the ante 15
Link_fNK: posts small blind 30
67KOSTAS: posts big blind 60
*** HOLE CARDS ***
jessecesar: folds 
sinister778: folds 
mehditheboss: folds 
lidi77777: raises 60 to 120
Link_fNK: raises 420 to 540
67KOSTAS: folds 
lidi77777: folds 
Uncalled bet (420) returned to Link_fNK
Link_fNK collected 390 from pot
Link_fNK: doesn't show hand 
*** SUMMARY ***
Total pot 390 | Rake 0 
Seat 1: 67KOSTAS (big blind) folded before Flop
Seat 2: jessecesar folded before Flop (didn't bet)
Seat 3: sinister778 folded before Flop (didn't bet)
Seat 4: mehditheboss folded before Flop (didn't bet)
Seat 5: lidi77777 (button) folded before Flop
Seat 6: Link_fNK (small blind) collected (390)

PokerStars Hand #251209107040: Tournament #3769361908, $52.38+$2.62 USD Hold'em No Limit - Level II (30/60) - 2024/06/26 22:06:22 UTC [2024/06/26 18:06:22 ET]
Table '3769361908 1' 6-max Seat #6 is the button
Seat 1: 67KOSTAS (10033 in chips) 
Seat 3: sinister778 (9970 in chips) 
Seat 4: mehditheboss (10129 in chips) 
Seat 5: lidi77777 (11238 in chips) 
Seat 6: Link_fNK (10168 in chips) 
67KOSTAS: posts the ante 15
sinister778: posts the ante 15
mehditheboss: posts the ante 15
lidi77777: posts the ante 15
Link_fNK: posts the ante 15
67KOSTAS: posts small blind 30
sinister778: posts big blind 60
*** HOLE CARDS ***
mehditheboss: raises 72 to 132
lidi77777: calls 132
Link_fNK: folds 
67KOSTAS: folds 
sinister778: calls 72
*** FLOP *** [3c 4s Ac]
sinister778: checks 
mehditheboss: bets 160
clareou0408 is disconnected 
lidi77777: calls 160
sinister778: folds 
*** TURN *** [3c 4s Ac] [2s]
mehditheboss: checks 
lidi77777: bets 471
mehditheboss: calls 471
*** RIVER *** [3c 4s Ac 2s] [9d]
mehditheboss: checks 
lidi77777: checks 
*** SHOW DOWN ***
mehditheboss: shows [Td Ah] (a pair of Aces)
lidi77777: shows [Ad Jd] (a pair of Aces - Jack kicker)
lidi77777 collected 1763 from pot
*** SUMMARY ***
Total pot 1763 | Rake 0 
Board [3c 4s Ac 2s 9d]
Seat 1: 67KOSTAS (small blind) folded before Flop
Seat 3: sinister778 (big blind) folded on the Flop
Seat 4: mehditheboss showed [Td Ah] and lost with a pair of Aces
Seat 5: lidi77777 showed [Ad Jd] and won (1763) with a pair of Aces
Seat 6: Link_fNK (button) folded before Flop (didn't bet)

PokerStars Hand #251209122496: Tournament #3769361908, $52.38+$2.62 USD Hold'em No Limit - Level II (30/60) - 2024/06/26 22:07:15 UTC [2024/06/26 18:07:15 ET]
Table '3769361908 1' 6-max Seat #1 is the button
Seat 1: 67KOSTAS (9988 in chips) 
Seat 2: clareou0408 (10000 in chips) out of hand (moved from another table into small blind)
Seat 3: sinister778 (9823 in chips) 
Seat 4: mehditheboss (9351 in chips) 
Seat 5: lidi77777 (12223 in chips) 
Seat 6: Link_fNK (10153 in chips) 
clareou0408 will be allowed to play after the button
67KOSTAS: posts the ante 15
sinister778: posts the ante 15
mehditheboss: posts the ante 15
lidi77777: posts the ante 15
Link_fNK: posts the ante 15
sinister778: posts small blind 30
mehditheboss: posts big blind 60
*** HOLE CARDS ***
lidi77777: folds 
Link_fNK: folds 
67KOSTAS: raises 120 to 180
sinister778: calls 150
mehditheboss: folds 
*** FLOP *** [3c 2d 9s]
sinister778: checks 
67KOSTAS: checks 
*** TURN *** [3c 2d 9s] [6c]
sinister778: bets 180
67KOSTAS: calls 180
*** RIVER *** [3c 2d 9s 6c] [Qc]
sinister778: bets 488
67KOSTAS: folds 
Uncalled bet (488) returned to sinister778
sinister778 collected 855 from pot
*** SUMMARY ***
Total pot 855 | Rake 0 
Board [3c 2d 9s 6c Qc]
Seat 1: 67KOSTAS (button) folded on the River
Seat 3: sinister778 (small blind) collected (855)
Seat 4: mehditheboss (big blind) folded before Flop
Seat 5: lidi77777 folded before Flop (didn't bet)
Seat 6: Link_fNK folded before Flop (didn't bet)

PokerStars Hand #251209139991: Tournament #3769361908, $52.38+$2.62 USD Hold'em No Limit - Level III (40/80) - 2024/06/26 22:08:15 UTC [2024/06/26 18:08:15 ET]
Table '3769361908 1' 6-max Seat #3 is the button
Seat 1: 67KOSTAS (9613 in chips) 
Seat 2: clareou0408 (10000 in chips) 
Seat 3: sinister778 (10303 in chips) 
Seat 4: mehditheboss (9276 in chips) 
Seat 5: lidi77777 (12208 in chips) 
Seat 6: Link_fNK (10138 in chips) 
67KOSTAS: posts the ante 20
clareou0408: posts the ante 20
sinister778: posts the ante 20
mehditheboss: posts the ante 20
lidi77777: posts the ante 20
Link_fNK: posts the ante 20
mehditheboss: posts small blind 40
lidi77777: posts big blind 80
*** HOLE CARDS ***
Link_fNK: folds 
67KOSTAS: raises 160 to 240
clareou0408: calls 240
sinister778: folds 
mehditheboss: folds 
lidi77777: raises 880 to 1120
67KOSTAS: calls 880
clareou0408: folds 
*** FLOP *** [9c 9s 5c]
lidi77777: bets 1320
67KOSTAS: calls 1320
*** TURN *** [9c 9s 5c] [6c]
lidi77777: bets 9748 and is all-in
67KOSTAS: folds 
Uncalled bet (9748) returned to lidi77777
lidi77777 collected 5280 from pot
*** SUMMARY ***
Total pot 5280 | Rake 0 
Board [9c 9s 5c 6c]
Seat 1: 67KOSTAS folded on the Turn
Seat 2: clareou0408 folded before Flop
Seat 3: sinister778 (button) folded before Flop (didn't bet)
Seat 4: mehditheboss (small blind) folded before Flop
Seat 5: lidi77777 (big blind) collected (5280)
Seat 6: Link_fNK folded before Flop (didn't bet)

PokerStars Hand #251209152459: Tournament #3769361908, $52.38+$2.62 USD Hold'em No Limit - Level III (40/80) - 2024/06/26 22:08:57 UTC [2024/06/26 18:08:57 ET]
Table '3769361908 1' 6-max Seat #4 is the button
Seat 1: 67KOSTAS (7153 in chips) 
Seat 2: clareou0408 (9740 in chips) 
Seat 3: sinister778 (10283 in chips) 
Seat 4: mehditheboss (9216 in chips) 
Seat 5: lidi77777 (15028 in chips) 
Seat 6: Link_fNK (10118 in chips) 
67KOSTAS: posts the ante 20
clareou0408: posts the ante 20
sinister778: posts the ante 20
mehditheboss: posts the ante 20
lidi77777: posts the ante 20
Link_fNK: posts the ante 20
lidi77777: posts small blind 40
Link_fNK: posts big blind 80
*** HOLE CARDS ***
67KOSTAS: folds 
clareou0408: folds 
sinister778: raises 80 to 160
mehditheboss: folds 
lidi77777: folds 
Link_fNK: folds 
Uncalled bet (80) returned to sinister778
sinister778 collected 320 from pot
*** SUMMARY ***
Total pot 320 | Rake 0 
Seat 1: 67KOSTAS folded before Flop (didn't bet)
Seat 2: clareou0408 folded before Flop (didn't bet)
Seat 3: sinister778 collected (320)
Seat 4: mehditheboss (button) folded before Flop (didn't bet)
Seat 5: lidi77777 (small blind) folded before Flop
Seat 6: Link_fNK (big blind) folded before Flop

PokerStars Hand #251209162121: Tournament #3769361908, $52.38+$2.62 USD Hold'em No Limit - Level III (40/80) - 2024/06/26 22:09:30 UTC [2024/06/26 18:09:30 ET]
Table '3769361908 1' 6-max Seat #5 is the button
Seat 1: 67KOSTAS (7133 in chips) 
Seat 2: clareou0408 (9720 in chips) 
Seat 3: sinister778 (10503 in chips) 
Seat 4: mehditheboss (9196 in chips) 
Seat 5: lidi77777 (14968 in chips) 
Seat 6: Link_fNK (10018 in chips) 
67KOSTAS: posts the ante 20
clareou0408: posts the ante 20
sinister778: posts the ante 20
mehditheboss: posts the ante 20
lidi77777: posts the ante 20
Link_fNK: posts the ante 20
Link_fNK: posts small blind 40
67KOSTAS: posts big blind 80
*** HOLE CARDS ***
clareou0408: folds 
sinister778: raises 80 to 160
mehditheboss: calls 160
lidi77777: calls 160
Link_fNK: folds 
67KOSTAS: raises 800 to 960
sinister778: calls 800
mehditheboss: calls 800
lidi77777: calls 800
*** FLOP *** [7c 2d 5d]
67KOSTAS: bets 2000
sinister778: folds 
mehditheboss: calls 2000
lidi77777: raises 5000 to 7000
67KOSTAS: calls 4153 and is all-in
mehditheboss: folds 
Uncalled bet (847) returned to lidi77777
*** TURN *** [7c 2d 5d] [6h]
*** RIVER *** [7c 2d 5d 6h] [As]
*** SHOW DOWN ***
67KOSTAS: shows [9d 9s] (a pair of Nines)
lidi77777: shows [9c 9h] (a pair of Nines)
67KOSTAS collected 9153 from pot
lidi77777 collected 9153 from pot
*** SUMMARY ***
Total pot 18306 | Rake 0 
Board [7c 2d 5d 6h As]
Seat 1: 67KOSTAS (big blind) showed [9d 9s] and won (9153) with a pair of Nines
Seat 2: clareou0408 folded before Flop (didn't bet)
Seat 3: sinister778 folded on the Flop
Seat 4: mehditheboss folded on the Flop
Seat 5: lidi77777 (button) showed [9c 9h] and won (9153) with a pair of Nines
Seat 6: Link_fNK (small blind) folded before Flop

PokerStars Hand #251209182619: Tournament #3769361908, $52.38+$2.62 USD Hold'em No Limit - Level III (40/80) - 2024/06/26 22:10:40 UTC [2024/06/26 18:10:40 ET]
Table '3769361908 1' 6-max Seat #6 is the button
Seat 1: 67KOSTAS (9153 in chips) 
Seat 2: clareou0408 (9700 in chips) 
Seat 3: sinister778 (9523 in chips) 
Seat 4: mehditheboss (6216 in chips) 
Seat 5: lidi77777 (16988 in chips) 
Seat 6: Link_fNK (9958 in chips) 
67KOSTAS: posts the ante 20
clareou0408: posts the ante 20
sinister778: posts the ante 20
mehditheboss: posts the ante 20
lidi77777: posts the ante 20
Link_fNK: posts the ante 20
67KOSTAS: posts small blind 40
clareou0408: posts big blind 80
*** HOLE CARDS ***
sinister778: raises 80 to 160
mehditheboss: raises 6036 to 6196 and is all-in
lidi77777: folds 
Link_fNK: folds 
67KOSTAS: folds 
clareou0408: folds 
sinister778: calls 6036
*** FLOP *** [5h 6c 3s]
*** TURN *** [5h 6c 3s] [Kd]
*** RIVER *** [5h 6c 3s Kd] [Js]
*** SHOW DOWN ***
sinister778: shows [4c 4s] (a pair of Fours)
mehditheboss: shows [Kh Ad] (a pair of Kings)
mehditheboss collected 12632 from pot
*** SUMMARY ***
Total pot 12632 | Rake 0 
Board [5h 6c 3s Kd Js]
Seat 1: 67KOSTAS (small blind) folded before Flop
Seat 2: clareou0408 (big blind) folded before Flop
Seat 3: sinister778 showed [4c 4s] and lost with a pair of Fours
Seat 4: mehditheboss showed [Kh Ad] and won (12632) with a pair of Kings
Seat 5: lidi77777 folded before Flop (didn't bet)
Seat 6: Link_fNK (button) folded before Flop (didn't bet)

PokerStars Hand #251209195289: Tournament #3769361908, $52.38+$2.62 USD Hold'em No Limit - Level IV (50/100) - 2024/06/26 22:11:25 UTC [2024/06/26 18:11:25 ET]
Table '3769361908 1' 6-max Seat #1 is the button
Seat 1: 67KOSTAS (9093 in chips) 
Seat 2: clareou0408 (9600 in chips) 
Seat 3: sinister778 (3307 in chips) 
Seat 4: mehditheboss (12632 in chips) 
Seat 5: lidi77777 (16968 in chips) 
Seat 6: Link_fNK (9938 in chips) 
67KOSTAS: posts the ante 25
clareou0408: posts the ante 25
sinister778: posts the ante 25
mehditheboss: posts the ante 25
lidi77777: posts the ante 25
Link_fNK: posts the ante 25
clareou0408: posts small blind 50
sinister778: posts big blind 100
*** HOLE CARDS ***
mehditheboss: raises 120 to 220
lidi77777: folds 
Link_fNK: folds 
67KOSTAS: raises 740 to 960
clareou0408: folds 
sinister778: folds 
mehditheboss: folds 
Uncalled bet (740) returned to 67KOSTAS
67KOSTAS collected 740 from pot
67KOSTAS: doesn't show hand 
*** SUMMARY ***
Total pot 740 | Rake 0 
Seat 1: 67KOSTAS (button) collected (740)
Seat 2: clareou0408 (small blind) folded before Flop
Seat 3: sinister778 (big blind) folded before Flop
Seat 4: mehditheboss folded before Flop
Seat 5: lidi77777 folded before Flop (didn't bet)
Seat 6: Link_fNK folded before Flop (didn't bet)

PokerStars Hand #251209200398: Tournament #3769361908, $52.38+$2.62 USD Hold'em No Limit - Level IV (50/100) - 2024/06/26 22:11:42 UTC [2024/06/26 18:11:42 ET]
Table '3769361908 1' 6-max Seat #2 is the button
Seat 2: clareou0408 (9525 in chips) 
Seat 3: sinister778 (3182 in chips) 
Seat 4: mehditheboss (12387 in chips) 
Seat 5: lidi77777 (16943 in chips) 
Seat 6: Link_fNK (9913 in chips) 
clareou0408: posts the ante 25
sinister778: posts the ante 25
mehditheboss: posts the ante 25
lidi77777: posts the ante 25
Link_fNK: posts the ante 25
sinister778: posts small blind 50
mehditheboss: posts big blind 100
*** HOLE CARDS ***
lidi77777: folds 
Link_fNK: folds 
clareou0408: raises 100 to 200
sinister778: calls 150
mehditheboss: folds 
*** FLOP *** [9d Kd 3c]
sinister778: checks 
clareou0408: bets 167
sinister778: calls 167
*** TURN *** [9d Kd 3c] [Td]
sinister778: checks 
clareou0408: checks 
*** RIVER *** [9d Kd 3c Td] [7h]
sinister778: checks 
clareou0408: checks 
*** SHOW DOWN ***
sinister778: shows [9h 8s] (a pair of Nines)
clareou0408: mucks hand 
sinister778 collected 959 from pot
*** SUMMARY ***
Total pot 959 | Rake 0 
Board [9d Kd 3c Td 7h]
Seat 2: clareou0408 (button) mucked
Seat 3: sinister778 (small blind) showed [9h 8s] and won (959) with a pair of Nines
Seat 4: mehditheboss (big blind) folded before Flop
Seat 5: lidi77777 folded before Flop (didn't bet)
Seat 6: Link_fNK folded before Flop (didn't bet)

PokerStars Hand #251209224634: Tournament #3769361908, $52.38+$2.62 USD Hold'em No Limit - Level IV (50/100) - 2024/06/26 22:13:07 UTC [2024/06/26 18:13:07 ET]
Table '3769361908 1' 6-max Seat #3 is the button
Seat 2: clareou0408 (9133 in chips) 
Seat 3: sinister778 (3749 in chips) 
Seat 4: mehditheboss (12262 in chips) 
Seat 5: lidi77777 (16918 in chips) 
Seat 6: Link_fNK (9888 in chips) 
clareou0408: posts the ante 25
sinister778: posts the ante 25
mehditheboss: posts the ante 25
lidi77777: posts the ante 25
Link_fNK: posts the ante 25
mehditheboss: posts small blind 50
lidi77777: posts big blind 100
*** HOLE CARDS ***
Link_fNK: folds 
clareou0408: folds 
sinister778: raises 300 to 400
mehditheboss: folds 
lidi77777: folds 
Uncalled bet (300) returned to sinister778
sinister778 collected 375 from pot
*** SUMMARY ***
Total pot 375 | Rake 0 
Seat 2: clareou0408 folded before Flop (didn't bet)
Seat 3: sinister778 (button) collected (375)
Seat 4: mehditheboss (small blind) folded before Flop
Seat 5: lidi77777 (big blind) folded before Flop
Seat 6: Link_fNK folded before Flop (didn't bet)

PokerStars Hand #251209231236: Tournament #3769361908, $52.38+$2.62 USD Hold'em No Limit - Level IV (50/100) - 2024/06/26 22:13:30 UTC [2024/06/26 18:13:30 ET]
Table '3769361908 1' 6-max Seat #4 is the button
Seat 2: clareou0408 (9108 in chips) 
Seat 3: sinister778 (3999 in chips) 
Seat 4: mehditheboss (12187 in chips) 
Seat 5: lidi77777 (16793 in chips) 
Seat 6: Link_fNK (9863 in chips) 
clareou0408: posts the ante 25
sinister778: posts the ante 25
mehditheboss: posts the ante 25
lidi77777: posts the ante 25
Link_fNK: posts the ante 25
lidi77777: posts small blind 50
Link_fNK: posts big blind 100
*** HOLE CARDS ***
lucaromanoo1 is disconnected 
clareou0408: folds 
sinister778: folds 
mehditheboss: raises 100 to 200
lidi77777: calls 150
Link_fNK: folds 
*** FLOP *** [4d 8d Th]
lidi77777: checks 
mehditheboss: checks 
*** TURN *** [4d 8d Th] [4s]
lidi77777: checks 
mehditheboss: bets 313
lidi77777: raises 626 to 939
mehditheboss: calls 626
*** RIVER *** [4d 8d Th 4s] [Qd]
lidi77777: bets 2452
mehditheboss: folds 
Uncalled bet (2452) returned to lidi77777
lidi77777 collected 2503 from pot
*** SUMMARY ***
Total pot 2503 | Rake 0 
Board [4d 8d Th 4s Qd]
Seat 2: clareou0408 folded before Flop (didn't bet)
Seat 3: sinister778 folded before Flop (didn't bet)
Seat 4: mehditheboss (button) folded on the River
Seat 5: lidi77777 (small blind) collected (2503)
Seat 6: Link_fNK (big blind) folded before Flop

PokerStars Hand #251209252257: Tournament #3769361908, $52.38+$2.62 USD Hold'em No Limit - Level V (60/120) - 2024/06/26 22:14:43 UTC [2024/06/26 18:14:43 ET]
Table '3769361908 1' 6-max Seat #5 is the button
Seat 1: lucaromanoo1 (10000 in chips) 
Seat 2: clareou0408 (9083 in chips) 
Seat 3: sinister778 (3974 in chips) 
Seat 4: mehditheboss (11023 in chips) 
Seat 5: lidi77777 (18132 in chips) 
Seat 6: Link_fNK (9738 in chips) 
lucaromanoo1: posts the ante 30
clareou0408: posts the ante 30
sinister778: posts the ante 30
mehditheboss: posts the ante 30
lidi77777: posts the ante 30
Link_fNK: posts the ante 30
Link_fNK: posts small blind 60
lucaromanoo1: posts big blind 120
*** HOLE CARDS ***
clareou0408: folds 
sinister778: folds 
mehditheboss: folds 
lidi77777: folds 
Link_fNK: raises 300 to 420
lucaromanoo1: calls 300
*** FLOP *** [Kc 2s 7s]
Link_fNK: bets 229
lucaromanoo1: calls 229
*** TURN *** [Kc 2s 7s] [8c]
Link_fNK: bets 1050
lucaromanoo1: calls 1050
*** RIVER *** [Kc 2s 7s 8c] [Js]
Link_fNK: checks 
lucaromanoo1: bets 8271 and is all-in
Link_fNK: folds 
Uncalled bet (8271) returned to lucaromanoo1
lucaromanoo1 collected 3578 from pot
lucaromanoo1: doesn't show hand 
*** SUMMARY ***
Total pot 3578 | Rake 0 
Board [Kc 2s 7s 8c Js]
Seat 1: lucaromanoo1 (big blind) collected (3578)
Seat 2: clareou0408 folded before Flop (didn't bet)
Seat 3: sinister778 folded before Flop (didn't bet)
Seat 4: mehditheboss folded before Flop (didn't bet)
Seat 5: lidi77777 (button) folded before Flop (didn't bet)
Seat 6: Link_fNK (small blind) folded on the River

PokerStars Hand #251209283203: Tournament #3769361908, $52.38+$2.62 USD Hold'em No Limit - Level V (60/120) - 2024/06/26 22:16:33 UTC [2024/06/26 18:16:33 ET]
Table '3769361908 1' 6-max Seat #6 is the button
Seat 1: lucaromanoo1 (11849 in chips) 
Seat 2: clareou0408 (9053 in chips) 
Seat 3: sinister778 (3944 in chips) 
Seat 4: mehditheboss (10993 in chips) 
Seat 5: lidi77777 (18102 in chips) 
Seat 6: Link_fNK (8009 in chips) 
lucaromanoo1: posts the ante 30
clareou0408: posts the ante 30
sinister778: posts the ante 30
mehditheboss: posts the ante 30
lidi77777: posts the ante 30
Link_fNK: posts the ante 30
lucaromanoo1: posts small blind 60
clareou0408: posts big blind 120
*** HOLE CARDS ***
sinister778: raises 120 to 240
mehditheboss: folds 
lidi77777: folds 
Link_fNK: raises 600 to 840
lucaromanoo1: folds 
clareou0408: folds 
sinister778: folds 
Uncalled bet (600) returned to Link_fNK
Link_fNK collected 840 from pot
Link_fNK: doesn't show hand 
*** SUMMARY ***
Total pot 840 | Rake 0 
Seat 1: lucaromanoo1 (small blind) folded before Flop
Seat 2: clareou0408 (big blind) folded before Flop
Seat 3: sinister778 folded before Flop
Seat 4: mehditheboss folded before Flop (didn't bet)
Seat 5: lidi77777 folded before Flop (didn't bet)
Seat 6: Link_fNK (button) collected (840)

PokerStars Hand #251209293039: Tournament #3769361908, $52.38+$2.62 USD Hold'em No Limit - Level V (60/120) - 2024/06/26 22:17:08 UTC [2024/06/26 18:17:08 ET]
Table '3769361908 1' 6-max Seat #1 is the button
Seat 1: lucaromanoo1 (11759 in chips) 
Seat 2: clareou0408 (8903 in chips) 
Seat 3: sinister778 (3674 in chips) 
Seat 4: mehditheboss (10963 in chips) 
Seat 5: lidi77777 (18072 in chips) 
Seat 6: Link_fNK (8579 in chips) 
lucaromanoo1: posts the ante 30
clareou0408: posts the ante 30
sinister778: posts the ante 30
mehditheboss: posts the ante 30
lidi77777: posts the ante 30
Link_fNK: posts the ante 30
clareou0408: posts small blind 60
sinister778: posts big blind 120
*** HOLE CARDS ***
mehditheboss: raises 120 to 240
lidi77777: folds 
Link_fNK: calls 240
lucaromanoo1: folds 
clareou0408: folds 
sinister778: raises 720 to 960
mehditheboss: folds 
Link_fNK: folds 
Uncalled bet (720) returned to sinister778
sinister778 collected 960 from pot
*** SUMMARY ***
Total pot 960 | Rake 0 
Seat 1: lucaromanoo1 (button) folded before Flop (didn't bet)
Seat 2: clareou0408 (small blind) folded before Flop
Seat 3: sinister778 (big blind) collected (960)
Seat 4: mehditheboss folded before Flop
Seat 5: lidi77777 folded before Flop (didn't bet)
Seat 6: Link_fNK folded before Flop

PokerStars Hand #251209300839: Tournament #3769361908, $52.38+$2.62 USD Hold'em No Limit - Level VI (80/160) - 2024/06/26 22:17:35 UTC [2024/06/26 18:17:35 ET]
Table '3769361908 1' 6-max Seat #2 is the button
Seat 1: lucaromanoo1 (11729 in chips) 
Seat 2: clareou0408 (8813 in chips) 
Seat 3: sinister778 (4364 in chips) 
Seat 4: mehditheboss (10693 in chips) 
Seat 5: lidi77777 (18042 in chips) 
Seat 6: Link_fNK (8309 in chips) 
lucaromanoo1: posts the ante 40
clareou0408: posts the ante 40
sinister778: posts the ante 40
mehditheboss: posts the ante 40
lidi77777: posts the ante 40
Link_fNK: posts the ante 40
sinister778: posts small blind 80
mehditheboss: posts big blind 160
*** HOLE CARDS ***
lidi77777: folds 
Link_fNK: folds 
lucaromanoo1: raises 192 to 352
clareou0408: calls 352
sinister778: folds 
mehditheboss: calls 192
*** FLOP *** [4s 9c Ah]
mehditheboss: checks 
lucaromanoo1: bets 440
clareou0408: calls 440
mehditheboss: raises 863 to 1303
lucaromanoo1: calls 863
clareou0408: folds 
*** TURN *** [4s 9c Ah] [6h]
mehditheboss: bets 2560
lucaromanoo1: calls 2560
*** RIVER *** [4s 9c Ah 6h] [Kd]
mehditheboss: bets 6438 and is all-in
lucaromanoo1: folds 
Uncalled bet (6438) returned to mehditheboss
mehditheboss collected 9542 from pot
mehditheboss: doesn't show hand 
*** SUMMARY ***
Total pot 9542 | Rake 0 
Board [4s 9c Ah 6h Kd]
Seat 1: lucaromanoo1 folded on the River
Seat 2: clareou0408 (button) folded on the Flop
Seat 3: sinister778 (small blind) folded before Flop
Seat 4: mehditheboss (big blind) collected (9542)
Seat 5: lidi77777 folded before Flop (didn't bet)
Seat 6: Link_fNK folded before Flop (didn't bet)

PokerStars Hand #251209330006: Tournament #3769361908, $52.38+$2.62 USD Hold'em No Limit - Level VI (80/160) - 2024/06/26 22:19:19 UTC [2024/06/26 18:19:19 ET]
Table '3769361908 1' 6-max Seat #3 is the button
Seat 1: lucaromanoo1 (7474 in chips) 
Seat 2: clareou0408 (7981 in chips) 
Seat 3: sinister778 (4244 in chips) 
Seat 4: mehditheboss (15980 in chips) 
Seat 5: lidi77777 (18002 in chips) 
Seat 6: Link_fNK (8269 in chips) 
lucaromanoo1: posts the ante 40
clareou0408: posts the ante 40
sinister778: posts the ante 40
mehditheboss: posts the ante 40
lidi77777: posts the ante 40
Link_fNK: posts the ante 40
mehditheboss: posts small blind 80
lidi77777: posts big blind 160
*** HOLE CARDS ***
Link_fNK: folds 
lucaromanoo1: raises 160 to 320
clareou0408: folds 
sinister778: folds 
mehditheboss: folds 
lidi77777: calls 160
*** FLOP *** [Ac Ts 2s]
lidi77777: checks 
lucaromanoo1: bets 560
lidi77777: calls 560
*** TURN *** [Ac Ts 2s] [2d]
lidi77777: checks 
lucaromanoo1: bets 1680
lidi77777: calls 1680
*** RIVER *** [Ac Ts 2s 2d] [Js]
lidi77777: checks 
lucaromanoo1: bets 4874 and is all-in
lidi77777: calls 4874
*** SHOW DOWN ***
lucaromanoo1: shows [Ad Qd] (two pair, Aces and Deuces)
lidi77777: shows [9h As] (two pair, Aces and Deuces - lower kicker)
lucaromanoo1 collected 15188 from pot
*** SUMMARY ***
Total pot 15188 | Rake 0 
Board [Ac Ts 2s 2d Js]
Seat 1: lucaromanoo1 showed [Ad Qd] and won (15188) with two pair, Aces and Deuces
Seat 2: clareou0408 folded before Flop (didn't bet)
Seat 3: sinister778 (button) folded before Flop (didn't bet)
Seat 4: mehditheboss (small blind) folded before Flop
Seat 5: lidi77777 (big blind) showed [9h As] and lost with two pair, Aces and Deuces
Seat 6: Link_fNK folded before Flop (didn't bet)

PokerStars Hand #251209348754: Tournament #3769361908, $52.38+$2.62 USD Hold'em No Limit - Level VII (100/200) - 2024/06/26 22:20:27 UTC [2024/06/26 18:20:27 ET]
Table '3769361908 1' 6-max Seat #4 is the button
Seat 1: lucaromanoo1 (15188 in chips) 
Seat 3: sinister778 (4204 in chips) 
Seat 4: mehditheboss (15860 in chips) 
Seat 5: lidi77777 (10528 in chips) 
Seat 6: Link_fNK (8229 in chips) 
lucaromanoo1: posts the ante 50
sinister778: posts the ante 50
mehditheboss: posts the ante 50
lidi77777: posts the ante 50
Link_fNK: posts the ante 50
lidi77777: posts small blind 100
Link_fNK: posts big blind 200
*** HOLE CARDS ***
lucaromanoo1: raises 200 to 400
sinister778: folds 
mehditheboss: folds 
lidi77777: calls 300
Link_fNK: folds 
*** FLOP *** [3h 4h 5d]
lidi77777: checks 
lucaromanoo1: bets 400
lidi77777: raises 1225 to 1625
lucaromanoo1: folds 
Uncalled bet (1225) returned to lidi77777
lidi77777 collected 2050 from pot
*** SUMMARY ***
Total pot 2050 | Rake 0 
Board [3h 4h 5d]
Seat 1: lucaromanoo1 folded on the Flop
Seat 3: sinister778 folded before Flop (didn't bet)
Seat 4: mehditheboss (button) folded before Flop (didn't bet)
Seat 5: lidi77777 (small blind) collected (2050)
Seat 6: Link_fNK (big blind) folded before Flop

PokerStars Hand #251209356462: Tournament #3769361908, $52.38+$2.62 USD Hold'em No Limit - Level VII (100/200) - 2024/06/26 22:20:54 UTC [2024/06/26 18:20:54 ET]
Table '3769361908 1' 6-max Seat #5 is the button
Seat 1: lucaromanoo1 (14338 in chips) 
Seat 3: sinister778 (4154 in chips) 
Seat 4: mehditheboss (15810 in chips) 
Seat 5: lidi77777 (11728 in chips) 
Seat 6: Link_fNK (7979 in chips) 
lucaromanoo1: posts the ante 50
sinister778: posts the ante 50
mehditheboss: posts the ante 50
lidi77777: posts the ante 50
Link_fNK: posts the ante 50
Link_fNK: posts small blind 100
lucaromanoo1: posts big blind 200
*** HOLE CARDS ***
sinister778: folds 
mehditheboss: raises 200 to 400
lidi77777: raises 1350 to 1750
Link_fNK: folds 
lucaromanoo1: folds 
mehditheboss: folds 
Uncalled bet (1350) returned to lidi77777
lidi77777 collected 1350 from pot
*** SUMMARY ***
Total pot 1350 | Rake 0 
Seat 1: lucaromanoo1 (big blind) folded before Flop
Seat 3: sinister778 folded before Flop (didn't bet)
Seat 4: mehditheboss folded before Flop
Seat 5: lidi77777 (button) collected (1350)
Seat 6: Link_fNK (small blind) folded before Flop

PokerStars Hand #251209362477: Tournament #3769361908, $52.38+$2.62 USD Hold'em No Limit - Level VII (100/200) - 2024/06/26 22:21:16 UTC [2024/06/26 18:21:16 ET]
Table '3769361908 1' 6-max Seat #6 is the button
Seat 1: lucaromanoo1 (14088 in chips) 
Seat 3: sinister778 (4104 in chips) 
Seat 4: mehditheboss (15360 in chips) 
Seat 5: lidi77777 (12628 in chips) 
Seat 6: Link_fNK (7829 in chips) 
lucaromanoo1: posts the ante 50
sinister778: posts the ante 50
mehditheboss: posts the ante 50
lidi77777: posts the ante 50
Link_fNK: posts the ante 50
lucaromanoo1: posts small blind 100
sinister778: posts big blind 200
*** HOLE CARDS ***
mehditheboss: folds 
lidi77777: folds 
anth0nypappa is disconnected 
Link_fNK: raises 200 to 400
lucaromanoo1: folds 
sinister778: calls 200
*** FLOP *** [8s 4d 5h]
sinister778: checks 
Link_fNK: checks 
*** TURN *** [8s 4d 5h] [3d]
lucaromanoo1 is disconnected 
sinister778: bets 800
Link_fNK: folds 
Uncalled bet (800) returned to sinister778
sinister778 collected 1150 from pot
*** SUMMARY ***
Total pot 1150 | Rake 0 
Board [8s 4d 5h 3d]
Seat 1: lucaromanoo1 (small blind) folded before Flop
Seat 3: sinister778 (big blind) collected (1150)
Seat 4: mehditheboss folded before Flop (didn't bet)
Seat 5: lidi77777 folded before Flop (didn't bet)
Seat 6: Link_fNK (button) folded on the Turn

PokerStars Hand #251209375889: Tournament #3769361908, $52.38+$2.62 USD Hold'em No Limit - Level VII (100/200) - 2024/06/26 22:22:04 UTC [2024/06/26 18:22:04 ET]
Table '3769361908 1' 6-max Seat #1 is the button
Seat 1: lucaromanoo1 (13938 in chips) 
Seat 2: anth0nypappa (10000 in chips) out of hand (moved from another table into small blind)
Seat 3: sinister778 (4804 in chips) 
Seat 4: mehditheboss (15310 in chips) 
Seat 5: lidi77777 (12578 in chips) 
Seat 6: Link_fNK (7379 in chips) 
anth0nypappa will be allowed to play after the button
lucaromanoo1: posts the ante 50
sinister778: posts the ante 50
mehditheboss: posts the ante 50
lidi77777: posts the ante 50
Link_fNK: posts the ante 50
sinister778: posts small blind 100
mehditheboss: posts big blind 200
*** HOLE CARDS ***
lidi77777: folds 
Link_fNK: folds 
lucaromanoo1: folds 
sinister778: raises 400 to 600
mehditheboss: folds 
Uncalled bet (400) returned to sinister778
sinister778 collected 650 from pot
*** SUMMARY ***
Total pot 650 | Rake 0 
Seat 1: lucaromanoo1 (button) folded before Flop (didn't bet)
Seat 3: sinister778 (small blind) collected (650)
Seat 4: mehditheboss (big blind) folded before Flop
Seat 5: lidi77777 folded before Flop (didn't bet)
Seat 6: Link_fNK folded before Flop (didn't bet)

PokerStars Hand #251209383596: Tournament #3769361908, $52.38+$2.62 USD Hold'em No Limit - Level VII (100/200) - 2024/06/26 22:22:31 UTC [2024/06/26 18:22:31 ET]
Table '3769361908 1' 6-max Seat #3 is the button
Seat 1: lucaromanoo1 (13888 in chips) 
Seat 2: anth0nypappa (10000 in chips) 
Seat 3: sinister778 (5204 in chips) 
Seat 4: mehditheboss (15060 in chips) 
Seat 5: lidi77777 (12528 in chips) 
Seat 6: Link_fNK (7329 in chips) 
lucaromanoo1: posts the ante 50
anth0nypappa: posts the ante 50
sinister778: posts the ante 50
mehditheboss: posts the ante 50
lidi77777: posts the ante 50
Link_fNK: posts the ante 50
mehditheboss: posts small blind 100
lidi77777: posts big blind 200
*** HOLE CARDS ***
Link_fNK: folds 
lucaromanoo1: folds 
anth0nypappa: folds 
sinister778: raises 400 to 600
mehditheboss: calls 500
lidi77777: folds 
*** FLOP *** [6d 7d Jd]
mehditheboss: checks 
sinister778: bets 4554 and is all-in
mehditheboss: folds 
Uncalled bet (4554) returned to sinister778
sinister778 collected 1700 from pot
*** SUMMARY ***
Total pot 1700 | Rake 0 
Board [6d 7d Jd]
Seat 1: lucaromanoo1 folded before Flop (didn't bet)
Seat 2: anth0nypappa folded before Flop (didn't bet)
Seat 3: sinister778 (button) collected (1700)
Seat 4: mehditheboss (small blind) folded on the Flop
Seat 5: lidi77777 (big blind) folded before Flop
Seat 6: Link_fNK folded before Flop (didn't bet)

PokerStars Hand #251209397685: Tournament #3769361908, $52.38+$2.62 USD Hold'em No Limit - Level VIII (125/250) - 2024/06/26 22:23:22 UTC [2024/06/26 18:23:22 ET]
Table '3769361908 1' 6-max Seat #4 is the button
Seat 1: lucaromanoo1 (13838 in chips) 
Seat 2: anth0nypappa (9950 in chips) 
Seat 3: sinister778 (6254 in chips) 
Seat 4: mehditheboss (14410 in chips) 
Seat 5: lidi77777 (12278 in chips) 
Seat 6: Link_fNK (7279 in chips) 
lucaromanoo1: posts the ante 60
anth0nypappa: posts the ante 60
sinister778: posts the ante 60
mehditheboss: posts the ante 60
lidi77777: posts the ante 60
Link_fNK: posts the ante 60
lidi77777: posts small blind 125
Link_fNK: posts big blind 250
*** HOLE CARDS ***
lucaromanoo1: folds 
anth0nypappa: folds 
sinister778: raises 250 to 500
mehditheboss: folds 
lidi77777: folds 
Link_fNK: calls 250
*** FLOP *** [9s Qh 2c]
Link_fNK: checks 
sinister778: checks 
*** TURN *** [9s Qh 2c] [5s]
Link_fNK: checks 
sinister778: checks 
*** RIVER *** [9s Qh 2c 5s] [7d]
Link_fNK: checks 
sinister778: checks 
*** SHOW DOWN ***
Link_fNK: shows [6h Kc] (high card King)
sinister778: shows [7h 8h] (a pair of Sevens)
sinister778 collected 1485 from pot
*** SUMMARY ***
Total pot 1485 | Rake 0 
Board [9s Qh 2c 5s 7d]
Seat 1: lucaromanoo1 folded before Flop (didn't bet)
Seat 2: anth0nypappa folded before Flop (didn't bet)
Seat 3: sinister778 showed [7h 8h] and won (1485) with a pair of Sevens
Seat 4: mehditheboss (button) folded before Flop (didn't bet)
Seat 5: lidi77777 (small blind) folded before Flop
Seat 6: Link_fNK (big blind) showed [6h Kc] and lost with high card King

PokerStars Hand #251209411751: Tournament #3769361908, $52.38+$2.62 USD Hold'em No Limit - Level VIII (125/250) - 2024/06/26 22:24:13 UTC [2024/06/26 18:24:13 ET]
Table '3769361908 1' 6-max Seat #5 is the button
Seat 1: lucaromanoo1 (13778 in chips) 
Seat 2: anth0nypappa (9890 in chips) 
Seat 3: sinister778 (7179 in chips) 
Seat 4: mehditheboss (14350 in chips) 
Seat 5: lidi77777 (12093 in chips) 
Seat 6: Link_fNK (6719 in chips) 
lucaromanoo1: posts the ante 60
anth0nypappa: posts the ante 60
sinister778: posts the ante 60
mehditheboss: posts the ante 60
lidi77777: posts the ante 60
Link_fNK: posts the ante 60
Link_fNK: posts small blind 125
lucaromanoo1: posts big blind 250
*** HOLE CARDS ***
anth0nypappa: folds 
sinister778: folds 
mehditheboss: folds 
lidi77777: folds 
Link_fNK: raises 500 to 750
lucaromanoo1: raises 12968 to 13718 and is all-in
Link_fNK: calls 5909 and is all-in
Uncalled bet (7059) returned to lucaromanoo1
*** FLOP *** [5c 7c Qh]
*** TURN *** [5c 7c Qh] [Ac]
*** RIVER *** [5c 7c Qh Ac] [8h]
*** SHOW DOWN ***
Link_fNK: shows [9h Ah] (a pair of Aces)
lucaromanoo1: shows [4c 4d] (a pair of Fours)
Link_fNK collected 13678 from pot
*** SUMMARY ***
Total pot 13678 | Rake 0 
Board [5c 7c Qh Ac 8h]
Seat 1: lucaromanoo1 (big blind) showed [4c 4d] and lost with a pair of Fours
Seat 2: anth0nypappa folded before Flop (didn't bet)
Seat 3: sinister778 folded before Flop (didn't bet)
Seat 4: mehditheboss folded before Flop (didn't bet)
Seat 5: lidi77777 (button) folded before Flop (didn't bet)
Seat 6: Link_fNK (small blind) showed [9h Ah] and won (13678) with a pair of Aces

PokerStars Hand #251209421037: Tournament #3769361908, $52.38+$2.62 USD Hold'em No Limit - Level VIII (125/250) - 2024/06/26 22:24:46 UTC [2024/06/26 18:24:46 ET]
Table '3769361908 1' 6-max Seat #6 is the button
Seat 1: lucaromanoo1 (7059 in chips) 
Seat 2: anth0nypappa (9830 in chips) 
Seat 3: sinister778 (7119 in chips) 
Seat 4: mehditheboss (14290 in chips) 
Seat 5: lidi77777 (12033 in chips) 
Seat 6: Link_fNK (13678 in chips) 
lucaromanoo1: posts the ante 60
anth0nypappa: posts the ante 60
sinister778: posts the ante 60
mehditheboss: posts the ante 60
lidi77777: posts the ante 60
Link_fNK: posts the ante 60
lucaromanoo1: posts small blind 125
anth0nypappa: posts big blind 250
*** HOLE CARDS ***
sinister778: folds 
mehditheboss: raises 300 to 550
lidi77777: calls 550
Link_fNK: raises 1635 to 2185
lucaromanoo1: folds 
anth0nypappa: folds 
mehditheboss: calls 1635
lidi77777: calls 1635
*** FLOP *** [Js Kh 3d]
mehditheboss: checks 
lidi77777: checks 
Link_fNK: checks 
*** TURN *** [Js Kh 3d] [5c]
mehditheboss: checks 
lidi77777: bets 3395
Link_fNK: folds 
mehditheboss: folds 
Uncalled bet (3395) returned to lidi77777
lidi77777 collected 7290 from pot
*** SUMMARY ***
Total pot 7290 | Rake 0 
Board [Js Kh 3d 5c]
Seat 1: lucaromanoo1 (small blind) folded before Flop
Seat 2: anth0nypappa (big blind) folded before Flop
Seat 3: sinister778 folded before Flop (didn't bet)
Seat 4: mehditheboss folded on the Turn
Seat 5: lidi77777 collected (7290)
Seat 6: Link_fNK (button) folded on the Turn

PokerStars Hand #251209438245: Tournament #3769361908, $52.38+$2.62 USD Hold'em No Limit - Level VIII (125/250) - 2024/06/26 22:25:48 UTC [2024/06/26 18:25:48 ET]
Table '3769361908 1' 6-max Seat #1 is the button
Seat 1: lucaromanoo1 (6874 in chips) 
Seat 2: anth0nypappa (9520 in chips) 
Seat 3: sinister778 (7059 in chips) 
Seat 4: mehditheboss (12045 in chips) 
Seat 5: lidi77777 (17078 in chips) 
Seat 6: Link_fNK (11433 in chips) 
lucaromanoo1: posts the ante 60
anth0nypappa: posts the ante 60
sinister778: posts the ante 60
mehditheboss: posts the ante 60
lidi77777: posts the ante 60
Link_fNK: posts the ante 60
anth0nypappa: posts small blind 125
sinister778: posts big blind 250
*** HOLE CARDS ***
mehditheboss: folds 
lidi77777: folds 
Link_fNK: folds 
lucaromanoo1: folds 
anth0nypappa: calls 125
sinister778: checks 
*** FLOP *** [Jd 8d 7c]
anth0nypappa: checks 
sinister778: checks 
*** TURN *** [Jd 8d 7c] [3d]
anth0nypappa: checks 
sinister778: checks 
*** RIVER *** [Jd 8d 7c 3d] [9c]
anth0nypappa: checks 
sinister778: checks 
*** SHOW DOWN ***
anth0nypappa: shows [4h Kh] (high card King)
sinister778: mucks hand 
anth0nypappa collected 860 from pot
*** SUMMARY ***
Total pot 860 | Rake 0 
Board [Jd 8d 7c 3d 9c]
Seat 1: lucaromanoo1 (button) folded before Flop (didn't bet)
Seat 2: anth0nypappa (small blind) showed [4h Kh] and won (860) with high card King
Seat 3: sinister778 (big blind) mucked
Seat 4: mehditheboss folded before Flop (didn't bet)
Seat 5: lidi77777 folded before Flop (didn't bet)
Seat 6: Link_fNK folded before Flop (didn't bet)

PokerStars Hand #251209451773: Tournament #3769361908, $52.38+$2.62 USD Hold'em No Limit - Level IX (150/300) - 2024/06/26 22:26:37 UTC [2024/06/26 18:26:37 ET]
Table '3769361908 1' 6-max Seat #2 is the button
Seat 1: lucaromanoo1 (6814 in chips) 
Seat 2: anth0nypappa (10070 in chips) 
Seat 3: sinister778 (6749 in chips) 
Seat 4: mehditheboss (11985 in chips) 
Seat 5: lidi77777 (17018 in chips) 
Seat 6: Link_fNK (11373 in chips) 
lucaromanoo1: posts the ante 75
anth0nypappa: posts the ante 75
sinister778: posts the ante 75
mehditheboss: posts the ante 75
lidi77777: posts the ante 75
Link_fNK: posts the ante 75
sinister778: posts small blind 150
mehditheboss: posts big blind 300
*** HOLE CARDS ***
lidi77777: folds 
Link_fNK: folds 
lucaromanoo1: folds 
anth0nypappa: raises 333 to 633
sinister778: folds 
mehditheboss: folds 
Uncalled bet (333) returned to anth0nypappa
anth0nypappa collected 1200 from pot
anth0nypappa: doesn't show hand 
*** SUMMARY ***
Total pot 1200 | Rake 0 
Seat 1: lucaromanoo1 folded before Flop (didn't bet)
Seat 2: anth0nypappa (button) collected (1200)
Seat 3: sinister778 (small blind) folded before Flop
Seat 4: mehditheboss (big blind) folded before Flop
Seat 5: lidi77777 folded before Flop (didn't bet)
Seat 6: Link_fNK folded before Flop (didn't bet)

PokerStars Hand #251209463242: Tournament #3769361908, $52.38+$2.62 USD Hold'em No Limit - Level IX (150/300) - 2024/06/26 22:27:18 UTC [2024/06/26 18:27:18 ET]
Table '3769361908 1' 6-max Seat #3 is the button
Seat 1: lucaromanoo1 (6739 in chips) 
Seat 2: anth0nypappa (10895 in chips) 
Seat 3: sinister778 (6524 in chips) 
Seat 4: mehditheboss (11610 in chips) 
Seat 5: lidi77777 (16943 in chips) 
Seat 6: Link_fNK (11298 in chips) 
lucaromanoo1: posts the ante 75
anth0nypappa: posts the ante 75
sinister778: posts the ante 75
mehditheboss: posts the ante 75
lidi77777: posts the ante 75
Link_fNK: posts the ante 75
mehditheboss: posts small blind 150
lidi77777: posts big blind 300
*** HOLE CARDS ***
Link_fNK: raises 300 to 600
lucaromanoo1: folds 
anth0nypappa: folds 
sinister778: folds 
mehditheboss: folds 
lidi77777: calls 300
*** FLOP *** [6d As 2s]
lidi77777: checks 
Link_fNK: bets 495
lidi77777: folds 
Uncalled bet (495) returned to Link_fNK
Link_fNK collected 1800 from pot
Link_fNK: doesn't show hand 
*** SUMMARY ***
Total pot 1800 | Rake 0 
Board [6d As 2s]
Seat 1: lucaromanoo1 folded before Flop (didn't bet)
Seat 2: anth0nypappa folded before Flop (didn't bet)
Seat 3: sinister778 (button) folded before Flop (didn't bet)
Seat 4: mehditheboss (small blind) folded before Flop
Seat 5: lidi77777 (big blind) folded on the Flop
Seat 6: Link_fNK collected (1800)

PokerStars Hand #251209476942: Tournament #3769361908, $52.38+$2.62 USD Hold'em No Limit - Level IX (150/300) - 2024/06/26 22:28:07 UTC [2024/06/26 18:28:07 ET]
Table '3769361908 1' 6-max Seat #4 is the button
Seat 1: lucaromanoo1 (6664 in chips) 
Seat 2: anth0nypappa (10820 in chips) 
Seat 3: sinister778 (6449 in chips) 
Seat 4: mehditheboss (11385 in chips) 
Seat 5: lidi77777 (16268 in chips) 
Seat 6: Link_fNK (12423 in chips) 
lucaromanoo1: posts the ante 75
anth0nypappa: posts the ante 75
sinister778: posts the ante 75
mehditheboss: posts the ante 75
lidi77777: posts the ante 75
Link_fNK: posts the ante 75
lidi77777: posts small blind 150
Link_fNK: posts big blind 300
*** HOLE CARDS ***
lucaromanoo1: folds 
anth0nypappa: raises 300 to 600
sinister778: raises 5774 to 6374 and is all-in
mehditheboss: folds 
lidi77777: folds 
Link_fNK: folds 
anth0nypappa: folds 
Uncalled bet (5774) returned to sinister778
sinister778 collected 2100 from pot
*** SUMMARY ***
Total pot 2100 | Rake 0 
Seat 1: lucaromanoo1 folded before Flop (didn't bet)
Seat 2: anth0nypappa folded before Flop
Seat 3: sinister778 collected (2100)
Seat 4: mehditheboss (button) folded before Flop (didn't bet)
Seat 5: lidi77777 (small blind) folded before Flop
Seat 6: Link_fNK (big blind) folded before Flop

PokerStars Hand #251209485257: Tournament #3769361908, $52.38+$2.62 USD Hold'em No Limit - Level IX (150/300) - 2024/06/26 22:28:37 UTC [2024/06/26 18:28:37 ET]
Table '3769361908 1' 6-max Seat #5 is the button
Seat 1: lucaromanoo1 (6589 in chips) 
Seat 2: anth0nypappa (10145 in chips) 
Seat 3: sinister778 (7874 in chips) 
Seat 4: mehditheboss (11310 in chips) 
Seat 5: lidi77777 (16043 in chips) 
Seat 6: Link_fNK (12048 in chips) 
lucaromanoo1: posts the ante 75
anth0nypappa: posts the ante 75
sinister778: posts the ante 75
mehditheboss: posts the ante 75
lidi77777: posts the ante 75
Link_fNK: posts the ante 75
Link_fNK: posts small blind 150
lucaromanoo1: posts big blind 300
*** HOLE CARDS ***
anth0nypappa: folds 
sinister778: folds 
mehditheboss: folds 
lidi77777: raises 300 to 600
Link_fNK: raises 1650 to 2250
lucaromanoo1: folds 
lidi77777: calls 1650
*** FLOP *** [Ac 2c Ad]
Link_fNK: bets 1380
lidi77777: calls 1380
*** TURN *** [Ac 2c Ad] [7c]
Link_fNK: bets 2669
lidi77777: calls 2669
*** RIVER *** [Ac 2c Ad 7c] [5c]
Link_fNK: bets 5674 and is all-in
lidi77777: calls 5674
*** SHOW DOWN ***
Link_fNK: shows [Kc As] (a flush, Ace high)
lidi77777: shows [8c Qc] (a flush, Ace high - lower cards)
Link_fNK collected 24696 from pot
*** SUMMARY ***
Total pot 24696 | Rake 0 
Board [Ac 2c Ad 7c 5c]
Seat 1: lucaromanoo1 (big blind) folded before Flop
Seat 2: anth0nypappa folded before Flop (didn't bet)
Seat 3: sinister778 folded before Flop (didn't bet)
Seat 4: mehditheboss folded before Flop (didn't bet)
Seat 5: lidi77777 (button) showed [8c Qc] and lost with a flush, Ace high
Seat 6: Link_fNK (small blind) showed [Kc As] and won (24696) with a flush, Ace high

PokerStars Hand #251209513937: Tournament #3769361908, $52.38+$2.62 USD Hold'em No Limit - Level X (200/400) - 2024/06/26 22:30:20 UTC [2024/06/26 18:30:20 ET]
Table '3769361908 1' 6-max Seat #6 is the button
Seat 1: lucaromanoo1 (6214 in chips) 
Seat 2: anth0nypappa (10070 in chips) 
Seat 3: sinister778 (7799 in chips) 
Seat 4: mehditheboss (11235 in chips) 
Seat 5: lidi77777 (3995 in chips) 
Seat 6: Link_fNK (24696 in chips) 
lucaromanoo1: posts the ante 100
anth0nypappa: posts the ante 100
sinister778: posts the ante 100
mehditheboss: posts the ante 100
lidi77777: posts the ante 100
Link_fNK: posts the ante 100
lucaromanoo1: posts small blind 200
anth0nypappa: posts big blind 400
*** HOLE CARDS ***
sinister778: folds 
mehditheboss: raises 400 to 800
lidi77777: raises 3095 to 3895 and is all-in
Link_fNK: folds 
lucaromanoo1: folds 
anth0nypappa: folds 
mehditheboss: calls 3095
*** FLOP *** [7d Kh 6d]
*** TURN *** [7d Kh 6d] [Js]
*** RIVER *** [7d Kh 6d Js] [Td]
*** SHOW DOWN ***
mehditheboss: shows [9s 7s] (a pair of Sevens)
lidi77777: shows [Kc Tc] (two pair, Kings and Tens)
lidi77777 collected 8990 from pot
*** SUMMARY ***
Total pot 8990 | Rake 0 
Board [7d Kh 6d Js Td]
Seat 1: lucaromanoo1 (small blind) folded before Flop
Seat 2: anth0nypappa (big blind) folded before Flop
Seat 3: sinister778 folded before Flop (didn't bet)
Seat 4: mehditheboss showed [9s 7s] and lost with a pair of Sevens
Seat 5: lidi77777 showed [Kc Tc] and won (8990) with two pair, Kings and Tens
Seat 6: Link_fNK (button) folded before Flop (didn't bet)

PokerStars Hand #251209521767: Tournament #3769361908, $52.38+$2.62 USD Hold'em No Limit - Level X (200/400) - 2024/06/26 22:30:48 UTC [2024/06/26 18:30:48 ET]
Table '3769361908 1' 6-max Seat #1 is the button
Seat 1: lucaromanoo1 (5914 in chips) 
Seat 2: anth0nypappa (9570 in chips) 
Seat 3: sinister778 (7699 in chips) 
Seat 4: mehditheboss (7240 in chips) 
Seat 5: lidi77777 (8990 in chips) 
Seat 6: Link_fNK (24596 in chips) 
lucaromanoo1: posts the ante 100
anth0nypappa: posts the ante 100
sinister778: posts the ante 100
mehditheboss: posts the ante 100
lidi77777: posts the ante 100
Link_fNK: posts the ante 100
anth0nypappa: posts small blind 200
sinister778: posts big blind 400
*** HOLE CARDS ***
mehditheboss: folds 
lidi77777: folds 
Link_fNK: folds 
lucaromanoo1: folds 
anth0nypappa: raises 9070 to 9470 and is all-in
sinister778: calls 7199 and is all-in
Uncalled bet (1871) returned to anth0nypappa
*** FLOP *** [Ad Kd 4h]
*** TURN *** [Ad Kd 4h] [Ts]
*** RIVER *** [Ad Kd 4h Ts] [Kh]
*** SHOW DOWN ***
anth0nypappa: shows [Jc 9h] (a pair of Kings)
sinister778: shows [2s Kc] (three of a kind, Kings)
sinister778 collected 15798 from pot
*** SUMMARY ***
Total pot 15798 | Rake 0 
Board [Ad Kd 4h Ts Kh]
Seat 1: lucaromanoo1 (button) folded before Flop (didn't bet)
Seat 2: anth0nypappa (small blind) showed [Jc 9h] and lost with a pair of Kings
Seat 3: sinister778 (big blind) showed [2s Kc] and won (15798) with three of a kind, Kings
Seat 4: mehditheboss folded before Flop (didn't bet)
Seat 5: lidi77777 folded before Flop (didn't bet)
Seat 6: Link_fNK folded before Flop (didn't bet)

PokerStars Hand #251209527139: Tournament #3769361908, $52.38+$2.62 USD Hold'em No Limit - Level X (200/400) - 2024/06/26 22:31:08 UTC [2024/06/26 18:31:08 ET]
Table '3769361908 1' 6-max Seat #2 is the button
Seat 1: lucaromanoo1 (5814 in chips) 
Seat 2: anth0nypappa (1871 in chips) 
Seat 3: sinister778 (15798 in chips) 
Seat 5: lidi77777 (8890 in chips) 
Seat 6: Link_fNK (24496 in chips) 
lucaromanoo1: posts the ante 100
anth0nypappa: posts the ante 100
sinister778: posts the ante 100
lidi77777: posts the ante 100
Link_fNK: posts the ante 100
sinister778: posts small blind 200
lidi77777: posts big blind 400
*** HOLE CARDS ***
Link_fNK: folds 
lucaromanoo1: raises 5314 to 5714 and is all-in
phcrf is disconnected 
anth0nypappa: folds 
sinister778: folds 
lidi77777: folds 
Uncalled bet (5314) returned to lucaromanoo1
lucaromanoo1 collected 1500 from pot
*** SUMMARY ***
Total pot 1500 | Rake 0 
Seat 1: lucaromanoo1 collected (1500)
Seat 2: anth0nypappa (button) folded before Flop (didn't bet)
Seat 3: sinister778 (small blind) folded before Flop
Seat 5: lidi77777 (big blind) folded before Flop
Seat 6: Link_fNK folded before Flop (didn't bet)

PokerStars Hand #251209534160: Tournament #3769361908, $52.38+$2.62 USD Hold'em No Limit - Level X (200/400) - 2024/06/26 22:31:33 UTC [2024/06/26 18:31:33 ET]
Table '3769361908 1' 6-max Seat #3 is the button
Seat 1: lucaromanoo1 (6814 in chips) 
Seat 2: anth0nypappa (1771 in chips) 
Seat 3: sinister778 (15498 in chips) 
Seat 4: phcrf (10000 in chips) out of hand (moved from another table into small blind)
Seat 5: lidi77777 (8390 in chips) 
Seat 6: Link_fNK (24396 in chips) 
phcrf will be allowed to play after the button
lucaromanoo1: posts the ante 100
anth0nypappa: posts the ante 100
sinister778: posts the ante 100
lidi77777: posts the ante 100
Link_fNK: posts the ante 100
lidi77777: posts small blind 200
Link_fNK: posts big blind 400
*** HOLE CARDS ***
lucaromanoo1: folds 
anth0nypappa: folds 
sinister778: folds 
lidi77777: raises 7890 to 8290 and is all-in
Link_fNK: folds 
Uncalled bet (7890) returned to lidi77777
lidi77777 collected 1300 from pot
*** SUMMARY ***
Total pot 1300 | Rake 0 
Seat 1: lucaromanoo1 folded before Flop (didn't bet)
Seat 2: anth0nypappa folded before Flop (didn't bet)
Seat 3: sinister778 (button) folded before Flop (didn't bet)
Seat 5: lidi77777 (small blind) collected (1300)
Seat 6: Link_fNK (big blind) folded before Flop

PokerStars Hand #251209537700: Tournament #3769361908, $52.38+$2.62 USD Hold'em No Limit - Level X (200/400) - 2024/06/26 22:31:46 UTC [2024/06/26 18:31:46 ET]
Table '3769361908 1' 6-max Seat #5 is the button
Seat 1: lucaromanoo1 (6714 in chips) 
Seat 2: anth0nypappa (1671 in chips) 
Seat 3: sinister778 (15398 in chips) 
Seat 4: phcrf (10000 in chips) 
Seat 5: lidi77777 (9190 in chips) 
Seat 6: Link_fNK (23896 in chips) 
lucaromanoo1: posts the ante 100
anth0nypappa: posts the ante 100
sinister778: posts the ante 100
phcrf: posts the ante 100
lidi77777: posts the ante 100
Link_fNK: posts the ante 100
Link_fNK: posts small blind 200
lucaromanoo1: posts big blind 400
*** HOLE CARDS ***
anth0nypappa: folds 
sinister778: folds 
phcrf: raises 400 to 800
lidi77777: calls 800
Link_fNK: folds 
lucaromanoo1: folds 
*** FLOP *** [Js 9h 9c]
phcrf: checks 
lidi77777: bets 800
phcrf: calls 800
*** TURN *** [Js 9h 9c] [Qh]
phcrf: checks 
lidi77777: bets 1800
phcrf: calls 1800
*** RIVER *** [Js 9h 9c Qh] [Ah]
phcrf: checks 
lidi77777: checks 
*** SHOW DOWN ***
phcrf: shows [Jh Jc] (a full house, Jacks full of Nines)
lidi77777: mucks hand 
phcrf collected 8000 from pot
*** SUMMARY ***
Total pot 8000 | Rake 0 
Board [Js 9h 9c Qh Ah]
Seat 1: lucaromanoo1 (big blind) folded before Flop
Seat 2: anth0nypappa folded before Flop (didn't bet)
Seat 3: sinister778 folded before Flop (didn't bet)
Seat 4: phcrf showed [Jh Jc] and won (8000) with a full house, Jacks full of Nines
Seat 5: lidi77777 (button) mucked
Seat 6: Link_fNK (small blind) folded before Flop

PokerStars Hand #251209555068: Tournament #3769361908, $52.38+$2.62 USD Hold'em No Limit - Level XI (250/500) - 2024/06/26 22:32:50 UTC [2024/06/26 18:32:50 ET]
Table '3769361908 1' 6-max Seat #6 is the button
Seat 1: lucaromanoo1 (6214 in chips) 
Seat 2: anth0nypappa (1571 in chips) 
Seat 3: sinister778 (15298 in chips) 
Seat 4: phcrf (14500 in chips) 
Seat 5: lidi77777 (5690 in chips) 
Seat 6: Link_fNK (23596 in chips) 
lucaromanoo1: posts the ante 125
anth0nypappa: posts the ante 125
sinister778: posts the ante 125
phcrf: posts the ante 125
lidi77777: posts the ante 125
Link_fNK: posts the ante 125
lucaromanoo1: posts small blind 250
anth0nypappa: posts big blind 500
*** HOLE CARDS ***
sinister778: folds 
phcrf: folds 
lidi77777: raises 5065 to 5565 and is all-in
Link_fNK: folds 
lucaromanoo1: folds 
anth0nypappa: calls 946 and is all-in
Uncalled bet (4119) returned to lidi77777
*** FLOP *** [2c 3s Jc]
*** TURN *** [2c 3s Jc] [6h]
*** RIVER *** [2c 3s Jc 6h] [4s]
*** SHOW DOWN ***
anth0nypappa: shows [2d 8d] (a pair of Deuces)
lidi77777: shows [Kd 9s] (high card King)
anth0nypappa collected 3892 from pot
*** SUMMARY ***
Total pot 3892 | Rake 0 
Board [2c 3s Jc 6h 4s]
Seat 1: lucaromanoo1 (small blind) folded before Flop
Seat 2: anth0nypappa (big blind) showed [2d 8d] and won (3892) with a pair of Deuces
Seat 3: sinister778 folded before Flop (didn't bet)
Seat 4: phcrf folded before Flop (didn't bet)
Seat 5: lidi77777 showed [Kd 9s] and lost with high card King
Seat 6: Link_fNK (button) folded before Flop (didn't bet)

PokerStars Hand #251209561660: Tournament #3769361908, $52.38+$2.62 USD Hold'em No Limit - Level XI (250/500) - 2024/06/26 22:33:15 UTC [2024/06/26 18:33:15 ET]
Table '3769361908 1' 6-max Seat #1 is the button
Seat 1: lucaromanoo1 (5839 in chips) 
Seat 2: anth0nypappa (3892 in chips) 
Seat 3: sinister778 (15173 in chips) 
Seat 4: phcrf (14375 in chips) 
Seat 5: lidi77777 (4119 in chips) 
Seat 6: Link_fNK (23471 in chips) 
lucaromanoo1: posts the ante 125
anth0nypappa: posts the ante 125
sinister778: posts the ante 125
phcrf: posts the ante 125
lidi77777: posts the ante 125
Link_fNK: posts the ante 125
anth0nypappa: posts small blind 250
sinister778: posts big blind 500
*** HOLE CARDS ***
phcrf: folds 
lidi77777: raises 3494 to 3994 and is all-in
Link_fNK: folds 
lucaromanoo1: folds 
anth0nypappa: folds 
sinister778: folds 
Uncalled bet (3494) returned to lidi77777
lidi77777 collected 2000 from pot
*** SUMMARY ***
Total pot 2000 | Rake 0 
Seat 1: lucaromanoo1 (button) folded before Flop (didn't bet)
Seat 2: anth0nypappa (small blind) folded before Flop
Seat 3: sinister778 (big blind) folded before Flop
Seat 4: phcrf folded before Flop (didn't bet)
Seat 5: lidi77777 collected (2000)
Seat 6: Link_fNK folded before Flop (didn't bet)

PokerStars Hand #251209567503: Tournament #3769361908, $52.38+$2.62 USD Hold'em No Limit - Level XI (250/500) - 2024/06/26 22:33:37 UTC [2024/06/26 18:33:37 ET]
Table '3769361908 1' 6-max Seat #2 is the button
Seat 1: lucaromanoo1 (5714 in chips) 
Seat 2: anth0nypappa (3517 in chips) 
Seat 3: sinister778 (14548 in chips) 
Seat 4: phcrf (14250 in chips) 
Seat 5: lidi77777 (5494 in chips) 
Seat 6: Link_fNK (23346 in chips) 
lucaromanoo1: posts the ante 125
anth0nypappa: posts the ante 125
sinister778: posts the ante 125
phcrf: posts the ante 125
lidi77777: posts the ante 125
Link_fNK: posts the ante 125
sinister778: posts small blind 250
phcrf: posts big blind 500
*** HOLE CARDS ***
lidi77777: calls 500
Link_fNK: folds 
lucaromanoo1: raises 5089 to 5589 and is all-in
anth0nypappa: folds 
sinister778: folds 
phcrf: folds 
lidi77777: calls 4869 and is all-in
Uncalled bet (220) returned to lucaromanoo1
*** FLOP *** [2d Qc 6c]
*** TURN *** [2d Qc 6c] [6s]
*** RIVER *** [2d Qc 6c 6s] [6h]
*** SHOW DOWN ***
lidi77777: shows [Ad Ah] (a full house, Sixes full of Aces)
lucaromanoo1: shows [8s 8d] (a full house, Sixes full of Eights)
lidi77777 collected 12238 from pot
*** SUMMARY ***
Total pot 12238 | Rake 0 
Board [2d Qc 6c 6s 6h]
Seat 1: lucaromanoo1 showed [8s 8d] and lost with a full house, Sixes full of Eights
Seat 2: anth0nypappa (button) folded before Flop (didn't bet)
Seat 3: sinister778 (small blind) folded before Flop
Seat 4: phcrf (big blind) folded before Flop
Seat 5: lidi77777 showed [Ad Ah] and won (12238) with a full house, Sixes full of Aces
Seat 6: Link_fNK folded before Flop (didn't bet)

PokerStars Hand #251209576426: Tournament #3769361908, $52.38+$2.62 USD Hold'em No Limit - Level XI (250/500) - 2024/06/26 22:34:10 UTC [2024/06/26 18:34:10 ET]
Table '3769361908 1' 6-max Seat #3 is the button
Seat 1: lucaromanoo1 (220 in chips) 
Seat 2: anth0nypappa (3392 in chips) 
Seat 3: sinister778 (14173 in chips) 
Seat 4: phcrf (13625 in chips) 
Seat 5: lidi77777 (12238 in chips) 
Seat 6: Link_fNK (23221 in chips) 
lucaromanoo1: posts the ante 125
anth0nypappa: posts the ante 125
sinister778: posts the ante 125
phcrf: posts the ante 125
lidi77777: posts the ante 125
Link_fNK: posts the ante 125
phcrf: posts small blind 250
lidi77777: posts big blind 500
*** HOLE CARDS ***
Link_fNK: raises 500 to 1000
lucaromanoo1: folds 
anth0nypappa: folds 
sinister778: calls 1000
phcrf: folds 
lidi77777: folds 
*** FLOP *** [6s Kd Qh]
Link_fNK: checks 
sinister778: bets 1500
Link_fNK: folds 
Uncalled bet (1500) returned to sinister778
sinister778 collected 3500 from pot
*** SUMMARY ***
Total pot 3500 | Rake 0 
Board [6s Kd Qh]
Seat 1: lucaromanoo1 folded before Flop (didn't bet)
Seat 2: anth0nypappa folded before Flop (didn't bet)
Seat 3: sinister778 (button) collected (3500)
Seat 4: phcrf (small blind) folded before Flop
Seat 5: lidi77777 (big blind) folded before Flop
Seat 6: Link_fNK folded on the Flop

PokerStars Hand #251209588785: Tournament #3769361908, $52.38+$2.62 USD Hold'em No Limit - Level XI (250/500) - 2024/06/26 22:34:55 UTC [2024/06/26 18:34:55 ET]
Table '3769361908 1' 6-max Seat #4 is the button
Seat 1: lucaromanoo1 (95 in chips) 
Seat 2: anth0nypappa (3267 in chips) 
Seat 3: sinister778 (16548 in chips) 
Seat 4: phcrf (13250 in chips) 
Seat 5: lidi77777 (11613 in chips) 
Seat 6: Link_fNK (22096 in chips) 
lucaromanoo1: posts the ante 95 and is all-in
anth0nypappa: posts the ante 125
sinister778: posts the ante 125
phcrf: posts the ante 125
lidi77777: posts the ante 125
Link_fNK: posts the ante 125
lidi77777: posts small blind 250
Link_fNK: posts big blind 500
*** HOLE CARDS ***
anth0nypappa is disconnected 
anth0nypappa has timed out while disconnected
anth0nypappa: folds 
anth0nypappa is sitting out
sinister778: folds 
phcrf: folds 
lucaromanoo1 is disconnected 
lidi77777: raises 10988 to 11488 and is all-in
Link_fNK: calls 10988
*** FLOP *** [7d 5c 5s]
*** TURN *** [7d 5c 5s] [6d]
*** RIVER *** [7d 5c 5s 6d] [2c]
*** SHOW DOWN ***
lidi77777: shows [2h 7h] (two pair, Sevens and Fives)
Link_fNK: shows [Qs Qh] (two pair, Queens and Fives)
Link_fNK collected 23126 from side pot
lucaromanoo1: shows [4s Qd] (a pair of Fives)
lucaromanoo1 is disconnected 
Link_fNK collected 570 from main pot
lidi77777 finished the tournament
lucaromanoo1 finished the tournament
*** SUMMARY ***
Total pot 23696 Main pot 570. Side pot 23126. | Rake 0 
Board [7d 5c 5s 6d 2c]
Seat 1: lucaromanoo1 showed [4s Qd] and lost with a pair of Fives
Seat 2: anth0nypappa folded before Flop (didn't bet)
Seat 3: sinister778 folded before Flop (didn't bet)
Seat 4: phcrf (button) folded before Flop (didn't bet)
Seat 5: lidi77777 (small blind) showed [2h 7h] and lost with two pair, Sevens and Fives
Seat 6: Link_fNK (big blind) showed [Qs Qh] and won (23696) with two pair, Queens and Fives

PokerStars Hand #251209607786: Tournament #3769361908, $52.38+$2.62 USD Hold'em No Limit - Level XII (300/600) - 2024/06/26 22:36:06 UTC [2024/06/26 18:36:06 ET]
Table '3769361908 1' 6-max Seat #6 is the button
Seat 1: Accio Aces1 (37044 in chips) out of hand (moved from another table into small blind)
Seat 2: anth0nypappa (3142 in chips) is sitting out
Seat 3: sinister778 (16423 in chips) 
Seat 4: phcrf (13125 in chips) 
Seat 6: Link_fNK (34179 in chips) 
Accio Aces1 will be allowed to play after the button
anth0nypappa: posts the ante 150
sinister778: posts the ante 150
phcrf: posts the ante 150
Link_fNK: posts the ante 150
anth0nypappa: posts small blind 300
sinister778: posts big blind 600
*** HOLE CARDS ***
joaoMathias is disconnected 
phcrf: folds 
Link_fNK: raises 600 to 1200
anth0nypappa: folds 
sinister778: calls 600
*** FLOP *** [2s Js 9s]
sinister778: checks 
Link_fNK: bets 825
sinister778: calls 825
*** TURN *** [2s Js 9s] [Td]
sinister778: checks 
Link_fNK: bets 3720
sinister778: calls 3720
*** RIVER *** [2s Js 9s Td] [5d]
sinister778: checks 
Link_fNK: bets 12390
sinister778: calls 10528 and is all-in
Uncalled bet (1862) returned to Link_fNK
*** SHOW DOWN ***
Link_fNK: shows [Ad 3s] (high card Ace)
sinister778: shows [Th Jd] (two pair, Jacks and Tens)
sinister778 collected 33446 from pot
*** SUMMARY ***
Total pot 33446 | Rake 0 
Board [2s Js 9s Td 5d]
Seat 2: anth0nypappa (small blind) folded before Flop
Seat 3: sinister778 (big blind) showed [Th Jd] and won (33446) with two pair, Jacks and Tens
Seat 4: phcrf folded before Flop (didn't bet)
Seat 6: Link_fNK (button) showed [Ad 3s] and lost with high card Ace

PokerStars Hand #251209634091: Tournament #3769361908, $52.38+$2.62 USD Hold'em No Limit - Level XII (300/600) - 2024/06/26 22:37:45 UTC [2024/06/26 18:37:45 ET]
Table '3769361908 1' 6-max Seat #2 is the button
Seat 1: Accio Aces1 (37044 in chips) 
Seat 2: anth0nypappa (2692 in chips) is sitting out
Seat 3: sinister778 (33446 in chips) 
Seat 4: phcrf (12975 in chips) 
Seat 5: joaoMathias (9850 in chips) 
Seat 6: Link_fNK (17756 in chips) 
Accio Aces1: posts the ante 150
anth0nypappa: posts the ante 150
sinister778: posts the ante 150
phcrf: posts the ante 150
joaoMathias: posts the ante 150
Link_fNK: posts the ante 150
sinister778: posts small blind 300
phcrf: posts big blind 600
*** HOLE CARDS ***
joaoMathias: folds 
Link_fNK: folds 
Accio Aces1: folds 
anth0nypappa: folds 
sinister778: raises 1200 to 1800
phcrf: folds [2c]
Uncalled bet (1200) returned to sinister778
sinister778 collected 2100 from pot
*** SUMMARY ***
Total pot 2100 | Rake 0 
Seat 1: Accio Aces1 folded before Flop (didn't bet)
Seat 2: anth0nypappa (button) folded before Flop (didn't bet)
Seat 3: sinister778 (small blind) collected (2100)
Seat 4: phcrf (big blind) folded before Flop
Seat 5: joaoMathias folded before Flop (didn't bet)
Seat 6: Link_fNK folded before Flop (didn't bet)

PokerStars Hand #251209645530: Tournament #3769361908, $52.38+$2.62 USD Hold'em No Limit - Level XIII (400/800) - 2024/06/26 22:38:27 UTC [2024/06/26 18:38:27 ET]
Table '3769361908 1' 6-max Seat #3 is the button
Seat 1: Accio Aces1 (36894 in chips) 
Seat 2: anth0nypappa (2542 in chips) is sitting out
Seat 3: sinister778 (34796 in chips) 
Seat 4: phcrf (12225 in chips) 
Seat 5: joaoMathias (9700 in chips) 
Seat 6: Link_fNK (17606 in chips) 
Accio Aces1: posts the ante 200
anth0nypappa: posts the ante 200
sinister778: posts the ante 200
phcrf: posts the ante 200
joaoMathias: posts the ante 200
Link_fNK: posts the ante 200
phcrf: posts small blind 400
joaoMathias: posts big blind 800
*** HOLE CARDS ***
Link_fNK: folds 
Accio Aces1: folds 
anth0nypappa: folds 
sinister778: folds 
phcrf: raises 11225 to 12025 and is all-in
joaoMathias: calls 8700 and is all-in
Uncalled bet (2525) returned to phcrf
*** FLOP *** [5h Kc Th]
*** TURN *** [5h Kc Th] [Ks]
*** RIVER *** [5h Kc Th Ks] [Jd]
*** SHOW DOWN ***
phcrf: shows [Js 6s] (two pair, Kings and Jacks)
joaoMathias: shows [9h 9s] (two pair, Kings and Nines)
phcrf collected 20200 from pot
joaoMathias finished the tournament
*** SUMMARY ***
Total pot 20200 | Rake 0 
Board [5h Kc Th Ks Jd]
Seat 1: Accio Aces1 folded before Flop (didn't bet)
Seat 2: anth0nypappa folded before Flop (didn't bet)
Seat 3: sinister778 (button) folded before Flop (didn't bet)
Seat 4: phcrf (small blind) showed [Js 6s] and won (20200) with two pair, Kings and Jacks
Seat 5: joaoMathias (big blind) showed [9h 9s] and lost with two pair, Kings and Nines
Seat 6: Link_fNK folded before Flop (didn't bet)

PokerStars Hand #251209652982: Tournament #3769361908, $52.38+$2.62 USD Hold'em No Limit - Level XIII (400/800) - 2024/06/26 22:38:55 UTC [2024/06/26 18:38:55 ET]
Table '3769361908 1' 6-max Seat #4 is the button
Seat 1: Accio Aces1 (36694 in chips) 
Seat 2: anth0nypappa (2342 in chips) is sitting out
Seat 3: sinister778 (34596 in chips) 
Seat 4: phcrf (22725 in chips) 
Seat 6: Link_fNK (17406 in chips) 
Accio Aces1: posts the ante 200
anth0nypappa: posts the ante 200
sinister778: posts the ante 200
phcrf: posts the ante 200
Link_fNK: posts the ante 200
Link_fNK: posts small blind 400
Accio Aces1: posts big blind 800
*** HOLE CARDS ***
anth0nypappa: folds 
sinister778: folds 
phcrf: raises 800 to 1600
Link_fNK: folds 
Accio Aces1: raises 34894 to 36494 and is all-in
phcrf: calls 20925 and is all-in
Uncalled bet (13969) returned to Accio Aces1
*** FLOP *** [Qh 9c 8s]
*** TURN *** [Qh 9c 8s] [4h]
*** RIVER *** [Qh 9c 8s 4h] [5d]
*** SHOW DOWN ***
Accio Aces1: shows [5s 4s] (two pair, Fives and Fours)
phcrf: shows [As Kh] (high card Ace)
Accio Aces1 collected 46450 from pot
phcrf finished the tournament
*** SUMMARY ***
Total pot 46450 | Rake 0 
Board [Qh 9c 8s 4h 5d]
Seat 1: Accio Aces1 (big blind) showed [5s 4s] and won (46450) with two pair, Fives and Fours
Seat 2: anth0nypappa folded before Flop (didn't bet)
Seat 3: sinister778 folded before Flop (didn't bet)
Seat 4: phcrf (button) showed [As Kh] and lost with high card Ace
Seat 6: Link_fNK (small blind) folded before Flop


PokerStars Hand #251209421633: Tournament #3769361908, $52.38+$2.62 USD Hold'em No Limit - Level VIII (125/250) - 2024/06/26 22:24:48 UTC [2024/06/26 18:24:48 ET]
Table '3769361908 16' 6-max Seat #4 is the button
Seat 1: fofAAoBR (24308 in chips) 
Seat 2: SAS_IDS0804 (9940 in chips) 
Seat 3: JonzStars (4132 in chips) 
Seat 4: MagoDelBaralho (8756 in chips) 
Seat 5: VICTOR TXR1 (9617 in chips) 
Seat 6: XxJoaoFeraxX (11346 in chips) 
fofAAoBR: posts the ante 60
SAS_IDS0804: posts the ante 60
JonzStars: posts the ante 60
MagoDelBaralho: posts the ante 60
VICTOR TXR1: posts the ante 60
XxJoaoFeraxX: posts the ante 60
VICTOR TXR1: posts small blind 125
XxJoaoFeraxX: posts big blind 250
*** HOLE CARDS ***
fofAAoBR: folds 
SAS_IDS0804: folds 
JonzStars: raises 250 to 500
MagoDelBaralho: folds 
VICTOR TXR1: folds 
XxJoaoFeraxX: folds 
Uncalled bet (250) returned to JonzStars
JonzStars collected 985 from pot
*** SUMMARY ***
Total pot 985 | Rake 0 
Seat 1: fofAAoBR folded before Flop (didn't bet)
Seat 2: SAS_IDS0804 folded before Flop (didn't bet)
Seat 3: JonzStars collected (985)
Seat 4: MagoDelBaralho (button) folded before Flop (didn't bet)
Seat 5: VICTOR TXR1 (small blind) folded before Flop
Seat 6: XxJoaoFeraxX (big blind) folded before Flop

PokerStars Hand #251209428726: Tournament #3769361908, $52.38+$2.62 USD Hold'em No Limit - Level VIII (125/250) - 2024/06/26 22:25:14 UTC [2024/06/26 18:25:14 ET]
Table '3769361908 16' 6-max Seat #5 is the button
Seat 1: fofAAoBR (24248 in chips) 
Seat 2: SAS_IDS0804 (9880 in chips) 
Seat 3: JonzStars (4807 in chips) 
Seat 4: MagoDelBaralho (8696 in chips) 
Seat 5: VICTOR TXR1 (9432 in chips) 
Seat 6: XxJoaoFeraxX (11036 in chips) 
fofAAoBR: posts the ante 60
SAS_IDS0804: posts the ante 60
JonzStars: posts the ante 60
MagoDelBaralho: posts the ante 60
VICTOR TXR1: posts the ante 60
XxJoaoFeraxX: posts the ante 60
XxJoaoFeraxX: posts small blind 125
fofAAoBR: posts big blind 250
*** HOLE CARDS ***
SAS_IDS0804: folds 
JonzStars: folds 
MagoDelBaralho: folds 
VICTOR TXR1: folds 
XxJoaoFeraxX: calls 125
fofAAoBR: raises 750 to 1000
XxJoaoFeraxX: folds 
Uncalled bet (750) returned to fofAAoBR
fofAAoBR collected 860 from pot
fofAAoBR: doesn't show hand 
*** SUMMARY ***
Total pot 860 | Rake 0 
Seat 1: fofAAoBR (big blind) collected (860)
Seat 2: SAS_IDS0804 folded before Flop (didn't bet)
Seat 3: JonzStars folded before Flop (didn't bet)
Seat 4: MagoDelBaralho folded before Flop (didn't bet)
Seat 5: VICTOR TXR1 (button) folded before Flop (didn't bet)
Seat 6: XxJoaoFeraxX (small blind) folded before Flop

PokerStars Hand #251209440366: Tournament #3769361908, $52.38+$2.62 USD Hold'em No Limit - Level VIII (125/250) - 2024/06/26 22:25:56 UTC [2024/06/26 18:25:56 ET]
Table '3769361908 16' 6-max Seat #6 is the button
Seat 1: fofAAoBR (24798 in chips) 
Seat 2: SAS_IDS0804 (9820 in chips) 
Seat 3: JonzStars (4747 in chips) 
Seat 4: MagoDelBaralho (8636 in chips) 
Seat 5: VICTOR TXR1 (9372 in chips) 
Seat 6: XxJoaoFeraxX (10726 in chips) 
fofAAoBR: posts the ante 60
SAS_IDS0804: posts the ante 60
JonzStars: posts the ante 60
MagoDelBaralho: posts the ante 60
VICTOR TXR1: posts the ante 60
XxJoaoFeraxX: posts the ante 60
fofAAoBR: posts small blind 125
SAS_IDS0804: posts big blind 250
*** HOLE CARDS ***
JonzStars: folds 
MagoDelBaralho: folds 
VICTOR TXR1: folds 
XxJoaoFeraxX: raises 250 to 500
fofAAoBR: calls 375
SAS_IDS0804: calls 250
*** FLOP *** [2d Jd Qd]
fofAAoBR: checks 
SAS_IDS0804: checks 
XxJoaoFeraxX: checks 
*** TURN *** [2d Jd Qd] [Tc]
fofAAoBR: checks 
SAS_IDS0804: checks 
XxJoaoFeraxX: checks 
*** RIVER *** [2d Jd Qd Tc] [Th]
fofAAoBR: checks 
SAS_IDS0804: checks 
XxJoaoFeraxX: bets 614
fofAAoBR: folds 
SAS_IDS0804: folds 
Uncalled bet (614) returned to XxJoaoFeraxX
XxJoaoFeraxX collected 1860 from pot
XxJoaoFeraxX: doesn't show hand 
*** SUMMARY ***
Total pot 1860 | Rake 0 
Board [2d Jd Qd Tc Th]
Seat 1: fofAAoBR (small blind) folded on the River
Seat 2: SAS_IDS0804 (big blind) folded on the River
Seat 3: JonzStars folded before Flop (didn't bet)
Seat 4: MagoDelBaralho folded before Flop (didn't bet)
Seat 5: VICTOR TXR1 folded before Flop (didn't bet)
Seat 6: XxJoaoFeraxX (button) collected (1860)

PokerStars Hand #251209470341: Tournament #3769361908, $52.38+$2.62 USD Hold'em No Limit - Level IX (150/300) - 2024/06/26 22:27:44 UTC [2024/06/26 18:27:44 ET]
Table '3769361908 16' 6-max Seat #1 is the button
Seat 1: fofAAoBR (24238 in chips) 
Seat 2: SAS_IDS0804 (9260 in chips) 
Seat 3: JonzStars (4687 in chips) 
Seat 4: MagoDelBaralho (8576 in chips) 
Seat 5: VICTOR TXR1 (9312 in chips) 
Seat 6: XxJoaoFeraxX (12026 in chips) 
fofAAoBR: posts the ante 75
SAS_IDS0804: posts the ante 75
JonzStars: posts the ante 75
MagoDelBaralho: posts the ante 75
VICTOR TXR1: posts the ante 75
XxJoaoFeraxX: posts the ante 75
SAS_IDS0804: posts small blind 150
JonzStars: posts big blind 300
*** HOLE CARDS ***
MagoDelBaralho: folds 
VICTOR TXR1: raises 348 to 648
XxJoaoFeraxX: folds 
fofAAoBR: calls 648
SAS_IDS0804: folds 
JonzStars: folds 
*** FLOP *** [9h Ks 3s]
VICTOR TXR1: checks 
fofAAoBR: checks 
*** TURN *** [9h Ks 3s] [7c]
VICTOR TXR1: bets 1500
fofAAoBR: calls 1500
*** RIVER *** [9h Ks 3s 7c] [5d]
VICTOR TXR1: checks 
fofAAoBR: checks 
*** SHOW DOWN ***
VICTOR TXR1: shows [Ah 5h] (a pair of Fives)
fofAAoBR: shows [Jh Jd] (a pair of Jacks)
fofAAoBR collected 5196 from pot
*** SUMMARY ***
Total pot 5196 | Rake 0 
Board [9h Ks 3s 7c 5d]
Seat 1: fofAAoBR (button) showed [Jh Jd] and won (5196) with a pair of Jacks
Seat 2: SAS_IDS0804 (small blind) folded before Flop
Seat 3: JonzStars (big blind) folded before Flop
Seat 4: MagoDelBaralho folded before Flop (didn't bet)
Seat 5: VICTOR TXR1 showed [Ah 5h] and lost with a pair of Fives
Seat 6: XxJoaoFeraxX folded before Flop (didn't bet)

PokerStars Hand #251209485644: Tournament #3769361908, $52.38+$2.62 USD Hold'em No Limit - Level IX (150/300) - 2024/06/26 22:28:38 UTC [2024/06/26 18:28:38 ET]
Table '3769361908 16' 6-max Seat #2 is the button
Seat 1: fofAAoBR (27211 in chips) 
Seat 2: SAS_IDS0804 (9035 in chips) 
Seat 3: JonzStars (4312 in chips) 
Seat 4: MagoDelBaralho (8501 in chips) 
Seat 5: VICTOR TXR1 (7089 in chips) 
Seat 6: XxJoaoFeraxX (11951 in chips) 
fofAAoBR: posts the ante 75
SAS_IDS0804: posts the ante 75
JonzStars: posts the ante 75
MagoDelBaralho: posts the ante 75
VICTOR TXR1: posts the ante 75
XxJoaoFeraxX: posts the ante 75
JonzStars: posts small blind 150
MagoDelBaralho: posts big blind 300
*** HOLE CARDS ***
VICTOR TXR1: folds 
XxJoaoFeraxX: folds 
fofAAoBR: raises 300 to 600
SAS_IDS0804: folds 
JonzStars: raises 3637 to 4237 and is all-in
MagoDelBaralho: folds 
fofAAoBR: folds 
Uncalled bet (3637) returned to JonzStars
JonzStars collected 1950 from pot
*** SUMMARY ***
Total pot 1950 | Rake 0 
Seat 1: fofAAoBR folded before Flop
Seat 2: SAS_IDS0804 (button) folded before Flop (didn't bet)
Seat 3: JonzStars (small blind) collected (1950)
Seat 4: MagoDelBaralho (big blind) folded before Flop
Seat 5: VICTOR TXR1 folded before Flop (didn't bet)
Seat 6: XxJoaoFeraxX folded before Flop (didn't bet)

PokerStars Hand #251209492386: Tournament #3769361908, $52.38+$2.62 USD Hold'em No Limit - Level IX (150/300) - 2024/06/26 22:29:03 UTC [2024/06/26 18:29:03 ET]
Table '3769361908 16' 6-max Seat #3 is the button
Seat 1: fofAAoBR (26536 in chips) 
Seat 2: SAS_IDS0804 (8960 in chips) 
Seat 3: JonzStars (5587 in chips) 
Seat 4: MagoDelBaralho (8126 in chips) 
Seat 6: XxJoaoFeraxX (11876 in chips) 
fofAAoBR: posts the ante 75
SAS_IDS0804: posts the ante 75
JonzStars: posts the ante 75
MagoDelBaralho: posts the ante 75
XxJoaoFeraxX: posts the ante 75
MagoDelBaralho: posts small blind 150
XxJoaoFeraxX: posts big blind 300
*** HOLE CARDS ***
fofAAoBR: folds 
SAS_IDS0804: folds 
JonzStars: folds 
MagoDelBaralho: folds 
Uncalled bet (150) returned to XxJoaoFeraxX
XxJoaoFeraxX collected 675 from pot
XxJoaoFeraxX: doesn't show hand 
*** SUMMARY ***
Total pot 675 | Rake 0 
Seat 1: fofAAoBR folded before Flop (didn't bet)
Seat 2: SAS_IDS0804 folded before Flop (didn't bet)
Seat 3: JonzStars (button) folded before Flop (didn't bet)
Seat 4: MagoDelBaralho (small blind) folded before Flop
Seat 6: XxJoaoFeraxX (big blind) collected (675)

PokerStars Hand #251209502783: Tournament #3769361908, $52.38+$2.62 USD Hold'em No Limit - Level X (200/400) - 2024/06/26 22:29:40 UTC [2024/06/26 18:29:40 ET]
Table '3769361908 16' 6-max Seat #4 is the button
Seat 1: fofAAoBR (26461 in chips) 
Seat 2: SAS_IDS0804 (8885 in chips) 
Seat 3: JonzStars (5512 in chips) 
Seat 4: MagoDelBaralho (7901 in chips) 
Seat 6: XxJoaoFeraxX (12326 in chips) 
fofAAoBR: posts the ante 100
SAS_IDS0804: posts the ante 100
JonzStars: posts the ante 100
MagoDelBaralho: posts the ante 100
XxJoaoFeraxX: posts the ante 100
XxJoaoFeraxX: posts small blind 200
fofAAoBR: posts big blind 400
*** HOLE CARDS ***
SAS_IDS0804: folds 
JonzStars: folds 
MagoDelBaralho: folds 
XxJoaoFeraxX: calls 200
fofAAoBR: checks 
*** FLOP *** [5h Tc Ad]
XxJoaoFeraxX: checks 
fofAAoBR: bets 400
XxJoaoFeraxX: calls 400
*** TURN *** [5h Tc Ad] [2d]
XxJoaoFeraxX: checks 
fofAAoBR: bets 1470
XxJoaoFeraxX: folds 
Uncalled bet (1470) returned to fofAAoBR
fofAAoBR collected 2100 from pot
fofAAoBR: doesn't show hand 
*** SUMMARY ***
Total pot 2100 | Rake 0 
Board [5h Tc Ad 2d]
Seat 1: fofAAoBR (big blind) collected (2100)
Seat 2: SAS_IDS0804 folded before Flop (didn't bet)
Seat 3: JonzStars folded before Flop (didn't bet)
Seat 4: MagoDelBaralho (button) folded before Flop (didn't bet)
Seat 6: XxJoaoFeraxX (small blind) folded on the Turn

PokerStars Hand #251209516322: Tournament #3769361908, $52.38+$2.62 USD Hold'em No Limit - Level X (200/400) - 2024/06/26 22:30:28 UTC [2024/06/26 18:30:28 ET]
Table '3769361908 16' 6-max Seat #6 is the button
Seat 1: fofAAoBR (27661 in chips) 
Seat 2: SAS_IDS0804 (8785 in chips) 
Seat 3: JonzStars (5412 in chips) 
Seat 4: MagoDelBaralho (7801 in chips) 
Seat 6: XxJoaoFeraxX (11426 in chips) 
fofAAoBR: posts the ante 100
SAS_IDS0804: posts the ante 100
JonzStars: posts the ante 100
MagoDelBaralho: posts the ante 100
XxJoaoFeraxX: posts the ante 100
fofAAoBR: posts small blind 200
SAS_IDS0804: posts big blind 400
*** HOLE CARDS ***
JonzStars: folds 
MagoDelBaralho: folds 
XxJoaoFeraxX: raises 400 to 800
fofAAoBR: folds 
SAS_IDS0804: calls 400
*** FLOP *** [5s Qh 3s]
SAS_IDS0804: checks 
XxJoaoFeraxX: checks 
*** TURN *** [5s Qh 3s] [As]
SAS_IDS0804: checks 
XxJoaoFeraxX: checks 
*** RIVER *** [5s Qh 3s As] [2d]
SAS_IDS0804: bets 7885 and is all-in
XxJoaoFeraxX: folds 
Uncalled bet (7885) returned to SAS_IDS0804
SAS_IDS0804 collected 2300 from pot
SAS_IDS0804: doesn't show hand 
*** SUMMARY ***
Total pot 2300 | Rake 0 
Board [5s Qh 3s As 2d]
Seat 1: fofAAoBR (small blind) folded before Flop
Seat 2: SAS_IDS0804 (big blind) collected (2300)
Seat 3: JonzStars folded before Flop (didn't bet)
Seat 4: MagoDelBaralho folded before Flop (didn't bet)
Seat 6: XxJoaoFeraxX (button) folded on the River

PokerStars Hand #251209539009: Tournament #3769361908, $52.38+$2.62 USD Hold'em No Limit - Level X (200/400) - 2024/06/26 22:31:51 UTC [2024/06/26 18:31:51 ET]
Table '3769361908 16' 6-max Seat #1 is the button
Seat 1: fofAAoBR (27361 in chips) 
Seat 2: SAS_IDS0804 (10185 in chips) 
Seat 3: JonzStars (5312 in chips) 
Seat 4: MagoDelBaralho (7701 in chips) 
Seat 5: mila is best (10000 in chips) 
Seat 6: XxJoaoFeraxX (10526 in chips) 
fofAAoBR: posts the ante 100
SAS_IDS0804: posts the ante 100
JonzStars: posts the ante 100
MagoDelBaralho: posts the ante 100
mila is best: posts the ante 100
XxJoaoFeraxX: posts the ante 100
SAS_IDS0804: posts small blind 200
JonzStars: posts big blind 400
*** HOLE CARDS ***
MagoDelBaralho: folds 
mila is best: raises 400 to 800
XxJoaoFeraxX: folds 
fofAAoBR: calls 800
SAS_IDS0804: folds 
JonzStars: calls 400
*** FLOP *** [Ad Td 5d]
JonzStars: checks 
mila is best: checks 
fofAAoBR: checks 
*** TURN *** [Ad Td 5d] [Jc]
JonzStars: checks 
mila is best: checks 
fofAAoBR: checks 
*** RIVER *** [Ad Td 5d Jc] [Kh]
JonzStars: checks 
mila is best: checks 
fofAAoBR: checks 
*** SHOW DOWN ***
JonzStars: shows [7d Th] (a pair of Tens)
mila is best: shows [Ts 8s] (a pair of Tens)
fofAAoBR: mucks hand 
JonzStars collected 1600 from pot
mila is best collected 1600 from pot
*** SUMMARY ***
Total pot 3200 | Rake 0 
Board [Ad Td 5d Jc Kh]
Seat 1: fofAAoBR (button) mucked
Seat 2: SAS_IDS0804 (small blind) folded before Flop
Seat 3: JonzStars (big blind) showed [7d Th] and won (1600) with a pair of Tens
Seat 4: MagoDelBaralho folded before Flop (didn't bet)
Seat 5: mila is best showed [Ts 8s] and won (1600) with a pair of Tens
Seat 6: XxJoaoFeraxX folded before Flop (didn't bet)

PokerStars Hand #251209556302: Tournament #3769361908, $52.38+$2.62 USD Hold'em No Limit - Level XI (250/500) - 2024/06/26 22:32:55 UTC [2024/06/26 18:32:55 ET]
Table '3769361908 16' 6-max Seat #2 is the button
Seat 1: fofAAoBR (26461 in chips) 
Seat 2: SAS_IDS0804 (9885 in chips) 
Seat 3: JonzStars (6012 in chips) 
Seat 4: MagoDelBaralho (7601 in chips) 
Seat 5: mila is best (10700 in chips) 
Seat 6: XxJoaoFeraxX (10426 in chips) 
fofAAoBR: posts the ante 125
SAS_IDS0804: posts the ante 125
JonzStars: posts the ante 125
MagoDelBaralho: posts the ante 125
mila is best: posts the ante 125
XxJoaoFeraxX: posts the ante 125
JonzStars: posts small blind 250
MagoDelBaralho: posts big blind 500
*** HOLE CARDS ***
mila is best: folds 
XxJoaoFeraxX: raises 500 to 1000
fofAAoBR: folds 
SAS_IDS0804: folds 
JonzStars: folds 
MagoDelBaralho: raises 6476 to 7476 and is all-in
XxJoaoFeraxX: folds 
Uncalled bet (6476) returned to MagoDelBaralho
MagoDelBaralho collected 3000 from pot
*** SUMMARY ***
Total pot 3000 | Rake 0 
Seat 1: fofAAoBR folded before Flop (didn't bet)
Seat 2: SAS_IDS0804 (button) folded before Flop (didn't bet)
Seat 3: JonzStars (small blind) folded before Flop
Seat 4: MagoDelBaralho (big blind) collected (3000)
Seat 5: mila is best folded before Flop (didn't bet)
Seat 6: XxJoaoFeraxX folded before Flop

PokerStars Hand #251209564298: Tournament #3769361908, $52.38+$2.62 USD Hold'em No Limit - Level XI (250/500) - 2024/06/26 22:33:24 UTC [2024/06/26 18:33:24 ET]
Table '3769361908 16' 6-max Seat #3 is the button
Seat 1: fofAAoBR (26336 in chips) 
Seat 2: SAS_IDS0804 (9760 in chips) 
Seat 3: JonzStars (5637 in chips) 
Seat 4: MagoDelBaralho (9476 in chips) 
Seat 5: mila is best (10575 in chips) 
Seat 6: XxJoaoFeraxX (9301 in chips) 
fofAAoBR: posts the ante 125
SAS_IDS0804: posts the ante 125
JonzStars: posts the ante 125
MagoDelBaralho: posts the ante 125
mila is best: posts the ante 125
XxJoaoFeraxX: posts the ante 125
MagoDelBaralho: posts small blind 250
mila is best: posts big blind 500
*** HOLE CARDS ***
XxJoaoFeraxX: raises 500 to 1000
fofAAoBR: folds 
SAS_IDS0804: folds 
JonzStars: folds 
MagoDelBaralho: folds 
mila is best: raises 9450 to 10450 and is all-in
XxJoaoFeraxX: folds 
Uncalled bet (9450) returned to mila is best
mila is best collected 3000 from pot
*** SUMMARY ***
Total pot 3000 | Rake 0 
Seat 1: fofAAoBR folded before Flop (didn't bet)
Seat 2: SAS_IDS0804 folded before Flop (didn't bet)
Seat 3: JonzStars (button) folded before Flop (didn't bet)
Seat 4: MagoDelBaralho (small blind) folded before Flop
Seat 5: mila is best (big blind) collected (3000)
Seat 6: XxJoaoFeraxX folded before Flop

PokerStars Hand #251209574005: Tournament #3769361908, $52.38+$2.62 USD Hold'em No Limit - Level XI (250/500) - 2024/06/26 22:34:01 UTC [2024/06/26 18:34:01 ET]
Table '3769361908 16' 6-max Seat #4 is the button
Seat 1: fofAAoBR (26211 in chips) 
Seat 2: SAS_IDS0804 (9635 in chips) 
Seat 3: JonzStars (5512 in chips) 
Seat 4: MagoDelBaralho (9101 in chips) 
Seat 5: mila is best (12450 in chips) 
Seat 6: XxJoaoFeraxX (8176 in chips) 
fofAAoBR: posts the ante 125
SAS_IDS0804: posts the ante 125
JonzStars: posts the ante 125
MagoDelBaralho: posts the ante 125
mila is best: posts the ante 125
XxJoaoFeraxX: posts the ante 125
mila is best: posts small blind 250
XxJoaoFeraxX: posts big blind 500
*** HOLE CARDS ***
fofAAoBR: raises 500 to 1000
SAS_IDS0804: folds 
JonzStars: folds 
MagoDelBaralho: folds 
mila is best: folds 
XxJoaoFeraxX: calls 500
*** FLOP *** [9s 5s 8h]
XxJoaoFeraxX: checks 
fofAAoBR: checks 
*** TURN *** [9s 5s 8h] [Ah]
XxJoaoFeraxX: checks 
fofAAoBR: bets 1500
XxJoaoFeraxX: calls 1500
*** RIVER *** [9s 5s 8h Ah] [Ac]
XxJoaoFeraxX: checks 
fofAAoBR: checks 
*** SHOW DOWN ***
XxJoaoFeraxX: shows [6c As] (three of a kind, Aces)
fofAAoBR: mucks hand 
XxJoaoFeraxX collected 6000 from pot
*** SUMMARY ***
Total pot 6000 | Rake 0 
Board [9s 5s 8h Ah Ac]
Seat 1: fofAAoBR mucked
Seat 2: SAS_IDS0804 folded before Flop (didn't bet)
Seat 3: JonzStars folded before Flop (didn't bet)
Seat 4: MagoDelBaralho (button) folded before Flop (didn't bet)
Seat 5: mila is best (small blind) folded before Flop
Seat 6: XxJoaoFeraxX (big blind) showed [6c As] and won (6000) with three of a kind, Aces

PokerStars Hand #251209588098: Tournament #3769361908, $52.38+$2.62 USD Hold'em No Limit - Level XI (250/500) - 2024/06/26 22:34:53 UTC [2024/06/26 18:34:53 ET]
Table '3769361908 16' 6-max Seat #5 is the button
Seat 1: fofAAoBR (23586 in chips) 
Seat 2: SAS_IDS0804 (9510 in chips) 
Seat 3: JonzStars (5387 in chips) 
Seat 4: MagoDelBaralho (8976 in chips) 
Seat 5: mila is best (12075 in chips) 
Seat 6: XxJoaoFeraxX (11551 in chips) 
fofAAoBR: posts the ante 125
SAS_IDS0804: posts the ante 125
JonzStars: posts the ante 125
MagoDelBaralho: posts the ante 125
mila is best: posts the ante 125
XxJoaoFeraxX: posts the ante 125
XxJoaoFeraxX: posts small blind 250
fofAAoBR: posts big blind 500
*** HOLE CARDS ***
SAS_IDS0804: folds 
JonzStars: raises 4762 to 5262 and is all-in
MagoDelBaralho: folds 
mila is best: folds 
XxJoaoFeraxX: folds 
fofAAoBR: folds 
Uncalled bet (4762) returned to JonzStars
JonzStars collected 2000 from pot
*** SUMMARY ***
Total pot 2000 | Rake 0 
Seat 1: fofAAoBR (big blind) folded before Flop
Seat 2: SAS_IDS0804 folded before Flop (didn't bet)
Seat 3: JonzStars collected (2000)
Seat 4: MagoDelBaralho folded before Flop (didn't bet)
Seat 5: mila is best (button) folded before Flop (didn't bet)
Seat 6: XxJoaoFeraxX (small blind) folded before Flop

PokerStars Hand #251209593806: Tournament #3769361908, $52.38+$2.62 USD Hold'em No Limit - Level XII (300/600) - 2024/06/26 22:35:14 UTC [2024/06/26 18:35:14 ET]
Table '3769361908 16' 6-max Seat #6 is the button
Seat 1: fofAAoBR (22961 in chips) 
Seat 2: SAS_IDS0804 (9385 in chips) 
Seat 3: JonzStars (6762 in chips) 
Seat 4: MagoDelBaralho (8851 in chips) 
Seat 5: mila is best (11950 in chips) 
Seat 6: XxJoaoFeraxX (11176 in chips) 
fofAAoBR: posts the ante 150
SAS_IDS0804: posts the ante 150
JonzStars: posts the ante 150
MagoDelBaralho: posts the ante 150
mila is best: posts the ante 150
XxJoaoFeraxX: posts the ante 150
fofAAoBR: posts small blind 300
SAS_IDS0804: posts big blind 600
*** HOLE CARDS ***
JonzStars: raises 6012 to 6612 and is all-in
MagoDelBaralho: folds 
mila is best: folds 
XxJoaoFeraxX: folds 
fofAAoBR: folds 
SAS_IDS0804: folds 
Uncalled bet (6012) returned to JonzStars
JonzStars collected 2400 from pot
*** SUMMARY ***
Total pot 2400 | Rake 0 
Seat 1: fofAAoBR (small blind) folded before Flop
Seat 2: SAS_IDS0804 (big blind) folded before Flop
Seat 3: JonzStars collected (2400)
Seat 4: MagoDelBaralho folded before Flop (didn't bet)
Seat 5: mila is best folded before Flop (didn't bet)
Seat 6: XxJoaoFeraxX (button) folded before Flop (didn't bet)

PokerStars Hand #251209600919: Tournament #3769361908, $52.38+$2.62 USD Hold'em No Limit - Level XII (300/600) - 2024/06/26 22:35:41 UTC [2024/06/26 18:35:41 ET]
Table '3769361908 16' 6-max Seat #1 is the button
Seat 1: fofAAoBR (22511 in chips) 
Seat 2: SAS_IDS0804 (8635 in chips) 
Seat 3: JonzStars (8412 in chips) 
Seat 4: MagoDelBaralho (8701 in chips) 
Seat 5: mila is best (11800 in chips) 
Seat 6: XxJoaoFeraxX (11026 in chips) 
fofAAoBR: posts the ante 150
SAS_IDS0804: posts the ante 150
JonzStars: posts the ante 150
MagoDelBaralho: posts the ante 150
mila is best: posts the ante 150
XxJoaoFeraxX: posts the ante 150
SAS_IDS0804: posts small blind 300
JonzStars: posts big blind 600
*** HOLE CARDS ***
MagoDelBaralho: folds 
mila is best: raises 600 to 1200
XxJoaoFeraxX: folds 
fofAAoBR: raises 1800 to 3000
SAS_IDS0804: folds 
JonzStars: folds 
mila is best: calls 1800
*** FLOP *** [9c Kc 2h]
mila is best: checks 
fofAAoBR: bets 900
mila is best: calls 900
*** TURN *** [9c Kc 2h] [As]
mila is best: checks 
fofAAoBR: bets 2100
mila is best: folds 
Uncalled bet (2100) returned to fofAAoBR
fofAAoBR collected 9600 from pot
fofAAoBR: doesn't show hand 
*** SUMMARY ***
Total pot 9600 | Rake 0 
Board [9c Kc 2h As]
Seat 1: fofAAoBR (button) collected (9600)
Seat 2: SAS_IDS0804 (small blind) folded before Flop
Seat 3: JonzStars (big blind) folded before Flop
Seat 4: MagoDelBaralho folded before Flop (didn't bet)
Seat 5: mila is best folded on the Turn
Seat 6: XxJoaoFeraxX folded before Flop (didn't bet)

PokerStars Hand #251209616592: Tournament #3769361908, $52.38+$2.62 USD Hold'em No Limit - Level XII (300/600) - 2024/06/26 22:36:39 UTC [2024/06/26 18:36:39 ET]
Table '3769361908 16' 6-max Seat #2 is the button
Seat 1: fofAAoBR (28061 in chips) 
Seat 2: SAS_IDS0804 (8185 in chips) 
Seat 3: JonzStars (7662 in chips) 
Seat 4: MagoDelBaralho (8551 in chips) 
Seat 5: mila is best (7750 in chips) 
Seat 6: XxJoaoFeraxX (10876 in chips) 
fofAAoBR: posts the ante 150
SAS_IDS0804: posts the ante 150
JonzStars: posts the ante 150
MagoDelBaralho: posts the ante 150
mila is best: posts the ante 150
XxJoaoFeraxX: posts the ante 150
JonzStars: posts small blind 300
MagoDelBaralho: posts big blind 600
*** HOLE CARDS ***
mila is best: folds 
XxJoaoFeraxX: raises 600 to 1200
fofAAoBR: folds 
SAS_IDS0804: folds 
JonzStars: folds 
MagoDelBaralho: raises 7201 to 8401 and is all-in
XxJoaoFeraxX: folds 
Uncalled bet (7201) returned to MagoDelBaralho
MagoDelBaralho collected 3600 from pot
*** SUMMARY ***
Total pot 3600 | Rake 0 
Seat 1: fofAAoBR folded before Flop (didn't bet)
Seat 2: SAS_IDS0804 (button) folded before Flop (didn't bet)
Seat 3: JonzStars (small blind) folded before Flop
Seat 4: MagoDelBaralho (big blind) collected (3600)
Seat 5: mila is best folded before Flop (didn't bet)
Seat 6: XxJoaoFeraxX folded before Flop

PokerStars Hand #251209627110: Tournament #3769361908, $52.38+$2.62 USD Hold'em No Limit - Level XII (300/600) - 2024/06/26 22:37:19 UTC [2024/06/26 18:37:19 ET]
Table '3769361908 16' 6-max Seat #3 is the button
Seat 1: fofAAoBR (27911 in chips) 
Seat 2: SAS_IDS0804 (8035 in chips) 
Seat 3: JonzStars (7212 in chips) 
Seat 4: MagoDelBaralho (10801 in chips) 
Seat 5: mila is best (7600 in chips) 
Seat 6: XxJoaoFeraxX (9526 in chips) 
fofAAoBR: posts the ante 150
SAS_IDS0804: posts the ante 150
JonzStars: posts the ante 150
MagoDelBaralho: posts the ante 150
mila is best: posts the ante 150
XxJoaoFeraxX: posts the ante 150
MagoDelBaralho: posts small blind 300
mila is best: posts big blind 600
*** HOLE CARDS ***
XxJoaoFeraxX: folds 
fofAAoBR: raises 720 to 1320
SAS_IDS0804: folds 
JonzStars: folds 
MagoDelBaralho: folds 
mila is best: calls 720
*** FLOP *** [3s Qc 7h]
mila is best: checks 
fofAAoBR: bets 1267
mila is best: calls 1267
*** TURN *** [3s Qc 7h] [Th]
mila is best: checks 
fofAAoBR: checks 
*** RIVER *** [3s Qc 7h Th] [6d]
mila is best: checks 
fofAAoBR: checks 
*** SHOW DOWN ***
mila is best: shows [3c 6c] (two pair, Sixes and Threes)
fofAAoBR: mucks hand 
mila is best collected 6374 from pot
*** SUMMARY ***
Total pot 6374 | Rake 0 
Board [3s Qc 7h Th 6d]
Seat 1: fofAAoBR mucked
Seat 2: SAS_IDS0804 folded before Flop (didn't bet)
Seat 3: JonzStars (button) folded before Flop (didn't bet)
Seat 4: MagoDelBaralho (small blind) folded before Flop
Seat 5: mila is best (big blind) showed [3c 6c] and won (6374) with two pair, Sixes and Threes
Seat 6: XxJoaoFeraxX folded before Flop (didn't bet)

PokerStars Hand #251209639696: Tournament #3769361908, $52.38+$2.62 USD Hold'em No Limit - Level XII (300/600) - 2024/06/26 22:38:06 UTC [2024/06/26 18:38:06 ET]
Table '3769361908 16' 6-max Seat #4 is the button
Seat 1: fofAAoBR (25174 in chips) 
Seat 2: SAS_IDS0804 (7885 in chips) 
Seat 3: JonzStars (7062 in chips) 
Seat 4: MagoDelBaralho (10351 in chips) 
Seat 5: mila is best (11237 in chips) 
Seat 6: XxJoaoFeraxX (9376 in chips) 
fofAAoBR: posts the ante 150
SAS_IDS0804: posts the ante 150
JonzStars: posts the ante 150
MagoDelBaralho: posts the ante 150
mila is best: posts the ante 150
XxJoaoFeraxX: posts the ante 150
mila is best: posts small blind 300
XxJoaoFeraxX: posts big blind 600
*** HOLE CARDS ***
fofAAoBR: folds 
SAS_IDS0804: raises 600 to 1200
JonzStars: folds 
MagoDelBaralho: folds 
mila is best: folds 
XxJoaoFeraxX: folds 
Uncalled bet (600) returned to SAS_IDS0804
SAS_IDS0804 collected 2400 from pot
SAS_IDS0804: doesn't show hand 
*** SUMMARY ***
Total pot 2400 | Rake 0 
Seat 1: fofAAoBR folded before Flop (didn't bet)
Seat 2: SAS_IDS0804 collected (2400)
Seat 3: JonzStars folded before Flop (didn't bet)
Seat 4: MagoDelBaralho (button) folded before Flop (didn't bet)
Seat 5: mila is best (small blind) folded before Flop
Seat 6: XxJoaoFeraxX (big blind) folded before Flop

PokerStars Hand #251209649665: Tournament #3769361908, $52.38+$2.62 USD Hold'em No Limit - Level XIII (400/800) - 2024/06/26 22:38:43 UTC [2024/06/26 18:38:43 ET]
Table '3769361908 16' 6-max Seat #5 is the button
Seat 1: fofAAoBR (25024 in chips) 
Seat 2: SAS_IDS0804 (9535 in chips) 
Seat 3: JonzStars (6912 in chips) 
Seat 4: MagoDelBaralho (10201 in chips) 
Seat 5: mila is best (10787 in chips) 
Seat 6: XxJoaoFeraxX (8626 in chips) 
fofAAoBR: posts the ante 200
SAS_IDS0804: posts the ante 200
JonzStars: posts the ante 200
MagoDelBaralho: posts the ante 200
mila is best: posts the ante 200
XxJoaoFeraxX: posts the ante 200
XxJoaoFeraxX: posts small blind 400
fofAAoBR: posts big blind 800
*** HOLE CARDS ***
SAS_IDS0804: folds 
JonzStars: raises 800 to 1600
MagoDelBaralho: folds 
mila is best: folds 
XxJoaoFeraxX: folds 
fofAAoBR: calls 800
*** FLOP *** [Td Kh Qs]
fofAAoBR: checks 
JonzStars: bets 5112 and is all-in
fofAAoBR: folds 
Uncalled bet (5112) returned to JonzStars
JonzStars collected 4800 from pot
*** SUMMARY ***
Total pot 4800 | Rake 0 
Board [Td Kh Qs]
Seat 1: fofAAoBR (big blind) folded on the Flop
Seat 2: SAS_IDS0804 folded before Flop (didn't bet)
Seat 3: JonzStars collected (4800)
Seat 4: MagoDelBaralho folded before Flop (didn't bet)
Seat 5: mila is best (button) folded before Flop (didn't bet)
Seat 6: XxJoaoFeraxX (small blind) folded before Flop

PokerStars Hand #251209657584: Tournament #3769361908, $52.38+$2.62 USD Hold'em No Limit - Level XIII (400/800) - 2024/06/26 22:39:13 UTC [2024/06/26 18:39:13 ET]
Table '3769361908 16' 6-max Seat #6 is the button
Seat 1: fofAAoBR (23224 in chips) 
Seat 2: SAS_IDS0804 (9335 in chips) 
Seat 3: JonzStars (9912 in chips) 
Seat 4: MagoDelBaralho (10001 in chips) 
Seat 5: mila is best (10587 in chips) 
Seat 6: XxJoaoFeraxX (8026 in chips) 
fofAAoBR: posts the ante 200
SAS_IDS0804: posts the ante 200
JonzStars: posts the ante 200
MagoDelBaralho: posts the ante 200
mila is best: posts the ante 200
XxJoaoFeraxX: posts the ante 200
fofAAoBR: posts small blind 400
SAS_IDS0804: posts big blind 800
*** HOLE CARDS ***
JonzStars: folds 
MagoDelBaralho: folds 
mila is best: raises 9587 to 10387 and is all-in
XxJoaoFeraxX: folds 
fofAAoBR: folds 
SAS_IDS0804: calls 8335 and is all-in
Uncalled bet (1252) returned to mila is best
*** FLOP *** [Js 6c Jh]
*** TURN *** [Js 6c Jh] [7d]
*** RIVER *** [Js 6c Jh 7d] [Qh]
*** SHOW DOWN ***
SAS_IDS0804: shows [As 3d] (a pair of Jacks)
mila is best: shows [Ad Kc] (a pair of Jacks - Ace+King kicker)
mila is best collected 19870 from pot
SAS_IDS0804 finished the tournament
*** SUMMARY ***
Total pot 19870 | Rake 0 
Board [Js 6c Jh 7d Qh]
Seat 1: fofAAoBR (small blind) folded before Flop
Seat 2: SAS_IDS0804 (big blind) showed [As 3d] and lost with a pair of Jacks
Seat 3: JonzStars folded before Flop (didn't bet)
Seat 4: MagoDelBaralho folded before Flop (didn't bet)
Seat 5: mila is best showed [Ad Kc] and won (19870) with a pair of Jacks
Seat 6: XxJoaoFeraxX (button) folded before Flop (didn't bet)

PokerStars Hand #251209666190: Tournament #3769361908, $52.38+$2.62 USD Hold'em No Limit - Level XIII (400/800) - 2024/06/26 22:39:45 UTC [2024/06/26 18:39:45 ET]
Table '3769361908 16' 6-max Seat #1 is the button
Seat 1: fofAAoBR (22624 in chips) 
Seat 3: JonzStars (9712 in chips) 
Seat 4: MagoDelBaralho (9801 in chips) 
Seat 5: mila is best (21122 in chips) 
Seat 6: XxJoaoFeraxX (7826 in chips) 
fofAAoBR: posts the ante 200
JonzStars: posts the ante 200
MagoDelBaralho: posts the ante 200
mila is best: posts the ante 200
XxJoaoFeraxX: posts the ante 200
JonzStars: posts small blind 400
MagoDelBaralho: posts big blind 800
*** HOLE CARDS ***
mila is best: folds 
XxJoaoFeraxX: raises 6826 to 7626 and is all-in
fofAAoBR: folds 
JonzStars: folds 
MagoDelBaralho: folds 
Uncalled bet (6826) returned to XxJoaoFeraxX
XxJoaoFeraxX collected 3000 from pot
XxJoaoFeraxX: doesn't show hand 
*** SUMMARY ***
Total pot 3000 | Rake 0 
Seat 1: fofAAoBR (button) folded before Flop (didn't bet)
Seat 3: JonzStars (small blind) folded before Flop
Seat 4: MagoDelBaralho (big blind) folded before Flop
Seat 5: mila is best folded before Flop (didn't bet)
Seat 6: XxJoaoFeraxX collected (3000)

PokerStars Hand #251209672029: Tournament #3769361908, $52.38+$2.62 USD Hold'em No Limit - Level XIII (400/800) - 2024/06/26 22:40:07 UTC [2024/06/26 18:40:07 ET]
Table '3769361908 16' 6-max Seat #3 is the button
Seat 1: fofAAoBR (22424 in chips) 
Seat 3: JonzStars (9112 in chips) 
Seat 4: MagoDelBaralho (8801 in chips) 
Seat 5: mila is best (20922 in chips) 
Seat 6: XxJoaoFeraxX (9826 in chips) 
fofAAoBR: posts the ante 200
JonzStars: posts the ante 200
MagoDelBaralho: posts the ante 200
mila is best: posts the ante 200
XxJoaoFeraxX: posts the ante 200
MagoDelBaralho: posts small blind 400
mila is best: posts big blind 800
*** HOLE CARDS ***
XxJoaoFeraxX: folds 
fofAAoBR: raises 800 to 1600
passat1g is disconnected 
JonzStars: folds 
MagoDelBaralho: folds 
mila is best: calls 800
*** FLOP *** [Jd 6s Jh]
mila is best: checks 
fofAAoBR: bets 1518
mila is best: calls 1518
*** TURN *** [Jd 6s Jh] [7h]
mila is best: checks 
fofAAoBR: bets 4800
mila is best: folds 
Uncalled bet (4800) returned to fofAAoBR
fofAAoBR collected 7636 from pot
fofAAoBR: doesn't show hand 
*** SUMMARY ***
Total pot 7636 | Rake 0 
Board [Jd 6s Jh 7h]
Seat 1: fofAAoBR collected (7636)
Seat 3: JonzStars (button) folded before Flop (didn't bet)
Seat 4: MagoDelBaralho (small blind) folded before Flop
Seat 5: mila is best (big blind) folded on the Turn
Seat 6: XxJoaoFeraxX folded before Flop (didn't bet)

PokerStars Hand #251209685063: Tournament #3769361908, $52.38+$2.62 USD Hold'em No Limit - Level XIII (400/800) - 2024/06/26 22:40:57 UTC [2024/06/26 18:40:57 ET]
Table '3769361908 16' 6-max Seat #4 is the button
Seat 2: passat1g (15144 in chips) 
Seat 3: JonzStars (8912 in chips) 
Seat 4: MagoDelBaralho (8201 in chips) 
Seat 5: mila is best (17604 in chips) 
Seat 6: XxJoaoFeraxX (9626 in chips) 
passat1g: posts the ante 200
JonzStars: posts the ante 200
MagoDelBaralho: posts the ante 200
mila is best: posts the ante 200
XxJoaoFeraxX: posts the ante 200
mila is best: posts small blind 400
XxJoaoFeraxX: posts big blind 800
*** HOLE CARDS ***
passat1g: raises 800 to 1600
JonzStars: folds 
MagoDelBaralho: folds 
mila is best: calls 1200
nzlking is disconnected 
XxJoaoFeraxX: folds 
*** FLOP *** [Th Jd Qh]
mila is best: checks 
passat1g: bets 3550
mila is best: raises 12254 to 15804 and is all-in
passat1g: calls 9794 and is all-in
Uncalled bet (2460) returned to mila is best
*** TURN *** [Th Jd Qh] [Qc]
*** RIVER *** [Th Jd Qh Qc] [Ad]
*** SHOW DOWN ***
mila is best: shows [9h 8d] (a straight, Eight to Queen)
passat1g: shows [Ts Js] (two pair, Queens and Jacks)
mila is best collected 31688 from pot
passat1g finished the tournament
*** SUMMARY ***
Total pot 31688 | Rake 0 
Board [Th Jd Qh Qc Ad]
Seat 2: passat1g showed [Ts Js] and lost with two pair, Queens and Jacks
Seat 3: JonzStars folded before Flop (didn't bet)
Seat 4: MagoDelBaralho (button) folded before Flop (didn't bet)
Seat 5: mila is best (small blind) showed [9h 8d] and won (31688) with a straight, Eight to Queen
Seat 6: XxJoaoFeraxX (big blind) folded before Flop

PokerStars Hand #251209698954: Tournament #3769361908, $52.38+$2.62 USD Hold'em No Limit - Level XIV (500/1000) - 2024/06/26 22:41:50 UTC [2024/06/26 18:41:50 ET]
Table '3769361908 16' 6-max Seat #5 is the button
Seat 1: nzlking (10000 in chips) 
Seat 3: JonzStars (8712 in chips) 
Seat 4: MagoDelBaralho (8001 in chips) 
Seat 5: mila is best (34148 in chips) 
Seat 6: XxJoaoFeraxX (8626 in chips) 
nzlking: posts the ante 250
JonzStars: posts the ante 250
MagoDelBaralho: posts the ante 250
mila is best: posts the ante 250
XxJoaoFeraxX: posts the ante 250
XxJoaoFeraxX: posts small blind 500
nzlking: posts big blind 1000
*** HOLE CARDS ***
JonzStars: folds 
MagoDelBaralho: raises 6751 to 7751 and is all-in
mila is best: folds 
XxJoaoFeraxX: folds 
nzlking: calls 6751
*** FLOP *** [Kc 8c Qs]
*** TURN *** [Kc 8c Qs] [3s]
*** RIVER *** [Kc 8c Qs 3s] [Ac]
*** SHOW DOWN ***
nzlking: shows [Td Ad] (a pair of Aces)
MagoDelBaralho: shows [Ks 5s] (a pair of Kings)
nzlking collected 17252 from pot
MagoDelBaralho finished the tournament
Joe Santana is disconnected 
*** SUMMARY ***
Total pot 17252 | Rake 0 
Board [Kc 8c Qs 3s Ac]
Seat 1: nzlking (big blind) showed [Td Ad] and won (17252) with a pair of Aces
Seat 3: JonzStars folded before Flop (didn't bet)
Seat 4: MagoDelBaralho showed [Ks 5s] and lost with a pair of Kings
Seat 5: mila is best (button) folded before Flop (didn't bet)
Seat 6: XxJoaoFeraxX (small blind) folded before Flop

PokerStars Hand #251209707489: Tournament #3769361908, $52.38+$2.62 USD Hold'em No Limit - Level XIV (500/1000) - 2024/06/26 22:42:23 UTC [2024/06/26 18:42:23 ET]
Table '3769361908 16' 6-max Seat #6 is the button
Seat 1: nzlking (19251 in chips) 
Seat 2: Joe Santana (13150 in chips) 
Seat 3: JonzStars (8462 in chips) 
Seat 5: mila is best (33898 in chips) 
Seat 6: XxJoaoFeraxX (7876 in chips) 
nzlking: posts the ante 250
Joe Santana: posts the ante 250
JonzStars: posts the ante 250
mila is best: posts the ante 250
XxJoaoFeraxX: posts the ante 250
nzlking: posts small blind 500
Joe Santana: posts big blind 1000
*** HOLE CARDS ***
JonzStars: raises 7212 to 8212 and is all-in
mila is best: folds 
XxJoaoFeraxX: folds 
nzlking: folds 
Joe Santana: folds 
Uncalled bet (7212) returned to JonzStars
JonzStars collected 3750 from pot
*** SUMMARY ***
Total pot 3750 | Rake 0 
Seat 1: nzlking (small blind) folded before Flop
Seat 2: Joe Santana (big blind) folded before Flop
Seat 3: JonzStars collected (3750)
Seat 5: mila is best folded before Flop (didn't bet)
Seat 6: XxJoaoFeraxX (button) folded before Flop (didn't bet)

PokerStars Hand #251209719767: Tournament #3769361908, $52.38+$2.62 USD Hold'em No Limit - Level XIV (500/1000) - 2024/06/26 22:43:11 UTC [2024/06/26 18:43:11 ET]
Table '3769361908 16' 6-max Seat #1 is the button
Seat 1: nzlking (18501 in chips) 
Seat 2: Joe Santana (11900 in chips) 
Seat 3: JonzStars (10962 in chips) 
Seat 5: mila is best (33648 in chips) 
Seat 6: XxJoaoFeraxX (7626 in chips) 
nzlking: posts the ante 250
Joe Santana: posts the ante 250
JonzStars: posts the ante 250
mila is best: posts the ante 250
XxJoaoFeraxX: posts the ante 250
Joe Santana: posts small blind 500
JonzStars: posts big blind 1000
*** HOLE CARDS ***
mila is best: folds 
XxJoaoFeraxX: folds 
nzlking: folds 
Earl of Poker V is disconnected 
Joe Santana: folds 
Uncalled bet (500) returned to JonzStars
JonzStars collected 2250 from pot
*** SUMMARY ***
Total pot 2250 | Rake 0 
Seat 1: nzlking (button) folded before Flop (didn't bet)
Seat 2: Joe Santana (small blind) folded before Flop
Seat 3: JonzStars (big blind) collected (2250)
Seat 5: mila is best folded before Flop (didn't bet)
Seat 6: XxJoaoFeraxX folded before Flop (didn't bet)

PokerStars Hand #251209730981: Tournament #3769361908, $52.38+$2.62 USD Hold'em No Limit - Level XIV (500/1000) - 2024/06/26 22:43:55 UTC [2024/06/26 18:43:55 ET]
Table '3769361908 16' 6-max Seat #2 is the button
Seat 1: nzlking (18251 in chips) 
Seat 2: Joe Santana (11150 in chips) 
Seat 3: JonzStars (12462 in chips) 
Seat 4: Earl of Poker V (10000 in chips) 
Seat 5: mila is best (33398 in chips) 
Seat 6: XxJoaoFeraxX (7376 in chips) 
nzlking: posts the ante 250
Joe Santana: posts the ante 250
JonzStars: posts the ante 250
Earl of Poker V: posts the ante 250
mila is best: posts the ante 250
XxJoaoFeraxX: posts the ante 250
JonzStars: posts small blind 500
Earl of Poker V: posts big blind 1000
*** HOLE CARDS ***
mila is best: raises 1000 to 2000
XxJoaoFeraxX: folds 
nzlking: folds 
Joe Santana: folds 
JonzStars: folds 
Earl of Poker V: folds 
Uncalled bet (1000) returned to mila is best
mila is best collected 4000 from pot
*** SUMMARY ***
Total pot 4000 | Rake 0 
Seat 1: nzlking folded before Flop (didn't bet)
Seat 2: Joe Santana (button) folded before Flop (didn't bet)
Seat 3: JonzStars (small blind) folded before Flop
Seat 4: Earl of Poker V (big blind) folded before Flop
Seat 5: mila is best collected (4000)
Seat 6: XxJoaoFeraxX folded before Flop (didn't bet)

PokerStars Hand #251209734654: Tournament #3769361908, $52.38+$2.62 USD Hold'em No Limit - Level XIV (500/1000) - 2024/06/26 22:44:09 UTC [2024/06/26 18:44:09 ET]
Table '3769361908 16' 6-max Seat #3 is the button
Seat 1: nzlking (18001 in chips) 
Seat 2: Joe Santana (10900 in chips) 
Seat 3: JonzStars (11712 in chips) 
Seat 4: Earl of Poker V (8750 in chips) 
Seat 5: mila is best (36148 in chips) 
Seat 6: XxJoaoFeraxX (7126 in chips) 
nzlking: posts the ante 250
Joe Santana: posts the ante 250
JonzStars: posts the ante 250
Earl of Poker V: posts the ante 250
mila is best: posts the ante 250
XxJoaoFeraxX: posts the ante 250
Earl of Poker V: posts small blind 500
mila is best: posts big blind 1000
*** HOLE CARDS ***
XxJoaoFeraxX: raises 5876 to 6876 and is all-in
nzlking: folds 
Joe Santana: folds 
JonzStars: folds 
Earl of Poker V: folds 
mila is best: calls 5876
*** FLOP *** [4c 7c 8s]
*** TURN *** [4c 7c 8s] [3c]
*** RIVER *** [4c 7c 8s 3c] [4s]
*** SHOW DOWN ***
mila is best: shows [3h Qh] (two pair, Fours and Threes)
XxJoaoFeraxX: shows [Jh Kd] (a pair of Fours)
mila is best collected 15752 from pot
XxJoaoFeraxX finished the tournament
*** SUMMARY ***
Total pot 15752 | Rake 0 
Board [4c 7c 8s 3c 4s]
Seat 1: nzlking folded before Flop (didn't bet)
Seat 2: Joe Santana folded before Flop (didn't bet)
Seat 3: JonzStars (button) folded before Flop (didn't bet)
Seat 4: Earl of Poker V (small blind) folded before Flop
Seat 5: mila is best (big blind) showed [3h Qh] and won (15752) with two pair, Fours and Threes
Seat 6: XxJoaoFeraxX showed [Jh Kd] and lost with a pair of Fours

PokerStars Hand #251209742837: Tournament #3769361908, $52.38+$2.62 USD Hold'em No Limit - Level XV (600/1200) - 2024/06/26 22:44:41 UTC [2024/06/26 18:44:41 ET]
Table '3769361908 16' 6-max Seat #4 is the button
Seat 1: nzlking (17751 in chips) 
Seat 2: Joe Santana (10650 in chips) 
Seat 3: JonzStars (11462 in chips) 
Seat 4: Earl of Poker V (8000 in chips) 
Seat 5: mila is best (44774 in chips) 
nzlking: posts the ante 300
Joe Santana: posts the ante 300
JonzStars: posts the ante 300
Earl of Poker V: posts the ante 300
mila is best: posts the ante 300
mila is best: posts small blind 600
nzlking: posts big blind 1200
*** HOLE CARDS ***
Joe Santana: folds 
escabofildo is disconnected 
JonzStars: folds 
Earl of Poker V: raises 6500 to 7700 and is all-in
mila is best: folds 
nzlking: folds 
Uncalled bet (6500) returned to Earl of Poker V
Earl of Poker V collected 4500 from pot
Earl of Poker V: doesn't show hand 
*** SUMMARY ***
Total pot 4500 | Rake 0 
Seat 1: nzlking (big blind) folded before Flop
Seat 2: Joe Santana folded before Flop (didn't bet)
Seat 3: JonzStars folded before Flop (didn't bet)
Seat 4: Earl of Poker V (button) collected (4500)
Seat 5: mila is best (small blind) folded before Flop

PokerStars Hand #251209749124: Tournament #3769361908, $52.38+$2.62 USD Hold'em No Limit - Level XV (600/1200) - 2024/06/26 22:45:05 UTC [2024/06/26 18:45:05 ET]
Table '3769361908 16' 6-max Seat #5 is the button
Seat 1: nzlking (16251 in chips) 
Seat 3: JonzStars (11162 in chips) 
Seat 4: Earl of Poker V (11000 in chips) 
Seat 5: mila is best (43874 in chips) 
Seat 6: escabofildo (10000 in chips) out of hand (moved from another table into small blind)
escabofildo will be allowed to play after the button
nzlking: posts the ante 300
JonzStars: posts the ante 300
Earl of Poker V: posts the ante 300
mila is best: posts the ante 300
nzlking: posts small blind 600
JonzStars: posts big blind 1200
*** HOLE CARDS ***
Earl of Poker V: folds 
mila is best: raises 1200 to 2400
4sasss is disconnected 
nzlking: folds 
JonzStars: calls 1200
*** FLOP *** [Qc 5s Tc]
JonzStars: checks 
mila is best: checks 
*** TURN *** [Qc 5s Tc] [Jd]
JonzStars: checks 
mila is best: checks 
*** RIVER *** [Qc 5s Tc Jd] [3h]
JonzStars: checks 
mila is best: bets 2400
JonzStars: folds 
Uncalled bet (2400) returned to mila is best
mila is best collected 6600 from pot
*** SUMMARY ***
Total pot 6600 | Rake 0 
Board [Qc 5s Tc Jd 3h]
Seat 1: nzlking (small blind) folded before Flop
Seat 3: JonzStars (big blind) folded on the River
Seat 4: Earl of Poker V folded before Flop (didn't bet)
Seat 5: mila is best (button) collected (6600)

PokerStars Hand #251209760257: Tournament #3769361908, $52.38+$2.62 USD Hold'em No Limit - Level XV (600/1200) - 2024/06/26 22:45:48 UTC [2024/06/26 18:45:48 ET]
Table '3769361908 16' 6-max Seat #1 is the button
Seat 1: nzlking (15351 in chips) 
Seat 2: 4sasss (10000 in chips) out of hand (moved from another table into small blind)
Seat 3: JonzStars (8462 in chips) 
Seat 4: Earl of Poker V (10700 in chips) 
Seat 5: mila is best (47774 in chips) 
Seat 6: escabofildo (10000 in chips) 
4sasss will be allowed to play after the button
nzlking: posts the ante 300
JonzStars: posts the ante 300
Earl of Poker V: posts the ante 300
mila is best: posts the ante 300
escabofildo: posts the ante 300
JonzStars: posts small blind 600
Earl of Poker V: posts big blind 1200
*** HOLE CARDS ***
mila is best: folds 
escabofildo: folds 
nzlking: folds 
JonzStars: raises 6600 to 7800
Earl of Poker V: folds 
Uncalled bet (6600) returned to JonzStars
JonzStars collected 3900 from pot
*** SUMMARY ***
Total pot 3900 | Rake 0 
Seat 1: nzlking (button) folded before Flop (didn't bet)
Seat 3: JonzStars (small blind) collected (3900)
Seat 4: Earl of Poker V (big blind) folded before Flop
Seat 5: mila is best folded before Flop (didn't bet)
Seat 6: escabofildo folded before Flop (didn't bet)

PokerStars Hand #251209764202: Tournament #3769361908, $52.38+$2.62 USD Hold'em No Limit - Level XV (600/1200) - 2024/06/26 22:46:04 UTC [2024/06/26 18:46:04 ET]
Table '3769361908 16' 6-max Seat #3 is the button
Seat 1: nzlking (15051 in chips) 
Seat 2: 4sasss (10000 in chips) 
Seat 3: JonzStars (10862 in chips) 
Seat 4: Earl of Poker V (9200 in chips) 
Seat 5: mila is best (47474 in chips) 
Seat 6: escabofildo (9700 in chips) 
nzlking: posts the ante 300
4sasss: posts the ante 300
JonzStars: posts the ante 300
Earl of Poker V: posts the ante 300
mila is best: posts the ante 300
escabofildo: posts the ante 300
Earl of Poker V: posts small blind 600
mila is best: posts big blind 1200
*** HOLE CARDS ***
escabofildo: folds 
nzlking: folds 
4sasss: raises 8500 to 9700 and is all-in
JonzStars: folds 
Earl of Poker V: calls 8300 and is all-in
mila is best: folds 
Uncalled bet (800) returned to 4sasss
*** FLOP *** [As Kc 7d]
*** TURN *** [As Kc 7d] [4d]
*** RIVER *** [As Kc 7d 4d] [9s]
*** SHOW DOWN ***
Earl of Poker V: shows [9d Kh] (two pair, Kings and Nines)
4sasss: shows [3h Ac] (a pair of Aces)
Earl of Poker V collected 20800 from pot
*** SUMMARY ***
Total pot 20800 | Rake 0 
Board [As Kc 7d 4d 9s]
Seat 1: nzlking folded before Flop (didn't bet)
Seat 2: 4sasss showed [3h Ac] and lost with a pair of Aces
Seat 3: JonzStars (button) folded before Flop (didn't bet)
Seat 4: Earl of Poker V (small blind) showed [9d Kh] and won (20800) with two pair, Kings and Nines
Seat 5: mila is best (big blind) folded before Flop
Seat 6: escabofildo folded before Flop (didn't bet)

PokerStars Hand #251209772343: Tournament #3769361908, $52.38+$2.62 USD Hold'em No Limit - Level XV (600/1200) - 2024/06/26 22:46:35 UTC [2024/06/26 18:46:35 ET]
Table '3769361908 16' 6-max Seat #4 is the button
Seat 1: nzlking (14751 in chips) 
Seat 2: 4sasss (800 in chips) 
Seat 3: JonzStars (10562 in chips) 
Seat 4: Earl of Poker V (20800 in chips) 
Seat 5: mila is best (45974 in chips) 
Seat 6: escabofildo (9400 in chips) 
nzlking: posts the ante 300
4sasss: posts the ante 300
JonzStars: posts the ante 300
Earl of Poker V: posts the ante 300
mila is best: posts the ante 300
escabofildo: posts the ante 300
mila is best: posts small blind 600
escabofildo: posts big blind 1200
*** HOLE CARDS ***
nzlking: folds 
4sasss: calls 500 and is all-in
JonzStars: folds 
Earl of Poker V: raises 19300 to 20500 and is all-in
mila is best: folds 
escabofildo: calls 7900 and is all-in
Uncalled bet (11400) returned to Earl of Poker V
*** FLOP *** [4s 2d 7h]
*** TURN *** [4s 2d 7h] [Kc]
*** RIVER *** [4s 2d 7h Kc] [6h]
*** SHOW DOWN ***
escabofildo: shows [As Ks] (a pair of Kings)
Earl of Poker V: shows [Td Qd] (high card King)
escabofildo collected 17300 from side pot
4sasss: shows [4c 2h] (two pair, Fours and Deuces)
4sasss collected 3800 from main pot
*** SUMMARY ***
Total pot 21100 Main pot 3800. Side pot 17300. | Rake 0 
Board [4s 2d 7h Kc 6h]
Seat 1: nzlking folded before Flop (didn't bet)
Seat 2: 4sasss showed [4c 2h] and won (3800) with two pair, Fours and Deuces
Seat 3: JonzStars folded before Flop (didn't bet)
Seat 4: Earl of Poker V (button) showed [Td Qd] and lost with high card King
Seat 5: mila is best (small blind) folded before Flop
Seat 6: escabofildo (big blind) showed [As Ks] and won (17300) with a pair of Kings

PokerStars Hand #251209779752: Tournament #3769361908, $52.38+$2.62 USD Hold'em No Limit - Level XV (600/1200) - 2024/06/26 22:47:04 UTC [2024/06/26 18:47:04 ET]
Table '3769361908 16' 6-max Seat #5 is the button
Seat 1: nzlking (14451 in chips) 
Seat 2: 4sasss (3800 in chips) 
Seat 3: JonzStars (10262 in chips) 
Seat 4: Earl of Poker V (11400 in chips) 
Seat 5: mila is best (45074 in chips) 
Seat 6: escabofildo (17300 in chips) 
nzlking: posts the ante 300
4sasss: posts the ante 300
JonzStars: posts the ante 300
Earl of Poker V: posts the ante 300
mila is best: posts the ante 300
escabofildo: posts the ante 300
escabofildo: posts small blind 600
nzlking: posts big blind 1200
*** HOLE CARDS ***
4sasss: raises 2300 to 3500 and is all-in
JonzStars: folds 
Earl of Poker V: folds 
mila is best: raises 41274 to 44774 and is all-in
escabofildo: folds 
nzlking: folds 
Uncalled bet (41274) returned to mila is best
*** FLOP *** [Ks Ts Qd]
*** TURN *** [Ks Ts Qd] [7c]
*** RIVER *** [Ks Ts Qd 7c] [Qh]
*** SHOW DOWN ***
4sasss: shows [8d As] (a pair of Queens)
mila is best: shows [Ad 8c] (a pair of Queens)
4sasss collected 5300 from pot
mila is best collected 5300 from pot
*** SUMMARY ***
Total pot 10600 | Rake 0 
Board [Ks Ts Qd 7c Qh]
Seat 1: nzlking (big blind) folded before Flop
Seat 2: 4sasss showed [8d As] and won (5300) with a pair of Queens
Seat 3: JonzStars folded before Flop (didn't bet)
Seat 4: Earl of Poker V folded before Flop (didn't bet)
Seat 5: mila is best (button) showed [Ad 8c] and won (5300) with a pair of Queens
Seat 6: escabofildo (small blind) folded before Flop

PokerStars Hand #251209786581: Tournament #3769361908, $52.38+$2.62 USD Hold'em No Limit - Level XVI (800/1600) - 2024/06/26 22:47:31 UTC [2024/06/26 18:47:31 ET]
Table '3769361908 16' 6-max Seat #6 is the button
Seat 1: nzlking (12951 in chips) 
Seat 2: 4sasss (5300 in chips) 
Seat 3: JonzStars (9962 in chips) 
Seat 4: Earl of Poker V (11100 in chips) 
Seat 5: mila is best (46574 in chips) 
Seat 6: escabofildo (16400 in chips) 
nzlking: posts the ante 400
4sasss: posts the ante 400
JonzStars: posts the ante 400
Earl of Poker V: posts the ante 400
mila is best: posts the ante 400
escabofildo: posts the ante 400
nzlking: posts small blind 800
4sasss: posts big blind 1600
*** HOLE CARDS ***
JonzStars: raises 7962 to 9562 and is all-in
Earl of Poker V: raises 1138 to 10700 and is all-in
mila is best: folds 
escabofildo: folds 
nzlking: folds 
4sasss: folds 
Uncalled bet (1138) returned to Earl of Poker V
*** FLOP *** [Kd 9d Kh]
*** TURN *** [Kd 9d Kh] [8s]
*** RIVER *** [Kd 9d Kh 8s] [9h]
*** SHOW DOWN ***
JonzStars: shows [6c 6s] (two pair, Kings and Nines)
Earl of Poker V: shows [Ac Qc] (two pair, Kings and Nines - Ace kicker)
Earl of Poker V collected 23924 from pot
JonzStars finished the tournament
*** SUMMARY ***
Total pot 23924 | Rake 0 
Board [Kd 9d Kh 8s 9h]
Seat 1: nzlking (small blind) folded before Flop
Seat 2: 4sasss (big blind) folded before Flop
Seat 3: JonzStars showed [6c 6s] and lost with two pair, Kings and Nines
Seat 4: Earl of Poker V showed [Ac Qc] and won (23924) with two pair, Kings and Nines
Seat 5: mila is best folded before Flop (didn't bet)
Seat 6: escabofildo (button) folded before Flop (didn't bet)

PokerStars Hand #251209793516: Tournament #3769361908, $52.38+$2.62 USD Hold'em No Limit - Level XVI (800/1600) - 2024/06/26 22:47:59 UTC [2024/06/26 18:47:59 ET]
Table '3769361908 16' 6-max Seat #1 is the button
Seat 1: nzlking (11751 in chips) 
Seat 2: 4sasss (3300 in chips) 
Seat 4: Earl of Poker V (25062 in chips) 
Seat 5: mila is best (46174 in chips) 
Seat 6: escabofildo (16000 in chips) 
nzlking: posts the ante 400
4sasss: posts the ante 400
Earl of Poker V: posts the ante 400
mila is best: posts the ante 400
escabofildo: posts the ante 400
4sasss: posts small blind 800
Earl of Poker V: posts big blind 1600
*** HOLE CARDS ***
mila is best: folds 
escabofildo: raises 14000 to 15600 and is all-in
nzlking: folds 
4sasss: folds 
Earl of Poker V: calls 14000
*** FLOP *** [Ah Kc 4c]
lintumies12 is disconnected 
*** TURN *** [Ah Kc 4c] [9h]
*** RIVER *** [Ah Kc 4c 9h] [6s]
*** SHOW DOWN ***
Earl of Poker V: shows [Ac 8s] (a pair of Aces)
escabofildo: shows [As 9d] (two pair, Aces and Nines)
escabofildo collected 34000 from pot
*** SUMMARY ***
Total pot 34000 | Rake 0 
Board [Ah Kc 4c 9h 6s]
Seat 1: nzlking (button) folded before Flop (didn't bet)
Seat 2: 4sasss (small blind) folded before Flop
Seat 4: Earl of Poker V (big blind) showed [Ac 8s] and lost with a pair of Aces
Seat 5: mila is best folded before Flop (didn't bet)
Seat 6: escabofildo showed [As 9d] and won (34000) with two pair, Aces and Nines

PokerStars Hand #251209798904: Tournament #3769361908, $52.38+$2.62 USD Hold'em No Limit - Level XVI (800/1600) - 2024/06/26 22:48:20 UTC [2024/06/26 18:48:20 ET]
Table '3769361908 16' 6-max Seat #2 is the button
Seat 1: nzlking (11351 in chips) 
Seat 2: 4sasss (2100 in chips) 
Seat 3: lintumies12 (17370 in chips) out of hand (moved from another table into small blind)
Seat 4: Earl of Poker V (9062 in chips) 
Seat 5: mila is best (45774 in chips) 
Seat 6: escabofildo (34000 in chips) 
lintumies12 will be allowed to play after the button
nzlking: posts the ante 400
4sasss: posts the ante 400
Earl of Poker V: posts the ante 400
mila is best: posts the ante 400
escabofildo: posts the ante 400
Earl of Poker V: posts small blind 800
mila is best: posts big blind 1600
*** HOLE CARDS ***
escabofildo: folds 
nzlking: folds 
4sasss: raises 100 to 1700 and is all-in
Earl of Poker V: raises 6962 to 8662 and is all-in
mila is best: calls 7062
*** FLOP *** [7d 6d 9d]
*** TURN *** [7d 6d 9d] [Th]
*** RIVER *** [7d 6d 9d Th] [8c]
*** SHOW DOWN ***
Earl of Poker V: shows [Kh 7s] (a straight, Six to Ten)
mila is best: shows [3c 3h] (a straight, Six to Ten)
Earl of Poker V collected 6962 from side pot
mila is best collected 6962 from side pot
4sasss: shows [3d Kd] (a flush, King high)
4sasss collected 7100 from main pot
*** SUMMARY ***
Total pot 21024 Main pot 7100. Side pot 13924. | Rake 0 
Board [7d 6d 9d Th 8c]
Seat 1: nzlking folded before Flop (didn't bet)
Seat 2: 4sasss (button) showed [3d Kd] and won (7100) with a flush, King high
Seat 4: Earl of Poker V (small blind) showed [Kh 7s] and won (6962) with a straight, Six to Ten
Seat 5: mila is best (big blind) showed [3c 3h] and won (6962) with a straight, Six to Ten
Seat 6: escabofildo folded before Flop (didn't bet)

PokerStars Hand #251209805854: Tournament #3769361908, $52.38+$2.62 USD Hold'em No Limit - Level XVI (800/1600) - 2024/06/26 22:48:47 UTC [2024/06/26 18:48:47 ET]
Table '3769361908 16' 6-max Seat #4 is the button
Seat 1: nzlking (10951 in chips) 
Seat 2: 4sasss (7100 in chips) 
Seat 3: lintumies12 (17370 in chips) 
Seat 4: Earl of Poker V (6962 in chips) 
Seat 5: mila is best (43674 in chips) 
Seat 6: escabofildo (33600 in chips) 
nzlking: posts the ante 400
4sasss: posts the ante 400
lintumies12: posts the ante 400
Earl of Poker V: posts the ante 400
mila is best: posts the ante 400
escabofildo: posts the ante 400
mila is best: posts small blind 800
escabofildo: posts big blind 1600
*** HOLE CARDS ***
nzlking: folds 
4sasss: raises 5100 to 6700 and is all-in
lintumies12: folds 
Earl of Poker V: folds 
mila is best: folds 
escabofildo: calls 5100
*** FLOP *** [3c 5c 8s]
*** TURN *** [3c 5c 8s] [Th]
*** RIVER *** [3c 5c 8s Th] [Kh]
*** SHOW DOWN ***
escabofildo: shows [Ad Jc] (high card Ace)
4sasss: shows [Kc Jd] (a pair of Kings)
4sasss collected 16600 from pot
*** SUMMARY ***
Total pot 16600 | Rake 0 
Board [3c 5c 8s Th Kh]
Seat 1: nzlking folded before Flop (didn't bet)
Seat 2: 4sasss showed [Kc Jd] and won (16600) with a pair of Kings
Seat 3: lintumies12 folded before Flop (didn't bet)
Seat 4: Earl of Poker V (button) folded before Flop (didn't bet)
Seat 5: mila is best (small blind) folded before Flop
Seat 6: escabofildo (big blind) showed [Ad Jc] and lost with high card Ace

PokerStars Hand #251209815640: Tournament #3769361908, $52.38+$2.62 USD Hold'em No Limit - Level XVI (800/1600) - 2024/06/26 22:49:27 UTC [2024/06/26 18:49:27 ET]
Table '3769361908 16' 6-max Seat #5 is the button
Seat 1: nzlking (10551 in chips) 
Seat 2: 4sasss (16600 in chips) 
Seat 3: lintumies12 (16970 in chips) 
Seat 4: Earl of Poker V (6562 in chips) 
Seat 5: mila is best (42474 in chips) 
Seat 6: escabofildo (26500 in chips) 
nzlking: posts the ante 400
4sasss: posts the ante 400
lintumies12: posts the ante 400
Earl of Poker V: posts the ante 400
mila is best: posts the ante 400
escabofildo: posts the ante 400
escabofildo: posts small blind 800
nzlking: posts big blind 1600
*** HOLE CARDS ***
4sasss: folds 
lintumies12: folds 
Earl of Poker V: folds 
mila is best: folds 
escabofildo: raises 24500 to 26100 and is all-in
nzlking: calls 8551 and is all-in
Uncalled bet (15949) returned to escabofildo
*** FLOP *** [Kc Ad 5h]
*** TURN *** [Kc Ad 5h] [As]
*** RIVER *** [Kc Ad 5h As] [8c]
*** SHOW DOWN ***
escabofildo: shows [3d Ts] (a pair of Aces)
nzlking: shows [6c Qc] (a pair of Aces - King+Queen kicker)
nzlking collected 22702 from pot
*** SUMMARY ***
Total pot 22702 | Rake 0 
Board [Kc Ad 5h As 8c]
Seat 1: nzlking (big blind) showed [6c Qc] and won (22702) with a pair of Aces
Seat 2: 4sasss folded before Flop (didn't bet)
Seat 3: lintumies12 folded before Flop (didn't bet)
Seat 4: Earl of Poker V folded before Flop (didn't bet)
Seat 5: mila is best (button) folded before Flop (didn't bet)
Seat 6: escabofildo (small blind) showed [3d Ts] and lost with a pair of Aces

PokerStars Hand #251209828910: Tournament #3769361908, $52.38+$2.62 USD Hold'em No Limit - Level XVII (1000/2000) - 2024/06/26 22:50:20 UTC [2024/06/26 18:50:20 ET]
Table '3769361908 16' 6-max Seat #6 is the button
Seat 1: nzlking (22702 in chips) 
Seat 2: 4sasss (16200 in chips) 
Seat 3: lintumies12 (16570 in chips) 
Seat 4: Earl of Poker V (6162 in chips) 
Seat 5: mila is best (42074 in chips) 
Seat 6: escabofildo (15949 in chips) 
nzlking: posts the ante 500
4sasss: posts the ante 500
lintumies12: posts the ante 500
Earl of Poker V: posts the ante 500
mila is best: posts the ante 500
escabofildo: posts the ante 500
nzlking: posts small blind 1000
4sasss: posts big blind 2000
*** HOLE CARDS ***
lintumies12: folds 
Earl of Poker V: raises 3662 to 5662 and is all-in
mila is best: folds 
escabofildo: folds 
nzlking: folds 
4sasss: calls 3662
*** FLOP *** [Js Ts Ac]
*** TURN *** [Js Ts Ac] [3c]
*** RIVER *** [Js Ts Ac 3c] [2s]
*** SHOW DOWN ***
4sasss: shows [6c Kh] (high card Ace)
Earl of Poker V: shows [Jd 8d] (a pair of Jacks)
Earl of Poker V collected 15324 from pot
*** SUMMARY ***
Total pot 15324 | Rake 0 
Board [Js Ts Ac 3c 2s]
Seat 1: nzlking (small blind) folded before Flop
Seat 2: 4sasss (big blind) showed [6c Kh] and lost with high card Ace
Seat 3: lintumies12 folded before Flop (didn't bet)
Seat 4: Earl of Poker V showed [Jd 8d] and won (15324) with a pair of Jacks
Seat 5: mila is best folded before Flop (didn't bet)
Seat 6: escabofildo (button) folded before Flop (didn't bet)

PokerStars Hand #251209838244: Tournament #3769361908, $52.38+$2.62 USD Hold'em No Limit - Level XVII (1000/2000) - 2024/06/26 22:50:59 UTC [2024/06/26 18:50:59 ET]
Table '3769361908 16' 6-max Seat #1 is the button
Seat 1: nzlking (21202 in chips) 
Seat 2: 4sasss (10038 in chips) 
Seat 3: lintumies12 (16070 in chips) 
Seat 4: Earl of Poker V (15324 in chips) 
Seat 5: mila is best (41574 in chips) 
Seat 6: escabofildo (15449 in chips) 
nzlking: posts the ante 500
4sasss: posts the ante 500
lintumies12: posts the ante 500
Earl of Poker V: posts the ante 500
mila is best: posts the ante 500
escabofildo: posts the ante 500
4sasss: posts small blind 1000
lintumies12: posts big blind 2000
*** HOLE CARDS ***
Earl of Poker V: folds 
mila is best: folds 
escabofildo: raises 12949 to 14949 and is all-in
nzlking: folds 
4sasss: folds 
lintumies12: calls 12949
*** FLOP *** [5s Qc 6d]
*** TURN *** [5s Qc 6d] [6h]
*** RIVER *** [5s Qc 6d 6h] [Qh]
*** SHOW DOWN ***
lintumies12: shows [Jd Qd] (a full house, Queens full of Sixes)
escabofildo: shows [Ks Ah] (two pair, Queens and Sixes)
lintumies12 collected 33898 from pot
escabofildo finished the tournament in 98th place
*** SUMMARY ***
Total pot 33898 | Rake 0 
Board [5s Qc 6d 6h Qh]
Seat 1: nzlking (button) folded before Flop (didn't bet)
Seat 2: 4sasss (small blind) folded before Flop
Seat 3: lintumies12 (big blind) showed [Jd Qd] and won (33898) with a full house, Queens full of Sixes
Seat 4: Earl of Poker V folded before Flop (didn't bet)
Seat 5: mila is best folded before Flop (didn't bet)
Seat 6: escabofildo showed [Ks Ah] and lost with two pair, Queens and Sixes

PokerStars Hand #251209850724: Tournament #3769361908, $52.38+$2.62 USD Hold'em No Limit - Level XVII (1000/2000) - 2024/06/26 22:51:50 UTC [2024/06/26 18:51:50 ET]
Table '3769361908 16' 6-max Seat #2 is the button
Seat 1: nzlking (20702 in chips) 
Seat 2: 4sasss (8538 in chips) 
Seat 3: lintumies12 (34519 in chips) 
Seat 4: Earl of Poker V (14824 in chips) 
Seat 5: mila is best (41074 in chips) 
nzlking: posts the ante 500
4sasss: posts the ante 500
lintumies12: posts the ante 500
Earl of Poker V: posts the ante 500
mila is best: posts the ante 500
lintumies12: posts small blind 1000
Earl of Poker V: posts big blind 2000
*** HOLE CARDS ***
GabrielTho1 is disconnected 
mila is best: folds 
nzlking: raises 18202 to 20202 and is all-in
4sasss: calls 8038 and is all-in
lintumies12: folds 
Earl of Poker V: folds 
Uncalled bet (12164) returned to nzlking
*** FLOP *** [2d 3d Td]
*** TURN *** [2d 3d Td] [6c]
*** RIVER *** [2d 3d Td 6c] [9d]
*** SHOW DOWN ***
nzlking: shows [As 5s] (high card Ace)
4sasss: shows [Qd Kd] (a flush, King high)
4sasss collected 21576 from pot
*** SUMMARY ***
Total pot 21576 | Rake 0 
Board [2d 3d Td 6c 9d]
Seat 1: nzlking showed [As 5s] and lost with high card Ace
Seat 2: 4sasss (button) showed [Qd Kd] and won (21576) with a flush, King high
Seat 3: lintumies12 (small blind) folded before Flop
Seat 4: Earl of Poker V (big blind) folded before Flop
Seat 5: mila is best folded before Flop (didn't bet)

PokerStars Hand #251209861204: Tournament #3769361908, $52.38+$2.62 USD Hold'em No Limit - Level XVII (1000/2000) - 2024/06/26 22:52:33 UTC [2024/06/26 18:52:33 ET]
Table '3769361908 16' 6-max Seat #3 is the button
Seat 1: nzlking (12164 in chips) 
Seat 2: 4sasss (21576 in chips) 
Seat 3: lintumies12 (33019 in chips) 
Seat 4: Earl of Poker V (12324 in chips) 
Seat 5: mila is best (40574 in chips) 
Seat 6: GabrielTho1 (32111 in chips) 
nzlking: posts the ante 500
4sasss: posts the ante 500
lintumies12: posts the ante 500
Earl of Poker V: posts the ante 500
mila is best: posts the ante 500
GabrielTho1: posts the ante 500
Earl of Poker V: posts small blind 1000
mila is best: posts big blind 2000
*** HOLE CARDS ***
GabrielTho1: folds 
nzlking: folds 
4sasss: raises 19076 to 21076 and is all-in
lintumies12: folds 
Earl of Poker V: folds 
mila is best: folds 
Uncalled bet (19076) returned to 4sasss
4sasss collected 8000 from pot
*** SUMMARY ***
Total pot 8000 | Rake 0 
Seat 1: nzlking folded before Flop (didn't bet)
Seat 2: 4sasss collected (8000)
Seat 3: lintumies12 (button) folded before Flop (didn't bet)
Seat 4: Earl of Poker V (small blind) folded before Flop
Seat 5: mila is best (big blind) folded before Flop
Seat 6: GabrielTho1 folded before Flop (didn't bet)

PokerStars Hand #251209869427: Tournament #3769361908, $52.38+$2.62 USD Hold'em No Limit - Level XVII (1000/2000) - 2024/06/26 22:53:06 UTC [2024/06/26 18:53:06 ET]
Table '3769361908 16' 6-max Seat #4 is the button
Seat 1: nzlking (11664 in chips) 
Seat 2: 4sasss (27076 in chips) 
Seat 3: lintumies12 (32519 in chips) 
Seat 4: Earl of Poker V (10824 in chips) 
Seat 5: mila is best (38074 in chips) 
Seat 6: GabrielTho1 (31611 in chips) 
nzlking: posts the ante 500
4sasss: posts the ante 500
lintumies12: posts the ante 500
Earl of Poker V: posts the ante 500
mila is best: posts the ante 500
GabrielTho1: posts the ante 500
mila is best: posts small blind 1000
GabrielTho1: posts big blind 2000
*** HOLE CARDS ***
nzlking: folds 
4sasss: folds 
lintumies12: raises 30019 to 32019 and is all-in
Earl of Poker V: folds 
mila is best: folds 
GabrielTho1: folds 
Uncalled bet (30019) returned to lintumies12
lintumies12 collected 8000 from pot
lintumies12: doesn't show hand 
*** SUMMARY ***
Total pot 8000 | Rake 0 
Seat 1: nzlking folded before Flop (didn't bet)
Seat 2: 4sasss folded before Flop (didn't bet)
Seat 3: lintumies12 collected (8000)
Seat 4: Earl of Poker V (button) folded before Flop (didn't bet)
Seat 5: mila is best (small blind) folded before Flop
Seat 6: GabrielTho1 (big blind) folded before Flop

PokerStars Hand #251209884120: Tournament #3769361908, $52.38+$2.62 USD Hold'em No Limit - Level XVIII (1200/2400) - 2024/06/26 22:54:07 UTC [2024/06/26 18:54:07 ET]
Table '3769361908 16' 6-max Seat #5 is the button
Seat 1: nzlking (11164 in chips) 
Seat 2: 4sasss (26576 in chips) 
Seat 3: lintumies12 (38019 in chips) 
Seat 4: Earl of Poker V (10324 in chips) 
Seat 5: mila is best (36574 in chips) 
Seat 6: GabrielTho1 (29111 in chips) 
nzlking: posts the ante 600
4sasss: posts the ante 600
lintumies12: posts the ante 600
Earl of Poker V: posts the ante 600
mila is best: posts the ante 600
GabrielTho1: posts the ante 600
GabrielTho1: posts small blind 1200
nzlking: posts big blind 2400
*** HOLE CARDS ***
4sasss: raises 3600 to 6000
lintumies12: folds 
Earl of Poker V: folds 
mila is best: folds 
GabrielTho1: folds 
nzlking: folds 
Uncalled bet (3600) returned to 4sasss
4sasss collected 9600 from pot
*** SUMMARY ***
Total pot 9600 | Rake 0 
Seat 1: nzlking (big blind) folded before Flop
Seat 2: 4sasss collected (9600)
Seat 3: lintumies12 folded before Flop (didn't bet)
Seat 4: Earl of Poker V folded before Flop (didn't bet)
Seat 5: mila is best (button) folded before Flop (didn't bet)
Seat 6: GabrielTho1 (small blind) folded before Flop

PokerStars Hand #251209893086: Tournament #3769361908, $52.38+$2.62 USD Hold'em No Limit - Level XVIII (1200/2400) - 2024/06/26 22:54:44 UTC [2024/06/26 18:54:44 ET]
Table '3769361908 16' 6-max Seat #6 is the button
Seat 1: nzlking (8164 in chips) 
Seat 2: 4sasss (33176 in chips) 
Seat 3: lintumies12 (37419 in chips) 
Seat 4: Earl of Poker V (9724 in chips) 
Seat 5: mila is best (35974 in chips) 
Seat 6: GabrielTho1 (27311 in chips) 
nzlking: posts the ante 600
4sasss: posts the ante 600
lintumies12: posts the ante 600
Earl of Poker V: posts the ante 600
mila is best: posts the ante 600
GabrielTho1: posts the ante 600
nzlking: posts small blind 1200
4sasss: posts big blind 2400
*** HOLE CARDS ***
lintumies12: raises 34419 to 36819 and is all-in
Earl of Poker V: calls 9124 and is all-in
mila is best: folds 
GabrielTho1: folds 
nzlking: calls 6364 and is all-in
4sasss: folds 
Uncalled bet (27695) returned to lintumies12
*** FLOP *** [Jh Td Jc]
*** TURN *** [Jh Td Jc] [2s]
*** RIVER *** [Jh Td Jc 2s] [9c]
*** SHOW DOWN ***
lintumies12: shows [Ad Kc] (a pair of Jacks)
Earl of Poker V: shows [Th Ts] (a full house, Tens full of Jacks)
Earl of Poker V collected 3120 from side pot
nzlking: shows [6h 6d] (two pair, Jacks and Sixes)
Earl of Poker V collected 28692 from main pot
nzlking finished the tournament in 73rd place
*** SUMMARY ***
Total pot 31812 Main pot 28692. Side pot 3120. | Rake 0 
Board [Jh Td Jc 2s 9c]
Seat 1: nzlking (small blind) showed [6h 6d] and lost with two pair, Jacks and Sixes
Seat 2: 4sasss (big blind) folded before Flop
Seat 3: lintumies12 showed [Ad Kc] and lost with a pair of Jacks
Seat 4: Earl of Poker V showed [Th Ts] and won (31812) with a full house, Tens full of Jacks
Seat 5: mila is best folded before Flop (didn't bet)
Seat 6: GabrielTho1 (button) folded before Flop (didn't bet)




PokerStars Hand #251209148851: Tournament #3769361908, $52.38+$2.62 USD Hold'em No Limit - Level III (40/80) - 2024/06/26 22:08:45 UTC [2024/06/26 18:08:45 ET]
Table '3769361908 14' 6-max Seat #5 is the button
Seat 1: dulek_jason (11287 in chips) 
Seat 2: jessecesar (8520 in chips) 
Seat 3: whaleptt (9605 in chips) 
Seat 4: Go4ElvIS (8330 in chips) 
Seat 5: mennck (6434 in chips) 
dulek_jason: posts the ante 20
jessecesar: posts the ante 20
whaleptt: posts the ante 20
Go4ElvIS: posts the ante 20
mennck: posts the ante 20
dulek_jason: posts small blind 40
jessecesar: posts big blind 80
*** HOLE CARDS ***
whaleptt: folds 
Go4ElvIS: folds 
mennck: folds 
dulek_jason: calls 40
$aymon9 is disconnected 
jessecesar: raises 240 to 320
dulek_jason: calls 240
*** FLOP *** [Qc Ac 8s]
dulek_jason: checks 
jessecesar: checks 
*** TURN *** [Qc Ac 8s] [3c]
dulek_jason: checks 
jessecesar: checks 
*** RIVER *** [Qc Ac 8s 3c] [5h]
dulek_jason: bets 548
jessecesar: folds 
Uncalled bet (548) returned to dulek_jason
dulek_jason collected 740 from pot
dulek_jason: doesn't show hand 
*** SUMMARY ***
Total pot 740 | Rake 0 
Board [Qc Ac 8s 3c 5h]
Seat 1: dulek_jason (small blind) collected (740)
Seat 2: jessecesar (big blind) folded on the River
Seat 3: whaleptt folded before Flop (didn't bet)
Seat 4: Go4ElvIS folded before Flop (didn't bet)
Seat 5: mennck (button) folded before Flop (didn't bet)

PokerStars Hand #251209174666: Tournament #3769361908, $52.38+$2.62 USD Hold'em No Limit - Level III (40/80) - 2024/06/26 22:10:13 UTC [2024/06/26 18:10:13 ET]
Table '3769361908 14' 6-max Seat #1 is the button
Seat 1: dulek_jason (11687 in chips) 
Seat 2: jessecesar (8180 in chips) 
Seat 3: whaleptt (9585 in chips) 
Seat 4: Go4ElvIS (8310 in chips) 
Seat 5: mennck (6414 in chips) 
Seat 6: $aymon9 (10000 in chips) 
dulek_jason: posts the ante 20
jessecesar: posts the ante 20
whaleptt: posts the ante 20
Go4ElvIS: posts the ante 20
mennck: posts the ante 20
$aymon9: posts the ante 20
jessecesar: posts small blind 40
whaleptt: posts big blind 80
*** HOLE CARDS ***
Go4ElvIS: folds 
mennck: folds 
$aymon9: folds 
dulek_jason: raises 91 to 171
jessecesar: calls 131
whaleptt: folds 
*** FLOP *** [5h Kc 7c]
jessecesar: checks 
dulek_jason: bets 179
jessecesar: raises 621 to 800
dulek_jason: folds 
Uncalled bet (621) returned to jessecesar
jessecesar collected 900 from pot
jessecesar: doesn't show hand 
*** SUMMARY ***
Total pot 900 | Rake 0 
Board [5h Kc 7c]
Seat 1: dulek_jason (button) folded on the Flop
Seat 2: jessecesar (small blind) collected (900)
Seat 3: whaleptt (big blind) folded before Flop
Seat 4: Go4ElvIS folded before Flop (didn't bet)
Seat 5: mennck folded before Flop (didn't bet)
Seat 6: $aymon9 folded before Flop (didn't bet)

PokerStars Hand #251209192049: Tournament #3769361908, $52.38+$2.62 USD Hold'em No Limit - Level IV (50/100) - 2024/06/26 22:11:13 UTC [2024/06/26 18:11:13 ET]
Table '3769361908 14' 6-max Seat #2 is the button
Seat 1: dulek_jason (11317 in chips) 
Seat 2: jessecesar (8710 in chips) 
Seat 3: whaleptt (9485 in chips) 
Seat 4: Go4ElvIS (8290 in chips) 
Seat 5: mennck (6394 in chips) 
Seat 6: $aymon9 (9980 in chips) 
dulek_jason: posts the ante 25
jessecesar: posts the ante 25
whaleptt: posts the ante 25
Go4ElvIS: posts the ante 25
mennck: posts the ante 25
$aymon9: posts the ante 25
whaleptt: posts small blind 50
Go4ElvIS: posts big blind 100
*** HOLE CARDS ***
mennck: folds 
$aymon9: raises 100 to 200
dulek_jason: folds 
jessecesar: calls 200
whaleptt: calls 150
Go4ElvIS: calls 100
*** FLOP *** [9c 6s 2d]
whaleptt: checks 
Go4ElvIS: checks 
$aymon9: bets 314
jessecesar: folds 
whaleptt: calls 314
Go4ElvIS: folds 
*** TURN *** [9c 6s 2d] [6d]
whaleptt: bets 395
$aymon9: calls 395
*** RIVER *** [9c 6s 2d 6d] [Qd]
whaleptt: bets 1965
$aymon9: calls 1965
*** SHOW DOWN ***
whaleptt: shows [7s As] (a pair of Sixes)
$aymon9: shows [Tc Td] (two pair, Tens and Sixes)
$aymon9 collected 6298 from pot
*** SUMMARY ***
Total pot 6298 | Rake 0 
Board [9c 6s 2d 6d Qd]
Seat 1: dulek_jason folded before Flop (didn't bet)
Seat 2: jessecesar (button) folded on the Flop
Seat 3: whaleptt (small blind) showed [7s As] and lost with a pair of Sixes
Seat 4: Go4ElvIS (big blind) folded on the Flop
Seat 5: mennck folded before Flop (didn't bet)
Seat 6: $aymon9 showed [Tc Td] and won (6298) with two pair, Tens and Sixes

PokerStars Hand #251209221124: Tournament #3769361908, $52.38+$2.62 USD Hold'em No Limit - Level IV (50/100) - 2024/06/26 22:12:54 UTC [2024/06/26 18:12:54 ET]
Table '3769361908 14' 6-max Seat #3 is the button
Seat 1: dulek_jason (11292 in chips) 
Seat 2: jessecesar (8485 in chips) 
Seat 3: whaleptt (6586 in chips) 
Seat 4: Go4ElvIS (8065 in chips) 
Seat 5: mennck (6369 in chips) 
Seat 6: $aymon9 (13379 in chips) 
dulek_jason: posts the ante 25
jessecesar: posts the ante 25
whaleptt: posts the ante 25
Go4ElvIS: posts the ante 25
mennck: posts the ante 25
$aymon9: posts the ante 25
Go4ElvIS: posts small blind 50
mennck: posts big blind 100
*** HOLE CARDS ***
$aymon9: raises 100 to 200
dulek_jason: folds 
jessecesar: folds 
whaleptt: folds 
Go4ElvIS: raises 400 to 600
mennck: folds 
$aymon9: calls 400
*** FLOP *** [8c Qs 4c]
Go4ElvIS: bets 479
$aymon9: calls 479
*** TURN *** [8c Qs 4c] [5c]
Go4ElvIS: checks 
$aymon9: checks 
*** RIVER *** [8c Qs 4c 5c] [2d]
Go4ElvIS: checks 
$aymon9: bets 1350
Go4ElvIS: calls 1350
*** SHOW DOWN ***
$aymon9: shows [Qc Ad] (a pair of Queens)
Go4ElvIS: mucks hand 
$aymon9 collected 5108 from pot
*** SUMMARY ***
Total pot 5108 | Rake 0 
Board [8c Qs 4c 5c 2d]
Seat 1: dulek_jason folded before Flop (didn't bet)
Seat 2: jessecesar folded before Flop (didn't bet)
Seat 3: whaleptt (button) folded before Flop (didn't bet)
Seat 4: Go4ElvIS (small blind) mucked
Seat 5: mennck (big blind) folded before Flop
Seat 6: $aymon9 showed [Qc Ad] and won (5108) with a pair of Queens

PokerStars Hand #251209239944: Tournament #3769361908, $52.38+$2.62 USD Hold'em No Limit - Level IV (50/100) - 2024/06/26 22:14:00 UTC [2024/06/26 18:14:00 ET]
Table '3769361908 14' 6-max Seat #4 is the button
Seat 1: dulek_jason (11267 in chips) 
Seat 2: jessecesar (8460 in chips) 
Seat 3: whaleptt (6561 in chips) 
Seat 4: Go4ElvIS (5611 in chips) 
Seat 5: mennck (6244 in chips) 
Seat 6: $aymon9 (16033 in chips) 
dulek_jason: posts the ante 25
jessecesar: posts the ante 25
whaleptt: posts the ante 25
Go4ElvIS: posts the ante 25
mennck: posts the ante 25
$aymon9: posts the ante 25
mennck: posts small blind 50
$aymon9: posts big blind 100
*** HOLE CARDS ***
dulek_jason: folds 
jessecesar: folds 
whaleptt: raises 120 to 220
Go4ElvIS: folds 
mennck: folds 
$aymon9: calls 120
*** FLOP *** [Ad 8c 5s]
$aymon9: checks 
whaleptt: bets 160
$aymon9: calls 160
*** TURN *** [Ad 8c 5s] [Qc]
$aymon9: checks 
whaleptt: checks 
*** RIVER *** [Ad 8c 5s Qc] [9c]
$aymon9: bets 600
whaleptt: folds 
Uncalled bet (600) returned to $aymon9
$aymon9 collected 960 from pot
*** SUMMARY ***
Total pot 960 | Rake 0 
Board [Ad 8c 5s Qc 9c]
Seat 1: dulek_jason folded before Flop (didn't bet)
Seat 2: jessecesar folded before Flop (didn't bet)
Seat 3: whaleptt folded on the River
Seat 4: Go4ElvIS (button) folded before Flop (didn't bet)
Seat 5: mennck (small blind) folded before Flop
Seat 6: $aymon9 (big blind) collected (960)

PokerStars Hand #251209261585: Tournament #3769361908, $52.38+$2.62 USD Hold'em No Limit - Level V (60/120) - 2024/06/26 22:15:16 UTC [2024/06/26 18:15:16 ET]
Table '3769361908 14' 6-max Seat #5 is the button
Seat 1: dulek_jason (11242 in chips) 
Seat 2: jessecesar (8435 in chips) 
Seat 3: whaleptt (6156 in chips) 
Seat 4: Go4ElvIS (5586 in chips) 
Seat 5: mennck (6169 in chips) 
Seat 6: $aymon9 (16588 in chips) 
dulek_jason: posts the ante 30
jessecesar: posts the ante 30
whaleptt: posts the ante 30
Go4ElvIS: posts the ante 30
mennck: posts the ante 30
$aymon9: posts the ante 30
$aymon9: posts small blind 60
dulek_jason: posts big blind 120
*** HOLE CARDS ***
jessecesar: raises 120 to 240
whaleptt: folds 
Go4ElvIS: folds 
mennck: folds 
$aymon9: raises 720 to 960
dulek_jason: folds 
jessecesar: folds 
Uncalled bet (720) returned to $aymon9
$aymon9 collected 780 from pot
*** SUMMARY ***
Total pot 780 | Rake 0 
Seat 1: dulek_jason (big blind) folded before Flop
Seat 2: jessecesar folded before Flop
Seat 3: whaleptt folded before Flop (didn't bet)
Seat 4: Go4ElvIS folded before Flop (didn't bet)
Seat 5: mennck (button) folded before Flop (didn't bet)
Seat 6: $aymon9 (small blind) collected (780)

PokerStars Hand #251209269202: Tournament #3769361908, $52.38+$2.62 USD Hold'em No Limit - Level V (60/120) - 2024/06/26 22:15:43 UTC [2024/06/26 18:15:43 ET]
Table '3769361908 14' 6-max Seat #6 is the button
Seat 1: dulek_jason (11092 in chips) 
Seat 2: jessecesar (8165 in chips) 
Seat 3: whaleptt (6126 in chips) 
Seat 4: Go4ElvIS (5556 in chips) 
Seat 5: mennck (6139 in chips) 
Seat 6: $aymon9 (17098 in chips) 
dulek_jason: posts the ante 30
jessecesar: posts the ante 30
whaleptt: posts the ante 30
Go4ElvIS: posts the ante 30
mennck: posts the ante 30
$aymon9: posts the ante 30
dulek_jason: posts small blind 60
jessecesar: posts big blind 120
*** HOLE CARDS ***
whaleptt: folds 
Go4ElvIS: raises 132 to 252
mennck: folds 
$aymon9: raises 468 to 720
dulek_jason: folds 
jessecesar: folds 
Go4ElvIS: raises 4806 to 5526 and is all-in
$aymon9: folds 
Uncalled bet (4806) returned to Go4ElvIS
Go4ElvIS collected 1800 from pot
Go4ElvIS: doesn't show hand 
*** SUMMARY ***
Total pot 1800 | Rake 0 
Seat 1: dulek_jason (small blind) folded before Flop
Seat 2: jessecesar (big blind) folded before Flop
Seat 3: whaleptt folded before Flop (didn't bet)
Seat 4: Go4ElvIS collected (1800)
Seat 5: mennck folded before Flop (didn't bet)
Seat 6: $aymon9 (button) folded before Flop

PokerStars Hand #251209281404: Tournament #3769361908, $52.38+$2.62 USD Hold'em No Limit - Level V (60/120) - 2024/06/26 22:16:26 UTC [2024/06/26 18:16:26 ET]
Table '3769361908 14' 6-max Seat #1 is the button
Seat 1: dulek_jason (11002 in chips) 
Seat 2: jessecesar (8015 in chips) 
Seat 3: whaleptt (6096 in chips) 
Seat 4: Go4ElvIS (6606 in chips) 
Seat 5: mennck (6109 in chips) 
Seat 6: $aymon9 (16348 in chips) 
dulek_jason: posts the ante 30
jessecesar: posts the ante 30
whaleptt: posts the ante 30
Go4ElvIS: posts the ante 30
mennck: posts the ante 30
$aymon9: posts the ante 30
jessecesar: posts small blind 60
whaleptt: posts big blind 120
*** HOLE CARDS ***
Go4ElvIS: folds 
mennck: raises 156 to 276
$aymon9: folds 
dulek_jason: folds 
jessecesar: folds 
whaleptt: calls 156
*** FLOP *** [Td 8h 9c]
whaleptt: checks 
mennck: checks 
*** TURN *** [Td 8h 9c] [2c]
whaleptt: checks 
mennck: checks 
*** RIVER *** [Td 8h 9c 2c] [2d]
whaleptt: checks 
mennck: bets 436
whaleptt: folds 
Uncalled bet (436) returned to mennck
mennck collected 792 from pot
mennck: doesn't show hand 
*** SUMMARY ***
Total pot 792 | Rake 0 
Board [Td 8h 9c 2c 2d]
Seat 1: dulek_jason (button) folded before Flop (didn't bet)
Seat 2: jessecesar (small blind) folded before Flop
Seat 3: whaleptt (big blind) folded on the River
Seat 4: Go4ElvIS folded before Flop (didn't bet)
Seat 5: mennck collected (792)
Seat 6: $aymon9 folded before Flop (didn't bet)

PokerStars Hand #251209296699: Tournament #3769361908, $52.38+$2.62 USD Hold'em No Limit - Level VI (80/160) - 2024/06/26 22:17:21 UTC [2024/06/26 18:17:21 ET]
Table '3769361908 14' 6-max Seat #2 is the button
Seat 1: dulek_jason (10972 in chips) 
Seat 2: jessecesar (7925 in chips) 
Seat 3: whaleptt (5790 in chips) 
Seat 4: Go4ElvIS (6576 in chips) 
Seat 5: mennck (6595 in chips) 
Seat 6: $aymon9 (16318 in chips) 
dulek_jason: posts the ante 40
jessecesar: posts the ante 40
whaleptt: posts the ante 40
Go4ElvIS: posts the ante 40
mennck: posts the ante 40
$aymon9: posts the ante 40
whaleptt: posts small blind 80
Go4ElvIS: posts big blind 160
*** HOLE CARDS ***
mennck: folds 
$aymon9: folds 
dulek_jason: folds 
jessecesar: raises 160 to 320
whaleptt: folds 
Go4ElvIS: folds 
Uncalled bet (160) returned to jessecesar
jessecesar collected 640 from pot
jessecesar: doesn't show hand 
*** SUMMARY ***
Total pot 640 | Rake 0 
Seat 1: dulek_jason folded before Flop (didn't bet)
Seat 2: jessecesar (button) collected (640)
Seat 3: whaleptt (small blind) folded before Flop
Seat 4: Go4ElvIS (big blind) folded before Flop
Seat 5: mennck folded before Flop (didn't bet)
Seat 6: $aymon9 folded before Flop (didn't bet)

PokerStars Hand #251209302238: Tournament #3769361908, $52.38+$2.62 USD Hold'em No Limit - Level VI (80/160) - 2024/06/26 22:17:40 UTC [2024/06/26 18:17:40 ET]
Table '3769361908 14' 6-max Seat #3 is the button
Seat 1: dulek_jason (10932 in chips) 
Seat 2: jessecesar (8365 in chips) 
Seat 3: whaleptt (5670 in chips) 
Seat 4: Go4ElvIS (6376 in chips) 
Seat 5: mennck (6555 in chips) 
Seat 6: $aymon9 (16278 in chips) 
dulek_jason: posts the ante 40
jessecesar: posts the ante 40
whaleptt: posts the ante 40
Go4ElvIS: posts the ante 40
mennck: posts the ante 40
$aymon9: posts the ante 40
Go4ElvIS: posts small blind 80
mennck: posts big blind 160
*** HOLE CARDS ***
$aymon9: folds 
dulek_jason: raises 182 to 342
jessecesar: raises 698 to 1040
whaleptt: folds 
Go4ElvIS: folds 
mennck: folds 
dulek_jason: calls 698
*** FLOP *** [4c 7s 2c]
dulek_jason: checks 
jessecesar: bets 844
dulek_jason: raises 1402 to 2246
jessecesar: raises 5039 to 7285 and is all-in
dulek_jason: calls 5039
*** TURN *** [4c 7s 2c] [Ts]
*** RIVER *** [4c 7s 2c Ts] [6h]
*** SHOW DOWN ***
dulek_jason: shows [9c 9d] (a pair of Nines)
jessecesar: shows [Th Td] (three of a kind, Tens)
jessecesar collected 17130 from pot
*** SUMMARY ***
Total pot 17130 | Rake 0 
Board [4c 7s 2c Ts 6h]
Seat 1: dulek_jason showed [9c 9d] and lost with a pair of Nines
Seat 2: jessecesar showed [Th Td] and won (17130) with three of a kind, Tens
Seat 3: whaleptt (button) folded before Flop (didn't bet)
Seat 4: Go4ElvIS (small blind) folded before Flop
Seat 5: mennck (big blind) folded before Flop
Seat 6: $aymon9 folded before Flop (didn't bet)

PokerStars Hand #251209321426: Tournament #3769361908, $52.38+$2.62 USD Hold'em No Limit - Level VI (80/160) - 2024/06/26 22:18:48 UTC [2024/06/26 18:18:48 ET]
Table '3769361908 14' 6-max Seat #4 is the button
Seat 1: dulek_jason (2567 in chips) 
Seat 2: jessecesar (17130 in chips) 
Seat 3: whaleptt (5630 in chips) 
Seat 4: Go4ElvIS (6256 in chips) 
Seat 5: mennck (6355 in chips) 
Seat 6: $aymon9 (16238 in chips) 
dulek_jason: posts the ante 40
jessecesar: posts the ante 40
whaleptt: posts the ante 40
Go4ElvIS: posts the ante 40
mennck: posts the ante 40
$aymon9: posts the ante 40
mennck: posts small blind 80
$aymon9: posts big blind 160
*** HOLE CARDS ***
dulek_jason: raises 160 to 320
jessecesar: raises 480 to 800
whaleptt: folds 
Go4ElvIS: folds 
mennck: folds 
$aymon9: folds 
dulek_jason: folds 
Uncalled bet (480) returned to jessecesar
jessecesar collected 1120 from pot
jessecesar: doesn't show hand 
*** SUMMARY ***
Total pot 1120 | Rake 0 
Seat 1: dulek_jason folded before Flop
Seat 2: jessecesar collected (1120)
Seat 3: whaleptt folded before Flop (didn't bet)
Seat 4: Go4ElvIS (button) folded before Flop (didn't bet)
Seat 5: mennck (small blind) folded before Flop
Seat 6: $aymon9 (big blind) folded before Flop

PokerStars Hand #251209330082: Tournament #3769361908, $52.38+$2.62 USD Hold'em No Limit - Level VI (80/160) - 2024/06/26 22:19:20 UTC [2024/06/26 18:19:20 ET]
Table '3769361908 14' 6-max Seat #5 is the button
Seat 1: dulek_jason (2207 in chips) 
Seat 2: jessecesar (17890 in chips) 
Seat 3: whaleptt (5590 in chips) 
Seat 4: Go4ElvIS (6216 in chips) 
Seat 5: mennck (6235 in chips) 
Seat 6: $aymon9 (16038 in chips) 
dulek_jason: posts the ante 40
jessecesar: posts the ante 40
whaleptt: posts the ante 40
Go4ElvIS: posts the ante 40
mennck: posts the ante 40
$aymon9: posts the ante 40
$aymon9: posts small blind 80
dulek_jason: posts big blind 160
*** HOLE CARDS ***
jessecesar: folds 
whaleptt: folds 
Go4ElvIS: folds 
mennck: folds 
$aymon9: raises 15838 to 15998 and is all-in
dulek_jason: calls 2007 and is all-in
Uncalled bet (13831) returned to $aymon9
*** FLOP *** [7h 5d Qc]
*** TURN *** [7h 5d Qc] [Kc]
*** RIVER *** [7h 5d Qc Kc] [7s]
*** SHOW DOWN ***
$aymon9: shows [Th 9d] (a pair of Sevens)
dulek_jason: shows [Ks 6s] (two pair, Kings and Sevens)
dulek_jason collected 4574 from pot
*** SUMMARY ***
Total pot 4574 | Rake 0 
Board [7h 5d Qc Kc 7s]
Seat 1: dulek_jason (big blind) showed [Ks 6s] and won (4574) with two pair, Kings and Sevens
Seat 2: jessecesar folded before Flop (didn't bet)
Seat 3: whaleptt folded before Flop (didn't bet)
Seat 4: Go4ElvIS folded before Flop (didn't bet)
Seat 5: mennck (button) folded before Flop (didn't bet)
Seat 6: $aymon9 (small blind) showed [Th 9d] and lost with a pair of Sevens

PokerStars Hand #251209337605: Tournament #3769361908, $52.38+$2.62 USD Hold'em No Limit - Level VI (80/160) - 2024/06/26 22:19:46 UTC [2024/06/26 18:19:46 ET]
Table '3769361908 14' 6-max Seat #6 is the button
Seat 1: dulek_jason (4574 in chips) 
Seat 2: jessecesar (17850 in chips) 
Seat 3: whaleptt (5550 in chips) 
Seat 4: Go4ElvIS (6176 in chips) 
Seat 5: mennck (6195 in chips) 
Seat 6: $aymon9 (13831 in chips) 
dulek_jason: posts the ante 40
jessecesar: posts the ante 40
whaleptt: posts the ante 40
Go4ElvIS: posts the ante 40
mennck: posts the ante 40
$aymon9: posts the ante 40
dulek_jason: posts small blind 80
jessecesar: posts big blind 160
*** HOLE CARDS ***
whaleptt: folds 
Go4ElvIS: folds 
mennck: folds 
$aymon9: folds 
dulek_jason: calls 80
jessecesar: checks 
*** FLOP *** [3s Ks Ad]
dulek_jason: bets 160
jessecesar: folds 
Uncalled bet (160) returned to dulek_jason
dulek_jason collected 560 from pot
dulek_jason: doesn't show hand 
*** SUMMARY ***
Total pot 560 | Rake 0 
Board [3s Ks Ad]
Seat 1: dulek_jason (small blind) collected (560)
Seat 2: jessecesar (big blind) folded on the Flop
Seat 3: whaleptt folded before Flop (didn't bet)
Seat 4: Go4ElvIS folded before Flop (didn't bet)
Seat 5: mennck folded before Flop (didn't bet)
Seat 6: $aymon9 (button) folded before Flop (didn't bet)

PokerStars Hand #251209350481: Tournament #3769361908, $52.38+$2.62 USD Hold'em No Limit - Level VII (100/200) - 2024/06/26 22:20:33 UTC [2024/06/26 18:20:33 ET]
Table '3769361908 14' 6-max Seat #1 is the button
Seat 1: dulek_jason (4934 in chips) 
Seat 2: jessecesar (17650 in chips) 
Seat 3: whaleptt (5510 in chips) 
Seat 4: Go4ElvIS (6136 in chips) 
Seat 5: mennck (6155 in chips) 
Seat 6: $aymon9 (13791 in chips) 
dulek_jason: posts the ante 50
jessecesar: posts the ante 50
whaleptt: posts the ante 50
Go4ElvIS: posts the ante 50
mennck: posts the ante 50
$aymon9: posts the ante 50
jessecesar: posts small blind 100
whaleptt: posts big blind 200
*** HOLE CARDS ***
Go4ElvIS: folds 
mennck: folds 
$aymon9: raises 200 to 400
dulek_jason: folds 
jessecesar: folds 
whaleptt: calls 200
*** FLOP *** [5s 9s 3c]
whaleptt: checks 
$aymon9: bets 396
whaleptt: calls 396
*** TURN *** [5s 9s 3c] [2h]
whaleptt: checks 
$aymon9: checks 
*** RIVER *** [5s 9s 3c 2h] [2c]
whaleptt: bets 657
$aymon9: folds 
Uncalled bet (657) returned to whaleptt
whaleptt collected 1992 from pot
whaleptt: doesn't show hand 
*** SUMMARY ***
Total pot 1992 | Rake 0 
Board [5s 9s 3c 2h 2c]
Seat 1: dulek_jason (button) folded before Flop (didn't bet)
Seat 2: jessecesar (small blind) folded before Flop
Seat 3: whaleptt (big blind) collected (1992)
Seat 4: Go4ElvIS folded before Flop (didn't bet)
Seat 5: mennck folded before Flop (didn't bet)
Seat 6: $aymon9 folded on the River

PokerStars Hand #251209371267: Tournament #3769361908, $52.38+$2.62 USD Hold'em No Limit - Level VII (100/200) - 2024/06/26 22:21:47 UTC [2024/06/26 18:21:47 ET]
Table '3769361908 14' 6-max Seat #2 is the button
Seat 1: dulek_jason (4884 in chips) 
Seat 2: jessecesar (17500 in chips) 
Seat 3: whaleptt (6656 in chips) 
Seat 4: Go4ElvIS (6086 in chips) 
Seat 5: mennck (6105 in chips) 
Seat 6: $aymon9 (12945 in chips) 
dulek_jason: posts the ante 50
jessecesar: posts the ante 50
whaleptt: posts the ante 50
Go4ElvIS: posts the ante 50
mennck: posts the ante 50
$aymon9: posts the ante 50
whaleptt: posts small blind 100
Go4ElvIS: posts big blind 200
*** HOLE CARDS ***
mennck: folds 
$aymon9: folds 
dulek_jason: raises 200 to 400
jessecesar: folds 
whaleptt: folds 
Go4ElvIS: folds 
Uncalled bet (200) returned to dulek_jason
dulek_jason collected 800 from pot
dulek_jason: doesn't show hand 
*** SUMMARY ***
Total pot 800 | Rake 0 
Seat 1: dulek_jason collected (800)
Seat 2: jessecesar (button) folded before Flop (didn't bet)
Seat 3: whaleptt (small blind) folded before Flop
Seat 4: Go4ElvIS (big blind) folded before Flop
Seat 5: mennck folded before Flop (didn't bet)
Seat 6: $aymon9 folded before Flop (didn't bet)

PokerStars Hand #251209377245: Tournament #3769361908, $52.38+$2.62 USD Hold'em No Limit - Level VII (100/200) - 2024/06/26 22:22:08 UTC [2024/06/26 18:22:08 ET]
Table '3769361908 14' 6-max Seat #3 is the button
Seat 1: dulek_jason (5434 in chips) 
Seat 2: jessecesar (17450 in chips) 
Seat 3: whaleptt (6506 in chips) 
Seat 4: Go4ElvIS (5836 in chips) 
Seat 5: mennck (6055 in chips) 
Seat 6: $aymon9 (12895 in chips) 
dulek_jason: posts the ante 50
jessecesar: posts the ante 50
whaleptt: posts the ante 50
Go4ElvIS: posts the ante 50
mennck: posts the ante 50
$aymon9: posts the ante 50
Go4ElvIS: posts small blind 100
mennck: posts big blind 200
*** HOLE CARDS ***
$aymon9: folds 
dulek_jason: folds 
jessecesar: folds 
whaleptt: raises 200 to 400
Go4ElvIS: calls 300
mennck: calls 200
*** FLOP *** [Ad 4d Ts]
Go4ElvIS: checks 
mennck: checks 
whaleptt: checks 
*** TURN *** [Ad 4d Ts] [8h]
Go4ElvIS: bets 1000
mennck: folds 
whaleptt: folds 
Uncalled bet (1000) returned to Go4ElvIS
Go4ElvIS collected 1500 from pot
Go4ElvIS: doesn't show hand 
*** SUMMARY ***
Total pot 1500 | Rake 0 
Board [Ad 4d Ts 8h]
Seat 1: dulek_jason folded before Flop (didn't bet)
Seat 2: jessecesar folded before Flop (didn't bet)
Seat 3: whaleptt (button) folded on the Turn
Seat 4: Go4ElvIS (small blind) collected (1500)
Seat 5: mennck (big blind) folded on the Turn
Seat 6: $aymon9 folded before Flop (didn't bet)

PokerStars Hand #251209391219: Tournament #3769361908, $52.38+$2.62 USD Hold'em No Limit - Level VII (100/200) - 2024/06/26 22:22:58 UTC [2024/06/26 18:22:58 ET]
Table '3769361908 14' 6-max Seat #4 is the button
Seat 1: dulek_jason (5384 in chips) 
Seat 2: jessecesar (17400 in chips) 
Seat 3: whaleptt (6056 in chips) 
Seat 4: Go4ElvIS (6886 in chips) 
Seat 5: mennck (5605 in chips) 
Seat 6: $aymon9 (12845 in chips) 
dulek_jason: posts the ante 50
jessecesar: posts the ante 50
whaleptt: posts the ante 50
Go4ElvIS: posts the ante 50
mennck: posts the ante 50
$aymon9: posts the ante 50
mennck: posts small blind 100
$aymon9: posts big blind 200
*** HOLE CARDS ***
dulek_jason: folds 
jessecesar: folds 
whaleptt: raises 200 to 400
Go4ElvIS: folds 
mennck: folds 
$aymon9: calls 200
*** FLOP *** [Kh 9s 9c]
$aymon9: checks 
whaleptt: bets 300
$aymon9: calls 300
*** TURN *** [Kh 9s 9c] [5s]
$aymon9: checks 
whaleptt: checks 
*** RIVER *** [Kh 9s 9c 5s] [9h]
$aymon9: bets 1200
whaleptt: calls 1200
*** SHOW DOWN ***
$aymon9: shows [Td Jd] (three of a kind, Nines)
whaleptt: shows [8c Ad] (three of a kind, Nines - Ace kicker)
whaleptt collected 4200 from pot
*** SUMMARY ***
Total pot 4200 | Rake 0 
Board [Kh 9s 9c 5s 9h]
Seat 1: dulek_jason folded before Flop (didn't bet)
Seat 2: jessecesar folded before Flop (didn't bet)
Seat 3: whaleptt showed [8c Ad] and won (4200) with three of a kind, Nines
Seat 4: Go4ElvIS (button) folded before Flop (didn't bet)
Seat 5: mennck (small blind) folded before Flop
Seat 6: $aymon9 (big blind) showed [Td Jd] and lost with three of a kind, Nines

PokerStars Hand #251209420638: Tournament #3769361908, $52.38+$2.62 USD Hold'em No Limit - Level VIII (125/250) - 2024/06/26 22:24:45 UTC [2024/06/26 18:24:45 ET]
Table '3769361908 14' 6-max Seat #5 is the button
Seat 1: dulek_jason (5334 in chips) 
Seat 2: jessecesar (17350 in chips) 
Seat 3: whaleptt (8306 in chips) 
Seat 4: Go4ElvIS (6836 in chips) 
Seat 5: mennck (5455 in chips) 
Seat 6: $aymon9 (10895 in chips) 
dulek_jason: posts the ante 60
jessecesar: posts the ante 60
whaleptt: posts the ante 60
Go4ElvIS: posts the ante 60
mennck: posts the ante 60
$aymon9: posts the ante 60
$aymon9: posts small blind 125
dulek_jason: posts big blind 250
*** HOLE CARDS ***
jessecesar: raises 250 to 500
whaleptt: folds 
Go4ElvIS: folds 
mennck: folds 
$aymon9: folds 
dulek_jason: folds 
Uncalled bet (250) returned to jessecesar
jessecesar collected 985 from pot
jessecesar: doesn't show hand 
*** SUMMARY ***
Total pot 985 | Rake 0 
Seat 1: dulek_jason (big blind) folded before Flop
Seat 2: jessecesar collected (985)
Seat 3: whaleptt folded before Flop (didn't bet)
Seat 4: Go4ElvIS folded before Flop (didn't bet)
Seat 5: mennck (button) folded before Flop (didn't bet)
Seat 6: $aymon9 (small blind) folded before Flop

PokerStars Hand #251209428525: Tournament #3769361908, $52.38+$2.62 USD Hold'em No Limit - Level VIII (125/250) - 2024/06/26 22:25:13 UTC [2024/06/26 18:25:13 ET]
Table '3769361908 14' 6-max Seat #6 is the button
Seat 1: dulek_jason (5024 in chips) 
Seat 2: jessecesar (18025 in chips) 
Seat 3: whaleptt (8246 in chips) 
Seat 4: Go4ElvIS (6776 in chips) 
Seat 5: mennck (5395 in chips) 
Seat 6: $aymon9 (10710 in chips) 
dulek_jason: posts the ante 60
jessecesar: posts the ante 60
whaleptt: posts the ante 60
Go4ElvIS: posts the ante 60
mennck: posts the ante 60
$aymon9: posts the ante 60
dulek_jason: posts small blind 125
jessecesar: posts big blind 250
*** HOLE CARDS ***
whaleptt: raises 250 to 500
Go4ElvIS: raises 6216 to 6716 and is all-in
mennck: folds 
$aymon9: folds 
dulek_jason: folds 
jessecesar: folds 
whaleptt: folds 
Uncalled bet (6216) returned to Go4ElvIS
Go4ElvIS collected 1735 from pot
Go4ElvIS: doesn't show hand 
*** SUMMARY ***
Total pot 1735 | Rake 0 
Seat 1: dulek_jason (small blind) folded before Flop
Seat 2: jessecesar (big blind) folded before Flop
Seat 3: whaleptt folded before Flop
Seat 4: Go4ElvIS collected (1735)
Seat 5: mennck folded before Flop (didn't bet)
Seat 6: $aymon9 (button) folded before Flop (didn't bet)

PokerStars Hand #251209437100: Tournament #3769361908, $52.38+$2.62 USD Hold'em No Limit - Level VIII (125/250) - 2024/06/26 22:25:44 UTC [2024/06/26 18:25:44 ET]
Table '3769361908 14' 6-max Seat #1 is the button
Seat 1: dulek_jason (4839 in chips) 
Seat 2: jessecesar (17715 in chips) 
Seat 3: whaleptt (7686 in chips) 
Seat 4: Go4ElvIS (7951 in chips) 
Seat 5: mennck (5335 in chips) 
Seat 6: $aymon9 (10650 in chips) 
dulek_jason: posts the ante 60
jessecesar: posts the ante 60
whaleptt: posts the ante 60
Go4ElvIS: posts the ante 60
mennck: posts the ante 60
$aymon9: posts the ante 60
jessecesar: posts small blind 125
whaleptt: posts big blind 250
*** HOLE CARDS ***
Go4ElvIS: folds 
mennck: folds 
$aymon9: raises 250 to 500
dulek_jason: raises 750 to 1250
jessecesar: folds 
whaleptt: folds 
$aymon9: raises 9340 to 10590 and is all-in
dulek_jason: calls 3529 and is all-in
Uncalled bet (5811) returned to $aymon9
*** FLOP *** [Qd 6d 8c]
*** TURN *** [Qd 6d 8c] [Td]
*** RIVER *** [Qd 6d 8c Td] [3s]
*** SHOW DOWN ***
$aymon9: shows [2d 2h] (a pair of Deuces)
dulek_jason: shows [Jh Jc] (a pair of Jacks)
dulek_jason collected 10293 from pot
*** SUMMARY ***
Total pot 10293 | Rake 0 
Board [Qd 6d 8c Td 3s]
Seat 1: dulek_jason (button) showed [Jh Jc] and won (10293) with a pair of Jacks
Seat 2: jessecesar (small blind) folded before Flop
Seat 3: whaleptt (big blind) folded before Flop
Seat 4: Go4ElvIS folded before Flop (didn't bet)
Seat 5: mennck folded before Flop (didn't bet)
Seat 6: $aymon9 showed [2d 2h] and lost with a pair of Deuces

PokerStars Hand #251209449480: Tournament #3769361908, $52.38+$2.62 USD Hold'em No Limit - Level IX (150/300) - 2024/06/26 22:26:29 UTC [2024/06/26 18:26:29 ET]
Table '3769361908 14' 6-max Seat #2 is the button
Seat 1: dulek_jason (10293 in chips) 
Seat 2: jessecesar (17530 in chips) 
Seat 3: whaleptt (7376 in chips) 
Seat 4: Go4ElvIS (7891 in chips) 
Seat 5: mennck (5275 in chips) 
Seat 6: $aymon9 (5811 in chips) 
dulek_jason: posts the ante 75
jessecesar: posts the ante 75
whaleptt: posts the ante 75
Go4ElvIS: posts the ante 75
mennck: posts the ante 75
$aymon9: posts the ante 75
whaleptt: posts small blind 150
Go4ElvIS: posts big blind 300
*** HOLE CARDS ***
mennck: folds 
$aymon9: folds 
dulek_jason: raises 300 to 600
jessecesar: raises 1200 to 1800
whaleptt: raises 5501 to 7301 and is all-in
Go4ElvIS: folds 
dulek_jason: folds 
jessecesar: folds 
Uncalled bet (5501) returned to whaleptt
whaleptt collected 4950 from pot
whaleptt: doesn't show hand 
*** SUMMARY ***
Total pot 4950 | Rake 0 
Seat 1: dulek_jason folded before Flop
Seat 2: jessecesar (button) folded before Flop
Seat 3: whaleptt (small blind) collected (4950)
Seat 4: Go4ElvIS (big blind) folded before Flop
Seat 5: mennck folded before Flop (didn't bet)
Seat 6: $aymon9 folded before Flop (didn't bet)

PokerStars Hand #251209461010: Tournament #3769361908, $52.38+$2.62 USD Hold'em No Limit - Level IX (150/300) - 2024/06/26 22:27:10 UTC [2024/06/26 18:27:10 ET]
Table '3769361908 14' 6-max Seat #3 is the button
Seat 1: dulek_jason (9618 in chips) 
Seat 2: jessecesar (15655 in chips) 
Seat 3: whaleptt (10451 in chips) 
Seat 4: Go4ElvIS (7516 in chips) 
Seat 5: mennck (5200 in chips) 
Seat 6: $aymon9 (5736 in chips) 
dulek_jason: posts the ante 75
jessecesar: posts the ante 75
whaleptt: posts the ante 75
Go4ElvIS: posts the ante 75
mennck: posts the ante 75
$aymon9: posts the ante 75
Go4ElvIS: posts small blind 150
mennck: posts big blind 300
*** HOLE CARDS ***
$aymon9: folds 
dulek_jason: folds 
jessecesar: folds 
whaleptt: raises 300 to 600
Go4ElvIS: raises 6841 to 7441 and is all-in
mennck: folds 
whaleptt: folds 
Uncalled bet (6841) returned to Go4ElvIS
Go4ElvIS collected 1950 from pot
Go4ElvIS: doesn't show hand 
*** SUMMARY ***
Total pot 1950 | Rake 0 
Seat 1: dulek_jason folded before Flop (didn't bet)
Seat 2: jessecesar folded before Flop (didn't bet)
Seat 3: whaleptt (button) folded before Flop
Seat 4: Go4ElvIS (small blind) collected (1950)
Seat 5: mennck (big blind) folded before Flop
Seat 6: $aymon9 folded before Flop (didn't bet)

PokerStars Hand #251209469081: Tournament #3769361908, $52.38+$2.62 USD Hold'em No Limit - Level IX (150/300) - 2024/06/26 22:27:39 UTC [2024/06/26 18:27:39 ET]
Table '3769361908 14' 6-max Seat #4 is the button
Seat 1: dulek_jason (9543 in chips) 
Seat 2: jessecesar (15580 in chips) 
Seat 3: whaleptt (9776 in chips) 
Seat 4: Go4ElvIS (8791 in chips) 
Seat 5: mennck (4825 in chips) 
Seat 6: $aymon9 (5661 in chips) 
dulek_jason: posts the ante 75
jessecesar: posts the ante 75
whaleptt: posts the ante 75
Go4ElvIS: posts the ante 75
mennck: posts the ante 75
$aymon9: posts the ante 75
mennck: posts small blind 150
$aymon9: posts big blind 300
*** HOLE CARDS ***
dulek_jason: raises 300 to 600
jessecesar: folds 
whaleptt: raises 900 to 1500
Go4ElvIS: folds 
mennck: folds 
$aymon9: folds 
dulek_jason: calls 900
*** FLOP *** [Ts Qh 6d]
dulek_jason: checks 
whaleptt: bets 1287
dulek_jason: calls 1287
*** TURN *** [Ts Qh 6d] [2c]
dulek_jason: checks 
whaleptt: bets 6914 and is all-in
dulek_jason: calls 6681 and is all-in
Uncalled bet (233) returned to whaleptt
*** RIVER *** [Ts Qh 6d 2c] [6c]
*** SHOW DOWN ***
dulek_jason: shows [Ad Ah] (two pair, Aces and Sixes)
whaleptt: shows [Jh Ac] (a pair of Sixes)
dulek_jason collected 19836 from pot
*** SUMMARY ***
Total pot 19836 | Rake 0 
Board [Ts Qh 6d 2c 6c]
Seat 1: dulek_jason showed [Ad Ah] and won (19836) with two pair, Aces and Sixes
Seat 2: jessecesar folded before Flop (didn't bet)
Seat 3: whaleptt showed [Jh Ac] and lost with a pair of Sixes
Seat 4: Go4ElvIS (button) folded before Flop (didn't bet)
Seat 5: mennck (small blind) folded before Flop
Seat 6: $aymon9 (big blind) folded before Flop

PokerStars Hand #251209484500: Tournament #3769361908, $52.38+$2.62 USD Hold'em No Limit - Level IX (150/300) - 2024/06/26 22:28:34 UTC [2024/06/26 18:28:34 ET]
Table '3769361908 14' 6-max Seat #5 is the button
Seat 1: dulek_jason (19836 in chips) 
Seat 2: jessecesar (15505 in chips) 
Seat 3: whaleptt (233 in chips) 
Seat 4: Go4ElvIS (8716 in chips) 
Seat 5: mennck (4600 in chips) 
Seat 6: $aymon9 (5286 in chips) 
dulek_jason: posts the ante 75
jessecesar: posts the ante 75
whaleptt: posts the ante 75
Go4ElvIS: posts the ante 75
mennck: posts the ante 75
$aymon9: posts the ante 75
$aymon9: posts small blind 150
dulek_jason: posts big blind 300
*** HOLE CARDS ***
jessecesar: folds 
whaleptt: calls 158 and is all-in
Go4ElvIS: folds 
mennck: folds 
$aymon9: folds 
Uncalled bet (142) returned to dulek_jason
*** FLOP *** [8c Qd 5h]
*** TURN *** [8c Qd 5h] [7s]
*** RIVER *** [8c Qd 5h 7s] [Ah]
*** SHOW DOWN ***
dulek_jason: shows [4s 2h] (high card Ace)
whaleptt: shows [Ad 5c] (two pair, Aces and Fives)
whaleptt collected 916 from pot
*** SUMMARY ***
Total pot 916 | Rake 0 
Board [8c Qd 5h 7s Ah]
Seat 1: dulek_jason (big blind) showed [4s 2h] and lost with high card Ace
Seat 2: jessecesar folded before Flop (didn't bet)
Seat 3: whaleptt showed [Ad 5c] and won (916) with two pair, Aces and Fives
Seat 4: Go4ElvIS folded before Flop (didn't bet)
Seat 5: mennck (button) folded before Flop (didn't bet)
Seat 6: $aymon9 (small blind) folded before Flop

PokerStars Hand #251209493269: Tournament #3769361908, $52.38+$2.62 USD Hold'em No Limit - Level IX (150/300) - 2024/06/26 22:29:06 UTC [2024/06/26 18:29:06 ET]
Table '3769361908 14' 6-max Seat #6 is the button
Seat 1: dulek_jason (19603 in chips) 
Seat 2: jessecesar (15430 in chips) 
Seat 3: whaleptt (916 in chips) 
Seat 4: Go4ElvIS (8641 in chips) 
Seat 5: mennck (4525 in chips) 
Seat 6: $aymon9 (5061 in chips) 
dulek_jason: posts the ante 75
jessecesar: posts the ante 75
whaleptt: posts the ante 75
Go4ElvIS: posts the ante 75
mennck: posts the ante 75
$aymon9: posts the ante 75
dulek_jason: posts small blind 150
jessecesar: posts big blind 300
*** HOLE CARDS ***
whaleptt: folds 
Go4ElvIS: raises 330 to 630
mennck: folds 
$aymon9: folds 
dulek_jason: folds 
jessecesar: calls 330
*** FLOP *** [Th 2c 9d]
jessecesar: checks 
Go4ElvIS: checks 
*** TURN *** [Th 2c 9d] [Qh]
jessecesar: checks 
Go4ElvIS: checks 
*** RIVER *** [Th 2c 9d Qh] [4d]
jessecesar: bets 615
Go4ElvIS: folds 
Uncalled bet (615) returned to jessecesar
jessecesar collected 1860 from pot
jessecesar: doesn't show hand 
*** SUMMARY ***
Total pot 1860 | Rake 0 
Board [Th 2c 9d Qh 4d]
Seat 1: dulek_jason (small blind) folded before Flop
Seat 2: jessecesar (big blind) collected (1860)
Seat 3: whaleptt folded before Flop (didn't bet)
Seat 4: Go4ElvIS folded on the River
Seat 5: mennck folded before Flop (didn't bet)
Seat 6: $aymon9 (button) folded before Flop (didn't bet)

PokerStars Hand #251209509711: Tournament #3769361908, $52.38+$2.62 USD Hold'em No Limit - Level X (200/400) - 2024/06/26 22:30:05 UTC [2024/06/26 18:30:05 ET]
Table '3769361908 14' 6-max Seat #1 is the button
Seat 1: dulek_jason (19378 in chips) 
Seat 2: jessecesar (16585 in chips) 
Seat 3: whaleptt (841 in chips) 
Seat 4: Go4ElvIS (7936 in chips) 
Seat 5: mennck (4450 in chips) 
Seat 6: $aymon9 (4986 in chips) 
dulek_jason: posts the ante 100
jessecesar: posts the ante 100
whaleptt: posts the ante 100
Go4ElvIS: posts the ante 100
mennck: posts the ante 100
$aymon9: posts the ante 100
jessecesar: posts small blind 200
whaleptt: posts big blind 400
*** HOLE CARDS ***
Go4ElvIS: folds 
mennck: raises 3950 to 4350 and is all-in
$aymon9: folds 
dulek_jason: folds 
jessecesar: folds 
whaleptt: calls 341 and is all-in
Uncalled bet (3609) returned to mennck
*** FLOP *** [2h 2s Kc]
*** TURN *** [2h 2s Kc] [Jd]
*** RIVER *** [2h 2s Kc Jd] [Js]
*** SHOW DOWN ***
whaleptt: shows [Jc 6s] (a full house, Jacks full of Deuces)
mennck: shows [Tc Td] (two pair, Jacks and Tens)
whaleptt collected 2282 from pot
*** SUMMARY ***
Total pot 2282 | Rake 0 
Board [2h 2s Kc Jd Js]
Seat 1: dulek_jason (button) folded before Flop (didn't bet)
Seat 2: jessecesar (small blind) folded before Flop
Seat 3: whaleptt (big blind) showed [Jc 6s] and won (2282) with a full house, Jacks full of Deuces
Seat 4: Go4ElvIS folded before Flop (didn't bet)
Seat 5: mennck showed [Tc Td] and lost with two pair, Jacks and Tens
Seat 6: $aymon9 folded before Flop (didn't bet)

PokerStars Hand #251209517112: Tournament #3769361908, $52.38+$2.62 USD Hold'em No Limit - Level X (200/400) - 2024/06/26 22:30:31 UTC [2024/06/26 18:30:31 ET]
Table '3769361908 14' 6-max Seat #2 is the button
Seat 1: dulek_jason (19278 in chips) 
Seat 2: jessecesar (16285 in chips) 
Seat 3: whaleptt (2282 in chips) 
Seat 4: Go4ElvIS (7836 in chips) 
Seat 5: mennck (3609 in chips) 
Seat 6: $aymon9 (4886 in chips) 
dulek_jason: posts the ante 100
jessecesar: posts the ante 100
whaleptt: posts the ante 100
Go4ElvIS: posts the ante 100
mennck: posts the ante 100
$aymon9: posts the ante 100
whaleptt: posts small blind 200
Go4ElvIS: posts big blind 400
*** HOLE CARDS ***
mennck: folds 
$aymon9: raises 400 to 800
dulek_jason: folds 
jessecesar: folds 
whaleptt: folds 
Go4ElvIS: folds 
Uncalled bet (400) returned to $aymon9
$aymon9 collected 1600 from pot
*** SUMMARY ***
Total pot 1600 | Rake 0 
Seat 1: dulek_jason folded before Flop (didn't bet)
Seat 2: jessecesar (button) folded before Flop (didn't bet)
Seat 3: whaleptt (small blind) folded before Flop
Seat 4: Go4ElvIS (big blind) folded before Flop
Seat 5: mennck folded before Flop (didn't bet)
Seat 6: $aymon9 collected (1600)

PokerStars Hand #251209524166: Tournament #3769361908, $52.38+$2.62 USD Hold'em No Limit - Level X (200/400) - 2024/06/26 22:30:57 UTC [2024/06/26 18:30:57 ET]
Table '3769361908 14' 6-max Seat #3 is the button
Seat 1: dulek_jason (19178 in chips) 
Seat 2: jessecesar (16185 in chips) 
Seat 3: whaleptt (1982 in chips) 
Seat 4: Go4ElvIS (7336 in chips) 
Seat 5: mennck (3509 in chips) 
Seat 6: $aymon9 (5986 in chips) 
dulek_jason: posts the ante 100
jessecesar: posts the ante 100
whaleptt: posts the ante 100
Go4ElvIS: posts the ante 100
mennck: posts the ante 100
$aymon9: posts the ante 100
Go4ElvIS: posts small blind 200
mennck: posts big blind 400
*** HOLE CARDS ***
$aymon9: folds 
dulek_jason: folds 
jessecesar: folds 
whaleptt: folds 
Go4ElvIS: folds 
Uncalled bet (200) returned to mennck
mennck collected 1000 from pot
mennck: doesn't show hand 
*** SUMMARY ***
Total pot 1000 | Rake 0 
Seat 1: dulek_jason folded before Flop (didn't bet)
Seat 2: jessecesar folded before Flop (didn't bet)
Seat 3: whaleptt (button) folded before Flop (didn't bet)
Seat 4: Go4ElvIS (small blind) folded before Flop
Seat 5: mennck (big blind) collected (1000)
Seat 6: $aymon9 folded before Flop (didn't bet)

PokerStars Hand #251209528970: Tournament #3769361908, $52.38+$2.62 USD Hold'em No Limit - Level X (200/400) - 2024/06/26 22:31:15 UTC [2024/06/26 18:31:15 ET]
Table '3769361908 14' 6-max Seat #4 is the button
Seat 1: dulek_jason (19078 in chips) 
Seat 2: jessecesar (16085 in chips) 
Seat 3: whaleptt (1882 in chips) 
Seat 4: Go4ElvIS (7036 in chips) 
Seat 5: mennck (4209 in chips) 
Seat 6: $aymon9 (5886 in chips) 
dulek_jason: posts the ante 100
jessecesar: posts the ante 100
whaleptt: posts the ante 100
Go4ElvIS: posts the ante 100
mennck: posts the ante 100
$aymon9: posts the ante 100
mennck: posts small blind 200
$aymon9: posts big blind 400
*** HOLE CARDS ***
dulek_jason: folds 
jessecesar: raises 400 to 800
whaleptt: folds 
Go4ElvIS: folds 
mennck: folds 
$aymon9: raises 4986 to 5786 and is all-in
jessecesar: folds 
Uncalled bet (4986) returned to $aymon9
$aymon9 collected 2400 from pot
*** SUMMARY ***
Total pot 2400 | Rake 0 
Seat 1: dulek_jason folded before Flop (didn't bet)
Seat 2: jessecesar folded before Flop
Seat 3: whaleptt folded before Flop (didn't bet)
Seat 4: Go4ElvIS (button) folded before Flop (didn't bet)
Seat 5: mennck (small blind) folded before Flop
Seat 6: $aymon9 (big blind) collected (2400)

PokerStars Hand #251209537528: Tournament #3769361908, $52.38+$2.62 USD Hold'em No Limit - Level X (200/400) - 2024/06/26 22:31:46 UTC [2024/06/26 18:31:46 ET]
Table '3769361908 14' 6-max Seat #5 is the button
Seat 1: dulek_jason (18978 in chips) 
Seat 2: jessecesar (15185 in chips) 
Seat 3: whaleptt (1782 in chips) 
Seat 4: Go4ElvIS (6936 in chips) 
Seat 5: mennck (3909 in chips) 
Seat 6: $aymon9 (7386 in chips) 
dulek_jason: posts the ante 100
jessecesar: posts the ante 100
whaleptt: posts the ante 100
Go4ElvIS: posts the ante 100
mennck: posts the ante 100
$aymon9: posts the ante 100
$aymon9: posts small blind 200
dulek_jason: posts big blind 400
*** HOLE CARDS ***
jessecesar: folds 
whaleptt: folds 
Go4ElvIS: folds 
mennck: folds 
$aymon9: calls 200
dulek_jason: checks 
*** FLOP *** [4d 8s Ah]
$aymon9: bets 400
dulek_jason: calls 400
*** TURN *** [4d 8s Ah] [5h]
$aymon9: checks 
dulek_jason: bets 1126
$aymon9: calls 1126
*** RIVER *** [4d 8s Ah 5h] [2h]
$aymon9: checks 
dulek_jason: bets 16952 and is all-in
$aymon9: folds 
Uncalled bet (16952) returned to dulek_jason
dulek_jason collected 4452 from pot
dulek_jason: doesn't show hand 
*** SUMMARY ***
Total pot 4452 | Rake 0 
Board [4d 8s Ah 5h 2h]
Seat 1: dulek_jason (big blind) collected (4452)
Seat 2: jessecesar folded before Flop (didn't bet)
Seat 3: whaleptt folded before Flop (didn't bet)
Seat 4: Go4ElvIS folded before Flop (didn't bet)
Seat 5: mennck (button) folded before Flop (didn't bet)
Seat 6: $aymon9 (small blind) folded on the River

PokerStars Hand #251209559353: Tournament #3769361908, $52.38+$2.62 USD Hold'em No Limit - Level XI (250/500) - 2024/06/26 22:33:06 UTC [2024/06/26 18:33:06 ET]
Table '3769361908 14' 6-max Seat #6 is the button
Seat 1: dulek_jason (21404 in chips) 
Seat 2: jessecesar (15085 in chips) 
Seat 3: whaleptt (1682 in chips) 
Seat 4: Go4ElvIS (6836 in chips) 
Seat 5: mennck (3809 in chips) 
Seat 6: $aymon9 (5360 in chips) 
dulek_jason: posts the ante 125
jessecesar: posts the ante 125
whaleptt: posts the ante 125
Go4ElvIS: posts the ante 125
mennck: posts the ante 125
$aymon9: posts the ante 125
dulek_jason: posts small blind 250
jessecesar: posts big blind 500
*** HOLE CARDS ***
whaleptt: folds 
Go4ElvIS: folds 
mennck: raises 3184 to 3684 and is all-in
$aymon9: folds 
dulek_jason: folds 
jessecesar: folds 
Uncalled bet (3184) returned to mennck
mennck collected 2000 from pot
mennck: doesn't show hand 
*** SUMMARY ***
Total pot 2000 | Rake 0 
Seat 1: dulek_jason (small blind) folded before Flop
Seat 2: jessecesar (big blind) folded before Flop
Seat 3: whaleptt folded before Flop (didn't bet)
Seat 4: Go4ElvIS folded before Flop (didn't bet)
Seat 5: mennck collected (2000)
Seat 6: $aymon9 (button) folded before Flop (didn't bet)

PokerStars Hand #251209564146: Tournament #3769361908, $52.38+$2.62 USD Hold'em No Limit - Level XI (250/500) - 2024/06/26 22:33:24 UTC [2024/06/26 18:33:24 ET]
Table '3769361908 14' 6-max Seat #1 is the button
Seat 1: dulek_jason (21029 in chips) 
Seat 2: jessecesar (14460 in chips) 
Seat 3: whaleptt (1557 in chips) 
Seat 4: Go4ElvIS (6711 in chips) 
Seat 5: mennck (5184 in chips) 
Seat 6: $aymon9 (5235 in chips) 
dulek_jason: posts the ante 125
jessecesar: posts the ante 125
whaleptt: posts the ante 125
Go4ElvIS: posts the ante 125
mennck: posts the ante 125
$aymon9: posts the ante 125
jessecesar: posts small blind 250
whaleptt: posts big blind 500
*** HOLE CARDS ***
Go4ElvIS: folds 
mennck: folds 
$aymon9: raises 4610 to 5110 and is all-in
dulek_jason: folds 
jessecesar: folds 
whaleptt: calls 932 and is all-in
Uncalled bet (3678) returned to $aymon9
*** FLOP *** [7d 2c Jh]
*** TURN *** [7d 2c Jh] [6h]
*** RIVER *** [7d 2c Jh 6h] [Kd]
*** SHOW DOWN ***
whaleptt: shows [3s Js] (a pair of Jacks)
$aymon9: shows [Jc Ad] (a pair of Jacks - Ace kicker)
$aymon9 collected 3864 from pot
whaleptt finished the tournament
*** SUMMARY ***
Total pot 3864 | Rake 0 
Board [7d 2c Jh 6h Kd]
Seat 1: dulek_jason (button) folded before Flop (didn't bet)
Seat 2: jessecesar (small blind) folded before Flop
Seat 3: whaleptt (big blind) showed [3s Js] and lost with a pair of Jacks
Seat 4: Go4ElvIS folded before Flop (didn't bet)
Seat 5: mennck folded before Flop (didn't bet)
Seat 6: $aymon9 showed [Jc Ad] and won (3864) with a pair of Jacks

PokerStars Hand #251209572575: Tournament #3769361908, $52.38+$2.62 USD Hold'em No Limit - Level XI (250/500) - 2024/06/26 22:33:55 UTC [2024/06/26 18:33:55 ET]
Table '3769361908 14' 6-max Seat #2 is the button
Seat 1: dulek_jason (20904 in chips) 
Seat 2: jessecesar (14085 in chips) 
Seat 4: Go4ElvIS (6586 in chips) 
Seat 5: mennck (5059 in chips) 
Seat 6: $aymon9 (7542 in chips) 
dulek_jason: posts the ante 125
jessecesar: posts the ante 125
Go4ElvIS: posts the ante 125
mennck: posts the ante 125
$aymon9: posts the ante 125
Go4ElvIS: posts small blind 250
mennck: posts big blind 500
*** HOLE CARDS ***
$aymon9: raises 500 to 1000
dulek_jason: folds 
jessecesar: folds 
Go4ElvIS: folds 
mennck: calls 500
*** FLOP *** [8h 3h 3s]
mennck: checks 
Gsmith13 is disconnected 
$aymon9: bets 750
mennck: raises 3184 to 3934 and is all-in
$aymon9: calls 3184
*** TURN *** [8h 3h 3s] [Kh]
*** RIVER *** [8h 3h 3s Kh] [Qc]
*** SHOW DOWN ***
mennck: shows [8d Qh] (two pair, Queens and Eights)
$aymon9: shows [Ad 9h] (a pair of Threes)
mennck collected 10743 from pot
*** SUMMARY ***
Total pot 10743 | Rake 0 
Board [8h 3h 3s Kh Qc]
Seat 1: dulek_jason folded before Flop (didn't bet)
Seat 2: jessecesar (button) folded before Flop (didn't bet)
Seat 4: Go4ElvIS (small blind) folded before Flop
Seat 5: mennck (big blind) showed [8d Qh] and won (10743) with two pair, Queens and Eights
Seat 6: $aymon9 showed [Ad 9h] and lost with a pair of Threes

PokerStars Hand #251209585945: Tournament #3769361908, $52.38+$2.62 USD Hold'em No Limit - Level XI (250/500) - 2024/06/26 22:34:45 UTC [2024/06/26 18:34:45 ET]
Table '3769361908 14' 6-max Seat #4 is the button
Seat 1: dulek_jason (20779 in chips) 
Seat 2: jessecesar (13960 in chips) 
Seat 3: Gsmith13 (10000 in chips) 
Seat 4: Go4ElvIS (6211 in chips) 
Seat 5: mennck (10743 in chips) 
Seat 6: $aymon9 (2483 in chips) 
dulek_jason: posts the ante 125
jessecesar: posts the ante 125
Gsmith13: posts the ante 125
Go4ElvIS: posts the ante 125
mennck: posts the ante 125
$aymon9: posts the ante 125
mennck: posts small blind 250
$aymon9: posts big blind 500
*** HOLE CARDS ***
dulek_jason: folds 
jessecesar: folds 
Gsmith13: folds 
Go4ElvIS: folds 
mennck: folds 
Uncalled bet (250) returned to $aymon9
$aymon9 collected 1250 from pot
*** SUMMARY ***
Total pot 1250 | Rake 0 
Seat 1: dulek_jason folded before Flop (didn't bet)
Seat 2: jessecesar folded before Flop (didn't bet)
Seat 3: Gsmith13 folded before Flop (didn't bet)
Seat 4: Go4ElvIS (button) folded before Flop (didn't bet)
Seat 5: mennck (small blind) folded before Flop
Seat 6: $aymon9 (big blind) collected (1250)

PokerStars Hand #251209590578: Tournament #3769361908, $52.38+$2.62 USD Hold'em No Limit - Level XI (250/500) - 2024/06/26 22:35:02 UTC [2024/06/26 18:35:02 ET]
Table '3769361908 14' 6-max Seat #5 is the button
Seat 1: dulek_jason (20654 in chips) 
Seat 2: jessecesar (13835 in chips) 
Seat 3: Gsmith13 (9875 in chips) 
Seat 4: Go4ElvIS (6086 in chips) 
Seat 5: mennck (10368 in chips) 
Seat 6: $aymon9 (3358 in chips) 
dulek_jason: posts the ante 125
jessecesar: posts the ante 125
Gsmith13: posts the ante 125
Go4ElvIS: posts the ante 125
mennck: posts the ante 125
$aymon9: posts the ante 125
$aymon9: posts small blind 250
dulek_jason: posts big blind 500
*** HOLE CARDS ***
jessecesar: folds 
Gsmith13: folds 
Go4ElvIS: folds 
mennck: folds 
$aymon9: raises 2733 to 3233 and is all-in
dulek_jason: calls 2733
*** FLOP *** [5d 5s Kd]
*** TURN *** [5d 5s Kd] [8h]
*** RIVER *** [5d 5s Kd 8h] [4s]
*** SHOW DOWN ***
$aymon9: shows [Th Td] (two pair, Tens and Fives)
dulek_jason: shows [2s Ac] (a pair of Fives)
$aymon9 collected 7216 from pot
*** SUMMARY ***
Total pot 7216 | Rake 0 
Board [5d 5s Kd 8h 4s]
Seat 1: dulek_jason (big blind) showed [2s Ac] and lost with a pair of Fives
Seat 2: jessecesar folded before Flop (didn't bet)
Seat 3: Gsmith13 folded before Flop (didn't bet)
Seat 4: Go4ElvIS folded before Flop (didn't bet)
Seat 5: mennck (button) folded before Flop (didn't bet)
Seat 6: $aymon9 (small blind) showed [Th Td] and won (7216) with two pair, Tens and Fives

PokerStars Hand #251209599285: Tournament #3769361908, $52.38+$2.62 USD Hold'em No Limit - Level XII (300/600) - 2024/06/26 22:35:34 UTC [2024/06/26 18:35:34 ET]
Table '3769361908 14' 6-max Seat #6 is the button
Seat 1: dulek_jason (17296 in chips) 
Seat 2: jessecesar (13710 in chips) 
Seat 3: Gsmith13 (9750 in chips) 
Seat 4: Go4ElvIS (5961 in chips) 
Seat 5: mennck (10243 in chips) 
Seat 6: $aymon9 (7216 in chips) 
dulek_jason: posts the ante 150
jessecesar: posts the ante 150
Gsmith13: posts the ante 150
Go4ElvIS: posts the ante 150
mennck: posts the ante 150
$aymon9: posts the ante 150
dulek_jason: posts small blind 300
jessecesar: posts big blind 600
*** HOLE CARDS ***
Gsmith13: folds 
Go4ElvIS: folds 
mennck: folds 
$aymon9: folds 
dulek_jason: calls 300
jessecesar: checks 
*** FLOP *** [5s Ts Qd]
dulek_jason: checks 
jessecesar: checks 
*** TURN *** [5s Ts Qd] [Jc]
dulek_jason: checks 
jessecesar: checks 
*** RIVER *** [5s Ts Qd Jc] [7c]
dulek_jason: bets 1554
jessecesar: folds 
Uncalled bet (1554) returned to dulek_jason
dulek_jason collected 2100 from pot
dulek_jason: doesn't show hand 
*** SUMMARY ***
Total pot 2100 | Rake 0 
Board [5s Ts Qd Jc 7c]
Seat 1: dulek_jason (small blind) collected (2100)
Seat 2: jessecesar (big blind) folded on the River
Seat 3: Gsmith13 folded before Flop (didn't bet)
Seat 4: Go4ElvIS folded before Flop (didn't bet)
Seat 5: mennck folded before Flop (didn't bet)
Seat 6: $aymon9 (button) folded before Flop (didn't bet)

PokerStars Hand #251209611919: Tournament #3769361908, $52.38+$2.62 USD Hold'em No Limit - Level XII (300/600) - 2024/06/26 22:36:21 UTC [2024/06/26 18:36:21 ET]
Table '3769361908 14' 6-max Seat #1 is the button
Seat 1: dulek_jason (18646 in chips) 
Seat 2: jessecesar (12960 in chips) 
Seat 3: Gsmith13 (9600 in chips) 
Seat 4: Go4ElvIS (5811 in chips) 
Seat 5: mennck (10093 in chips) 
Seat 6: $aymon9 (7066 in chips) 
dulek_jason: posts the ante 150
jessecesar: posts the ante 150
Gsmith13: posts the ante 150
Go4ElvIS: posts the ante 150
mennck: posts the ante 150
$aymon9: posts the ante 150
jessecesar: posts small blind 300
Gsmith13: posts big blind 600
*** HOLE CARDS ***
Go4ElvIS: raises 660 to 1260
mennck: folds 
$aymon9: folds 
dulek_jason: folds 
jessecesar: folds 
Gsmith13: folds 
Uncalled bet (660) returned to Go4ElvIS
Go4ElvIS collected 2400 from pot
Go4ElvIS: doesn't show hand 
*** SUMMARY ***
Total pot 2400 | Rake 0 
Seat 1: dulek_jason (button) folded before Flop (didn't bet)
Seat 2: jessecesar (small blind) folded before Flop
Seat 3: Gsmith13 (big blind) folded before Flop
Seat 4: Go4ElvIS collected (2400)
Seat 5: mennck folded before Flop (didn't bet)
Seat 6: $aymon9 folded before Flop (didn't bet)

PokerStars Hand #251209616977: Tournament #3769361908, $52.38+$2.62 USD Hold'em No Limit - Level XII (300/600) - 2024/06/26 22:36:40 UTC [2024/06/26 18:36:40 ET]
Table '3769361908 14' 6-max Seat #2 is the button
Seat 1: dulek_jason (18496 in chips) 
Seat 2: jessecesar (12510 in chips) 
Seat 3: Gsmith13 (8850 in chips) 
Seat 4: Go4ElvIS (7461 in chips) 
Seat 5: mennck (9943 in chips) 
Seat 6: $aymon9 (6916 in chips) 
dulek_jason: posts the ante 150
jessecesar: posts the ante 150
Gsmith13: posts the ante 150
Go4ElvIS: posts the ante 150
mennck: posts the ante 150
$aymon9: posts the ante 150
Gsmith13: posts small blind 300
Go4ElvIS: posts big blind 600
*** HOLE CARDS ***
mennck: folds 
$aymon9: folds 
dulek_jason: raises 17746 to 18346 and is all-in
jessecesar: folds 
Gsmith13: folds 
Go4ElvIS: folds 
Uncalled bet (17746) returned to dulek_jason
dulek_jason collected 2400 from pot
dulek_jason: doesn't show hand 
*** SUMMARY ***
Total pot 2400 | Rake 0 
Seat 1: dulek_jason collected (2400)
Seat 2: jessecesar (button) folded before Flop (didn't bet)
Seat 3: Gsmith13 (small blind) folded before Flop
Seat 4: Go4ElvIS (big blind) folded before Flop
Seat 5: mennck folded before Flop (didn't bet)
Seat 6: $aymon9 folded before Flop (didn't bet)

PokerStars Hand #251209623262: Tournament #3769361908, $52.38+$2.62 USD Hold'em No Limit - Level XII (300/600) - 2024/06/26 22:37:04 UTC [2024/06/26 18:37:04 ET]
Table '3769361908 14' 6-max Seat #3 is the button
Seat 1: dulek_jason (20146 in chips) 
Seat 2: jessecesar (12360 in chips) 
Seat 3: Gsmith13 (8400 in chips) 
Seat 4: Go4ElvIS (6711 in chips) 
Seat 5: mennck (9793 in chips) 
Seat 6: $aymon9 (6766 in chips) 
dulek_jason: posts the ante 150
jessecesar: posts the ante 150
Gsmith13: posts the ante 150
Go4ElvIS: posts the ante 150
mennck: posts the ante 150
$aymon9: posts the ante 150
Go4ElvIS: posts small blind 300
mennck: posts big blind 600
*** HOLE CARDS ***
$aymon9: raises 600 to 1200
dulek_jason: folds 
jessecesar: raises 11010 to 12210 and is all-in
Gsmith13: folds 
Go4ElvIS: calls 6261 and is all-in
mennck: folds 
$aymon9: folds 
Uncalled bet (5649) returned to jessecesar
*** FLOP *** [6h Qh 8c]
*** TURN *** [6h Qh 8c] [9h]
*** RIVER *** [6h Qh 8c 9h] [As]
*** SHOW DOWN ***
Go4ElvIS: shows [9s 9d] (three of a kind, Nines)
jessecesar: shows [Kd Td] (high card Ace)
Go4ElvIS collected 15822 from pot
*** SUMMARY ***
Total pot 15822 | Rake 0 
Board [6h Qh 8c 9h As]
Seat 1: dulek_jason folded before Flop (didn't bet)
Seat 2: jessecesar showed [Kd Td] and lost with high card Ace
Seat 3: Gsmith13 (button) folded before Flop (didn't bet)
Seat 4: Go4ElvIS (small blind) showed [9s 9d] and won (15822) with three of a kind, Nines
Seat 5: mennck (big blind) folded before Flop
Seat 6: $aymon9 folded before Flop

PokerStars Hand #251209632578: Tournament #3769361908, $52.38+$2.62 USD Hold'em No Limit - Level XII (300/600) - 2024/06/26 22:37:39 UTC [2024/06/26 18:37:39 ET]
Table '3769361908 14' 6-max Seat #4 is the button
Seat 1: dulek_jason (19996 in chips) 
Seat 2: jessecesar (5649 in chips) 
Seat 3: Gsmith13 (8250 in chips) 
Seat 4: Go4ElvIS (15822 in chips) 
Seat 5: mennck (9043 in chips) 
Seat 6: $aymon9 (5416 in chips) 
dulek_jason: posts the ante 150
jessecesar: posts the ante 150
Gsmith13: posts the ante 150
Go4ElvIS: posts the ante 150
mennck: posts the ante 150
$aymon9: posts the ante 150
mennck: posts small blind 300
$aymon9: posts big blind 600
*** HOLE CARDS ***
dulek_jason: folds 
jessecesar: raises 4899 to 5499 and is all-in
Gsmith13: folds 
Go4ElvIS: raises 10173 to 15672 and is all-in
mennck: folds 
$aymon9: folds 
Uncalled bet (10173) returned to Go4ElvIS
*** FLOP *** [8c 8h 4h]
*** TURN *** [8c 8h 4h] [3c]
*** RIVER *** [8c 8h 4h 3c] [Kd]
*** SHOW DOWN ***
jessecesar: shows [Ah 3d] (two pair, Eights and Threes)
Go4ElvIS: shows [5c Ad] (a pair of Eights)
jessecesar collected 12798 from pot
*** SUMMARY ***
Total pot 12798 | Rake 0 
Board [8c 8h 4h 3c Kd]
Seat 1: dulek_jason folded before Flop (didn't bet)
Seat 2: jessecesar showed [Ah 3d] and won (12798) with two pair, Eights and Threes
Seat 3: Gsmith13 folded before Flop (didn't bet)
Seat 4: Go4ElvIS (button) showed [5c Ad] and lost with a pair of Eights
Seat 5: mennck (small blind) folded before Flop
Seat 6: $aymon9 (big blind) folded before Flop

PokerStars Hand #251209645086: Tournament #3769361908, $52.38+$2.62 USD Hold'em No Limit - Level XIII (400/800) - 2024/06/26 22:38:26 UTC [2024/06/26 18:38:26 ET]
Table '3769361908 14' 6-max Seat #5 is the button
Seat 1: dulek_jason (19846 in chips) 
Seat 2: jessecesar (12798 in chips) 
Seat 3: Gsmith13 (8100 in chips) 
Seat 4: Go4ElvIS (10173 in chips) 
Seat 5: mennck (8593 in chips) 
Seat 6: $aymon9 (4666 in chips) 
dulek_jason: posts the ante 200
jessecesar: posts the ante 200
Gsmith13: posts the ante 200
Go4ElvIS: posts the ante 200
mennck: posts the ante 200
$aymon9: posts the ante 200
$aymon9: posts small blind 400
dulek_jason: posts big blind 800
*** HOLE CARDS ***
jessecesar: folds 
Gsmith13: folds 
Go4ElvIS: folds 
mennck: folds 
$aymon9: raises 3666 to 4466 and is all-in
dulek_jason: calls 3666
*** FLOP *** [6h Js 7s]
*** TURN *** [6h Js 7s] [6s]
*** RIVER *** [6h Js 7s 6s] [7c]
*** SHOW DOWN ***
$aymon9: shows [Qh 2d] (two pair, Sevens and Sixes)
dulek_jason: shows [5c Qc] (two pair, Sevens and Sixes)
$aymon9 collected 5066 from pot
dulek_jason collected 5066 from pot
*** SUMMARY ***
Total pot 10132 | Rake 0 
Board [6h Js 7s 6s 7c]
Seat 1: dulek_jason (big blind) showed [5c Qc] and won (5066) with two pair, Sevens and Sixes
Seat 2: jessecesar folded before Flop (didn't bet)
Seat 3: Gsmith13 folded before Flop (didn't bet)
Seat 4: Go4ElvIS folded before Flop (didn't bet)
Seat 5: mennck (button) folded before Flop (didn't bet)
Seat 6: $aymon9 (small blind) showed [Qh 2d] and won (5066) with two pair, Sevens and Sixes

PokerStars Hand #251209652822: Tournament #3769361908, $52.38+$2.62 USD Hold'em No Limit - Level XIII (400/800) - 2024/06/26 22:38:54 UTC [2024/06/26 18:38:54 ET]
Table '3769361908 14' 6-max Seat #6 is the button
Seat 1: dulek_jason (20246 in chips) 
Seat 2: jessecesar (12598 in chips) 
Seat 3: Gsmith13 (7900 in chips) 
Seat 4: Go4ElvIS (9973 in chips) 
Seat 5: mennck (8393 in chips) 
Seat 6: $aymon9 (5066 in chips) 
dulek_jason: posts the ante 200
jessecesar: posts the ante 200
Gsmith13: posts the ante 200
Go4ElvIS: posts the ante 200
mennck: posts the ante 200
$aymon9: posts the ante 200
dulek_jason: posts small blind 400
jessecesar: posts big blind 800
*** HOLE CARDS ***
Gsmith13: folds 
Go4ElvIS: raises 8973 to 9773 and is all-in
mennck: folds 
$aymon9: folds 
dulek_jason: folds 
jessecesar: calls 8973
*** FLOP *** [Kh Th 2h]
*** TURN *** [Kh Th 2h] [6h]
*** RIVER *** [Kh Th 2h 6h] [Qh]
*** SHOW DOWN ***
jessecesar: shows [9s Ad] (a flush, King high)
Go4ElvIS: shows [As 6d] (a flush, King high)
jessecesar collected 10573 from pot
Go4ElvIS collected 10573 from pot
*** SUMMARY ***
Total pot 21146 | Rake 0 
Board [Kh Th 2h 6h Qh]
Seat 1: dulek_jason (small blind) folded before Flop
Seat 2: jessecesar (big blind) showed [9s Ad] and won (10573) with a flush, King high
Seat 3: Gsmith13 folded before Flop (didn't bet)
Seat 4: Go4ElvIS showed [As 6d] and won (10573) with a flush, King high
Seat 5: mennck folded before Flop (didn't bet)
Seat 6: $aymon9 (button) folded before Flop (didn't bet)

PokerStars Hand #251209661865: Tournament #3769361908, $52.38+$2.62 USD Hold'em No Limit - Level XIII (400/800) - 2024/06/26 22:39:28 UTC [2024/06/26 18:39:28 ET]
Table '3769361908 14' 6-max Seat #1 is the button
Seat 1: dulek_jason (19646 in chips) 
Seat 2: jessecesar (13198 in chips) 
Seat 3: Gsmith13 (7700 in chips) 
Seat 4: Go4ElvIS (10573 in chips) 
Seat 5: mennck (8193 in chips) 
Seat 6: $aymon9 (4866 in chips) 
dulek_jason: posts the ante 200
jessecesar: posts the ante 200
Gsmith13: posts the ante 200
Go4ElvIS: posts the ante 200
mennck: posts the ante 200
$aymon9: posts the ante 200
jessecesar: posts small blind 400
Gsmith13: posts big blind 800
*** HOLE CARDS ***
Go4ElvIS: raises 9573 to 10373 and is all-in
mennck: folds 
$aymon9: folds 
dulek_jason: folds 
jessecesar: folds 
Gsmith13: folds 
Uncalled bet (9573) returned to Go4ElvIS
Go4ElvIS collected 3200 from pot
Go4ElvIS: doesn't show hand 
*** SUMMARY ***
Total pot 3200 | Rake 0 
Seat 1: dulek_jason (button) folded before Flop (didn't bet)
Seat 2: jessecesar (small blind) folded before Flop
Seat 3: Gsmith13 (big blind) folded before Flop
Seat 4: Go4ElvIS collected (3200)
Seat 5: mennck folded before Flop (didn't bet)
Seat 6: $aymon9 folded before Flop (didn't bet)

PokerStars Hand #251209668351: Tournament #3769361908, $52.38+$2.62 USD Hold'em No Limit - Level XIII (400/800) - 2024/06/26 22:39:53 UTC [2024/06/26 18:39:53 ET]
Table '3769361908 14' 6-max Seat #2 is the button
Seat 1: dulek_jason (19446 in chips) 
Seat 2: jessecesar (12598 in chips) 
Seat 3: Gsmith13 (6700 in chips) 
Seat 4: Go4ElvIS (12773 in chips) 
Seat 5: mennck (7993 in chips) 
Seat 6: $aymon9 (4666 in chips) 
dulek_jason: posts the ante 200
jessecesar: posts the ante 200
Gsmith13: posts the ante 200
Go4ElvIS: posts the ante 200
mennck: posts the ante 200
$aymon9: posts the ante 200
Gsmith13: posts small blind 400
Go4ElvIS: posts big blind 800
*** HOLE CARDS ***
mennck: folds 
$aymon9: raises 3666 to 4466 and is all-in
dulek_jason: folds 
jessecesar: folds 
Gsmith13: folds 
Go4ElvIS: calls 3666
*** FLOP *** [Qc 7h Qd]
*** TURN *** [Qc 7h Qd] [9c]
*** RIVER *** [Qc 7h Qd 9c] [3d]
*** SHOW DOWN ***
Go4ElvIS: shows [As Jc] (a pair of Queens)
$aymon9: shows [Ks Qs] (three of a kind, Queens)
$aymon9 collected 10532 from pot
*** SUMMARY ***
Total pot 10532 | Rake 0 
Board [Qc 7h Qd 9c 3d]
Seat 1: dulek_jason folded before Flop (didn't bet)
Seat 2: jessecesar (button) folded before Flop (didn't bet)
Seat 3: Gsmith13 (small blind) folded before Flop
Seat 4: Go4ElvIS (big blind) showed [As Jc] and lost with a pair of Queens
Seat 5: mennck folded before Flop (didn't bet)
Seat 6: $aymon9 showed [Ks Qs] and won (10532) with three of a kind, Queens

PokerStars Hand #251209674359: Tournament #3769361908, $52.38+$2.62 USD Hold'em No Limit - Level XIII (400/800) - 2024/06/26 22:40:16 UTC [2024/06/26 18:40:16 ET]
Table '3769361908 14' 6-max Seat #3 is the button
Seat 1: dulek_jason (19246 in chips) 
Seat 2: jessecesar (12398 in chips) 
Seat 3: Gsmith13 (6100 in chips) 
Seat 4: Go4ElvIS (8107 in chips) 
Seat 5: mennck (7793 in chips) 
Seat 6: $aymon9 (10532 in chips) 
dulek_jason: posts the ante 200
jessecesar: posts the ante 200
Gsmith13: posts the ante 200
Go4ElvIS: posts the ante 200
mennck: posts the ante 200
$aymon9: posts the ante 200
Go4ElvIS: posts small blind 400
mennck: posts big blind 800
*** HOLE CARDS ***
$aymon9: folds 
dulek_jason: folds 
jessecesar: folds 
Gsmith13: folds 
Go4ElvIS: raises 7107 to 7907 and is all-in
mennck: folds 
Uncalled bet (7107) returned to Go4ElvIS
Go4ElvIS collected 2800 from pot
Go4ElvIS: doesn't show hand 
*** SUMMARY ***
Total pot 2800 | Rake 0 
Seat 1: dulek_jason folded before Flop (didn't bet)
Seat 2: jessecesar folded before Flop (didn't bet)
Seat 3: Gsmith13 (button) folded before Flop (didn't bet)
Seat 4: Go4ElvIS (small blind) collected (2800)
Seat 5: mennck (big blind) folded before Flop
Seat 6: $aymon9 folded before Flop (didn't bet)

PokerStars Hand #251209680632: Tournament #3769361908, $52.38+$2.62 USD Hold'em No Limit - Level XIII (400/800) - 2024/06/26 22:40:39 UTC [2024/06/26 18:40:39 ET]
Table '3769361908 14' 6-max Seat #4 is the button
Seat 1: dulek_jason (19046 in chips) 
Seat 2: jessecesar (12198 in chips) 
Seat 3: Gsmith13 (5900 in chips) 
Seat 4: Go4ElvIS (9907 in chips) 
Seat 5: mennck (6793 in chips) 
Seat 6: $aymon9 (10332 in chips) 
dulek_jason: posts the ante 200
jessecesar: posts the ante 200
Gsmith13: posts the ante 200
Go4ElvIS: posts the ante 200
mennck: posts the ante 200
$aymon9: posts the ante 200
mennck: posts small blind 400
$aymon9: posts big blind 800
*** HOLE CARDS ***
dulek_jason: folds 
jessecesar: folds 
Gsmith13: raises 4900 to 5700 and is all-in
Go4ElvIS: folds 
mennck: folds 
$aymon9: folds 
Uncalled bet (4900) returned to Gsmith13
Gsmith13 collected 3200 from pot
Gsmith13: doesn't show hand 
*** SUMMARY ***
Total pot 3200 | Rake 0 
Seat 1: dulek_jason folded before Flop (didn't bet)
Seat 2: jessecesar folded before Flop (didn't bet)
Seat 3: Gsmith13 collected (3200)
Seat 4: Go4ElvIS (button) folded before Flop (didn't bet)
Seat 5: mennck (small blind) folded before Flop
Seat 6: $aymon9 (big blind) folded before Flop

PokerStars Hand #251209687465: Tournament #3769361908, $52.38+$2.62 USD Hold'em No Limit - Level XIII (400/800) - 2024/06/26 22:41:06 UTC [2024/06/26 18:41:06 ET]
Table '3769361908 14' 6-max Seat #5 is the button
Seat 1: dulek_jason (18846 in chips) 
Seat 2: jessecesar (11998 in chips) 
Seat 3: Gsmith13 (8100 in chips) 
Seat 4: Go4ElvIS (9707 in chips) 
Seat 5: mennck (6193 in chips) 
Seat 6: $aymon9 (9332 in chips) 
dulek_jason: posts the ante 200
jessecesar: posts the ante 200
Gsmith13: posts the ante 200
Go4ElvIS: posts the ante 200
mennck: posts the ante 200
$aymon9: posts the ante 200
$aymon9: posts small blind 400
dulek_jason: posts big blind 800
*** HOLE CARDS ***
jessecesar: raises 800 to 1600
Gsmith13: folds 
Go4ElvIS: folds 
mennck: folds 
$aymon9: folds 
dulek_jason: folds 
Uncalled bet (800) returned to jessecesar
jessecesar collected 3200 from pot
jessecesar: doesn't show hand 
*** SUMMARY ***
Total pot 3200 | Rake 0 
Seat 1: dulek_jason (big blind) folded before Flop
Seat 2: jessecesar collected (3200)
Seat 3: Gsmith13 folded before Flop (didn't bet)
Seat 4: Go4ElvIS folded before Flop (didn't bet)
Seat 5: mennck (button) folded before Flop (didn't bet)
Seat 6: $aymon9 (small blind) folded before Flop

PokerStars Hand #251209695603: Tournament #3769361908, $52.38+$2.62 USD Hold'em No Limit - Level XIV (500/1000) - 2024/06/26 22:41:37 UTC [2024/06/26 18:41:37 ET]
Table '3769361908 14' 6-max Seat #6 is the button
Seat 1: dulek_jason (17846 in chips) 
Seat 2: jessecesar (14198 in chips) 
Seat 3: Gsmith13 (7900 in chips) 
Seat 4: Go4ElvIS (9507 in chips) 
Seat 5: mennck (5993 in chips) 
Seat 6: $aymon9 (8732 in chips) 
dulek_jason: posts the ante 250
jessecesar: posts the ante 250
Gsmith13: posts the ante 250
Go4ElvIS: posts the ante 250
mennck: posts the ante 250
$aymon9: posts the ante 250
dulek_jason: posts small blind 500
jessecesar: posts big blind 1000
*** HOLE CARDS ***
Gsmith13: folds 
Go4ElvIS: raises 8257 to 9257 and is all-in
mennck: folds 
$aymon9: folds 
dulek_jason: folds 
jessecesar: calls 8257
*** FLOP *** [Qh Th Js]
*** TURN *** [Qh Th Js] [As]
*** RIVER *** [Qh Th Js As] [Td]
*** SHOW DOWN ***
jessecesar: shows [Qd Ah] (two pair, Aces and Queens)
Go4ElvIS: shows [Ad Jc] (two pair, Aces and Jacks)
jessecesar collected 20514 from pot
Go4ElvIS finished the tournament
*** SUMMARY ***
Total pot 20514 | Rake 0 
Board [Qh Th Js As Td]
Seat 1: dulek_jason (small blind) folded before Flop
Seat 2: jessecesar (big blind) showed [Qd Ah] and won (20514) with two pair, Aces and Queens
Seat 3: Gsmith13 folded before Flop (didn't bet)
Seat 4: Go4ElvIS showed [Ad Jc] and lost with two pair, Aces and Jacks
Seat 5: mennck folded before Flop (didn't bet)
Seat 6: $aymon9 (button) folded before Flop (didn't bet)


PokerStars Hand #251209384555: Tournament #3769361908, $52.38+$2.62 USD Hold'em No Limit - Level VII (100/200) - 2024/06/26 22:22:34 UTC [2024/06/26 18:22:34 ET]
Table '3769361908 13' 6-max Seat #1 is the button
Seat 1: sanatamaria (11150 in chips) 
Seat 3: giftmyra (5838 in chips) 
Seat 4: fernandoefv (10310 in chips) 
Seat 5: laapin (11010 in chips) 
Seat 6: ratitoBR (11965 in chips) 
sanatamaria: posts the ante 50
giftmyra: posts the ante 50
fernandoefv: posts the ante 50
laapin: posts the ante 50
ratitoBR: posts the ante 50
giftmyra: posts small blind 100
fernandoefv: posts big blind 200
*** HOLE CARDS ***
laapin: raises 300 to 500
ratitoBR: folds 
sanatamaria: folds 
giftmyra: folds 
fernandoefv: calls 300
*** FLOP *** [4c Jd Kh]
fernandoefv: checks 
laapin: bets 959
fernandoefv: calls 959
*** TURN *** [4c Jd Kh] [4d]
fernandoefv: checks 
laapin: checks 
*** RIVER *** [4c Jd Kh 4d] [9s]
handsfull69 is disconnected 
fernandoefv: checks 
laapin: checks 
*** SHOW DOWN ***
fernandoefv: shows [Td Qs] (a straight, Nine to King)
laapin: mucks hand 
fernandoefv collected 3268 from pot
*** SUMMARY ***
Total pot 3268 | Rake 0 
Board [4c Jd Kh 4d 9s]
Seat 1: sanatamaria (button) folded before Flop (didn't bet)
Seat 3: giftmyra (small blind) folded before Flop
Seat 4: fernandoefv (big blind) showed [Td Qs] and won (3268) with a straight, Nine to King
Seat 5: laapin mucked
Seat 6: ratitoBR folded before Flop (didn't bet)

PokerStars Hand #251209404882: Tournament #3769361908, $52.38+$2.62 USD Hold'em No Limit - Level VIII (125/250) - 2024/06/26 22:23:48 UTC [2024/06/26 18:23:48 ET]
Table '3769361908 13' 6-max Seat #3 is the button
Seat 1: sanatamaria (11100 in chips) 
Seat 2: handsfull69 (10000 in chips) 
Seat 3: giftmyra (5688 in chips) 
Seat 4: fernandoefv (12069 in chips) 
Seat 5: laapin (9501 in chips) 
Seat 6: ratitoBR (11915 in chips) 
sanatamaria: posts the ante 60
handsfull69: posts the ante 60
giftmyra: posts the ante 60
fernandoefv: posts the ante 60
laapin: posts the ante 60
ratitoBR: posts the ante 60
fernandoefv: posts small blind 125
laapin: posts big blind 250
*** HOLE CARDS ***
ratitoBR: raises 250 to 500
sanatamaria: calls 500
handsfull69: folds 
giftmyra: folds 
fernandoefv: folds 
laapin: folds 
*** FLOP *** [2d Kd 4h]
ratitoBR: checks 
sanatamaria: checks 
*** TURN *** [2d Kd 4h] [3h]
ratitoBR: checks 
sanatamaria: checks 
*** RIVER *** [2d Kd 4h 3h] [Ad]
ratitoBR: bets 500
sanatamaria: calls 500
*** SHOW DOWN ***
ratitoBR: shows [Jc Qd] (high card Ace)
sanatamaria: shows [9h As] (a pair of Aces)
sanatamaria collected 2735 from pot
*** SUMMARY ***
Total pot 2735 | Rake 0 
Board [2d Kd 4h 3h Ad]
Seat 1: sanatamaria showed [9h As] and won (2735) with a pair of Aces
Seat 2: handsfull69 folded before Flop (didn't bet)
Seat 3: giftmyra (button) folded before Flop (didn't bet)
Seat 4: fernandoefv (small blind) folded before Flop
Seat 5: laapin (big blind) folded before Flop
Seat 6: ratitoBR showed [Jc Qd] and lost with high card Ace

PokerStars Hand #251209416027: Tournament #3769361908, $52.38+$2.62 USD Hold'em No Limit - Level VIII (125/250) - 2024/06/26 22:24:28 UTC [2024/06/26 18:24:28 ET]
Table '3769361908 13' 6-max Seat #4 is the button
Seat 1: sanatamaria (12775 in chips) 
Seat 2: handsfull69 (9940 in chips) 
Seat 3: giftmyra (5628 in chips) 
Seat 4: fernandoefv (11884 in chips) 
Seat 5: laapin (9191 in chips) 
Seat 6: ratitoBR (10855 in chips) 
sanatamaria: posts the ante 60
handsfull69: posts the ante 60
giftmyra: posts the ante 60
fernandoefv: posts the ante 60
laapin: posts the ante 60
ratitoBR: posts the ante 60
laapin: posts small blind 125
ratitoBR: posts big blind 250
*** HOLE CARDS ***
sanatamaria: calls 250
handsfull69: folds 
giftmyra: raises 275 to 525
fernandoefv: folds 
laapin: raises 8606 to 9131 and is all-in
ratitoBR: folds 
sanatamaria: folds 
giftmyra: calls 5043 and is all-in
Uncalled bet (3563) returned to laapin
*** FLOP *** [6h 9c Ts]
*** TURN *** [6h 9c Ts] [Kc]
*** RIVER *** [6h 9c Ts Kc] [3c]
*** SHOW DOWN ***
laapin: shows [Ah Jd] (high card Ace)
giftmyra: shows [As Td] (a pair of Tens)
giftmyra collected 11996 from pot
*** SUMMARY ***
Total pot 11996 | Rake 0 
Board [6h 9c Ts Kc 3c]
Seat 1: sanatamaria folded before Flop
Seat 2: handsfull69 folded before Flop (didn't bet)
Seat 3: giftmyra showed [As Td] and won (11996) with a pair of Tens
Seat 4: fernandoefv (button) folded before Flop (didn't bet)
Seat 5: laapin (small blind) showed [Ah Jd] and lost with high card Ace
Seat 6: ratitoBR (big blind) folded before Flop

PokerStars Hand #251209433415: Tournament #3769361908, $52.38+$2.62 USD Hold'em No Limit - Level VIII (125/250) - 2024/06/26 22:25:31 UTC [2024/06/26 18:25:31 ET]
Table '3769361908 13' 6-max Seat #5 is the button
Seat 1: sanatamaria (12465 in chips) 
Seat 2: handsfull69 (9880 in chips) 
Seat 3: giftmyra (11996 in chips) 
Seat 4: fernandoefv (11824 in chips) 
Seat 5: laapin (3563 in chips) 
Seat 6: ratitoBR (10545 in chips) 
sanatamaria: posts the ante 60
handsfull69: posts the ante 60
giftmyra: posts the ante 60
fernandoefv: posts the ante 60
laapin: posts the ante 60
ratitoBR: posts the ante 60
ratitoBR: posts small blind 125
sanatamaria: posts big blind 250
*** HOLE CARDS ***
handsfull69: folds 
giftmyra: folds 
fernandoefv: folds 
laapin: raises 3253 to 3503 and is all-in
ratitoBR: raises 6982 to 10485 and is all-in
sanatamaria: calls 10235
*** FLOP *** [Ts 7d 2d]
*** TURN *** [Ts 7d 2d] [Ah]
*** RIVER *** [Ts 7d 2d Ah] [9c]
*** SHOW DOWN ***
ratitoBR: shows [4d 4h] (a pair of Fours)
sanatamaria: shows [Qc Kh] (high card Ace)
ratitoBR collected 13964 from side pot
laapin: shows [5h 7s] (a pair of Sevens)
laapin collected 10869 from main pot
*** SUMMARY ***
Total pot 24833 Main pot 10869. Side pot 13964. | Rake 0 
Board [Ts 7d 2d Ah 9c]
Seat 1: sanatamaria (big blind) showed [Qc Kh] and lost with high card Ace
Seat 2: handsfull69 folded before Flop (didn't bet)
Seat 3: giftmyra folded before Flop (didn't bet)
Seat 4: fernandoefv folded before Flop (didn't bet)
Seat 5: laapin (button) showed [5h 7s] and won (10869) with a pair of Sevens
Seat 6: ratitoBR (small blind) showed [4d 4h] and won (13964) with a pair of Fours

PokerStars Hand #251209440873: Tournament #3769361908, $52.38+$2.62 USD Hold'em No Limit - Level VIII (125/250) - 2024/06/26 22:25:58 UTC [2024/06/26 18:25:58 ET]
Table '3769361908 13' 6-max Seat #6 is the button
Seat 1: sanatamaria (1920 in chips) 
Seat 2: handsfull69 (9820 in chips) 
Seat 3: giftmyra (11936 in chips) 
Seat 4: fernandoefv (11764 in chips) 
Seat 5: laapin (10869 in chips) 
Seat 6: ratitoBR (13964 in chips) 
sanatamaria: posts the ante 60
handsfull69: posts the ante 60
giftmyra: posts the ante 60
fernandoefv: posts the ante 60
laapin: posts the ante 60
ratitoBR: posts the ante 60
sanatamaria: posts small blind 125
handsfull69: posts big blind 250
*** HOLE CARDS ***
giftmyra: folds 
fernandoefv: folds 
laapin: folds 
ratitoBR: folds 
sanatamaria: raises 1610 to 1860 and is all-in
handsfull69: calls 1610
*** FLOP *** [Qd 3s 5d]
*** TURN *** [Qd 3s 5d] [9h]
*** RIVER *** [Qd 3s 5d 9h] [4h]
*** SHOW DOWN ***
sanatamaria: shows [Js Tc] (high card Queen)
handsfull69: shows [Jh 7h] (high card Queen - lower kicker)
sanatamaria collected 4080 from pot
*** SUMMARY ***
Total pot 4080 | Rake 0 
Board [Qd 3s 5d 9h 4h]
Seat 1: sanatamaria (small blind) showed [Js Tc] and won (4080) with high card Queen
Seat 2: handsfull69 (big blind) showed [Jh 7h] and lost with high card Queen
Seat 3: giftmyra folded before Flop (didn't bet)
Seat 4: fernandoefv folded before Flop (didn't bet)
Seat 5: laapin folded before Flop (didn't bet)
Seat 6: ratitoBR (button) folded before Flop (didn't bet)

PokerStars Hand #251209452520: Tournament #3769361908, $52.38+$2.62 USD Hold'em No Limit - Level IX (150/300) - 2024/06/26 22:26:40 UTC [2024/06/26 18:26:40 ET]
Table '3769361908 13' 6-max Seat #1 is the button
Seat 1: sanatamaria (4080 in chips) 
Seat 2: handsfull69 (7900 in chips) 
Seat 3: giftmyra (11876 in chips) 
Seat 4: fernandoefv (11704 in chips) 
Seat 5: laapin (10809 in chips) 
Seat 6: ratitoBR (13904 in chips) 
sanatamaria: posts the ante 75
handsfull69: posts the ante 75
giftmyra: posts the ante 75
fernandoefv: posts the ante 75
laapin: posts the ante 75
ratitoBR: posts the ante 75
handsfull69: posts small blind 150
giftmyra: posts big blind 300
*** HOLE CARDS ***
fernandoefv: raises 300 to 600
laapin: folds 
ratitoBR: folds 
sanatamaria: folds 
handsfull69: calls 450
giftmyra: folds 
*** FLOP *** [Jd 8d Jc]
handsfull69: bets 975
fernandoefv: folds 
Uncalled bet (975) returned to handsfull69
handsfull69 collected 1950 from pot
*** SUMMARY ***
Total pot 1950 | Rake 0 
Board [Jd 8d Jc]
Seat 1: sanatamaria (button) folded before Flop (didn't bet)
Seat 2: handsfull69 (small blind) collected (1950)
Seat 3: giftmyra (big blind) folded before Flop
Seat 4: fernandoefv folded on the Flop
Seat 5: laapin folded before Flop (didn't bet)
Seat 6: ratitoBR folded before Flop (didn't bet)

PokerStars Hand #251209467806: Tournament #3769361908, $52.38+$2.62 USD Hold'em No Limit - Level IX (150/300) - 2024/06/26 22:27:35 UTC [2024/06/26 18:27:35 ET]
Table '3769361908 13' 6-max Seat #2 is the button
Seat 1: sanatamaria (4005 in chips) 
Seat 2: handsfull69 (9175 in chips) 
Seat 3: giftmyra (11501 in chips) 
Seat 5: laapin (10734 in chips) 
Seat 6: ratitoBR (13829 in chips) 
sanatamaria: posts the ante 75
handsfull69: posts the ante 75
giftmyra: posts the ante 75
laapin: posts the ante 75
ratitoBR: posts the ante 75
giftmyra: posts small blind 150
laapin: posts big blind 300
*** HOLE CARDS ***
ratitoBR: folds 
sanatamaria: folds 
handsfull69: raises 300 to 600
giftmyra: folds 
laapin: folds 
Uncalled bet (300) returned to handsfull69
handsfull69 collected 1125 from pot
*** SUMMARY ***
Total pot 1125 | Rake 0 
Seat 1: sanatamaria folded before Flop (didn't bet)
Seat 2: handsfull69 (button) collected (1125)
Seat 3: giftmyra (small blind) folded before Flop
Seat 5: laapin (big blind) folded before Flop
Seat 6: ratitoBR folded before Flop (didn't bet)

PokerStars Hand #251209472811: Tournament #3769361908, $52.38+$2.62 USD Hold'em No Limit - Level IX (150/300) - 2024/06/26 22:27:52 UTC [2024/06/26 18:27:52 ET]
Table '3769361908 13' 6-max Seat #3 is the button
Seat 1: sanatamaria (3930 in chips) 
Seat 2: handsfull69 (9925 in chips) 
Seat 3: giftmyra (11276 in chips) 
Seat 5: laapin (10359 in chips) 
Seat 6: ratitoBR (13754 in chips) 
sanatamaria: posts the ante 75
handsfull69: posts the ante 75
giftmyra: posts the ante 75
laapin: posts the ante 75
ratitoBR: posts the ante 75
laapin: posts small blind 150
ratitoBR: posts big blind 300
*** HOLE CARDS ***
sanatamaria: folds 
handsfull69: raises 300 to 600
giftmyra: folds 
laapin: folds 
ratitoBR: calls 300
*** FLOP *** [Jh 8c 7c]
ratitoBR: checks 
vip_1985Z is disconnected 
handsfull69: checks 
*** TURN *** [Jh 8c 7c] [2h]
ratitoBR: checks 
handsfull69: checks 
*** RIVER *** [Jh 8c 7c 2h] [9d]
ratitoBR: checks 
handsfull69: checks 
*** SHOW DOWN ***
ratitoBR: shows [2s Ah] (a pair of Deuces)
handsfull69: shows [4d 4s] (a pair of Fours)
handsfull69 collected 1725 from pot
*** SUMMARY ***
Total pot 1725 | Rake 0 
Board [Jh 8c 7c 2h 9d]
Seat 1: sanatamaria folded before Flop (didn't bet)
Seat 2: handsfull69 showed [4d 4s] and won (1725) with a pair of Fours
Seat 3: giftmyra (button) folded before Flop (didn't bet)
Seat 5: laapin (small blind) folded before Flop
Seat 6: ratitoBR (big blind) showed [2s Ah] and lost with a pair of Deuces

PokerStars Hand #251209485972: Tournament #3769361908, $52.38+$2.62 USD Hold'em No Limit - Level IX (150/300) - 2024/06/26 22:28:40 UTC [2024/06/26 18:28:40 ET]
Table '3769361908 13' 6-max Seat #5 is the button
Seat 1: sanatamaria (3855 in chips) 
Seat 2: handsfull69 (10975 in chips) 
Seat 3: giftmyra (11201 in chips) 
Seat 4: vip_1985Z (10000 in chips) 
Seat 5: laapin (10134 in chips) 
Seat 6: ratitoBR (13079 in chips) 
sanatamaria: posts the ante 75
handsfull69: posts the ante 75
giftmyra: posts the ante 75
vip_1985Z: posts the ante 75
laapin: posts the ante 75
ratitoBR: posts the ante 75
ratitoBR: posts small blind 150
sanatamaria: posts big blind 300
*** HOLE CARDS ***
handsfull69: raises 300 to 600
giftmyra: folds 
vip_1985Z: folds 
laapin: folds 
ratitoBR: folds 
sanatamaria: calls 300
*** FLOP *** [Ks Qs 2h]
sanatamaria: checks 
handsfull69: checks 
*** TURN *** [Ks Qs 2h] [7s]
sanatamaria: checks 
handsfull69: checks 
*** RIVER *** [Ks Qs 2h 7s] [4h]
sanatamaria: bets 3180 and is all-in
handsfull69: calls 3180
*** SHOW DOWN ***
sanatamaria: shows [9d Kh] (a pair of Kings)
handsfull69: shows [6h 6s] (a pair of Sixes)
sanatamaria collected 8160 from pot
*** SUMMARY ***
Total pot 8160 | Rake 0 
Board [Ks Qs 2h 7s 4h]
Seat 1: sanatamaria (big blind) showed [9d Kh] and won (8160) with a pair of Kings
Seat 2: handsfull69 showed [6h 6s] and lost with a pair of Sixes
Seat 3: giftmyra folded before Flop (didn't bet)
Seat 4: vip_1985Z folded before Flop (didn't bet)
Seat 5: laapin (button) folded before Flop (didn't bet)
Seat 6: ratitoBR (small blind) folded before Flop

PokerStars Hand #251209496462: Tournament #3769361908, $52.38+$2.62 USD Hold'em No Limit - Level X (200/400) - 2024/06/26 22:29:17 UTC [2024/06/26 18:29:17 ET]
Table '3769361908 13' 6-max Seat #6 is the button
Seat 1: sanatamaria (8160 in chips) 
Seat 2: handsfull69 (7120 in chips) 
Seat 3: giftmyra (11126 in chips) 
Seat 4: vip_1985Z (9925 in chips) 
Seat 5: laapin (10059 in chips) 
Seat 6: ratitoBR (12854 in chips) 
sanatamaria: posts the ante 100
handsfull69: posts the ante 100
giftmyra: posts the ante 100
vip_1985Z: posts the ante 100
laapin: posts the ante 100
ratitoBR: posts the ante 100
sanatamaria: posts small blind 200
handsfull69: posts big blind 400
*** HOLE CARDS ***
giftmyra: folds 
vip_1985Z: folds 
laapin: folds 
ratitoBR: folds 
sanatamaria: folds 
Uncalled bet (200) returned to handsfull69
handsfull69 collected 1000 from pot
*** SUMMARY ***
Total pot 1000 | Rake 0 
Seat 1: sanatamaria (small blind) folded before Flop
Seat 2: handsfull69 (big blind) collected (1000)
Seat 3: giftmyra folded before Flop (didn't bet)
Seat 4: vip_1985Z folded before Flop (didn't bet)
Seat 5: laapin folded before Flop (didn't bet)
Seat 6: ratitoBR (button) folded before Flop (didn't bet)

PokerStars Hand #251209505300: Tournament #3769361908, $52.38+$2.62 USD Hold'em No Limit - Level X (200/400) - 2024/06/26 22:29:49 UTC [2024/06/26 18:29:49 ET]
Table '3769361908 13' 6-max Seat #1 is the button
Seat 1: sanatamaria (7860 in chips) 
Seat 2: handsfull69 (7820 in chips) 
Seat 3: giftmyra (11026 in chips) 
Seat 4: vip_1985Z (9825 in chips) 
Seat 5: laapin (9959 in chips) 
Seat 6: ratitoBR (12754 in chips) 
sanatamaria: posts the ante 100
handsfull69: posts the ante 100
giftmyra: posts the ante 100
vip_1985Z: posts the ante 100
laapin: posts the ante 100
ratitoBR: posts the ante 100
handsfull69: posts small blind 200
giftmyra: posts big blind 400
*** HOLE CARDS ***
vip_1985Z: folds 
laapin: folds 
ratitoBR: folds 
sanatamaria: folds 
handsfull69: raises 7320 to 7720 and is all-in
giftmyra: folds 
Uncalled bet (7320) returned to handsfull69
handsfull69 collected 1400 from pot
*** SUMMARY ***
Total pot 1400 | Rake 0 
Seat 1: sanatamaria (button) folded before Flop (didn't bet)
Seat 2: handsfull69 (small blind) collected (1400)
Seat 3: giftmyra (big blind) folded before Flop
Seat 4: vip_1985Z folded before Flop (didn't bet)
Seat 5: laapin folded before Flop (didn't bet)
Seat 6: ratitoBR folded before Flop (didn't bet)

PokerStars Hand #251209514978: Tournament #3769361908, $52.38+$2.62 USD Hold'em No Limit - Level X (200/400) - 2024/06/26 22:30:23 UTC [2024/06/26 18:30:23 ET]
Table '3769361908 13' 6-max Seat #2 is the button
Seat 1: sanatamaria (7760 in chips) 
Seat 2: handsfull69 (8720 in chips) 
Seat 3: giftmyra (10526 in chips) 
Seat 4: vip_1985Z (9725 in chips) 
Seat 5: laapin (9859 in chips) 
Seat 6: ratitoBR (12654 in chips) 
sanatamaria: posts the ante 100
handsfull69: posts the ante 100
giftmyra: posts the ante 100
vip_1985Z: posts the ante 100
laapin: posts the ante 100
ratitoBR: posts the ante 100
giftmyra: posts small blind 200
vip_1985Z: posts big blind 400
*** HOLE CARDS ***
laapin: folds 
ratitoBR: folds 
sanatamaria: folds 
handsfull69: folds 
giftmyra: folds 
Uncalled bet (200) returned to vip_1985Z
vip_1985Z collected 1000 from pot
vip_1985Z: doesn't show hand 
*** SUMMARY ***
Total pot 1000 | Rake 0 
Seat 1: sanatamaria folded before Flop (didn't bet)
Seat 2: handsfull69 (button) folded before Flop (didn't bet)
Seat 3: giftmyra (small blind) folded before Flop
Seat 4: vip_1985Z (big blind) collected (1000)
Seat 5: laapin folded before Flop (didn't bet)
Seat 6: ratitoBR folded before Flop (didn't bet)

PokerStars Hand #251209525409: Tournament #3769361908, $52.38+$2.62 USD Hold'em No Limit - Level X (200/400) - 2024/06/26 22:31:01 UTC [2024/06/26 18:31:01 ET]
Table '3769361908 13' 6-max Seat #3 is the button
Seat 1: sanatamaria (7660 in chips) 
Seat 2: handsfull69 (8620 in chips) 
Seat 3: giftmyra (10226 in chips) 
Seat 4: vip_1985Z (10425 in chips) 
Seat 5: laapin (9759 in chips) 
Seat 6: ratitoBR (12554 in chips) 
sanatamaria: posts the ante 100
handsfull69: posts the ante 100
giftmyra: posts the ante 100
vip_1985Z: posts the ante 100
laapin: posts the ante 100
ratitoBR: posts the ante 100
vip_1985Z: posts small blind 200
laapin: posts big blind 400
*** HOLE CARDS ***
ratitoBR: folds 
sanatamaria: raises 7160 to 7560 and is all-in
handsfull69: raises 960 to 8520 and is all-in
giftmyra: folds 
vip_1985Z: folds 
laapin: calls 8120
*** FLOP *** [Jd Ks 3s]
*** TURN *** [Jd Ks 3s] [6h]
*** RIVER *** [Jd Ks 3s 6h] [2c]
*** SHOW DOWN ***
laapin: shows [5c 5s] (a pair of Fives)
handsfull69: shows [9d 9s] (a pair of Nines)
handsfull69 collected 1920 from side pot
sanatamaria: shows [Th Kh] (a pair of Kings)
sanatamaria collected 23480 from main pot
*** SUMMARY ***
Total pot 25400 Main pot 23480. Side pot 1920. | Rake 0 
Board [Jd Ks 3s 6h 2c]
Seat 1: sanatamaria showed [Th Kh] and won (23480) with a pair of Kings
Seat 2: handsfull69 showed [9d 9s] and won (1920) with a pair of Nines
Seat 3: giftmyra (button) folded before Flop (didn't bet)
Seat 4: vip_1985Z (small blind) folded before Flop
Seat 5: laapin (big blind) showed [5c 5s] and lost with a pair of Fives
Seat 6: ratitoBR folded before Flop (didn't bet)

PokerStars Hand #251209534378: Tournament #3769361908, $52.38+$2.62 USD Hold'em No Limit - Level X (200/400) - 2024/06/26 22:31:34 UTC [2024/06/26 18:31:34 ET]
Table '3769361908 13' 6-max Seat #4 is the button
Seat 1: sanatamaria (23480 in chips) 
Seat 2: handsfull69 (1920 in chips) 
Seat 3: giftmyra (10126 in chips) 
Seat 4: vip_1985Z (10125 in chips) 
Seat 5: laapin (1139 in chips) 
Seat 6: ratitoBR (12454 in chips) 
sanatamaria: posts the ante 100
handsfull69: posts the ante 100
giftmyra: posts the ante 100
vip_1985Z: posts the ante 100
laapin: posts the ante 100
ratitoBR: posts the ante 100
laapin: posts small blind 200
ratitoBR: posts big blind 400
*** HOLE CARDS ***
sanatamaria: folds 
handsfull69: raises 1420 to 1820 and is all-in
giftmyra: folds 
vip_1985Z: calls 1820
laapin: calls 839 and is all-in
ratitoBR: folds 
*** FLOP *** [Tc 5c 3d]
*** TURN *** [Tc 5c 3d] [3c]
*** RIVER *** [Tc 5c 3d 3c] [6s]
*** SHOW DOWN ***
handsfull69: shows [Jd 4h] (a pair of Threes)
vip_1985Z: shows [Ah As] (two pair, Aces and Threes)
vip_1985Z collected 1562 from side pot
laapin: shows [3h 2h] (three of a kind, Threes)
laapin collected 4117 from main pot
handsfull69 finished the tournament
*** SUMMARY ***
Total pot 5679 Main pot 4117. Side pot 1562. | Rake 0 
Board [Tc 5c 3d 3c 6s]
Seat 1: sanatamaria folded before Flop (didn't bet)
Seat 2: handsfull69 showed [Jd 4h] and lost with a pair of Threes
Seat 3: giftmyra folded before Flop (didn't bet)
Seat 4: vip_1985Z (button) showed [Ah As] and won (1562) with two pair, Aces and Threes
Seat 5: laapin (small blind) showed [3h 2h] and won (4117) with three of a kind, Threes
Seat 6: ratitoBR (big blind) folded before Flop

PokerStars Hand #251209540693: Tournament #3769361908, $52.38+$2.62 USD Hold'em No Limit - Level X (200/400) - 2024/06/26 22:31:57 UTC [2024/06/26 18:31:57 ET]
Table '3769361908 13' 6-max Seat #5 is the button
Seat 1: sanatamaria (23380 in chips) 
Seat 3: giftmyra (10026 in chips) 
Seat 4: vip_1985Z (9767 in chips) 
Seat 5: laapin (4117 in chips) 
Seat 6: ratitoBR (11954 in chips) 
sanatamaria: posts the ante 100
giftmyra: posts the ante 100
vip_1985Z: posts the ante 100
laapin: posts the ante 100
ratitoBR: posts the ante 100
ratitoBR: posts small blind 200
sanatamaria: posts big blind 400
*** HOLE CARDS ***
giftmyra: folds 
vip_1985Z: folds 
PIUlimeira is disconnected 
laapin: raises 3617 to 4017 and is all-in
ratitoBR: calls 3817
sanatamaria: folds 
*** FLOP *** [Kd 8d Kc]
*** TURN *** [Kd 8d Kc] [Ah]
*** RIVER *** [Kd 8d Kc Ah] [Qh]
*** SHOW DOWN ***
ratitoBR: shows [2s As] (two pair, Aces and Kings)
laapin: shows [5d 6h] (a pair of Kings)
ratitoBR collected 8934 from pot
laapin finished the tournament
*** SUMMARY ***
Total pot 8934 | Rake 0 
Board [Kd 8d Kc Ah Qh]
Seat 1: sanatamaria (big blind) folded before Flop
Seat 3: giftmyra folded before Flop (didn't bet)
Seat 4: vip_1985Z folded before Flop (didn't bet)
Seat 5: laapin (button) showed [5d 6h] and lost with a pair of Kings
Seat 6: ratitoBR (small blind) showed [2s As] and won (8934) with two pair, Aces and Kings

PokerStars Hand #251209550127: Tournament #3769361908, $52.38+$2.62 USD Hold'em No Limit - Level XI (250/500) - 2024/06/26 22:32:32 UTC [2024/06/26 18:32:32 ET]
Table '3769361908 13' 6-max Seat #6 is the button
Seat 1: sanatamaria (22880 in chips) 
Seat 2: PIUlimeira (10000 in chips) 
Seat 3: giftmyra (9926 in chips) 
Seat 4: vip_1985Z (9667 in chips) 
Seat 6: ratitoBR (16771 in chips) 
sanatamaria: posts the ante 125
PIUlimeira: posts the ante 125
giftmyra: posts the ante 125
vip_1985Z: posts the ante 125
ratitoBR: posts the ante 125
sanatamaria: posts small blind 250
PIUlimeira: posts big blind 500
*** HOLE CARDS ***
giftmyra: folds 
vip_1985Z: folds 
ratitoBR: folds 
sanatamaria: calls 250
PIUlimeira: checks 
*** FLOP *** [7h 4s 4h]
sanatamaria: bets 500
PIUlimeira: folds 
Uncalled bet (500) returned to sanatamaria
sanatamaria collected 1625 from pot
sanatamaria: doesn't show hand 
*** SUMMARY ***
Total pot 1625 | Rake 0 
Board [7h 4s 4h]
Seat 1: sanatamaria (small blind) collected (1625)
Seat 2: PIUlimeira (big blind) folded on the Flop
Seat 3: giftmyra folded before Flop (didn't bet)
Seat 4: vip_1985Z folded before Flop (didn't bet)
Seat 6: ratitoBR (button) folded before Flop (didn't bet)

PokerStars Hand #251209559655: Tournament #3769361908, $52.38+$2.62 USD Hold'em No Limit - Level XI (250/500) - 2024/06/26 22:33:07 UTC [2024/06/26 18:33:07 ET]
Table '3769361908 13' 6-max Seat #1 is the button
Seat 1: sanatamaria (23880 in chips) 
Seat 2: PIUlimeira (9375 in chips) 
Seat 3: giftmyra (9801 in chips) 
Seat 4: vip_1985Z (9542 in chips) 
Seat 6: ratitoBR (16646 in chips) 
sanatamaria: posts the ante 125
PIUlimeira: posts the ante 125
giftmyra: posts the ante 125
vip_1985Z: posts the ante 125
ratitoBR: posts the ante 125
PIUlimeira: posts small blind 250
giftmyra: posts big blind 500
*** HOLE CARDS ***
vip_1985Z: raises 600 to 1100
ratitoBR: folds 
sanatamaria: folds 
PIUlimeira: folds 
giftmyra: calls 600
*** FLOP *** [8h Qh 5s]
giftmyra: checks 
vip_1985Z: bets 923
giftmyra: calls 923
*** TURN *** [8h Qh 5s] [5h]
giftmyra: checks 
vip_1985Z: checks 
*** RIVER *** [8h Qh 5s 5h] [7c]
giftmyra: bets 1624
vip_1985Z: folds 
Uncalled bet (1624) returned to giftmyra
giftmyra collected 4921 from pot
giftmyra: doesn't show hand 
*** SUMMARY ***
Total pot 4921 | Rake 0 
Board [8h Qh 5s 5h 7c]
Seat 1: sanatamaria (button) folded before Flop (didn't bet)
Seat 2: PIUlimeira (small blind) folded before Flop
Seat 3: giftmyra (big blind) collected (4921)
Seat 4: vip_1985Z folded on the River
Seat 6: ratitoBR folded before Flop (didn't bet)

PokerStars Hand #251209579286: Tournament #3769361908, $52.38+$2.62 USD Hold'em No Limit - Level XI (250/500) - 2024/06/26 22:34:20 UTC [2024/06/26 18:34:20 ET]
Table '3769361908 13' 6-max Seat #2 is the button
Seat 1: sanatamaria (23755 in chips) 
Seat 2: PIUlimeira (9000 in chips) 
Seat 3: giftmyra (12574 in chips) 
Seat 4: vip_1985Z (7394 in chips) 
Seat 6: ratitoBR (16521 in chips) 
sanatamaria: posts the ante 125
PIUlimeira: posts the ante 125
giftmyra: posts the ante 125
vip_1985Z: posts the ante 125
ratitoBR: posts the ante 125
giftmyra: posts small blind 250
vip_1985Z: posts big blind 500
*** HOLE CARDS ***
ratitoBR: folds 
sanatamaria: folds 
PIUlimeira: folds 
giftmyra: calls 250
vip_1985Z: checks 
*** FLOP *** [Ac Ad 7h]
giftmyra: bets 500
vip_1985Z: folds 
Uncalled bet (500) returned to giftmyra
giftmyra collected 1625 from pot
giftmyra: doesn't show hand 
*** SUMMARY ***
Total pot 1625 | Rake 0 
Board [Ac Ad 7h]
Seat 1: sanatamaria folded before Flop (didn't bet)
Seat 2: PIUlimeira (button) folded before Flop (didn't bet)
Seat 3: giftmyra (small blind) collected (1625)
Seat 4: vip_1985Z (big blind) folded on the Flop
Seat 6: ratitoBR folded before Flop (didn't bet)

PokerStars Hand #251209587507: Tournament #3769361908, $52.38+$2.62 USD Hold'em No Limit - Level XI (250/500) - 2024/06/26 22:34:51 UTC [2024/06/26 18:34:51 ET]
Table '3769361908 13' 6-max Seat #3 is the button
Seat 1: sanatamaria (23630 in chips) 
Seat 2: PIUlimeira (8875 in chips) 
Seat 3: giftmyra (13574 in chips) 
Seat 4: vip_1985Z (6769 in chips) 
Seat 6: ratitoBR (16396 in chips) 
sanatamaria: posts the ante 125
PIUlimeira: posts the ante 125
giftmyra: posts the ante 125
vip_1985Z: posts the ante 125
ratitoBR: posts the ante 125
vip_1985Z: posts small blind 250
ratitoBR: posts big blind 500
*** HOLE CARDS ***
sanatamaria: folds 
PIUlimeira: folds 
giftmyra: folds 
vip_1985Z: folds 
Uncalled bet (250) returned to ratitoBR
ratitoBR collected 1125 from pot
ratitoBR: doesn't show hand 
*** SUMMARY ***
Total pot 1125 | Rake 0 
Seat 1: sanatamaria folded before Flop (didn't bet)
Seat 2: PIUlimeira folded before Flop (didn't bet)
Seat 3: giftmyra (button) folded before Flop (didn't bet)
Seat 4: vip_1985Z (small blind) folded before Flop
Seat 6: ratitoBR (big blind) collected (1125)

PokerStars Hand #251209597714: Tournament #3769361908, $52.38+$2.62 USD Hold'em No Limit - Level XII (300/600) - 2024/06/26 22:35:29 UTC [2024/06/26 18:35:29 ET]
Table '3769361908 13' 6-max Seat #4 is the button
Seat 1: sanatamaria (23505 in chips) 
Seat 2: PIUlimeira (8750 in chips) 
Seat 3: giftmyra (13449 in chips) 
Seat 4: vip_1985Z (6394 in chips) 
Seat 6: ratitoBR (17146 in chips) 
sanatamaria: posts the ante 150
PIUlimeira: posts the ante 150
giftmyra: posts the ante 150
vip_1985Z: posts the ante 150
ratitoBR: posts the ante 150
ratitoBR: posts small blind 300
sanatamaria: posts big blind 600
*** HOLE CARDS ***
PIUlimeira: folds 
giftmyra: folds 
vip_1985Z: folds 
ratitoBR: calls 300
sanatamaria: checks 
*** FLOP *** [7s 9h 3c]
ratitoBR: bets 600
sanatamaria: folds 
Uncalled bet (600) returned to ratitoBR
ratitoBR collected 1950 from pot
ratitoBR: doesn't show hand 
*** SUMMARY ***
Total pot 1950 | Rake 0 
Board [7s 9h 3c]
Seat 1: sanatamaria (big blind) folded on the Flop
Seat 2: PIUlimeira folded before Flop (didn't bet)
Seat 3: giftmyra folded before Flop (didn't bet)
Seat 4: vip_1985Z (button) folded before Flop (didn't bet)
Seat 6: ratitoBR (small blind) collected (1950)

PokerStars Hand #251209607619: Tournament #3769361908, $52.38+$2.62 USD Hold'em No Limit - Level XII (300/600) - 2024/06/26 22:36:05 UTC [2024/06/26 18:36:05 ET]
Table '3769361908 13' 6-max Seat #6 is the button
Seat 1: sanatamaria (22755 in chips) 
Seat 2: PIUlimeira (8600 in chips) 
Seat 3: giftmyra (13299 in chips) 
Seat 4: vip_1985Z (6244 in chips) 
Seat 6: ratitoBR (18346 in chips) 
sanatamaria: posts the ante 150
PIUlimeira: posts the ante 150
giftmyra: posts the ante 150
vip_1985Z: posts the ante 150
ratitoBR: posts the ante 150
sanatamaria: posts small blind 300
PIUlimeira: posts big blind 600
*** HOLE CARDS ***
giftmyra: folds 
vip_1985Z: folds 
ratitoBR: raises 600 to 1200
sanatamaria: folds 
PIUlimeira: folds 
Uncalled bet (600) returned to ratitoBR
ratitoBR collected 2250 from pot
ratitoBR: doesn't show hand 
*** SUMMARY ***
Total pot 2250 | Rake 0 
Seat 1: sanatamaria (small blind) folded before Flop
Seat 2: PIUlimeira (big blind) folded before Flop
Seat 3: giftmyra folded before Flop (didn't bet)
Seat 4: vip_1985Z folded before Flop (didn't bet)
Seat 6: ratitoBR (button) collected (2250)

PokerStars Hand #251209614731: Tournament #3769361908, $52.38+$2.62 USD Hold'em No Limit - Level XII (300/600) - 2024/06/26 22:36:32 UTC [2024/06/26 18:36:32 ET]
Table '3769361908 13' 6-max Seat #1 is the button
Seat 1: sanatamaria (22305 in chips) 
Seat 2: PIUlimeira (7850 in chips) 
Seat 3: giftmyra (13149 in chips) 
Seat 4: vip_1985Z (6094 in chips) 
Seat 6: ratitoBR (19846 in chips) 
sanatamaria: posts the ante 150
PIUlimeira: posts the ante 150
giftmyra: posts the ante 150
vip_1985Z: posts the ante 150
ratitoBR: posts the ante 150
PIUlimeira: posts small blind 300
giftmyra: posts big blind 600
*** HOLE CARDS ***
vip_1985Z: folds 
ratitoBR: folds 
sanatamaria: folds 
PIUlimeira: raises 7100 to 7700 and is all-in
giftmyra: folds 
Uncalled bet (7100) returned to PIUlimeira
PIUlimeira collected 1950 from pot
*** SUMMARY ***
Total pot 1950 | Rake 0 
Seat 1: sanatamaria (button) folded before Flop (didn't bet)
Seat 2: PIUlimeira (small blind) collected (1950)
Seat 3: giftmyra (big blind) folded before Flop
Seat 4: vip_1985Z folded before Flop (didn't bet)
Seat 6: ratitoBR folded before Flop (didn't bet)

PokerStars Hand #251209619887: Tournament #3769361908, $52.38+$2.62 USD Hold'em No Limit - Level XII (300/600) - 2024/06/26 22:36:52 UTC [2024/06/26 18:36:52 ET]
Table '3769361908 13' 6-max Seat #2 is the button
Seat 1: sanatamaria (22155 in chips) 
Seat 2: PIUlimeira (9050 in chips) 
Seat 3: giftmyra (12399 in chips) 
Seat 4: vip_1985Z (5944 in chips) 
Seat 6: ratitoBR (19696 in chips) 
sanatamaria: posts the ante 150
PIUlimeira: posts the ante 150
giftmyra: posts the ante 150
vip_1985Z: posts the ante 150
ratitoBR: posts the ante 150
giftmyra: posts small blind 300
vip_1985Z: posts big blind 600
*** HOLE CARDS ***
ratitoBR: raises 900 to 1500
sanatamaria: folds 
PIUlimeira: folds 
leocir25 is disconnected 
giftmyra: folds 
vip_1985Z: folds 
Uncalled bet (900) returned to ratitoBR
ratitoBR collected 2250 from pot
ratitoBR: doesn't show hand 
*** SUMMARY ***
Total pot 2250 | Rake 0 
Seat 1: sanatamaria folded before Flop (didn't bet)
Seat 2: PIUlimeira (button) folded before Flop (didn't bet)
Seat 3: giftmyra (small blind) folded before Flop
Seat 4: vip_1985Z (big blind) folded before Flop
Seat 6: ratitoBR collected (2250)

PokerStars Hand #251209626125: Tournament #3769361908, $52.38+$2.62 USD Hold'em No Limit - Level XII (300/600) - 2024/06/26 22:37:15 UTC [2024/06/26 18:37:15 ET]
Table '3769361908 13' 6-max Seat #3 is the button
Seat 1: sanatamaria (22005 in chips) 
Seat 2: PIUlimeira (8900 in chips) 
Seat 3: giftmyra (11949 in chips) 
Seat 4: vip_1985Z (5194 in chips) 
Seat 5: leocir25 (10000 in chips) 
Seat 6: ratitoBR (21196 in chips) 
sanatamaria: posts the ante 150
PIUlimeira: posts the ante 150
giftmyra: posts the ante 150
vip_1985Z: posts the ante 150
leocir25: posts the ante 150
ratitoBR: posts the ante 150
vip_1985Z: posts small blind 300
leocir25: posts big blind 600
*** HOLE CARDS ***
ratitoBR: raises 600 to 1200
sanatamaria: folds 
PIUlimeira: folds 
giftmyra: folds 
vip_1985Z: folds 
leocir25: calls 600
*** FLOP *** [Qs 4s 9s]
leocir25: checks 
ratitoBR: bets 1100
leocir25: calls 1100
*** TURN *** [Qs 4s 9s] [Jh]
leocir25: checks 
ratitoBR: bets 2800
leocir25: calls 2800
*** RIVER *** [Qs 4s 9s Jh] [7d]
leocir25: checks 
ratitoBR: checks 
*** SHOW DOWN ***
leocir25: shows [9c Qh] (two pair, Queens and Nines)
ratitoBR: mucks hand 
leocir25 collected 11400 from pot
*** SUMMARY ***
Total pot 11400 | Rake 0 
Board [Qs 4s 9s Jh 7d]
Seat 1: sanatamaria folded before Flop (didn't bet)
Seat 2: PIUlimeira folded before Flop (didn't bet)
Seat 3: giftmyra (button) folded before Flop (didn't bet)
Seat 4: vip_1985Z (small blind) folded before Flop
Seat 5: leocir25 (big blind) showed [9c Qh] and won (11400) with two pair, Queens and Nines
Seat 6: ratitoBR mucked

PokerStars Hand #251209653112: Tournament #3769361908, $52.38+$2.62 USD Hold'em No Limit - Level XIII (400/800) - 2024/06/26 22:38:55 UTC [2024/06/26 18:38:55 ET]
Table '3769361908 13' 6-max Seat #4 is the button
Seat 1: sanatamaria (21855 in chips) 
Seat 2: PIUlimeira (8750 in chips) 
Seat 3: giftmyra (11799 in chips) 
Seat 4: vip_1985Z (4744 in chips) 
Seat 5: leocir25 (16150 in chips) 
Seat 6: ratitoBR (15946 in chips) 
sanatamaria: posts the ante 200
PIUlimeira: posts the ante 200
giftmyra: posts the ante 200
vip_1985Z: posts the ante 200
leocir25: posts the ante 200
ratitoBR: posts the ante 200
leocir25: posts small blind 400
ratitoBR: posts big blind 800
*** HOLE CARDS ***
sanatamaria: folds 
PIUlimeira: folds 
giftmyra: folds 
vip_1985Z: folds 
leocir25: calls 400
ratitoBR: checks 
*** FLOP *** [5s Qc Kc]
leocir25: bets 2328
ratitoBR: calls 2328
*** TURN *** [5s Qc Kc] [Kh]
leocir25: bets 3728
ratitoBR: calls 3728
*** RIVER *** [5s Qc Kc Kh] [3h]
leocir25: bets 9094 and is all-in
ratitoBR: calls 8890 and is all-in
Uncalled bet (204) returned to leocir25
*** SHOW DOWN ***
leocir25: shows [Tc Ks] (three of a kind, Kings)
ratitoBR: shows [Jc Qs] (two pair, Kings and Queens)
leocir25 collected 32692 from pot
ratitoBR finished the tournament
*** SUMMARY ***
Total pot 32692 | Rake 0 
Board [5s Qc Kc Kh 3h]
Seat 1: sanatamaria folded before Flop (didn't bet)
Seat 2: PIUlimeira folded before Flop (didn't bet)
Seat 3: giftmyra folded before Flop (didn't bet)
Seat 4: vip_1985Z (button) folded before Flop (didn't bet)
Seat 5: leocir25 (small blind) showed [Tc Ks] and won (32692) with three of a kind, Kings
Seat 6: ratitoBR (big blind) showed [Jc Qs] and lost with two pair, Kings and Queens

PokerStars Hand #251209676767: Tournament #3769361908, $52.38+$2.62 USD Hold'em No Limit - Level XIII (400/800) - 2024/06/26 22:40:25 UTC [2024/06/26 18:40:25 ET]
Table '3769361908 13' 6-max Seat #5 is the button
Seat 1: sanatamaria (21655 in chips) 
Seat 2: PIUlimeira (8550 in chips) 
Seat 3: giftmyra (11599 in chips) 
Seat 4: vip_1985Z (4544 in chips) 
Seat 5: leocir25 (32896 in chips) 
sanatamaria: posts the ante 200
PIUlimeira: posts the ante 200
giftmyra: posts the ante 200
vip_1985Z: posts the ante 200
leocir25: posts the ante 200
sanatamaria: posts small blind 400
PIUlimeira: posts big blind 800
*** HOLE CARDS ***
vavan199212 is disconnected 
giftmyra: folds 
vip_1985Z: raises 3544 to 4344 and is all-in
leocir25: folds 
sanatamaria: raises 3544 to 7888
PIUlimeira: folds 
Uncalled bet (3544) returned to sanatamaria
*** FLOP *** [Kh Tc 2h]
*** TURN *** [Kh Tc 2h] [8c]
*** RIVER *** [Kh Tc 2h 8c] [5s]
*** SHOW DOWN ***
sanatamaria: shows [Kd Ks] (three of a kind, Kings)
vip_1985Z: shows [As Qs] (high card Ace)
sanatamaria collected 10488 from pot
vip_1985Z finished the tournament
*** SUMMARY ***
Total pot 10488 | Rake 0 
Board [Kh Tc 2h 8c 5s]
Seat 1: sanatamaria (small blind) showed [Kd Ks] and won (10488) with three of a kind, Kings
Seat 2: PIUlimeira (big blind) folded before Flop
Seat 3: giftmyra folded before Flop (didn't bet)
Seat 4: vip_1985Z showed [As Qs] and lost with high card Ace
Seat 5: leocir25 (button) folded before Flop (didn't bet)

PokerStars Hand #251209687836: Tournament #3769361908, $52.38+$2.62 USD Hold'em No Limit - Level XIII (400/800) - 2024/06/26 22:41:07 UTC [2024/06/26 18:41:07 ET]
Table '3769361908 13' 6-max Seat #1 is the button
Seat 1: sanatamaria (27599 in chips) 
Seat 2: PIUlimeira (7550 in chips) 
Seat 3: giftmyra (11399 in chips) 
Seat 5: leocir25 (32696 in chips) 
Seat 6: vavan199212 (10000 in chips) 
sanatamaria: posts the ante 200
PIUlimeira: posts the ante 200
giftmyra: posts the ante 200
leocir25: posts the ante 200
vavan199212: posts the ante 200
PIUlimeira: posts small blind 400
giftmyra: posts big blind 800
*** HOLE CARDS ***
leocir25: raises 800 to 1600
vavan199212: folds 
sanatamaria: folds 
PIUlimeira: folds 
giftmyra: calls 800
*** FLOP *** [Ad 8c Th]
giftmyra: checks 
leocir25: bets 1152
giftmyra: raises 2278 to 3430
leocir25: raises 22962 to 26392
giftmyra: calls 6169 and is all-in
Uncalled bet (16793) returned to leocir25
*** TURN *** [Ad 8c Th] [5c]
*** RIVER *** [Ad 8c Th 5c] [3s]
*** SHOW DOWN ***
giftmyra: shows [7c 9s] (high card Ace)
leocir25: shows [Qh Qc] (a pair of Queens)
leocir25 collected 23798 from pot
giftmyra finished the tournament
Gsmith13 is disconnected 
*** SUMMARY ***
Total pot 23798 | Rake 0 
Board [Ad 8c Th 5c 3s]
Seat 1: sanatamaria (button) folded before Flop (didn't bet)
Seat 2: PIUlimeira (small blind) folded before Flop
Seat 3: giftmyra (big blind) showed [7c 9s] and lost with high card Ace
Seat 5: leocir25 showed [Qh Qc] and won (23798) with a pair of Queens
Seat 6: vavan199212 folded before Flop (didn't bet)

PokerStars Hand #251209702939: Tournament #3769361908, $52.38+$2.62 USD Hold'em No Limit - Level XIV (500/1000) - 2024/06/26 22:42:06 UTC [2024/06/26 18:42:06 ET]
Table '3769361908 13' 6-max Seat #2 is the button
Seat 1: sanatamaria (27399 in chips) 
Seat 2: PIUlimeira (6950 in chips) 
Seat 3: jessecesar (25205 in chips) out of hand (moved from another table into small blind)
Seat 4: Gsmith13 (7650 in chips) out of hand (moved from another table into small blind)
Seat 5: leocir25 (45095 in chips) 
Seat 6: vavan199212 (9800 in chips) 
jessecesar will be allowed to play after the button
Gsmith13 will be allowed to play after the button
sanatamaria: posts the ante 250
PIUlimeira: posts the ante 250
leocir25: posts the ante 250
vavan199212: posts the ante 250
leocir25: posts small blind 500
vavan199212: posts big blind 1000
*** HOLE CARDS ***
sanatamaria: folds 
PIUlimeira: raises 5700 to 6700 and is all-in
leocir25: raises 5700 to 12400
vavan199212: folds 
Uncalled bet (5700) returned to leocir25
*** FLOP *** [9h Ts 3d]
*** TURN *** [9h Ts 3d] [Jh]
*** RIVER *** [9h Ts 3d Jh] [7s]
*** SHOW DOWN ***
leocir25: shows [Kc Jd] (a pair of Jacks)
PIUlimeira: shows [Kh 7d] (a pair of Sevens)
leocir25 collected 15400 from pot
PIUlimeira finished the tournament
*** SUMMARY ***
Total pot 15400 | Rake 0 
Board [9h Ts 3d Jh 7s]
Seat 1: sanatamaria folded before Flop (didn't bet)
Seat 2: PIUlimeira (button) showed [Kh 7d] and lost with a pair of Sevens
Seat 5: leocir25 (small blind) showed [Kc Jd] and won (15400) with a pair of Jacks
Seat 6: vavan199212 (big blind) folded before Flop

PokerStars Hand #251209709534: Tournament #3769361908, $52.38+$2.62 USD Hold'em No Limit - Level XIV (500/1000) - 2024/06/26 22:42:31 UTC [2024/06/26 18:42:31 ET]
Table '3769361908 13' 6-max Seat #5 is the button
Seat 1: sanatamaria (27149 in chips) 
Seat 3: jessecesar (25205 in chips) 
Seat 4: Gsmith13 (7650 in chips) 
Seat 5: leocir25 (53545 in chips) 
Seat 6: vavan199212 (8550 in chips) 
sanatamaria: posts the ante 250
jessecesar: posts the ante 250
Gsmith13: posts the ante 250
leocir25: posts the ante 250
vavan199212: posts the ante 250
vavan199212: posts small blind 500
sanatamaria: posts big blind 1000
*** HOLE CARDS ***
jessecesar: folds 
Gsmith13: raises 6400 to 7400 and is all-in
tom6969222 is disconnected 
leocir25: folds 
vavan199212: folds 
sanatamaria: calls 6400
*** FLOP *** [4s 9d Qd]
*** TURN *** [4s 9d Qd] [8c]
*** RIVER *** [4s 9d Qd 8c] [Td]
*** SHOW DOWN ***
sanatamaria: shows [Th Kd] (a pair of Tens)
Gsmith13: shows [Ks 7s] (high card King)
sanatamaria collected 16550 from pot
Gsmith13 finished the tournament
*** SUMMARY ***
Total pot 16550 | Rake 0 
Board [4s 9d Qd 8c Td]
Seat 1: sanatamaria (big blind) showed [Th Kd] and won (16550) with a pair of Tens
Seat 3: jessecesar folded before Flop (didn't bet)
Seat 4: Gsmith13 showed [Ks 7s] and lost with high card King
Seat 5: leocir25 (button) folded before Flop (didn't bet)
Seat 6: vavan199212 (small blind) folded before Flop

PokerStars Hand #251209716783: Tournament #3769361908, $52.38+$2.62 USD Hold'em No Limit - Level XIV (500/1000) - 2024/06/26 22:42:59 UTC [2024/06/26 18:42:59 ET]
Table '3769361908 13' 6-max Seat #6 is the button
Seat 1: sanatamaria (36049 in chips) 
Seat 2: tom6969222 (10000 in chips) 
Seat 3: jessecesar (24955 in chips) 
Seat 5: leocir25 (53295 in chips) 
Seat 6: vavan199212 (7800 in chips) 
sanatamaria: posts the ante 250
tom6969222: posts the ante 250
jessecesar: posts the ante 250
leocir25: posts the ante 250
vavan199212: posts the ante 250
sanatamaria: posts small blind 500
tom6969222: posts big blind 1000
*** HOLE CARDS ***
jessecesar: folds 
leocir25: folds 
vavan199212: folds 
sanatamaria: folds 
Uncalled bet (500) returned to tom6969222
tom6969222 collected 2250 from pot
tom6969222: doesn't show hand 
*** SUMMARY ***
Total pot 2250 | Rake 0 
Seat 1: sanatamaria (small blind) folded before Flop
Seat 2: tom6969222 (big blind) collected (2250)
Seat 3: jessecesar folded before Flop (didn't bet)
Seat 5: leocir25 folded before Flop (didn't bet)
Seat 6: vavan199212 (button) folded before Flop (didn't bet)

PokerStars Hand #251209719026: Tournament #3769361908, $52.38+$2.62 USD Hold'em No Limit - Level XIV (500/1000) - 2024/06/26 22:43:08 UTC [2024/06/26 18:43:08 ET]
Table '3769361908 13' 6-max Seat #1 is the button
Seat 1: sanatamaria (35299 in chips) 
Seat 2: tom6969222 (11500 in chips) 
Seat 3: jessecesar (24705 in chips) 
Seat 5: leocir25 (53045 in chips) 
Seat 6: vavan199212 (7550 in chips) 
sanatamaria: posts the ante 250
tom6969222: posts the ante 250
jessecesar: posts the ante 250
leocir25: posts the ante 250
vavan199212: posts the ante 250
tom6969222: posts small blind 500
jessecesar: posts big blind 1000
*** HOLE CARDS ***
leocir25: folds 
vavan199212: folds 
sanatamaria: folds 
tom6969222: folds 
Uncalled bet (500) returned to jessecesar
jessecesar collected 2250 from pot
jessecesar: doesn't show hand 
*** SUMMARY ***
Total pot 2250 | Rake 0 
Seat 1: sanatamaria (button) folded before Flop (didn't bet)
Seat 2: tom6969222 (small blind) folded before Flop
Seat 3: jessecesar (big blind) collected (2250)
Seat 5: leocir25 folded before Flop (didn't bet)
Seat 6: vavan199212 folded before Flop (didn't bet)

PokerStars Hand #251209721426: Tournament #3769361908, $52.38+$2.62 USD Hold'em No Limit - Level XIV (500/1000) - 2024/06/26 22:43:17 UTC [2024/06/26 18:43:17 ET]
Table '3769361908 13' 6-max Seat #2 is the button
Seat 1: sanatamaria (35049 in chips) 
Seat 2: tom6969222 (10750 in chips) 
Seat 3: jessecesar (26205 in chips) 
Seat 5: leocir25 (52795 in chips) 
Seat 6: vavan199212 (7300 in chips) 
sanatamaria: posts the ante 250
tom6969222: posts the ante 250
jessecesar: posts the ante 250
leocir25: posts the ante 250
vavan199212: posts the ante 250
jessecesar: posts small blind 500
leocir25: posts big blind 1000
*** HOLE CARDS ***
vavan199212: raises 6050 to 7050 and is all-in
sanatamaria: folds 
tom6969222: folds 
jessecesar: folds 
leocir25: folds 
Uncalled bet (6050) returned to vavan199212
vavan199212 collected 3750 from pot
vavan199212: doesn't show hand 
*** SUMMARY ***
Total pot 3750 | Rake 0 
Seat 1: sanatamaria folded before Flop (didn't bet)
Seat 2: tom6969222 (button) folded before Flop (didn't bet)
Seat 3: jessecesar (small blind) folded before Flop
Seat 5: leocir25 (big blind) folded before Flop
Seat 6: vavan199212 collected (3750)

PokerStars Hand #251209729286: Tournament #3769361908, $52.38+$2.62 USD Hold'em No Limit - Level XIV (500/1000) - 2024/06/26 22:43:48 UTC [2024/06/26 18:43:48 ET]
Table '3769361908 13' 6-max Seat #3 is the button
Seat 1: sanatamaria (34799 in chips) 
Seat 2: tom6969222 (10500 in chips) 
Seat 3: jessecesar (25455 in chips) 
Seat 5: leocir25 (51545 in chips) 
Seat 6: vavan199212 (9800 in chips) 
sanatamaria: posts the ante 250
tom6969222: posts the ante 250
jessecesar: posts the ante 250
leocir25: posts the ante 250
vavan199212: posts the ante 250
leocir25: posts small blind 500
vavan199212: posts big blind 1000
*** HOLE CARDS ***
sanatamaria: folds 
tom6969222: folds 
jessecesar: folds 
DarkSkies21 is disconnected 
leocir25: calls 500
vavan199212: checks 
*** FLOP *** [Qc Ac 7d]
leocir25: bets 2000
vavan199212: folds 
Uncalled bet (2000) returned to leocir25
leocir25 collected 3250 from pot
*** SUMMARY ***
Total pot 3250 | Rake 0 
Board [Qc Ac 7d]
Seat 1: sanatamaria folded before Flop (didn't bet)
Seat 2: tom6969222 folded before Flop (didn't bet)
Seat 3: jessecesar (button) folded before Flop (didn't bet)
Seat 5: leocir25 (small blind) collected (3250)
Seat 6: vavan199212 (big blind) folded on the Flop

PokerStars Hand #251209736012: Tournament #3769361908, $52.38+$2.62 USD Hold'em No Limit - Level XV (600/1200) - 2024/06/26 22:44:14 UTC [2024/06/26 18:44:14 ET]
Table '3769361908 13' 6-max Seat #5 is the button
Seat 1: sanatamaria (34549 in chips) 
Seat 2: tom6969222 (10250 in chips) 
Seat 3: jessecesar (25205 in chips) 
Seat 4: DarkSkies21 (26834 in chips) 
Seat 5: leocir25 (53545 in chips) 
Seat 6: vavan199212 (8550 in chips) 
sanatamaria: posts the ante 300
tom6969222: posts the ante 300
jessecesar: posts the ante 300
DarkSkies21: posts the ante 300
leocir25: posts the ante 300
vavan199212: posts the ante 300
vavan199212: posts small blind 600
sanatamaria: posts big blind 1200
*** HOLE CARDS ***
tom6969222: folds 
jessecesar: folds 
DarkSkies21: folds 
leocir25: raises 1200 to 2400
vavan199212: raises 5850 to 8250 and is all-in
sanatamaria: folds 
leocir25: calls 5850
*** FLOP *** [Jh 6d Th]
*** TURN *** [Jh 6d Th] [Ts]
*** RIVER *** [Jh 6d Th Ts] [4s]
*** SHOW DOWN ***
vavan199212: shows [9c Ah] (a pair of Tens)
leocir25: shows [Tc Js] (a full house, Tens full of Jacks)
leocir25 collected 19500 from pot
vavan199212 finished the tournament
teamcucha10 is disconnected 
*** SUMMARY ***
Total pot 19500 | Rake 0 
Board [Jh 6d Th Ts 4s]
Seat 1: sanatamaria (big blind) folded before Flop
Seat 2: tom6969222 folded before Flop (didn't bet)
Seat 3: jessecesar folded before Flop (didn't bet)
Seat 4: DarkSkies21 folded before Flop (didn't bet)
Seat 5: leocir25 (button) showed [Tc Js] and won (19500) with a full house, Tens full of Jacks
Seat 6: vavan199212 (small blind) showed [9c Ah] and lost with a pair of Tens

PokerStars Hand #251209744139: Tournament #3769361908, $52.38+$2.62 USD Hold'em No Limit - Level XV (600/1200) - 2024/06/26 22:44:46 UTC [2024/06/26 18:44:46 ET]
Table '3769361908 13' 6-max Seat #1 is the button
Seat 1: sanatamaria (33049 in chips) 
Seat 2: tom6969222 (9950 in chips) 
Seat 3: jessecesar (24905 in chips) 
Seat 4: DarkSkies21 (26534 in chips) 
Seat 5: leocir25 (64495 in chips) 
Seat 6: teamcucha10 (29564 in chips) 
sanatamaria: posts the ante 300
tom6969222: posts the ante 300
jessecesar: posts the ante 300
DarkSkies21: posts the ante 300
leocir25: posts the ante 300
teamcucha10: posts the ante 300
tom6969222: posts small blind 600
jessecesar: posts big blind 1200
*** HOLE CARDS ***
DarkSkies21: folds 
leocir25: folds 
teamcucha10: folds 
sanatamaria: folds 
tom6969222: raises 8450 to 9650 and is all-in
jessecesar: folds 
Uncalled bet (8450) returned to tom6969222
tom6969222 collected 4200 from pot
tom6969222: doesn't show hand 
*** SUMMARY ***
Total pot 4200 | Rake 0 
Seat 1: sanatamaria (button) folded before Flop (didn't bet)
Seat 2: tom6969222 (small blind) collected (4200)
Seat 3: jessecesar (big blind) folded before Flop
Seat 4: DarkSkies21 folded before Flop (didn't bet)
Seat 5: leocir25 folded before Flop (didn't bet)
Seat 6: teamcucha10 folded before Flop (didn't bet)

PokerStars Hand #251209753367: Tournament #3769361908, $52.38+$2.62 USD Hold'em No Limit - Level XV (600/1200) - 2024/06/26 22:45:22 UTC [2024/06/26 18:45:22 ET]
Table '3769361908 13' 6-max Seat #2 is the button
Seat 1: sanatamaria (32749 in chips) 
Seat 2: tom6969222 (12650 in chips) 
Seat 3: jessecesar (23405 in chips) 
Seat 4: DarkSkies21 (26234 in chips) 
Seat 5: leocir25 (64195 in chips) 
Seat 6: teamcucha10 (29264 in chips) 
sanatamaria: posts the ante 300
tom6969222: posts the ante 300
jessecesar: posts the ante 300
DarkSkies21: posts the ante 300
leocir25: posts the ante 300
teamcucha10: posts the ante 300
jessecesar: posts small blind 600
DarkSkies21: posts big blind 1200
*** HOLE CARDS ***
leocir25: folds 
teamcucha10: folds 
sanatamaria: folds 
tom6969222: raises 2400 to 3600
jessecesar: folds 
DarkSkies21: folds 
Uncalled bet (2400) returned to tom6969222
tom6969222 collected 4800 from pot
tom6969222: doesn't show hand 
*** SUMMARY ***
Total pot 4800 | Rake 0 
Seat 1: sanatamaria folded before Flop (didn't bet)
Seat 2: tom6969222 (button) collected (4800)
Seat 3: jessecesar (small blind) folded before Flop
Seat 4: DarkSkies21 (big blind) folded before Flop
Seat 5: leocir25 folded before Flop (didn't bet)
Seat 6: teamcucha10 folded before Flop (didn't bet)

PokerStars Hand #251209762270: Tournament #3769361908, $52.38+$2.62 USD Hold'em No Limit - Level XV (600/1200) - 2024/06/26 22:45:56 UTC [2024/06/26 18:45:56 ET]
Table '3769361908 13' 6-max Seat #3 is the button
Seat 1: sanatamaria (32449 in chips) 
Seat 2: tom6969222 (15950 in chips) 
Seat 3: jessecesar (22505 in chips) 
Seat 4: DarkSkies21 (24734 in chips) 
Seat 5: leocir25 (63895 in chips) 
Seat 6: teamcucha10 (28964 in chips) 
sanatamaria: posts the ante 300
tom6969222: posts the ante 300
jessecesar: posts the ante 300
DarkSkies21: posts the ante 300
leocir25: posts the ante 300
teamcucha10: posts the ante 300
DarkSkies21: posts small blind 600
leocir25: posts big blind 1200
*** HOLE CARDS ***
teamcucha10: folds 
sanatamaria: folds 
tom6969222: raises 2400 to 3600
jessecesar: folds 
DarkSkies21: folds 
leocir25: folds 
Uncalled bet (2400) returned to tom6969222
tom6969222 collected 4800 from pot
tom6969222: doesn't show hand 
*** SUMMARY ***
Total pot 4800 | Rake 0 
Seat 1: sanatamaria folded before Flop (didn't bet)
Seat 2: tom6969222 collected (4800)
Seat 3: jessecesar (button) folded before Flop (didn't bet)
Seat 4: DarkSkies21 (small blind) folded before Flop
Seat 5: leocir25 (big blind) folded before Flop
Seat 6: teamcucha10 folded before Flop (didn't bet)

PokerStars Hand #251209770409: Tournament #3769361908, $52.38+$2.62 USD Hold'em No Limit - Level XV (600/1200) - 2024/06/26 22:46:28 UTC [2024/06/26 18:46:28 ET]
Table '3769361908 13' 6-max Seat #4 is the button
Seat 1: sanatamaria (32149 in chips) 
Seat 2: tom6969222 (19250 in chips) 
Seat 3: jessecesar (22205 in chips) 
Seat 4: DarkSkies21 (23834 in chips) 
Seat 5: leocir25 (62395 in chips) 
Seat 6: teamcucha10 (28664 in chips) 
sanatamaria: posts the ante 300
tom6969222: posts the ante 300
jessecesar: posts the ante 300
DarkSkies21: posts the ante 300
leocir25: posts the ante 300
teamcucha10: posts the ante 300
leocir25: posts small blind 600
teamcucha10: posts big blind 1200
*** HOLE CARDS ***
sanatamaria: folds 
tom6969222: folds 
jessecesar: folds 
DarkSkies21: folds 
leocir25: calls 600
teamcucha10: checks 
*** FLOP *** [8s 9d 3c]
leocir25: checks 
teamcucha10: bets 1200
leocir25: calls 1200
*** TURN *** [8s 9d 3c] [5h]
leocir25: checks 
teamcucha10: bets 3600
leocir25: calls 3600
*** RIVER *** [8s 9d 3c 5h] [4h]
leocir25: checks 
teamcucha10: bets 11550
leocir25: folds 
Uncalled bet (11550) returned to teamcucha10
teamcucha10 collected 13800 from pot
teamcucha10: doesn't show hand 
*** SUMMARY ***
Total pot 13800 | Rake 0 
Board [8s 9d 3c 5h 4h]
Seat 1: sanatamaria folded before Flop (didn't bet)
Seat 2: tom6969222 folded before Flop (didn't bet)
Seat 3: jessecesar folded before Flop (didn't bet)
Seat 4: DarkSkies21 (button) folded before Flop (didn't bet)
Seat 5: leocir25 (small blind) folded on the River
Seat 6: teamcucha10 (big blind) collected (13800)

PokerStars Hand #251209801230: Tournament #3769361908, $52.38+$2.62 USD Hold'em No Limit - Level XVI (800/1600) - 2024/06/26 22:48:29 UTC [2024/06/26 18:48:29 ET]
Table '3769361908 13' 6-max Seat #5 is the button
Seat 1: sanatamaria (31849 in chips) 
Seat 2: tom6969222 (18950 in chips) 
Seat 3: jessecesar (21905 in chips) 
Seat 4: DarkSkies21 (23534 in chips) 
Seat 5: leocir25 (56095 in chips) 
Seat 6: teamcucha10 (36164 in chips) 
sanatamaria: posts the ante 400
tom6969222: posts the ante 400
jessecesar: posts the ante 400
DarkSkies21: posts the ante 400
leocir25: posts the ante 400
teamcucha10: posts the ante 400
teamcucha10: posts small blind 800
sanatamaria: posts big blind 1600
*** HOLE CARDS ***
tom6969222: folds 
jessecesar: folds 
DarkSkies21: folds 
leocir25: raises 1600 to 3200
teamcucha10: folds 
sanatamaria: folds 
Uncalled bet (1600) returned to leocir25
leocir25 collected 6400 from pot
*** SUMMARY ***
Total pot 6400 | Rake 0 
Seat 1: sanatamaria (big blind) folded before Flop
Seat 2: tom6969222 folded before Flop (didn't bet)
Seat 3: jessecesar folded before Flop (didn't bet)
Seat 4: DarkSkies21 folded before Flop (didn't bet)
Seat 5: leocir25 (button) collected (6400)
Seat 6: teamcucha10 (small blind) folded before Flop

PokerStars Hand #251209814161: Tournament #3769361908, $52.38+$2.62 USD Hold'em No Limit - Level XVI (800/1600) - 2024/06/26 22:49:21 UTC [2024/06/26 18:49:21 ET]
Table '3769361908 13' 6-max Seat #6 is the button
Seat 1: sanatamaria (29849 in chips) 
Seat 2: tom6969222 (18550 in chips) 
Seat 3: jessecesar (21505 in chips) 
Seat 4: DarkSkies21 (23134 in chips) 
Seat 5: leocir25 (60495 in chips) 
Seat 6: teamcucha10 (34964 in chips) 
sanatamaria: posts the ante 400
tom6969222: posts the ante 400
jessecesar: posts the ante 400
DarkSkies21: posts the ante 400
leocir25: posts the ante 400
teamcucha10: posts the ante 400
sanatamaria: posts small blind 800
tom6969222: posts big blind 1600
*** HOLE CARDS ***
jessecesar: folds 
DarkSkies21: folds 
leocir25: folds 
teamcucha10: raises 32964 to 34564 and is all-in
sanatamaria: folds 
tom6969222: calls 16550 and is all-in
Uncalled bet (16414) returned to teamcucha10
*** FLOP *** [3c 5s As]
*** TURN *** [3c 5s As] [7h]
*** RIVER *** [3c 5s As 7h] [6s]
*** SHOW DOWN ***
tom6969222: shows [Kc Tc] (high card Ace)
teamcucha10: shows [Qc Kd] (high card Ace - King+Queen kicker)
teamcucha10 collected 39500 from pot
tom6969222 finished the tournament in 111th place
*** SUMMARY ***
Total pot 39500 | Rake 0 
Board [3c 5s As 7h 6s]
Seat 1: sanatamaria (small blind) folded before Flop
Seat 2: tom6969222 (big blind) showed [Kc Tc] and lost with high card Ace
Seat 3: jessecesar folded before Flop (didn't bet)
Seat 4: DarkSkies21 folded before Flop (didn't bet)
Seat 5: leocir25 folded before Flop (didn't bet)
Seat 6: teamcucha10 (button) showed [Qc Kd] and won (39500) with high card Ace

PokerStars Hand #251209824371: Tournament #3769361908, $52.38+$2.62 USD Hold'em No Limit - Level XVI (800/1600) - 2024/06/26 22:50:02 UTC [2024/06/26 18:50:02 ET]
Table '3769361908 13' 6-max Seat #1 is the button
Seat 1: sanatamaria (28649 in chips) 
Seat 3: jessecesar (21105 in chips) 
Seat 4: DarkSkies21 (22734 in chips) 
Seat 5: leocir25 (60095 in chips) 
Seat 6: teamcucha10 (55914 in chips) 
sanatamaria: posts the ante 400
jessecesar: posts the ante 400
DarkSkies21: posts the ante 400
leocir25: posts the ante 400
teamcucha10: posts the ante 400
jessecesar: posts small blind 800
DarkSkies21: posts big blind 1600
*** HOLE CARDS ***
leocir25: folds 
teamcucha10: raises 1760 to 3360
sanatamaria: folds 
jessecesar: folds 
MezuuÜuuT is disconnected 
DarkSkies21: raises 18974 to 22334 and is all-in
teamcucha10: calls 18974
*** FLOP *** [8s 5c 8h]
*** TURN *** [8s 5c 8h] [Td]
*** RIVER *** [8s 5c 8h Td] [3s]
*** SHOW DOWN ***
DarkSkies21: shows [6c 6h] (two pair, Eights and Sixes)
teamcucha10: shows [Th Tc] (a full house, Tens full of Eights)
teamcucha10 collected 47468 from pot
DarkSkies21 finished the tournament in 108th place
*** SUMMARY ***
Total pot 47468 | Rake 0 
Board [8s 5c 8h Td 3s]
Seat 1: sanatamaria (button) folded before Flop (didn't bet)
Seat 3: jessecesar (small blind) folded before Flop
Seat 4: DarkSkies21 (big blind) showed [6c 6h] and lost with two pair, Eights and Sixes
Seat 5: leocir25 folded before Flop (didn't bet)
Seat 6: teamcucha10 showed [Th Tc] and won (47468) with a full house, Tens full of Eights

PokerStars Hand #251209833374: Tournament #3769361908, $52.38+$2.62 USD Hold'em No Limit - Level XVII (1000/2000) - 2024/06/26 22:50:39 UTC [2024/06/26 18:50:39 ET]
Table '3769361908 13' 6-max Seat #3 is the button
Seat 1: sanatamaria (28249 in chips) 
Seat 2: MezuuÜuuT (12800 in chips) 
Seat 3: jessecesar (19905 in chips) 
Seat 5: leocir25 (59695 in chips) 
Seat 6: teamcucha10 (80648 in chips) 
sanatamaria: posts the ante 500
MezuuÜuuT: posts the ante 500
jessecesar: posts the ante 500
leocir25: posts the ante 500
teamcucha10: posts the ante 500
leocir25: posts small blind 1000
teamcucha10: posts big blind 2000
*** HOLE CARDS ***
sanatamaria: folds 
MezuuÜuuT: raises 10300 to 12300 and is all-in
jessecesar: folds 
leocir25: folds 
teamcucha10: folds 
Uncalled bet (10300) returned to MezuuÜuuT
MezuuÜuuT collected 7500 from pot
MezuuÜuuT: doesn't show hand 
*** SUMMARY ***
Total pot 7500 | Rake 0 
Seat 1: sanatamaria folded before Flop (didn't bet)
Seat 2: MezuuÜuuT collected (7500)
Seat 3: jessecesar (button) folded before Flop (didn't bet)
Seat 5: leocir25 (small blind) folded before Flop
Seat 6: teamcucha10 (big blind) folded before Flop

PokerStars Hand #251209843086: Tournament #3769361908, $52.38+$2.62 USD Hold'em No Limit - Level XVII (1000/2000) - 2024/06/26 22:51:19 UTC [2024/06/26 18:51:19 ET]
Table '3769361908 13' 6-max Seat #5 is the button
Seat 1: sanatamaria (27749 in chips) 
Seat 2: MezuuÜuuT (17800 in chips) 
Seat 3: jessecesar (19405 in chips) 
Seat 5: leocir25 (58195 in chips) 
Seat 6: teamcucha10 (78148 in chips) 
sanatamaria: posts the ante 500
MezuuÜuuT: posts the ante 500
jessecesar: posts the ante 500
leocir25: posts the ante 500
teamcucha10: posts the ante 500
teamcucha10: posts small blind 1000
sanatamaria: posts big blind 2000
*** HOLE CARDS ***
Muringa.SP is disconnected 
MezuuÜuuT: folds 
jessecesar: raises 16905 to 18905 and is all-in
leocir25: folds 
teamcucha10: folds 
sanatamaria: folds 
Uncalled bet (16905) returned to jessecesar
jessecesar collected 7500 from pot
jessecesar: doesn't show hand 
*** SUMMARY ***
Total pot 7500 | Rake 0 
Seat 1: sanatamaria (big blind) folded before Flop
Seat 2: MezuuÜuuT folded before Flop (didn't bet)
Seat 3: jessecesar collected (7500)
Seat 5: leocir25 (button) folded before Flop (didn't bet)
Seat 6: teamcucha10 (small blind) folded before Flop

PokerStars Hand #251209850260: Tournament #3769361908, $52.38+$2.62 USD Hold'em No Limit - Level XVII (1000/2000) - 2024/06/26 22:51:48 UTC [2024/06/26 18:51:48 ET]
Table '3769361908 13' 6-max Seat #6 is the button
Seat 1: sanatamaria (25249 in chips) 
Seat 2: MezuuÜuuT (17300 in chips) 
Seat 3: jessecesar (24405 in chips) 
Seat 4: Muringa.SP (21875 in chips) 
Seat 5: leocir25 (57695 in chips) 
Seat 6: teamcucha10 (76648 in chips) 
sanatamaria: posts the ante 500
MezuuÜuuT: posts the ante 500
jessecesar: posts the ante 500
Muringa.SP: posts the ante 500
leocir25: posts the ante 500
teamcucha10: posts the ante 500
sanatamaria: posts small blind 1000
MezuuÜuuT: posts big blind 2000
*** HOLE CARDS ***
jessecesar: folds 
Muringa.SP: folds 
leocir25: raises 2000 to 4000
teamcucha10: folds 
sanatamaria: folds 
MezuuÜuuT: calls 2000
*** FLOP *** [Td 9h Th]
MezuuÜuuT: bets 12800 and is all-in
leocir25: calls 12800
*** TURN *** [Td 9h Th] [2s]
*** RIVER *** [Td 9h Th 2s] [4d]
*** SHOW DOWN ***
MezuuÜuuT: shows [7d Jh] (a pair of Tens)
leocir25: shows [6d Ad] (a pair of Tens - Ace kicker)
leocir25 collected 37600 from pot
MezuuÜuuT finished the tournament in 95th place
*** SUMMARY ***
Total pot 37600 | Rake 0 
Board [Td 9h Th 2s 4d]
Seat 1: sanatamaria (small blind) folded before Flop
Seat 2: MezuuÜuuT (big blind) showed [7d Jh] and lost with a pair of Tens
Seat 3: jessecesar folded before Flop (didn't bet)
Seat 4: Muringa.SP folded before Flop (didn't bet)
Seat 5: leocir25 showed [6d Ad] and won (37600) with a pair of Tens
Seat 6: teamcucha10 (button) folded before Flop (didn't bet)

PokerStars Hand #251209859743: Tournament #3769361908, $52.38+$2.62 USD Hold'em No Limit - Level XVII (1000/2000) - 2024/06/26 22:52:27 UTC [2024/06/26 18:52:27 ET]
Table '3769361908 13' 6-max Seat #1 is the button
Seat 1: sanatamaria (23749 in chips) 
Seat 3: jessecesar (23905 in chips) 
Seat 4: Muringa.SP (21375 in chips) 
Seat 5: leocir25 (77995 in chips) 
Seat 6: teamcucha10 (76148 in chips) 
sanatamaria: posts the ante 500
jessecesar: posts the ante 500
Muringa.SP: posts the ante 500
leocir25: posts the ante 500
teamcucha10: posts the ante 500
jessecesar: posts small blind 1000
Muringa.SP: posts big blind 2000
*** HOLE CARDS ***
leocir25: raises 2000 to 4000
teamcucha10: folds 
podiiii is disconnected 
sanatamaria: folds 
jessecesar: folds 
Muringa.SP: calls 2000
*** FLOP *** [7d 2c 4h]
Muringa.SP: checks 
leocir25: checks 
*** TURN *** [7d 2c 4h] [Ac]
Muringa.SP: checks 
leocir25: checks 
*** RIVER *** [7d 2c 4h Ac] [Jd]
Muringa.SP: checks 
leocir25: checks 
*** SHOW DOWN ***
Muringa.SP: shows [9s Qh] (high card Ace)
leocir25: shows [3s 3h] (a pair of Threes)
leocir25 collected 11500 from pot
*** SUMMARY ***
Total pot 11500 | Rake 0 
Board [7d 2c 4h Ac Jd]
Seat 1: sanatamaria (button) folded before Flop (didn't bet)
Seat 3: jessecesar (small blind) folded before Flop
Seat 4: Muringa.SP (big blind) showed [9s Qh] and lost with high card Ace
Seat 5: leocir25 showed [3s 3h] and won (11500) with a pair of Threes
Seat 6: teamcucha10 folded before Flop (didn't bet)

PokerStars Hand #251209873515: Tournament #3769361908, $52.38+$2.62 USD Hold'em No Limit - Level XVIII (1200/2400) - 2024/06/26 22:53:23 UTC [2024/06/26 18:53:23 ET]
Table '3769361908 13' 6-max Seat #3 is the button
Seat 1: sanatamaria (23249 in chips) 
Seat 2: podiiii (29236 in chips) 
Seat 3: jessecesar (22405 in chips) 
Seat 4: Muringa.SP (16875 in chips) 
Seat 5: leocir25 (84995 in chips) 
Seat 6: teamcucha10 (75648 in chips) 
sanatamaria: posts the ante 600
podiiii: posts the ante 600
jessecesar: posts the ante 600
Muringa.SP: posts the ante 600
leocir25: posts the ante 600
teamcucha10: posts the ante 600
Muringa.SP: posts small blind 1200
leocir25: posts big blind 2400
*** HOLE CARDS ***
teamcucha10: folds 
sanatamaria: folds 
podiiii: folds 
jessecesar: folds 
Muringa.SP: raises 13875 to 16275 and is all-in
leocir25: calls 13875
*** FLOP *** [8d Qs Td]
*** TURN *** [8d Qs Td] [8h]
*** RIVER *** [8d Qs Td 8h] [3d]
*** SHOW DOWN ***
Muringa.SP: shows [4s Ts] (two pair, Tens and Eights)
leocir25: shows [Qh 9s] (two pair, Queens and Eights)
leocir25 collected 36150 from pot
Muringa.SP finished the tournament in 85th place
*** SUMMARY ***
Total pot 36150 | Rake 0 
Board [8d Qs Td 8h 3d]
Seat 1: sanatamaria folded before Flop (didn't bet)
Seat 2: podiiii folded before Flop (didn't bet)
Seat 3: jessecesar (button) folded before Flop (didn't bet)
Seat 4: Muringa.SP (small blind) showed [4s Ts] and lost with two pair, Tens and Eights
Seat 5: leocir25 (big blind) showed [Qh 9s] and won (36150) with two pair, Queens and Eights
Seat 6: teamcucha10 folded before Flop (didn't bet)


PokerStars Hand #251209502112: Tournament #3769361908, $52.38+$2.62 USD Hold'em No Limit - Level X (200/400) - 2024/06/26 22:29:37 UTC [2024/06/26 18:29:37 ET]
Table '3769361908 12' 6-max Seat #4 is the button
Seat 1: Baca4b (18647 in chips) 
Seat 2: lamer0k (4470 in chips) 
Seat 3: Tom_Poker_NL (11767 in chips) 
Seat 4: jvieiradias8 (19635 in chips) 
Seat 5: MPB2502 (5372 in chips) 
Seat 6: goshaleg (9850 in chips) 
Baca4b: posts the ante 100
lamer0k: posts the ante 100
Tom_Poker_NL: posts the ante 100
jvieiradias8: posts the ante 100
MPB2502: posts the ante 100
goshaleg: posts the ante 100
MPB2502: posts small blind 200
goshaleg: posts big blind 400
*** HOLE CARDS ***
Baca4b: raises 400 to 800
lamer0k: folds 
Tom_Poker_NL: folds 
jvieiradias8: folds 
MPB2502: raises 4472 to 5272 and is all-in
goshaleg: folds 
Baca4b: folds 
Uncalled bet (4472) returned to MPB2502
MPB2502 collected 2600 from pot
MPB2502: doesn't show hand 
*** SUMMARY ***
Total pot 2600 | Rake 0 
Seat 1: Baca4b folded before Flop
Seat 2: lamer0k folded before Flop (didn't bet)
Seat 3: Tom_Poker_NL folded before Flop (didn't bet)
Seat 4: jvieiradias8 (button) folded before Flop (didn't bet)
Seat 5: MPB2502 (small blind) collected (2600)
Seat 6: goshaleg (big blind) folded before Flop

PokerStars Hand #251209512976: Tournament #3769361908, $52.38+$2.62 USD Hold'em No Limit - Level X (200/400) - 2024/06/26 22:30:16 UTC [2024/06/26 18:30:16 ET]
Table '3769361908 12' 6-max Seat #5 is the button
Seat 1: Baca4b (17747 in chips) 
Seat 2: lamer0k (4370 in chips) 
Seat 3: Tom_Poker_NL (11667 in chips) 
Seat 4: jvieiradias8 (19535 in chips) 
Seat 5: MPB2502 (7072 in chips) 
Seat 6: goshaleg (9350 in chips) 
Baca4b: posts the ante 100
lamer0k: posts the ante 100
Tom_Poker_NL: posts the ante 100
jvieiradias8: posts the ante 100
MPB2502: posts the ante 100
goshaleg: posts the ante 100
goshaleg: posts small blind 200
Baca4b: posts big blind 400
*** HOLE CARDS ***
lamer0k: folds 
Tom_Poker_NL: raises 400 to 800
jvieiradias8: folds 
MPB2502: folds 
goshaleg: folds 
Baca4b: raises 1800 to 2600
Tom_Poker_NL: calls 1800
*** FLOP *** [Kc 3h 7d]
Baca4b: bets 1000
Tom_Poker_NL: calls 1000
*** TURN *** [Kc 3h 7d] [4c]
Baca4b: bets 2400
Tom_Poker_NL: folds 
Uncalled bet (2400) returned to Baca4b
Baca4b collected 8000 from pot
Baca4b: doesn't show hand 
*** SUMMARY ***
Total pot 8000 | Rake 0 
Board [Kc 3h 7d 4c]
Seat 1: Baca4b (big blind) collected (8000)
Seat 2: lamer0k folded before Flop (didn't bet)
Seat 3: Tom_Poker_NL folded on the Turn
Seat 4: jvieiradias8 folded before Flop (didn't bet)
Seat 5: MPB2502 (button) folded before Flop (didn't bet)
Seat 6: goshaleg (small blind) folded before Flop

PokerStars Hand #251209535856: Tournament #3769361908, $52.38+$2.62 USD Hold'em No Limit - Level X (200/400) - 2024/06/26 22:31:40 UTC [2024/06/26 18:31:40 ET]
Table '3769361908 12' 6-max Seat #6 is the button
Seat 1: Baca4b (22047 in chips) 
Seat 2: lamer0k (4270 in chips) 
Seat 3: Tom_Poker_NL (7967 in chips) 
Seat 4: jvieiradias8 (19435 in chips) 
Seat 5: MPB2502 (6972 in chips) 
Seat 6: goshaleg (9050 in chips) 
Baca4b: posts the ante 100
lamer0k: posts the ante 100
Tom_Poker_NL: posts the ante 100
jvieiradias8: posts the ante 100
MPB2502: posts the ante 100
goshaleg: posts the ante 100
Baca4b: posts small blind 200
lamer0k: posts big blind 400
*** HOLE CARDS ***
Tom_Poker_NL: folds 
jvieiradias8: raises 400 to 800
MPB2502: folds 
goshaleg: folds 
Baca4b: folds 
lamer0k: calls 400
*** FLOP *** [4s Jd Qd]
lamer0k: checks 
jvieiradias8: bets 600
lamer0k: raises 2770 to 3370 and is all-in
jvieiradias8: calls 2770
*** TURN *** [4s Jd Qd] [5d]
*** RIVER *** [4s Jd Qd 5d] [6s]
*** SHOW DOWN ***
lamer0k: shows [Kd 6d] (a flush, King high)
jvieiradias8: shows [9s Js] (a pair of Jacks)
lamer0k collected 9140 from pot
*** SUMMARY ***
Total pot 9140 | Rake 0 
Board [4s Jd Qd 5d 6s]
Seat 1: Baca4b (small blind) folded before Flop
Seat 2: lamer0k (big blind) showed [Kd 6d] and won (9140) with a flush, King high
Seat 3: Tom_Poker_NL folded before Flop (didn't bet)
Seat 4: jvieiradias8 showed [9s Js] and lost with a pair of Jacks
Seat 5: MPB2502 folded before Flop (didn't bet)
Seat 6: goshaleg (button) folded before Flop (didn't bet)

PokerStars Hand #251209558219: Tournament #3769361908, $52.38+$2.62 USD Hold'em No Limit - Level XI (250/500) - 2024/06/26 22:33:02 UTC [2024/06/26 18:33:02 ET]
Table '3769361908 12' 6-max Seat #1 is the button
Seat 1: Baca4b (21747 in chips) 
Seat 2: lamer0k (9140 in chips) 
Seat 3: Tom_Poker_NL (7867 in chips) 
Seat 4: jvieiradias8 (15165 in chips) 
Seat 5: MPB2502 (6872 in chips) 
Seat 6: goshaleg (8950 in chips) 
Baca4b: posts the ante 125
lamer0k: posts the ante 125
Tom_Poker_NL: posts the ante 125
jvieiradias8: posts the ante 125
MPB2502: posts the ante 125
goshaleg: posts the ante 125
lamer0k: posts small blind 250
Tom_Poker_NL: posts big blind 500
*** HOLE CARDS ***
jvieiradias8: raises 500 to 1000
MPB2502: folds 
goshaleg: folds 
Baca4b: folds 
lamer0k: calls 750
Tom_Poker_NL: calls 500
*** FLOP *** [Jh 3d Kh]
lamer0k: checks 
Tom_Poker_NL: checks 
jvieiradias8: bets 1240
lamer0k: calls 1240
Tom_Poker_NL: folds 
*** TURN *** [Jh 3d Kh] [Qc]
lamer0k: checks 
jvieiradias8: bets 2565
lamer0k: raises 4210 to 6775 and is all-in
jvieiradias8: calls 4210
*** RIVER *** [Jh 3d Kh Qc] [6c]
*** SHOW DOWN ***
lamer0k: shows [Qd Ah] (a pair of Queens)
jvieiradias8: shows [Kc Td] (a pair of Kings)
jvieiradias8 collected 19780 from pot
lamer0k finished the tournament
*** SUMMARY ***
Total pot 19780 | Rake 0 
Board [Jh 3d Kh Qc 6c]
Seat 1: Baca4b (button) folded before Flop (didn't bet)
Seat 2: lamer0k (small blind) showed [Qd Ah] and lost with a pair of Queens
Seat 3: Tom_Poker_NL (big blind) folded on the Flop
Seat 4: jvieiradias8 showed [Kc Td] and won (19780) with a pair of Kings
Seat 5: MPB2502 folded before Flop (didn't bet)
Seat 6: goshaleg folded before Flop (didn't bet)

PokerStars Hand #251209580694: Tournament #3769361908, $52.38+$2.62 USD Hold'em No Limit - Level XI (250/500) - 2024/06/26 22:34:25 UTC [2024/06/26 18:34:25 ET]
Table '3769361908 12' 6-max Seat #3 is the button
Seat 1: Baca4b (21622 in chips) 
Seat 3: Tom_Poker_NL (6742 in chips) 
Seat 4: jvieiradias8 (25805 in chips) 
Seat 5: MPB2502 (6747 in chips) 
Seat 6: goshaleg (8825 in chips) 
Baca4b: posts the ante 125
Tom_Poker_NL: posts the ante 125
jvieiradias8: posts the ante 125
MPB2502: posts the ante 125
goshaleg: posts the ante 125
jvieiradias8: posts small blind 250
MPB2502: posts big blind 500
*** HOLE CARDS ***
goshaleg: folds 
Baca4b: folds 
Tom_Poker_NL: folds 
jvieiradias8: raises 25180 to 25680 and is all-in
MPB2502: calls 6122 and is all-in
Uncalled bet (19058) returned to jvieiradias8
*** FLOP *** [5c Th Jd]
*** TURN *** [5c Th Jd] [Kh]
*** RIVER *** [5c Th Jd Kh] [4c]
*** SHOW DOWN ***
jvieiradias8: shows [7h Kd] (a pair of Kings)
MPB2502: shows [Qs Td] (a pair of Tens)
jvieiradias8 collected 13869 from pot
MPB2502 finished the tournament
*** SUMMARY ***
Total pot 13869 | Rake 0 
Board [5c Th Jd Kh 4c]
Seat 1: Baca4b folded before Flop (didn't bet)
Seat 3: Tom_Poker_NL (button) folded before Flop (didn't bet)
Seat 4: jvieiradias8 (small blind) showed [7h Kd] and won (13869) with a pair of Kings
Seat 5: MPB2502 (big blind) showed [Qs Td] and lost with a pair of Tens
Seat 6: goshaleg folded before Flop (didn't bet)

PokerStars Hand #251209589312: Tournament #3769361908, $52.38+$2.62 USD Hold'em No Limit - Level XI (250/500) - 2024/06/26 22:34:57 UTC [2024/06/26 18:34:57 ET]
Table '3769361908 12' 6-max Seat #4 is the button
Seat 1: Baca4b (21497 in chips) 
Seat 3: Tom_Poker_NL (6617 in chips) 
Seat 4: jvieiradias8 (32927 in chips) 
Seat 6: goshaleg (8700 in chips) 
Baca4b: posts the ante 125
Tom_Poker_NL: posts the ante 125
jvieiradias8: posts the ante 125
goshaleg: posts the ante 125
goshaleg: posts small blind 250
Baca4b: posts big blind 500
*** HOLE CARDS ***
RenALLiin is disconnected 
Tom_Poker_NL: folds 
jvieiradias8: folds 
goshaleg: folds 
Uncalled bet (250) returned to Baca4b
Baca4b collected 1000 from pot
Baca4b: doesn't show hand 
*** SUMMARY ***
Total pot 1000 | Rake 0 
Seat 1: Baca4b (big blind) collected (1000)
Seat 3: Tom_Poker_NL folded before Flop (didn't bet)
Seat 4: jvieiradias8 (button) folded before Flop (didn't bet)
Seat 6: goshaleg (small blind) folded before Flop

PokerStars Hand #251209594411: Tournament #3769361908, $52.38+$2.62 USD Hold'em No Limit - Level XII (300/600) - 2024/06/26 22:35:16 UTC [2024/06/26 18:35:16 ET]
Table '3769361908 12' 6-max Seat #6 is the button
Seat 1: Baca4b (22122 in chips) 
Seat 2: RenALLiin (13125 in chips) 
Seat 3: Tom_Poker_NL (6492 in chips) 
Seat 4: jvieiradias8 (32802 in chips) 
Seat 6: goshaleg (8325 in chips) 
Baca4b: posts the ante 150
RenALLiin: posts the ante 150
Tom_Poker_NL: posts the ante 150
jvieiradias8: posts the ante 150
goshaleg: posts the ante 150
Baca4b: posts small blind 300
RenALLiin: posts big blind 600
*** HOLE CARDS ***
Tom_Poker_NL: raises 5742 to 6342 and is all-in
jvieiradias8: raises 26310 to 32652 and is all-in
goshaleg: folds 
Baca4b: folds 
RenALLiin: folds 
Uncalled bet (26310) returned to jvieiradias8
*** FLOP *** [As 8d Jd]
*** TURN *** [As 8d Jd] [6d]
*** RIVER *** [As 8d Jd 6d] [7s]
*** SHOW DOWN ***
Tom_Poker_NL: shows [Jh Qd] (a pair of Jacks)
jvieiradias8: shows [7c 7d] (three of a kind, Sevens)
jvieiradias8 collected 14334 from pot
Tom_Poker_NL finished the tournament
*** SUMMARY ***
Total pot 14334 | Rake 0 
Board [As 8d Jd 6d 7s]
Seat 1: Baca4b (small blind) folded before Flop
Seat 2: RenALLiin (big blind) folded before Flop
Seat 3: Tom_Poker_NL showed [Jh Qd] and lost with a pair of Jacks
Seat 4: jvieiradias8 showed [7c 7d] and won (14334) with three of a kind, Sevens
Seat 6: goshaleg (button) folded before Flop (didn't bet)

PokerStars Hand #251209601707: Tournament #3769361908, $52.38+$2.62 USD Hold'em No Limit - Level XII (300/600) - 2024/06/26 22:35:43 UTC [2024/06/26 18:35:43 ET]
Table '3769361908 12' 6-max Seat #1 is the button
Seat 1: Baca4b (21672 in chips) 
Seat 2: RenALLiin (12375 in chips) 
Seat 4: jvieiradias8 (40644 in chips) 
Seat 6: goshaleg (8175 in chips) 
Baca4b: posts the ante 150
RenALLiin: posts the ante 150
jvieiradias8: posts the ante 150
goshaleg: posts the ante 150
RenALLiin: posts small blind 300
jvieiradias8: posts big blind 600
*** HOLE CARDS ***
LadyLuke2010 is disconnected 
goshaleg: folds 
Baca4b: folds 
RenALLiin: raises 11625 to 12225 and is all-in
jvieiradias8: folds 
Uncalled bet (11625) returned to RenALLiin
Scorgiej is disconnected 
RenALLiin collected 1800 from pot
RenALLiin: doesn't show hand 
*** SUMMARY ***
Total pot 1800 | Rake 0 
Seat 1: Baca4b (button) folded before Flop (didn't bet)
Seat 2: RenALLiin (small blind) collected (1800)
Seat 4: jvieiradias8 (big blind) folded before Flop
Seat 6: goshaleg folded before Flop (didn't bet)

PokerStars Hand #251209608988: Tournament #3769361908, $52.38+$2.62 USD Hold'em No Limit - Level XII (300/600) - 2024/06/26 22:36:10 UTC [2024/06/26 18:36:10 ET]
Table '3769361908 12' 6-max Seat #2 is the button
Seat 1: Baca4b (21522 in chips) 
Seat 2: RenALLiin (13425 in chips) 
Seat 3: LadyLuke2010 (5350 in chips) out of hand (moved from another table into small blind)
Seat 4: jvieiradias8 (39894 in chips) 
Seat 5: Scorgiej (9975 in chips) 
Seat 6: goshaleg (8025 in chips) 
LadyLuke2010 will be allowed to play after the button
Baca4b: posts the ante 150
RenALLiin: posts the ante 150
jvieiradias8: posts the ante 150
Scorgiej: posts the ante 150
goshaleg: posts the ante 150
jvieiradias8: posts small blind 300
Scorgiej: posts big blind 600
*** HOLE CARDS ***
goshaleg: raises 7275 to 7875 and is all-in
Baca4b: folds 
RenALLiin: folds 
jvieiradias8: folds 
Scorgiej: folds 
Uncalled bet (7275) returned to goshaleg
goshaleg collected 2250 from pot
goshaleg: doesn't show hand 
*** SUMMARY ***
Total pot 2250 | Rake 0 
Seat 1: Baca4b folded before Flop (didn't bet)
Seat 2: RenALLiin (button) folded before Flop (didn't bet)
Seat 4: jvieiradias8 (small blind) folded before Flop
Seat 5: Scorgiej (big blind) folded before Flop
Seat 6: goshaleg collected (2250)

PokerStars Hand #251209613544: Tournament #3769361908, $52.38+$2.62 USD Hold'em No Limit - Level XII (300/600) - 2024/06/26 22:36:27 UTC [2024/06/26 18:36:27 ET]
Table '3769361908 12' 6-max Seat #4 is the button
Seat 1: Baca4b (21372 in chips) 
Seat 2: RenALLiin (13275 in chips) 
Seat 3: LadyLuke2010 (5350 in chips) 
Seat 4: jvieiradias8 (39444 in chips) 
Seat 5: Scorgiej (9225 in chips) 
Seat 6: goshaleg (9525 in chips) 
Baca4b: posts the ante 150
RenALLiin: posts the ante 150
LadyLuke2010: posts the ante 150
jvieiradias8: posts the ante 150
Scorgiej: posts the ante 150
goshaleg: posts the ante 150
Scorgiej: posts small blind 300
goshaleg: posts big blind 600
*** HOLE CARDS ***
Baca4b: folds 
RenALLiin: folds 
LadyLuke2010: raises 4600 to 5200 and is all-in
jvieiradias8: folds 
Scorgiej: folds 
goshaleg: calls 4600
*** FLOP *** [9c 6c Td]
*** TURN *** [9c 6c Td] [2d]
*** RIVER *** [9c 6c Td 2d] [Ts]
*** SHOW DOWN ***
goshaleg: shows [4d 4c] (two pair, Tens and Fours)
LadyLuke2010: shows [Qh Ac] (a pair of Tens)
goshaleg collected 11600 from pot
LadyLuke2010 finished the tournament
*** SUMMARY ***
Total pot 11600 | Rake 0 
Board [9c 6c Td 2d Ts]
Seat 1: Baca4b folded before Flop (didn't bet)
Seat 2: RenALLiin folded before Flop (didn't bet)
Seat 3: LadyLuke2010 showed [Qh Ac] and lost with a pair of Tens
Seat 4: jvieiradias8 (button) folded before Flop (didn't bet)
Seat 5: Scorgiej (small blind) folded before Flop
Seat 6: goshaleg (big blind) showed [4d 4c] and won (11600) with two pair, Tens and Fours

PokerStars Hand #251209619547: Tournament #3769361908, $52.38+$2.62 USD Hold'em No Limit - Level XII (300/600) - 2024/06/26 22:36:50 UTC [2024/06/26 18:36:50 ET]
Table '3769361908 12' 6-max Seat #5 is the button
Seat 1: Baca4b (21222 in chips) 
Seat 2: RenALLiin (13125 in chips) 
Seat 4: jvieiradias8 (39294 in chips) 
Seat 5: Scorgiej (8775 in chips) 
Seat 6: goshaleg (15775 in chips) 
Baca4b: posts the ante 150
RenALLiin: posts the ante 150
jvieiradias8: posts the ante 150
Scorgiej: posts the ante 150
goshaleg: posts the ante 150
goshaleg: posts small blind 300
Baca4b: posts big blind 600
*** HOLE CARDS ***
RenALLiin: folds 
LadyLuke2010 is disconnected 
jvieiradias8: folds 
Scorgiej: raises 8025 to 8625 and is all-in
goshaleg: folds 
Baca4b: folds 
Uncalled bet (8025) returned to Scorgiej
Scorgiej collected 2250 from pot
Scorgiej: doesn't show hand 
*** SUMMARY ***
Total pot 2250 | Rake 0 
Seat 1: Baca4b (big blind) folded before Flop
Seat 2: RenALLiin folded before Flop (didn't bet)
Seat 4: jvieiradias8 folded before Flop (didn't bet)
Seat 5: Scorgiej (button) collected (2250)
Seat 6: goshaleg (small blind) folded before Flop

PokerStars Hand #251209623747: Tournament #3769361908, $52.38+$2.62 USD Hold'em No Limit - Level XII (300/600) - 2024/06/26 22:37:06 UTC [2024/06/26 18:37:06 ET]
Table '3769361908 12' 6-max Seat #6 is the button
Seat 1: Baca4b (20472 in chips) 
Seat 2: RenALLiin (12975 in chips) 
Seat 3: LadyLuke2010 (10000 in chips) 
Seat 4: jvieiradias8 (39144 in chips) 
Seat 5: Scorgiej (10275 in chips) 
Seat 6: goshaleg (15325 in chips) 
Baca4b: posts the ante 150
RenALLiin: posts the ante 150
LadyLuke2010: posts the ante 150
jvieiradias8: posts the ante 150
Scorgiej: posts the ante 150
goshaleg: posts the ante 150
Baca4b: posts small blind 300
RenALLiin: posts big blind 600
*** HOLE CARDS ***
LadyLuke2010: folds 
jvieiradias8: folds 
Scorgiej: raises 600 to 1200
goshaleg: folds 
Baca4b: folds 
RenALLiin: calls 600
*** FLOP *** [7s Ts 4d]
RenALLiin: checks 
Scorgiej: checks 
*** TURN *** [7s Ts 4d] [Jd]
RenALLiin: bets 1188
Scorgiej: calls 1188
*** RIVER *** [7s Ts 4d Jd] [2d]
RenALLiin: bets 1494
Scorgiej: calls 1494
*** SHOW DOWN ***
RenALLiin: shows [Td Qs] (a pair of Tens)
Scorgiej: mucks hand 
RenALLiin collected 8964 from pot
*** SUMMARY ***
Total pot 8964 | Rake 0 
Board [7s Ts 4d Jd 2d]
Seat 1: Baca4b (small blind) folded before Flop
Seat 2: RenALLiin (big blind) showed [Td Qs] and won (8964) with a pair of Tens
Seat 3: LadyLuke2010 folded before Flop (didn't bet)
Seat 4: jvieiradias8 folded before Flop (didn't bet)
Seat 5: Scorgiej mucked
Seat 6: goshaleg (button) folded before Flop (didn't bet)

PokerStars Hand #251209637143: Tournament #3769361908, $52.38+$2.62 USD Hold'em No Limit - Level XII (300/600) - 2024/06/26 22:37:56 UTC [2024/06/26 18:37:56 ET]
Table '3769361908 12' 6-max Seat #1 is the button
Seat 1: Baca4b (20022 in chips) 
Seat 2: RenALLiin (17907 in chips) 
Seat 3: LadyLuke2010 (9850 in chips) 
Seat 4: jvieiradias8 (38994 in chips) 
Seat 5: Scorgiej (6243 in chips) 
Seat 6: goshaleg (15175 in chips) 
Baca4b: posts the ante 150
RenALLiin: posts the ante 150
LadyLuke2010: posts the ante 150
jvieiradias8: posts the ante 150
Scorgiej: posts the ante 150
goshaleg: posts the ante 150
RenALLiin: posts small blind 300
LadyLuke2010: posts big blind 600
*** HOLE CARDS ***
jvieiradias8: folds 
Scorgiej: folds 
goshaleg: raises 600 to 1200
Baca4b: folds 
RenALLiin: raises 16557 to 17757 and is all-in
LadyLuke2010: folds 
goshaleg: folds 
Uncalled bet (16557) returned to RenALLiin
RenALLiin collected 3900 from pot
RenALLiin: doesn't show hand 
*** SUMMARY ***
Total pot 3900 | Rake 0 
Seat 1: Baca4b (button) folded before Flop (didn't bet)
Seat 2: RenALLiin (small blind) collected (3900)
Seat 3: LadyLuke2010 (big blind) folded before Flop
Seat 4: jvieiradias8 folded before Flop (didn't bet)
Seat 5: Scorgiej folded before Flop (didn't bet)
Seat 6: goshaleg folded before Flop

PokerStars Hand #251209646366: Tournament #3769361908, $52.38+$2.62 USD Hold'em No Limit - Level XIII (400/800) - 2024/06/26 22:38:30 UTC [2024/06/26 18:38:30 ET]
Table '3769361908 12' 6-max Seat #2 is the button
Seat 1: Baca4b (19872 in chips) 
Seat 2: RenALLiin (20457 in chips) 
Seat 3: LadyLuke2010 (9100 in chips) 
Seat 4: jvieiradias8 (38844 in chips) 
Seat 5: Scorgiej (6093 in chips) 
Seat 6: goshaleg (13825 in chips) 
Baca4b: posts the ante 200
RenALLiin: posts the ante 200
LadyLuke2010: posts the ante 200
jvieiradias8: posts the ante 200
Scorgiej: posts the ante 200
goshaleg: posts the ante 200
LadyLuke2010: posts small blind 400
jvieiradias8: posts big blind 800
*** HOLE CARDS ***
Scorgiej: folds 
goshaleg: calls 800
Baca4b: folds 
RenALLiin: calls 800
LadyLuke2010: calls 400
jvieiradias8: raises 4000 to 4800
goshaleg: folds 
RenALLiin: folds 
LadyLuke2010: folds 
Uncalled bet (4000) returned to jvieiradias8
jvieiradias8 collected 4400 from pot
jvieiradias8: doesn't show hand 
*** SUMMARY ***
Total pot 4400 | Rake 0 
Seat 1: Baca4b folded before Flop (didn't bet)
Seat 2: RenALLiin (button) folded before Flop
Seat 3: LadyLuke2010 (small blind) folded before Flop
Seat 4: jvieiradias8 (big blind) collected (4400)
Seat 5: Scorgiej folded before Flop (didn't bet)
Seat 6: goshaleg folded before Flop

PokerStars Hand #251209661136: Tournament #3769361908, $52.38+$2.62 USD Hold'em No Limit - Level XIII (400/800) - 2024/06/26 22:39:26 UTC [2024/06/26 18:39:26 ET]
Table '3769361908 12' 6-max Seat #4 is the button
Seat 1: Baca4b (19672 in chips) 
Seat 2: RenALLiin (19457 in chips) 
Seat 4: jvieiradias8 (42244 in chips) 
Seat 5: Scorgiej (5893 in chips) 
Seat 6: goshaleg (12825 in chips) 
Baca4b: posts the ante 200
RenALLiin: posts the ante 200
jvieiradias8: posts the ante 200
Scorgiej: posts the ante 200
goshaleg: posts the ante 200
Scorgiej: posts small blind 400
goshaleg: posts big blind 800
*** HOLE CARDS ***
Baca4b: folds 
Link_fNK is disconnected 
RenALLiin: raises 800 to 1600
jvieiradias8: calls 1600
Scorgiej: folds 
goshaleg: folds 
*** FLOP *** [3h 3s 6c]
RenALLiin: checks 
jvieiradias8: checks 
*** TURN *** [3h 3s 6c] [2c]
RenALLiin: bets 3564
jvieiradias8: calls 3564
*** RIVER *** [3h 3s 6c 2c] [Ks]
RenALLiin: bets 14093 and is all-in
jvieiradias8: folds 
Uncalled bet (14093) returned to RenALLiin
RenALLiin collected 12528 from pot
RenALLiin: doesn't show hand 
*** SUMMARY ***
Total pot 12528 | Rake 0 
Board [3h 3s 6c 2c Ks]
Seat 1: Baca4b folded before Flop (didn't bet)
Seat 2: RenALLiin collected (12528)
Seat 4: jvieiradias8 (button) folded on the River
Seat 5: Scorgiej (small blind) folded before Flop
Seat 6: goshaleg (big blind) folded before Flop

PokerStars Hand #251209678484: Tournament #3769361908, $52.38+$2.62 USD Hold'em No Limit - Level XIII (400/800) - 2024/06/26 22:40:31 UTC [2024/06/26 18:40:31 ET]
Table '3769361908 12' 6-max Seat #5 is the button
Seat 1: Baca4b (19472 in chips) 
Seat 2: RenALLiin (26621 in chips) 
Seat 3: Link_fNK (16806 in chips) 
Seat 4: jvieiradias8 (36880 in chips) 
Seat 5: Scorgiej (5293 in chips) 
Seat 6: goshaleg (11825 in chips) 
Baca4b: posts the ante 200
RenALLiin: posts the ante 200
Link_fNK: posts the ante 200
jvieiradias8: posts the ante 200
Scorgiej: posts the ante 200
goshaleg: posts the ante 200
goshaleg: posts small blind 400
Baca4b: posts big blind 800
*** HOLE CARDS ***
RenALLiin: folds 
Link_fNK: folds 
jvieiradias8: folds 
Scorgiej: folds 
goshaleg: calls 400
Baca4b: checks 
*** FLOP *** [Js 2d Td]
goshaleg: checks 
Baca4b: bets 800
goshaleg: folds 
Uncalled bet (800) returned to Baca4b
Baca4b collected 2800 from pot
Baca4b: doesn't show hand 
*** SUMMARY ***
Total pot 2800 | Rake 0 
Board [Js 2d Td]
Seat 1: Baca4b (big blind) collected (2800)
Seat 2: RenALLiin folded before Flop (didn't bet)
Seat 3: Link_fNK folded before Flop (didn't bet)
Seat 4: jvieiradias8 folded before Flop (didn't bet)
Seat 5: Scorgiej (button) folded before Flop (didn't bet)
Seat 6: goshaleg (small blind) folded on the Flop

PokerStars Hand #251209687889: Tournament #3769361908, $52.38+$2.62 USD Hold'em No Limit - Level XIII (400/800) - 2024/06/26 22:41:08 UTC [2024/06/26 18:41:08 ET]
Table '3769361908 12' 6-max Seat #6 is the button
Seat 1: Baca4b (21272 in chips) 
Seat 2: RenALLiin (26421 in chips) 
Seat 3: Link_fNK (16606 in chips) 
Seat 4: jvieiradias8 (36680 in chips) 
Seat 5: Scorgiej (5093 in chips) 
Seat 6: goshaleg (10825 in chips) 
Baca4b: posts the ante 200
RenALLiin: posts the ante 200
Link_fNK: posts the ante 200
jvieiradias8: posts the ante 200
Scorgiej: posts the ante 200
goshaleg: posts the ante 200
Baca4b: posts small blind 400
RenALLiin: posts big blind 800
*** HOLE CARDS ***
Link_fNK: folds 
jvieiradias8: raises 800 to 1600
Scorgiej: folds 
goshaleg: folds 
Baca4b: folds 
RenALLiin: calls 800
*** FLOP *** [7c Jh 8c]
RenALLiin: checks 
jvieiradias8: checks 
*** TURN *** [7c Jh 8c] [6s]
RenALLiin: checks 
jvieiradias8: checks 
*** RIVER *** [7c Jh 8c 6s] [5s]
RenALLiin: bets 2400
jvieiradias8: folds 
Uncalled bet (2400) returned to RenALLiin
RenALLiin collected 4800 from pot
RenALLiin: doesn't show hand 
*** SUMMARY ***
Total pot 4800 | Rake 0 
Board [7c Jh 8c 6s 5s]
Seat 1: Baca4b (small blind) folded before Flop
Seat 2: RenALLiin (big blind) collected (4800)
Seat 3: Link_fNK folded before Flop (didn't bet)
Seat 4: jvieiradias8 folded on the River
Seat 5: Scorgiej folded before Flop (didn't bet)
Seat 6: goshaleg (button) folded before Flop (didn't bet)

PokerStars Hand #251209708806: Tournament #3769361908, $52.38+$2.62 USD Hold'em No Limit - Level XIV (500/1000) - 2024/06/26 22:42:28 UTC [2024/06/26 18:42:28 ET]
Table '3769361908 12' 6-max Seat #1 is the button
Seat 1: Baca4b (20672 in chips) 
Seat 2: RenALLiin (29421 in chips) 
Seat 3: Link_fNK (16406 in chips) 
Seat 4: jvieiradias8 (34880 in chips) 
Seat 5: Scorgiej (4893 in chips) 
Seat 6: goshaleg (10625 in chips) 
Baca4b: posts the ante 250
RenALLiin: posts the ante 250
Link_fNK: posts the ante 250
jvieiradias8: posts the ante 250
Scorgiej: posts the ante 250
goshaleg: posts the ante 250
RenALLiin: posts small blind 500
Link_fNK: posts big blind 1000
*** HOLE CARDS ***
jvieiradias8: folds 
Scorgiej: folds 
goshaleg: raises 9375 to 10375 and is all-in
Baca4b: folds 
RenALLiin: raises 9375 to 19750
Link_fNK: calls 15156 and is all-in
Uncalled bet (3594) returned to RenALLiin
*** FLOP *** [9h 5s 5c]
*** TURN *** [9h 5s 5c] [8d]
*** RIVER *** [9h 5s 5c 8d] [Jc]
*** SHOW DOWN ***
RenALLiin: shows [Ah Qd] (a pair of Fives)
Link_fNK: shows [Qh As] (a pair of Fives)
RenALLiin collected 5781 from side pot
Link_fNK collected 5781 from side pot
goshaleg: shows [Ks 8s] (two pair, Eights and Fives)
goshaleg collected 32625 from main pot
*** SUMMARY ***
Total pot 44187 Main pot 32625. Side pot 11562. | Rake 0 
Board [9h 5s 5c 8d Jc]
Seat 1: Baca4b (button) folded before Flop (didn't bet)
Seat 2: RenALLiin (small blind) showed [Ah Qd] and won (5781) with a pair of Fives
Seat 3: Link_fNK (big blind) showed [Qh As] and won (5781) with a pair of Fives
Seat 4: jvieiradias8 folded before Flop (didn't bet)
Seat 5: Scorgiej folded before Flop (didn't bet)
Seat 6: goshaleg showed [Ks 8s] and won (32625) with two pair, Eights and Fives

PokerStars Hand #251209717984: Tournament #3769361908, $52.38+$2.62 USD Hold'em No Limit - Level XIV (500/1000) - 2024/06/26 22:43:04 UTC [2024/06/26 18:43:04 ET]
Table '3769361908 12' 6-max Seat #2 is the button
Seat 1: Baca4b (20422 in chips) 
Seat 2: RenALLiin (18796 in chips) 
Seat 3: Link_fNK (5781 in chips) 
Seat 4: jvieiradias8 (34630 in chips) 
Seat 5: Scorgiej (4643 in chips) 
Seat 6: goshaleg (32625 in chips) 
Baca4b: posts the ante 250
RenALLiin: posts the ante 250
Link_fNK: posts the ante 250
jvieiradias8: posts the ante 250
Scorgiej: posts the ante 250
goshaleg: posts the ante 250
Link_fNK: posts small blind 500
jvieiradias8: posts big blind 1000
*** HOLE CARDS ***
Scorgiej: raises 3393 to 4393 and is all-in
goshaleg: folds 
Baca4b: folds 
RenALLiin: folds 
Link_fNK: folds 
jvieiradias8: folds 
Uncalled bet (3393) returned to Scorgiej
Scorgiej collected 4000 from pot
Scorgiej: doesn't show hand 
*** SUMMARY ***
Total pot 4000 | Rake 0 
Seat 1: Baca4b folded before Flop (didn't bet)
Seat 2: RenALLiin (button) folded before Flop (didn't bet)
Seat 3: Link_fNK (small blind) folded before Flop
Seat 4: jvieiradias8 (big blind) folded before Flop
Seat 5: Scorgiej collected (4000)
Seat 6: goshaleg folded before Flop (didn't bet)

PokerStars Hand #251209723964: Tournament #3769361908, $52.38+$2.62 USD Hold'em No Limit - Level XIV (500/1000) - 2024/06/26 22:43:27 UTC [2024/06/26 18:43:27 ET]
Table '3769361908 12' 6-max Seat #3 is the button
Seat 1: Baca4b (20172 in chips) 
Seat 2: RenALLiin (18546 in chips) 
Seat 3: Link_fNK (5031 in chips) 
Seat 4: jvieiradias8 (33380 in chips) 
Seat 5: Scorgiej (7393 in chips) 
Seat 6: goshaleg (32375 in chips) 
Baca4b: posts the ante 250
RenALLiin: posts the ante 250
Link_fNK: posts the ante 250
jvieiradias8: posts the ante 250
Scorgiej: posts the ante 250
goshaleg: posts the ante 250
jvieiradias8: posts small blind 500
Scorgiej: posts big blind 1000
*** HOLE CARDS ***
goshaleg: folds 
Baca4b: folds 
RenALLiin: folds 
Link_fNK: raises 3781 to 4781 and is all-in
jvieiradias8: raises 3781 to 8562
Scorgiej: calls 6143 and is all-in
Uncalled bet (1419) returned to jvieiradias8
*** FLOP *** [7c 3s 3h]
*** TURN *** [7c 3s 3h] [7h]
*** RIVER *** [7c 3s 3h 7h] [Jd]
*** SHOW DOWN ***
jvieiradias8: shows [Qc 9c] (two pair, Sevens and Threes)
Scorgiej: shows [Ah Ad] (two pair, Aces and Sevens)
Scorgiej collected 4724 from side pot
Link_fNK: shows [6d Ac] (two pair, Sevens and Threes)
Scorgiej collected 15843 from main pot
Link_fNK finished the tournament
*** SUMMARY ***
Total pot 20567 Main pot 15843. Side pot 4724. | Rake 0 
Board [7c 3s 3h 7h Jd]
Seat 1: Baca4b folded before Flop (didn't bet)
Seat 2: RenALLiin folded before Flop (didn't bet)
Seat 3: Link_fNK (button) showed [6d Ac] and lost with two pair, Sevens and Threes
Seat 4: jvieiradias8 (small blind) showed [Qc 9c] and lost with two pair, Sevens and Threes
Seat 5: Scorgiej (big blind) showed [Ah Ad] and won (20567) with two pair, Aces and Sevens
Seat 6: goshaleg folded before Flop (didn't bet)

PokerStars Hand #251209730364: Tournament #3769361908, $52.38+$2.62 USD Hold'em No Limit - Level XIV (500/1000) - 2024/06/26 22:43:52 UTC [2024/06/26 18:43:52 ET]
Table '3769361908 12' 6-max Seat #4 is the button
Seat 1: Baca4b (19922 in chips) 
Seat 2: RenALLiin (18296 in chips) 
Seat 4: jvieiradias8 (25987 in chips) 
Seat 5: Scorgiej (20567 in chips) 
Seat 6: goshaleg (32125 in chips) 
Baca4b: posts the ante 250
RenALLiin: posts the ante 250
jvieiradias8: posts the ante 250
Scorgiej: posts the ante 250
goshaleg: posts the ante 250
Scorgiej: posts small blind 500
goshaleg: posts big blind 1000
*** HOLE CARDS ***
Baca4b: folds 
RenALLiin: folds 
jvieiradias8: raises 1000 to 2000
Scorgiej: raises 18317 to 20317 and is all-in
@tetaschell is disconnected 
goshaleg: folds 
jvieiradias8: calls 18317
*** FLOP *** [5c Js 6s]
*** TURN *** [5c Js 6s] [Qd]
*** RIVER *** [5c Js 6s Qd] [As]
*** SHOW DOWN ***
Scorgiej: shows [5s Ac] (two pair, Aces and Fives)
jvieiradias8: shows [7d 7s] (a pair of Sevens)
Scorgiej collected 42884 from pot
*** SUMMARY ***
Total pot 42884 | Rake 0 
Board [5c Js 6s Qd As]
Seat 1: Baca4b folded before Flop (didn't bet)
Seat 2: RenALLiin folded before Flop (didn't bet)
Seat 4: jvieiradias8 (button) showed [7d 7s] and lost with a pair of Sevens
Seat 5: Scorgiej (small blind) showed [5s Ac] and won (42884) with two pair, Aces and Fives
Seat 6: goshaleg (big blind) folded before Flop

PokerStars Hand #251209740627: Tournament #3769361908, $52.38+$2.62 USD Hold'em No Limit - Level XV (600/1200) - 2024/06/26 22:44:32 UTC [2024/06/26 18:44:32 ET]
Table '3769361908 12' 6-max Seat #5 is the button
Seat 1: Baca4b (19672 in chips) 
Seat 2: RenALLiin (18046 in chips) 
Seat 3: @tetaschell (10000 in chips) 
Seat 4: jvieiradias8 (5420 in chips) 
Seat 5: Scorgiej (42884 in chips) 
Seat 6: goshaleg (30875 in chips) 
Baca4b: posts the ante 300
RenALLiin: posts the ante 300
@tetaschell: posts the ante 300
jvieiradias8: posts the ante 300
Scorgiej: posts the ante 300
goshaleg: posts the ante 300
goshaleg: posts small blind 600
Baca4b: posts big blind 1200
*** HOLE CARDS ***
RenALLiin: folds 
@tetaschell: raises 8500 to 9700 and is all-in
jvieiradias8: folds 
Scorgiej: raises 32884 to 42584 and is all-in
goshaleg: folds 
Baca4b: folds 
Uncalled bet (32884) returned to Scorgiej
*** FLOP *** [4d 7h 8s]
*** TURN *** [4d 7h 8s] [Th]
*** RIVER *** [4d 7h 8s Th] [Js]
*** SHOW DOWN ***
@tetaschell: shows [Qh Qd] (a pair of Queens)
Scorgiej: shows [As Kd] (high card Ace)
@tetaschell collected 23000 from pot
*** SUMMARY ***
Total pot 23000 | Rake 0 
Board [4d 7h 8s Th Js]
Seat 1: Baca4b (big blind) folded before Flop
Seat 2: RenALLiin folded before Flop (didn't bet)
Seat 3: @tetaschell showed [Qh Qd] and won (23000) with a pair of Queens
Seat 4: jvieiradias8 folded before Flop (didn't bet)
Seat 5: Scorgiej (button) showed [As Kd] and lost with high card Ace
Seat 6: goshaleg (small blind) folded before Flop

PokerStars Hand #251209752025: Tournament #3769361908, $52.38+$2.62 USD Hold'em No Limit - Level XV (600/1200) - 2024/06/26 22:45:16 UTC [2024/06/26 18:45:16 ET]
Table '3769361908 12' 6-max Seat #6 is the button
Seat 1: Baca4b (18172 in chips) 
Seat 2: RenALLiin (17746 in chips) 
Seat 3: @tetaschell (23000 in chips) 
Seat 4: jvieiradias8 (5120 in chips) 
Seat 5: Scorgiej (32884 in chips) 
Seat 6: goshaleg (29975 in chips) 
Baca4b: posts the ante 300
RenALLiin: posts the ante 300
@tetaschell: posts the ante 300
jvieiradias8: posts the ante 300
Scorgiej: posts the ante 300
goshaleg: posts the ante 300
Baca4b: posts small blind 600
RenALLiin: posts big blind 1200
*** HOLE CARDS ***
@tetaschell: folds 
jvieiradias8: raises 3620 to 4820 and is all-in
Scorgiej: raises 27764 to 32584 and is all-in
goshaleg: folds 
Baca4b: folds 
RenALLiin: folds 
Uncalled bet (27764) returned to Scorgiej
*** FLOP *** [2s 2d Qc]
*** TURN *** [2s 2d Qc] [7d]
*** RIVER *** [2s 2d Qc 7d] [Tc]
*** SHOW DOWN ***
jvieiradias8: shows [Js Kd] (a pair of Deuces)
Scorgiej: shows [8h 8d] (two pair, Eights and Deuces)
Scorgiej collected 13240 from pot
jvieiradias8 finished the tournament
*** SUMMARY ***
Total pot 13240 | Rake 0 
Board [2s 2d Qc 7d Tc]
Seat 1: Baca4b (small blind) folded before Flop
Seat 2: RenALLiin (big blind) folded before Flop
Seat 3: @tetaschell folded before Flop (didn't bet)
Seat 4: jvieiradias8 showed [Js Kd] and lost with a pair of Deuces
Seat 5: Scorgiej showed [8h 8d] and won (13240) with two pair, Eights and Deuces
Seat 6: goshaleg (button) folded before Flop (didn't bet)

PokerStars Hand #251209763900: Tournament #3769361908, $52.38+$2.62 USD Hold'em No Limit - Level XV (600/1200) - 2024/06/26 22:46:02 UTC [2024/06/26 18:46:02 ET]
Table '3769361908 12' 6-max Seat #1 is the button
Seat 1: Baca4b (17272 in chips) 
Seat 2: RenALLiin (16246 in chips) 
Seat 3: @tetaschell (22700 in chips) 
Seat 5: Scorgiej (41004 in chips) 
Seat 6: goshaleg (29675 in chips) 
Baca4b: posts the ante 300
RenALLiin: posts the ante 300
@tetaschell: posts the ante 300
Scorgiej: posts the ante 300
goshaleg: posts the ante 300
RenALLiin: posts small blind 600
@tetaschell: posts big blind 1200
*** HOLE CARDS ***
Scorgiej: raises 1200 to 2400
goshaleg: folds 
Baca4b: folds 
RenALLiin: folds 
@tetaschell: calls 1200
*** FLOP *** [9h 5c 9c]
@tetaschell: checks 
Scorgiej: checks 
*** TURN *** [9h 5c 9c] [2c]
@tetaschell: bets 2400
Scorgiej: calls 2400
*** RIVER *** [9h 5c 9c 2c] [Tc]
@tetaschell: bets 2661
Monsieur Foutre is disconnected 
Scorgiej: folds 
Uncalled bet (2661) returned to @tetaschell
@tetaschell collected 11700 from pot
@tetaschell: doesn't show hand 
*** SUMMARY ***
Total pot 11700 | Rake 0 
Board [9h 5c 9c 2c Tc]
Seat 1: Baca4b (button) folded before Flop (didn't bet)
Seat 2: RenALLiin (small blind) folded before Flop
Seat 3: @tetaschell (big blind) collected (11700)
Seat 5: Scorgiej folded on the River
Seat 6: goshaleg folded before Flop (didn't bet)

PokerStars Hand #251209780520: Tournament #3769361908, $52.38+$2.62 USD Hold'em No Limit - Level XV (600/1200) - 2024/06/26 22:47:07 UTC [2024/06/26 18:47:07 ET]
Table '3769361908 12' 6-max Seat #2 is the button
Seat 1: Baca4b (16972 in chips) 
Seat 2: RenALLiin (15346 in chips) 
Seat 3: @tetaschell (29300 in chips) 
Seat 4: Monsieur Foutre (10000 in chips) 
Seat 5: Scorgiej (35904 in chips) 
Seat 6: goshaleg (29375 in chips) 
Baca4b: posts the ante 300
RenALLiin: posts the ante 300
@tetaschell: posts the ante 300
Monsieur Foutre: posts the ante 300
Scorgiej: posts the ante 300
goshaleg: posts the ante 300
@tetaschell: posts small blind 600
Monsieur Foutre: posts big blind 1200
*** HOLE CARDS ***
Scorgiej: raises 1200 to 2400
goshaleg: folds 
Baca4b: folds 
RenALLiin: folds 
@tetaschell: folds 
Monsieur Foutre: calls 1200
*** FLOP *** [7c 7h 2c]
Monsieur Foutre: checks 
Scorgiej: bets 1200
Monsieur Foutre: raises 6100 to 7300 and is all-in
Scorgiej: calls 6100
*** TURN *** [7c 7h 2c] [8c]
*** RIVER *** [7c 7h 2c 8c] [3c]
*** SHOW DOWN ***
Monsieur Foutre: shows [As 3d] (two pair, Sevens and Threes)
Scorgiej: shows [Th Ts] (two pair, Tens and Sevens)
Scorgiej collected 21800 from pot
Monsieur Foutre finished the tournament
*** SUMMARY ***
Total pot 21800 | Rake 0 
Board [7c 7h 2c 8c 3c]
Seat 1: Baca4b folded before Flop (didn't bet)
Seat 2: RenALLiin (button) folded before Flop (didn't bet)
Seat 3: @tetaschell (small blind) folded before Flop
Seat 4: Monsieur Foutre (big blind) showed [As 3d] and lost with two pair, Sevens and Threes
Seat 5: Scorgiej showed [Th Ts] and won (21800) with two pair, Tens and Sevens
Seat 6: goshaleg folded before Flop (didn't bet)

PokerStars Hand #251209794207: Tournament #3769361908, $52.38+$2.62 USD Hold'em No Limit - Level XVI (800/1600) - 2024/06/26 22:48:01 UTC [2024/06/26 18:48:01 ET]
Table '3769361908 12' 6-max Seat #3 is the button
Seat 1: Baca4b (16672 in chips) 
Seat 2: RenALLiin (15046 in chips) 
Seat 3: @tetaschell (28400 in chips) 
Seat 5: Scorgiej (47704 in chips) 
Seat 6: goshaleg (29075 in chips) 
Baca4b: posts the ante 400
RenALLiin: posts the ante 400
@tetaschell: posts the ante 400
Scorgiej: posts the ante 400
goshaleg: posts the ante 400
Scorgiej: posts small blind 800
goshaleg: posts big blind 1600
*** HOLE CARDS ***
Baca4b: folds 
RenALLiin: raises 13046 to 14646 and is all-in
@tetaschell: folds 
Scorgiej: raises 32658 to 47304 and is all-in
goshaleg: folds 
Uncalled bet (32658) returned to Scorgiej
*** FLOP *** [3s 9s Qs]
*** TURN *** [3s 9s Qs] [Td]
*** RIVER *** [3s 9s Qs Td] [3h]
*** SHOW DOWN ***
Scorgiej: shows [As Ad] (two pair, Aces and Threes)
RenALLiin: shows [5d 5c] (two pair, Fives and Threes)
Scorgiej collected 32892 from pot
RenALLiin finished the tournament
*** SUMMARY ***
Total pot 32892 | Rake 0 
Board [3s 9s Qs Td 3h]
Seat 1: Baca4b folded before Flop (didn't bet)
Seat 2: RenALLiin showed [5d 5c] and lost with two pair, Fives and Threes
Seat 3: @tetaschell (button) folded before Flop (didn't bet)
Seat 5: Scorgiej (small blind) showed [As Ad] and won (32892) with two pair, Aces and Threes
Seat 6: goshaleg (big blind) folded before Flop

PokerStars Hand #251209801194: Tournament #3769361908, $52.38+$2.62 USD Hold'em No Limit - Level XVI (800/1600) - 2024/06/26 22:48:29 UTC [2024/06/26 18:48:29 ET]
Table '3769361908 12' 6-max Seat #5 is the button
Seat 1: Baca4b (16272 in chips) 
Seat 3: @tetaschell (28000 in chips) 
Seat 5: Scorgiej (65550 in chips) 
Seat 6: goshaleg (27075 in chips) 
Baca4b: posts the ante 400
@tetaschell: posts the ante 400
Scorgiej: posts the ante 400
goshaleg: posts the ante 400
goshaleg: posts small blind 800
Baca4b: posts big blind 1600
*** HOLE CARDS ***
@tetaschell: folds 
Scorgiej: raises 2080 to 3680
goshaleg: folds 
Baca4b: calls 2080
*** FLOP *** [4c 2c Jh]
Baca4b: checks 
Scorgiej: checks 
*** TURN *** [4c 2c Jh] [2s]
Baca4b: checks 
Scorgiej: checks 
*** RIVER *** [4c 2c Jh 2s] [6d]
Baca4b: bets 4880
Scorgiej: folds 
Uncalled bet (4880) returned to Baca4b
Baca4b collected 9760 from pot
Baca4b: doesn't show hand 
*** SUMMARY ***
Total pot 9760 | Rake 0 
Board [4c 2c Jh 2s 6d]
Seat 1: Baca4b (big blind) collected (9760)
Seat 3: @tetaschell folded before Flop (didn't bet)
Seat 5: Scorgiej (button) folded on the River
Seat 6: goshaleg (small blind) folded before Flop

PokerStars Hand #251209814087: Tournament #3769361908, $52.38+$2.62 USD Hold'em No Limit - Level XVI (800/1600) - 2024/06/26 22:49:20 UTC [2024/06/26 18:49:20 ET]
Table '3769361908 12' 6-max Seat #6 is the button
Seat 1: Baca4b (21952 in chips) 
Seat 2: jklñjklñ (7410 in chips) 
Seat 3: @tetaschell (27600 in chips) 
Seat 5: Scorgiej (61470 in chips) 
Seat 6: goshaleg (25875 in chips) 
Baca4b: posts the ante 400
jklñjklñ: posts the ante 400
@tetaschell: posts the ante 400
Scorgiej: posts the ante 400
goshaleg: posts the ante 400
Baca4b: posts small blind 800
jklñjklñ: posts big blind 1600
*** HOLE CARDS ***
@tetaschell: folds 
vitor762 is disconnected 
Scorgiej: raises 1600 to 3200
goshaleg: folds 
Baca4b: folds 
jklñjklñ: folds 
Uncalled bet (1600) returned to Scorgiej
Scorgiej collected 6000 from pot
Scorgiej: doesn't show hand 
*** SUMMARY ***
Total pot 6000 | Rake 0 
Seat 1: Baca4b (small blind) folded before Flop
Seat 2: jklñjklñ (big blind) folded before Flop
Seat 3: @tetaschell folded before Flop (didn't bet)
Seat 5: Scorgiej collected (6000)
Seat 6: goshaleg (button) folded before Flop (didn't bet)

PokerStars Hand #251209819951: Tournament #3769361908, $52.38+$2.62 USD Hold'em No Limit - Level XVI (800/1600) - 2024/06/26 22:49:44 UTC [2024/06/26 18:49:44 ET]
Table '3769361908 12' 6-max Seat #1 is the button
Seat 1: Baca4b (20752 in chips) 
Seat 2: jklñjklñ (5410 in chips) 
Seat 3: @tetaschell (27200 in chips) 
Seat 4: vitor762 (14070 in chips) 
Seat 5: Scorgiej (65470 in chips) 
Seat 6: goshaleg (25475 in chips) 
Baca4b: posts the ante 400
jklñjklñ: posts the ante 400
@tetaschell: posts the ante 400
vitor762: posts the ante 400
Scorgiej: posts the ante 400
goshaleg: posts the ante 400
jklñjklñ: posts small blind 800
@tetaschell: posts big blind 1600
*** HOLE CARDS ***
vitor762: folds 
Scorgiej: folds 
goshaleg: raises 1600 to 3200
Baca4b: folds 
jklñjklñ: folds 
@tetaschell: raises 4000 to 7200
goshaleg: folds 
Uncalled bet (4000) returned to @tetaschell
@tetaschell collected 9600 from pot
@tetaschell: doesn't show hand 
*** SUMMARY ***
Total pot 9600 | Rake 0 
Seat 1: Baca4b (button) folded before Flop (didn't bet)
Seat 2: jklñjklñ (small blind) folded before Flop
Seat 3: @tetaschell (big blind) collected (9600)
Seat 4: vitor762 folded before Flop (didn't bet)
Seat 5: Scorgiej folded before Flop (didn't bet)
Seat 6: goshaleg folded before Flop

PokerStars Hand #251209830418: Tournament #3769361908, $52.38+$2.62 USD Hold'em No Limit - Level XVII (1000/2000) - 2024/06/26 22:50:26 UTC [2024/06/26 18:50:26 ET]
Table '3769361908 12' 6-max Seat #2 is the button
Seat 1: Baca4b (20352 in chips) 
Seat 2: jklñjklñ (4210 in chips) 
Seat 3: @tetaschell (33200 in chips) 
Seat 4: vitor762 (13670 in chips) 
Seat 5: Scorgiej (65070 in chips) 
Seat 6: goshaleg (21875 in chips) 
Baca4b: posts the ante 500
jklñjklñ: posts the ante 500
@tetaschell: posts the ante 500
vitor762: posts the ante 500
Scorgiej: posts the ante 500
goshaleg: posts the ante 500
@tetaschell: posts small blind 1000
vitor762: posts big blind 2000
*** HOLE CARDS ***
Scorgiej: folds 
goshaleg: folds 
Baca4b: folds 
jklñjklñ: raises 1710 to 3710 and is all-in
@tetaschell: raises 28990 to 32700 and is all-in
vitor762: calls 11170 and is all-in
Uncalled bet (19530) returned to @tetaschell
*** FLOP *** [2s Th 4h]
*** TURN *** [2s Th 4h] [6c]
*** RIVER *** [2s Th 4h 6c] [3d]
*** SHOW DOWN ***
@tetaschell: shows [6d 8d] (a pair of Sixes)
vitor762: shows [8h 8c] (a pair of Eights)
vitor762 collected 18920 from side pot
jklñjklñ: shows [Qd Qs] (a pair of Queens)
jklñjklñ collected 14130 from main pot
*** SUMMARY ***
Total pot 33050 Main pot 14130. Side pot 18920. | Rake 0 
Board [2s Th 4h 6c 3d]
Seat 1: Baca4b folded before Flop (didn't bet)
Seat 2: jklñjklñ (button) showed [Qd Qs] and won (14130) with a pair of Queens
Seat 3: @tetaschell (small blind) showed [6d 8d] and lost with a pair of Sixes
Seat 4: vitor762 (big blind) showed [8h 8c] and won (18920) with a pair of Eights
Seat 5: Scorgiej folded before Flop (didn't bet)
Seat 6: goshaleg folded before Flop (didn't bet)

PokerStars Hand #251209838074: Tournament #3769361908, $52.38+$2.62 USD Hold'em No Limit - Level XVII (1000/2000) - 2024/06/26 22:50:58 UTC [2024/06/26 18:50:58 ET]
Table '3769361908 12' 6-max Seat #3 is the button
Seat 1: Baca4b (19852 in chips) 
Seat 2: jklñjklñ (14130 in chips) 
Seat 3: @tetaschell (19530 in chips) 
Seat 4: vitor762 (18920 in chips) 
Seat 5: Scorgiej (64570 in chips) 
Seat 6: goshaleg (21375 in chips) 
Baca4b: posts the ante 500
jklñjklñ: posts the ante 500
@tetaschell: posts the ante 500
vitor762: posts the ante 500
Scorgiej: posts the ante 500
goshaleg: posts the ante 500
vitor762: posts small blind 1000
Scorgiej: posts big blind 2000
*** HOLE CARDS ***
goshaleg: folds 
Baca4b: folds 
jklñjklñ: raises 11630 to 13630 and is all-in
@tetaschell: folds 
vitor762: folds 
Scorgiej: folds 
Uncalled bet (11630) returned to jklñjklñ
jklñjklñ collected 8000 from pot
*** SUMMARY ***
Total pot 8000 | Rake 0 
Seat 1: Baca4b folded before Flop (didn't bet)
Seat 2: jklñjklñ collected (8000)
Seat 3: @tetaschell (button) folded before Flop (didn't bet)
Seat 4: vitor762 (small blind) folded before Flop
Seat 5: Scorgiej (big blind) folded before Flop
Seat 6: goshaleg folded before Flop (didn't bet)

PokerStars Hand #251209842678: Tournament #3769361908, $52.38+$2.62 USD Hold'em No Limit - Level XVII (1000/2000) - 2024/06/26 22:51:17 UTC [2024/06/26 18:51:17 ET]
Table '3769361908 12' 6-max Seat #4 is the button
Seat 1: Baca4b (19352 in chips) 
Seat 2: jklñjklñ (19630 in chips) 
Seat 3: @tetaschell (19030 in chips) 
Seat 4: vitor762 (17420 in chips) 
Seat 5: Scorgiej (62070 in chips) 
Seat 6: goshaleg (20875 in chips) 
Baca4b: posts the ante 500
jklñjklñ: posts the ante 500
@tetaschell: posts the ante 500
vitor762: posts the ante 500
Scorgiej: posts the ante 500
goshaleg: posts the ante 500
Scorgiej: posts small blind 1000
goshaleg: posts big blind 2000
*** HOLE CARDS ***
Baca4b: folds 
jklñjklñ: folds 
@tetaschell: folds 
vitor762: folds 
Scorgiej: raises 59570 to 61570 and is all-in
goshaleg: calls 18375 and is all-in
Uncalled bet (41195) returned to Scorgiej
*** FLOP *** [8d 2s Qh]
*** TURN *** [8d 2s Qh] [2d]
*** RIVER *** [8d 2s Qh 2d] [6s]
*** SHOW DOWN ***
Scorgiej: shows [9d Qc] (two pair, Queens and Deuces)
goshaleg: shows [Ad 4h] (a pair of Deuces)
Scorgiej collected 43750 from pot
goshaleg finished the tournament in 100th place
*** SUMMARY ***
Total pot 43750 | Rake 0 
Board [8d 2s Qh 2d 6s]
Seat 1: Baca4b folded before Flop (didn't bet)
Seat 2: jklñjklñ folded before Flop (didn't bet)
Seat 3: @tetaschell folded before Flop (didn't bet)
Seat 4: vitor762 (button) folded before Flop (didn't bet)
Seat 5: Scorgiej (small blind) showed [9d Qc] and won (43750) with two pair, Queens and Deuces
Seat 6: goshaleg (big blind) showed [Ad 4h] and lost with a pair of Deuces

PokerStars Hand #251209849149: Tournament #3769361908, $52.38+$2.62 USD Hold'em No Limit - Level XVII (1000/2000) - 2024/06/26 22:51:44 UTC [2024/06/26 18:51:44 ET]
Table '3769361908 12' 6-max Seat #5 is the button
Seat 1: Baca4b (18852 in chips) 
Seat 2: jklñjklñ (19130 in chips) 
Seat 3: @tetaschell (18530 in chips) 
Seat 4: vitor762 (16920 in chips) 
Seat 5: Scorgiej (84945 in chips) 
Baca4b: posts the ante 500
jklñjklñ: posts the ante 500
@tetaschell: posts the ante 500
vitor762: posts the ante 500
Scorgiej: posts the ante 500
Baca4b: posts small blind 1000
jklñjklñ: posts big blind 2000
*** HOLE CARDS ***
@tetaschell: folds 
vitor762: raises 14420 to 16420 and is all-in
Scorgiej: folds 
Baca4b: raises 1932 to 18352 and is all-in
jklñjklñ: folds 
Uncalled bet (1932) returned to Baca4b
*** FLOP *** [3s Jc 8s]
*** TURN *** [3s Jc 8s] [7s]
*** RIVER *** [3s Jc 8s 7s] [Js]
G_haeffner is disconnected 
*** SHOW DOWN ***
Baca4b: shows [6d 6c] (two pair, Jacks and Sixes)
vitor762: shows [Qs Qc] (a flush, Queen high)
vitor762 collected 37340 from pot
*** SUMMARY ***
Total pot 37340 | Rake 0 
Board [3s Jc 8s 7s Js]
Seat 1: Baca4b (small blind) showed [6d 6c] and lost with two pair, Jacks and Sixes
Seat 2: jklñjklñ (big blind) folded before Flop
Seat 3: @tetaschell folded before Flop (didn't bet)
Seat 4: vitor762 showed [Qs Qc] and won (37340) with a flush, Queen high
Seat 5: Scorgiej (button) folded before Flop (didn't bet)

PokerStars Hand #251209856163: Tournament #3769361908, $52.38+$2.62 USD Hold'em No Limit - Level XVII (1000/2000) - 2024/06/26 22:52:12 UTC [2024/06/26 18:52:12 ET]
Table '3769361908 12' 6-max Seat #1 is the button
Seat 1: Baca4b (1932 in chips) 
Seat 2: jklñjklñ (16630 in chips) 
Seat 3: @tetaschell (18030 in chips) 
Seat 4: vitor762 (37340 in chips) 
Seat 5: Scorgiej (84445 in chips) 
Seat 6: G_haeffner (9348 in chips) 
Baca4b: posts the ante 500
jklñjklñ: posts the ante 500
@tetaschell: posts the ante 500
vitor762: posts the ante 500
Scorgiej: posts the ante 500
G_haeffner: posts the ante 500
jklñjklñ: posts small blind 1000
@tetaschell: posts big blind 2000
*** HOLE CARDS ***
vitor762: folds 
Scorgiej: raises 81945 to 83945 and is all-in
G_haeffner: folds 
Baca4b: calls 1432 and is all-in
jklñjklñ: folds 
@tetaschell: folds 
Uncalled bet (81945) returned to Scorgiej
*** FLOP *** [Jd 7d 5s]
*** TURN *** [Jd 7d 5s] [Js]
*** RIVER *** [Jd 7d 5s Js] [3h]
*** SHOW DOWN ***
Scorgiej: shows [6h As] (a pair of Jacks)
Scorgiej collected 1136 from side pot
Baca4b: shows [5d 5c] (a full house, Fives full of Jacks)
Baca4b collected 8296 from main pot
*** SUMMARY ***
Total pot 9432 Main pot 8296. Side pot 1136. | Rake 0 
Board [Jd 7d 5s Js 3h]
Seat 1: Baca4b (button) showed [5d 5c] and won (8296) with a full house, Fives full of Jacks
Seat 2: jklñjklñ (small blind) folded before Flop
Seat 3: @tetaschell (big blind) folded before Flop
Seat 4: vitor762 folded before Flop (didn't bet)
Seat 5: Scorgiej showed [6h As] and won (1136) with a pair of Jacks
Seat 6: G_haeffner folded before Flop (didn't bet)

PokerStars Hand #251209863128: Tournament #3769361908, $52.38+$2.62 USD Hold'em No Limit - Level XVII (1000/2000) - 2024/06/26 22:52:40 UTC [2024/06/26 18:52:40 ET]
Table '3769361908 12' 6-max Seat #2 is the button
Seat 1: Baca4b (8296 in chips) 
Seat 2: jklñjklñ (15130 in chips) 
Seat 3: @tetaschell (15530 in chips) 
Seat 4: vitor762 (36840 in chips) 
Seat 5: Scorgiej (83081 in chips) 
Seat 6: G_haeffner (8848 in chips) 
Baca4b: posts the ante 500
jklñjklñ: posts the ante 500
@tetaschell: posts the ante 500
vitor762: posts the ante 500
Scorgiej: posts the ante 500
G_haeffner: posts the ante 500
@tetaschell: posts small blind 1000
vitor762: posts big blind 2000
*** HOLE CARDS ***
Scorgiej: raises 2000 to 4000
G_haeffner: folds 
Baca4b: folds 
jklñjklñ: folds 
@tetaschell: folds 
vitor762: calls 2000
*** FLOP *** [Jd 8d Jh]
vitor762: checks 
Scorgiej: bets 3000
vitor762: folds 
Uncalled bet (3000) returned to Scorgiej
Scorgiej collected 12000 from pot
Scorgiej: doesn't show hand 
*** SUMMARY ***
Total pot 12000 | Rake 0 
Board [Jd 8d Jh]
Seat 1: Baca4b folded before Flop (didn't bet)
Seat 2: jklñjklñ (button) folded before Flop (didn't bet)
Seat 3: @tetaschell (small blind) folded before Flop
Seat 4: vitor762 (big blind) folded on the Flop
Seat 5: Scorgiej collected (12000)
Seat 6: G_haeffner folded before Flop (didn't bet)

PokerStars Hand #251209874511: Tournament #3769361908, $52.38+$2.62 USD Hold'em No Limit - Level XVIII (1200/2400) - 2024/06/26 22:53:28 UTC [2024/06/26 18:53:28 ET]
Table '3769361908 12' 6-max Seat #3 is the button
Seat 1: Baca4b (7796 in chips) 
Seat 2: jklñjklñ (14630 in chips) 
Seat 3: @tetaschell (14030 in chips) 
Seat 4: vitor762 (32340 in chips) 
Seat 5: Scorgiej (90581 in chips) 
Seat 6: G_haeffner (8348 in chips) 
Baca4b: posts the ante 600
jklñjklñ: posts the ante 600
@tetaschell: posts the ante 600
vitor762: posts the ante 600
Scorgiej: posts the ante 600
G_haeffner: posts the ante 600
vitor762: posts small blind 1200
Scorgiej: posts big blind 2400
*** HOLE CARDS ***
G_haeffner: raises 5348 to 7748 and is all-in
Baca4b: calls 7196 and is all-in
jklñjklñ: raises 6282 to 14030 and is all-in
@tetaschell: folds 
vitor762: folds 
Scorgiej: folds 
Uncalled bet (6282) returned to jklñjklñ
*** FLOP *** [8h Ks 9c]
*** TURN *** [8h Ks 9c] [9h]
*** RIVER *** [8h Ks 9c 9h] [6d]
*** SHOW DOWN ***
G_haeffner: shows [Qh Ah] (a pair of Nines)
jklñjklñ: shows [Ac Jc] (a pair of Nines - lower kicker)
G_haeffner collected 1104 from side pot
Baca4b: shows [Ad Tc] (a pair of Nines - lower kicker)
G_haeffner collected 28788 from main pot
Baca4b finished the tournament in 83rd place
*** SUMMARY ***
Total pot 29892 Main pot 28788. Side pot 1104. | Rake 0 
Board [8h Ks 9c 9h 6d]
Seat 1: Baca4b showed [Ad Tc] and lost with a pair of Nines
Seat 2: jklñjklñ showed [Ac Jc] and lost with a pair of Nines
Seat 3: @tetaschell (button) folded before Flop (didn't bet)
Seat 4: vitor762 (small blind) folded before Flop
Seat 5: Scorgiej (big blind) folded before Flop
Seat 6: G_haeffner showed [Qh Ah] and won (29892) with a pair of Nines

PokerStars Hand #251209885604: Tournament #3769361908, $52.38+$2.62 USD Hold'em No Limit - Level XVIII (1200/2400) - 2024/06/26 22:54:13 UTC [2024/06/26 18:54:13 ET]
Table '3769361908 12' 6-max Seat #4 is the button
Seat 2: jklñjklñ (6282 in chips) 
Seat 3: @tetaschell (13430 in chips) 
Seat 4: vitor762 (30540 in chips) 
Seat 5: Scorgiej (87581 in chips) 
Seat 6: G_haeffner (29892 in chips) 
jklñjklñ: posts the ante 600
@tetaschell: posts the ante 600
vitor762: posts the ante 600
Scorgiej: posts the ante 600
G_haeffner: posts the ante 600
Scorgiej: posts small blind 1200
G_haeffner: posts big blind 2400
*** HOLE CARDS ***
jklñjklñ: folds 
@tetaschell: folds 
vitor762: folds 
Scorgiej: raises 84581 to 86981 and is all-in
G_haeffner: folds 
Uncalled bet (84581) returned to Scorgiej
Scorgiej collected 7800 from pot
Scorgiej: doesn't show hand 
*** SUMMARY ***
Total pot 7800 | Rake 0 
Seat 2: jklñjklñ folded before Flop (didn't bet)
Seat 3: @tetaschell folded before Flop (didn't bet)
Seat 4: vitor762 (button) folded before Flop (didn't bet)
Seat 5: Scorgiej (small blind) collected (7800)
Seat 6: G_haeffner (big blind) folded before Flop

PokerStars Hand #251209892168: Tournament #3769361908, $52.38+$2.62 USD Hold'em No Limit - Level XVIII (1200/2400) - 2024/06/26 22:54:40 UTC [2024/06/26 18:54:40 ET]
Table '3769361908 12' 6-max Seat #5 is the button
Seat 2: jklñjklñ (5682 in chips) 
Seat 3: @tetaschell (12830 in chips) 
Seat 4: vitor762 (29940 in chips) 
Seat 5: Scorgiej (92381 in chips) 
Seat 6: G_haeffner (26892 in chips) 
jklñjklñ: posts the ante 600
@tetaschell: posts the ante 600
vitor762: posts the ante 600
Scorgiej: posts the ante 600
G_haeffner: posts the ante 600
G_haeffner: posts small blind 1200
jklñjklñ: posts big blind 2400
*** HOLE CARDS ***
@tetaschell: raises 9830 to 12230 and is all-in
vitor762: folds 
Scorgiej: folds 
G_haeffner: folds 
jklñjklñ: calls 2682 and is all-in
Uncalled bet (7148) returned to @tetaschell
*** FLOP *** [7h 6c 9s]
DR. ELDAR is disconnected 
*** TURN *** [7h 6c 9s] [6s]
*** RIVER *** [7h 6c 9s 6s] [4c]
*** SHOW DOWN ***
jklñjklñ: shows [3s Jd] (a pair of Sixes)
@tetaschell: shows [9h As] (two pair, Nines and Sixes)
@tetaschell collected 14364 from pot
jklñjklñ finished the tournament in 77th place
*** SUMMARY ***
Total pot 14364 | Rake 0 
Board [7h 6c 9s 6s 4c]
Seat 2: jklñjklñ (big blind) showed [3s Jd] and lost with a pair of Sixes
Seat 3: @tetaschell showed [9h As] and won (14364) with two pair, Nines and Sixes
Seat 4: vitor762 folded before Flop (didn't bet)
Seat 5: Scorgiej (button) folded before Flop (didn't bet)
Seat 6: G_haeffner (small blind) folded before Flop

PokerStars Hand #251209964591: Tournament #3769361908, $52.38+$2.62 USD Hold'em No Limit - Level XVIII (1200/2400) - 2024/06/26 23:01:09 UTC [2024/06/26 19:01:09 ET]
Table '3769361908 12' 6-max Seat #6 is the button
Seat 1: DR. ELDAR (36345 in chips) out of hand (moved from another table into small blind)
Seat 2: 4sasss (30176 in chips) out of hand (moved from another table into small blind)
Seat 3: @tetaschell (21512 in chips) 
Seat 4: vitor762 (29340 in chips) 
Seat 5: Scorgiej (91781 in chips) 
Seat 6: G_haeffner (25092 in chips) 
DR. ELDAR will be allowed to play after the button
4sasss will be allowed to play after the button
@tetaschell: posts the ante 600
vitor762: posts the ante 600
Scorgiej: posts the ante 600
G_haeffner: posts the ante 600
@tetaschell: posts small blind 1200
vitor762: posts big blind 2400
*** HOLE CARDS ***
Scorgiej: folds 
G_haeffner: folds 
@tetaschell: raises 18512 to 20912 and is all-in
vitor762: folds 
Uncalled bet (18512) returned to @tetaschell
@tetaschell collected 7200 from pot
@tetaschell: doesn't show hand 
*** SUMMARY ***
Total pot 7200 | Rake 0 
Seat 3: @tetaschell (small blind) collected (7200)
Seat 4: vitor762 (big blind) folded before Flop
Seat 5: Scorgiej folded before Flop (didn't bet)
Seat 6: G_haeffner (button) folded before Flop (didn't bet)

PokerStars Hand #251209968830: Tournament #3769361908, $52.38+$2.62 USD Hold'em No Limit - Level XVIII (1200/2400) - 2024/06/26 23:01:28 UTC [2024/06/26 19:01:28 ET]
Table '3769361908 12' 6-max Seat #3 is the button
Seat 1: DR. ELDAR (36345 in chips) 
Seat 2: 4sasss (30176 in chips) 
Seat 3: @tetaschell (25712 in chips) 
Seat 4: vitor762 (26340 in chips) 
Seat 5: Scorgiej (91181 in chips) 
Seat 6: G_haeffner (24492 in chips) 
DR. ELDAR: posts the ante 600
4sasss: posts the ante 600
@tetaschell: posts the ante 600
vitor762: posts the ante 600
Scorgiej: posts the ante 600
G_haeffner: posts the ante 600
vitor762: posts small blind 1200
Scorgiej: posts big blind 2400
*** HOLE CARDS ***
G_haeffner: folds 
DR. ELDAR: folds 
4sasss: folds 
@tetaschell: folds 
vitor762: folds 
Uncalled bet (1200) returned to Scorgiej
Scorgiej collected 6000 from pot
Scorgiej: doesn't show hand 
*** SUMMARY ***
Total pot 6000 | Rake 0 
Seat 1: DR. ELDAR folded before Flop (didn't bet)
Seat 2: 4sasss folded before Flop (didn't bet)
Seat 3: @tetaschell (button) folded before Flop (didn't bet)
Seat 4: vitor762 (small blind) folded before Flop
Seat 5: Scorgiej (big blind) collected (6000)
Seat 6: G_haeffner folded before Flop (didn't bet)

PokerStars Hand #251209982019: Tournament #3769361908, $52.38+$2.62 USD Hold'em No Limit - Level XIX (1400/2800) - 2024/06/26 23:02:25 UTC [2024/06/26 19:02:25 ET]
Table '3769361908 12' 6-max Seat #4 is the button
Seat 1: DR. ELDAR (35745 in chips) 
Seat 2: 4sasss (29576 in chips) 
Seat 3: @tetaschell (25112 in chips) 
Seat 4: vitor762 (24540 in chips) 
Seat 5: Scorgiej (95381 in chips) 
Seat 6: G_haeffner (23892 in chips) 
DR. ELDAR: posts the ante 700
4sasss: posts the ante 700
@tetaschell: posts the ante 700
vitor762: posts the ante 700
Scorgiej: posts the ante 700
G_haeffner: posts the ante 700
Scorgiej: posts small blind 1400
G_haeffner: posts big blind 2800
*** HOLE CARDS ***
DR. ELDAR: folds 
4sasss: raises 26076 to 28876 and is all-in
@tetaschell: folds 
vitor762: calls 23840 and is all-in
Scorgiej: folds 
G_haeffner: folds 
Uncalled bet (5036) returned to 4sasss
*** FLOP *** [6d 5h 9d]
*** TURN *** [6d 5h 9d] [3c]
*** RIVER *** [6d 5h 9d 3c] [4c]
*** SHOW DOWN ***
4sasss: shows [Qs Ah] (high card Ace)
vitor762: shows [As Ac] (a pair of Aces)
vitor762 collected 56080 from pot
*** SUMMARY ***
Total pot 56080 | Rake 0 
Board [6d 5h 9d 3c 4c]
Seat 1: DR. ELDAR folded before Flop (didn't bet)
Seat 2: 4sasss showed [Qs Ah] and lost with high card Ace
Seat 3: @tetaschell folded before Flop (didn't bet)
Seat 4: vitor762 (button) showed [As Ac] and won (56080) with a pair of Aces
Seat 5: Scorgiej (small blind) folded before Flop
Seat 6: G_haeffner (big blind) folded before Flop

PokerStars Hand #251209994009: Tournament #3769361908, $52.38+$2.62 USD Hold'em No Limit - Level XIX (1400/2800) - 2024/06/26 23:03:17 UTC [2024/06/26 19:03:17 ET]
Table '3769361908 12' 6-max Seat #5 is the button
Seat 1: DR. ELDAR (35045 in chips) 
Seat 2: 4sasss (5036 in chips) 
Seat 3: @tetaschell (24412 in chips) 
Seat 4: vitor762 (56080 in chips) 
Seat 5: Scorgiej (93281 in chips) 
Seat 6: G_haeffner (20392 in chips) 
DR. ELDAR: posts the ante 700
4sasss: posts the ante 700
@tetaschell: posts the ante 700
vitor762: posts the ante 700
Scorgiej: posts the ante 700
G_haeffner: posts the ante 700
G_haeffner: posts small blind 1400
DR. ELDAR: posts big blind 2800
*** HOLE CARDS ***
4sasss: folds 
@tetaschell: folds 
vitor762: folds 
Scorgiej: folds 
G_haeffner: folds 
Uncalled bet (1400) returned to DR. ELDAR
DR. ELDAR collected 7000 from pot
DR. ELDAR: doesn't show hand 
*** SUMMARY ***
Total pot 7000 | Rake 0 
Seat 1: DR. ELDAR (big blind) collected (7000)
Seat 2: 4sasss folded before Flop (didn't bet)
Seat 3: @tetaschell folded before Flop (didn't bet)
Seat 4: vitor762 folded before Flop (didn't bet)
Seat 5: Scorgiej (button) folded before Flop (didn't bet)
Seat 6: G_haeffner (small blind) folded before Flop

PokerStars Hand #251210006784: Tournament #3769361908, $52.38+$2.62 USD Hold'em No Limit - Level XIX (1400/2800) - 2024/06/26 23:04:12 UTC [2024/06/26 19:04:12 ET]
Table '3769361908 12' 6-max Seat #6 is the button
Seat 1: DR. ELDAR (39945 in chips) 
Seat 2: 4sasss (4336 in chips) 
Seat 3: @tetaschell (23712 in chips) 
Seat 4: vitor762 (55380 in chips) 
Seat 5: Scorgiej (92581 in chips) 
Seat 6: G_haeffner (18292 in chips) 
DR. ELDAR: posts the ante 700
4sasss: posts the ante 700
@tetaschell: posts the ante 700
vitor762: posts the ante 700
Scorgiej: posts the ante 700
G_haeffner: posts the ante 700
DR. ELDAR: posts small blind 1400
4sasss: posts big blind 2800
*** HOLE CARDS ***
@tetaschell: folds 
vitor762: raises 2800 to 5600
Scorgiej: folds 
G_haeffner: folds 
DR. ELDAR: folds 
4sasss: calls 836 and is all-in
Uncalled bet (1964) returned to vitor762
*** FLOP *** [4c Kc 9s]
*** TURN *** [4c Kc 9s] [Jc]
*** RIVER *** [4c Kc 9s Jc] [4h]
*** SHOW DOWN ***
4sasss: shows [2c 7d] (a pair of Fours)
vitor762: shows [Ad 8s] (a pair of Fours - Ace kicker)
vitor762 collected 12872 from pot
4sasss finished the tournament in 65th place
*** SUMMARY ***
Total pot 12872 | Rake 0 
Board [4c Kc 9s Jc 4h]
Seat 1: DR. ELDAR (small blind) folded before Flop
Seat 2: 4sasss (big blind) showed [2c 7d] and lost with a pair of Fours
Seat 3: @tetaschell folded before Flop (didn't bet)
Seat 4: vitor762 showed [Ad 8s] and won (12872) with a pair of Fours
Seat 5: Scorgiej folded before Flop (didn't bet)
Seat 6: G_haeffner (button) folded before Flop (didn't bet)

PokerStars Hand #251210018709: Tournament #3769361908, $52.38+$2.62 USD Hold'em No Limit - Level XIX (1400/2800) - 2024/06/26 23:05:03 UTC [2024/06/26 19:05:03 ET]
Table '3769361908 12' 6-max Seat #1 is the button
Seat 1: DR. ELDAR (37845 in chips) 
Seat 3: @tetaschell (23012 in chips) 
Seat 4: vitor762 (63916 in chips) 
Seat 5: Scorgiej (91881 in chips) 
Seat 6: G_haeffner (17592 in chips) 
DR. ELDAR: posts the ante 700
@tetaschell: posts the ante 700
vitor762: posts the ante 700
Scorgiej: posts the ante 700
G_haeffner: posts the ante 700
@tetaschell: posts small blind 1400
vitor762: posts big blind 2800
*** HOLE CARDS ***
Scorgiej: folds 
G_haeffner: folds 
DR. ELDAR: raises 34345 to 37145 and is all-in
@tetaschell: folds 
vitor762: folds 
Uncalled bet (34345) returned to DR. ELDAR
DR. ELDAR collected 10500 from pot
DR. ELDAR: doesn't show hand 
*** SUMMARY ***
Total pot 10500 | Rake 0 
Seat 1: DR. ELDAR (button) collected (10500)
Seat 3: @tetaschell (small blind) folded before Flop
Seat 4: vitor762 (big blind) folded before Flop
Seat 5: Scorgiej folded before Flop (didn't bet)
Seat 6: G_haeffner folded before Flop (didn't bet)

PokerStars Hand #251210036486: Tournament #3769361908, $52.38+$2.62 USD Hold'em No Limit - Level XX (1600/3200) - 2024/06/26 23:06:21 UTC [2024/06/26 19:06:21 ET]
Table '3769361908 12' 6-max Seat #3 is the button
Seat 1: DR. ELDAR (44845 in chips) 
Seat 3: @tetaschell (20912 in chips) 
Seat 4: vitor762 (60416 in chips) 
Seat 5: Scorgiej (91181 in chips) 
Seat 6: G_haeffner (16892 in chips) 
DR. ELDAR: posts the ante 800
@tetaschell: posts the ante 800
vitor762: posts the ante 800
Scorgiej: posts the ante 800
G_haeffner: posts the ante 800
vitor762: posts small blind 1600
Scorgiej: posts big blind 3200
*** HOLE CARDS ***
G_haeffner: folds 
DR. ELDAR: folds 
@tetaschell: folds 
vitor762: calls 1600
Scorgiej: checks 
*** FLOP *** [9d Kd 4h]
vitor762: bets 3200
Scorgiej: folds 
Uncalled bet (3200) returned to vitor762
vitor762 collected 10400 from pot
vitor762: doesn't show hand 
*** SUMMARY ***
Total pot 10400 | Rake 0 
Board [9d Kd 4h]
Seat 1: DR. ELDAR folded before Flop (didn't bet)
Seat 3: @tetaschell (button) folded before Flop (didn't bet)
Seat 4: vitor762 (small blind) collected (10400)
Seat 5: Scorgiej (big blind) folded on the Flop
Seat 6: G_haeffner folded before Flop (didn't bet)

PokerStars Hand #251210050918: Tournament #3769361908, $52.38+$2.62 USD Hold'em No Limit - Level XX (1600/3200) - 2024/06/26 23:07:24 UTC [2024/06/26 19:07:24 ET]
Table '3769361908 12' 6-max Seat #4 is the button
Seat 1: DR. ELDAR (44045 in chips) 
Seat 3: @tetaschell (20112 in chips) 
Seat 4: vitor762 (66816 in chips) 
Seat 5: Scorgiej (87181 in chips) 
Seat 6: G_haeffner (16092 in chips) 
DR. ELDAR: posts the ante 800
@tetaschell: posts the ante 800
vitor762: posts the ante 800
Scorgiej: posts the ante 800
G_haeffner: posts the ante 800
Scorgiej: posts small blind 1600
G_haeffner: posts big blind 3200
*** HOLE CARDS ***
DR. ELDAR: folds 
@tetaschell: raises 16000 to 19200
vitor762: folds 
Scorgiej: folds 
G_haeffner: folds 
Uncalled bet (16000) returned to @tetaschell
@tetaschell collected 12000 from pot
@tetaschell: doesn't show hand 
*** SUMMARY ***
Total pot 12000 | Rake 0 
Seat 1: DR. ELDAR folded before Flop (didn't bet)
Seat 3: @tetaschell collected (12000)
Seat 4: vitor762 (button) folded before Flop (didn't bet)
Seat 5: Scorgiej (small blind) folded before Flop
Seat 6: G_haeffner (big blind) folded before Flop

PokerStars Hand #251210063048: Tournament #3769361908, $52.38+$2.62 USD Hold'em No Limit - Level XXI (1800/3600) - 2024/06/26 23:08:18 UTC [2024/06/26 19:08:18 ET]
Table '3769361908 12' 6-max Seat #5 is the button
Seat 1: DR. ELDAR (43245 in chips) 
Seat 3: @tetaschell (28112 in chips) 
Seat 4: vitor762 (66016 in chips) 
Seat 5: Scorgiej (84781 in chips) 
Seat 6: G_haeffner (12092 in chips) 
DR. ELDAR: posts the ante 900
@tetaschell: posts the ante 900
vitor762: posts the ante 900
Scorgiej: posts the ante 900
G_haeffner: posts the ante 900
G_haeffner: posts small blind 1800
DR. ELDAR: posts big blind 3600
*** HOLE CARDS ***
@tetaschell: folds 
vitor762: folds 
Scorgiej: raises 80281 to 83881 and is all-in
G_haeffner: folds 
DR. ELDAR: folds 
Uncalled bet (80281) returned to Scorgiej
Scorgiej collected 13500 from pot
Scorgiej: doesn't show hand 
*** SUMMARY ***
Total pot 13500 | Rake 0 
Seat 1: DR. ELDAR (big blind) folded before Flop
Seat 3: @tetaschell folded before Flop (didn't bet)
Seat 4: vitor762 folded before Flop (didn't bet)
Seat 5: Scorgiej (button) collected (13500)
Seat 6: G_haeffner (small blind) folded before Flop

PokerStars Hand #251210075601: Tournament #3769361908, $52.38+$2.62 USD Hold'em No Limit - Level XXI (1800/3600) - 2024/06/26 23:09:14 UTC [2024/06/26 19:09:14 ET]
Table '3769361908 12' 6-max Seat #6 is the button
Seat 1: DR. ELDAR (38745 in chips) 
Seat 3: @tetaschell (27212 in chips) 
Seat 4: vitor762 (65116 in chips) 
Seat 5: Scorgiej (93781 in chips) 
Seat 6: G_haeffner (9392 in chips) 
DR. ELDAR: posts the ante 900
@tetaschell: posts the ante 900
vitor762: posts the ante 900
Scorgiej: posts the ante 900
G_haeffner: posts the ante 900
DR. ELDAR: posts small blind 1800
@tetaschell: posts big blind 3600
*** HOLE CARDS ***
vitor762: folds 
Scorgiej: folds 
G_haeffner: folds 
DR. ELDAR: raises 34245 to 37845 and is all-in
@tetaschell: folds 
Uncalled bet (34245) returned to DR. ELDAR
DR. ELDAR collected 11700 from pot
DR. ELDAR: doesn't show hand 
*** SUMMARY ***
Total pot 11700 | Rake 0 
Seat 1: DR. ELDAR (small blind) collected (11700)
Seat 3: @tetaschell (big blind) folded before Flop
Seat 4: vitor762 folded before Flop (didn't bet)
Seat 5: Scorgiej folded before Flop (didn't bet)
Seat 6: G_haeffner (button) folded before Flop (didn't bet)

PokerStars Hand #251210087833: Tournament #3769361908, $52.38+$2.62 USD Hold'em No Limit - Level XXI (1800/3600) - 2024/06/26 23:10:10 UTC [2024/06/26 19:10:10 ET]
Table '3769361908 12' 6-max Seat #1 is the button
Seat 1: DR. ELDAR (45945 in chips) 
Seat 3: @tetaschell (22712 in chips) 
Seat 4: vitor762 (64216 in chips) 
Seat 5: Scorgiej (92881 in chips) 
Seat 6: G_haeffner (8492 in chips) 
DR. ELDAR: posts the ante 900
@tetaschell: posts the ante 900
vitor762: posts the ante 900
Scorgiej: posts the ante 900
G_haeffner: posts the ante 900
@tetaschell: posts small blind 1800
vitor762: posts big blind 3600
*** HOLE CARDS ***
Scorgiej: folds 
G_haeffner: raises 3600 to 7200
DR. ELDAR: folds 
@tetaschell: folds 
vitor762: calls 3600
*** FLOP *** [6h Ad 4d]
vitor762: bets 3600
G_haeffner: calls 392 and is all-in
Uncalled bet (3208) returned to vitor762
*** TURN *** [6h Ad 4d] [7d]
*** RIVER *** [6h Ad 4d 7d] [Js]
*** SHOW DOWN ***
vitor762: shows [2c Ac] (a pair of Aces)
G_haeffner: shows [Kh Qc] (high card Ace)
vitor762 collected 21484 from pot
G_haeffner finished the tournament in 63rd place
*** SUMMARY ***
Total pot 21484 | Rake 0 
Board [6h Ad 4d 7d Js]
Seat 1: DR. ELDAR (button) folded before Flop (didn't bet)
Seat 3: @tetaschell (small blind) folded before Flop
Seat 4: vitor762 (big blind) showed [2c Ac] and won (21484) with a pair of Aces
Seat 5: Scorgiej folded before Flop (didn't bet)
Seat 6: G_haeffner showed [Kh Qc] and lost with high card Ace

PokerStars Hand #251210099753: Tournament #3769361908, $52.38+$2.62 USD Hold'em No Limit - Level XXI (1800/3600) - 2024/06/26 23:11:04 UTC [2024/06/26 19:11:04 ET]
Table '3769361908 12' 6-max Seat #3 is the button
Seat 1: DR. ELDAR (45045 in chips) 
Seat 3: @tetaschell (20012 in chips) 
Seat 4: vitor762 (77208 in chips) 
Seat 5: Scorgiej (91981 in chips) 
DR. ELDAR: posts the ante 900
@tetaschell: posts the ante 900
vitor762: posts the ante 900
Scorgiej: posts the ante 900
vitor762: posts small blind 1800
Scorgiej: posts big blind 3600
*** HOLE CARDS ***
EqualizeSTAR is disconnected 
DR. ELDAR: folds 
@tetaschell: folds 
vitor762: folds 
Uncalled bet (1800) returned to Scorgiej
Scorgiej collected 7200 from pot
Scorgiej: doesn't show hand 
*** SUMMARY ***
Total pot 7200 | Rake 0 
Seat 1: DR. ELDAR folded before Flop (didn't bet)
Seat 3: @tetaschell (button) folded before Flop (didn't bet)
Seat 4: vitor762 (small blind) folded before Flop
Seat 5: Scorgiej (big blind) collected (7200)

PokerStars Hand #251210106072: Tournament #3769361908, $52.38+$2.62 USD Hold'em No Limit - Level XXII (2000/4000) - 2024/06/26 23:11:33 UTC [2024/06/26 19:11:33 ET]
Table '3769361908 12' 6-max Seat #4 is the button
Seat 1: DR. ELDAR (44145 in chips) 
Seat 3: @tetaschell (19112 in chips) 
Seat 4: vitor762 (74508 in chips) 
Seat 5: Scorgiej (96481 in chips) 
Seat 6: EqualizeSTAR (38358 in chips) 
DR. ELDAR: posts the ante 1000
@tetaschell: posts the ante 1000
vitor762: posts the ante 1000
Scorgiej: posts the ante 1000
EqualizeSTAR: posts the ante 1000
Scorgiej: posts small blind 2000
EqualizeSTAR: posts big blind 4000
*** HOLE CARDS ***
DR. ELDAR: folds 
@tetaschell: folds 
vitor762: raises 4000 to 8000
Scorgiej: folds 
EqualizeSTAR: calls 4000
*** FLOP *** [5d 5c 4c]
EqualizeSTAR: checks 
vitor762: bets 6000
pj0901 is disconnected 
EqualizeSTAR: folds 
Uncalled bet (6000) returned to vitor762
vitor762 collected 23000 from pot
vitor762: doesn't show hand 
*** SUMMARY ***
Total pot 23000 | Rake 0 
Board [5d 5c 4c]
Seat 1: DR. ELDAR folded before Flop (didn't bet)
Seat 3: @tetaschell folded before Flop (didn't bet)
Seat 4: vitor762 (button) collected (23000)
Seat 5: Scorgiej (small blind) folded before Flop
Seat 6: EqualizeSTAR (big blind) folded on the Flop

PokerStars Hand #251210129375: Tournament #3769361908, $52.38+$2.62 USD Hold'em No Limit - Level XXII (2000/4000) - 2024/06/26 23:13:22 UTC [2024/06/26 19:13:22 ET]
Table '3769361908 12' 6-max Seat #5 is the button
Seat 1: DR. ELDAR (43145 in chips) 
Seat 2: pj0901 (25996 in chips) 
Seat 3: @tetaschell (18112 in chips) 
Seat 4: vitor762 (88508 in chips) 
Seat 5: Scorgiej (93481 in chips) 
Seat 6: EqualizeSTAR (29358 in chips) 
DR. ELDAR: posts the ante 1000
pj0901: posts the ante 1000
@tetaschell: posts the ante 1000
vitor762: posts the ante 1000
Scorgiej: posts the ante 1000
EqualizeSTAR: posts the ante 1000
EqualizeSTAR: posts small blind 2000
DR. ELDAR: posts big blind 4000
*** HOLE CARDS ***
pj0901: raises 20000 to 24000
@tetaschell: folds 
vitor762: folds 
Scorgiej: folds 
EqualizeSTAR: folds 
DR. ELDAR: folds 
Uncalled bet (20000) returned to pj0901
pj0901 collected 16000 from pot
pj0901: doesn't show hand 
*** SUMMARY ***
Total pot 16000 | Rake 0 
Seat 1: DR. ELDAR (big blind) folded before Flop
Seat 2: pj0901 collected (16000)
Seat 3: @tetaschell folded before Flop (didn't bet)
Seat 4: vitor762 folded before Flop (didn't bet)
Seat 5: Scorgiej (button) folded before Flop (didn't bet)
Seat 6: EqualizeSTAR (small blind) folded before Flop

PokerStars Hand #251210133891: Tournament #3769361908, $52.38+$2.62 USD Hold'em No Limit - Level XXII (2000/4000) - 2024/06/26 23:13:42 UTC [2024/06/26 19:13:42 ET]
Table '3769361908 12' 6-max Seat #6 is the button
Seat 1: DR. ELDAR (38145 in chips) 
Seat 2: pj0901 (36996 in chips) 
Seat 3: @tetaschell (17112 in chips) 
Seat 4: vitor762 (87508 in chips) 
Seat 5: Scorgiej (92481 in chips) 
Seat 6: EqualizeSTAR (26358 in chips) 
DR. ELDAR: posts the ante 1000
pj0901: posts the ante 1000
@tetaschell: posts the ante 1000
vitor762: posts the ante 1000
Scorgiej: posts the ante 1000
EqualizeSTAR: posts the ante 1000
DR. ELDAR: posts small blind 2000
pj0901: posts big blind 4000
*** HOLE CARDS ***
@tetaschell: folds 
vitor762: folds 
Scorgiej: folds 
EqualizeSTAR: folds 
DR. ELDAR: folds 
Uncalled bet (2000) returned to pj0901
pj0901 collected 10000 from pot
pj0901: doesn't show hand 
*** SUMMARY ***
Total pot 10000 | Rake 0 
Seat 1: DR. ELDAR (small blind) folded before Flop
Seat 2: pj0901 (big blind) collected (10000)
Seat 3: @tetaschell folded before Flop (didn't bet)
Seat 4: vitor762 folded before Flop (didn't bet)
Seat 5: Scorgiej folded before Flop (didn't bet)
Seat 6: EqualizeSTAR (button) folded before Flop (didn't bet)

PokerStars Hand #251210141457: Tournament #3769361908, $52.38+$2.62 USD Hold'em No Limit - Level XXIII (2500/5000) - 2024/06/26 23:14:18 UTC [2024/06/26 19:14:18 ET]
Table '3769361908 12' 6-max Seat #1 is the button
Seat 1: DR. ELDAR (35145 in chips) 
Seat 2: pj0901 (43996 in chips) 
Seat 3: @tetaschell (16112 in chips) 
Seat 4: vitor762 (86508 in chips) 
Seat 5: Scorgiej (91481 in chips) 
Seat 6: EqualizeSTAR (25358 in chips) 
DR. ELDAR: posts the ante 1250
pj0901: posts the ante 1250
@tetaschell: posts the ante 1250
vitor762: posts the ante 1250
Scorgiej: posts the ante 1250
EqualizeSTAR: posts the ante 1250
pj0901: posts small blind 2500
@tetaschell: posts big blind 5000
*** HOLE CARDS ***
vitor762: folds 
Scorgiej: folds 
EqualizeSTAR: folds 
DR. ELDAR: folds 
pj0901: raises 8500 to 13500
@tetaschell: raises 1362 to 14862 and is all-in
pj0901: calls 1362
*** FLOP *** [2h 5c 7c]
*** TURN *** [2h 5c 7c] [6s]
*** RIVER *** [2h 5c 7c 6s] [3h]
*** SHOW DOWN ***
pj0901: shows [Th 6d] (a pair of Sixes)
@tetaschell: shows [3s Ks] (a pair of Threes)
pj0901 collected 37224 from pot
@tetaschell finished the tournament in 52nd place and received $91.90.
*** SUMMARY ***
Total pot 37224 | Rake 0 
Board [2h 5c 7c 6s 3h]
Seat 1: DR. ELDAR (button) folded before Flop (didn't bet)
Seat 2: pj0901 (small blind) showed [Th 6d] and won (37224) with a pair of Sixes
Seat 3: @tetaschell (big blind) showed [3s Ks] and lost with a pair of Threes
Seat 4: vitor762 folded before Flop (didn't bet)
Seat 5: Scorgiej folded before Flop (didn't bet)
Seat 6: EqualizeSTAR folded before Flop (didn't bet)

PokerStars Hand #251210152125: Tournament #3769361908, $52.38+$2.62 USD Hold'em No Limit - Level XXIII (2500/5000) - 2024/06/26 23:15:07 UTC [2024/06/26 19:15:07 ET]
Table '3769361908 12' 6-max Seat #2 is the button
Seat 1: DR. ELDAR (33895 in chips) 
Seat 2: pj0901 (65108 in chips) 
Seat 4: vitor762 (85258 in chips) 
Seat 5: Scorgiej (90231 in chips) 
Seat 6: EqualizeSTAR (24108 in chips) 
DR. ELDAR: posts the ante 1250
pj0901: posts the ante 1250
vitor762: posts the ante 1250
Scorgiej: posts the ante 1250
EqualizeSTAR: posts the ante 1250
vitor762: posts small blind 2500
Scorgiej: posts big blind 5000
*** HOLE CARDS ***
EqualizeSTAR: folds 
DR. ELDAR: folds 
pj0901: folds 
vitor762: calls 2500
Scorgiej: raises 8500 to 13500
vitor762: raises 70508 to 84008 and is all-in
Scorgiej: folds 
Uncalled bet (70508) returned to vitor762
vitor762 collected 33250 from pot
vitor762: doesn't show hand 
*** SUMMARY ***
Total pot 33250 | Rake 0 
Seat 1: DR. ELDAR folded before Flop (didn't bet)
Seat 2: pj0901 (button) folded before Flop (didn't bet)
Seat 4: vitor762 (small blind) collected (33250)
Seat 5: Scorgiej (big blind) folded before Flop
Seat 6: EqualizeSTAR folded before Flop (didn't bet)

PokerStars Hand #251210163884: Tournament #3769361908, $52.38+$2.62 USD Hold'em No Limit - Level XXIII (2500/5000) - 2024/06/26 23:16:02 UTC [2024/06/26 19:16:02 ET]
Table '3769361908 12' 6-max Seat #4 is the button
Seat 1: DR. ELDAR (32645 in chips) 
Seat 2: pj0901 (63858 in chips) 
Seat 3: assalbi (87332 in chips) 
Seat 4: vitor762 (103758 in chips) 
Seat 5: Scorgiej (75481 in chips) 
Seat 6: EqualizeSTAR (22858 in chips) 
DR. ELDAR: posts the ante 1250
pj0901: posts the ante 1250
assalbi: posts the ante 1250
vitor762: posts the ante 1250
Scorgiej: posts the ante 1250
EqualizeSTAR: posts the ante 1250
Scorgiej: posts small blind 2500
EqualizeSTAR: posts big blind 5000
*** HOLE CARDS ***
DR. ELDAR: folds 
pj0901: folds 
assalbi: folds 
vitor762: folds 
Scorgiej: folds 
Uncalled bet (2500) returned to EqualizeSTAR
EqualizeSTAR collected 12500 from pot
EqualizeSTAR: doesn't show hand 
*** SUMMARY ***
Total pot 12500 | Rake 0 
Seat 1: DR. ELDAR folded before Flop (didn't bet)
Seat 2: pj0901 folded before Flop (didn't bet)
Seat 3: assalbi folded before Flop (didn't bet)
Seat 4: vitor762 (button) folded before Flop (didn't bet)
Seat 5: Scorgiej (small blind) folded before Flop
Seat 6: EqualizeSTAR (big blind) collected (12500)

PokerStars Hand #251210170856: Tournament #3769361908, $52.38+$2.62 USD Hold'em No Limit - Level XXIII (2500/5000) - 2024/06/26 23:16:34 UTC [2024/06/26 19:16:34 ET]
Table '3769361908 12' 6-max Seat #5 is the button
Seat 1: DR. ELDAR (31395 in chips) 
Seat 2: pj0901 (62608 in chips) 
Seat 3: assalbi (86082 in chips) 
Seat 4: vitor762 (102508 in chips) 
Seat 5: Scorgiej (71731 in chips) 
Seat 6: EqualizeSTAR (31608 in chips) 
DR. ELDAR: posts the ante 1250
pj0901: posts the ante 1250
assalbi: posts the ante 1250
vitor762: posts the ante 1250
Scorgiej: posts the ante 1250
EqualizeSTAR: posts the ante 1250
EqualizeSTAR: posts small blind 2500
DR. ELDAR: posts big blind 5000
*** HOLE CARDS ***
pj0901: folds 
assalbi: folds 
vitor762: folds 
Scorgiej: folds 
EqualizeSTAR: raises 25358 to 30358 and is all-in
DR. ELDAR: folds 
Uncalled bet (25358) returned to EqualizeSTAR
EqualizeSTAR collected 17500 from pot
EqualizeSTAR: doesn't show hand 
*** SUMMARY ***
Total pot 17500 | Rake 0 
Seat 1: DR. ELDAR (big blind) folded before Flop
Seat 2: pj0901 folded before Flop (didn't bet)
Seat 3: assalbi folded before Flop (didn't bet)
Seat 4: vitor762 folded before Flop (didn't bet)
Seat 5: Scorgiej (button) folded before Flop (didn't bet)
Seat 6: EqualizeSTAR (small blind) collected (17500)

PokerStars Hand #251210177558: Tournament #3769361908, $52.38+$2.62 USD Hold'em No Limit - Level XXIII (2500/5000) - 2024/06/26 23:17:06 UTC [2024/06/26 19:17:06 ET]
Table '3769361908 12' 6-max Seat #6 is the button
Seat 1: DR. ELDAR (25145 in chips) 
Seat 2: pj0901 (61358 in chips) 
Seat 3: assalbi (84832 in chips) 
Seat 4: vitor762 (101258 in chips) 
Seat 5: Scorgiej (70481 in chips) 
Seat 6: EqualizeSTAR (42858 in chips) 
DR. ELDAR: posts the ante 1250
pj0901: posts the ante 1250
assalbi: posts the ante 1250
vitor762: posts the ante 1250
Scorgiej: posts the ante 1250
EqualizeSTAR: posts the ante 1250
DR. ELDAR: posts small blind 2500
pj0901: posts big blind 5000
*** HOLE CARDS ***
assalbi: folds 
vitor762: folds 
Scorgiej: folds 
EqualizeSTAR: folds 
DR. ELDAR: raises 18895 to 23895 and is all-in
pj0901: folds 
Uncalled bet (18895) returned to DR. ELDAR
DR. ELDAR collected 17500 from pot
DR. ELDAR: doesn't show hand 
*** SUMMARY ***
Total pot 17500 | Rake 0 
Seat 1: DR. ELDAR (small blind) collected (17500)
Seat 2: pj0901 (big blind) folded before Flop
Seat 3: assalbi folded before Flop (didn't bet)
Seat 4: vitor762 folded before Flop (didn't bet)
Seat 5: Scorgiej folded before Flop (didn't bet)
Seat 6: EqualizeSTAR (button) folded before Flop (didn't bet)

PokerStars Hand #251210185839: Tournament #3769361908, $52.38+$2.62 USD Hold'em No Limit - Level XXIV (3000/6000) - 2024/06/26 23:17:45 UTC [2024/06/26 19:17:45 ET]
Table '3769361908 12' 6-max Seat #1 is the button
Seat 1: DR. ELDAR (36395 in chips) 
Seat 2: pj0901 (55108 in chips) 
Seat 3: assalbi (83582 in chips) 
Seat 4: vitor762 (100008 in chips) 
Seat 5: Scorgiej (69231 in chips) 
Seat 6: EqualizeSTAR (41608 in chips) 
DR. ELDAR: posts the ante 1500
pj0901: posts the ante 1500
assalbi: posts the ante 1500
vitor762: posts the ante 1500
Scorgiej: posts the ante 1500
EqualizeSTAR: posts the ante 1500
pj0901: posts small blind 3000
assalbi: posts big blind 6000
*** HOLE CARDS ***
vitor762: folds 
Scorgiej: folds 
EqualizeSTAR: folds 
DR. ELDAR: raises 28895 to 34895 and is all-in
pj0901: folds 
assalbi: folds 
Uncalled bet (28895) returned to DR. ELDAR
DR. ELDAR collected 24000 from pot
DR. ELDAR: doesn't show hand 
*** SUMMARY ***
Total pot 24000 | Rake 0 
Seat 1: DR. ELDAR (button) collected (24000)
Seat 2: pj0901 (small blind) folded before Flop
Seat 3: assalbi (big blind) folded before Flop
Seat 4: vitor762 folded before Flop (didn't bet)
Seat 5: Scorgiej folded before Flop (didn't bet)
Seat 6: EqualizeSTAR folded before Flop (didn't bet)

PokerStars Hand #251210194137: Tournament #3769361908, $52.38+$2.62 USD Hold'em No Limit - Level XXIV (3000/6000) - 2024/06/26 23:18:24 UTC [2024/06/26 19:18:24 ET]
Table '3769361908 12' 6-max Seat #2 is the button
Seat 1: DR. ELDAR (52895 in chips) 
Seat 2: pj0901 (50608 in chips) 
Seat 3: assalbi (76082 in chips) 
Seat 4: vitor762 (98508 in chips) 
Seat 5: Scorgiej (67731 in chips) 
Seat 6: EqualizeSTAR (40108 in chips) 
DR. ELDAR: posts the ante 1500
pj0901: posts the ante 1500
assalbi: posts the ante 1500
vitor762: posts the ante 1500
Scorgiej: posts the ante 1500
EqualizeSTAR: posts the ante 1500
assalbi: posts small blind 3000
vitor762: posts big blind 6000
*** HOLE CARDS ***
Scorgiej: raises 60231 to 66231 and is all-in
EqualizeSTAR: folds 
DR. ELDAR: folds 
pj0901: folds 
assalbi: folds 
vitor762: folds 
Uncalled bet (60231) returned to Scorgiej
Scorgiej collected 24000 from pot
Scorgiej: doesn't show hand 
*** SUMMARY ***
Total pot 24000 | Rake 0 
Seat 1: DR. ELDAR folded before Flop (didn't bet)
Seat 2: pj0901 (button) folded before Flop (didn't bet)
Seat 3: assalbi (small blind) folded before Flop
Seat 4: vitor762 (big blind) folded before Flop
Seat 5: Scorgiej collected (24000)
Seat 6: EqualizeSTAR folded before Flop (didn't bet)

PokerStars Hand #251210200770: Tournament #3769361908, $52.38+$2.62 USD Hold'em No Limit - Level XXIV (3000/6000) - 2024/06/26 23:18:56 UTC [2024/06/26 19:18:56 ET]
Table '3769361908 12' 6-max Seat #3 is the button
Seat 1: DR. ELDAR (51395 in chips) 
Seat 2: pj0901 (49108 in chips) 
Seat 3: assalbi (71582 in chips) 
Seat 4: vitor762 (91008 in chips) 
Seat 5: Scorgiej (84231 in chips) 
Seat 6: EqualizeSTAR (38608 in chips) 
DR. ELDAR: posts the ante 1500
pj0901: posts the ante 1500
assalbi: posts the ante 1500
vitor762: posts the ante 1500
Scorgiej: posts the ante 1500
EqualizeSTAR: posts the ante 1500
vitor762: posts small blind 3000
Scorgiej: posts big blind 6000
*** HOLE CARDS ***
EqualizeSTAR: folds 
DR. ELDAR: folds 
pj0901: folds 
assalbi: folds 
vitor762: calls 3000
Scorgiej: checks 
*** FLOP *** [9d 7c Qh]
vitor762: bets 6930
Scorgiej: calls 6930
*** TURN *** [9d 7c Qh] [Kd]
vitor762: bets 21600
Scorgiej: folds 
Uncalled bet (21600) returned to vitor762
vitor762 collected 34860 from pot
vitor762: doesn't show hand 
*** SUMMARY ***
Total pot 34860 | Rake 0 
Board [9d 7c Qh Kd]
Seat 1: DR. ELDAR folded before Flop (didn't bet)
Seat 2: pj0901 folded before Flop (didn't bet)
Seat 3: assalbi (button) folded before Flop (didn't bet)
Seat 4: vitor762 (small blind) collected (34860)
Seat 5: Scorgiej (big blind) folded on the Turn
Seat 6: EqualizeSTAR folded before Flop (didn't bet)

PokerStars Hand #251210213337: Tournament #3769361908, $52.38+$2.62 USD Hold'em No Limit - Level XXIV (3000/6000) - 2024/06/26 23:19:56 UTC [2024/06/26 19:19:56 ET]
Table '3769361908 12' 6-max Seat #4 is the button
Seat 1: DR. ELDAR (49895 in chips) 
Seat 2: pj0901 (47608 in chips) 
Seat 3: assalbi (70082 in chips) 
Seat 4: vitor762 (111438 in chips) 
Seat 5: Scorgiej (69801 in chips) 
Seat 6: EqualizeSTAR (37108 in chips) 
DR. ELDAR: posts the ante 1500
pj0901: posts the ante 1500
assalbi: posts the ante 1500
vitor762: posts the ante 1500
Scorgiej: posts the ante 1500
EqualizeSTAR: posts the ante 1500
Scorgiej: posts small blind 3000
EqualizeSTAR: posts big blind 6000
*** HOLE CARDS ***
DR. ELDAR: raises 6600 to 12600
pj0901: folds 
assalbi: folds 
vitor762: folds 
Scorgiej: folds 
EqualizeSTAR: raises 23008 to 35608 and is all-in
DR. ELDAR: calls 23008
*** FLOP *** [6c Jd 5s]
*** TURN *** [6c Jd 5s] [Ks]
*** RIVER *** [6c Jd 5s Ks] [2h]
*** SHOW DOWN ***
EqualizeSTAR: shows [8c Ad] (high card Ace)
DR. ELDAR: shows [Jc Tc] (a pair of Jacks)
DR. ELDAR collected 83216 from pot
EqualizeSTAR finished the tournament in 32nd place and received $111.65.
*** SUMMARY ***
Total pot 83216 | Rake 0 
Board [6c Jd 5s Ks 2h]
Seat 1: DR. ELDAR showed [Jc Tc] and won (83216) with a pair of Jacks
Seat 2: pj0901 folded before Flop (didn't bet)
Seat 3: assalbi folded before Flop (didn't bet)
Seat 4: vitor762 (button) folded before Flop (didn't bet)
Seat 5: Scorgiej (small blind) folded before Flop
Seat 6: EqualizeSTAR (big blind) showed [8c Ad] and lost with high card Ace

PokerStars Hand #251210224391: Tournament #3769361908, $52.38+$2.62 USD Hold'em No Limit - Level XXV (3500/7000) - 2024/06/26 23:20:49 UTC [2024/06/26 19:20:49 ET]
Table '3769361908 12' 6-max Seat #5 is the button
Seat 1: DR. ELDAR (96003 in chips) 
Seat 2: pj0901 (46108 in chips) 
Seat 3: assalbi (68582 in chips) 
Seat 4: vitor762 (109938 in chips) 
Seat 5: Scorgiej (65301 in chips) 
DR. ELDAR: posts the ante 1750
pj0901: posts the ante 1750
assalbi: posts the ante 1750
vitor762: posts the ante 1750
Scorgiej: posts the ante 1750
DR. ELDAR: posts small blind 3500
pj0901: posts big blind 7000
*** HOLE CARDS ***
assalbi: folds 
vitor762: folds 
Scorgiej: folds 
DR. ELDAR: folds 
Uncalled bet (3500) returned to pj0901
pj0901 collected 15750 from pot
pj0901: doesn't show hand 
*** SUMMARY ***
Total pot 15750 | Rake 0 
Seat 1: DR. ELDAR (small blind) folded before Flop
Seat 2: pj0901 (big blind) collected (15750)
Seat 3: assalbi folded before Flop (didn't bet)
Seat 4: vitor762 folded before Flop (didn't bet)
Seat 5: Scorgiej (button) folded before Flop (didn't bet)

PokerStars Hand #251210228730: Tournament #3769361908, $52.38+$2.62 USD Hold'em No Limit - Level XXV (3500/7000) - 2024/06/26 23:21:10 UTC [2024/06/26 19:21:10 ET]
Table '3769361908 12' 6-max Seat #1 is the button
Seat 1: DR. ELDAR (90753 in chips) 
Seat 2: pj0901 (56608 in chips) 
Seat 3: assalbi (66832 in chips) 
Seat 4: vitor762 (108188 in chips) 
Seat 5: Scorgiej (63551 in chips) 
Seat 6: sinister778 (114122 in chips) 
DR. ELDAR: posts the ante 1750
pj0901: posts the ante 1750
assalbi: posts the ante 1750
vitor762: posts the ante 1750
Scorgiej: posts the ante 1750
sinister778: posts the ante 1750
pj0901: posts small blind 3500
assalbi: posts big blind 7000
*** HOLE CARDS ***
vitor762: folds 
Scorgiej: folds 
sinister778: raises 7000 to 14000
DR. ELDAR: folds 
pj0901: folds 
assalbi: folds 
Uncalled bet (7000) returned to sinister778
sinister778 collected 28000 from pot
*** SUMMARY ***
Total pot 28000 | Rake 0 
Seat 1: DR. ELDAR (button) folded before Flop (didn't bet)
Seat 2: pj0901 (small blind) folded before Flop
Seat 3: assalbi (big blind) folded before Flop
Seat 4: vitor762 folded before Flop (didn't bet)
Seat 5: Scorgiej folded before Flop (didn't bet)
Seat 6: sinister778 collected (28000)

PokerStars Hand #251210235643: Tournament #3769361908, $52.38+$2.62 USD Hold'em No Limit - Level XXV (3500/7000) - 2024/06/26 23:21:43 UTC [2024/06/26 19:21:43 ET]
Table '3769361908 12' 6-max Seat #2 is the button
Seat 1: DR. ELDAR (89003 in chips) 
Seat 2: pj0901 (51358 in chips) 
Seat 3: assalbi (58082 in chips) 
Seat 4: vitor762 (106438 in chips) 
Seat 5: Scorgiej (61801 in chips) 
Seat 6: sinister778 (133372 in chips) 
DR. ELDAR: posts the ante 1750
pj0901: posts the ante 1750
assalbi: posts the ante 1750
vitor762: posts the ante 1750
Scorgiej: posts the ante 1750
sinister778: posts the ante 1750
assalbi: posts small blind 3500
vitor762: posts big blind 7000
*** HOLE CARDS ***
Scorgiej: folds 
sinister778: folds 
DR. ELDAR: raises 80253 to 87253 and is all-in
pj0901: folds 
assalbi: folds 
vitor762: calls 80253
*** FLOP *** [Qd Tc Qh]
*** TURN *** [Qd Tc Qh] [6s]
*** RIVER *** [Qd Tc Qh 6s] [Ks]
*** SHOW DOWN ***
vitor762: shows [9s 9h] (two pair, Queens and Nines)
DR. ELDAR: shows [Kd 7c] (two pair, Kings and Queens)
DR. ELDAR collected 188506 from pot
*** SUMMARY ***
Total pot 188506 | Rake 0 
Board [Qd Tc Qh 6s Ks]
Seat 1: DR. ELDAR showed [Kd 7c] and won (188506) with two pair, Kings and Queens
Seat 2: pj0901 (button) folded before Flop (didn't bet)
Seat 3: assalbi (small blind) folded before Flop
Seat 4: vitor762 (big blind) showed [9s 9h] and lost with two pair, Queens and Nines
Seat 5: Scorgiej folded before Flop (didn't bet)
Seat 6: sinister778 folded before Flop (didn't bet)

PokerStars Hand #251210243687: Tournament #3769361908, $52.38+$2.62 USD Hold'em No Limit - Level XXV (3500/7000) - 2024/06/26 23:22:22 UTC [2024/06/26 19:22:22 ET]
Table '3769361908 12' 6-max Seat #3 is the button
Seat 1: DR. ELDAR (188506 in chips) 
Seat 2: pj0901 (49608 in chips) 
Seat 3: assalbi (52832 in chips) 
Seat 4: vitor762 (17435 in chips) 
Seat 5: Scorgiej (60051 in chips) 
DR. ELDAR: posts the ante 1750
pj0901: posts the ante 1750
assalbi: posts the ante 1750
vitor762: posts the ante 1750
Scorgiej: posts the ante 1750
vitor762: posts small blind 3500
Scorgiej: posts big blind 7000
*** HOLE CARDS ***
DR. ELDAR: folds 
pj0901: raises 35000 to 42000
assalbi: folds 
vitor762: folds 
Scorgiej: folds 
Uncalled bet (35000) returned to pj0901
pj0901 collected 26250 from pot
pj0901: doesn't show hand 
*** SUMMARY ***
Total pot 26250 | Rake 0 
Seat 1: DR. ELDAR folded before Flop (didn't bet)
Seat 2: pj0901 collected (26250)
Seat 3: assalbi (button) folded before Flop (didn't bet)
Seat 4: vitor762 (small blind) folded before Flop
Seat 5: Scorgiej (big blind) folded before Flop

PokerStars Hand #251210247972: Tournament #3769361908, $52.38+$2.62 USD Hold'em No Limit - Level XXV (3500/7000) - 2024/06/26 23:22:43 UTC [2024/06/26 19:22:43 ET]
Table '3769361908 12' 6-max Seat #4 is the button
Seat 1: DR. ELDAR (186756 in chips) 
Seat 2: pj0901 (67108 in chips) 
Seat 3: assalbi (51082 in chips) 
Seat 4: vitor762 (12185 in chips) 
Seat 5: Scorgiej (51301 in chips) 
DR. ELDAR: posts the ante 1750
pj0901: posts the ante 1750
assalbi: posts the ante 1750
vitor762: posts the ante 1750
Scorgiej: posts the ante 1750
Scorgiej: posts small blind 3500
DR. ELDAR: posts big blind 7000
*** HOLE CARDS ***
pj0901: folds 
assalbi: folds 
vitor762: folds 
Scorgiej: folds 
Uncalled bet (3500) returned to DR. ELDAR
DR. ELDAR collected 15750 from pot
DR. ELDAR: doesn't show hand 
*** SUMMARY ***
Total pot 15750 | Rake 0 
Seat 1: DR. ELDAR (big blind) collected (15750)
Seat 2: pj0901 folded before Flop (didn't bet)
Seat 3: assalbi folded before Flop (didn't bet)
Seat 4: vitor762 (button) folded before Flop (didn't bet)
Seat 5: Scorgiej (small blind) folded before Flop

PokerStars Hand #251210252890: Tournament #3769361908, $52.38+$2.62 USD Hold'em No Limit - Level XXV (3500/7000) - 2024/06/26 23:23:06 UTC [2024/06/26 19:23:06 ET]
Table '3769361908 12' 6-max Seat #5 is the button
Seat 1: DR. ELDAR (197256 in chips) 
Seat 2: pj0901 (65358 in chips) 
Seat 3: assalbi (49332 in chips) 
Seat 4: vitor762 (10435 in chips) 
Seat 5: Scorgiej (46051 in chips) 
DR. ELDAR: posts the ante 1750
pj0901: posts the ante 1750
assalbi: posts the ante 1750
vitor762: posts the ante 1750
Scorgiej: posts the ante 1750
DR. ELDAR: posts small blind 3500
pj0901: posts big blind 7000
*** HOLE CARDS ***
assalbi: raises 40582 to 47582 and is all-in
vitor762: folds 
Scorgiej: folds 
DR. ELDAR: folds 
pj0901: folds 
Uncalled bet (40582) returned to assalbi
assalbi collected 26250 from pot
assalbi: doesn't show hand 
*** SUMMARY ***
Total pot 26250 | Rake 0 
Seat 1: DR. ELDAR (small blind) folded before Flop
Seat 2: pj0901 (big blind) folded before Flop
Seat 3: assalbi collected (26250)
Seat 4: vitor762 folded before Flop (didn't bet)
Seat 5: Scorgiej (button) folded before Flop (didn't bet)

PokerStars Hand #251210258247: Tournament #3769361908, $52.38+$2.62 USD Hold'em No Limit - Level XXVI (4000/8000) - 2024/06/26 23:23:32 UTC [2024/06/26 19:23:32 ET]
Table '3769361908 12' 6-max Seat #1 is the button
Seat 1: DR. ELDAR (192006 in chips) 
Seat 2: pj0901 (56608 in chips) 
Seat 3: assalbi (66832 in chips) 
Seat 4: vitor762 (8685 in chips) 
Seat 5: Scorgiej (44301 in chips) 
DR. ELDAR: posts the ante 2000
pj0901: posts the ante 2000
assalbi: posts the ante 2000
vitor762: posts the ante 2000
Scorgiej: posts the ante 2000
pj0901: posts small blind 4000
assalbi: posts big blind 8000
*** HOLE CARDS ***
vitor762: calls 6685 and is all-in
Scorgiej: folds 
DR. ELDAR: folds 
pj0901: raises 44000 to 52000
assalbi: folds 
Uncalled bet (44000) returned to pj0901
*** FLOP *** [7s 4h Jc]
*** TURN *** [7s 4h Jc] [2s]
*** RIVER *** [7s 4h Jc 2s] [9h]
*** SHOW DOWN ***
pj0901: shows [Kc 6h] (high card King)
pj0901 collected 2630 from side pot
vitor762: shows [Qs Ac] (high card Ace)
vitor762 collected 30055 from main pot
*** SUMMARY ***
Total pot 32685 Main pot 30055. Side pot 2630. | Rake 0 
Board [7s 4h Jc 2s 9h]
Seat 1: DR. ELDAR (button) folded before Flop (didn't bet)
Seat 2: pj0901 (small blind) showed [Kc 6h] and won (2630) with high card King
Seat 3: assalbi (big blind) folded before Flop
Seat 4: vitor762 showed [Qs Ac] and won (30055) with high card Ace
Seat 5: Scorgiej folded before Flop (didn't bet)

PokerStars Hand #251210266461: Tournament #3769361908, $52.38+$2.62 USD Hold'em No Limit - Level XXVI (4000/8000) - 2024/06/26 23:24:12 UTC [2024/06/26 19:24:12 ET]
Table '3769361908 12' 6-max Seat #2 is the button
Seat 1: DR. ELDAR (190006 in chips) 
Seat 2: pj0901 (49238 in chips) 
Seat 3: assalbi (56832 in chips) 
Seat 4: vitor762 (30055 in chips) 
Seat 5: Scorgiej (42301 in chips) 
DR. ELDAR: posts the ante 2000
pj0901: posts the ante 2000
assalbi: posts the ante 2000
vitor762: posts the ante 2000
Scorgiej: posts the ante 2000
assalbi: posts small blind 4000
vitor762: posts big blind 8000
*** HOLE CARDS ***
Scorgiej: raises 32000 to 40000
DR. ELDAR: folds 
pj0901: folds 
assalbi: raises 14832 to 54832 and is all-in
vitor762: folds 
Scorgiej: calls 301 and is all-in
Uncalled bet (14531) returned to assalbi
*** FLOP *** [8d Qc 7s]
*** TURN *** [8d Qc 7s] [5h]
*** RIVER *** [8d Qc 7s 5h] [7c]
*** SHOW DOWN ***
assalbi: shows [Ac Ks] (a pair of Sevens)
Scorgiej: shows [7h 7d] (four of a kind, Sevens)
Scorgiej collected 98602 from pot
*** SUMMARY ***
Total pot 98602 | Rake 0 
Board [8d Qc 7s 5h 7c]
Seat 1: DR. ELDAR folded before Flop (didn't bet)
Seat 2: pj0901 (button) folded before Flop (didn't bet)
Seat 3: assalbi (small blind) showed [Ac Ks] and lost with a pair of Sevens
Seat 4: vitor762 (big blind) folded before Flop
Seat 5: Scorgiej showed [7h 7d] and won (98602) with four of a kind, Sevens

PokerStars Hand #251210277132: Tournament #3769361908, $52.38+$2.62 USD Hold'em No Limit - Level XXVI (4000/8000) - 2024/06/26 23:25:04 UTC [2024/06/26 19:25:04 ET]
Table '3769361908 12' 6-max Seat #3 is the button
Seat 1: DR. ELDAR (188006 in chips) 
Seat 2: pj0901 (47238 in chips) 
Seat 3: assalbi (14531 in chips) 
Seat 4: vitor762 (20055 in chips) 
Seat 5: Scorgiej (98602 in chips) 
DR. ELDAR: posts the ante 2000
pj0901: posts the ante 2000
assalbi: posts the ante 2000
vitor762: posts the ante 2000
Scorgiej: posts the ante 2000
vitor762: posts small blind 4000
Scorgiej: posts big blind 8000
*** HOLE CARDS ***
DR. ELDAR: folds 
pj0901: folds 
assalbi: raises 4531 to 12531 and is all-in
vitor762: folds 
Scorgiej: calls 4531
*** FLOP *** [8h 6c 3h]
*** TURN *** [8h 6c 3h] [As]
*** RIVER *** [8h 6c 3h As] [Kc]
*** SHOW DOWN ***
Scorgiej: shows [Ah 9c] (a pair of Aces)
assalbi: shows [7h Jd] (high card Ace)
Scorgiej collected 39062 from pot
assalbi finished the tournament in 27th place and received $135.63.
*** SUMMARY ***
Total pot 39062 | Rake 0 
Board [8h 6c 3h As Kc]
Seat 1: DR. ELDAR folded before Flop (didn't bet)
Seat 2: pj0901 folded before Flop (didn't bet)
Seat 3: assalbi (button) showed [7h Jd] and lost with high card Ace
Seat 4: vitor762 (small blind) folded before Flop
Seat 5: Scorgiej (big blind) showed [Ah 9c] and won (39062) with a pair of Aces

PokerStars Hand #251210283587: Tournament #3769361908, $52.38+$2.62 USD Hold'em No Limit - Level XXVI (4000/8000) - 2024/06/26 23:25:35 UTC [2024/06/26 19:25:35 ET]
Table '3769361908 12' 6-max Seat #4 is the button
Seat 1: DR. ELDAR (186006 in chips) 
Seat 2: pj0901 (45238 in chips) 
Seat 4: vitor762 (14055 in chips) 
Seat 5: Scorgiej (123133 in chips) 
DR. ELDAR: posts the ante 2000
pj0901: posts the ante 2000
vitor762: posts the ante 2000
Scorgiej: posts the ante 2000
Scorgiej: posts small blind 4000
DR. ELDAR: posts big blind 8000
*** HOLE CARDS ***
pj0901: folds 
vitor762: raises 4055 to 12055 and is all-in
chrichrac is disconnected 
Scorgiej: calls 8055
DR. ELDAR: calls 4055
*** FLOP *** [8h 2h 7h]
Scorgiej: checks 
DR. ELDAR: checks 
*** TURN *** [8h 2h 7h] [8d]
Scorgiej: checks 
DR. ELDAR: checks 
*** RIVER *** [8h 2h 7h 8d] [2d]
Scorgiej: checks 
DR. ELDAR: checks 
*** SHOW DOWN ***
Scorgiej: shows [Jh 9d] (two pair, Eights and Deuces)
DR. ELDAR: shows [Js Td] (two pair, Eights and Deuces)
vitor762: shows [Ks 8c] (a full house, Eights full of Deuces)
vitor762 collected 44165 from pot
*** SUMMARY ***
Total pot 44165 | Rake 0 
Board [8h 2h 7h 8d 2d]
Seat 1: DR. ELDAR (big blind) showed [Js Td] and lost with two pair, Eights and Deuces
Seat 2: pj0901 folded before Flop (didn't bet)
Seat 4: vitor762 (button) showed [Ks 8c] and won (44165) with a full house, Eights full of Deuces
Seat 5: Scorgiej (small blind) showed [Jh 9d] and lost with two pair, Eights and Deuces

PokerStars Hand #251210290969: Tournament #3769361908, $52.38+$2.62 USD Hold'em No Limit - Level XXVI (4000/8000) - 2024/06/26 23:26:12 UTC [2024/06/26 19:26:12 ET]
Table '3769361908 12' 6-max Seat #5 is the button
Seat 1: DR. ELDAR (171951 in chips) 
Seat 2: pj0901 (43238 in chips) 
Seat 3: chrichrac (83486 in chips) 
Seat 4: vitor762 (44165 in chips) 
Seat 5: Scorgiej (109078 in chips) 
DR. ELDAR: posts the ante 2000
pj0901: posts the ante 2000
chrichrac: posts the ante 2000
vitor762: posts the ante 2000
Scorgiej: posts the ante 2000
DR. ELDAR: posts small blind 4000
pj0901: posts big blind 8000
*** HOLE CARDS ***
chrichrac: folds 
vitor762: folds 
Scorgiej: folds 
DR. ELDAR: folds 
Uncalled bet (4000) returned to pj0901
pj0901 collected 18000 from pot
pj0901: doesn't show hand 
*** SUMMARY ***
Total pot 18000 | Rake 0 
Seat 1: DR. ELDAR (small blind) folded before Flop
Seat 2: pj0901 (big blind) collected (18000)
Seat 3: chrichrac folded before Flop (didn't bet)
Seat 4: vitor762 folded before Flop (didn't bet)
Seat 5: Scorgiej (button) folded before Flop (didn't bet)

PokerStars Hand #251210295720: Tournament #3769361908, $52.38+$2.62 USD Hold'em No Limit - Level XXVII (4500/9000) - 2024/06/26 23:26:35 UTC [2024/06/26 19:26:35 ET]
Table '3769361908 12' 6-max Seat #1 is the button
Seat 1: DR. ELDAR (165951 in chips) 
Seat 2: pj0901 (55238 in chips) 
Seat 3: chrichrac (81486 in chips) 
Seat 4: vitor762 (42165 in chips) 
Seat 5: Scorgiej (107078 in chips) 
DR. ELDAR: posts the ante 2250
pj0901: posts the ante 2250
chrichrac: posts the ante 2250
vitor762: posts the ante 2250
Scorgiej: posts the ante 2250
pj0901: posts small blind 4500
chrichrac: posts big blind 9000
*** HOLE CARDS ***
vitor762: raises 30915 to 39915 and is all-in
Scorgiej: folds 
DR. ELDAR: folds 
pj0901: folds 
chrichrac: folds 
Uncalled bet (30915) returned to vitor762
vitor762 collected 33750 from pot
vitor762: doesn't show hand 
*** SUMMARY ***
Total pot 33750 | Rake 0 
Seat 1: DR. ELDAR (button) folded before Flop (didn't bet)
Seat 2: pj0901 (small blind) folded before Flop
Seat 3: chrichrac (big blind) folded before Flop
Seat 4: vitor762 collected (33750)
Seat 5: Scorgiej folded before Flop (didn't bet)

PokerStars Hand #251210304273: Tournament #3769361908, $52.38+$2.62 USD Hold'em No Limit - Level XXVII (4500/9000) - 2024/06/26 23:27:18 UTC [2024/06/26 19:27:18 ET]
Table '3769361908 12' 6-max Seat #2 is the button
Seat 1: DR. ELDAR (163701 in chips) 
Seat 2: pj0901 (48488 in chips) 
Seat 3: chrichrac (70236 in chips) 
Seat 4: vitor762 (64665 in chips) 
Seat 5: Scorgiej (104828 in chips) 
DR. ELDAR: posts the ante 2250
pj0901: posts the ante 2250
chrichrac: posts the ante 2250
vitor762: posts the ante 2250
Scorgiej: posts the ante 2250
chrichrac: posts small blind 4500
vitor762: posts big blind 9000
*** HOLE CARDS ***
Scorgiej: folds 
DR. ELDAR: raises 152451 to 161451 and is all-in
pj0901: folds 
chrichrac: folds 
vitor762: calls 53415 and is all-in
Uncalled bet (99036) returned to DR. ELDAR
*** FLOP *** [8s 7d 9h]
*** TURN *** [8s 7d 9h] [3d]
*** RIVER *** [8s 7d 9h 3d] [Jc]
*** SHOW DOWN ***
vitor762: shows [Jd Ks] (a pair of Jacks)
DR. ELDAR: shows [Qd Ac] (high card Ace)
vitor762 collected 140580 from pot
*** SUMMARY ***
Total pot 140580 | Rake 0 
Board [8s 7d 9h 3d Jc]
Seat 1: DR. ELDAR showed [Qd Ac] and lost with high card Ace
Seat 2: pj0901 (button) folded before Flop (didn't bet)
Seat 3: chrichrac (small blind) folded before Flop
Seat 4: vitor762 (big blind) showed [Jd Ks] and won (140580) with a pair of Jacks
Seat 5: Scorgiej folded before Flop (didn't bet)

PokerStars Hand #251210316212: Tournament #3769361908, $52.38+$2.62 USD Hold'em No Limit - Level XXVII (4500/9000) - 2024/06/26 23:28:17 UTC [2024/06/26 19:28:17 ET]
Table '3769361908 12' 6-max Seat #3 is the button
Seat 1: DR. ELDAR (99036 in chips) 
Seat 2: pj0901 (46238 in chips) 
Seat 3: chrichrac (63486 in chips) 
Seat 4: vitor762 (140580 in chips) 
Seat 5: Scorgiej (102578 in chips) 
Seat 6: mila is best (110124 in chips) 
DR. ELDAR: posts the ante 2250
pj0901: posts the ante 2250
chrichrac: posts the ante 2250
vitor762: posts the ante 2250
Scorgiej: posts the ante 2250
mila is best: posts the ante 2250
vitor762: posts small blind 4500
Scorgiej: posts big blind 9000
*** HOLE CARDS ***
mila is best: folds 
DR. ELDAR: folds 
pj0901: raises 31500 to 40500
chrichrac has timed out
chrichrac: folds 
chrichrac is sitting out
chrichrac has returned
vitor762: folds 
Scorgiej: folds 
Uncalled bet (31500) returned to pj0901
pj0901 collected 36000 from pot
pj0901: doesn't show hand 
*** SUMMARY ***
Total pot 36000 | Rake 0 
Seat 1: DR. ELDAR folded before Flop (didn't bet)
Seat 2: pj0901 collected (36000)
Seat 3: chrichrac (button) folded before Flop (didn't bet)
Seat 4: vitor762 (small blind) folded before Flop
Seat 5: Scorgiej (big blind) folded before Flop
Seat 6: mila is best folded before Flop (didn't bet)

PokerStars Hand #251210325067: Tournament #3769361908, $52.38+$2.62 USD Hold'em No Limit - Level XXVII (4500/9000) - 2024/06/26 23:29:01 UTC [2024/06/26 19:29:01 ET]
Table '3769361908 12' 6-max Seat #4 is the button
Seat 1: DR. ELDAR (96786 in chips) 
Seat 2: pj0901 (70988 in chips) 
Seat 3: chrichrac (61236 in chips) 
Seat 4: vitor762 (133830 in chips) 
Seat 5: Scorgiej (91328 in chips) 
Seat 6: mila is best (107874 in chips) 
DR. ELDAR: posts the ante 2250
pj0901: posts the ante 2250
chrichrac: posts the ante 2250
vitor762: posts the ante 2250
Scorgiej: posts the ante 2250
mila is best: posts the ante 2250
Scorgiej: posts small blind 4500
mila is best: posts big blind 9000
*** HOLE CARDS ***
DR. ELDAR: raises 19800 to 28800
pj0901: folds 
chrichrac: folds 
vitor762: folds 
Scorgiej: raises 60278 to 89078 and is all-in
mila is best: folds 
DR. ELDAR: calls 60278
*** FLOP *** [2c Jd 5d]
*** TURN *** [2c Jd 5d] [Qd]
*** RIVER *** [2c Jd 5d Qd] [7c]
*** SHOW DOWN ***
Scorgiej: shows [Ks Kc] (a pair of Kings)
DR. ELDAR: shows [Qh Jc] (two pair, Queens and Jacks)
DR. ELDAR collected 200656 from pot
Scorgiej finished the tournament in 22nd place and received $164.76.
*** SUMMARY ***
Total pot 200656 | Rake 0 
Board [2c Jd 5d Qd 7c]
Seat 1: DR. ELDAR showed [Qh Jc] and won (200656) with two pair, Queens and Jacks
Seat 2: pj0901 folded before Flop (didn't bet)
Seat 3: chrichrac folded before Flop (didn't bet)
Seat 4: vitor762 (button) folded before Flop (didn't bet)
Seat 5: Scorgiej (small blind) showed [Ks Kc] and lost with a pair of Kings
Seat 6: mila is best (big blind) folded before Flop

PokerStars Hand #251210336153: Tournament #3769361908, $52.38+$2.62 USD Hold'em No Limit - Level XXVIII (5000/10000) - 2024/06/26 23:29:57 UTC [2024/06/26 19:29:57 ET]
Table '3769361908 12' 6-max Seat #6 is the button
Seat 1: DR. ELDAR (206114 in chips) 
Seat 2: pj0901 (68738 in chips) 
Seat 3: chrichrac (58986 in chips) 
Seat 4: vitor762 (131580 in chips) 
Seat 6: mila is best (96624 in chips) 
DR. ELDAR: posts the ante 2500
pj0901: posts the ante 2500
chrichrac: posts the ante 2500
vitor762: posts the ante 2500
mila is best: posts the ante 2500
DR. ELDAR: posts small blind 5000
pj0901: posts big blind 10000
*** HOLE CARDS ***
chrichrac: raises 46486 to 56486 and is all-in
vitor762: folds 
mila is best: raises 37638 to 94124 and is all-in
DR. ELDAR: folds 
pj0901: folds 
Uncalled bet (37638) returned to mila is best
*** FLOP *** [3s 8s Js]
*** TURN *** [3s 8s Js] [9c]
*** RIVER *** [3s 8s Js 9c] [Qs]
*** SHOW DOWN ***
chrichrac: shows [Kc Th] (a straight, Nine to King)
mila is best: shows [Qc Ac] (a pair of Queens)
chrichrac collected 140472 from pot
*** SUMMARY ***
Total pot 140472 | Rake 0 
Board [3s 8s Js 9c Qs]
Seat 1: DR. ELDAR (small blind) folded before Flop
Seat 2: pj0901 (big blind) folded before Flop
Seat 3: chrichrac showed [Kc Th] and won (140472) with a straight, Nine to King
Seat 4: vitor762 folded before Flop (didn't bet)
Seat 6: mila is best (button) showed [Qc Ac] and lost with a pair of Queens

PokerStars Hand #251210344950: Tournament #3769361908, $52.38+$2.62 USD Hold'em No Limit - Level XXVIII (5000/10000) - 2024/06/26 23:30:41 UTC [2024/06/26 19:30:41 ET]
Table '3769361908 12' 6-max Seat #1 is the button
Seat 1: DR. ELDAR (198614 in chips) 
Seat 2: pj0901 (56238 in chips) 
Seat 3: chrichrac (140472 in chips) 
Seat 4: vitor762 (129080 in chips) 
Seat 6: mila is best (37638 in chips) 
DR. ELDAR: posts the ante 2500
pj0901: posts the ante 2500
chrichrac: posts the ante 2500
vitor762: posts the ante 2500
mila is best: posts the ante 2500
pj0901: posts small blind 5000
chrichrac: posts big blind 10000
*** HOLE CARDS ***
vitor762: folds 
mila is best: folds 
DR. ELDAR: folds 
pj0901: folds 
Uncalled bet (5000) returned to chrichrac
chrichrac collected 22500 from pot
chrichrac: doesn't show hand 
*** SUMMARY ***
Total pot 22500 | Rake 0 
Seat 1: DR. ELDAR (button) folded before Flop (didn't bet)
Seat 2: pj0901 (small blind) folded before Flop
Seat 3: chrichrac (big blind) collected (22500)
Seat 4: vitor762 folded before Flop (didn't bet)
Seat 6: mila is best folded before Flop (didn't bet)

PokerStars Hand #251210350900: Tournament #3769361908, $52.38+$2.62 USD Hold'em No Limit - Level XXVIII (5000/10000) - 2024/06/26 23:31:10 UTC [2024/06/26 19:31:10 ET]
Table '3769361908 12' 6-max Seat #2 is the button
Seat 1: DR. ELDAR (196114 in chips) 
Seat 2: pj0901 (48738 in chips) 
Seat 3: chrichrac (155472 in chips) 
Seat 4: vitor762 (126580 in chips) 
Seat 6: mila is best (35138 in chips) 
DR. ELDAR: posts the ante 2500
pj0901: posts the ante 2500
chrichrac: posts the ante 2500
vitor762: posts the ante 2500
mila is best: posts the ante 2500
chrichrac: posts small blind 5000
vitor762: posts big blind 10000
*** HOLE CARDS ***
mila is best: folds 
DR. ELDAR: folds 
pj0901: raises 35000 to 45000
chrichrac: raises 107972 to 152972 and is all-in
vitor762: folds 
pj0901: calls 1238 and is all-in
Uncalled bet (106734) returned to chrichrac
*** FLOP *** [8c 2c 9c]
*** TURN *** [8c 2c 9c] [7s]
*** RIVER *** [8c 2c 9c 7s] [6s]
*** SHOW DOWN ***
chrichrac: shows [9s 9d] (three of a kind, Nines)
pj0901: shows [Qc Jd] (high card Queen)
chrichrac collected 114976 from pot
pj0901 finished the tournament in 19th place and received $164.76.
*** SUMMARY ***
Total pot 114976 | Rake 0 
Board [8c 2c 9c 7s 6s]
Seat 1: DR. ELDAR folded before Flop (didn't bet)
Seat 2: pj0901 (button) showed [Qc Jd] and lost with high card Queen
Seat 3: chrichrac (small blind) showed [9s 9d] and won (114976) with three of a kind, Nines
Seat 4: vitor762 (big blind) folded before Flop
Seat 6: mila is best folded before Flop (didn't bet)
